country,year_month,Conflict,Economic,Governance,Other,Political,Social,Unknown,push_factor_index
Afghanistan,01/05/2010,128,0,1,0,19,17,0,165
Afghanistan,02/05/2010,197,0,-8,0,24,39,0,252
Afghanistan,03/05/2010,303,0,0,0,16,31,0,350
Afghanistan,04/05/2010,159,2,1,0,52,39,0,253
Afghanistan,05/05/2010,153,0,-2,0,28,8,0,187
Afghanistan,06/05/2010,27,0,0,0,6,1,0,34
Afghanistan,07/05/2010,7,0,0,0,6,1,0,14
Afghanistan,08/05/2010,34,0,1,0,12,0,0,47
Afghanistan,09/05/2010,59,0,0,0,9,0,0,68
Afghanistan,10/05/2010,74,0,0,0,21,10,0,105
Afghanistan,11/05/2010,147,0,1,0,49,8,0,205
Afghanistan,12/05/2010,158,0,0,0,24,31,0,213
Afghanistan,13/05/2010,27,0,0,0,1,8,0,36
Afghanistan,14/05/2010,39,0,0,0,5,0,0,44
Afghanistan,15/05/2010,48,4,2,0,16,0,0,70
Afghanistan,16/05/2010,74,2,0,0,18,2,0,96
Afghanistan,17/05/2010,95,0,0,0,29,5,0,129
Afghanistan,18/05/2010,67,2,-5,0,9,17,0,90
Afghanistan,19/05/2010,112,0,1,0,12,16,0,141
Afghanistan,20/05/2010,20,0,0,0,-3,2,0,19
Afghanistan,21/05/2010,53,0,0,0,12,7,0,72
Afghanistan,22/05/2010,110,0,0,0,15,0,0,125
Afghanistan,23/05/2010,213,2,0,0,54,11,0,280
Afghanistan,24/05/2010,39,0,0,0,1,1,0,41
Afghanistan,25/05/2010,150,2,0,0,6,17,0,175
Afghanistan,26/05/2010,164,0,1,0,11,24,0,200
Afghanistan,27/05/2010,129,0,4,0,9,9,0,151
Afghanistan,28/05/2010,91,2,0,0,9,2,0,104
Afghanistan,29/05/2010,193,2,0,0,21,11,0,227
Afghanistan,30/05/2010,94,0,0,0,41,16,0,151
Afghanistan,31/05/2010,54,0,1,0,6,2,0,63
Albania,01/05/2010,2,0,0,0,3,8,0,13
Albania,02/05/2010,0,0,0,0,18,0,0,18
Albania,03/05/2010,5,0,0,0,3,0,0,8
Albania,04/05/2010,2,0,-2,0,0,0,0,0
Albania,05/05/2010,2,0,-1,0,0,0,0,1
Albania,06/05/2010,0,0,0,0,0,4,0,4
Albania,07/05/2010,0,0,-4,0,0,2,0,-2
Albania,10/05/2010,51,0,-2,0,12,1,0,62
Albania,11/05/2010,26,0,0,0,6,0,0,32
Albania,12/05/2010,56,0,0,0,6,0,0,62
Albania,13/05/2010,8,0,1,0,0,3,0,12
Albania,14/05/2010,3,0,0,0,0,0,0,3
Albania,15/05/2010,0,0,0,0,0,0,0,0
Albania,17/05/2010,7,0,0,0,0,0,0,7
Albania,18/05/2010,4,0,-6,0,6,5,0,9
Albania,19/05/2010,29,0,1,0,9,2,0,41
Albania,20/05/2010,12,0,0,0,4,4,0,20
Albania,21/05/2010,1,0,0,0,0,2,0,3
Albania,22/05/2010,5,0,0,0,3,0,0,8
Albania,24/05/2010,5,0,0,0,6,0,0,11
Albania,25/05/2010,5,0,1,0,0,0,0,6
Albania,26/05/2010,3,0,0,0,0,0,0,3
Albania,27/05/2010,0,0,0,0,0,0,0,0
Albania,28/05/2010,0,0,0,0,0,0,0,0
Albania,30/05/2010,32,0,0,0,3,17,0,52
Albania,31/05/2010,0,0,0,0,0,0,0,0
Algeria,01/05/2010,18,0,0,0,6,0,0,24
Algeria,02/05/2010,17,0,0,0,0,0,0,17
Algeria,03/05/2010,4,0,1,0,21,0,0,26
Algeria,04/05/2010,2,0,-1,0,0,0,0,1
Algeria,05/05/2010,0,0,0,0,0,0,0,0
Algeria,06/05/2010,0,0,0,0,0,0,0,0
Algeria,07/05/2010,0,0,0,0,0,0,0,0
Algeria,08/05/2010,0,0,0,0,0,0,0,0
Algeria,09/05/2010,0,0,0,0,1,0,0,1
Algeria,10/05/2010,-1,0,0,0,1,0,0,0
Algeria,11/05/2010,4,0,0,0,0,0,0,4
Algeria,12/05/2010,0,0,0,0,9,0,0,9
Algeria,13/05/2010,0,0,0,0,-6,0,0,-6
Algeria,14/05/2010,1,0,0,0,16,0,0,17
Algeria,15/05/2010,0,0,0,0,0,0,0,0
Algeria,16/05/2010,0,0,0,0,-4,0,0,-4
Algeria,17/05/2010,0,0,0,0,7,0,0,7
Algeria,18/05/2010,1,0,0,0,12,0,0,13
Algeria,19/05/2010,1,0,0,0,9,0,0,10
Algeria,20/05/2010,2,0,0,0,0,0,0,2
Algeria,21/05/2010,5,0,0,0,0,1,0,6
Algeria,22/05/2010,0,0,0,0,0,1,0,1
Algeria,23/05/2010,5,0,0,0,-1,0,0,4
Algeria,24/05/2010,0,0,0,0,0,0,0,0
Algeria,25/05/2010,0,0,0,0,9,0,0,9
Algeria,26/05/2010,2,0,0,0,1,0,0,3
Algeria,27/05/2010,4,0,0,0,0,0,0,4
Algeria,28/05/2010,1,0,0,0,0,0,0,1
Algeria,29/05/2010,0,0,0,0,3,0,0,3
Algeria,30/05/2010,3,0,0,0,0,0,0,3
Algeria,31/05/2010,32,0,0,0,0,2,0,34
Bangladesh,01/05/2010,11,0,-3,0,2,0,0,10
Bangladesh,02/05/2010,18,0,0,0,4,0,0,22
Bangladesh,03/05/2010,28,0,-2,0,0,5,0,31
Bangladesh,04/05/2010,1,0,0,0,3,1,0,5
Bangladesh,05/05/2010,5,4,-4,0,21,1,0,27
Bangladesh,06/05/2010,0,0,0,0,-3,0,0,-3
Bangladesh,07/05/2010,3,0,0,0,0,0,0,3
Bangladesh,08/05/2010,0,0,0,0,0,0,0,0
Bangladesh,09/05/2010,-1,0,0,0,0,0,0,-1
Bangladesh,10/05/2010,4,0,0,0,12,0,0,16
Bangladesh,11/05/2010,6,0,0,0,1,0,0,7
Bangladesh,12/05/2010,3,0,0,0,0,0,0,3
Bangladesh,13/05/2010,4,0,0,0,0,0,0,4
Bangladesh,14/05/2010,0,0,0,0,0,0,0,0
Bangladesh,15/05/2010,2,0,0,0,-1,0,0,1
Bangladesh,16/05/2010,26,0,0,0,3,0,0,29
Bangladesh,17/05/2010,6,0,0,0,-1,0,0,5
Bangladesh,18/05/2010,-2,0,0,0,0,0,0,-2
Bangladesh,19/05/2010,3,0,0,0,3,0,0,6
Bangladesh,20/05/2010,6,0,0,0,0,0,0,6
Bangladesh,21/05/2010,2,0,0,0,0,0,0,2
Bangladesh,22/05/2010,3,0,0,0,0,0,0,3
Bangladesh,23/05/2010,2,0,0,0,0,1,0,3
Bangladesh,24/05/2010,1,0,0,0,2,0,0,3
Bangladesh,25/05/2010,2,0,0,0,-4,0,0,-2
Bangladesh,26/05/2010,2,0,0,0,-2,2,0,2
Bangladesh,27/05/2010,6,0,0,0,15,5,0,26
Bangladesh,28/05/2010,3,0,0,0,7,0,0,10
Bangladesh,29/05/2010,19,0,2,0,22,0,0,43
Bangladesh,30/05/2010,10,0,3,0,25,9,0,47
Bangladesh,31/05/2010,0,0,0,0,0,0,0,0
Cameroon,01/05/2010,3,0,0,0,0,0,0,3
Cameroon,02/05/2010,3,0,0,0,6,0,0,9
Cameroon,03/05/2010,0,0,0,0,0,0,0,0
Cameroon,04/05/2010,0,0,0,0,0,0,0,0
Cameroon,05/05/2010,0,0,0,0,0,0,0,0
Cameroon,09/05/2010,0,0,0,0,0,0,0,0
Cameroon,10/05/2010,2,0,0,0,0,0,0,2
Cameroon,17/05/2010,5,0,0,0,1,0,0,6
Cameroon,18/05/2010,0,0,0,0,0,0,0,0
Cameroon,19/05/2010,0,0,0,0,4,0,0,4
Cameroon,20/05/2010,0,0,0,0,6,0,0,6
Cameroon,21/05/2010,2,0,0,0,0,0,0,2
Cameroon,22/05/2010,2,0,0,0,3,0,0,5
Cameroon,25/05/2010,3,0,0,0,0,0,0,3
Cameroon,26/05/2010,0,0,0,0,0,0,0,0
Cameroon,28/05/2010,0,0,0,0,0,0,0,0
Cameroon,29/05/2010,0,0,0,0,0,0,0,0
China,01/05/2010,44,2,0,0,10,12,0,68
China,02/05/2010,92,0,-2,0,13,7,0,110
China,03/05/2010,55,2,-4,0,47,25,0,125
China,04/05/2010,32,0,0,0,47,7,0,86
China,05/05/2010,67,0,-2,0,39,22,0,126
China,06/05/2010,13,0,0,0,5,0,0,18
China,07/05/2010,12,0,0,0,15,0,0,27
China,08/05/2010,5,0,0,0,12,0,0,17
China,09/05/2010,-4,0,0,0,3,2,0,1
China,10/05/2010,12,0,1,0,-1,3,0,15
China,11/05/2010,43,0,-1,0,5,8,0,55
China,12/05/2010,58,4,0,0,4,20,0,86
China,13/05/2010,23,0,0,0,15,4,0,42
China,14/05/2010,37,0,0,0,14,3,0,54
China,15/05/2010,44,2,0,0,70,2,0,118
China,16/05/2010,8,0,0,0,21,1,0,30
China,17/05/2010,43,0,1,0,21,5,0,70
China,18/05/2010,50,0,0,0,32,8,0,90
China,19/05/2010,77,2,-1,0,27,3,0,108
China,20/05/2010,40,0,0,0,2,2,0,44
China,21/05/2010,14,0,-1,0,12,9,0,34
China,22/05/2010,51,2,3,0,24,4,0,84
China,23/05/2010,26,0,2,0,20,2,0,50
China,24/05/2010,5,0,1,0,17,2,0,25
China,25/05/2010,25,0,0,0,11,12,0,48
China,26/05/2010,82,0,0,0,15,5,0,102
China,27/05/2010,13,0,0,0,-1,4,0,16
China,28/05/2010,30,2,0,0,23,6,0,61
China,29/05/2010,69,0,0,0,-6,2,0,65
China,30/05/2010,70,0,0,0,16,0,0,86
China,31/05/2010,-8,0,0,0,6,4,0,2
Egypt,01/05/2010,54,0,0,0,10,4,0,68
Egypt,02/05/2010,56,0,0,0,4,6,0,66
Egypt,03/05/2010,29,0,-1,0,18,6,0,52
Egypt,04/05/2010,19,0,1,0,21,0,0,41
Egypt,05/05/2010,13,0,0,0,27,0,0,40
Egypt,06/05/2010,6,0,0,0,0,0,0,6
Egypt,07/05/2010,9,0,0,0,2,18,0,29
Egypt,08/05/2010,10,0,0,0,3,4,0,17
Egypt,09/05/2010,8,0,0,0,12,0,0,20
Egypt,10/05/2010,22,0,0,0,15,0,0,37
Egypt,11/05/2010,19,0,0,0,-2,0,0,17
Egypt,12/05/2010,12,0,0,0,-5,5,0,12
Egypt,13/05/2010,9,0,0,0,15,14,0,38
Egypt,14/05/2010,21,0,1,0,21,0,0,43
Egypt,15/05/2010,22,0,0,0,3,0,0,25
Egypt,16/05/2010,17,0,0,0,0,0,0,17
Egypt,17/05/2010,21,0,0,0,18,2,0,41
Egypt,18/05/2010,30,0,0,0,0,0,0,30
Egypt,19/05/2010,12,0,0,0,8,6,0,26
Egypt,20/05/2010,14,0,0,0,4,5,0,23
Egypt,21/05/2010,6,0,0,0,9,5,0,20
Egypt,22/05/2010,19,0,0,0,3,1,0,23
Egypt,23/05/2010,17,0,1,0,9,0,0,27
Egypt,24/05/2010,6,0,0,0,3,0,0,9
Egypt,25/05/2010,11,0,0,0,-5,1,0,7
Egypt,26/05/2010,17,2,-3,0,3,2,0,21
Egypt,27/05/2010,11,0,0,0,6,0,0,17
Egypt,28/05/2010,15,0,0,0,0,0,0,15
Egypt,29/05/2010,37,0,0,0,3,6,0,46
Egypt,30/05/2010,35,0,0,0,-2,3,0,36
Egypt,31/05/2010,62,0,-6,0,3,0,0,59
Eritrea,01/05/2010,0,0,0,0,3,0,0,3
Eritrea,02/05/2010,1,0,0,0,12,0,0,13
Eritrea,03/05/2010,0,0,0,0,22,2,0,24
Eritrea,04/05/2010,0,0,0,0,6,0,0,6
Eritrea,05/05/2010,4,0,0,0,15,0,0,19
Eritrea,08/05/2010,0,0,0,0,0,0,0,0
Eritrea,10/05/2010,-2,0,0,0,0,0,0,-2
Eritrea,11/05/2010,1,0,0,0,6,0,0,7
Eritrea,12/05/2010,0,8,0,0,0,0,0,8
Eritrea,13/05/2010,3,8,0,0,0,0,0,11
Eritrea,14/05/2010,0,0,0,0,0,0,0,0
Eritrea,15/05/2010,0,0,0,0,-8,0,0,-8
Eritrea,16/05/2010,6,0,0,0,0,0,0,6
Eritrea,18/05/2010,0,0,0,0,0,0,0,0
Eritrea,19/05/2010,-3,0,0,0,0,0,0,-3
Eritrea,20/05/2010,0,0,0,0,3,0,0,3
Eritrea,21/05/2010,0,0,0,0,0,0,0,0
Eritrea,22/05/2010,3,0,0,0,0,0,0,3
Eritrea,23/05/2010,20,0,0,0,3,2,0,25
Eritrea,24/05/2010,12,0,0,0,0,0,0,12
Eritrea,25/05/2010,0,0,0,0,0,0,0,0
Eritrea,26/05/2010,0,0,0,0,0,0,0,0
Eritrea,27/05/2010,3,0,0,0,0,0,0,3
Eritrea,28/05/2010,0,0,0,0,6,0,0,6
Eritrea,29/05/2010,0,0,0,0,0,0,0,0
Eritrea,30/05/2010,0,0,0,0,0,0,0,0
Eritrea,31/05/2010,1,0,0,0,0,0,0,1
Georgia,01/05/2010,13,0,0,0,4,1,0,18
Georgia,02/05/2010,6,0,0,0,3,0,0,9
Georgia,03/05/2010,23,0,3,0,17,3,0,46
Georgia,04/05/2010,10,2,0,0,0,0,0,12
Georgia,05/05/2010,1,0,0,0,13,2,0,16
Georgia,06/05/2010,0,0,0,0,0,0,0,0
Georgia,07/05/2010,7,0,0,0,6,0,0,13
Georgia,08/05/2010,3,0,0,0,0,0,0,3
Georgia,09/05/2010,3,0,0,0,0,1,0,4
Georgia,10/05/2010,2,0,0,0,0,0,0,2
Georgia,11/05/2010,1,0,0,0,6,1,0,8
Georgia,12/05/2010,8,4,0,0,9,3,0,24
Georgia,13/05/2010,14,0,1,0,-1,0,0,14
Georgia,14/05/2010,3,0,-4,0,-2,0,0,-3
Georgia,15/05/2010,1,0,0,0,-2,0,0,-1
Georgia,16/05/2010,0,0,0,0,0,0,0,0
Georgia,17/05/2010,3,0,0,0,0,0,0,3
Georgia,18/05/2010,6,0,0,0,9,0,0,15
Georgia,19/05/2010,6,0,0,0,4,4,0,14
Georgia,20/05/2010,0,0,0,0,0,0,0,0
Georgia,21/05/2010,5,0,0,0,3,2,0,10
Georgia,22/05/2010,34,0,0,0,4,1,0,39
Georgia,23/05/2010,2,0,0,0,0,0,0,2
Georgia,24/05/2010,0,0,0,0,1,0,0,1
Georgia,25/05/2010,-1,0,0,0,-1,0,0,-2
Georgia,26/05/2010,21,0,0,0,7,2,0,30
Georgia,27/05/2010,2,0,0,0,3,0,0,5
Georgia,28/05/2010,10,0,0,0,6,0,0,16
Georgia,29/05/2010,16,0,0,0,6,1,0,23
Georgia,30/05/2010,9,0,0,0,7,0,0,16
Georgia,31/05/2010,3,0,0,0,0,0,0,3
India,01/05/2010,48,0,-1,0,1,4,0,52
India,02/05/2010,55,0,1,0,7,5,0,68
India,03/05/2010,60,0,-4,0,15,3,0,74
India,04/05/2010,15,0,-2,0,2,1,0,16
India,05/05/2010,51,0,0,0,9,2,0,62
India,07/05/2010,2,0,-1,0,0,0,0,1
India,08/05/2010,28,2,0,0,0,1,0,31
India,09/05/2010,4,0,0,0,0,0,0,4
India,10/05/2010,23,0,0,0,12,0,0,35
India,11/05/2010,25,0,0,0,3,0,0,28
India,12/05/2010,13,0,0,0,-4,1,0,10
India,13/05/2010,4,0,0,0,6,2,0,12
India,14/05/2010,17,0,0,0,3,3,0,23
India,15/05/2010,23,0,0,0,10,3,0,36
India,16/05/2010,25,0,0,0,3,2,0,30
India,17/05/2010,28,2,-1,0,9,0,0,38
India,18/05/2010,51,0,-1,0,0,3,0,53
India,19/05/2010,41,0,-4,0,16,2,0,55
India,20/05/2010,6,0,0,0,-2,0,0,4
India,21/05/2010,21,0,-2,0,-4,1,0,16
India,22/05/2010,47,0,-1,0,13,1,0,60
India,23/05/2010,52,0,0,0,5,2,0,59
India,24/05/2010,6,0,-5,0,9,2,0,12
India,25/05/2010,15,0,-12,0,13,7,0,23
India,26/05/2010,36,0,0,0,3,0,0,39
India,27/05/2010,27,0,-1,0,13,2,0,41
India,28/05/2010,29,0,-2,0,-2,5,0,30
India,29/05/2010,45,0,0,0,4,5,0,54
India,30/05/2010,13,0,-3,0,1,0,0,11
India,31/05/2010,4,0,-4,0,6,6,0,12
Iran,01/05/2010,71,0,2,0,45,9,0,127
Iran,02/05/2010,75,2,1,0,34,8,0,120
Iran,03/05/2010,158,2,-2,0,45,11,0,214
Iran,04/05/2010,79,0,-3,0,36,14,0,126
Iran,05/05/2010,95,6,4,0,21,17,0,143
Iran,06/05/2010,7,0,0,0,1,0,0,8
Iran,07/05/2010,19,0,0,0,4,0,0,23
Iran,08/05/2010,27,0,0,0,21,0,0,48
Iran,09/05/2010,14,0,0,0,7,0,0,21
Iran,10/05/2010,54,4,0,0,22,0,0,80
Iran,11/05/2010,12,0,0,0,22,0,0,34
Iran,12/05/2010,37,0,0,0,15,5,0,57
Iran,13/05/2010,17,0,0,0,10,11,0,38
Iran,14/05/2010,16,0,0,0,16,0,0,32
Iran,15/05/2010,20,0,0,0,20,5,0,45
Iran,16/05/2010,3,0,0,0,9,4,0,16
Iran,17/05/2010,21,0,0,0,10,3,0,34
Iran,18/05/2010,19,0,-2,0,47,9,0,73
Iran,19/05/2010,126,0,0,0,81,22,0,229
Iran,20/05/2010,27,0,0,0,14,16,0,57
Iran,21/05/2010,10,2,0,0,14,6,0,32
Iran,22/05/2010,44,0,0,0,19,5,0,68
Iran,23/05/2010,52,0,0,0,-11,2,0,43
Iran,24/05/2010,11,0,0,0,6,0,0,17
Iran,25/05/2010,60,0,-2,0,15,3,0,76
Iran,26/05/2010,22,0,0,0,8,4,0,34
Iran,27/05/2010,12,0,0,0,-5,2,0,9
Iran,28/05/2010,23,0,-1,0,-4,2,0,20
Iran,29/05/2010,34,0,0,0,9,5,0,48
Iran,30/05/2010,31,0,0,0,1,1,0,33
Iran,31/05/2010,24,0,0,0,2,1,0,27
Iraq,01/05/2010,62,0,1,0,12,33,0,108
Iraq,02/05/2010,68,0,0,0,22,32,0,122
Iraq,03/05/2010,121,4,1,0,23,8,0,157
Iraq,04/05/2010,25,2,2,0,22,3,0,54
Iraq,05/05/2010,76,0,0,0,19,9,0,104
Iraq,06/05/2010,4,0,0,0,4,2,0,10
Iraq,07/05/2010,17,0,0,0,6,7,0,30
Iraq,08/05/2010,36,0,0,0,0,0,0,36
Iraq,09/05/2010,26,0,0,0,3,2,0,31
Iraq,10/05/2010,17,0,0,0,6,3,0,26
Iraq,11/05/2010,14,0,0,0,12,10,0,36
Iraq,12/05/2010,14,0,0,0,15,8,0,37
Iraq,13/05/2010,16,0,0,0,3,2,0,21
Iraq,14/05/2010,18,0,0,0,0,2,0,20
Iraq,15/05/2010,38,2,1,0,-3,2,0,40
Iraq,16/05/2010,11,0,0,0,1,0,0,12
Iraq,17/05/2010,21,0,0,0,3,4,0,28
Iraq,18/05/2010,17,0,0,0,11,3,0,31
Iraq,19/05/2010,44,0,0,0,49,0,0,93
Iraq,20/05/2010,87,0,0,0,0,3,0,90
Iraq,21/05/2010,50,0,0,0,9,0,0,59
Iraq,22/05/2010,111,0,2,0,40,2,0,155
Iraq,23/05/2010,34,0,0,0,37,4,0,75
Iraq,24/05/2010,35,0,0,0,16,6,0,57
Iraq,25/05/2010,104,0,0,0,23,10,0,137
Iraq,26/05/2010,107,0,0,0,-1,12,0,118
Iraq,27/05/2010,58,0,0,0,15,0,0,73
Iraq,28/05/2010,43,0,0,0,5,2,0,50
Iraq,29/05/2010,92,0,0,0,50,3,0,145
Iraq,30/05/2010,77,0,0,0,14,3,0,94
Iraq,31/05/2010,32,2,2,0,0,0,0,36
Morocco,01/05/2010,16,0,0,0,1,0,0,17
Morocco,02/05/2010,0,0,0,0,0,0,0,0
Morocco,03/05/2010,-5,0,0,0,1,2,0,-2
Morocco,04/05/2010,-1,0,0,0,0,1,0,0
Morocco,05/05/2010,6,0,0,0,0,0,0,6
Morocco,06/05/2010,0,0,0,0,0,0,0,0
Morocco,07/05/2010,0,0,0,0,3,0,0,3
Morocco,08/05/2010,0,0,0,0,0,0,0,0
Morocco,09/05/2010,-3,0,0,0,0,0,0,-3
Morocco,10/05/2010,0,0,0,0,0,0,0,0
Morocco,11/05/2010,16,0,0,0,6,0,0,22
Morocco,12/05/2010,1,0,0,0,0,0,0,1
Morocco,13/05/2010,0,0,0,0,0,0,0,0
Morocco,14/05/2010,0,0,0,0,0,0,0,0
Morocco,15/05/2010,3,0,0,0,3,0,0,6
Morocco,16/05/2010,11,0,0,0,12,0,0,23
Morocco,17/05/2010,14,0,0,0,3,0,0,17
Morocco,18/05/2010,2,0,0,0,15,0,0,17
Morocco,19/05/2010,0,0,0,0,6,0,0,6
Morocco,20/05/2010,2,0,0,0,9,0,0,11
Morocco,21/05/2010,0,0,0,0,3,0,0,3
Morocco,22/05/2010,0,0,0,0,0,0,0,0
Morocco,24/05/2010,0,0,0,0,0,0,0,0
Morocco,25/05/2010,3,0,0,0,3,1,0,7
Morocco,26/05/2010,0,0,0,0,9,1,0,10
Morocco,27/05/2010,2,0,0,0,0,0,0,2
Morocco,28/05/2010,8,0,-2,0,6,0,0,12
Morocco,29/05/2010,9,0,0,0,0,0,0,9
Morocco,30/05/2010,3,0,0,0,0,0,0,3
Morocco,31/05/2010,0,0,0,0,3,0,0,3
Nigeria,01/05/2010,10,0,0,0,10,1,0,21
Nigeria,02/05/2010,4,0,0,0,15,0,0,19
Nigeria,03/05/2010,29,0,0,0,40,4,0,73
Nigeria,04/05/2010,16,0,0,0,22,0,0,38
Nigeria,05/05/2010,34,0,-1,0,19,1,0,53
Nigeria,06/05/2010,3,0,0,0,0,0,0,3
Nigeria,07/05/2010,0,0,0,0,0,-2,0,-2
Nigeria,08/05/2010,0,0,0,0,0,0,0,0
Nigeria,09/05/2010,0,0,0,0,3,0,0,3
Nigeria,10/05/2010,8,0,-3,0,6,0,0,11
Nigeria,11/05/2010,7,0,0,0,4,2,0,13
Nigeria,12/05/2010,6,0,0,0,0,0,0,6
Nigeria,13/05/2010,4,0,0,0,-4,0,0,0
Nigeria,14/05/2010,6,0,0,0,6,0,0,12
Nigeria,15/05/2010,2,0,0,0,-2,0,0,0
Nigeria,16/05/2010,7,0,0,0,9,2,0,18
Nigeria,17/05/2010,2,0,1,0,3,0,0,6
Nigeria,18/05/2010,1,0,0,0,0,3,0,4
Nigeria,19/05/2010,9,0,0,0,2,1,0,12
Nigeria,20/05/2010,3,0,0,0,-2,0,0,1
Nigeria,21/05/2010,6,0,1,0,3,2,0,12
Nigeria,22/05/2010,6,0,0,0,-2,0,0,4
Nigeria,23/05/2010,17,0,-1,0,9,0,0,25
Nigeria,24/05/2010,0,0,0,0,0,0,0,0
Nigeria,25/05/2010,6,0,0,0,15,2,0,23
Nigeria,26/05/2010,5,2,0,0,3,0,0,10
Nigeria,27/05/2010,2,0,0,0,0,0,0,2
Nigeria,28/05/2010,1,0,0,0,1,0,0,2
Nigeria,29/05/2010,0,0,0,0,-2,1,0,-1
Nigeria,30/05/2010,1,0,0,0,1,1,0,3
Nigeria,31/05/2010,0,0,0,0,6,0,0,6
Pakistan,01/05/2010,45,0,-1,0,30,3,0,77
Pakistan,02/05/2010,146,0,1,0,27,4,0,178
Pakistan,03/05/2010,327,0,0,0,322,44,0,693
Pakistan,04/05/2010,184,0,2,0,78,11,0,275
Pakistan,05/05/2010,93,0,0,0,70,17,0,180
Pakistan,06/05/2010,41,0,0,0,16,0,0,57
Pakistan,07/05/2010,53,0,0,0,18,0,0,71
Pakistan,08/05/2010,35,0,0,0,12,8,0,55
Pakistan,09/05/2010,13,0,0,0,19,0,0,32
Pakistan,10/05/2010,88,0,0,0,10,19,0,117
Pakistan,11/05/2010,61,2,-2,0,30,8,0,99
Pakistan,12/05/2010,46,2,0,0,6,26,0,80
Pakistan,13/05/2010,14,0,0,0,8,12,0,34
Pakistan,14/05/2010,74,0,0,0,45,6,0,125
Pakistan,15/05/2010,47,0,0,0,15,4,0,66
Pakistan,16/05/2010,26,0,0,0,28,6,0,60
Pakistan,17/05/2010,61,0,0,0,4,8,0,73
Pakistan,18/05/2010,57,0,0,0,43,9,0,109
Pakistan,19/05/2010,97,0,3,0,68,29,0,197
Pakistan,20/05/2010,43,0,0,0,23,16,0,82
Pakistan,21/05/2010,74,0,-2,0,43,5,0,120
Pakistan,22/05/2010,75,0,0,0,59,11,0,145
Pakistan,23/05/2010,13,0,0,0,14,2,0,29
Pakistan,24/05/2010,27,0,1,0,10,10,0,48
Pakistan,25/05/2010,37,2,0,0,11,0,0,50
Pakistan,26/05/2010,73,0,0,0,27,6,0,106
Pakistan,27/05/2010,21,0,0,0,24,0,0,45
Pakistan,28/05/2010,31,0,0,0,48,3,0,82
Pakistan,29/05/2010,129,0,1,0,40,23,0,193
Pakistan,30/05/2010,45,0,0,0,38,11,0,94
Pakistan,31/05/2010,19,0,1,0,-3,0,0,17
Sierra Leone,01/05/2010,0,0,0,0,6,0,0,6
Sierra Leone,03/05/2010,0,0,0,0,0,0,0,0
Sierra Leone,04/05/2010,1,0,0,0,0,4,0,5
Sierra Leone,05/05/2010,0,0,0,0,9,0,0,9
Sierra Leone,07/05/2010,0,0,0,0,0,0,0,0
Sierra Leone,10/05/2010,28,0,0,0,0,0,0,28
Sierra Leone,11/05/2010,0,0,0,0,0,10,0,10
Sierra Leone,12/05/2010,0,0,0,0,0,2,0,2
Sierra Leone,13/05/2010,3,0,0,0,0,0,0,3
Sierra Leone,14/05/2010,0,0,0,0,0,0,0,0
Sierra Leone,17/05/2010,0,2,0,0,0,0,0,2
Sierra Leone,18/05/2010,0,0,0,0,0,0,0,0
Sierra Leone,19/05/2010,3,0,0,0,0,0,0,3
Sierra Leone,20/05/2010,1,0,0,0,0,0,0,1
Sierra Leone,21/05/2010,3,0,0,0,3,1,0,7
Sierra Leone,22/05/2010,2,0,0,0,0,0,0,2
Sierra Leone,23/05/2010,0,0,0,0,-1,0,0,-1
Sierra Leone,24/05/2010,0,0,0,0,0,0,0,0
Sierra Leone,25/05/2010,0,0,-6,0,0,4,0,-2
Sierra Leone,26/05/2010,1,0,0,0,0,0,0,1
Sierra Leone,27/05/2010,3,0,1,0,0,0,0,4
Sierra Leone,28/05/2010,4,0,0,0,9,0,0,13
Sierra Leone,31/05/2010,0,0,0,0,0,0,0,0
Somalia,01/05/2010,11,0,-1,0,39,3,0,52
Somalia,02/05/2010,42,2,0,0,19,3,0,66
Somalia,03/05/2010,32,0,0,0,21,5,0,58
Somalia,04/05/2010,6,0,0,0,7,0,0,13
Somalia,05/05/2010,66,0,0,0,11,0,0,77
Somalia,06/05/2010,45,0,0,0,-14,0,0,31
Somalia,07/05/2010,13,0,0,0,0,0,0,13
Somalia,08/05/2010,6,0,0,0,24,0,0,30
Somalia,09/05/2010,14,0,0,0,15,0,0,29
Somalia,10/05/2010,12,2,0,0,15,4,0,33
Somalia,11/05/2010,0,0,0,0,11,6,0,17
Somalia,12/05/2010,29,0,0,0,11,0,0,40
Somalia,13/05/2010,7,0,0,0,-9,0,0,-2
Somalia,14/05/2010,5,0,-2,0,-8,4,0,-1
Somalia,15/05/2010,8,0,0,0,-4,2,0,6
Somalia,16/05/2010,5,0,0,0,21,0,0,26
Somalia,17/05/2010,14,0,0,0,-3,0,0,11
Somalia,18/05/2010,12,0,0,0,20,0,0,32
Somalia,19/05/2010,52,0,0,0,5,4,0,61
Somalia,20/05/2010,5,0,0,0,0,0,0,5
Somalia,21/05/2010,22,0,0,0,41,0,0,63
Somalia,22/05/2010,34,4,0,0,4,2,0,44
Somalia,23/05/2010,25,0,0,0,-6,4,0,23
Somalia,24/05/2010,4,2,0,0,-1,0,0,5
Somalia,25/05/2010,29,0,0,0,12,1,0,42
Somalia,26/05/2010,6,0,0,0,12,2,0,20
Somalia,27/05/2010,17,0,0,0,-3,0,0,14
Somalia,28/05/2010,26,0,0,0,0,0,0,26
Somalia,29/05/2010,11,0,-2,0,-1,0,0,8
Somalia,30/05/2010,0,0,0,0,19,0,0,19
Somalia,31/05/2010,9,0,0,0,1,0,0,10
Syria,01/05/2010,21,0,0,0,3,0,0,24
Syria,02/05/2010,20,0,5,0,13,0,0,38
Syria,03/05/2010,6,2,3,0,3,4,0,18
Syria,04/05/2010,8,0,1,0,0,0,0,9
Syria,05/05/2010,5,0,0,0,0,1,0,6
Syria,06/05/2010,-2,0,0,0,0,0,0,-2
Syria,07/05/2010,7,0,0,0,3,0,0,10
Syria,08/05/2010,7,0,0,0,0,0,0,7
Syria,09/05/2010,2,0,0,0,15,3,0,20
Syria,10/05/2010,7,0,0,0,9,0,0,16
Syria,11/05/2010,5,0,0,0,2,0,0,7
Syria,12/05/2010,15,0,0,0,11,0,0,26
Syria,13/05/2010,0,0,0,0,7,0,0,7
Syria,14/05/2010,0,0,0,0,0,0,0,0
Syria,15/05/2010,13,0,0,0,11,0,0,24
Syria,16/05/2010,2,0,0,0,1,1,0,4
Syria,17/05/2010,0,0,0,0,-2,2,0,0
Syria,18/05/2010,11,0,0,0,0,0,0,11
Syria,19/05/2010,13,0,0,0,10,0,0,23
Syria,20/05/2010,0,0,0,0,0,0,0,0
Syria,21/05/2010,10,0,0,0,12,0,0,22
Syria,22/05/2010,3,0,0,0,20,4,0,27
Syria,23/05/2010,25,0,1,0,14,0,0,40
Syria,24/05/2010,8,0,0,0,0,0,0,8
Syria,25/05/2010,17,0,-1,0,3,0,0,19
Syria,26/05/2010,0,0,0,0,3,0,0,3
Syria,27/05/2010,0,0,0,0,6,0,0,6
Syria,28/05/2010,6,0,0,0,9,0,0,15
Syria,29/05/2010,2,0,0,0,4,0,0,6
Syria,30/05/2010,8,0,0,0,6,0,0,14
Syria,31/05/2010,6,0,0,0,0,0,0,6
Yemen,01/05/2010,26,0,0,0,26,5,0,57
Yemen,02/05/2010,1,0,-4,0,9,2,0,8
Yemen,03/05/2010,16,0,0,0,12,1,0,29
Yemen,04/05/2010,19,0,0,0,-2,2,0,19
Yemen,05/05/2010,1,0,0,0,0,0,0,1
Yemen,06/05/2010,0,0,0,0,0,0,0,0
Yemen,07/05/2010,3,0,0,0,0,0,0,3
Yemen,08/05/2010,0,0,0,0,0,0,0,0
Yemen,09/05/2010,2,0,0,0,6,0,0,8
Yemen,10/05/2010,5,0,0,0,9,0,0,14
Yemen,11/05/2010,4,0,0,0,0,3,0,7
Yemen,12/05/2010,0,0,0,0,3,9,0,12
Yemen,13/05/2010,1,0,0,0,3,5,0,9
Yemen,14/05/2010,3,0,0,0,21,0,0,24
Yemen,15/05/2010,3,0,0,0,9,6,0,18
Yemen,16/05/2010,0,0,0,0,9,0,0,9
Yemen,17/05/2010,3,0,0,0,3,0,0,6
Yemen,18/05/2010,15,0,1,0,32,2,0,50
Yemen,19/05/2010,9,0,0,0,15,1,0,25
Yemen,20/05/2010,2,0,0,0,9,3,0,14
Yemen,21/05/2010,15,0,-5,0,-10,0,0,0
Yemen,22/05/2010,12,0,0,0,6,0,0,18
Yemen,23/05/2010,57,0,0,0,26,7,0,90
Yemen,24/05/2010,0,0,0,0,6,0,0,6
Yemen,25/05/2010,5,0,0,0,-4,2,0,3
Yemen,26/05/2010,2,2,0,0,-2,0,0,2
Yemen,27/05/2010,0,0,0,0,9,0,0,9
Yemen,28/05/2010,7,0,0,0,0,2,0,9
Yemen,29/05/2010,11,0,0,0,-2,2,0,11
Yemen,30/05/2010,0,0,0,0,2,0,0,2
Yemen,31/05/2010,0,0,0,0,6,0,0,6
Afghanistan,01/11/2010,194,0,2,0,88,55,0,339
Afghanistan,02/11/2010,198,2,-7,0,62,22,0,277
Afghanistan,03/11/2010,394,4,2,0,31,17,0,448
Afghanistan,04/11/2010,318,0,-2,0,106,32,0,454
Afghanistan,05/11/2010,306,2,1,0,64,48,0,421
Afghanistan,06/11/2010,212,0,-1,0,44,35,0,290
Afghanistan,07/11/2010,288,2,3,0,19,14,0,326
Afghanistan,08/11/2010,210,0,0,0,15,16,0,241
Afghanistan,09/11/2010,281,0,-4,0,50,24,0,351
Afghanistan,10/11/2010,340,0,-2,0,16,17,0,371
Afghanistan,11/11/2010,431,2,1,0,41,41,0,516
Afghanistan,12/11/2010,210,2,0,0,40,19,0,271
Afghanistan,13/11/2010,70,0,-2,0,17,5,0,90
Afghanistan,14/11/2010,260,2,-1,0,-14,27,0,274
Afghanistan,15/11/2010,340,4,3,0,0,30,0,377
Afghanistan,16/11/2010,220,4,-1,0,21,40,0,284
Afghanistan,17/11/2010,245,6,-1,0,39,33,0,322
Afghanistan,18/11/2010,165,4,-1,0,38,21,0,227
Afghanistan,19/11/2010,-1,0,1,0,-6,0,0,-6
Afghanistan,20/11/2010,488,4,-7,0,27,35,0,547
Afghanistan,21/11/2010,289,0,0,0,-4,12,0,297
Afghanistan,22/11/2010,301,0,2,0,2,27,0,332
Afghanistan,23/11/2010,238,0,2,0,79,14,0,333
Afghanistan,24/11/2010,178,0,0,0,78,8,0,264
Afghanistan,25/11/2010,124,2,0,0,17,19,0,162
Afghanistan,26/11/2010,120,4,2,0,39,17,0,182
Afghanistan,27/11/2010,119,0,0,0,45,17,0,181
Afghanistan,28/11/2010,114,2,1,0,5,20,0,142
Afghanistan,29/11/2010,332,0,2,0,80,31,0,445
Afghanistan,30/11/2010,376,0,1,0,58,36,0,471
Albania,01/11/2010,3,0,0,0,0,1,0,4
Albania,02/11/2010,4,0,-9,0,0,0,0,-5
Albania,03/11/2010,7,0,0,0,0,0,0,7
Albania,04/11/2010,3,0,0,0,0,0,0,3
Albania,05/11/2010,-3,0,0,0,0,0,0,-3
Albania,06/11/2010,0,0,0,0,3,0,0,3
Albania,07/11/2010,2,0,0,0,-2,0,0,0
Albania,08/11/2010,0,0,0,0,-4,0,0,-4
Albania,09/11/2010,10,0,0,0,-6,2,0,6
Albania,10/11/2010,21,0,0,0,11,1,0,33
Albania,11/11/2010,11,0,1,0,-4,2,0,10
Albania,12/11/2010,18,0,0,0,21,0,0,39
Albania,13/11/2010,10,0,0,0,9,0,0,19
Albania,14/11/2010,3,0,0,0,0,6,0,9
Albania,15/11/2010,1,0,-1,0,9,3,0,12
Albania,16/11/2010,2,0,0,0,0,1,0,3
Albania,17/11/2010,0,0,0,0,6,0,0,6
Albania,18/11/2010,3,0,0,0,0,0,0,3
Albania,19/11/2010,0,0,-4,0,0,0,0,-4
Albania,20/11/2010,2,0,0,0,0,0,0,2
Albania,21/11/2010,1,0,0,0,0,0,0,1
Albania,22/11/2010,0,0,0,0,0,0,0,0
Albania,23/11/2010,0,0,0,0,0,0,0,0
Albania,24/11/2010,10,0,0,0,6,0,0,16
Albania,25/11/2010,0,0,0,0,0,0,0,0
Albania,26/11/2010,3,0,0,0,0,0,0,3
Albania,27/11/2010,0,0,0,0,-2,0,0,-2
Albania,28/11/2010,4,0,0,0,3,0,0,7
Albania,29/11/2010,6,0,0,0,2,0,0,8
Albania,30/11/2010,0,0,0,0,3,0,0,3
Algeria,01/11/2010,6,0,0,0,3,4,0,13
Algeria,02/11/2010,5,0,0,0,18,1,0,24
Algeria,03/11/2010,7,0,0,0,-1,1,0,7
Algeria,04/11/2010,4,0,0,0,0,0,0,4
Algeria,05/11/2010,6,0,0,0,18,1,0,25
Algeria,06/11/2010,6,0,0,0,0,0,0,6
Algeria,07/11/2010,0,0,0,0,3,0,0,3
Algeria,08/11/2010,32,0,-2,0,6,4,0,40
Algeria,09/11/2010,23,0,0,0,12,0,0,35
Algeria,10/11/2010,11,0,0,0,12,0,0,23
Algeria,11/11/2010,17,0,0,0,-2,2,0,17
Algeria,12/11/2010,3,0,0,0,0,0,0,3
Algeria,13/11/2010,0,0,0,0,0,0,0,0
Algeria,14/11/2010,3,0,0,0,0,4,0,7
Algeria,15/11/2010,1,0,0,0,0,0,0,1
Algeria,16/11/2010,1,0,0,0,0,0,0,1
Algeria,17/11/2010,2,0,0,0,30,2,0,34
Algeria,18/11/2010,7,0,0,0,0,7,0,14
Algeria,19/11/2010,8,0,0,0,0,0,0,8
Algeria,20/11/2010,6,0,0,0,0,0,0,6
Algeria,21/11/2010,1,0,0,0,0,0,0,1
Algeria,22/11/2010,-1,0,0,0,6,0,0,5
Algeria,23/11/2010,17,0,0,0,6,0,0,23
Algeria,24/11/2010,11,0,0,0,0,0,0,11
Algeria,25/11/2010,-1,0,0,0,9,0,0,8
Algeria,26/11/2010,11,0,0,0,7,4,0,22
Algeria,27/11/2010,10,0,0,0,15,0,0,25
Algeria,28/11/2010,6,0,0,0,0,0,0,6
Algeria,29/11/2010,18,0,0,0,-2,0,0,16
Algeria,30/11/2010,0,0,0,0,6,0,0,6
Bangladesh,01/11/2010,7,0,0,0,9,0,0,16
Bangladesh,02/11/2010,26,2,0,0,6,1,0,35
Bangladesh,03/11/2010,22,2,0,0,-1,6,0,29
Bangladesh,04/11/2010,13,2,0,0,-16,6,0,5
Bangladesh,05/11/2010,10,0,0,0,13,5,0,28
Bangladesh,06/11/2010,2,0,0,0,-2,0,0,0
Bangladesh,07/11/2010,12,0,0,0,3,12,0,27
Bangladesh,08/11/2010,18,0,0,0,10,3,0,31
Bangladesh,09/11/2010,-31,0,0,0,22,2,0,-7
Bangladesh,10/11/2010,10,0,0,0,3,7,0,20
Bangladesh,11/11/2010,15,0,-2,0,6,1,0,20
Bangladesh,12/11/2010,4,0,0,0,0,1,0,5
Bangladesh,13/11/2010,6,0,0,0,6,0,0,12
Bangladesh,14/11/2010,4,0,0,0,5,9,0,18
Bangladesh,15/11/2010,19,0,0,0,16,0,0,35
Bangladesh,16/11/2010,34,0,0,0,0,1,0,35
Bangladesh,17/11/2010,5,0,0,0,0,0,0,5
Bangladesh,18/11/2010,11,0,2,0,2,6,0,21
Bangladesh,19/11/2010,4,0,0,0,0,4,0,8
Bangladesh,20/11/2010,17,0,-6,0,-6,4,0,9
Bangladesh,21/11/2010,10,2,0,0,3,0,0,15
Bangladesh,22/11/2010,8,0,1,0,9,0,0,18
Bangladesh,23/11/2010,8,0,-8,0,5,2,0,7
Bangladesh,24/11/2010,8,0,-8,0,6,2,0,8
Bangladesh,25/11/2010,8,0,-1,0,17,1,0,25
Bangladesh,26/11/2010,25,0,0,0,25,4,0,54
Bangladesh,27/11/2010,4,0,2,0,16,7,0,29
Bangladesh,28/11/2010,20,0,-4,0,7,5,0,28
Bangladesh,29/11/2010,16,0,1,0,7,0,0,24
Bangladesh,30/11/2010,14,2,0,0,11,5,0,32
Cameroon,01/11/2010,0,0,0,0,0,0,0,0
Cameroon,02/11/2010,11,0,0,0,0,0,0,11
Cameroon,03/11/2010,3,0,0,0,-2,0,0,1
Cameroon,04/11/2010,8,0,0,0,6,1,0,15
Cameroon,05/11/2010,5,0,0,0,3,1,0,9
Cameroon,06/11/2010,0,0,0,0,0,0,0,0
Cameroon,07/11/2010,0,0,0,0,0,0,0,0
Cameroon,08/11/2010,5,0,0,0,1,1,0,7
Cameroon,09/11/2010,3,0,0,0,0,0,0,3
Cameroon,10/11/2010,-2,0,0,0,0,0,0,-2
Cameroon,11/11/2010,3,0,0,0,9,1,0,13
Cameroon,13/11/2010,0,0,0,0,0,1,0,1
Cameroon,15/11/2010,-4,0,0,0,12,0,0,8
Cameroon,16/11/2010,0,0,0,0,0,0,0,0
Cameroon,17/11/2010,36,0,0,0,-1,1,0,36
Cameroon,18/11/2010,16,0,0,0,3,0,0,19
Cameroon,20/11/2010,0,0,0,0,9,0,0,9
Cameroon,21/11/2010,2,0,0,0,0,0,0,2
Cameroon,22/11/2010,1,0,0,0,0,0,0,1
Cameroon,23/11/2010,0,0,0,0,6,2,0,8
Cameroon,24/11/2010,-3,0,0,0,-2,0,0,-5
Cameroon,25/11/2010,4,0,0,0,9,0,0,13
Cameroon,26/11/2010,1,0,0,0,26,0,0,27
Cameroon,27/11/2010,2,0,0,0,0,0,0,2
Cameroon,28/11/2010,0,0,0,0,0,0,0,0
Cameroon,29/11/2010,0,0,0,0,1,0,0,1
Cameroon,30/11/2010,0,0,0,0,0,0,0,0
China,01/11/2010,125,4,1,0,57,20,0,207
China,02/11/2010,132,0,-5,0,58,20,0,205
China,03/11/2010,158,4,-3,0,50,14,0,223
China,04/11/2010,131,0,0,0,5,25,0,161
China,05/11/2010,125,6,-8,0,56,8,0,187
China,06/11/2010,69,2,-3,0,-17,9,0,60
China,07/11/2010,92,4,0,0,56,11,0,163
China,08/11/2010,241,0,-5,0,100,16,0,352
China,09/11/2010,231,2,2,0,35,20,0,290
China,10/11/2010,236,2,-4,0,35,22,0,291
China,11/11/2010,131,4,-15,0,35,23,0,178
China,12/11/2010,34,4,-1,0,49,3,0,89
China,13/11/2010,85,0,-1,0,-21,12,0,75
China,14/11/2010,100,0,-3,0,-17,8,0,88
China,15/11/2010,130,4,-7,0,62,18,0,207
China,16/11/2010,99,2,-23,0,59,9,0,146
China,17/11/2010,149,0,-24,0,22,25,0,172
China,18/11/2010,139,4,-7,0,66,17,0,219
China,19/11/2010,5,0,-2,0,8,2,0,13
China,20/11/2010,80,0,-4,0,44,11,0,131
China,21/11/2010,131,4,-1,0,32,4,0,170
China,22/11/2010,153,6,-12,0,24,12,0,183
China,23/11/2010,219,0,-5,0,13,14,0,241
China,24/11/2010,247,4,-1,0,-7,11,0,254
China,25/11/2010,176,2,-32,0,40,10,0,196
China,26/11/2010,200,0,-3,0,46,9,0,252
China,27/11/2010,122,6,-6,0,19,10,0,151
China,28/11/2010,192,8,-3,0,11,8,0,216
China,29/11/2010,259,0,-7,0,22,21,0,295
China,30/11/2010,177,2,-6,0,28,22,0,223
Egypt,01/11/2010,152,0,0,0,79,14,0,245
Egypt,02/11/2010,89,0,0,0,66,18,0,173
Egypt,03/11/2010,54,0,0,0,58,10,0,122
Egypt,04/11/2010,57,0,0,0,17,7,0,81
Egypt,05/11/2010,60,0,0,0,23,2,0,85
Egypt,06/11/2010,27,0,0,0,10,1,0,38
Egypt,07/11/2010,6,0,0,0,0,1,0,7
Egypt,08/11/2010,-2,0,0,0,20,15,0,33
Egypt,09/11/2010,38,0,-1,0,43,17,0,97
Egypt,10/11/2010,56,0,0,0,21,4,0,81
Egypt,11/11/2010,59,0,-1,0,16,8,0,82
Egypt,12/11/2010,16,0,0,0,24,0,0,40
Egypt,13/11/2010,-1,0,0,0,24,0,0,23
Egypt,14/11/2010,49,0,2,0,27,4,0,82
Egypt,15/11/2010,43,0,1,0,41,1,0,86
Egypt,16/11/2010,29,0,3,0,34,6,0,72
Egypt,17/11/2010,8,0,2,0,20,8,0,38
Egypt,18/11/2010,31,0,1,0,19,1,0,52
Egypt,19/11/2010,20,0,0,0,6,2,0,28
Egypt,20/11/2010,27,0,-4,0,16,0,0,39
Egypt,21/11/2010,70,4,0,0,57,4,0,135
Egypt,22/11/2010,37,0,1,0,16,2,0,56
Egypt,23/11/2010,34,0,0,0,24,5,0,63
Egypt,24/11/2010,52,0,2,0,12,13,0,79
Egypt,25/11/2010,62,0,-4,0,45,6,0,109
Egypt,26/11/2010,57,0,0,0,63,11,0,131
Egypt,27/11/2010,34,0,0,0,47,4,0,85
Egypt,28/11/2010,109,0,1,0,37,15,0,162
Egypt,29/11/2010,72,0,2,0,16,11,0,101
Egypt,30/11/2010,82,0,6,0,37,12,0,137
Eritrea,01/11/2010,0,0,0,0,0,0,0,0
Eritrea,03/11/2010,1,0,0,0,-4,0,0,-3
Eritrea,04/11/2010,0,0,0,0,0,0,0,0
Eritrea,05/11/2010,0,0,0,0,0,4,0,4
Eritrea,06/11/2010,2,0,0,0,0,0,0,2
Eritrea,07/11/2010,0,0,0,0,3,0,0,3
Eritrea,08/11/2010,5,0,0,0,3,0,0,8
Eritrea,09/11/2010,2,0,0,0,0,0,0,2
Eritrea,10/11/2010,0,0,0,0,0,0,0,0
Eritrea,11/11/2010,0,0,0,0,0,0,0,0
Eritrea,12/11/2010,4,0,0,0,3,0,0,7
Eritrea,13/11/2010,0,0,0,0,3,0,0,3
Eritrea,14/11/2010,0,0,0,0,-2,0,0,-2
Eritrea,15/11/2010,3,0,0,0,0,0,0,3
Eritrea,16/11/2010,0,0,0,0,0,0,0,0
Eritrea,17/11/2010,2,0,0,0,0,0,0,2
Eritrea,18/11/2010,1,0,0,0,0,0,0,1
Eritrea,20/11/2010,0,0,0,0,0,0,0,0
Eritrea,21/11/2010,-3,0,0,0,0,0,0,-3
Eritrea,22/11/2010,2,0,0,0,0,4,0,6
Eritrea,23/11/2010,3,0,0,0,0,0,0,3
Eritrea,24/11/2010,0,0,0,0,-2,0,0,-2
Eritrea,25/11/2010,3,0,0,0,6,2,0,11
Eritrea,26/11/2010,10,0,0,0,4,0,0,14
Eritrea,28/11/2010,0,0,0,0,0,0,0,0
Eritrea,29/11/2010,0,0,0,0,0,0,0,0
Eritrea,30/11/2010,0,0,0,0,0,0,0,0
Georgia,01/11/2010,74,0,0,0,22,12,0,108
Georgia,02/11/2010,50,0,0,0,13,23,0,86
Georgia,03/11/2010,30,0,0,0,7,4,0,41
Georgia,04/11/2010,52,0,0,0,34,8,0,94
Georgia,05/11/2010,57,0,0,0,27,6,0,90
Georgia,06/11/2010,19,0,1,0,17,3,0,40
Georgia,07/11/2010,2,0,0,0,18,1,0,21
Georgia,08/11/2010,39,2,0,0,32,6,0,79
Georgia,09/11/2010,32,0,-2,0,17,2,0,49
Georgia,10/11/2010,35,0,0,0,23,2,0,60
Georgia,11/11/2010,41,0,-2,0,17,4,0,60
Georgia,12/11/2010,22,0,-1,0,-2,2,0,21
Georgia,13/11/2010,2,0,1,0,0,1,0,4
Georgia,14/11/2010,19,0,1,0,5,0,0,25
Georgia,15/11/2010,65,0,-2,0,20,4,0,87
Georgia,16/11/2010,9,0,0,0,20,0,0,29
Georgia,17/11/2010,46,0,-4,0,33,6,0,81
Georgia,18/11/2010,21,2,0,0,34,4,0,61
Georgia,19/11/2010,0,0,0,0,0,0,0,0
Georgia,20/11/2010,29,4,0,0,7,9,0,49
Georgia,21/11/2010,18,0,1,0,4,0,0,23
Georgia,22/11/2010,43,4,0,0,40,14,0,101
Georgia,23/11/2010,24,0,-2,0,30,6,0,58
Georgia,24/11/2010,7,0,0,0,22,4,0,33
Georgia,25/11/2010,33,0,0,0,-2,2,0,33
Georgia,26/11/2010,36,0,0,0,-5,0,0,31
Georgia,27/11/2010,14,0,-2,0,8,2,0,22
Georgia,28/11/2010,30,0,0,0,12,8,0,50
Georgia,29/11/2010,60,2,0,0,15,1,0,78
Georgia,30/11/2010,29,2,3,0,41,10,0,85
India,01/11/2010,71,0,1,0,7,10,0,89
India,02/11/2010,38,0,-2,0,-1,15,0,50
India,03/11/2010,57,4,-3,0,-4,7,0,61
India,04/11/2010,65,2,-3,0,11,10,0,85
India,05/11/2010,62,0,-11,0,16,16,0,83
India,06/11/2010,47,2,-6,0,14,9,0,66
India,07/11/2010,83,0,2,0,22,14,0,121
India,08/11/2010,106,6,-3,0,25,12,0,146
India,09/11/2010,81,0,0,0,-18,4,0,67
India,10/11/2010,146,0,1,0,2,22,0,171
India,11/11/2010,35,0,-2,0,5,5,0,43
India,12/11/2010,55,2,-4,0,-3,4,0,54
India,13/11/2010,54,0,-2,0,-3,2,0,51
India,14/11/2010,31,4,1,0,-14,8,0,30
India,15/11/2010,73,0,-33,0,23,6,0,69
India,16/11/2010,68,0,-1,0,44,3,0,114
India,17/11/2010,43,4,-6,0,1,20,0,62
India,18/11/2010,40,0,-12,0,9,2,0,39
India,19/11/2010,15,0,-6,0,9,0,0,18
India,20/11/2010,29,2,-2,0,34,3,0,66
India,21/11/2010,59,2,-1,0,15,8,0,83
India,22/11/2010,61,0,-6,0,2,8,0,65
India,23/11/2010,70,0,-10,0,9,8,0,77
India,24/11/2010,55,0,-7,0,-5,8,0,51
India,25/11/2010,58,2,-9,0,3,18,0,72
India,26/11/2010,40,0,-1,0,22,3,0,64
India,27/11/2010,43,0,1,0,22,7,0,73
India,28/11/2010,56,2,0,0,-5,0,0,53
India,29/11/2010,76,2,-6,0,9,15,0,96
India,30/11/2010,77,4,0,0,16,6,0,103
Iran,01/11/2010,42,0,0,0,71,2,0,115
Iran,02/11/2010,54,2,1,0,53,1,0,111
Iran,03/11/2010,94,0,-3,0,82,86,0,259
Iran,04/11/2010,63,2,0,0,96,13,0,174
Iran,05/11/2010,50,0,0,0,19,6,0,75
Iran,06/11/2010,61,0,0,0,10,3,0,74
Iran,07/11/2010,78,0,0,0,10,6,0,94
Iran,08/11/2010,150,0,-1,0,58,114,0,321
Iran,09/11/2010,99,2,-8,0,40,25,0,158
Iran,10/11/2010,97,0,-3,0,69,9,0,172
Iran,11/11/2010,82,0,-9,0,32,13,0,118
Iran,12/11/2010,40,0,2,0,1,12,0,55
Iran,13/11/2010,36,0,0,0,4,7,0,47
Iran,14/11/2010,46,0,-1,0,35,3,0,83
Iran,15/11/2010,36,0,0,0,43,10,0,89
Iran,16/11/2010,84,0,3,0,32,8,0,127
Iran,17/11/2010,58,0,-2,0,32,16,0,104
Iran,18/11/2010,109,2,0,0,20,10,0,141
Iran,19/11/2010,20,0,0,0,4,4,0,28
Iran,20/11/2010,88,0,0,0,23,1,0,112
Iran,21/11/2010,84,0,0,0,20,8,0,112
Iran,22/11/2010,89,2,1,0,90,3,0,185
Iran,23/11/2010,67,0,0,0,56,2,0,125
Iran,24/11/2010,81,0,0,0,35,6,0,122
Iran,25/11/2010,50,0,0,0,44,17,0,111
Iran,26/11/2010,96,0,0,0,4,1,0,101
Iran,27/11/2010,63,2,-1,0,32,2,0,98
Iran,28/11/2010,68,0,0,0,37,30,0,135
Iran,29/11/2010,287,2,6,0,147,35,0,477
Iran,30/11/2010,175,0,7,0,108,33,0,323
Iraq,01/11/2010,176,0,0,0,39,17,0,232
Iraq,02/11/2010,194,0,0,0,103,29,0,326
Iraq,03/11/2010,162,2,0,0,94,11,0,269
Iraq,04/11/2010,202,6,-1,0,55,11,0,273
Iraq,05/11/2010,138,0,-1,0,42,19,0,198
Iraq,06/11/2010,93,0,2,0,10,10,0,115
Iraq,07/11/2010,40,2,0,0,27,16,0,85
Iraq,08/11/2010,120,0,1,0,23,32,0,176
Iraq,09/11/2010,131,14,1,0,46,18,0,210
Iraq,10/11/2010,156,14,-7,0,50,5,0,218
Iraq,11/11/2010,208,4,-5,0,62,11,0,280
Iraq,12/11/2010,81,0,1,0,21,7,0,110
Iraq,13/11/2010,10,0,0,0,52,2,0,64
Iraq,14/11/2010,161,2,0,0,45,7,0,215
Iraq,15/11/2010,145,0,0,0,29,10,0,184
Iraq,16/11/2010,118,0,1,0,13,20,0,152
Iraq,17/11/2010,229,0,1,0,108,23,0,361
Iraq,18/11/2010,175,0,0,0,113,38,0,326
Iraq,19/11/2010,4,0,0,0,-2,2,0,4
Iraq,20/11/2010,88,2,1,0,47,5,0,143
Iraq,21/11/2010,119,0,1,0,70,20,0,210
Iraq,22/11/2010,82,0,0,0,67,8,0,157
Iraq,23/11/2010,79,0,0,0,21,6,0,106
Iraq,24/11/2010,115,0,-4,0,30,8,0,149
Iraq,25/11/2010,116,0,0,0,1,24,0,141
Iraq,26/11/2010,119,2,1,0,10,10,0,142
Iraq,27/11/2010,69,0,0,0,19,5,0,93
Iraq,28/11/2010,85,0,0,0,47,12,0,144
Iraq,29/11/2010,214,0,2,0,155,13,0,384
Iraq,30/11/2010,168,0,4,0,109,3,0,284
Morocco,01/11/2010,12,0,0,0,-6,0,0,6
Morocco,02/11/2010,30,0,0,0,1,9,0,40
Morocco,03/11/2010,13,0,-1,0,6,2,0,20
Morocco,04/11/2010,5,0,0,0,13,1,0,19
Morocco,05/11/2010,10,0,0,0,1,0,0,11
Morocco,06/11/2010,0,0,0,0,-4,0,0,-4
Morocco,07/11/2010,9,0,0,0,1,1,0,11
Morocco,08/11/2010,131,0,-4,0,45,24,0,196
Morocco,09/11/2010,137,0,-2,0,32,18,0,185
Morocco,10/11/2010,179,0,-2,0,44,13,0,234
Morocco,11/11/2010,24,0,0,0,17,0,0,41
Morocco,12/11/2010,14,0,0,0,20,1,0,35
Morocco,13/11/2010,14,0,0,0,0,6,0,20
Morocco,14/11/2010,34,0,-2,0,15,9,0,56
Morocco,15/11/2010,45,0,0,0,-2,5,0,48
Morocco,16/11/2010,28,2,0,0,3,4,0,37
Morocco,17/11/2010,35,0,0,0,38,9,0,82
Morocco,18/11/2010,8,0,0,0,15,4,0,27
Morocco,19/11/2010,9,0,0,0,3,0,0,12
Morocco,20/11/2010,32,0,0,0,28,0,0,60
Morocco,21/11/2010,24,0,-2,0,-4,2,0,20
Morocco,22/11/2010,5,0,0,0,6,2,0,13
Morocco,23/11/2010,1,0,0,0,24,0,0,25
Morocco,24/11/2010,25,0,0,0,8,4,0,37
Morocco,25/11/2010,12,0,0,0,9,0,0,21
Morocco,26/11/2010,33,0,0,0,17,2,0,52
Morocco,27/11/2010,20,0,0,0,9,1,0,30
Morocco,28/11/2010,12,0,0,0,2,2,0,16
Morocco,29/11/2010,21,0,0,0,0,2,0,23
Morocco,30/11/2010,0,0,0,0,0,2,0,2
Nigeria,01/11/2010,40,0,-3,0,46,1,0,84
Nigeria,02/11/2010,31,0,1,0,39,6,0,77
Nigeria,03/11/2010,30,0,-1,0,13,10,0,52
Nigeria,04/11/2010,30,0,1,0,12,2,0,45
Nigeria,05/11/2010,10,0,0,0,19,3,0,32
Nigeria,06/11/2010,15,0,0,0,0,2,0,17
Nigeria,07/11/2010,9,2,0,0,6,2,0,19
Nigeria,08/11/2010,29,2,-2,0,58,5,0,92
Nigeria,09/11/2010,35,0,0,0,17,3,0,55
Nigeria,10/11/2010,51,0,-2,0,-5,-2,0,42
Nigeria,11/11/2010,26,0,0,0,17,2,0,45
Nigeria,12/11/2010,30,0,0,0,-10,0,0,20
Nigeria,13/11/2010,6,0,-2,0,3,0,0,7
Nigeria,14/11/2010,15,0,0,0,1,1,0,17
Nigeria,15/11/2010,26,0,0,0,-5,2,0,23
Nigeria,16/11/2010,29,0,0,0,12,10,0,51
Nigeria,17/11/2010,72,0,-3,0,24,2,0,95
Nigeria,18/11/2010,27,0,-4,0,-7,5,0,21
Nigeria,19/11/2010,-1,0,0,0,0,0,0,-1
Nigeria,20/11/2010,15,0,0,0,-2,5,0,18
Nigeria,21/11/2010,23,0,0,0,12,12,0,47
Nigeria,22/11/2010,39,2,-2,0,18,13,0,70
Nigeria,23/11/2010,31,0,0,0,28,5,0,64
Nigeria,24/11/2010,44,0,0,0,10,7,0,61
Nigeria,25/11/2010,11,0,0,0,3,4,0,18
Nigeria,26/11/2010,13,0,0,0,21,2,0,36
Nigeria,27/11/2010,25,0,0,0,21,1,0,47
Nigeria,28/11/2010,4,0,0,0,7,0,0,11
Nigeria,29/11/2010,16,2,0,0,8,5,0,31
Nigeria,30/11/2010,29,0,0,0,0,0,0,29
Pakistan,01/11/2010,123,4,-2,0,23,19,0,167
Pakistan,02/11/2010,67,0,1,0,15,12,0,95
Pakistan,03/11/2010,70,0,2,0,23,6,0,101
Pakistan,04/11/2010,122,0,-4,0,91,8,0,217
Pakistan,05/11/2010,110,0,0,0,29,60,0,199
Pakistan,06/11/2010,103,2,-4,0,22,28,0,151
Pakistan,07/11/2010,135,0,0,0,6,14,0,155
Pakistan,08/11/2010,171,4,14,0,31,28,0,248
Pakistan,09/11/2010,132,2,-3,0,46,7,0,184
Pakistan,10/11/2010,142,2,0,0,64,4,0,212
Pakistan,11/11/2010,88,2,-2,0,47,0,0,135
Pakistan,12/11/2010,51,0,-1,0,-5,1,0,46
Pakistan,13/11/2010,83,0,0,0,33,10,0,126
Pakistan,14/11/2010,41,2,0,0,1,11,0,55
Pakistan,15/11/2010,75,0,-1,0,75,25,0,174
Pakistan,16/11/2010,90,0,0,0,48,11,0,149
Pakistan,17/11/2010,108,0,-8,0,127,6,0,233
Pakistan,18/11/2010,63,4,0,0,64,3,0,134
Pakistan,19/11/2010,14,0,0,0,6,0,0,20
Pakistan,20/11/2010,99,0,1,0,68,18,0,186
Pakistan,21/11/2010,81,2,0,0,5,8,0,96
Pakistan,22/11/2010,96,2,0,0,44,10,0,152
Pakistan,23/11/2010,106,0,0,0,55,13,0,174
Pakistan,24/11/2010,99,0,2,0,29,4,0,134
Pakistan,25/11/2010,94,2,1,0,15,7,0,119
Pakistan,26/11/2010,101,6,0,0,50,14,0,171
Pakistan,27/11/2010,89,2,0,0,53,33,0,177
Pakistan,28/11/2010,81,0,0,0,20,23,0,124
Pakistan,29/11/2010,75,2,0,0,33,21,0,131
Pakistan,30/11/2010,109,0,-1,0,61,15,0,184
Sierra Leone,01/11/2010,1,0,0,0,15,0,0,16
Sierra Leone,02/11/2010,15,0,0,0,9,0,0,24
Sierra Leone,03/11/2010,6,0,-2,0,0,0,0,4
Sierra Leone,04/11/2010,9,0,0,0,-1,0,0,8
Sierra Leone,05/11/2010,7,0,0,0,0,0,0,7
Sierra Leone,06/11/2010,0,0,0,0,-2,0,0,-2
Sierra Leone,07/11/2010,0,0,0,0,-4,0,0,-4
Sierra Leone,08/11/2010,4,0,0,0,0,0,0,4
Sierra Leone,09/11/2010,8,0,0,0,9,1,0,18
Sierra Leone,10/11/2010,-2,0,0,0,0,0,0,-2
Sierra Leone,11/11/2010,0,0,0,0,3,0,0,3
Sierra Leone,12/11/2010,1,0,0,0,3,0,0,4
Sierra Leone,13/11/2010,4,0,0,0,0,0,0,4
Sierra Leone,14/11/2010,0,0,0,0,0,0,0,0
Sierra Leone,15/11/2010,3,0,0,0,9,0,0,12
Sierra Leone,16/11/2010,3,0,0,0,9,0,0,12
Sierra Leone,17/11/2010,15,0,-2,0,9,1,0,23
Sierra Leone,18/11/2010,13,0,0,0,0,0,0,13
Sierra Leone,20/11/2010,3,0,0,0,-8,0,0,-5
Sierra Leone,21/11/2010,6,0,0,0,12,0,0,18
Sierra Leone,22/11/2010,2,0,0,0,3,0,0,5
Sierra Leone,23/11/2010,6,0,0,0,0,1,0,7
Sierra Leone,24/11/2010,0,0,0,0,0,1,0,1
Sierra Leone,25/11/2010,1,0,0,0,-2,0,0,-1
Sierra Leone,26/11/2010,3,0,0,0,4,0,0,7
Sierra Leone,27/11/2010,0,0,0,0,0,0,0,0
Sierra Leone,28/11/2010,1,0,0,0,0,0,0,1
Sierra Leone,29/11/2010,4,0,0,0,0,1,0,5
Sierra Leone,30/11/2010,0,0,0,0,3,1,0,4
Somalia,01/11/2010,21,0,0,0,54,6,0,81
Somalia,02/11/2010,70,0,-2,0,35,7,0,110
Somalia,03/11/2010,57,0,0,0,44,10,0,111
Somalia,04/11/2010,12,0,0,0,46,2,0,60
Somalia,05/11/2010,35,6,0,0,66,3,0,110
Somalia,06/11/2010,25,0,0,0,-21,5,0,9
Somalia,07/11/2010,52,0,0,0,-16,7,0,43
Somalia,08/11/2010,45,2,0,0,97,14,0,158
Somalia,09/11/2010,65,0,-2,0,158,6,0,227
Somalia,10/11/2010,38,0,0,0,91,3,0,132
Somalia,11/11/2010,78,0,0,0,14,9,0,101
Somalia,12/11/2010,68,0,0,0,9,2,0,79
Somalia,13/11/2010,38,2,0,0,16,0,0,56
Somalia,14/11/2010,75,0,0,0,-27,1,0,49
Somalia,15/11/2010,45,4,1,0,-2,2,0,50
Somalia,16/11/2010,24,0,-4,0,17,1,0,38
Somalia,17/11/2010,22,0,0,0,21,8,0,51
Somalia,18/11/2010,29,0,0,0,25,8,0,62
Somalia,19/11/2010,6,0,0,0,0,0,0,6
Somalia,20/11/2010,14,0,0,0,16,0,0,30
Somalia,21/11/2010,20,0,0,0,35,4,0,59
Somalia,22/11/2010,47,0,0,0,104,16,0,167
Somalia,23/11/2010,31,0,0,0,69,9,0,109
Somalia,24/11/2010,71,0,0,0,134,7,0,212
Somalia,25/11/2010,60,0,0,0,60,10,0,130
Somalia,26/11/2010,32,0,0,0,64,6,0,102
Somalia,27/11/2010,93,0,-6,0,84,30,0,201
Somalia,28/11/2010,92,0,0,0,54,35,0,181
Somalia,29/11/2010,114,2,0,0,105,38,0,259
Somalia,30/11/2010,61,2,0,0,43,13,0,119
Syria,01/11/2010,46,0,0,0,15,2,0,63
Syria,02/11/2010,32,0,1,0,12,0,0,45
Syria,03/11/2010,22,0,0,0,7,3,0,32
Syria,04/11/2010,25,0,0,0,28,4,0,57
Syria,05/11/2010,14,2,0,0,14,13,0,43
Syria,06/11/2010,50,0,1,0,25,6,0,82
Syria,07/11/2010,16,0,3,0,7,5,0,31
Syria,08/11/2010,35,0,0,0,10,7,0,52
Syria,09/11/2010,72,0,0,0,22,11,0,105
Syria,10/11/2010,40,0,0,0,45,3,0,88
Syria,11/11/2010,66,0,0,0,18,10,0,94
Syria,12/11/2010,51,0,0,0,57,0,0,108
Syria,13/11/2010,21,0,0,0,15,0,0,36
Syria,14/11/2010,57,0,0,0,43,0,0,100
Syria,15/11/2010,63,0,0,0,79,2,0,144
Syria,16/11/2010,52,0,0,0,61,3,0,116
Syria,17/11/2010,26,0,0,0,3,5,0,34
Syria,18/11/2010,29,0,0,0,20,0,0,49
Syria,19/11/2010,10,0,0,0,9,0,0,19
Syria,20/11/2010,16,0,0,0,12,0,0,28
Syria,21/11/2010,7,0,0,0,24,0,0,31
Syria,22/11/2010,44,0,1,0,15,2,0,62
Syria,23/11/2010,11,0,0,0,0,2,0,13
Syria,24/11/2010,29,0,0,0,47,0,0,76
Syria,25/11/2010,15,0,0,0,3,0,0,18
Syria,26/11/2010,15,6,0,0,15,0,0,36
Syria,27/11/2010,6,0,-2,0,7,5,0,16
Syria,28/11/2010,36,0,-1,0,6,0,0,41
Syria,29/11/2010,39,0,0,0,14,1,0,54
Syria,30/11/2010,15,0,0,0,7,2,0,24
Yemen,01/11/2010,208,0,0,0,171,34,0,413
Yemen,02/11/2010,180,0,0,0,306,27,0,513
Yemen,03/11/2010,137,2,0,0,89,10,0,238
Yemen,04/11/2010,140,10,-1,0,46,19,0,214
Yemen,05/11/2010,82,4,0,0,70,5,0,161
Yemen,06/11/2010,102,0,0,0,62,13,0,177
Yemen,07/11/2010,69,0,0,0,39,4,0,112
Yemen,08/11/2010,187,0,1,0,60,32,0,280
Yemen,09/11/2010,128,6,0,0,137,2,0,273
Yemen,10/11/2010,67,2,0,0,62,6,0,137
Yemen,11/11/2010,74,0,-1,0,46,4,0,123
Yemen,12/11/2010,7,0,0,0,6,0,0,13
Yemen,13/11/2010,24,0,0,0,20,0,0,44
Yemen,14/11/2010,22,0,0,0,19,2,0,43
Yemen,15/11/2010,22,0,0,0,8,2,0,32
Yemen,16/11/2010,14,0,0,0,7,1,0,22
Yemen,17/11/2010,30,0,0,0,4,0,0,34
Yemen,18/11/2010,26,0,0,0,-5,4,0,25
Yemen,19/11/2010,0,0,0,0,0,0,0,0
Yemen,20/11/2010,6,0,0,0,12,2,0,20
Yemen,21/11/2010,50,0,0,0,-2,0,0,48
Yemen,22/11/2010,36,0,0,0,0,6,0,42
Yemen,23/11/2010,22,0,0,0,3,8,0,33
Yemen,24/11/2010,43,0,0,0,9,23,0,75
Yemen,25/11/2010,34,0,0,0,3,9,0,46
Yemen,26/11/2010,58,0,0,0,120,3,0,181
Yemen,27/11/2010,20,0,0,0,41,6,0,67
Yemen,28/11/2010,38,0,0,0,13,25,0,76
Yemen,29/11/2010,55,0,0,0,29,16,0,100
Yemen,30/11/2010,39,0,0,0,-6,1,0,34
Afghanistan,01/07/2012,256,2,0,0,4,15,0,277
Afghanistan,02/07/2012,499,0,-4,0,13,26,0,534
Afghanistan,03/07/2012,398,4,-2,0,19,35,0,454
Afghanistan,04/07/2012,325,6,0,0,34,16,0,381
Afghanistan,05/07/2012,326,0,-4,0,84,16,0,422
Afghanistan,06/07/2012,223,2,5,0,57,19,0,306
Afghanistan,07/07/2012,184,0,5,0,83,18,0,290
Afghanistan,08/07/2012,215,8,-2,0,39,28,0,288
Afghanistan,09/07/2012,265,2,-2,0,41,47,0,353
Afghanistan,10/07/2012,214,2,0,0,34,30,0,280
Afghanistan,11/07/2012,164,6,-4,0,-14,23,0,175
Afghanistan,12/07/2012,130,4,-2,0,74,13,0,219
Afghanistan,13/07/2012,144,8,0,0,27,6,0,185
Afghanistan,14/07/2012,235,4,-4,0,66,106,0,407
Afghanistan,15/07/2012,105,0,0,0,18,25,0,148
Afghanistan,16/07/2012,157,2,0,0,55,14,0,228
Afghanistan,17/07/2012,190,2,0,0,61,31,0,284
Afghanistan,18/07/2012,82,0,-4,0,17,18,0,113
Afghanistan,19/07/2012,132,0,-4,0,14,19,0,161
Afghanistan,20/07/2012,112,0,-6,0,30,12,0,148
Afghanistan,21/07/2012,163,8,-1,0,42,46,0,258
Afghanistan,22/07/2012,140,2,1,0,30,32,0,205
Afghanistan,23/07/2012,201,2,2,0,21,9,0,235
Afghanistan,24/07/2012,314,4,4,0,90,17,0,429
Afghanistan,25/07/2012,233,2,4,0,110,9,0,358
Afghanistan,26/07/2012,235,0,-1,0,97,18,0,349
Afghanistan,27/07/2012,169,2,-4,0,44,6,0,217
Afghanistan,28/07/2012,191,2,-1,0,65,8,0,265
Afghanistan,29/07/2012,204,0,1,0,46,10,0,261
Afghanistan,30/07/2012,209,2,0,0,52,2,0,265
Afghanistan,31/07/2012,160,0,0,0,78,12,0,250
Albania,01/07/2012,2,0,0,0,0,0,0,2
Albania,02/07/2012,12,0,0,0,0,1,0,13
Albania,03/07/2012,4,6,0,0,-4,2,0,8
Albania,04/07/2012,5,2,0,0,6,0,0,13
Albania,05/07/2012,13,0,0,0,0,2,0,15
Albania,06/07/2012,7,0,0,0,15,1,0,23
Albania,07/07/2012,6,0,0,0,0,0,0,6
Albania,08/07/2012,2,4,0,0,0,1,0,7
Albania,09/07/2012,22,0,1,0,27,8,0,58
Albania,10/07/2012,15,0,-2,0,0,2,0,15
Albania,11/07/2012,16,0,0,0,-6,1,0,11
Albania,12/07/2012,-1,0,-6,0,0,6,0,-1
Albania,13/07/2012,7,0,-2,0,0,1,0,6
Albania,14/07/2012,0,0,0,0,0,0,0,0
Albania,16/07/2012,18,0,0,0,9,2,0,29
Albania,17/07/2012,6,0,0,0,0,0,0,6
Albania,18/07/2012,2,0,0,0,3,0,0,5
Albania,19/07/2012,1,0,0,0,0,0,0,1
Albania,20/07/2012,-1,0,0,0,0,0,0,-1
Albania,21/07/2012,0,0,0,0,0,0,0,0
Albania,22/07/2012,0,0,0,0,0,1,0,1
Albania,23/07/2012,1,0,-1,0,3,0,0,3
Albania,24/07/2012,4,0,0,0,3,0,0,7
Albania,25/07/2012,1,0,0,0,6,0,0,7
Albania,26/07/2012,5,0,0,0,0,0,0,5
Albania,27/07/2012,0,0,0,0,0,0,0,0
Albania,28/07/2012,0,0,0,0,0,0,0,0
Albania,29/07/2012,12,0,-1,0,0,0,0,11
Albania,30/07/2012,29,0,-1,0,6,4,0,38
Albania,31/07/2012,7,0,-1,0,3,0,0,9
Algeria,01/07/2012,7,0,-6,0,0,0,0,1
Algeria,02/07/2012,12,0,0,0,0,0,0,12
Algeria,03/07/2012,4,0,0,0,27,0,0,31
Algeria,04/07/2012,18,0,-2,0,18,0,0,34
Algeria,05/07/2012,56,0,0,0,12,2,0,70
Algeria,06/07/2012,21,0,0,0,4,3,0,28
Algeria,07/07/2012,12,0,0,0,1,0,0,13
Algeria,08/07/2012,1,0,0,0,0,0,0,1
Algeria,09/07/2012,7,0,1,0,0,0,0,8
Algeria,10/07/2012,10,2,0,0,0,0,0,12
Algeria,11/07/2012,13,0,1,0,-14,0,0,0
Algeria,12/07/2012,27,0,0,0,2,0,0,29
Algeria,13/07/2012,12,0,0,0,-12,1,0,1
Algeria,14/07/2012,6,0,0,0,-12,2,0,-4
Algeria,15/07/2012,5,0,0,0,0,0,0,5
Algeria,16/07/2012,13,0,0,0,-6,0,0,7
Algeria,17/07/2012,-4,0,0,0,-6,0,0,-10
Algeria,18/07/2012,4,0,0,0,0,6,0,10
Algeria,19/07/2012,-3,0,0,0,-3,0,0,-6
Algeria,20/07/2012,20,0,0,0,33,4,0,57
Algeria,21/07/2012,0,0,0,0,6,0,0,6
Algeria,22/07/2012,19,0,0,0,6,2,0,27
Algeria,23/07/2012,16,0,-16,0,7,1,0,8
Algeria,24/07/2012,7,0,0,0,0,0,0,7
Algeria,25/07/2012,14,0,0,0,0,0,0,14
Algeria,26/07/2012,15,0,0,0,0,1,0,16
Algeria,27/07/2012,1,0,0,0,1,0,0,2
Algeria,28/07/2012,3,0,0,0,0,1,0,4
Algeria,29/07/2012,0,0,0,0,-4,0,0,-4
Algeria,30/07/2012,4,0,-3,0,-2,1,0,0
Algeria,31/07/2012,14,0,0,0,9,2,0,25
Bangladesh,01/07/2012,34,2,0,0,-2,4,0,38
Bangladesh,02/07/2012,37,0,1,0,23,3,0,64
Bangladesh,03/07/2012,13,0,0,0,2,1,0,16
Bangladesh,04/07/2012,9,0,0,0,16,0,0,25
Bangladesh,05/07/2012,10,0,0,0,18,2,0,30
Bangladesh,06/07/2012,10,0,0,0,6,1,0,17
Bangladesh,07/07/2012,10,0,0,0,8,2,0,20
Bangladesh,08/07/2012,32,0,0,0,10,1,0,43
Bangladesh,09/07/2012,26,0,2,0,34,2,0,64
Bangladesh,10/07/2012,36,0,0,0,12,0,0,48
Bangladesh,11/07/2012,10,0,3,0,2,0,0,15
Bangladesh,12/07/2012,13,0,0,0,-2,1,0,12
Bangladesh,13/07/2012,15,0,-2,0,30,2,0,45
Bangladesh,14/07/2012,11,0,-2,0,14,1,0,24
Bangladesh,15/07/2012,5,0,0,0,2,4,0,11
Bangladesh,16/07/2012,28,0,-2,0,12,4,0,42
Bangladesh,17/07/2012,22,0,-12,0,4,2,0,16
Bangladesh,18/07/2012,14,0,-4,0,1,0,0,11
Bangladesh,19/07/2012,29,0,0,0,0,3,0,32
Bangladesh,20/07/2012,53,0,0,0,20,9,0,82
Bangladesh,21/07/2012,36,0,0,0,-5,7,0,38
Bangladesh,22/07/2012,3,0,1,0,12,3,0,19
Bangladesh,23/07/2012,45,0,1,0,6,11,0,63
Bangladesh,24/07/2012,52,4,-2,0,15,15,0,84
Bangladesh,25/07/2012,199,0,0,0,7,7,0,213
Bangladesh,26/07/2012,78,0,-6,0,9,3,0,84
Bangladesh,27/07/2012,76,0,-4,0,9,4,0,85
Bangladesh,28/07/2012,57,0,-4,0,15,7,0,75
Bangladesh,29/07/2012,78,0,-1,0,10,6,0,93
Bangladesh,30/07/2012,61,0,1,0,31,8,0,101
Bangladesh,31/07/2012,61,0,1,0,14,5,0,81
Cameroon,01/07/2012,0,0,0,0,-2,0,0,-2
Cameroon,02/07/2012,5,0,0,0,0,0,0,5
Cameroon,03/07/2012,4,0,0,0,0,0,0,4
Cameroon,04/07/2012,3,0,0,0,0,0,0,3
Cameroon,05/07/2012,1,0,0,0,0,0,0,1
Cameroon,06/07/2012,0,0,0,0,0,0,0,0
Cameroon,07/07/2012,3,0,0,0,0,0,0,3
Cameroon,08/07/2012,0,0,0,0,0,0,0,0
Cameroon,09/07/2012,2,0,0,0,0,0,0,2
Cameroon,10/07/2012,1,0,0,0,0,0,0,1
Cameroon,11/07/2012,2,0,0,0,9,0,0,11
Cameroon,13/07/2012,4,0,0,0,0,0,0,4
Cameroon,14/07/2012,0,0,1,0,0,0,0,1
Cameroon,15/07/2012,0,0,0,0,6,0,0,6
Cameroon,16/07/2012,12,0,0,0,12,2,0,26
Cameroon,17/07/2012,6,0,0,0,0,0,0,6
Cameroon,18/07/2012,3,0,0,0,0,0,0,3
Cameroon,19/07/2012,0,0,0,0,0,0,0,0
Cameroon,20/07/2012,2,0,0,0,-2,0,0,0
Cameroon,21/07/2012,1,6,0,0,0,0,0,7
Cameroon,23/07/2012,2,0,0,0,0,0,0,2
Cameroon,24/07/2012,7,0,0,0,4,0,0,11
Cameroon,25/07/2012,0,0,0,0,3,0,0,3
Cameroon,26/07/2012,2,0,0,0,0,0,0,2
Cameroon,27/07/2012,5,0,0,0,6,0,0,11
Cameroon,28/07/2012,0,0,0,0,0,0,0,0
Cameroon,29/07/2012,2,0,0,0,0,0,0,2
Cameroon,31/07/2012,0,0,0,0,0,0,0,0
China,01/07/2012,86,0,5,0,71,27,0,189
China,02/07/2012,162,6,2,0,43,16,0,229
China,03/07/2012,137,2,1,0,50,27,0,217
China,04/07/2012,139,2,-7,0,58,22,0,214
China,05/07/2012,259,8,1,0,77,14,0,359
China,06/07/2012,289,8,-9,0,80,19,0,387
China,07/07/2012,80,0,-6,0,21,9,0,104
China,08/07/2012,105,0,0,0,20,17,0,142
China,09/07/2012,187,0,-5,0,59,17,0,258
China,10/07/2012,166,2,-1,0,128,26,0,321
China,11/07/2012,193,2,0,0,77,14,0,286
China,12/07/2012,84,0,0,0,41,7,0,132
China,13/07/2012,233,2,-8,0,52,33,0,312
China,14/07/2012,133,0,-4,0,65,8,0,202
China,15/07/2012,175,0,-1,0,43,16,0,233
China,16/07/2012,212,2,-3,0,44,12,0,267
China,17/07/2012,251,6,1,0,79,18,0,355
China,18/07/2012,165,4,-7,0,23,7,0,192
China,19/07/2012,259,0,-7,0,83,51,0,386
China,20/07/2012,169,6,-10,0,50,9,0,224
China,21/07/2012,139,4,0,0,38,8,0,189
China,22/07/2012,94,2,-4,0,53,5,0,150
China,23/07/2012,185,0,-1,0,51,49,0,284
China,24/07/2012,191,2,3,0,8,31,0,235
China,25/07/2012,178,2,2,0,154,23,0,359
China,26/07/2012,250,8,2,0,147,40,0,447
China,27/07/2012,133,2,-12,0,78,25,0,226
China,28/07/2012,127,0,-3,0,13,10,0,147
China,29/07/2012,120,2,1,0,34,12,0,169
China,30/07/2012,189,4,0,0,110,26,0,329
China,31/07/2012,222,6,-7,0,134,24,0,379
Egypt,01/07/2012,83,2,-10,0,29,14,0,118
Egypt,02/07/2012,159,0,-11,0,50,22,0,220
Egypt,03/07/2012,143,0,-7,0,-9,10,0,137
Egypt,04/07/2012,86,0,-6,0,66,9,0,155
Egypt,05/07/2012,85,6,-22,0,41,15,0,125
Egypt,06/07/2012,92,0,-10,0,1,8,0,91
Egypt,07/07/2012,67,0,-5,0,19,22,0,103
Egypt,08/07/2012,176,0,-4,0,68,12,0,252
Egypt,09/07/2012,184,0,-9,0,51,22,0,248
Egypt,10/07/2012,157,0,17,0,75,17,0,266
Egypt,11/07/2012,149,0,-4,0,48,19,0,212
Egypt,12/07/2012,71,0,0,0,16,11,0,98
Egypt,13/07/2012,106,2,-1,0,24,16,0,147
Egypt,14/07/2012,42,0,1,0,36,23,0,102
Egypt,15/07/2012,76,0,3,0,46,17,0,142
Egypt,16/07/2012,97,0,2,0,52,16,0,167
Egypt,17/07/2012,81,0,-2,0,31,15,0,125
Egypt,18/07/2012,39,0,0,0,6,7,0,52
Egypt,19/07/2012,129,0,-13,0,22,3,0,141
Egypt,20/07/2012,91,0,-6,0,33,5,0,123
Egypt,21/07/2012,20,0,0,0,50,1,0,71
Egypt,22/07/2012,135,0,-1,0,23,10,0,167
Egypt,23/07/2012,15,0,2,0,12,2,0,31
Egypt,24/07/2012,80,2,0,0,3,1,0,86
Egypt,25/07/2012,86,0,-7,0,25,5,0,109
Egypt,26/07/2012,66,0,2,0,1,3,0,72
Egypt,27/07/2012,44,0,-6,0,18,5,0,61
Egypt,28/07/2012,55,0,-6,0,9,5,0,63
Egypt,29/07/2012,85,0,-4,0,4,17,0,102
Egypt,30/07/2012,70,0,-2,0,-6,7,0,69
Egypt,31/07/2012,65,4,-2,0,34,7,0,108
Eritrea,01/07/2012,6,0,0,0,3,0,0,9
Eritrea,02/07/2012,0,0,0,0,4,0,0,4
Eritrea,03/07/2012,6,0,0,0,0,2,0,8
Eritrea,04/07/2012,2,0,0,0,6,0,0,8
Eritrea,05/07/2012,4,0,0,0,12,0,0,16
Eritrea,06/07/2012,3,0,0,0,-1,2,0,4
Eritrea,07/07/2012,0,0,0,0,3,0,0,3
Eritrea,08/07/2012,9,0,0,0,3,0,0,12
Eritrea,09/07/2012,2,0,0,0,0,0,0,2
Eritrea,10/07/2012,2,0,0,0,6,0,0,8
Eritrea,11/07/2012,2,0,0,0,3,0,0,5
Eritrea,12/07/2012,0,0,0,0,0,2,0,2
Eritrea,13/07/2012,4,0,0,0,6,0,0,10
Eritrea,14/07/2012,9,0,0,0,0,0,0,9
Eritrea,15/07/2012,0,0,0,0,0,0,0,0
Eritrea,16/07/2012,0,0,0,0,0,0,0,0
Eritrea,17/07/2012,14,0,0,0,12,10,0,36
Eritrea,18/07/2012,15,0,0,0,0,0,0,15
Eritrea,19/07/2012,1,0,0,0,6,0,0,7
Eritrea,20/07/2012,1,0,0,0,0,1,0,2
Eritrea,21/07/2012,0,0,0,0,0,0,0,0
Eritrea,22/07/2012,0,0,0,0,0,0,0,0
Eritrea,23/07/2012,3,0,0,0,6,0,0,9
Eritrea,24/07/2012,6,0,0,0,0,0,0,6
Eritrea,25/07/2012,0,0,0,0,0,0,0,0
Eritrea,26/07/2012,14,0,0,0,0,0,0,14
Eritrea,27/07/2012,0,0,0,0,0,0,0,0
Eritrea,28/07/2012,0,0,0,0,3,0,0,3
Eritrea,29/07/2012,1,0,0,0,-2,1,0,0
Eritrea,30/07/2012,-1,0,0,0,0,2,0,1
Eritrea,31/07/2012,1,0,2,0,3,0,0,6
Georgia,02/07/2012,2,0,0,0,3,0,0,5
Georgia,03/07/2012,2,0,0,0,0,0,0,2
Georgia,04/07/2012,0,0,0,0,2,0,0,2
Georgia,05/07/2012,4,0,0,0,0,0,0,4
Georgia,07/07/2012,2,0,0,0,0,0,0,2
Georgia,08/07/2012,4,0,0,0,0,0,0,4
Georgia,09/07/2012,2,0,0,0,0,0,0,2
Georgia,10/07/2012,1,0,0,0,0,0,0,1
Georgia,11/07/2012,0,0,0,0,0,0,0,0
Georgia,12/07/2012,2,0,0,0,0,0,0,2
Georgia,13/07/2012,1,0,0,0,0,0,0,1
Georgia,14/07/2012,1,0,0,0,0,0,0,1
Georgia,15/07/2012,0,0,0,0,0,0,0,0
Georgia,16/07/2012,2,0,0,0,0,0,0,2
Georgia,17/07/2012,2,0,0,0,12,0,0,14
Georgia,18/07/2012,0,0,0,0,3,0,0,3
Georgia,19/07/2012,0,2,0,0,0,1,0,3
Georgia,20/07/2012,3,0,0,0,0,3,0,6
Georgia,21/07/2012,-1,0,0,0,0,0,0,-1
Georgia,23/07/2012,8,0,0,0,0,0,0,8
Georgia,24/07/2012,6,0,0,0,0,3,0,9
Georgia,25/07/2012,0,2,0,0,0,0,0,2
Georgia,26/07/2012,0,0,0,0,0,0,0,0
Georgia,27/07/2012,0,0,0,0,0,5,0,5
Georgia,28/07/2012,0,0,0,0,0,2,0,2
Georgia,29/07/2012,0,0,0,0,0,0,0,0
Georgia,30/07/2012,3,0,0,0,0,0,0,3
Georgia,31/07/2012,3,0,0,0,0,4,0,7
India,01/07/2012,48,0,1,0,19,19,0,87
India,02/07/2012,62,0,-4,0,7,11,0,76
India,03/07/2012,53,6,-5,0,30,7,0,91
India,04/07/2012,66,0,-2,0,12,10,0,86
India,05/07/2012,64,0,0,0,7,13,0,84
India,06/07/2012,90,0,-1,0,1,10,0,100
India,07/07/2012,44,0,-3,0,7,2,0,50
India,08/07/2012,55,0,-2,0,1,6,0,60
India,09/07/2012,85,2,-8,0,16,11,0,106
India,10/07/2012,80,2,0,0,42,8,0,132
India,11/07/2012,85,0,-2,0,12,12,0,107
India,12/07/2012,52,0,2,0,37,5,0,96
India,13/07/2012,83,2,0,0,46,19,0,150
India,14/07/2012,37,2,0,0,6,10,0,55
India,15/07/2012,51,0,-2,0,13,6,0,68
India,16/07/2012,113,0,-6,0,17,18,0,142
India,17/07/2012,78,0,-2,0,36,9,0,121
India,18/07/2012,70,0,-1,0,29,11,0,109
India,19/07/2012,104,2,3,0,31,27,0,167
India,20/07/2012,101,2,-6,0,21,22,0,140
India,21/07/2012,39,2,-7,0,24,32,0,90
India,22/07/2012,98,4,-6,0,24,14,0,134
India,23/07/2012,68,2,-4,0,8,11,0,85
India,24/07/2012,10,0,-3,0,10,2,0,19
India,25/07/2012,81,2,-2,0,28,10,0,119
India,26/07/2012,130,2,-2,0,14,15,0,159
India,27/07/2012,103,2,1,0,18,8,0,132
India,28/07/2012,67,0,1,0,15,7,0,90
India,29/07/2012,26,6,1,0,23,6,0,62
India,30/07/2012,69,2,0,0,76,23,0,170
India,31/07/2012,79,2,-1,0,51,6,0,137
Iran,01/07/2012,81,0,4,0,19,13,0,117
Iran,02/07/2012,103,2,4,0,55,18,0,182
Iran,03/07/2012,264,2,5,0,36,21,0,328
Iran,04/07/2012,171,0,3,0,71,10,0,255
Iran,05/07/2012,135,0,3,0,61,5,0,204
Iran,06/07/2012,129,0,1,0,21,11,0,162
Iran,07/07/2012,116,0,-5,0,48,13,0,172
Iran,08/07/2012,126,0,-1,0,45,0,0,170
Iran,09/07/2012,120,0,2,0,47,6,0,175
Iran,10/07/2012,99,0,0,0,34,6,0,139
Iran,11/07/2012,113,0,-2,0,10,6,0,127
Iran,12/07/2012,53,0,0,0,11,0,0,64
Iran,13/07/2012,99,2,-3,0,100,20,0,218
Iran,14/07/2012,86,0,0,0,81,13,0,180
Iran,15/07/2012,86,0,0,0,68,5,0,159
Iran,16/07/2012,141,0,1,0,25,17,0,184
Iran,17/07/2012,145,0,-4,0,21,12,0,174
Iran,18/07/2012,113,0,-4,0,34,10,0,153
Iran,19/07/2012,255,0,2,0,83,18,0,358
Iran,20/07/2012,118,2,-2,0,29,68,0,215
Iran,21/07/2012,97,0,0,0,27,43,0,167
Iran,22/07/2012,157,2,0,0,16,19,0,194
Iran,23/07/2012,159,0,0,0,60,20,0,239
Iran,24/07/2012,191,2,-7,0,65,31,0,282
Iran,25/07/2012,174,0,-5,0,31,29,0,229
Iran,26/07/2012,141,0,-3,0,39,17,0,194
Iran,27/07/2012,58,0,-2,0,52,14,0,122
Iran,28/07/2012,65,0,0,0,3,11,0,79
Iran,29/07/2012,125,0,2,0,21,7,0,155
Iran,30/07/2012,106,4,0,0,73,17,0,200
Iran,31/07/2012,194,4,-3,0,67,15,0,277
Iraq,01/07/2012,114,0,0,0,2,5,0,121
Iraq,02/07/2012,207,4,1,0,38,3,0,253
Iraq,03/07/2012,110,0,-3,0,24,18,0,149
Iraq,04/07/2012,149,10,-2,0,28,13,0,198
Iraq,05/07/2012,168,8,0,0,41,1,0,218
Iraq,06/07/2012,81,4,0,0,14,4,0,103
Iraq,07/07/2012,21,0,1,0,-2,0,0,20
Iraq,08/07/2012,48,4,0,0,0,2,0,54
Iraq,09/07/2012,81,8,0,0,37,5,0,131
Iraq,10/07/2012,72,2,0,0,-9,2,0,67
Iraq,11/07/2012,83,2,0,0,10,3,0,98
Iraq,12/07/2012,48,0,-2,0,2,4,0,52
Iraq,13/07/2012,94,0,0,0,21,8,0,123
Iraq,14/07/2012,41,4,3,0,2,5,0,55
Iraq,15/07/2012,77,0,0,0,17,2,0,96
Iraq,16/07/2012,154,0,1,0,30,10,0,195
Iraq,17/07/2012,240,2,0,0,39,6,0,287
Iraq,18/07/2012,80,0,0,0,14,3,0,97
Iraq,19/07/2012,178,2,1,0,24,16,0,221
Iraq,20/07/2012,341,2,0,0,40,17,0,400
Iraq,21/07/2012,248,0,-2,0,24,9,0,279
Iraq,22/07/2012,181,0,0,0,12,10,0,203
Iraq,23/07/2012,200,4,-27,0,10,16,0,203
Iraq,24/07/2012,167,2,6,0,-19,4,0,160
Iraq,25/07/2012,149,0,-1,0,-11,16,0,153
Iraq,26/07/2012,268,0,-2,0,-15,24,0,275
Iraq,27/07/2012,126,0,-6,0,7,5,0,132
Iraq,28/07/2012,170,0,1,0,-8,0,0,163
Iraq,29/07/2012,110,2,-1,0,18,3,0,132
Iraq,30/07/2012,104,6,0,0,-4,8,0,114
Iraq,31/07/2012,148,4,2,0,15,8,0,177
Morocco,01/07/2012,5,0,0,0,9,0,0,14
Morocco,02/07/2012,0,0,0,0,6,1,0,7
Morocco,03/07/2012,1,0,0,0,0,0,0,1
Morocco,04/07/2012,1,0,0,0,-2,0,0,-1
Morocco,05/07/2012,6,0,0,0,0,0,0,6
Morocco,06/07/2012,13,0,-4,0,0,3,0,12
Morocco,07/07/2012,0,0,0,0,9,0,0,9
Morocco,08/07/2012,7,0,-3,0,60,2,0,66
Morocco,09/07/2012,4,0,0,0,22,0,0,26
Morocco,10/07/2012,21,0,0,0,18,0,0,39
Morocco,11/07/2012,29,0,0,0,15,9,0,53
Morocco,12/07/2012,6,0,0,0,3,0,0,9
Morocco,13/07/2012,2,0,0,0,3,0,0,5
Morocco,14/07/2012,2,0,0,0,0,3,0,5
Morocco,15/07/2012,1,0,0,0,0,0,0,1
Morocco,16/07/2012,23,0,-1,0,6,2,0,30
Morocco,17/07/2012,35,0,0,0,15,1,0,51
Morocco,18/07/2012,-1,0,0,0,3,0,0,2
Morocco,19/07/2012,7,0,0,0,11,0,0,18
Morocco,20/07/2012,5,0,1,0,0,1,0,7
Morocco,21/07/2012,2,0,0,0,0,0,0,2
Morocco,22/07/2012,2,0,0,0,0,0,0,2
Morocco,23/07/2012,7,0,0,0,0,1,0,8
Morocco,24/07/2012,4,0,0,0,0,0,0,4
Morocco,25/07/2012,8,0,0,0,-4,2,0,6
Morocco,26/07/2012,13,0,0,0,0,1,0,14
Morocco,27/07/2012,8,0,0,0,3,0,0,11
Morocco,28/07/2012,1,0,0,0,0,0,0,1
Morocco,29/07/2012,4,2,0,0,-8,0,0,-2
Morocco,30/07/2012,1,0,0,0,0,0,0,1
Morocco,31/07/2012,7,0,0,0,0,0,0,7
Nigeria,01/07/2012,6,2,-1,0,10,6,0,23
Nigeria,02/07/2012,25,0,0,0,26,4,0,55
Nigeria,03/07/2012,25,2,0,0,28,5,0,60
Nigeria,04/07/2012,68,2,0,0,16,2,0,88
Nigeria,05/07/2012,18,0,0,0,12,4,0,34
Nigeria,06/07/2012,36,2,0,0,31,0,0,69
Nigeria,07/07/2012,23,0,0,0,1,1,0,25
Nigeria,08/07/2012,86,0,0,0,6,3,0,95
Nigeria,09/07/2012,95,0,7,0,36,4,0,142
Nigeria,10/07/2012,58,0,3,0,18,3,0,82
Nigeria,11/07/2012,27,0,0,0,12,2,0,41
Nigeria,12/07/2012,18,0,1,0,15,9,0,43
Nigeria,13/07/2012,17,0,1,0,4,3,0,25
Nigeria,14/07/2012,25,2,0,0,-2,3,0,28
Nigeria,15/07/2012,12,0,0,0,21,5,0,38
Nigeria,16/07/2012,26,0,1,0,16,6,0,49
Nigeria,17/07/2012,50,0,3,0,34,1,0,88
Nigeria,18/07/2012,18,0,1,0,12,6,0,37
Nigeria,19/07/2012,23,0,-5,0,4,6,0,28
Nigeria,20/07/2012,12,0,3,0,7,1,0,23
Nigeria,21/07/2012,0,0,-2,0,15,4,0,17
Nigeria,22/07/2012,26,0,0,0,4,1,0,31
Nigeria,23/07/2012,37,0,-4,0,10,2,0,45
Nigeria,24/07/2012,40,0,0,0,22,0,0,62
Nigeria,25/07/2012,27,0,0,0,9,5,0,41
Nigeria,26/07/2012,12,0,1,0,17,1,0,31
Nigeria,27/07/2012,25,2,0,0,14,3,0,44
Nigeria,28/07/2012,20,0,0,0,10,7,0,37
Nigeria,29/07/2012,17,0,0,0,-8,2,0,11
Nigeria,30/07/2012,37,0,-1,0,4,2,0,42
Nigeria,31/07/2012,33,0,0,0,32,6,0,71
Pakistan,01/07/2012,128,0,-1,0,33,6,0,166
Pakistan,02/07/2012,84,2,2,0,25,19,0,132
Pakistan,03/07/2012,174,0,-3,0,15,24,0,210
Pakistan,04/07/2012,108,0,-4,0,48,8,0,160
Pakistan,05/07/2012,102,6,0,0,52,5,0,165
Pakistan,06/07/2012,107,2,0,0,26,7,0,142
Pakistan,07/07/2012,68,0,-8,0,7,4,0,71
Pakistan,08/07/2012,161,0,0,0,28,12,0,201
Pakistan,09/07/2012,119,0,2,0,14,11,0,146
Pakistan,10/07/2012,175,0,-3,0,46,17,0,235
Pakistan,11/07/2012,66,0,-2,0,12,14,0,90
Pakistan,12/07/2012,54,0,0,0,10,4,0,68
Pakistan,13/07/2012,121,2,-13,0,26,15,0,151
Pakistan,14/07/2012,41,0,-1,0,20,6,0,66
Pakistan,15/07/2012,65,0,-2,0,26,5,0,94
Pakistan,16/07/2012,46,0,-1,0,30,8,0,83
Pakistan,17/07/2012,91,4,-1,0,12,5,0,111
Pakistan,18/07/2012,77,4,0,0,18,12,0,111
Pakistan,19/07/2012,119,0,1,0,68,36,0,224
Pakistan,20/07/2012,70,0,0,0,37,12,0,119
Pakistan,21/07/2012,76,2,-1,0,4,8,0,89
Pakistan,22/07/2012,146,0,0,0,28,20,0,194
Pakistan,23/07/2012,155,0,3,0,14,11,0,183
Pakistan,24/07/2012,62,0,5,0,5,11,0,83
Pakistan,25/07/2012,53,0,-1,0,45,11,0,108
Pakistan,26/07/2012,101,0,0,0,34,15,0,150
Pakistan,27/07/2012,55,0,0,0,32,8,0,95
Pakistan,28/07/2012,68,0,0,0,36,14,0,118
Pakistan,29/07/2012,86,0,1,0,40,6,0,133
Pakistan,30/07/2012,86,0,-2,0,46,4,0,134
Pakistan,31/07/2012,129,0,1,0,52,17,0,199
Sierra Leone,01/07/2012,6,0,0,0,0,2,0,8
Sierra Leone,02/07/2012,0,0,0,0,3,0,0,3
Sierra Leone,03/07/2012,3,0,0,0,0,0,0,3
Sierra Leone,04/07/2012,4,0,0,0,0,0,0,4
Sierra Leone,05/07/2012,3,0,0,0,9,0,0,12
Sierra Leone,06/07/2012,2,0,0,0,1,0,0,3
Sierra Leone,07/07/2012,1,0,0,0,12,0,0,13
Sierra Leone,08/07/2012,0,0,0,0,0,0,0,0
Sierra Leone,09/07/2012,3,0,0,0,0,0,0,3
Sierra Leone,10/07/2012,3,0,0,0,21,0,0,24
Sierra Leone,11/07/2012,4,0,0,0,0,0,0,4
Sierra Leone,12/07/2012,3,0,0,0,0,0,0,3
Sierra Leone,13/07/2012,3,0,0,0,0,0,0,3
Sierra Leone,14/07/2012,0,0,0,0,0,0,0,0
Sierra Leone,15/07/2012,8,6,0,0,0,1,0,15
Sierra Leone,16/07/2012,9,0,0,0,3,1,0,13
Sierra Leone,17/07/2012,0,0,0,0,0,0,0,0
Sierra Leone,18/07/2012,7,0,0,0,3,0,0,10
Sierra Leone,19/07/2012,0,0,0,0,27,0,0,27
Sierra Leone,20/07/2012,4,0,0,0,6,0,0,10
Sierra Leone,22/07/2012,0,0,0,0,0,0,0,0
Sierra Leone,23/07/2012,3,0,0,0,3,0,0,6
Sierra Leone,24/07/2012,-2,0,0,0,-2,0,0,-4
Sierra Leone,25/07/2012,1,0,0,0,3,0,0,4
Sierra Leone,26/07/2012,1,0,0,0,30,2,0,33
Sierra Leone,27/07/2012,-1,0,0,0,6,0,0,5
Sierra Leone,28/07/2012,0,0,0,0,0,0,0,0
Sierra Leone,29/07/2012,1,0,0,0,0,1,0,2
Sierra Leone,30/07/2012,0,0,0,0,9,0,0,9
Sierra Leone,31/07/2012,12,0,0,0,1,0,0,13
Somalia,01/07/2012,471,0,-4,0,40,34,0,541
Somalia,02/07/2012,202,4,0,0,6,28,0,240
Somalia,03/07/2012,112,0,-5,0,23,15,0,145
Somalia,04/07/2012,136,0,0,0,28,6,0,170
Somalia,05/07/2012,97,2,-4,0,37,10,0,142
Somalia,06/07/2012,103,0,-2,0,49,15,0,165
Somalia,07/07/2012,51,0,0,0,40,10,0,101
Somalia,08/07/2012,66,0,0,0,39,6,0,111
Somalia,09/07/2012,67,2,-4,0,41,5,0,111
Somalia,10/07/2012,64,0,4,0,21,8,0,97
Somalia,11/07/2012,69,0,3,0,5,17,0,94
Somalia,12/07/2012,45,0,-2,0,13,8,0,64
Somalia,13/07/2012,54,0,1,0,27,6,0,88
Somalia,14/07/2012,25,0,-1,0,30,9,0,63
Somalia,15/07/2012,34,0,1,0,18,10,0,63
Somalia,16/07/2012,120,0,-2,0,24,8,0,150
Somalia,17/07/2012,118,0,-2,0,46,2,0,164
Somalia,18/07/2012,57,0,0,0,10,15,0,82
Somalia,19/07/2012,79,0,3,0,31,14,0,127
Somalia,20/07/2012,78,4,-2,0,35,8,0,123
Somalia,21/07/2012,59,0,0,0,47,14,0,120
Somalia,22/07/2012,71,0,1,0,22,11,0,105
Somalia,23/07/2012,30,0,0,0,51,7,0,88
Somalia,24/07/2012,91,0,-1,0,-3,8,0,95
Somalia,25/07/2012,68,0,3,0,48,4,0,123
Somalia,26/07/2012,79,0,-2,0,37,6,0,120
Somalia,27/07/2012,56,0,-2,0,61,7,0,122
Somalia,28/07/2012,12,0,1,0,15,3,0,31
Somalia,29/07/2012,58,0,0,0,27,6,0,91
Somalia,30/07/2012,102,0,0,0,43,5,0,150
Somalia,31/07/2012,101,0,1,0,20,13,0,135
Syria,01/07/2012,330,0,-19,0,59,13,0,383
Syria,02/07/2012,695,0,-25,0,125,41,0,836
Syria,03/07/2012,481,0,-16,0,238,26,0,729
Syria,04/07/2012,553,0,-12,0,59,41,0,641
Syria,05/07/2012,494,0,-13,0,-26,29,0,484
Syria,06/07/2012,510,0,-12,0,41,37,0,576
Syria,07/07/2012,227,0,-2,0,30,54,0,309
Syria,08/07/2012,212,0,1,0,24,39,0,276
Syria,09/07/2012,376,2,-5,0,34,17,0,424
Syria,10/07/2012,337,16,0,0,15,27,0,395
Syria,11/07/2012,373,6,-6,0,10,42,0,425
Syria,12/07/2012,400,0,-18,0,10,16,0,408
Syria,13/07/2012,886,8,7,0,29,69,0,999
Syria,14/07/2012,699,4,-4,0,64,152,0,915
Syria,15/07/2012,503,0,1,0,53,34,0,591
Syria,16/07/2012,428,2,-12,0,75,29,0,522
Syria,17/07/2012,539,2,-3,0,65,64,0,667
Syria,18/07/2012,398,4,-2,0,45,49,0,494
Syria,19/07/2012,345,8,-7,0,34,47,0,427
Syria,20/07/2012,285,0,-72,0,91,41,0,345
Syria,21/07/2012,153,0,-1,0,-11,5,0,146
Syria,22/07/2012,241,0,-1,0,-5,13,0,248
Syria,23/07/2012,332,14,-7,0,43,18,0,400
Syria,24/07/2012,455,2,-23,0,31,29,0,494
Syria,25/07/2012,471,0,-4,0,87,35,0,589
Syria,26/07/2012,342,4,3,0,-1,43,0,391
Syria,27/07/2012,411,0,-2,0,47,35,0,491
Syria,28/07/2012,234,6,-1,0,19,18,0,276
Syria,29/07/2012,294,8,-2,0,30,29,0,359
Syria,30/07/2012,366,4,-6,0,-3,41,0,402
Syria,31/07/2012,234,0,-5,0,16,19,0,264
Yemen,01/07/2012,17,0,-2,0,6,0,0,21
Yemen,02/07/2012,17,0,0,0,-8,8,0,17
Yemen,03/07/2012,41,0,0,0,4,0,0,45
Yemen,04/07/2012,8,0,0,0,3,0,0,11
Yemen,05/07/2012,6,0,-2,0,8,0,0,12
Yemen,06/07/2012,45,0,0,0,9,3,0,57
Yemen,07/07/2012,39,0,0,0,0,1,0,40
Yemen,08/07/2012,24,0,0,0,3,2,0,29
Yemen,09/07/2012,15,0,-2,0,3,0,0,16
Yemen,10/07/2012,2,0,0,0,3,0,0,5
Yemen,11/07/2012,60,0,0,0,0,23,0,83
Yemen,12/07/2012,25,0,0,0,-4,4,0,25
Yemen,13/07/2012,33,0,-4,0,18,0,0,47
Yemen,14/07/2012,9,0,0,0,12,0,0,21
Yemen,15/07/2012,14,0,0,0,6,1,0,21
Yemen,16/07/2012,22,0,0,0,0,3,0,25
Yemen,17/07/2012,71,0,-8,0,-2,0,0,61
Yemen,18/07/2012,23,0,-4,0,6,0,0,25
Yemen,19/07/2012,101,0,0,0,31,9,0,141
Yemen,20/07/2012,75,0,0,0,12,1,0,88
Yemen,21/07/2012,22,0,0,0,6,0,0,28
Yemen,22/07/2012,10,0,0,0,10,1,0,21
Yemen,23/07/2012,8,0,-2,0,20,8,0,34
Yemen,24/07/2012,27,0,-2,0,6,0,0,31
Yemen,25/07/2012,8,0,0,0,24,1,0,33
Yemen,26/07/2012,10,0,0,0,6,3,0,19
Yemen,27/07/2012,21,0,0,0,0,2,0,23
Yemen,28/07/2012,8,2,0,0,0,0,0,10
Yemen,29/07/2012,16,0,0,0,36,0,0,52
Yemen,30/07/2012,114,0,-4,0,6,6,0,122
Yemen,31/07/2012,35,0,0,0,-2,3,0,36
Afghanistan,01/10/2009,420,2,2,0,47,32,0,503
Afghanistan,02/10/2009,369,2,4,0,37,17,0,429
Afghanistan,03/10/2009,242,6,1,0,22,30,0,301
Afghanistan,04/10/2009,265,0,1,0,22,24,0,312
Afghanistan,05/10/2009,400,0,1,0,34,68,0,503
Afghanistan,06/10/2009,444,4,-2,0,53,63,0,562
Afghanistan,07/10/2009,523,2,3,0,49,32,0,609
Afghanistan,08/10/2009,380,0,4,0,25,50,0,459
Afghanistan,09/10/2009,501,2,1,0,30,97,0,631
Afghanistan,10/10/2009,351,2,-3,0,45,55,0,450
Afghanistan,11/10/2009,196,0,3,0,35,31,0,265
Afghanistan,12/10/2009,455,4,2,0,26,61,0,548
Afghanistan,13/10/2009,347,6,2,0,92,46,0,493
Afghanistan,14/10/2009,340,0,1,0,28,21,0,390
Afghanistan,15/10/2009,409,4,2,0,98,58,0,571
Afghanistan,16/10/2009,187,2,-2,0,10,10,0,207
Afghanistan,17/10/2009,305,0,-2,0,33,26,0,362
Afghanistan,18/10/2009,267,6,1,0,47,53,0,374
Afghanistan,19/10/2009,383,2,10,0,88,47,0,530
Afghanistan,20/10/2009,421,10,-37,0,67,52,0,513
Afghanistan,21/10/2009,266,2,-12,0,67,26,0,349
Afghanistan,22/10/2009,385,4,-12,0,75,38,0,490
Afghanistan,23/10/2009,296,2,-3,0,58,74,0,427
Afghanistan,24/10/2009,271,0,5,0,81,47,0,404
Afghanistan,25/10/2009,199,6,-9,0,9,35,0,240
Afghanistan,26/10/2009,457,4,-4,0,40,45,0,542
Afghanistan,27/10/2009,475,0,3,0,52,53,0,583
Afghanistan,28/10/2009,404,4,1,0,100,35,0,544
Afghanistan,29/10/2009,506,4,3,0,113,48,0,674
Afghanistan,30/10/2009,378,0,-3,0,54,53,0,482
Afghanistan,31/10/2009,229,6,-8,0,42,26,0,295
Albania,01/10/2009,10,0,0,0,-8,3,0,5
Albania,02/10/2009,12,0,-2,0,20,1,0,31
Albania,03/10/2009,24,0,0,0,9,0,0,33
Albania,04/10/2009,0,0,0,0,0,0,0,0
Albania,05/10/2009,0,0,0,0,0,0,0,0
Albania,06/10/2009,0,0,-2,0,-4,1,0,-5
Albania,07/10/2009,8,0,2,0,-2,4,0,12
Albania,08/10/2009,12,0,0,0,6,2,0,20
Albania,09/10/2009,6,0,0,0,12,3,0,21
Albania,10/10/2009,1,0,0,0,0,1,0,2
Albania,11/10/2009,0,0,0,0,6,3,0,9
Albania,12/10/2009,0,0,0,0,0,0,0,0
Albania,13/10/2009,8,0,0,0,6,2,0,16
Albania,14/10/2009,19,0,-1,0,-2,1,0,17
Albania,15/10/2009,11,0,0,0,1,0,0,12
Albania,16/10/2009,0,0,0,0,0,2,0,2
Albania,17/10/2009,0,0,0,0,0,0,0,0
Albania,18/10/2009,0,0,0,0,0,0,0,0
Albania,19/10/2009,1,0,1,0,6,0,0,8
Albania,20/10/2009,10,0,0,0,0,0,0,10
Albania,21/10/2009,4,0,0,0,6,0,0,10
Albania,22/10/2009,9,0,0,0,3,0,0,12
Albania,23/10/2009,5,0,0,0,0,0,0,5
Albania,24/10/2009,2,0,0,0,1,0,0,3
Albania,25/10/2009,10,0,0,0,12,0,0,22
Albania,26/10/2009,5,0,0,0,6,0,0,11
Albania,27/10/2009,6,0,0,0,0,0,0,6
Albania,28/10/2009,6,0,0,0,-2,0,0,4
Albania,29/10/2009,9,0,0,0,39,0,0,48
Albania,30/10/2009,3,0,0,0,-6,0,0,-3
Albania,31/10/2009,0,0,0,0,-4,0,0,-4
Algeria,01/10/2009,0,0,0,0,0,1,0,1
Algeria,02/10/2009,8,0,0,0,0,0,0,8
Algeria,03/10/2009,1,0,0,0,0,1,0,2
Algeria,04/10/2009,0,0,0,0,0,0,0,0
Algeria,05/10/2009,19,0,0,0,0,0,0,19
Algeria,06/10/2009,14,0,0,0,0,0,0,14
Algeria,07/10/2009,1,0,0,0,1,1,0,3
Algeria,08/10/2009,7,0,0,0,6,1,0,14
Algeria,09/10/2009,7,0,0,0,27,0,0,34
Algeria,10/10/2009,2,0,0,0,-1,0,0,1
Algeria,11/10/2009,1,0,0,0,3,0,0,4
Algeria,12/10/2009,4,0,0,0,9,1,0,14
Algeria,13/10/2009,14,0,0,0,3,0,0,17
Algeria,14/10/2009,1,0,0,0,19,0,0,20
Algeria,15/10/2009,4,0,0,0,10,0,0,14
Algeria,17/10/2009,0,0,0,0,0,0,0,0
Algeria,18/10/2009,0,0,0,0,0,0,0,0
Algeria,19/10/2009,1,0,0,0,9,0,0,10
Algeria,20/10/2009,9,0,0,0,11,4,0,24
Algeria,21/10/2009,43,0,0,0,7,0,0,50
Algeria,22/10/2009,19,0,0,0,1,2,0,22
Algeria,23/10/2009,11,0,0,0,0,0,0,11
Algeria,24/10/2009,1,0,0,0,0,0,0,1
Algeria,25/10/2009,2,0,0,0,0,0,0,2
Algeria,26/10/2009,7,0,0,0,0,2,0,9
Algeria,27/10/2009,2,0,0,0,-5,3,0,0
Algeria,28/10/2009,47,0,0,0,0,0,0,47
Algeria,29/10/2009,28,0,0,0,7,0,0,35
Algeria,30/10/2009,8,0,0,0,-4,0,0,4
Algeria,31/10/2009,3,0,0,0,3,0,0,6
Bangladesh,01/10/2009,7,0,-1,0,3,1,0,10
Bangladesh,02/10/2009,15,0,-1,0,6,0,0,20
Bangladesh,03/10/2009,18,0,0,0,2,3,0,23
Bangladesh,04/10/2009,7,0,-1,0,1,2,0,9
Bangladesh,05/10/2009,19,0,0,0,1,3,0,23
Bangladesh,06/10/2009,9,0,0,0,0,0,0,9
Bangladesh,07/10/2009,18,0,0,0,9,1,0,28
Bangladesh,08/10/2009,16,0,1,0,6,1,0,24
Bangladesh,09/10/2009,8,0,0,0,0,2,0,10
Bangladesh,10/10/2009,10,0,-3,0,0,0,0,7
Bangladesh,11/10/2009,17,0,0,0,-2,2,0,17
Bangladesh,12/10/2009,17,0,0,0,-5,2,0,14
Bangladesh,13/10/2009,13,0,0,0,21,2,0,36
Bangladesh,14/10/2009,15,2,0,0,9,1,0,27
Bangladesh,15/10/2009,2,0,0,0,1,1,0,4
Bangladesh,16/10/2009,14,0,0,0,1,0,0,15
Bangladesh,17/10/2009,28,0,0,0,0,3,0,31
Bangladesh,18/10/2009,10,0,0,0,3,1,0,14
Bangladesh,19/10/2009,0,0,0,0,6,2,0,8
Bangladesh,20/10/2009,22,0,2,0,3,0,0,27
Bangladesh,21/10/2009,15,0,0,0,-1,2,0,16
Bangladesh,22/10/2009,15,0,-2,0,3,0,0,16
Bangladesh,23/10/2009,33,0,0,0,30,4,0,67
Bangladesh,24/10/2009,12,0,0,0,0,2,0,14
Bangladesh,25/10/2009,7,0,0,0,12,0,0,19
Bangladesh,26/10/2009,24,0,0,0,13,0,0,37
Bangladesh,27/10/2009,7,0,0,0,1,6,0,14
Bangladesh,28/10/2009,23,0,-2,0,3,1,0,25
Bangladesh,29/10/2009,17,0,0,0,16,0,0,33
Bangladesh,30/10/2009,12,6,0,0,12,0,0,30
Bangladesh,31/10/2009,6,0,0,0,3,3,0,12
Cameroon,01/10/2009,0,0,0,0,0,0,0,0
Cameroon,02/10/2009,6,0,0,0,0,1,0,7
Cameroon,03/10/2009,0,0,0,0,0,0,0,0
Cameroon,04/10/2009,1,0,2,0,0,0,0,3
Cameroon,05/10/2009,0,0,0,0,3,2,0,5
Cameroon,06/10/2009,2,0,0,0,0,0,0,2
Cameroon,07/10/2009,0,0,0,0,0,0,0,0
Cameroon,08/10/2009,4,0,0,0,3,0,0,7
Cameroon,09/10/2009,0,0,0,0,0,0,0,0
Cameroon,10/10/2009,7,0,0,0,5,0,0,12
Cameroon,12/10/2009,0,0,0,0,0,0,0,0
Cameroon,13/10/2009,0,0,0,0,0,0,0,0
Cameroon,14/10/2009,0,0,0,0,0,0,0,0
Cameroon,15/10/2009,1,0,1,0,6,1,0,9
Cameroon,16/10/2009,1,0,0,0,0,0,0,1
Cameroon,17/10/2009,0,0,0,0,3,2,0,5
Cameroon,18/10/2009,0,0,0,0,0,0,0,0
Cameroon,19/10/2009,7,0,0,0,0,0,0,7
Cameroon,20/10/2009,3,0,0,0,6,0,0,9
Cameroon,21/10/2009,0,0,0,0,0,0,0,0
Cameroon,22/10/2009,0,0,0,0,0,0,0,0
Cameroon,23/10/2009,10,0,0,0,0,0,0,10
Cameroon,25/10/2009,4,0,0,0,0,0,0,4
Cameroon,26/10/2009,2,0,0,0,0,0,0,2
Cameroon,27/10/2009,4,0,0,0,3,0,0,7
Cameroon,28/10/2009,5,0,0,0,0,0,0,5
Cameroon,29/10/2009,3,0,0,0,0,0,0,3
Cameroon,30/10/2009,8,0,0,0,0,0,0,8
Cameroon,31/10/2009,0,0,0,0,0,0,0,0
China,01/10/2009,112,0,-9,0,57,26,0,186
China,02/10/2009,131,10,-2,0,51,21,0,211
China,03/10/2009,49,2,0,0,16,3,0,70
China,04/10/2009,79,0,-12,0,60,18,0,145
China,05/10/2009,71,4,0,0,54,19,0,148
China,06/10/2009,114,4,-10,0,17,10,0,135
China,07/10/2009,117,10,-2,0,31,15,0,171
China,08/10/2009,194,2,1,0,56,12,0,265
China,09/10/2009,158,0,-2,0,25,12,0,193
China,10/10/2009,49,18,0,0,21,4,0,92
China,11/10/2009,57,8,-2,0,33,7,0,103
China,12/10/2009,195,2,0,0,185,32,0,414
China,13/10/2009,164,4,-4,0,95,19,0,278
China,14/10/2009,186,2,-9,0,46,18,0,243
China,15/10/2009,146,4,-2,0,97,18,0,263
China,16/10/2009,16,0,-4,0,13,5,0,30
China,17/10/2009,99,0,-2,0,39,10,0,146
China,18/10/2009,56,4,0,0,22,6,0,88
China,19/10/2009,138,2,-6,0,160,15,0,309
China,20/10/2009,172,2,-1,0,33,25,0,231
China,21/10/2009,154,8,2,0,67,40,0,271
China,22/10/2009,153,2,0,0,35,10,0,200
China,23/10/2009,61,0,-3,0,58,16,0,132
China,24/10/2009,47,2,-3,0,4,15,0,65
China,25/10/2009,82,2,0,0,6,18,0,108
China,26/10/2009,88,0,-4,0,7,21,0,112
China,27/10/2009,136,0,-2,0,60,18,0,212
China,28/10/2009,125,2,-8,0,63,7,0,189
China,29/10/2009,142,5,-6,0,93,20,0,254
China,30/10/2009,103,4,2,0,48,12,0,169
China,31/10/2009,144,0,0,0,13,7,0,164
Egypt,01/10/2009,55,0,0,0,5,4,0,64
Egypt,02/10/2009,56,0,-1,0,-7,0,0,48
Egypt,03/10/2009,23,0,0,0,-5,3,0,21
Egypt,04/10/2009,37,0,0,0,0,0,0,37
Egypt,05/10/2009,45,0,0,0,56,1,0,102
Egypt,06/10/2009,37,0,0,0,39,2,0,78
Egypt,07/10/2009,35,4,0,0,59,3,0,101
Egypt,08/10/2009,37,4,0,0,58,3,0,102
Egypt,09/10/2009,39,4,0,0,13,0,0,56
Egypt,10/10/2009,14,0,0,0,14,2,0,30
Egypt,11/10/2009,39,0,0,0,37,2,0,78
Egypt,12/10/2009,24,0,-2,0,11,8,0,41
Egypt,13/10/2009,66,2,-2,0,31,5,0,102
Egypt,14/10/2009,61,2,0,0,61,1,0,125
Egypt,15/10/2009,49,0,4,0,21,4,0,78
Egypt,16/10/2009,26,0,0,0,9,5,0,40
Egypt,17/10/2009,43,0,-2,0,-5,2,0,38
Egypt,18/10/2009,42,0,0,0,7,0,0,49
Egypt,19/10/2009,50,0,0,0,13,4,0,67
Egypt,20/10/2009,15,0,1,0,12,4,0,32
Egypt,21/10/2009,19,0,0,0,21,4,0,44
Egypt,22/10/2009,41,0,0,0,0,1,0,42
Egypt,23/10/2009,35,0,-2,0,-6,3,0,30
Egypt,24/10/2009,31,0,2,0,10,0,0,43
Egypt,25/10/2009,33,0,0,0,4,0,0,37
Egypt,26/10/2009,82,0,-2,0,66,11,0,157
Egypt,27/10/2009,57,0,-2,0,13,3,0,71
Egypt,28/10/2009,41,0,0,0,39,7,0,87
Egypt,29/10/2009,17,0,1,0,18,2,0,38
Egypt,30/10/2009,15,0,0,0,9,0,0,24
Egypt,31/10/2009,19,0,1,0,15,0,0,35
Eritrea,01/10/2009,-1,0,0,0,0,0,0,-1
Eritrea,02/10/2009,6,0,0,0,0,0,0,6
Eritrea,03/10/2009,-1,0,0,0,4,0,0,3
Eritrea,05/10/2009,5,0,0,0,0,0,0,5
Eritrea,06/10/2009,0,0,0,0,0,0,0,0
Eritrea,07/10/2009,1,0,0,0,-2,0,0,-1
Eritrea,08/10/2009,3,0,0,0,0,0,0,3
Eritrea,09/10/2009,2,0,0,0,0,0,0,2
Eritrea,10/10/2009,10,0,0,0,0,0,0,10
Eritrea,12/10/2009,0,0,0,0,0,0,0,0
Eritrea,13/10/2009,0,0,0,0,0,0,0,0
Eritrea,14/10/2009,2,0,0,0,0,0,0,2
Eritrea,15/10/2009,6,0,0,0,-2,1,0,5
Eritrea,16/10/2009,0,0,0,0,0,0,0,0
Eritrea,18/10/2009,3,0,0,0,0,0,0,3
Eritrea,19/10/2009,0,0,0,0,0,0,0,0
Eritrea,20/10/2009,7,0,0,0,-2,0,0,5
Eritrea,21/10/2009,0,0,0,0,0,0,0,0
Eritrea,22/10/2009,9,0,0,0,-6,0,0,3
Eritrea,23/10/2009,1,0,0,0,-6,0,0,-5
Eritrea,24/10/2009,7,0,0,0,0,0,0,7
Eritrea,25/10/2009,0,0,0,0,0,0,0,0
Eritrea,26/10/2009,8,0,0,0,0,0,0,8
Eritrea,27/10/2009,10,0,0,0,-2,0,0,8
Eritrea,28/10/2009,2,0,0,0,0,0,0,2
Eritrea,29/10/2009,0,0,0,0,0,0,0,0
Eritrea,30/10/2009,3,0,1,0,0,0,0,4
Eritrea,31/10/2009,7,0,1,0,6,0,0,14
Georgia,01/10/2009,44,4,0,0,20,1,0,69
Georgia,02/10/2009,22,0,-2,0,33,2,0,55
Georgia,03/10/2009,3,0,0,0,0,1,0,4
Georgia,04/10/2009,16,0,0,0,1,3,0,20
Georgia,05/10/2009,56,0,0,0,32,9,0,97
Georgia,06/10/2009,38,4,0,0,30,6,0,78
Georgia,07/10/2009,16,2,1,0,30,9,0,58
Georgia,08/10/2009,13,0,-2,0,8,10,0,29
Georgia,09/10/2009,15,0,0,0,4,4,0,23
Georgia,10/10/2009,3,0,0,0,-1,1,0,3
Georgia,11/10/2009,10,0,0,0,-8,0,0,2
Georgia,12/10/2009,25,0,0,0,8,3,0,36
Georgia,13/10/2009,22,0,0,0,3,3,0,28
Georgia,14/10/2009,55,2,0,0,11,8,0,76
Georgia,15/10/2009,25,2,0,0,21,5,0,53
Georgia,16/10/2009,0,0,0,0,9,1,0,10
Georgia,17/10/2009,12,0,0,0,14,0,0,26
Georgia,18/10/2009,5,0,0,0,-2,0,0,3
Georgia,19/10/2009,18,0,1,0,15,2,0,36
Georgia,20/10/2009,34,0,-2,0,7,4,0,43
Georgia,21/10/2009,14,2,0,0,10,4,0,30
Georgia,22/10/2009,16,0,0,0,13,9,0,38
Georgia,23/10/2009,18,0,-6,0,11,6,0,29
Georgia,24/10/2009,13,0,0,0,6,4,0,23
Georgia,25/10/2009,14,4,0,0,11,5,0,34
Georgia,26/10/2009,33,0,1,0,19,2,0,55
Georgia,27/10/2009,2,0,-1,0,9,2,0,12
Georgia,28/10/2009,17,0,1,0,30,2,0,50
Georgia,29/10/2009,63,0,0,0,48,4,0,115
Georgia,30/10/2009,45,2,1,0,32,3,0,83
Georgia,31/10/2009,13,0,0,0,10,1,0,24
India,01/10/2009,86,2,-2,0,32,15,0,133
India,02/10/2009,67,6,-1,0,-4,7,0,75
India,03/10/2009,58,0,-1,0,2,4,0,63
India,04/10/2009,64,2,-2,0,12,1,0,77
India,05/10/2009,83,0,-2,0,31,8,0,120
India,06/10/2009,85,0,1,0,-2,8,0,92
India,07/10/2009,63,4,-4,0,2,21,0,86
India,08/10/2009,153,0,0,0,23,43,0,219
India,09/10/2009,84,6,3,0,14,13,0,120
India,10/10/2009,69,0,0,0,16,19,0,104
India,11/10/2009,93,0,0,0,36,3,0,132
India,12/10/2009,106,0,-5,0,25,6,0,132
India,13/10/2009,92,2,0,0,-8,16,0,102
India,14/10/2009,47,0,0,0,12,7,0,66
India,15/10/2009,74,0,5,0,28,8,0,115
India,16/10/2009,23,0,0,0,0,1,0,24
India,17/10/2009,36,0,-2,0,23,6,0,63
India,18/10/2009,45,2,1,0,7,25,0,80
India,19/10/2009,85,0,0,0,21,12,0,118
India,20/10/2009,52,4,0,0,-1,8,0,63
India,21/10/2009,81,2,0,0,8,4,0,95
India,22/10/2009,76,0,0,0,12,10,0,98
India,23/10/2009,69,0,0,0,21,7,0,97
India,24/10/2009,62,0,0,0,19,9,0,90
India,25/10/2009,90,4,-1,0,4,4,0,101
India,26/10/2009,121,4,1,0,52,8,0,186
India,27/10/2009,67,4,0,0,-4,7,0,74
India,28/10/2009,56,4,0,0,-3,22,0,79
India,29/10/2009,62,6,-1,0,22,9,0,98
India,30/10/2009,27,0,-6,0,9,1,0,31
India,31/10/2009,58,0,-2,0,2,3,0,61
Iran,01/10/2009,41,0,0,0,24,10,0,75
Iran,02/10/2009,93,0,2,0,39,15,0,149
Iran,03/10/2009,73,0,-1,0,3,4,0,79
Iran,04/10/2009,31,0,0,0,14,10,0,55
Iran,05/10/2009,74,0,-1,0,33,9,0,115
Iran,06/10/2009,46,0,-1,0,42,3,0,90
Iran,07/10/2009,116,4,1,0,19,7,0,147
Iran,08/10/2009,75,0,4,0,38,5,0,122
Iran,09/10/2009,106,0,0,0,48,23,0,177
Iran,10/10/2009,54,2,2,0,31,15,0,104
Iran,11/10/2009,40,0,2,0,21,8,0,71
Iran,12/10/2009,125,0,4,0,39,8,0,176
Iran,13/10/2009,49,0,2,0,31,10,0,92
Iran,14/10/2009,90,0,0,0,30,5,0,125
Iran,15/10/2009,100,0,-2,0,68,9,0,175
Iran,16/10/2009,46,0,1,0,-2,3,0,48
Iran,17/10/2009,34,0,3,0,17,6,0,60
Iran,18/10/2009,167,2,0,0,15,50,0,234
Iran,19/10/2009,258,0,1,0,51,28,0,338
Iran,20/10/2009,98,4,0,0,91,20,0,213
Iran,21/10/2009,71,0,0,0,55,17,0,143
Iran,22/10/2009,114,0,2,0,43,7,0,166
Iran,23/10/2009,97,0,0,0,8,7,0,112
Iran,24/10/2009,49,0,0,0,14,7,0,70
Iran,25/10/2009,30,0,0,0,9,2,0,41
Iran,26/10/2009,97,0,-2,0,40,21,0,156
Iran,27/10/2009,111,0,-2,0,19,21,0,149
Iran,28/10/2009,62,4,2,0,23,10,0,101
Iran,29/10/2009,38,10,0,0,23,10,0,81
Iran,30/10/2009,44,2,1,0,21,2,0,70
Iran,31/10/2009,92,0,0,0,28,0,0,120
Iraq,01/10/2009,136,2,1,0,39,8,0,186
Iraq,02/10/2009,73,0,0,0,36,5,0,114
Iraq,03/10/2009,53,0,0,0,22,11,0,86
Iraq,04/10/2009,31,2,1,0,23,7,0,64
Iraq,05/10/2009,217,0,3,0,35,37,0,292
Iraq,06/10/2009,166,0,2,0,40,35,0,243
Iraq,07/10/2009,138,4,2,0,5,11,0,160
Iraq,08/10/2009,81,0,-2,0,50,9,0,138
Iraq,09/10/2009,193,0,4,0,16,35,0,248
Iraq,10/10/2009,78,0,-10,0,35,7,0,110
Iraq,11/10/2009,72,0,2,0,11,12,0,97
Iraq,12/10/2009,128,0,0,0,70,28,0,226
Iraq,13/10/2009,127,6,5,0,27,14,0,179
Iraq,14/10/2009,115,0,2,0,35,10,0,162
Iraq,15/10/2009,107,0,-4,0,26,14,0,143
Iraq,16/10/2009,48,0,0,0,-1,0,0,47
Iraq,17/10/2009,40,0,0,0,36,13,0,89
Iraq,18/10/2009,37,0,1,0,32,13,0,83
Iraq,19/10/2009,64,2,12,0,40,6,0,124
Iraq,20/10/2009,114,6,4,0,63,9,0,196
Iraq,21/10/2009,95,4,1,0,78,13,0,191
Iraq,22/10/2009,97,0,0,0,53,11,0,161
Iraq,23/10/2009,52,6,0,0,15,31,0,104
Iraq,24/10/2009,35,0,0,0,4,2,0,41
Iraq,25/10/2009,36,0,0,0,6,4,0,46
Iraq,26/10/2009,122,0,-8,0,20,18,0,152
Iraq,27/10/2009,142,0,-1,0,24,22,0,187
Iraq,28/10/2009,141,0,4,0,22,8,0,175
Iraq,29/10/2009,177,0,3,0,10,4,0,194
Iraq,30/10/2009,94,4,3,0,42,2,0,145
Iraq,31/10/2009,67,0,0,0,67,3,0,137
Morocco,01/10/2009,1,0,0,0,6,0,0,7
Morocco,02/10/2009,5,0,0,0,12,0,0,17
Morocco,03/10/2009,11,0,0,0,12,4,0,27
Morocco,04/10/2009,2,0,0,0,4,0,0,6
Morocco,05/10/2009,5,0,0,0,15,4,0,24
Morocco,06/10/2009,-1,0,0,0,3,0,0,2
Morocco,07/10/2009,11,0,0,0,5,0,0,16
Morocco,08/10/2009,2,0,0,0,12,2,0,16
Morocco,09/10/2009,1,0,0,0,0,0,0,1
Morocco,10/10/2009,1,0,0,0,1,0,0,2
Morocco,11/10/2009,8,0,0,0,6,0,0,14
Morocco,12/10/2009,6,0,0,0,4,0,0,10
Morocco,13/10/2009,-5,0,0,0,15,0,0,10
Morocco,14/10/2009,9,0,0,0,30,11,0,50
Morocco,15/10/2009,3,0,0,0,16,0,0,19
Morocco,16/10/2009,0,0,0,0,3,0,0,3
Morocco,17/10/2009,2,0,-5,0,6,2,0,5
Morocco,18/10/2009,0,0,0,0,0,1,0,1
Morocco,19/10/2009,10,0,0,0,4,0,0,14
Morocco,20/10/2009,3,0,0,0,8,0,0,11
Morocco,21/10/2009,7,0,0,0,0,4,0,11
Morocco,22/10/2009,6,0,0,0,0,0,0,6
Morocco,23/10/2009,7,0,0,0,0,0,0,7
Morocco,24/10/2009,5,0,0,0,0,0,0,5
Morocco,25/10/2009,11,0,0,0,1,0,0,12
Morocco,26/10/2009,9,0,0,0,18,0,0,27
Morocco,27/10/2009,2,0,0,0,16,1,0,19
Morocco,28/10/2009,3,0,0,0,9,0,0,12
Morocco,29/10/2009,7,0,0,0,9,0,0,16
Morocco,30/10/2009,26,0,0,0,41,0,0,67
Morocco,31/10/2009,13,0,0,0,9,0,0,22
Nigeria,01/10/2009,34,0,0,0,23,2,0,59
Nigeria,02/10/2009,14,0,0,0,23,4,0,41
Nigeria,03/10/2009,2,0,0,0,1,0,0,3
Nigeria,04/10/2009,24,0,0,0,4,0,0,28
Nigeria,05/10/2009,42,0,-1,0,57,4,0,102
Nigeria,06/10/2009,23,2,1,0,22,2,0,50
Nigeria,07/10/2009,56,0,1,0,8,3,0,68
Nigeria,08/10/2009,16,0,1,0,6,3,0,26
Nigeria,09/10/2009,11,0,0,0,12,4,0,27
Nigeria,10/10/2009,15,2,0,0,3,0,0,20
Nigeria,11/10/2009,1,0,0,0,0,3,0,4
Nigeria,12/10/2009,28,0,0,0,23,1,0,52
Nigeria,13/10/2009,23,0,0,0,1,3,0,27
Nigeria,14/10/2009,17,0,2,0,24,4,0,47
Nigeria,15/10/2009,23,0,-1,0,8,4,0,34
Nigeria,16/10/2009,3,0,-1,0,4,0,0,6
Nigeria,17/10/2009,14,0,-2,0,0,0,0,12
Nigeria,18/10/2009,9,0,-2,0,4,0,0,11
Nigeria,19/10/2009,30,0,-2,0,2,6,0,36
Nigeria,20/10/2009,32,0,0,0,2,3,0,37
Nigeria,21/10/2009,34,0,0,0,1,10,0,45
Nigeria,22/10/2009,16,0,0,0,12,3,0,31
Nigeria,23/10/2009,20,0,0,0,10,2,0,32
Nigeria,24/10/2009,13,0,0,0,1,0,0,14
Nigeria,25/10/2009,14,0,-1,0,12,1,0,26
Nigeria,26/10/2009,40,0,0,0,10,3,0,53
Nigeria,27/10/2009,10,0,-2,0,8,4,0,20
Nigeria,28/10/2009,25,0,0,0,8,3,0,36
Nigeria,29/10/2009,17,0,2,0,0,3,0,22
Nigeria,30/10/2009,13,2,0,0,9,3,0,27
Nigeria,31/10/2009,14,0,0,0,-3,7,0,18
Pakistan,01/10/2009,137,2,2,0,0,2,0,143
Pakistan,02/10/2009,96,2,3,0,16,15,0,132
Pakistan,03/10/2009,60,0,1,0,50,3,0,114
Pakistan,04/10/2009,210,0,-4,0,41,11,0,258
Pakistan,05/10/2009,247,0,1,0,100,23,0,371
Pakistan,06/10/2009,210,0,9,0,68,14,0,301
Pakistan,07/10/2009,319,4,10,0,15,19,0,367
Pakistan,08/10/2009,215,0,-1,0,23,34,0,271
Pakistan,09/10/2009,123,0,2,0,37,9,0,171
Pakistan,10/10/2009,132,0,0,0,27,13,0,172
Pakistan,11/10/2009,260,2,2,0,21,15,0,300
Pakistan,12/10/2009,126,2,0,0,17,14,0,159
Pakistan,13/10/2009,123,0,-1,0,41,18,0,181
Pakistan,14/10/2009,100,2,0,0,-3,9,0,108
Pakistan,15/10/2009,104,2,0,0,13,10,0,129
Pakistan,16/10/2009,32,0,0,0,35,0,0,67
Pakistan,17/10/2009,70,0,0,0,66,9,0,145
Pakistan,18/10/2009,179,0,0,0,220,75,0,474
Pakistan,19/10/2009,243,4,0,0,48,47,0,342
Pakistan,20/10/2009,201,0,0,0,59,32,0,292
Pakistan,21/10/2009,100,0,-3,0,11,32,0,140
Pakistan,22/10/2009,119,0,0,0,51,5,0,175
Pakistan,23/10/2009,63,0,0,0,42,8,0,113
Pakistan,24/10/2009,78,0,0,0,19,11,0,108
Pakistan,25/10/2009,86,0,0,0,19,13,0,118
Pakistan,26/10/2009,109,2,-4,0,34,27,0,168
Pakistan,27/10/2009,104,0,0,0,73,26,0,203
Pakistan,28/10/2009,224,0,0,0,23,17,0,264
Pakistan,29/10/2009,83,1,1,0,26,7,0,118
Pakistan,30/10/2009,55,0,0,0,21,11,0,87
Pakistan,31/10/2009,67,0,1,0,51,12,0,131
Sierra Leone,01/10/2009,0,0,0,0,0,0,0,0
Sierra Leone,02/10/2009,8,0,0,0,0,0,0,8
Sierra Leone,03/10/2009,2,0,0,0,2,2,0,6
Sierra Leone,04/10/2009,0,0,0,0,0,0,0,0
Sierra Leone,05/10/2009,0,0,0,0,2,0,0,2
Sierra Leone,06/10/2009,2,0,0,0,0,0,0,2
Sierra Leone,07/10/2009,-2,0,0,0,6,5,0,9
Sierra Leone,08/10/2009,2,0,0,0,0,1,0,3
Sierra Leone,09/10/2009,-1,0,0,0,-2,0,0,-3
Sierra Leone,11/10/2009,0,0,0,0,0,0,0,0
Sierra Leone,12/10/2009,2,0,0,0,0,0,0,2
Sierra Leone,13/10/2009,0,0,0,0,0,0,0,0
Sierra Leone,14/10/2009,0,2,0,0,0,0,0,2
Sierra Leone,15/10/2009,-1,0,0,0,0,0,0,-1
Sierra Leone,16/10/2009,0,0,0,0,12,0,0,12
Sierra Leone,17/10/2009,0,0,1,0,27,0,0,28
Sierra Leone,18/10/2009,0,0,0,0,0,0,0,0
Sierra Leone,19/10/2009,0,0,0,0,0,0,0,0
Sierra Leone,20/10/2009,0,0,0,0,0,0,0,0
Sierra Leone,21/10/2009,0,0,0,0,0,0,0,0
Sierra Leone,22/10/2009,0,0,0,0,3,0,0,3
Sierra Leone,23/10/2009,1,0,0,0,0,0,0,1
Sierra Leone,24/10/2009,1,0,0,0,0,0,0,1
Sierra Leone,25/10/2009,0,0,0,0,0,0,0,0
Sierra Leone,26/10/2009,6,0,0,0,15,1,0,22
Sierra Leone,27/10/2009,-1,0,0,0,-1,2,0,0
Sierra Leone,28/10/2009,0,0,0,0,0,0,0,0
Sierra Leone,29/10/2009,4,0,0,0,0,0,0,4
Sierra Leone,30/10/2009,6,0,0,0,-2,0,0,4
Sierra Leone,31/10/2009,12,0,1,0,0,0,0,13
Somalia,01/10/2009,49,0,-1,0,16,2,0,66
Somalia,02/10/2009,49,0,0,0,30,2,0,81
Somalia,03/10/2009,16,0,0,0,2,0,0,18
Somalia,04/10/2009,13,0,0,0,39,0,0,52
Somalia,05/10/2009,30,0,0,0,6,5,0,41
Somalia,06/10/2009,62,0,0,0,92,7,0,161
Somalia,07/10/2009,145,2,3,0,69,11,0,230
Somalia,08/10/2009,41,0,0,0,20,0,0,61
Somalia,09/10/2009,23,0,0,0,6,4,0,33
Somalia,10/10/2009,5,0,0,0,13,3,0,21
Somalia,11/10/2009,10,0,0,0,12,0,0,22
Somalia,12/10/2009,31,0,0,0,28,3,0,62
Somalia,13/10/2009,46,0,0,0,21,0,0,67
Somalia,14/10/2009,39,0,0,0,47,0,0,86
Somalia,15/10/2009,26,0,0,0,37,0,0,63
Somalia,16/10/2009,0,0,0,0,0,0,0,0
Somalia,17/10/2009,26,0,0,0,8,0,0,34
Somalia,18/10/2009,13,0,0,0,6,0,0,19
Somalia,19/10/2009,62,0,0,0,45,0,0,107
Somalia,20/10/2009,50,0,1,0,8,0,0,59
Somalia,21/10/2009,100,0,2,0,70,8,0,180
Somalia,22/10/2009,384,14,0,0,81,4,0,483
Somalia,23/10/2009,84,2,0,0,25,7,0,118
Somalia,24/10/2009,27,2,0,0,6,0,0,35
Somalia,25/10/2009,14,0,0,0,11,5,0,30
Somalia,26/10/2009,27,0,0,0,6,7,0,40
Somalia,27/10/2009,58,0,0,0,29,4,0,91
Somalia,28/10/2009,62,0,0,0,15,0,0,77
Somalia,29/10/2009,59,6,0,0,181,0,0,246
Somalia,30/10/2009,51,0,0,0,72,2,0,125
Somalia,31/10/2009,54,0,0,0,103,16,0,173
Syria,01/10/2009,11,0,0,0,0,0,0,11
Syria,02/10/2009,30,0,0,0,-12,0,0,18
Syria,03/10/2009,8,0,0,0,3,1,0,12
Syria,04/10/2009,30,0,0,0,6,4,0,40
Syria,05/10/2009,14,0,0,0,-1,0,0,13
Syria,06/10/2009,18,0,0,0,8,2,0,28
Syria,07/10/2009,21,0,-2,0,34,6,0,59
Syria,08/10/2009,6,0,0,0,0,0,0,6
Syria,09/10/2009,20,4,0,0,5,3,0,32
Syria,10/10/2009,10,0,0,0,15,1,0,26
Syria,11/10/2009,2,0,0,0,6,2,0,10
Syria,12/10/2009,19,0,2,0,42,0,0,63
Syria,13/10/2009,0,0,0,0,19,4,0,23
Syria,14/10/2009,10,0,0,0,9,6,0,25
Syria,15/10/2009,26,0,1,0,35,2,0,64
Syria,16/10/2009,37,0,0,0,3,6,0,46
Syria,17/10/2009,27,0,0,0,8,3,0,38
Syria,18/10/2009,0,0,0,0,3,0,0,3
Syria,19/10/2009,6,0,0,0,18,0,0,24
Syria,20/10/2009,17,0,0,0,11,2,0,30
Syria,21/10/2009,50,0,0,0,30,1,0,81
Syria,22/10/2009,15,0,0,0,29,0,0,44
Syria,23/10/2009,6,0,0,0,18,0,0,24
Syria,24/10/2009,40,0,0,0,4,2,0,46
Syria,25/10/2009,15,0,0,0,13,0,0,28
Syria,26/10/2009,4,0,0,0,9,4,0,17
Syria,27/10/2009,10,0,0,0,6,0,0,16
Syria,28/10/2009,-1,0,0,0,7,3,0,9
Syria,29/10/2009,11,0,0,0,15,-4,0,22
Syria,30/10/2009,24,0,0,0,-2,0,0,22
Syria,31/10/2009,13,0,2,0,6,0,0,21
Yemen,01/10/2009,33,0,0,0,3,0,0,36
Yemen,02/10/2009,41,0,0,0,11,4,0,56
Yemen,03/10/2009,6,0,0,0,47,2,0,55
Yemen,04/10/2009,35,0,0,0,10,0,0,45
Yemen,05/10/2009,52,0,0,0,1,3,0,56
Yemen,06/10/2009,38,0,0,0,0,9,0,47
Yemen,07/10/2009,12,0,0,0,-4,9,0,17
Yemen,08/10/2009,8,0,0,0,-2,2,0,8
Yemen,09/10/2009,6,0,0,0,-4,0,0,2
Yemen,10/10/2009,12,0,0,0,0,0,0,12
Yemen,11/10/2009,8,0,0,0,0,7,0,15
Yemen,12/10/2009,11,0,0,0,0,3,0,14
Yemen,13/10/2009,60,0,0,0,6,0,0,66
Yemen,14/10/2009,39,0,0,0,15,0,0,54
Yemen,15/10/2009,10,0,0,0,0,0,0,10
Yemen,16/10/2009,0,0,0,0,0,0,0,0
Yemen,17/10/2009,8,0,0,0,-2,0,0,6
Yemen,18/10/2009,44,0,0,0,-1,10,0,53
Yemen,19/10/2009,19,0,0,0,17,6,0,42
Yemen,20/10/2009,8,0,0,0,17,7,0,32
Yemen,21/10/2009,13,0,0,0,7,0,0,20
Yemen,22/10/2009,21,0,0,0,6,0,0,27
Yemen,23/10/2009,9,0,0,0,3,2,0,14
Yemen,24/10/2009,4,0,0,0,6,0,0,10
Yemen,25/10/2009,12,0,0,0,8,2,0,22
Yemen,26/10/2009,12,0,0,0,6,0,0,18
Yemen,27/10/2009,13,0,0,0,9,2,0,24
Yemen,28/10/2009,27,2,0,0,9,1,0,39
Yemen,29/10/2009,14,0,0,0,15,0,0,29
Yemen,30/10/2009,14,0,0,0,-2,0,0,12
Yemen,31/10/2009,31,2,0,0,66,2,0,101
Afghanistan,01/04/2009,548,0,1,0,47,40,0,636
Afghanistan,02/04/2009,231,2,2,0,97,26,0,358
Afghanistan,03/04/2009,380,8,-8,0,97,32,0,509
Afghanistan,04/04/2009,505,10,-2,0,53,99,0,665
Afghanistan,05/04/2009,200,2,-4,0,16,43,0,257
Afghanistan,06/04/2009,273,0,-1,0,41,22,0,335
Afghanistan,07/04/2009,142,6,0,0,21,15,0,184
Afghanistan,08/04/2009,242,0,-2,0,64,23,0,327
Afghanistan,09/04/2009,246,6,0,0,28,39,0,319
Afghanistan,10/04/2009,134,4,1,0,22,22,0,183
Afghanistan,11/04/2009,78,0,0,0,35,8,0,121
Afghanistan,12/04/2009,171,0,-3,0,36,25,0,229
Afghanistan,13/04/2009,216,4,0,0,60,11,0,291
Afghanistan,14/04/2009,144,0,-4,0,40,0,0,180
Afghanistan,15/04/2009,184,2,1,0,46,43,0,276
Afghanistan,16/04/2009,140,0,0,0,37,24,0,201
Afghanistan,17/04/2009,131,0,0,0,96,19,0,246
Afghanistan,18/04/2009,149,4,0,0,28,21,0,202
Afghanistan,19/04/2009,182,2,0,0,56,12,0,252
Afghanistan,20/04/2009,253,4,0,0,34,25,0,316
Afghanistan,21/04/2009,201,4,1,0,101,10,0,317
Afghanistan,22/04/2009,186,2,1,0,26,11,0,226
Afghanistan,23/04/2009,106,0,0,0,26,15,0,147
Afghanistan,24/04/2009,264,4,-1,0,53,27,0,347
Afghanistan,25/04/2009,171,4,-4,0,34,73,0,278
Afghanistan,26/04/2009,110,0,0,0,0,45,0,155
Afghanistan,27/04/2009,131,0,-1,0,26,19,0,175
Afghanistan,28/04/2009,246,0,-2,0,63,6,0,313
Afghanistan,29/04/2009,271,2,-3,0,25,13,0,308
Afghanistan,30/04/2009,272,10,0,0,40,7,0,329
Albania,01/04/2009,44,0,-1,0,0,2,0,45
Albania,02/04/2009,3,0,0,0,-2,2,0,3
Albania,03/04/2009,-1,0,0,0,-2,0,0,-3
Albania,04/04/2009,15,0,0,0,4,0,0,19
Albania,05/04/2009,6,0,0,0,-18,3,0,-9
Albania,06/04/2009,8,0,0,0,-10,0,0,-2
Albania,07/04/2009,4,0,0,0,-5,0,0,-1
Albania,08/04/2009,2,0,0,0,3,8,0,13
Albania,09/04/2009,6,0,0,0,0,0,0,6
Albania,10/04/2009,41,0,0,0,1,2,0,44
Albania,11/04/2009,24,0,0,0,-4,0,0,20
Albania,12/04/2009,6,0,0,0,3,0,0,9
Albania,13/04/2009,4,0,0,0,0,0,0,4
Albania,14/04/2009,6,0,0,0,6,0,0,12
Albania,15/04/2009,-3,0,0,0,1,0,0,-2
Albania,16/04/2009,3,0,0,0,9,2,0,14
Albania,17/04/2009,13,0,0,0,-2,0,0,11
Albania,18/04/2009,7,0,2,0,0,0,0,9
Albania,19/04/2009,3,0,0,0,0,0,0,3
Albania,20/04/2009,0,0,0,0,0,0,0,0
Albania,21/04/2009,3,0,2,0,0,1,0,6
Albania,22/04/2009,2,0,0,0,0,2,0,4
Albania,23/04/2009,4,0,0,0,18,1,0,23
Albania,24/04/2009,9,0,0,0,20,0,0,29
Albania,25/04/2009,12,0,0,0,3,0,0,15
Albania,26/04/2009,0,0,0,0,0,1,0,1
Albania,27/04/2009,28,0,-3,0,14,26,0,65
Albania,28/04/2009,1,0,-2,0,8,8,0,15
Albania,29/04/2009,12,0,-2,0,27,4,0,41
Albania,30/04/2009,12,0,0,0,9,2,0,23
Algeria,01/04/2009,2,0,0,0,0,0,0,2
Algeria,02/04/2009,11,0,0,0,4,0,0,15
Algeria,03/04/2009,-1,0,0,0,13,35,0,47
Algeria,04/04/2009,7,0,0,0,12,14,0,33
Algeria,05/04/2009,9,0,0,0,-4,0,0,5
Algeria,06/04/2009,14,0,2,0,0,4,0,20
Algeria,07/04/2009,2,0,0,0,1,1,0,4
Algeria,08/04/2009,9,0,-4,0,10,0,0,15
Algeria,09/04/2009,14,0,-1,0,4,8,0,25
Algeria,10/04/2009,3,0,-2,0,14,9,0,24
Algeria,11/04/2009,10,0,0,0,0,2,0,12
Algeria,12/04/2009,2,0,-2,0,0,3,0,3
Algeria,13/04/2009,14,0,0,0,0,0,0,14
Algeria,14/04/2009,15,0,0,0,3,0,0,18
Algeria,15/04/2009,13,0,0,0,0,0,0,13
Algeria,16/04/2009,0,0,0,0,0,0,0,0
Algeria,17/04/2009,0,0,0,0,9,0,0,9
Algeria,18/04/2009,1,0,0,0,3,0,0,4
Algeria,19/04/2009,1,0,0,0,-2,1,0,0
Algeria,20/04/2009,0,0,0,0,0,1,0,1
Algeria,21/04/2009,2,0,0,0,3,0,0,5
Algeria,22/04/2009,12,0,0,0,7,6,0,25
Algeria,23/04/2009,10,0,0,0,-3,9,0,16
Algeria,24/04/2009,5,0,0,0,10,3,0,18
Algeria,25/04/2009,5,0,0,0,0,3,0,8
Algeria,26/04/2009,13,0,0,0,24,0,0,37
Algeria,27/04/2009,0,0,0,0,-1,0,0,-1
Algeria,28/04/2009,-1,0,-2,0,3,0,0,0
Algeria,29/04/2009,6,0,0,0,-4,3,0,5
Algeria,30/04/2009,40,0,0,0,6,0,0,46
Bangladesh,01/04/2009,13,0,0,0,1,2,0,16
Bangladesh,02/04/2009,13,0,-4,0,3,11,0,23
Bangladesh,03/04/2009,9,0,-6,0,2,0,0,5
Bangladesh,04/04/2009,3,0,0,0,0,0,0,3
Bangladesh,05/04/2009,14,0,0,0,3,1,0,18
Bangladesh,06/04/2009,19,0,-2,0,-6,7,0,18
Bangladesh,07/04/2009,16,2,0,0,7,9,0,34
Bangladesh,08/04/2009,13,0,0,0,9,2,0,24
Bangladesh,09/04/2009,23,0,0,0,0,0,0,23
Bangladesh,10/04/2009,10,0,0,0,3,3,0,16
Bangladesh,11/04/2009,19,0,3,0,6,5,0,33
Bangladesh,12/04/2009,11,0,0,0,15,11,0,37
Bangladesh,13/04/2009,11,0,0,0,6,2,0,19
Bangladesh,14/04/2009,31,0,0,0,3,1,0,35
Bangladesh,15/04/2009,9,0,2,0,1,2,0,14
Bangladesh,16/04/2009,4,0,0,0,24,0,0,28
Bangladesh,17/04/2009,18,0,0,0,3,0,0,21
Bangladesh,18/04/2009,19,0,-2,0,9,4,0,30
Bangladesh,19/04/2009,18,0,0,0,6,2,0,26
Bangladesh,20/04/2009,3,0,0,0,12,0,0,15
Bangladesh,21/04/2009,4,0,0,0,0,4,0,8
Bangladesh,22/04/2009,6,0,0,0,6,0,0,12
Bangladesh,23/04/2009,4,0,0,0,3,0,0,7
Bangladesh,24/04/2009,13,0,0,0,0,4,0,17
Bangladesh,25/04/2009,7,0,0,0,4,1,0,12
Bangladesh,26/04/2009,12,0,1,0,3,0,0,16
Bangladesh,27/04/2009,30,0,-4,0,6,0,0,32
Bangladesh,28/04/2009,21,0,0,0,0,0,0,21
Bangladesh,29/04/2009,3,0,0,0,3,5,0,11
Bangladesh,30/04/2009,20,0,0,0,6,12,0,38
Cameroon,01/04/2009,0,0,0,0,0,0,0,0
Cameroon,02/04/2009,1,0,0,0,0,0,0,1
Cameroon,03/04/2009,1,0,0,0,0,0,0,1
Cameroon,04/04/2009,-1,0,0,0,0,0,0,-1
Cameroon,05/04/2009,0,0,0,0,0,0,0,0
Cameroon,06/04/2009,2,0,0,0,0,0,0,2
Cameroon,07/04/2009,0,0,0,0,0,0,0,0
Cameroon,08/04/2009,6,0,0,0,0,0,0,6
Cameroon,09/04/2009,2,0,0,0,0,0,0,2
Cameroon,10/04/2009,0,0,0,0,-2,0,0,-2
Cameroon,11/04/2009,0,0,0,0,0,0,0,0
Cameroon,12/04/2009,1,0,0,0,10,4,0,15
Cameroon,13/04/2009,6,0,0,0,-2,0,0,4
Cameroon,14/04/2009,0,0,0,0,0,0,0,0
Cameroon,15/04/2009,0,0,0,0,0,0,0,0
Cameroon,16/04/2009,0,0,0,0,0,0,0,0
Cameroon,17/04/2009,1,0,0,0,6,0,0,7
Cameroon,18/04/2009,1,0,0,0,-1,2,0,2
Cameroon,19/04/2009,0,0,0,0,0,0,0,0
Cameroon,20/04/2009,1,0,0,0,0,0,0,1
Cameroon,21/04/2009,0,0,0,0,0,0,0,0
Cameroon,22/04/2009,-3,0,0,0,0,0,0,-3
Cameroon,24/04/2009,0,0,0,0,0,0,0,0
Cameroon,25/04/2009,1,0,0,0,0,3,0,4
Cameroon,26/04/2009,1,0,0,0,0,0,0,1
Cameroon,27/04/2009,2,0,0,0,0,0,0,2
Cameroon,28/04/2009,-1,0,0,0,0,0,0,-1
Cameroon,29/04/2009,0,0,0,0,0,0,0,0
Cameroon,30/04/2009,0,0,0,0,0,0,0,0
China,01/04/2009,146,2,3,0,88,13,0,252
China,02/04/2009,120,4,-11,0,19,12,0,144
China,03/04/2009,101,0,-3,0,28,6,0,132
China,04/04/2009,80,0,1,0,59,1,0,141
China,05/04/2009,144,0,-3,0,15,6,0,162
China,06/04/2009,133,0,-3,0,13,25,0,168
China,07/04/2009,82,10,-11,0,74,24,0,179
China,08/04/2009,153,2,-4,0,61,15,0,227
China,09/04/2009,77,2,-3,0,36,6,0,118
China,10/04/2009,126,4,0,0,27,17,0,174
China,11/04/2009,119,0,5,0,23,33,0,180
China,12/04/2009,61,0,0,0,19,1,0,81
China,13/04/2009,76,0,-1,0,29,14,0,118
China,14/04/2009,50,0,-1,0,9,4,0,62
China,15/04/2009,108,0,-3,0,20,16,0,141
China,16/04/2009,116,0,2,0,41,11,0,170
China,17/04/2009,92,2,-3,0,20,14,0,125
China,18/04/2009,66,0,0,0,22,11,0,99
China,19/04/2009,34,0,-4,0,36,11,0,77
China,20/04/2009,89,6,1,0,30,18,0,144
China,21/04/2009,112,6,4,0,88,11,0,221
China,22/04/2009,101,0,0,0,32,3,0,136
China,23/04/2009,73,0,0,0,-3,3,0,73
China,24/04/2009,83,2,2,0,87,10,0,184
China,25/04/2009,91,0,0,0,32,7,0,130
China,26/04/2009,70,2,-5,0,37,9,0,113
China,27/04/2009,89,2,-3,0,33,5,0,126
China,28/04/2009,98,0,0,0,24,6,0,128
China,29/04/2009,76,0,-2,0,46,11,0,131
China,30/04/2009,97,10,-3,0,49,8,0,161
Egypt,01/04/2009,50,4,1,0,2,3,0,60
Egypt,02/04/2009,13,0,0,0,3,7,0,23
Egypt,03/04/2009,0,0,0,0,20,8,0,28
Egypt,04/04/2009,8,0,-1,0,33,5,0,45
Egypt,05/04/2009,8,0,0,0,13,1,0,22
Egypt,06/04/2009,19,0,-1,0,11,1,0,30
Egypt,07/04/2009,19,0,0,0,12,0,0,31
Egypt,08/04/2009,18,0,0,0,26,3,0,47
Egypt,09/04/2009,31,0,0,0,21,0,0,52
Egypt,10/04/2009,22,0,1,0,51,1,0,75
Egypt,11/04/2009,47,0,1,0,24,0,0,72
Egypt,12/04/2009,43,4,2,0,6,0,0,55
Egypt,13/04/2009,125,0,0,0,36,0,0,161
Egypt,14/04/2009,10,0,0,0,20,2,0,32
Egypt,15/04/2009,73,0,-6,0,91,12,0,170
Egypt,16/04/2009,78,0,0,0,33,3,0,114
Egypt,17/04/2009,26,0,0,0,18,6,0,50
Egypt,18/04/2009,44,0,0,0,32,6,0,82
Egypt,19/04/2009,46,0,0,0,26,2,0,74
Egypt,20/04/2009,54,0,0,0,-4,1,0,51
Egypt,21/04/2009,9,2,1,0,22,1,0,35
Egypt,22/04/2009,60,0,0,0,31,-8,0,83
Egypt,23/04/2009,44,0,0,0,9,0,0,53
Egypt,24/04/2009,35,0,1,0,38,2,0,76
Egypt,25/04/2009,20,0,0,0,11,5,0,36
Egypt,26/04/2009,15,0,1,0,23,1,0,40
Egypt,27/04/2009,18,0,-1,0,3,8,0,28
Egypt,28/04/2009,34,0,1,0,12,0,0,47
Egypt,29/04/2009,101,2,0,0,1,0,0,104
Egypt,30/04/2009,65,0,0,0,-3,0,0,62
Eritrea,01/04/2009,2,0,0,0,6,0,0,8
Eritrea,02/04/2009,3,0,0,0,12,0,0,15
Eritrea,03/04/2009,10,0,0,0,0,0,0,10
Eritrea,04/04/2009,3,0,0,0,6,0,0,9
Eritrea,07/04/2009,14,0,0,0,0,0,0,14
Eritrea,08/04/2009,38,0,1,0,0,0,0,39
Eritrea,09/04/2009,0,0,0,0,0,0,0,0
Eritrea,10/04/2009,1,0,0,0,0,0,0,1
Eritrea,11/04/2009,1,0,0,0,0,0,0,1
Eritrea,12/04/2009,1,0,0,0,0,0,0,1
Eritrea,13/04/2009,0,0,0,0,0,0,0,0
Eritrea,14/04/2009,0,0,0,0,3,2,0,5
Eritrea,15/04/2009,6,0,0,0,0,0,0,6
Eritrea,16/04/2009,0,0,0,0,6,0,0,6
Eritrea,17/04/2009,2,0,0,0,0,0,0,2
Eritrea,18/04/2009,0,0,0,0,-2,0,0,-2
Eritrea,20/04/2009,0,0,0,0,0,0,0,0
Eritrea,21/04/2009,3,0,1,0,-6,0,0,-2
Eritrea,22/04/2009,4,0,0,0,0,2,0,6
Eritrea,23/04/2009,3,0,0,0,0,0,0,3
Eritrea,24/04/2009,10,0,0,0,0,0,0,10
Eritrea,25/04/2009,14,0,0,0,-3,0,0,11
Eritrea,26/04/2009,0,0,0,0,0,0,0,0
Eritrea,27/04/2009,2,0,0,0,3,6,0,11
Eritrea,28/04/2009,1,0,0,0,0,0,0,1
Eritrea,29/04/2009,10,0,0,0,3,0,0,13
Eritrea,30/04/2009,3,0,0,0,3,0,0,6
Georgia,01/04/2009,3,0,1,0,0,1,0,5
Georgia,02/04/2009,12,0,1,0,10,1,0,24
Georgia,03/04/2009,14,0,0,0,-1,3,0,16
Georgia,04/04/2009,4,0,0,0,0,2,0,6
Georgia,05/04/2009,17,0,0,0,-2,0,0,15
Georgia,06/04/2009,24,0,0,0,6,3,0,33
Georgia,07/04/2009,6,0,-1,0,3,1,0,9
Georgia,08/04/2009,21,0,0,0,3,1,0,25
Georgia,09/04/2009,39,0,0,0,27,7,0,73
Georgia,10/04/2009,21,0,-2,0,6,1,0,26
Georgia,11/04/2009,11,0,-2,0,-1,9,0,17
Georgia,12/04/2009,9,0,0,0,1,0,0,10
Georgia,13/04/2009,8,0,0,0,-4,6,0,10
Georgia,14/04/2009,6,2,-2,0,0,3,0,9
Georgia,15/04/2009,14,2,0,0,2,0,0,18
Georgia,16/04/2009,3,0,1,0,1,4,0,9
Georgia,17/04/2009,16,0,0,0,6,0,0,22
Georgia,18/04/2009,19,0,0,0,9,0,0,28
Georgia,19/04/2009,0,0,1,0,0,0,0,1
Georgia,20/04/2009,3,0,0,0,9,1,0,13
Georgia,21/04/2009,10,0,0,0,7,5,0,22
Georgia,22/04/2009,3,0,0,0,7,0,0,10
Georgia,23/04/2009,-3,0,0,0,0,0,0,-3
Georgia,24/04/2009,30,0,0,0,0,3,0,33
Georgia,25/04/2009,58,0,0,0,0,1,0,59
Georgia,26/04/2009,60,0,0,0,4,2,0,66
Georgia,27/04/2009,37,0,-4,0,5,4,0,42
Georgia,28/04/2009,43,0,0,0,18,7,0,68
Georgia,29/04/2009,17,0,0,0,13,1,0,31
Georgia,30/04/2009,47,0,-2,0,24,10,0,79
India,01/04/2009,93,2,0,0,9,14,0,118
India,02/04/2009,75,0,-7,0,17,4,0,89
India,03/04/2009,105,0,0,0,-2,6,0,109
India,04/04/2009,30,0,0,0,-16,4,0,18
India,05/04/2009,42,0,0,0,-2,2,0,42
India,06/04/2009,88,4,-2,0,3,4,0,97
India,07/04/2009,61,0,-1,0,13,4,0,77
India,08/04/2009,30,2,-2,0,16,4,0,50
India,09/04/2009,45,0,0,0,19,6,0,70
India,10/04/2009,36,0,-1,0,2,5,0,42
India,11/04/2009,34,4,-1,0,10,4,0,51
India,12/04/2009,38,0,0,0,19,10,0,67
India,13/04/2009,82,0,0,0,3,2,0,87
India,14/04/2009,21,0,0,0,3,3,0,27
India,15/04/2009,56,2,0,0,14,13,0,85
India,16/04/2009,61,0,1,0,-2,7,0,67
India,17/04/2009,37,0,-2,0,7,11,0,53
India,18/04/2009,26,0,0,0,11,12,0,49
India,19/04/2009,31,0,-2,0,16,6,0,51
India,20/04/2009,28,0,-2,0,18,11,0,55
India,21/04/2009,34,0,-1,0,7,5,0,45
India,22/04/2009,73,0,-1,0,2,6,0,80
India,23/04/2009,18,0,1,0,3,3,0,25
India,24/04/2009,87,2,-3,0,6,7,0,99
India,25/04/2009,64,2,-2,0,0,0,0,64
India,26/04/2009,78,8,0,0,-10,2,0,78
India,27/04/2009,55,0,-1,0,28,7,0,89
India,28/04/2009,93,0,-6,0,42,8,0,137
India,29/04/2009,42,0,2,0,8,4,0,56
India,30/04/2009,60,0,5,0,9,3,0,77
Iran,01/04/2009,47,0,0,0,70,3,0,120
Iran,02/04/2009,45,0,1,0,16,5,0,67
Iran,03/04/2009,64,0,-4,0,13,0,0,73
Iran,04/04/2009,19,2,-3,0,-9,6,0,15
Iran,05/04/2009,137,2,-1,0,-2,13,0,149
Iran,06/04/2009,55,2,3,0,24,10,0,94
Iran,07/04/2009,98,0,1,0,31,6,0,136
Iran,08/04/2009,62,0,-2,0,59,7,0,126
Iran,09/04/2009,62,0,0,0,70,6,0,138
Iran,10/04/2009,63,0,2,0,3,5,0,73
Iran,11/04/2009,66,0,0,0,24,2,0,92
Iran,12/04/2009,29,0,0,0,30,2,0,61
Iran,13/04/2009,49,0,-2,0,29,5,0,81
Iran,14/04/2009,28,0,0,0,37,3,0,68
Iran,15/04/2009,72,0,0,0,55,4,0,131
Iran,16/04/2009,46,0,0,0,32,5,0,83
Iran,17/04/2009,14,0,0,0,19,1,0,34
Iran,18/04/2009,71,2,0,0,123,8,0,204
Iran,19/04/2009,112,0,1,0,93,7,0,213
Iran,20/04/2009,170,0,2,0,92,3,0,267
Iran,21/04/2009,155,6,0,0,29,19,0,209
Iran,22/04/2009,83,4,1,0,44,5,0,137
Iran,23/04/2009,38,0,0,0,51,1,0,90
Iran,24/04/2009,182,2,2,0,34,84,0,304
Iran,25/04/2009,94,0,0,0,39,57,0,190
Iran,26/04/2009,48,0,3,0,38,8,0,97
Iran,27/04/2009,70,0,0,0,37,6,0,113
Iran,28/04/2009,63,0,-3,0,42,14,0,116
Iran,29/04/2009,29,0,2,0,52,7,0,90
Iran,30/04/2009,19,4,0,0,3,6,0,32
Iraq,01/04/2009,85,6,2,0,21,15,0,129
Iraq,02/04/2009,64,2,0,0,1,13,0,80
Iraq,03/04/2009,60,2,-1,0,18,1,0,80
Iraq,04/04/2009,40,2,0,0,6,5,0,53
Iraq,05/04/2009,29,2,1,0,3,0,0,35
Iraq,06/04/2009,34,16,1,0,31,18,0,100
Iraq,07/04/2009,122,2,0,0,32,16,0,172
Iraq,08/04/2009,76,0,0,0,4,2,0,82
Iraq,09/04/2009,78,2,-5,0,44,15,0,134
Iraq,10/04/2009,151,6,0,0,21,17,0,195
Iraq,11/04/2009,64,0,0,0,22,27,0,113
Iraq,12/04/2009,104,0,1,0,38,7,0,150
Iraq,13/04/2009,156,0,2,0,53,13,0,224
Iraq,14/04/2009,42,0,0,0,7,9,0,58
Iraq,15/04/2009,155,2,-2,0,59,29,0,243
Iraq,16/04/2009,87,0,1,0,67,13,0,168
Iraq,17/04/2009,88,0,-2,0,10,5,0,101
Iraq,18/04/2009,35,0,0,0,13,16,0,64
Iraq,19/04/2009,21,0,-5,0,20,7,0,43
Iraq,20/04/2009,72,0,0,0,18,12,0,102
Iraq,21/04/2009,75,0,2,0,38,13,0,128
Iraq,22/04/2009,65,2,-3,0,40,13,0,117
Iraq,23/04/2009,38,0,0,0,17,5,0,60
Iraq,24/04/2009,94,0,0,0,15,12,0,121
Iraq,25/04/2009,134,2,0,0,38,27,0,201
Iraq,26/04/2009,128,0,2,0,19,28,0,177
Iraq,27/04/2009,226,0,3,0,29,14,0,272
Iraq,28/04/2009,135,0,3,0,29,5,0,172
Iraq,29/04/2009,125,0,0,0,23,28,0,176
Iraq,30/04/2009,217,2,-2,0,53,21,0,291
Morocco,01/04/2009,7,0,0,0,2,0,0,9
Morocco,02/04/2009,-1,0,0,0,9,0,0,8
Morocco,03/04/2009,3,0,0,0,-4,0,0,-1
Morocco,04/04/2009,7,0,0,0,3,2,0,12
Morocco,05/04/2009,0,0,0,0,9,2,0,11
Morocco,06/04/2009,0,0,0,0,0,0,0,0
Morocco,07/04/2009,0,0,0,0,6,0,0,6
Morocco,08/04/2009,12,0,0,0,0,14,0,26
Morocco,09/04/2009,8,0,0,0,0,1,0,9
Morocco,10/04/2009,3,0,0,0,0,0,0,3
Morocco,11/04/2009,5,0,6,0,0,0,0,11
Morocco,12/04/2009,0,0,0,0,3,0,0,3
Morocco,13/04/2009,0,0,0,0,0,0,0,0
Morocco,14/04/2009,0,0,0,0,0,0,0,0
Morocco,15/04/2009,27,2,0,0,2,2,0,33
Morocco,16/04/2009,8,0,0,0,3,1,0,12
Morocco,17/04/2009,-1,0,0,0,0,1,0,0
Morocco,18/04/2009,-1,0,0,0,3,0,0,2
Morocco,19/04/2009,0,0,0,0,0,0,0,0
Morocco,20/04/2009,3,0,0,0,3,2,0,8
Morocco,21/04/2009,4,0,-1,0,3,0,0,6
Morocco,22/04/2009,5,0,0,0,9,1,0,15
Morocco,23/04/2009,0,0,0,0,0,2,0,2
Morocco,24/04/2009,8,0,0,0,3,0,0,11
Morocco,25/04/2009,6,0,0,0,0,0,0,6
Morocco,26/04/2009,0,0,0,0,-6,0,0,-6
Morocco,27/04/2009,3,0,0,0,0,0,0,3
Morocco,28/04/2009,0,0,0,0,12,0,0,12
Morocco,29/04/2009,1,0,0,0,3,1,0,5
Morocco,30/04/2009,10,0,0,0,-2,0,0,8
Nigeria,01/04/2009,10,0,0,0,32,6,0,48
Nigeria,02/04/2009,5,0,0,0,5,0,0,10
Nigeria,03/04/2009,0,0,-6,0,0,0,0,-6
Nigeria,04/04/2009,5,0,0,0,9,0,0,14
Nigeria,05/04/2009,18,0,0,0,0,0,0,18
Nigeria,06/04/2009,25,0,0,0,46,0,0,71
Nigeria,07/04/2009,16,0,0,0,20,1,0,37
Nigeria,08/04/2009,5,0,0,0,12,1,0,18
Nigeria,09/04/2009,29,0,0,0,7,3,0,39
Nigeria,10/04/2009,10,0,0,0,15,12,0,37
Nigeria,11/04/2009,36,0,0,0,12,3,0,51
Nigeria,12/04/2009,4,0,0,0,17,5,0,26
Nigeria,13/04/2009,25,0,-1,0,-2,0,0,22
Nigeria,14/04/2009,0,0,0,0,0,0,0,0
Nigeria,15/04/2009,36,0,0,0,40,2,0,78
Nigeria,16/04/2009,26,0,0,0,28,3,0,57
Nigeria,17/04/2009,18,0,0,0,0,0,0,18
Nigeria,18/04/2009,5,0,0,0,3,0,0,8
Nigeria,19/04/2009,15,0,0,0,-15,2,0,2
Nigeria,20/04/2009,13,0,-4,0,-1,0,0,8
Nigeria,21/04/2009,31,0,-2,0,0,5,0,34
Nigeria,22/04/2009,35,0,0,0,48,6,0,89
Nigeria,23/04/2009,3,0,0,0,14,3,0,20
Nigeria,24/04/2009,10,2,0,0,17,1,0,30
Nigeria,25/04/2009,8,0,0,0,0,0,0,8
Nigeria,26/04/2009,10,0,1,0,-8,0,0,3
Nigeria,27/04/2009,23,2,0,0,13,2,0,40
Nigeria,28/04/2009,24,0,0,0,7,2,0,33
Nigeria,29/04/2009,12,0,0,0,8,4,0,24
Nigeria,30/04/2009,15,0,0,0,-8,0,0,7
Pakistan,01/04/2009,190,2,0,0,41,4,0,237
Pakistan,02/04/2009,85,2,-1,0,45,10,0,141
Pakistan,03/04/2009,94,0,-1,0,38,3,0,134
Pakistan,04/04/2009,163,0,-6,0,14,39,0,210
Pakistan,05/04/2009,115,0,-1,0,-20,53,0,147
Pakistan,06/04/2009,136,6,0,0,4,13,0,159
Pakistan,07/04/2009,90,2,0,0,25,3,0,120
Pakistan,08/04/2009,131,2,0,0,33,14,0,180
Pakistan,09/04/2009,152,4,-3,0,90,25,0,268
Pakistan,10/04/2009,206,4,0,0,79,11,0,300
Pakistan,11/04/2009,65,2,3,0,36,3,0,109
Pakistan,12/04/2009,88,4,-5,0,13,3,0,103
Pakistan,13/04/2009,90,0,0,0,28,8,0,126
Pakistan,14/04/2009,55,0,1,0,10,3,0,69
Pakistan,15/04/2009,125,2,0,0,45,9,0,181
Pakistan,16/04/2009,135,2,0,0,60,5,0,202
Pakistan,17/04/2009,210,2,1,0,106,2,0,321
Pakistan,18/04/2009,135,12,1,0,15,10,0,173
Pakistan,19/04/2009,113,2,-2,0,22,5,0,140
Pakistan,20/04/2009,67,4,0,0,57,3,0,131
Pakistan,21/04/2009,73,0,0,0,52,7,0,132
Pakistan,22/04/2009,153,2,3,0,57,6,0,221
Pakistan,23/04/2009,44,0,0,0,54,7,0,105
Pakistan,24/04/2009,100,2,0,0,53,17,0,172
Pakistan,25/04/2009,84,0,0,0,11,20,0,115
Pakistan,26/04/2009,83,0,0,0,0,9,0,92
Pakistan,27/04/2009,109,2,1,0,34,4,0,150
Pakistan,28/04/2009,119,2,0,0,126,3,0,250
Pakistan,29/04/2009,177,2,1,0,94,15,0,289
Pakistan,30/04/2009,119,2,2,0,56,8,0,187
Sierra Leone,01/04/2009,6,0,0,0,-2,1,0,5
Sierra Leone,02/04/2009,7,0,0,0,10,2,0,19
Sierra Leone,03/04/2009,0,0,0,0,6,0,0,6
Sierra Leone,04/04/2009,0,0,0,0,0,0,0,0
Sierra Leone,05/04/2009,3,0,0,0,0,0,0,3
Sierra Leone,06/04/2009,19,0,0,0,3,2,0,24
Sierra Leone,07/04/2009,0,0,0,0,1,0,0,1
Sierra Leone,08/04/2009,12,0,0,0,25,0,0,37
Sierra Leone,09/04/2009,1,0,0,0,10,0,0,11
Sierra Leone,10/04/2009,3,0,0,0,9,0,0,12
Sierra Leone,12/04/2009,0,0,0,0,0,0,0,0
Sierra Leone,13/04/2009,6,0,0,0,0,0,0,6
Sierra Leone,15/04/2009,2,0,0,0,0,0,0,2
Sierra Leone,16/04/2009,0,0,0,0,0,0,0,0
Sierra Leone,17/04/2009,0,0,0,0,33,0,0,33
Sierra Leone,18/04/2009,9,0,0,0,0,0,0,9
Sierra Leone,19/04/2009,0,0,0,0,1,0,0,1
Sierra Leone,20/04/2009,0,0,0,0,0,0,0,0
Sierra Leone,21/04/2009,1,0,0,0,0,0,0,1
Sierra Leone,22/04/2009,5,0,0,0,18,0,0,23
Sierra Leone,23/04/2009,0,0,0,0,3,0,0,3
Sierra Leone,24/04/2009,0,0,0,0,-2,0,0,-2
Sierra Leone,25/04/2009,0,0,0,0,3,0,0,3
Sierra Leone,26/04/2009,2,0,0,0,0,1,0,3
Sierra Leone,27/04/2009,9,0,0,0,0,0,0,9
Sierra Leone,28/04/2009,2,0,0,0,0,1,0,3
Sierra Leone,29/04/2009,8,0,0,0,0,0,0,8
Sierra Leone,30/04/2009,0,0,0,0,0,0,0,0
Somalia,01/04/2009,20,0,0,0,0,0,0,20
Somalia,02/04/2009,41,0,0,0,28,2,0,71
Somalia,03/04/2009,39,0,0,0,-25,6,0,20
Somalia,04/04/2009,24,0,0,0,-4,7,0,27
Somalia,05/04/2009,22,0,0,0,7,7,0,36
Somalia,06/04/2009,32,0,1,0,43,0,0,76
Somalia,07/04/2009,59,0,2,0,10,1,0,72
Somalia,08/04/2009,354,0,-2,0,135,22,0,509
Somalia,09/04/2009,306,6,1,0,247,40,0,600
Somalia,10/04/2009,310,6,5,0,279,46,0,646
Somalia,11/04/2009,300,0,0,0,463,42,0,805
Somalia,12/04/2009,438,2,1,0,269,24,0,734
Somalia,13/04/2009,408,0,0,0,199,24,0,631
Somalia,14/04/2009,180,0,2,0,144,27,0,353
Somalia,15/04/2009,418,6,3,0,210,69,0,706
Somalia,16/04/2009,284,0,5,0,68,42,0,399
Somalia,17/04/2009,166,2,1,0,75,21,0,265
Somalia,18/04/2009,160,6,0,0,84,22,0,272
Somalia,19/04/2009,156,2,0,0,132,18,0,308
Somalia,20/04/2009,102,2,0,0,-3,16,0,117
Somalia,21/04/2009,186,6,-2,0,86,13,0,289
Somalia,22/04/2009,119,2,0,0,93,12,0,226
Somalia,23/04/2009,71,6,-6,0,67,4,0,142
Somalia,24/04/2009,61,4,0,0,54,7,0,126
Somalia,25/04/2009,51,0,0,0,35,4,0,90
Somalia,26/04/2009,434,0,0,0,18,4,0,456
Somalia,27/04/2009,143,0,0,0,48,2,0,193
Somalia,28/04/2009,107,4,-1,0,70,14,0,194
Somalia,29/04/2009,75,0,0,0,97,5,0,177
Somalia,30/04/2009,46,0,1,0,52,14,0,113
Syria,01/04/2009,1,0,0,0,7,2,0,10
Syria,02/04/2009,18,0,0,0,4,0,0,22
Syria,03/04/2009,10,0,0,0,10,0,0,20
Syria,04/04/2009,10,0,0,0,3,0,0,13
Syria,05/04/2009,21,0,0,0,4,1,0,26
Syria,06/04/2009,14,0,0,0,9,2,0,25
Syria,07/04/2009,37,0,0,0,9,2,0,48
Syria,08/04/2009,-10,0,0,0,3,2,0,-5
Syria,09/04/2009,0,0,0,0,24,0,0,24
Syria,10/04/2009,14,0,0,0,7,0,0,21
Syria,11/04/2009,6,0,0,0,21,5,0,32
Syria,12/04/2009,5,0,0,0,1,0,0,6
Syria,13/04/2009,29,0,0,0,6,29,0,64
Syria,14/04/2009,25,0,0,0,3,8,0,36
Syria,15/04/2009,22,0,0,0,26,12,0,60
Syria,16/04/2009,18,0,1,0,3,0,0,22
Syria,17/04/2009,24,0,0,0,0,0,0,24
Syria,18/04/2009,3,0,0,0,6,0,0,9
Syria,19/04/2009,4,0,0,0,18,0,0,22
Syria,20/04/2009,34,0,0,0,7,0,0,41
Syria,21/04/2009,18,0,0,0,67,6,0,91
Syria,22/04/2009,15,2,0,0,7,2,0,26
Syria,23/04/2009,5,0,0,0,-3,0,0,2
Syria,24/04/2009,0,0,0,0,21,0,0,21
Syria,25/04/2009,7,0,0,0,12,0,0,19
Syria,26/04/2009,43,0,3,0,15,0,0,61
Syria,27/04/2009,2,0,0,0,19,0,0,21
Syria,28/04/2009,6,0,0,0,21,2,0,29
Syria,29/04/2009,37,0,0,0,-5,7,0,39
Syria,30/04/2009,51,0,0,0,3,0,0,54
Yemen,01/04/2009,14,0,0,0,21,0,0,35
Yemen,02/04/2009,8,0,0,0,-3,0,0,5
Yemen,03/04/2009,8,0,0,0,-2,2,0,8
Yemen,04/04/2009,8,0,0,0,6,0,0,14
Yemen,05/04/2009,6,0,-2,0,9,0,0,13
Yemen,06/04/2009,10,0,8,0,6,0,0,24
Yemen,07/04/2009,15,0,1,0,14,0,0,30
Yemen,08/04/2009,35,4,0,0,25,2,0,66
Yemen,09/04/2009,13,0,0,0,18,2,0,33
Yemen,10/04/2009,17,2,0,0,27,0,0,46
Yemen,11/04/2009,5,0,-4,0,6,0,0,7
Yemen,12/04/2009,10,0,0,0,-8,3,0,5
Yemen,13/04/2009,6,0,0,0,9,2,0,17
Yemen,14/04/2009,27,0,0,0,11,8,0,46
Yemen,15/04/2009,36,0,0,0,19,18,0,73
Yemen,16/04/2009,16,0,0,0,3,1,0,20
Yemen,17/04/2009,3,0,0,0,0,0,0,3
Yemen,18/04/2009,13,0,0,0,29,0,0,42
Yemen,19/04/2009,10,4,0,0,4,3,0,21
Yemen,20/04/2009,46,0,0,0,-22,5,0,29
Yemen,21/04/2009,23,0,0,0,-5,2,0,20
Yemen,22/04/2009,16,0,0,0,0,2,0,18
Yemen,23/04/2009,0,0,0,0,3,0,0,3
Yemen,24/04/2009,5,0,0,0,-1,1,0,5
Yemen,25/04/2009,1,0,0,0,3,0,0,4
Yemen,26/04/2009,49,2,0,0,1,6,0,58
Yemen,27/04/2009,31,0,0,0,-1,2,0,32
Yemen,28/04/2009,11,2,0,0,-4,0,0,9
Yemen,29/04/2009,5,0,0,0,-1,0,0,4
Yemen,30/04/2009,0,0,0,0,0,0,0,0
Afghanistan,01/05/2009,167,4,0,0,40,12,0,223
Afghanistan,02/05/2009,231,0,-1,0,24,10,0,264
Afghanistan,03/05/2009,278,0,-2,0,32,24,0,332
Afghanistan,04/05/2009,248,0,0,0,26,20,0,294
Afghanistan,05/05/2009,279,0,0,0,1,14,0,294
Afghanistan,06/05/2009,399,0,0,0,30,30,0,459
Afghanistan,07/05/2009,354,10,-5,0,41,34,0,434
Afghanistan,08/05/2009,249,10,5,0,24,10,0,298
Afghanistan,09/05/2009,254,4,-3,0,18,15,0,288
Afghanistan,10/05/2009,242,2,2,0,25,7,0,278
Afghanistan,11/05/2009,351,0,-16,0,91,52,0,478
Afghanistan,12/05/2009,349,4,-5,0,85,37,0,470
Afghanistan,13/05/2009,370,2,-1,0,-1,45,0,415
Afghanistan,14/05/2009,251,0,0,0,17,45,0,313
Afghanistan,15/05/2009,266,0,1,0,43,16,0,326
Afghanistan,16/05/2009,207,6,0,0,3,13,0,229
Afghanistan,17/05/2009,147,0,1,0,17,7,0,172
Afghanistan,18/05/2009,209,0,1,0,17,11,0,238
Afghanistan,19/05/2009,223,0,-2,0,56,12,0,289
Afghanistan,20/05/2009,171,0,-2,0,42,7,0,218
Afghanistan,21/05/2009,179,6,0,0,78,13,0,276
Afghanistan,22/05/2009,231,4,0,0,60,17,0,312
Afghanistan,23/05/2009,213,0,0,0,45,7,0,265
Afghanistan,24/05/2009,331,0,0,0,66,16,0,413
Afghanistan,25/05/2009,143,8,0,0,31,27,0,209
Afghanistan,26/05/2009,245,0,0,0,15,9,0,269
Afghanistan,27/05/2009,122,4,1,0,10,13,0,150
Afghanistan,28/05/2009,180,0,0,0,34,25,0,239
Afghanistan,29/05/2009,212,0,0,0,28,31,0,271
Afghanistan,30/05/2009,151,0,0,0,13,11,0,175
Afghanistan,31/05/2009,177,2,0,0,21,5,0,205
Albania,01/05/2009,20,0,-1,0,9,16,0,44
Albania,02/05/2009,1,0,0,0,0,0,0,1
Albania,03/05/2009,3,0,0,0,-2,0,0,1
Albania,04/05/2009,18,0,0,0,3,10,0,31
Albania,05/05/2009,0,0,0,0,7,3,0,10
Albania,06/05/2009,1,0,0,0,6,9,0,16
Albania,07/05/2009,2,0,0,0,38,0,0,40
Albania,08/05/2009,5,0,0,0,9,0,0,14
Albania,09/05/2009,2,0,0,0,9,0,0,11
Albania,10/05/2009,2,0,0,0,0,0,0,2
Albania,11/05/2009,5,0,0,0,15,2,0,22
Albania,12/05/2009,1,0,-1,0,6,0,0,6
Albania,13/05/2009,5,0,0,0,0,1,0,6
Albania,14/05/2009,0,0,0,0,0,3,0,3
Albania,15/05/2009,2,0,-2,0,0,0,0,0
Albania,16/05/2009,1,0,0,0,0,0,0,1
Albania,17/05/2009,-1,0,0,0,0,1,0,0
Albania,18/05/2009,13,0,0,0,-2,0,0,11
Albania,19/05/2009,6,0,0,0,-2,0,0,4
Albania,20/05/2009,1,0,0,0,3,0,0,4
Albania,21/05/2009,5,0,0,0,0,5,0,10
Albania,22/05/2009,3,0,0,0,0,0,0,3
Albania,23/05/2009,5,0,0,0,0,0,0,5
Albania,24/05/2009,0,0,0,0,0,0,0,0
Albania,26/05/2009,14,0,0,0,6,4,0,24
Albania,27/05/2009,13,0,0,0,4,0,0,17
Albania,28/05/2009,1,0,0,0,-2,0,0,-1
Albania,29/05/2009,5,0,0,0,0,4,0,9
Albania,30/05/2009,6,0,0,0,0,0,0,6
Albania,31/05/2009,0,0,0,0,0,0,0,0
Algeria,01/05/2009,6,0,0,0,9,1,0,16
Algeria,02/05/2009,3,0,0,0,4,0,0,7
Algeria,03/05/2009,0,0,0,0,-1,0,0,-1
Algeria,04/05/2009,6,0,0,0,6,0,0,12
Algeria,05/05/2009,2,0,0,0,-4,0,0,-2
Algeria,06/05/2009,17,0,0,0,3,0,0,20
Algeria,07/05/2009,12,0,0,0,1,0,0,13
Algeria,08/05/2009,4,0,0,0,0,0,0,4
Algeria,09/05/2009,20,0,-2,0,23,1,0,42
Algeria,10/05/2009,14,0,1,0,0,0,0,15
Algeria,11/05/2009,14,0,-2,0,7,0,0,19
Algeria,12/05/2009,21,0,0,0,23,0,0,44
Algeria,13/05/2009,5,0,0,0,3,0,0,8
Algeria,14/05/2009,11,0,0,0,0,0,0,11
Algeria,15/05/2009,46,0,-2,0,43,4,0,91
Algeria,16/05/2009,20,0,0,0,44,5,0,69
Algeria,17/05/2009,12,0,0,0,-1,0,0,11
Algeria,18/05/2009,13,0,0,0,19,0,0,32
Algeria,19/05/2009,12,0,0,0,12,0,0,24
Algeria,20/05/2009,5,0,0,0,39,0,0,44
Algeria,21/05/2009,6,0,0,0,53,0,0,59
Algeria,22/05/2009,4,0,0,0,8,0,0,12
Algeria,23/05/2009,3,0,0,0,7,0,0,10
Algeria,24/05/2009,4,0,0,0,3,0,0,7
Algeria,25/05/2009,-15,6,1,0,3,0,0,-5
Algeria,26/05/2009,8,4,0,0,15,0,0,27
Algeria,27/05/2009,16,0,0,0,8,0,0,24
Algeria,28/05/2009,8,0,0,0,0,0,0,8
Algeria,29/05/2009,4,0,0,0,0,1,0,5
Algeria,30/05/2009,0,0,0,0,0,0,0,0
Algeria,31/05/2009,4,0,0,0,0,0,0,4
Bangladesh,01/05/2009,20,2,0,0,0,1,0,23
Bangladesh,02/05/2009,9,0,0,0,7,1,0,17
Bangladesh,03/05/2009,19,0,0,0,-6,3,0,16
Bangladesh,04/05/2009,13,0,1,0,9,0,0,23
Bangladesh,05/05/2009,4,0,0,0,7,1,0,12
Bangladesh,06/05/2009,9,0,0,0,0,3,0,12
Bangladesh,07/05/2009,9,0,0,0,-2,1,0,8
Bangladesh,08/05/2009,8,0,0,0,-3,0,0,5
Bangladesh,09/05/2009,1,0,0,0,0,3,0,4
Bangladesh,10/05/2009,10,0,0,0,6,0,0,16
Bangladesh,11/05/2009,2,0,0,0,0,0,0,2
Bangladesh,12/05/2009,4,0,0,0,0,0,0,4
Bangladesh,13/05/2009,15,0,0,0,9,1,0,25
Bangladesh,14/05/2009,26,0,0,0,12,1,0,39
Bangladesh,15/05/2009,14,0,0,0,6,0,0,20
Bangladesh,16/05/2009,6,0,1,0,3,0,0,10
Bangladesh,17/05/2009,5,0,1,0,0,0,0,6
Bangladesh,18/05/2009,18,0,0,0,6,4,0,28
Bangladesh,19/05/2009,12,0,0,0,16,2,0,30
Bangladesh,20/05/2009,2,0,-3,0,9,2,0,10
Bangladesh,21/05/2009,5,0,0,0,12,2,0,19
Bangladesh,22/05/2009,21,0,0,0,7,4,0,32
Bangladesh,23/05/2009,16,0,0,0,4,3,0,23
Bangladesh,24/05/2009,3,0,0,0,3,3,0,9
Bangladesh,25/05/2009,0,0,0,0,3,2,0,5
Bangladesh,26/05/2009,20,0,0,0,3,6,0,29
Bangladesh,27/05/2009,11,0,0,0,31,6,0,48
Bangladesh,28/05/2009,6,0,1,0,9,8,0,24
Bangladesh,29/05/2009,23,0,0,0,0,2,0,25
Bangladesh,30/05/2009,13,0,0,0,3,2,0,18
Bangladesh,31/05/2009,7,0,0,0,0,0,0,7
Cameroon,01/05/2009,0,0,0,0,0,0,0,0
Cameroon,02/05/2009,0,0,0,0,0,0,0,0
Cameroon,03/05/2009,0,0,0,0,0,0,0,0
Cameroon,04/05/2009,0,4,0,0,-4,0,0,0
Cameroon,05/05/2009,0,0,0,0,0,0,0,0
Cameroon,06/05/2009,0,0,0,0,0,0,0,0
Cameroon,07/05/2009,0,0,0,0,6,1,0,7
Cameroon,08/05/2009,3,0,0,0,15,0,0,18
Cameroon,09/05/2009,-1,0,0,0,0,0,0,-1
Cameroon,10/05/2009,1,0,0,0,0,1,0,2
Cameroon,11/05/2009,-1,0,0,0,3,0,0,2
Cameroon,12/05/2009,0,0,0,0,0,0,0,0
Cameroon,13/05/2009,0,0,0,0,0,0,0,0
Cameroon,14/05/2009,1,0,0,0,0,4,0,5
Cameroon,15/05/2009,5,0,0,0,0,0,0,5
Cameroon,16/05/2009,0,0,0,0,0,0,0,0
Cameroon,17/05/2009,0,0,0,0,0,0,0,0
Cameroon,18/05/2009,1,0,0,0,3,0,0,4
Cameroon,19/05/2009,0,0,0,0,0,0,0,0
Cameroon,20/05/2009,0,0,0,0,0,0,0,0
Cameroon,21/05/2009,2,0,0,0,0,2,0,4
Cameroon,22/05/2009,0,0,0,0,0,0,0,0
Cameroon,23/05/2009,0,0,0,0,0,0,0,0
Cameroon,24/05/2009,1,0,0,0,0,0,0,1
Cameroon,25/05/2009,0,0,0,0,0,0,0,0
Cameroon,26/05/2009,9,0,0,0,0,0,0,9
Cameroon,27/05/2009,3,0,0,0,0,0,0,3
Cameroon,28/05/2009,18,0,0,0,3,1,0,22
Cameroon,29/05/2009,0,0,0,0,0,2,0,2
Cameroon,30/05/2009,-2,0,0,0,0,0,0,-2
Cameroon,31/05/2009,0,0,0,0,3,0,0,3
China,01/05/2009,108,0,-4,0,44,17,0,165
China,02/05/2009,55,0,1,0,36,3,0,95
China,03/05/2009,64,0,-8,0,22,4,0,82
China,04/05/2009,115,8,-1,0,30,14,0,166
China,05/05/2009,81,0,-9,0,67,17,0,156
China,06/05/2009,93,0,0,0,51,7,0,151
China,07/05/2009,95,0,-7,0,34,17,0,139
China,08/05/2009,96,0,0,0,46,13,0,155
China,09/05/2009,56,0,0,0,25,3,0,84
China,10/05/2009,32,0,-12,0,7,7,0,34
China,11/05/2009,75,0,1,0,17,5,0,98
China,12/05/2009,63,0,1,0,33,14,0,111
China,13/05/2009,52,2,1,0,92,17,0,164
China,14/05/2009,102,0,5,0,70,9,0,186
China,15/05/2009,64,2,2,0,48,9,0,125
China,16/05/2009,66,0,1,0,15,4,0,86
China,17/05/2009,36,0,-4,0,27,8,0,67
China,18/05/2009,115,0,-1,0,59,28,0,201
China,19/05/2009,121,2,-1,0,49,5,0,176
China,20/05/2009,86,6,0,0,14,29,0,135
China,21/05/2009,72,4,-1,0,35,16,0,126
China,22/05/2009,86,2,3,0,-13,9,0,87
China,23/05/2009,53,0,0,0,26,4,0,83
China,24/05/2009,39,0,0,0,20,13,0,72
China,25/05/2009,103,2,-2,0,53,22,0,178
China,26/05/2009,124,8,-3,0,23,14,0,166
China,27/05/2009,99,6,1,0,34,16,0,156
China,28/05/2009,88,12,4,0,26,7,0,137
China,29/05/2009,168,2,2,0,11,15,0,198
China,30/05/2009,116,0,-1,0,16,9,0,140
China,31/05/2009,78,0,0,0,11,7,0,96
Egypt,01/05/2009,63,0,0,0,2,4,0,69
Egypt,02/05/2009,88,0,0,0,-2,0,0,86
Egypt,03/05/2009,64,0,0,0,18,6,0,88
Egypt,04/05/2009,50,0,0,0,42,0,0,92
Egypt,05/05/2009,69,0,0,0,30,2,0,101
Egypt,06/05/2009,29,0,0,0,-9,1,0,21
Egypt,07/05/2009,21,0,-2,0,-3,4,0,20
Egypt,08/05/2009,20,2,0,0,8,3,0,33
Egypt,09/05/2009,37,0,1,0,5,1,0,44
Egypt,10/05/2009,15,0,0,0,3,0,0,18
Egypt,11/05/2009,30,2,0,0,6,2,0,40
Egypt,12/05/2009,15,2,0,0,9,3,0,29
Egypt,13/05/2009,41,0,0,0,46,7,0,94
Egypt,14/05/2009,41,0,0,0,18,3,0,62
Egypt,15/05/2009,150,0,0,0,16,0,0,166
Egypt,16/05/2009,77,0,0,0,6,0,0,83
Egypt,17/05/2009,33,0,0,0,9,1,0,43
Egypt,18/05/2009,17,0,-1,0,16,0,0,32
Egypt,19/05/2009,41,0,4,0,15,1,0,61
Egypt,20/05/2009,44,0,0,0,16,5,0,65
Egypt,21/05/2009,36,0,0,0,22,4,0,62
Egypt,22/05/2009,34,0,0,0,6,0,0,40
Egypt,23/05/2009,47,0,0,0,2,7,0,56
Egypt,24/05/2009,29,0,0,0,-2,6,0,33
Egypt,25/05/2009,30,2,0,0,18,2,0,52
Egypt,26/05/2009,86,0,0,0,19,0,0,105
Egypt,27/05/2009,45,2,0,0,6,0,0,53
Egypt,28/05/2009,21,0,0,0,7,4,0,32
Egypt,29/05/2009,26,0,0,0,7,0,0,33
Egypt,30/05/2009,15,0,0,0,-6,0,0,9
Egypt,31/05/2009,103,0,-1,0,0,0,0,102
Eritrea,01/05/2009,6,0,0,0,21,0,0,27
Eritrea,02/05/2009,6,0,0,0,18,0,0,24
Eritrea,03/05/2009,14,0,1,0,11,0,0,26
Eritrea,04/05/2009,15,0,0,0,-5,0,0,10
Eritrea,05/05/2009,0,0,0,0,0,0,0,0
Eritrea,06/05/2009,0,0,0,0,0,0,0,0
Eritrea,07/05/2009,2,0,0,0,0,0,0,2
Eritrea,08/05/2009,9,0,0,0,0,0,0,9
Eritrea,09/05/2009,8,0,0,0,0,0,0,8
Eritrea,10/05/2009,0,0,0,0,0,0,0,0
Eritrea,11/05/2009,3,0,0,0,3,0,0,6
Eritrea,12/05/2009,3,0,0,0,0,0,0,3
Eritrea,13/05/2009,-1,0,0,0,0,0,0,-1
Eritrea,14/05/2009,1,0,-1,0,0,2,0,2
Eritrea,15/05/2009,5,0,-1,0,-6,0,0,-2
Eritrea,16/05/2009,23,0,0,0,0,0,0,23
Eritrea,17/05/2009,40,0,0,0,0,0,0,40
Eritrea,18/05/2009,28,0,0,0,0,0,0,28
Eritrea,19/05/2009,6,0,0,0,3,2,0,11
Eritrea,20/05/2009,1,0,0,0,6,0,0,7
Eritrea,21/05/2009,29,0,0,0,6,0,0,35
Eritrea,22/05/2009,36,0,0,0,2,0,0,38
Eritrea,23/05/2009,45,0,0,0,3,7,0,55
Eritrea,24/05/2009,37,0,0,0,-1,3,0,39
Eritrea,25/05/2009,6,0,0,0,0,8,0,14
Eritrea,26/05/2009,6,0,0,0,3,0,0,9
Eritrea,27/05/2009,7,0,0,0,3,0,0,10
Eritrea,28/05/2009,2,0,0,0,0,0,0,2
Eritrea,29/05/2009,0,0,0,0,9,0,0,9
Eritrea,30/05/2009,2,0,0,0,-1,0,0,1
Eritrea,31/05/2009,0,0,0,0,0,0,0,0
Georgia,01/05/2009,56,0,0,0,19,6,0,81
Georgia,02/05/2009,16,0,0,0,2,2,0,20
Georgia,03/05/2009,10,0,0,0,12,0,0,22
Georgia,04/05/2009,17,0,0,0,3,3,0,23
Georgia,05/05/2009,36,0,1,0,18,12,0,67
Georgia,06/05/2009,53,0,0,0,19,8,0,80
Georgia,07/05/2009,20,4,0,0,4,1,0,29
Georgia,08/05/2009,28,0,0,0,9,0,0,37
Georgia,09/05/2009,26,0,0,0,3,0,0,29
Georgia,10/05/2009,29,0,0,0,6,1,0,36
Georgia,11/05/2009,4,0,-2,0,6,1,0,9
Georgia,12/05/2009,32,0,0,0,-4,0,0,28
Georgia,13/05/2009,30,6,1,0,4,1,0,42
Georgia,14/05/2009,14,4,0,0,4,2,0,24
Georgia,15/05/2009,4,0,0,0,9,5,0,18
Georgia,16/05/2009,22,0,0,0,-4,0,0,18
Georgia,17/05/2009,12,0,0,0,0,0,0,12
Georgia,18/05/2009,27,0,0,0,1,1,0,29
Georgia,19/05/2009,33,0,0,0,34,5,0,72
Georgia,20/05/2009,4,0,0,0,13,4,0,21
Georgia,21/05/2009,0,0,0,0,-4,1,0,-3
Georgia,22/05/2009,16,0,0,0,9,0,0,25
Georgia,23/05/2009,4,0,0,0,8,0,0,12
Georgia,24/05/2009,9,0,-2,0,1,1,0,9
Georgia,25/05/2009,4,0,0,0,-6,0,0,-2
Georgia,26/05/2009,12,0,1,0,-2,2,0,13
Georgia,27/05/2009,6,0,-2,0,3,2,0,9
Georgia,28/05/2009,22,2,0,0,7,3,0,34
Georgia,29/05/2009,25,0,0,0,4,8,0,37
Georgia,30/05/2009,5,0,0,0,8,1,0,14
Georgia,31/05/2009,14,0,0,0,6,0,0,20
India,01/05/2009,43,2,-1,0,-5,2,0,41
India,02/05/2009,38,0,0,0,-3,5,0,40
India,03/05/2009,64,0,-5,0,12,4,0,75
India,04/05/2009,73,0,-10,0,8,4,0,75
India,05/05/2009,88,0,-9,0,31,12,0,122
India,06/05/2009,49,0,0,0,18,4,0,71
India,07/05/2009,44,2,1,0,26,3,0,76
India,08/05/2009,92,0,-4,0,9,10,0,107
India,09/05/2009,76,0,0,0,9,-2,0,83
India,10/05/2009,41,0,-3,0,-1,4,0,41
India,11/05/2009,36,0,0,0,-5,0,0,31
India,12/05/2009,18,0,0,0,-3,3,0,18
India,13/05/2009,47,0,0,0,7,4,0,58
India,14/05/2009,35,0,0,0,13,3,0,51
India,15/05/2009,35,0,-9,0,21,6,0,53
India,16/05/2009,43,0,-3,0,3,10,0,53
India,17/05/2009,44,0,-1,0,13,8,0,64
India,18/05/2009,101,4,-1,0,28,2,0,134
India,19/05/2009,76,4,-3,0,28,6,0,111
India,20/05/2009,58,0,1,0,19,9,0,87
India,21/05/2009,75,2,0,0,30,3,0,110
India,22/05/2009,37,10,-1,0,12,5,0,63
India,23/05/2009,38,2,0,0,21,3,0,64
India,24/05/2009,117,0,1,0,-1,9,0,126
India,25/05/2009,99,0,-6,0,-3,3,0,93
India,26/05/2009,62,0,-2,0,3,4,0,67
India,27/05/2009,41,0,0,0,14,3,0,58
India,28/05/2009,72,0,0,0,40,8,0,120
India,29/05/2009,71,0,1,0,10,9,0,91
India,30/05/2009,59,0,0,0,37,17,0,113
India,31/05/2009,58,0,2,0,19,29,0,108
Iran,01/05/2009,154,4,-1,0,92,15,0,264
Iran,02/05/2009,99,0,0,0,54,6,0,159
Iran,03/05/2009,86,0,1,0,13,6,0,106
Iran,04/05/2009,84,0,0,0,36,18,0,138
Iran,05/05/2009,89,0,3,0,44,4,0,140
Iran,06/05/2009,76,0,-1,0,26,3,0,104
Iran,07/05/2009,58,0,0,0,29,1,0,88
Iran,08/05/2009,69,0,1,0,27,3,0,100
Iran,09/05/2009,39,0,0,0,16,1,0,56
Iran,10/05/2009,65,0,2,0,50,6,0,123
Iran,11/05/2009,24,0,0,0,-16,1,0,9
Iran,12/05/2009,56,0,0,0,20,2,0,78
Iran,13/05/2009,85,0,2,0,27,0,0,114
Iran,14/05/2009,44,4,1,0,54,13,0,116
Iran,15/05/2009,42,0,1,0,39,9,0,91
Iran,16/05/2009,23,2,0,0,1,2,0,28
Iran,17/05/2009,57,2,-2,0,12,2,0,71
Iran,18/05/2009,80,0,1,0,31,3,0,115
Iran,19/05/2009,48,4,1,0,1,5,0,59
Iran,20/05/2009,168,0,1,0,28,13,0,210
Iran,21/05/2009,66,0,3,0,28,3,0,100
Iran,22/05/2009,25,4,0,0,9,8,0,46
Iran,23/05/2009,30,0,3,0,13,1,0,47
Iran,24/05/2009,55,0,0,0,25,15,0,95
Iran,25/05/2009,74,0,-1,0,7,6,0,86
Iran,26/05/2009,83,0,-2,0,18,3,0,102
Iran,27/05/2009,35,0,2,0,-11,8,0,34
Iran,28/05/2009,53,0,2,0,41,5,0,101
Iran,29/05/2009,189,0,2,0,35,7,0,233
Iran,30/05/2009,69,0,0,0,-3,10,0,76
Iran,31/05/2009,50,2,0,0,18,10,0,80
Iraq,01/05/2009,120,2,-3,0,30,15,0,164
Iraq,02/05/2009,142,2,0,0,30,8,0,182
Iraq,03/05/2009,101,0,0,0,18,1,0,120
Iraq,04/05/2009,68,0,0,0,-2,26,0,92
Iraq,05/05/2009,99,0,1,0,14,11,0,125
Iraq,06/05/2009,69,0,0,0,30,8,0,107
Iraq,07/05/2009,111,6,1,0,40,18,0,176
Iraq,08/05/2009,83,2,-4,0,37,4,0,122
Iraq,09/05/2009,53,0,-2,0,7,5,0,63
Iraq,10/05/2009,115,2,0,0,16,2,0,135
Iraq,11/05/2009,133,0,-4,0,27,7,0,163
Iraq,12/05/2009,111,0,-1,0,54,16,0,180
Iraq,13/05/2009,234,0,0,0,19,12,0,265
Iraq,14/05/2009,160,0,0,0,22,14,0,196
Iraq,15/05/2009,151,0,-2,0,84,6,0,239
Iraq,16/05/2009,105,4,0,0,12,9,0,130
Iraq,17/05/2009,61,0,0,0,4,7,0,72
Iraq,18/05/2009,87,0,1,0,41,11,0,140
Iraq,19/05/2009,132,0,-2,0,47,3,0,180
Iraq,20/05/2009,124,2,1,0,51,0,0,178
Iraq,21/05/2009,63,0,2,0,34,7,0,106
Iraq,22/05/2009,54,0,0,0,32,10,0,96
Iraq,23/05/2009,95,0,-2,0,26,11,0,130
Iraq,24/05/2009,117,0,-4,0,16,12,0,141
Iraq,25/05/2009,88,2,-16,0,3,16,0,93
Iraq,26/05/2009,74,2,1,0,17,13,0,107
Iraq,27/05/2009,87,4,-32,0,12,10,0,81
Iraq,28/05/2009,134,2,2,0,58,21,0,217
Iraq,29/05/2009,153,0,0,0,41,11,0,205
Iraq,30/05/2009,48,0,0,0,33,1,0,82
Iraq,31/05/2009,63,0,0,0,20,18,0,101
Morocco,01/05/2009,18,0,0,0,1,0,0,19
Morocco,02/05/2009,2,0,0,0,3,0,0,5
Morocco,03/05/2009,1,0,0,0,3,0,0,4
Morocco,04/05/2009,4,0,0,0,0,0,0,4
Morocco,05/05/2009,3,0,0,0,3,0,0,6
Morocco,06/05/2009,-1,0,0,0,0,0,0,-1
Morocco,07/05/2009,0,0,0,0,-1,0,0,-1
Morocco,08/05/2009,2,0,0,0,6,0,0,8
Morocco,09/05/2009,2,0,0,0,0,0,0,2
Morocco,10/05/2009,8,0,0,0,3,4,0,15
Morocco,11/05/2009,0,0,0,0,-2,0,0,-2
Morocco,12/05/2009,8,0,0,0,13,0,0,21
Morocco,13/05/2009,0,0,0,0,2,0,0,2
Morocco,14/05/2009,6,0,0,0,0,0,0,6
Morocco,15/05/2009,6,0,0,0,0,2,0,8
Morocco,16/05/2009,0,0,0,0,3,0,0,3
Morocco,17/05/2009,4,0,0,0,6,2,0,12
Morocco,18/05/2009,8,0,0,0,3,0,0,11
Morocco,19/05/2009,0,0,0,0,6,1,0,7
Morocco,20/05/2009,3,0,0,0,0,0,0,3
Morocco,21/05/2009,6,0,0,0,12,1,0,19
Morocco,22/05/2009,6,0,0,0,3,0,0,9
Morocco,23/05/2009,2,0,0,0,9,0,0,11
Morocco,24/05/2009,4,0,0,0,1,0,0,5
Morocco,25/05/2009,10,0,0,0,3,0,0,13
Morocco,26/05/2009,4,0,0,0,3,0,0,7
Morocco,27/05/2009,-1,0,0,0,-8,2,0,-7
Morocco,28/05/2009,0,0,0,0,18,0,0,18
Morocco,29/05/2009,4,0,0,0,0,1,0,5
Morocco,30/05/2009,6,0,0,0,3,0,0,9
Morocco,31/05/2009,0,0,-1,0,0,0,0,-1
Nigeria,01/05/2009,20,0,2,0,6,0,0,28
Nigeria,02/05/2009,13,0,0,0,2,1,0,16
Nigeria,03/05/2009,16,0,0,0,-1,2,0,17
Nigeria,04/05/2009,13,0,-1,0,27,2,0,41
Nigeria,05/05/2009,17,0,-2,0,16,0,0,31
Nigeria,06/05/2009,10,0,0,0,4,3,0,17
Nigeria,07/05/2009,5,0,1,0,9,2,0,17
Nigeria,08/05/2009,43,0,0,0,21,4,0,68
Nigeria,09/05/2009,21,0,-1,0,6,8,0,34
Nigeria,10/05/2009,26,0,1,0,0,0,0,27
Nigeria,11/05/2009,43,8,2,0,10,3,0,66
Nigeria,12/05/2009,18,0,0,0,9,1,0,28
Nigeria,13/05/2009,16,0,0,0,13,5,0,34
Nigeria,14/05/2009,11,0,0,0,3,0,0,14
Nigeria,15/05/2009,40,0,0,0,8,0,0,48
Nigeria,16/05/2009,2,0,0,0,13,0,0,15
Nigeria,17/05/2009,11,0,0,0,1,2,0,14
Nigeria,18/05/2009,21,0,0,0,13,2,0,36
Nigeria,19/05/2009,4,0,0,0,9,0,0,13
Nigeria,20/05/2009,15,0,0,0,9,1,0,25
Nigeria,21/05/2009,26,0,0,0,0,0,0,26
Nigeria,22/05/2009,21,0,0,0,31,1,0,53
Nigeria,23/05/2009,9,0,-1,0,36,0,0,44
Nigeria,24/05/2009,0,0,0,0,0,0,0,0
Nigeria,25/05/2009,19,0,0,0,-3,0,0,16
Nigeria,26/05/2009,17,0,-1,0,6,2,0,24
Nigeria,27/05/2009,12,0,1,0,3,1,0,17
Nigeria,28/05/2009,12,0,0,0,24,6,0,42
Nigeria,29/05/2009,15,0,2,0,1,0,0,18
Nigeria,30/05/2009,8,0,0,0,-6,1,0,3
Nigeria,31/05/2009,8,0,0,0,0,2,0,10
Pakistan,01/05/2009,142,0,0,0,64,16,0,222
Pakistan,02/05/2009,139,0,-1,0,26,2,0,166
Pakistan,03/05/2009,84,2,0,0,16,8,0,110
Pakistan,04/05/2009,211,6,1,0,63,16,0,297
Pakistan,05/05/2009,227,6,-2,0,29,11,0,271
Pakistan,06/05/2009,336,0,0,0,18,7,0,361
Pakistan,07/05/2009,283,0,-1,0,22,21,0,325
Pakistan,08/05/2009,152,0,0,0,19,18,0,189
Pakistan,09/05/2009,107,12,1,0,17,7,0,144
Pakistan,10/05/2009,140,0,0,0,0,0,0,140
Pakistan,11/05/2009,126,2,0,0,115,16,0,259
Pakistan,12/05/2009,118,10,0,0,39,12,0,179
Pakistan,13/05/2009,148,26,0,0,34,12,0,220
Pakistan,14/05/2009,139,2,-2,0,41,18,0,198
Pakistan,15/05/2009,125,2,-10,0,43,18,0,178
Pakistan,16/05/2009,44,2,0,0,11,2,0,59
Pakistan,17/05/2009,58,0,1,0,21,10,0,90
Pakistan,18/05/2009,106,6,-2,0,74,8,0,192
Pakistan,19/05/2009,104,4,-3,0,37,14,0,156
Pakistan,20/05/2009,121,4,-3,0,39,10,0,171
Pakistan,21/05/2009,153,2,0,0,68,7,0,230
Pakistan,22/05/2009,144,0,-2,0,29,10,0,181
Pakistan,23/05/2009,167,2,-5,0,67,3,0,234
Pakistan,24/05/2009,110,0,-4,0,68,38,0,212
Pakistan,25/05/2009,114,0,2,0,48,7,0,171
Pakistan,26/05/2009,54,2,0,0,62,9,0,127
Pakistan,27/05/2009,68,0,1,0,35,6,0,110
Pakistan,28/05/2009,83,2,0,0,43,18,0,146
Pakistan,29/05/2009,133,0,0,0,55,3,0,191
Pakistan,30/05/2009,49,0,0,0,46,4,0,99
Pakistan,31/05/2009,76,0,0,0,35,12,0,123
Sierra Leone,01/05/2009,0,0,0,0,0,0,0,0
Sierra Leone,02/05/2009,2,0,0,0,0,0,0,2
Sierra Leone,03/05/2009,0,0,0,0,0,0,0,0
Sierra Leone,04/05/2009,8,0,0,0,2,2,0,12
Sierra Leone,05/05/2009,-1,0,0,0,0,0,0,-1
Sierra Leone,06/05/2009,0,0,0,0,0,0,0,0
Sierra Leone,07/05/2009,3,0,0,0,0,0,0,3
Sierra Leone,08/05/2009,0,0,0,0,1,0,0,1
Sierra Leone,09/05/2009,0,0,0,0,0,0,0,0
Sierra Leone,10/05/2009,0,0,0,0,0,0,0,0
Sierra Leone,11/05/2009,0,0,0,0,0,0,0,0
Sierra Leone,12/05/2009,2,0,0,0,0,1,0,3
Sierra Leone,13/05/2009,-3,0,0,0,3,0,0,0
Sierra Leone,14/05/2009,0,0,0,0,0,0,0,0
Sierra Leone,15/05/2009,-2,0,0,0,0,0,0,-2
Sierra Leone,16/05/2009,-1,0,0,0,0,1,0,0
Sierra Leone,17/05/2009,0,0,0,0,0,0,0,0
Sierra Leone,18/05/2009,0,0,0,0,0,2,0,2
Sierra Leone,19/05/2009,0,0,0,0,0,1,0,1
Sierra Leone,20/05/2009,4,0,0,0,0,0,0,4
Sierra Leone,21/05/2009,2,0,0,0,0,0,0,2
Sierra Leone,22/05/2009,0,0,0,0,0,0,0,0
Sierra Leone,23/05/2009,1,0,0,0,0,0,0,1
Sierra Leone,24/05/2009,36,0,0,0,0,0,0,36
Sierra Leone,25/05/2009,0,0,0,0,0,0,0,0
Sierra Leone,26/05/2009,10,0,0,0,0,0,0,10
Sierra Leone,27/05/2009,1,0,0,0,3,0,0,4
Sierra Leone,28/05/2009,1,0,0,0,0,0,0,1
Sierra Leone,29/05/2009,0,0,0,0,6,0,0,6
Sierra Leone,30/05/2009,0,0,0,0,0,0,0,0
Somalia,01/05/2009,42,0,0,0,10,2,0,54
Somalia,02/05/2009,122,0,2,0,114,0,0,238
Somalia,03/05/2009,58,0,1,0,62,8,0,129
Somalia,04/05/2009,75,0,1,0,43,5,0,124
Somalia,05/05/2009,21,0,1,0,64,4,0,90
Somalia,06/05/2009,21,0,0,0,63,1,0,85
Somalia,07/05/2009,57,0,2,0,82,1,0,142
Somalia,08/05/2009,54,4,2,0,21,0,0,81
Somalia,09/05/2009,20,0,0,0,12,2,0,34
Somalia,10/05/2009,57,0,0,0,24,2,0,83
Somalia,11/05/2009,32,0,0,0,9,4,0,45
Somalia,12/05/2009,36,0,0,0,-11,9,0,34
Somalia,13/05/2009,32,0,0,0,13,1,0,46
Somalia,14/05/2009,42,0,0,0,56,10,0,108
Somalia,15/05/2009,83,0,0,0,11,3,0,97
Somalia,16/05/2009,22,0,0,0,9,6,0,37
Somalia,17/05/2009,4,6,0,0,6,0,0,16
Somalia,18/05/2009,57,14,0,0,41,1,0,113
Somalia,19/05/2009,43,2,0,0,66,8,0,119
Somalia,20/05/2009,46,0,0,0,47,6,0,99
Somalia,21/05/2009,56,0,0,0,35,8,0,99
Somalia,22/05/2009,75,0,0,0,57,5,0,137
Somalia,23/05/2009,44,0,1,0,10,0,0,55
Somalia,24/05/2009,25,0,0,0,14,0,0,39
Somalia,25/05/2009,70,0,0,0,67,0,0,137
Somalia,26/05/2009,76,0,1,0,71,0,0,148
Somalia,27/05/2009,39,2,0,0,34,5,0,80
Somalia,28/05/2009,40,0,0,0,30,2,0,72
Somalia,29/05/2009,83,0,0,0,30,2,0,115
Somalia,30/05/2009,39,0,0,0,51,12,0,102
Somalia,31/05/2009,31,0,0,0,27,1,0,59
Syria,01/05/2009,4,4,0,0,-5,0,0,3
Syria,02/05/2009,26,0,0,0,60,0,0,86
Syria,03/05/2009,7,0,0,0,24,0,0,31
Syria,04/05/2009,3,0,-1,0,3,6,0,11
Syria,05/05/2009,43,0,0,0,21,5,0,69
Syria,06/05/2009,19,0,0,0,13,1,0,33
Syria,07/05/2009,9,0,0,0,18,0,0,27
Syria,08/05/2009,6,0,0,0,3,1,0,10
Syria,09/05/2009,9,0,1,0,3,1,0,14
Syria,10/05/2009,6,0,0,0,2,1,0,9
Syria,11/05/2009,20,0,0,0,16,1,0,37
Syria,12/05/2009,11,0,0,0,12,0,0,23
Syria,13/05/2009,5,0,0,0,12,0,0,17
Syria,14/05/2009,-1,0,0,0,10,3,0,12
Syria,15/05/2009,15,0,0,0,0,1,0,16
Syria,16/05/2009,-2,0,0,0,2,1,0,1
Syria,17/05/2009,5,0,0,0,0,0,0,5
Syria,18/05/2009,10,0,0,0,1,3,0,14
Syria,19/05/2009,7,0,0,0,4,4,0,15
Syria,20/05/2009,10,0,0,0,-8,3,0,5
Syria,21/05/2009,20,0,0,0,9,2,0,31
Syria,22/05/2009,35,0,0,0,17,4,0,56
Syria,23/05/2009,6,0,0,0,27,1,0,34
Syria,24/05/2009,19,0,0,0,15,0,0,34
Syria,25/05/2009,13,0,0,0,18,2,0,33
Syria,26/05/2009,46,4,1,0,9,1,0,61
Syria,27/05/2009,28,0,0,0,15,4,0,47
Syria,28/05/2009,3,0,0,0,18,2,0,23
Syria,29/05/2009,20,0,0,0,1,0,0,21
Syria,30/05/2009,13,0,0,0,16,0,0,29
Syria,31/05/2009,10,0,0,0,4,1,0,15
Yemen,01/05/2009,8,0,0,0,3,1,0,12
Yemen,02/05/2009,17,0,0,0,9,1,0,27
Yemen,03/05/2009,22,0,0,0,0,0,0,22
Yemen,04/05/2009,13,0,0,0,-24,0,0,-11
Yemen,05/05/2009,28,0,0,0,-12,0,0,16
Yemen,06/05/2009,13,0,0,0,33,0,0,46
Yemen,07/05/2009,32,0,0,0,9,10,0,51
Yemen,08/05/2009,8,0,0,0,0,1,0,9
Yemen,09/05/2009,5,0,0,0,0,1,0,6
Yemen,10/05/2009,-2,0,0,0,-4,0,0,-6
Yemen,11/05/2009,7,0,0,0,11,0,0,18
Yemen,12/05/2009,8,0,0,0,0,0,0,8
Yemen,13/05/2009,31,0,0,0,12,0,0,43
Yemen,14/05/2009,28,0,0,0,24,6,0,58
Yemen,15/05/2009,3,0,0,0,19,0,0,22
Yemen,16/05/2009,10,0,0,0,14,1,0,25
Yemen,17/05/2009,-1,0,0,0,6,0,0,5
Yemen,18/05/2009,3,0,0,0,42,2,0,47
Yemen,19/05/2009,4,0,0,0,5,0,0,9
Yemen,20/05/2009,15,0,0,0,14,2,0,31
Yemen,21/05/2009,71,0,-2,0,22,9,0,100
Yemen,22/05/2009,31,0,3,0,29,0,0,63
Yemen,23/05/2009,11,0,0,0,0,0,0,11
Yemen,24/05/2009,13,0,0,0,12,2,0,27
Yemen,25/05/2009,16,0,0,0,7,0,0,23
Yemen,26/05/2009,9,0,-3,0,19,4,0,29
Yemen,27/05/2009,3,0,0,0,27,0,0,30
Yemen,28/05/2009,5,0,0,0,21,0,0,26
Yemen,29/05/2009,6,6,0,0,9,0,0,21
Yemen,30/05/2009,0,0,0,0,0,1,0,1
Yemen,31/05/2009,29,0,0,0,5,6,0,40
Afghanistan,01/11/2009,228,2,-11,0,81,46,0,346
Afghanistan,02/11/2009,143,6,4,0,33,43,0,229
Afghanistan,03/11/2009,255,0,-2,0,35,37,0,325
Afghanistan,04/11/2009,406,0,-7,0,66,36,0,501
Afghanistan,05/11/2009,412,0,4,0,71,29,0,516
Afghanistan,06/11/2009,670,0,1,0,8,23,0,702
Afghanistan,07/11/2009,532,0,1,0,2,23,0,558
Afghanistan,08/11/2009,365,4,0,0,33,24,0,426
Afghanistan,09/11/2009,483,8,1,0,26,34,0,552
Afghanistan,10/11/2009,556,4,4,0,57,84,0,705
Afghanistan,11/11/2009,494,10,1,0,60,53,0,618
Afghanistan,12/11/2009,180,4,2,0,24,18,0,228
Afghanistan,13/11/2009,109,0,0,0,9,35,0,153
Afghanistan,14/11/2009,102,0,0,0,16,6,0,124
Afghanistan,15/11/2009,82,0,0,0,27,11,0,120
Afghanistan,16/11/2009,106,4,0,0,29,22,0,161
Afghanistan,17/11/2009,288,4,1,0,79,25,0,397
Afghanistan,18/11/2009,331,0,-4,0,48,19,0,394
Afghanistan,19/11/2009,153,0,2,0,43,13,0,211
Afghanistan,20/11/2009,210,4,1,0,14,37,0,266
Afghanistan,21/11/2009,255,0,2,0,17,59,0,333
Afghanistan,22/11/2009,218,0,-5,0,107,19,0,339
Afghanistan,23/11/2009,401,0,-1,0,114,27,0,541
Afghanistan,24/11/2009,374,10,-1,0,121,30,0,534
Afghanistan,25/11/2009,319,4,0,0,92,38,0,453
Afghanistan,26/11/2009,207,0,-23,0,124,35,0,343
Afghanistan,27/11/2009,182,4,-20,0,83,5,0,254
Afghanistan,28/11/2009,142,0,-3,0,31,3,0,173
Afghanistan,29/11/2009,234,2,0,0,50,29,0,315
Afghanistan,30/11/2009,352,2,-4,0,93,45,0,488
Albania,01/11/2009,13,0,0,0,0,0,0,13
Albania,02/11/2009,13,0,0,0,0,0,0,13
Albania,03/11/2009,18,0,0,0,0,0,0,18
Albania,04/11/2009,14,0,0,0,3,2,0,19
Albania,05/11/2009,0,0,0,0,0,0,0,0
Albania,06/11/2009,-2,0,0,0,0,0,0,-2
Albania,07/11/2009,1,0,0,0,0,0,0,1
Albania,08/11/2009,6,0,0,0,-2,0,0,4
Albania,09/11/2009,7,0,0,0,0,0,0,7
Albania,10/11/2009,3,0,0,0,0,0,0,3
Albania,11/11/2009,6,0,0,0,0,4,0,10
Albania,12/11/2009,17,0,0,0,0,8,0,25
Albania,13/11/2009,0,0,0,0,0,7,0,7
Albania,14/11/2009,12,0,0,0,3,11,0,26
Albania,15/11/2009,0,0,0,0,0,2,0,2
Albania,16/11/2009,40,0,-6,0,0,9,0,43
Albania,17/11/2009,19,0,0,0,0,0,0,19
Albania,18/11/2009,4,0,-2,0,-2,1,0,1
Albania,19/11/2009,4,0,0,0,0,0,0,4
Albania,20/11/2009,2,0,0,0,0,0,0,2
Albania,21/11/2009,0,0,0,0,0,0,0,0
Albania,22/11/2009,2,0,0,0,0,0,0,2
Albania,23/11/2009,1,0,0,0,5,0,0,6
Albania,24/11/2009,6,0,0,0,-2,2,0,6
Albania,25/11/2009,0,0,0,0,0,1,0,1
Albania,26/11/2009,11,0,0,0,0,0,0,11
Albania,27/11/2009,8,0,0,0,0,0,0,8
Albania,28/11/2009,-2,0,0,0,0,0,0,-2
Albania,29/11/2009,1,0,0,0,0,0,0,1
Albania,30/11/2009,20,0,-1,0,21,3,0,43
Algeria,01/11/2009,0,0,0,0,0,1,0,1
Algeria,02/11/2009,3,0,0,0,6,0,0,9
Algeria,03/11/2009,3,0,0,0,-1,0,0,2
Algeria,04/11/2009,2,0,0,0,0,0,0,2
Algeria,05/11/2009,8,0,0,0,6,0,0,14
Algeria,06/11/2009,3,0,0,0,-8,0,0,-5
Algeria,07/11/2009,0,0,0,0,3,0,0,3
Algeria,08/11/2009,4,0,0,0,6,0,0,10
Algeria,09/11/2009,21,0,0,0,3,0,0,24
Algeria,10/11/2009,10,0,0,0,0,1,0,11
Algeria,11/11/2009,13,0,0,0,10,4,0,27
Algeria,12/11/2009,8,0,0,0,3,0,0,11
Algeria,13/11/2009,0,0,0,0,0,0,0,0
Algeria,14/11/2009,-1,0,0,0,0,0,0,-1
Algeria,15/11/2009,0,0,0,0,0,0,0,0
Algeria,16/11/2009,-4,0,0,0,1,1,0,-2
Algeria,17/11/2009,-3,2,0,0,3,0,0,2
Algeria,18/11/2009,0,0,0,0,6,2,0,8
Algeria,19/11/2009,14,0,0,0,0,0,0,14
Algeria,20/11/2009,8,0,0,0,6,1,0,15
Algeria,21/11/2009,0,0,0,0,2,1,0,3
Algeria,22/11/2009,2,0,0,0,2,0,0,4
Algeria,23/11/2009,5,0,0,0,12,3,0,20
Algeria,24/11/2009,0,0,0,0,6,0,0,6
Algeria,25/11/2009,10,0,0,0,0,0,0,10
Algeria,26/11/2009,9,0,0,0,0,3,0,12
Algeria,27/11/2009,0,0,0,0,0,2,0,2
Algeria,29/11/2009,0,0,-2,0,0,0,0,-2
Algeria,30/11/2009,19,0,0,0,33,0,0,52
Bangladesh,01/11/2009,27,0,0,0,25,0,0,52
Bangladesh,02/11/2009,36,0,1,0,10,3,0,50
Bangladesh,03/11/2009,37,0,0,0,29,0,0,66
Bangladesh,04/11/2009,3,0,0,0,0,7,0,10
Bangladesh,05/11/2009,6,0,1,0,9,5,0,21
Bangladesh,06/11/2009,8,0,0,0,12,1,0,21
Bangladesh,07/11/2009,8,0,0,0,17,1,0,26
Bangladesh,08/11/2009,18,0,0,0,12,1,0,31
Bangladesh,09/11/2009,4,0,0,0,-10,4,0,-2
Bangladesh,10/11/2009,19,2,0,0,7,1,0,29
Bangladesh,11/11/2009,22,0,0,0,-2,0,0,20
Bangladesh,12/11/2009,3,0,0,0,0,0,0,3
Bangladesh,13/11/2009,0,0,0,0,0,0,0,0
Bangladesh,14/11/2009,1,0,0,0,0,0,0,1
Bangladesh,15/11/2009,0,0,0,0,3,4,0,7
Bangladesh,16/11/2009,11,0,0,0,0,0,0,11
Bangladesh,17/11/2009,13,4,0,0,9,4,0,30
Bangladesh,18/11/2009,16,0,0,0,12,0,0,28
Bangladesh,19/11/2009,7,0,5,0,11,1,0,24
Bangladesh,20/11/2009,1,0,4,0,6,0,0,11
Bangladesh,21/11/2009,32,0,0,0,16,3,0,51
Bangladesh,22/11/2009,23,0,0,0,1,5,0,29
Bangladesh,23/11/2009,15,0,0,0,35,1,0,51
Bangladesh,24/11/2009,23,0,-4,0,-1,0,0,18
Bangladesh,25/11/2009,21,0,0,0,12,0,0,33
Bangladesh,26/11/2009,32,0,0,0,0,0,0,32
Bangladesh,27/11/2009,1,0,-8,0,-2,1,0,-8
Bangladesh,28/11/2009,2,0,-4,0,-2,0,0,-4
Bangladesh,29/11/2009,3,0,0,0,-3,0,0,0
Bangladesh,30/11/2009,23,0,1,0,28,2,0,54
Cameroon,01/11/2009,0,0,0,0,0,0,0,0
Cameroon,02/11/2009,3,0,0,0,0,0,0,3
Cameroon,03/11/2009,4,0,0,0,0,0,0,4
Cameroon,04/11/2009,0,0,0,0,0,0,0,0
Cameroon,05/11/2009,0,0,0,0,0,0,0,0
Cameroon,06/11/2009,3,0,0,0,12,0,0,15
Cameroon,07/11/2009,0,0,0,0,0,0,0,0
Cameroon,08/11/2009,0,0,0,0,0,0,0,0
Cameroon,09/11/2009,0,0,0,0,0,0,0,0
Cameroon,10/11/2009,9,0,0,0,0,1,0,10
Cameroon,11/11/2009,5,0,0,0,3,0,0,8
Cameroon,12/11/2009,0,0,0,0,0,0,0,0
Cameroon,15/11/2009,2,0,0,0,0,0,0,2
Cameroon,16/11/2009,0,0,0,0,0,0,0,0
Cameroon,17/11/2009,9,0,0,0,50,2,0,61
Cameroon,18/11/2009,8,0,0,0,30,0,0,38
Cameroon,19/11/2009,0,0,0,0,0,0,0,0
Cameroon,21/11/2009,0,0,0,0,-1,0,0,-1
Cameroon,22/11/2009,0,0,0,0,0,0,0,0
Cameroon,23/11/2009,-1,0,0,0,3,0,0,2
Cameroon,24/11/2009,0,0,0,0,0,2,0,2
Cameroon,25/11/2009,0,0,0,0,0,0,0,0
Cameroon,26/11/2009,8,0,0,0,0,0,0,8
Cameroon,27/11/2009,0,0,0,0,0,0,0,0
Cameroon,28/11/2009,0,0,0,0,0,1,0,1
Cameroon,29/11/2009,0,0,0,0,3,0,0,3
Cameroon,30/11/2009,0,0,0,0,0,0,0,0
China,01/11/2009,97,0,-2,0,14,2,0,111
China,02/11/2009,96,0,-1,0,-9,9,0,95
China,03/11/2009,65,6,5,0,27,19,0,122
China,04/11/2009,146,4,-6,0,28,23,0,195
China,05/11/2009,178,0,0,0,17,21,0,216
China,06/11/2009,99,0,3,0,14,8,0,124
China,07/11/2009,56,4,0,0,30,3,0,93
China,08/11/2009,119,0,2,0,21,7,0,149
China,09/11/2009,168,2,-3,0,94,13,0,274
China,10/11/2009,118,2,1,0,49,13,0,183
China,11/11/2009,108,0,-8,0,44,9,0,153
China,12/11/2009,53,2,0,0,32,9,0,96
China,13/11/2009,20,0,-1,0,13,3,0,35
China,14/11/2009,33,0,0,0,7,0,0,40
China,15/11/2009,30,0,0,0,4,13,0,47
China,16/11/2009,23,0,0,0,6,6,0,35
China,17/11/2009,138,4,-7,0,29,15,0,179
China,18/11/2009,170,0,-3,0,17,15,0,199
China,19/11/2009,33,0,1,0,5,2,0,41
China,20/11/2009,46,8,-1,0,11,12,0,76
China,21/11/2009,101,0,-1,0,47,6,0,153
China,22/11/2009,80,10,1,0,33,10,0,134
China,23/11/2009,169,0,-3,0,40,8,0,214
China,24/11/2009,141,6,-3,0,69,27,0,240
China,25/11/2009,149,0,-23,0,29,48,0,203
China,26/11/2009,117,0,-3,0,103,37,0,254
China,27/11/2009,55,2,-48,0,56,13,0,78
China,28/11/2009,48,0,0,0,19,10,0,77
China,29/11/2009,71,2,-4,0,24,31,0,124
China,30/11/2009,166,2,1,0,13,14,0,196
Egypt,01/11/2009,31,0,0,0,3,6,0,40
Egypt,02/11/2009,50,4,-3,0,12,11,0,74
Egypt,03/11/2009,56,4,0,0,26,8,0,94
Egypt,04/11/2009,105,4,0,0,57,14,0,180
Egypt,05/11/2009,34,0,-2,0,30,1,0,63
Egypt,06/11/2009,59,0,-2,0,16,1,0,74
Egypt,07/11/2009,22,0,-8,0,7,0,0,21
Egypt,08/11/2009,26,0,0,0,21,0,0,47
Egypt,09/11/2009,57,0,-1,0,21,3,0,80
Egypt,10/11/2009,35,0,0,0,39,5,0,79
Egypt,11/11/2009,144,0,-3,0,194,20,0,355
Egypt,12/11/2009,20,0,0,0,24,6,0,50
Egypt,13/11/2009,12,0,0,0,0,0,0,12
Egypt,14/11/2009,8,0,2,0,3,0,0,13
Egypt,15/11/2009,18,0,0,0,0,6,0,24
Egypt,16/11/2009,24,0,0,0,15,5,0,44
Egypt,17/11/2009,30,0,0,0,22,3,0,55
Egypt,18/11/2009,16,0,0,0,19,3,0,38
Egypt,19/11/2009,33,0,-8,0,14,0,0,39
Egypt,20/11/2009,26,0,-6,0,7,1,0,28
Egypt,21/11/2009,47,0,0,0,0,-2,0,45
Egypt,22/11/2009,51,0,0,0,4,6,0,61
Egypt,23/11/2009,26,0,1,0,-2,2,0,27
Egypt,24/11/2009,18,0,1,0,7,0,0,26
Egypt,25/11/2009,20,0,-4,0,-4,1,0,13
Egypt,26/11/2009,40,0,-8,0,-5,1,0,28
Egypt,27/11/2009,40,0,0,0,-1,2,0,41
Egypt,28/11/2009,4,0,-6,0,0,1,0,-1
Egypt,29/11/2009,33,0,-2,0,39,2,0,72
Egypt,30/11/2009,42,0,-1,0,24,4,0,69
Eritrea,01/11/2009,1,0,0,0,0,0,0,1
Eritrea,02/11/2009,1,0,0,0,0,0,0,1
Eritrea,03/11/2009,0,0,0,0,0,0,0,0
Eritrea,04/11/2009,0,0,0,0,0,0,0,0
Eritrea,05/11/2009,8,0,0,0,0,0,0,8
Eritrea,06/11/2009,2,0,0,0,0,0,0,2
Eritrea,07/11/2009,2,0,0,0,0,0,0,2
Eritrea,08/11/2009,2,0,0,0,0,0,0,2
Eritrea,09/11/2009,2,0,0,0,0,0,0,2
Eritrea,10/11/2009,9,0,0,0,2,0,0,11
Eritrea,11/11/2009,0,0,0,0,0,0,0,0
Eritrea,12/11/2009,0,0,0,0,0,0,0,0
Eritrea,15/11/2009,0,0,0,0,0,0,0,0
Eritrea,16/11/2009,0,0,0,0,0,0,0,0
Eritrea,17/11/2009,21,0,0,0,-2,0,0,19
Eritrea,18/11/2009,0,0,0,0,0,0,0,0
Eritrea,19/11/2009,1,0,0,0,-2,0,0,-1
Eritrea,20/11/2009,-3,0,0,0,0,0,0,-3
Eritrea,21/11/2009,0,0,2,0,0,0,0,2
Eritrea,22/11/2009,0,0,0,0,10,0,0,10
Eritrea,23/11/2009,0,0,0,0,0,2,0,2
Eritrea,24/11/2009,9,0,0,0,12,2,0,23
Eritrea,25/11/2009,0,0,0,0,24,0,0,24
Eritrea,26/11/2009,12,0,0,0,6,0,0,18
Eritrea,27/11/2009,4,0,0,0,0,0,0,4
Eritrea,28/11/2009,0,0,0,0,0,0,0,0
Eritrea,29/11/2009,0,0,0,0,0,0,0,0
Eritrea,30/11/2009,4,0,0,0,0,0,0,4
Georgia,01/11/2009,7,0,0,0,3,0,0,10
Georgia,02/11/2009,12,0,-6,0,3,13,0,22
Georgia,03/11/2009,35,2,0,0,21,15,0,73
Georgia,04/11/2009,29,4,0,0,16,8,0,57
Georgia,05/11/2009,39,0,1,0,19,3,0,62
Georgia,06/11/2009,39,0,1,0,18,0,0,58
Georgia,07/11/2009,17,0,0,0,-3,2,0,16
Georgia,08/11/2009,19,0,0,0,-3,0,0,16
Georgia,09/11/2009,29,0,1,0,25,7,0,62
Georgia,10/11/2009,31,0,0,0,20,7,0,58
Georgia,11/11/2009,14,0,0,0,7,1,0,22
Georgia,12/11/2009,3,0,0,0,0,0,0,3
Georgia,14/11/2009,2,0,0,0,0,0,0,2
Georgia,15/11/2009,0,0,0,0,0,0,0,0
Georgia,16/11/2009,0,0,0,0,0,0,0,0
Georgia,17/11/2009,18,0,1,0,5,2,0,26
Georgia,18/11/2009,18,0,0,0,7,1,0,26
Georgia,19/11/2009,0,0,0,0,-2,0,0,-2
Georgia,20/11/2009,18,0,0,0,3,0,0,21
Georgia,21/11/2009,6,0,0,0,5,3,0,14
Georgia,22/11/2009,3,0,0,0,3,1,0,7
Georgia,23/11/2009,14,0,0,0,6,2,0,22
Georgia,24/11/2009,14,2,0,0,21,12,0,49
Georgia,25/11/2009,16,0,0,0,14,13,0,43
Georgia,26/11/2009,6,0,0,0,6,4,0,16
Georgia,27/11/2009,4,0,-2,0,3,1,0,6
Georgia,28/11/2009,8,0,0,0,3,0,0,11
Georgia,29/11/2009,6,2,0,0,0,2,0,10
Georgia,30/11/2009,17,0,0,0,4,1,0,22
India,01/11/2009,45,0,0,0,-8,4,0,41
India,02/11/2009,54,0,1,0,9,15,0,79
India,03/11/2009,96,2,1,0,4,9,0,112
India,04/11/2009,100,2,-5,0,8,9,0,114
India,05/11/2009,61,4,2,0,10,11,0,88
India,06/11/2009,71,2,-6,0,12,5,0,84
India,07/11/2009,25,2,0,0,22,3,0,52
India,08/11/2009,32,0,0,0,13,4,0,49
India,09/11/2009,72,0,1,0,18,7,0,98
India,10/11/2009,53,0,-4,0,6,5,0,60
India,11/11/2009,42,0,2,0,-6,6,0,44
India,12/11/2009,15,0,0,0,12,2,0,29
India,13/11/2009,18,0,1,0,21,3,0,43
India,14/11/2009,4,0,0,0,0,0,0,4
India,15/11/2009,1,0,0,0,0,0,0,1
India,16/11/2009,15,2,0,0,3,0,0,20
India,17/11/2009,50,4,0,0,11,9,0,74
India,18/11/2009,69,2,-1,0,42,4,0,116
India,19/11/2009,32,0,-4,0,12,0,0,40
India,20/11/2009,31,2,0,0,0,7,0,40
India,21/11/2009,43,0,0,0,2,5,0,50
India,22/11/2009,49,0,2,0,9,13,0,73
India,23/11/2009,104,0,-2,0,14,9,0,125
India,24/11/2009,43,0,0,0,0,13,0,56
India,25/11/2009,97,0,3,0,39,16,0,155
India,26/11/2009,67,4,2,0,18,6,0,97
India,27/11/2009,44,0,2,0,5,5,0,56
India,28/11/2009,28,2,-2,0,-9,4,0,23
India,29/11/2009,26,0,0,0,4,3,0,33
India,30/11/2009,31,0,-9,0,8,9,0,39
Iran,01/11/2009,46,0,0,0,4,2,0,52
Iran,02/11/2009,37,2,-1,0,35,7,0,80
Iran,03/11/2009,110,0,0,0,32,5,0,147
Iran,04/11/2009,83,0,0,0,142,9,0,234
Iran,05/11/2009,114,2,5,0,68,7,0,196
Iran,06/11/2009,71,0,2,0,42,3,0,118
Iran,07/11/2009,48,0,2,0,48,4,0,102
Iran,08/11/2009,53,2,0,0,14,8,0,77
Iran,09/11/2009,79,0,1,0,66,10,0,156
Iran,10/11/2009,84,0,1,0,23,6,0,114
Iran,11/11/2009,84,2,1,0,56,5,0,148
Iran,12/11/2009,55,0,0,0,11,0,0,66
Iran,13/11/2009,32,0,0,0,12,0,0,44
Iran,14/11/2009,11,0,0,0,3,1,0,15
Iran,15/11/2009,13,0,0,0,10,1,0,24
Iran,16/11/2009,8,0,0,0,0,5,0,13
Iran,17/11/2009,93,2,2,0,54,6,0,157
Iran,18/11/2009,52,0,0,0,39,10,0,101
Iran,19/11/2009,18,0,-1,0,3,0,0,20
Iran,20/11/2009,19,0,-2,0,4,4,0,25
Iran,21/11/2009,34,2,1,0,46,15,0,98
Iran,22/11/2009,70,0,1,0,51,17,0,139
Iran,23/11/2009,106,0,0,0,55,24,0,185
Iran,24/11/2009,84,0,0,0,7,14,0,105
Iran,25/11/2009,71,2,0,0,38,12,0,123
Iran,26/11/2009,83,0,1,0,61,18,0,163
Iran,27/11/2009,79,0,6,0,18,13,0,116
Iran,28/11/2009,61,0,1,0,4,7,0,73
Iran,29/11/2009,61,0,5,0,14,1,0,81
Iran,30/11/2009,52,0,2,0,96,1,0,151
Iraq,01/11/2009,71,0,0,0,10,9,0,90
Iraq,02/11/2009,87,0,0,0,28,12,0,127
Iraq,03/11/2009,72,0,0,0,22,13,0,107
Iraq,04/11/2009,119,0,2,0,26,6,0,153
Iraq,05/11/2009,327,0,3,0,24,17,0,371
Iraq,06/11/2009,476,0,3,0,48,8,0,535
Iraq,07/11/2009,170,10,-4,0,45,4,0,225
Iraq,08/11/2009,112,6,4,0,13,11,0,146
Iraq,09/11/2009,237,0,-1,0,122,5,0,363
Iraq,10/11/2009,241,0,1,0,98,4,0,344
Iraq,11/11/2009,262,4,1,0,22,25,0,314
Iraq,12/11/2009,111,0,0,0,9,3,0,123
Iraq,13/11/2009,23,0,1,0,0,2,0,26
Iraq,14/11/2009,15,0,-2,0,3,0,0,16
Iraq,15/11/2009,43,0,0,0,14,4,0,61
Iraq,16/11/2009,25,0,0,0,36,14,0,75
Iraq,17/11/2009,104,4,-3,0,53,28,0,186
Iraq,18/11/2009,137,0,7,0,41,18,0,203
Iraq,19/11/2009,31,0,1,0,-1,9,0,40
Iraq,20/11/2009,34,0,0,0,-1,1,0,34
Iraq,21/11/2009,74,0,-2,0,16,3,0,91
Iraq,22/11/2009,128,0,0,0,-5,8,0,131
Iraq,23/11/2009,198,0,3,0,20,17,0,238
Iraq,24/11/2009,178,0,1,0,42,35,0,256
Iraq,25/11/2009,214,0,0,0,48,28,0,290
Iraq,26/11/2009,153,0,3,0,20,12,0,188
Iraq,27/11/2009,103,4,-43,0,10,2,0,76
Iraq,28/11/2009,61,0,2,0,16,9,0,88
Iraq,29/11/2009,46,0,1,0,74,19,0,140
Iraq,30/11/2009,106,52,3,0,48,9,0,218
Morocco,01/11/2009,4,0,0,0,15,0,0,19
Morocco,02/11/2009,31,0,0,0,6,0,0,37
Morocco,03/11/2009,30,0,0,0,13,1,0,44
Morocco,04/11/2009,12,0,0,0,9,0,0,21
Morocco,05/11/2009,8,0,2,0,0,0,0,10
Morocco,06/11/2009,17,2,0,0,4,0,0,23
Morocco,07/11/2009,2,0,0,0,0,0,0,2
Morocco,08/11/2009,2,0,0,0,0,0,0,2
Morocco,09/11/2009,0,0,0,0,3,0,0,3
Morocco,10/11/2009,5,0,0,0,18,0,0,23
Morocco,11/11/2009,1,0,0,0,12,0,0,13
Morocco,12/11/2009,0,0,1,0,1,1,0,3
Morocco,13/11/2009,2,0,0,0,0,0,0,2
Morocco,15/11/2009,0,0,0,0,0,0,0,0
Morocco,16/11/2009,1,0,0,0,21,1,0,23
Morocco,17/11/2009,0,0,0,0,33,1,0,34
Morocco,18/11/2009,0,0,0,0,27,0,0,27
Morocco,19/11/2009,0,0,0,0,15,6,0,21
Morocco,20/11/2009,9,0,0,0,19,3,0,31
Morocco,21/11/2009,13,0,0,0,15,0,0,28
Morocco,22/11/2009,4,0,0,0,3,4,0,11
Morocco,23/11/2009,3,0,0,0,6,1,0,10
Morocco,24/11/2009,5,0,0,0,39,0,0,44
Morocco,25/11/2009,4,0,0,0,6,0,0,10
Morocco,26/11/2009,0,0,0,0,3,0,0,3
Morocco,27/11/2009,5,0,0,0,6,0,0,11
Morocco,28/11/2009,15,0,-2,0,6,0,0,19
Morocco,29/11/2009,3,0,0,0,9,2,0,14
Morocco,30/11/2009,8,0,0,0,6,0,0,14
Nigeria,01/11/2009,9,0,0,0,3,3,0,15
Nigeria,02/11/2009,15,0,3,0,0,4,0,22
Nigeria,03/11/2009,31,0,0,0,21,0,0,52
Nigeria,04/11/2009,48,0,0,0,6,6,0,60
Nigeria,05/11/2009,42,0,1,0,10,0,0,53
Nigeria,06/11/2009,1,0,1,0,-5,1,0,-2
Nigeria,07/11/2009,15,0,1,0,0,0,0,16
Nigeria,08/11/2009,36,0,1,0,-2,1,0,36
Nigeria,09/11/2009,51,0,0,0,7,10,0,68
Nigeria,10/11/2009,18,0,-4,0,19,4,0,37
Nigeria,11/11/2009,44,0,0,0,4,3,0,51
Nigeria,12/11/2009,4,0,0,0,1,0,0,5
Nigeria,13/11/2009,2,0,0,0,0,0,0,2
Nigeria,14/11/2009,0,0,0,0,6,0,0,6
Nigeria,15/11/2009,0,0,0,0,0,0,0,0
Nigeria,16/11/2009,0,0,0,0,3,0,0,3
Nigeria,17/11/2009,12,0,-3,0,4,1,0,14
Nigeria,18/11/2009,10,0,0,0,12,10,0,32
Nigeria,19/11/2009,10,0,0,0,6,3,0,19
Nigeria,20/11/2009,9,0,0,0,9,2,0,20
Nigeria,21/11/2009,10,14,0,0,7,0,0,31
Nigeria,22/11/2009,8,0,0,0,15,1,0,24
Nigeria,23/11/2009,10,0,0,0,17,1,0,28
Nigeria,24/11/2009,37,0,0,0,24,2,0,63
Nigeria,25/11/2009,42,0,1,0,21,6,0,70
Nigeria,26/11/2009,27,0,0,0,14,2,0,43
Nigeria,27/11/2009,17,0,0,0,18,0,0,35
Nigeria,28/11/2009,13,0,0,0,4,0,0,17
Nigeria,29/11/2009,17,0,0,0,12,2,0,31
Nigeria,30/11/2009,25,0,0,0,10,1,0,36
Pakistan,01/11/2009,62,0,-6,0,13,2,0,71
Pakistan,02/11/2009,100,4,-6,0,24,8,0,130
Pakistan,03/11/2009,68,6,0,0,30,9,0,113
Pakistan,04/11/2009,81,6,-1,0,31,14,0,131
Pakistan,05/11/2009,58,0,-3,0,1,3,0,59
Pakistan,06/11/2009,117,0,0,0,32,17,0,166
Pakistan,07/11/2009,41,0,0,0,17,5,0,63
Pakistan,08/11/2009,60,4,-4,0,43,16,0,119
Pakistan,09/11/2009,138,0,1,0,30,23,0,192
Pakistan,10/11/2009,163,0,3,0,12,16,0,194
Pakistan,11/11/2009,86,0,0,0,47,6,0,139
Pakistan,12/11/2009,65,0,0,0,23,3,0,91
Pakistan,13/11/2009,79,0,-3,0,25,2,0,103
Pakistan,14/11/2009,14,0,0,0,12,0,0,26
Pakistan,15/11/2009,20,0,0,0,33,4,0,57
Pakistan,16/11/2009,35,6,0,0,14,4,0,59
Pakistan,17/11/2009,139,2,1,0,19,26,0,187
Pakistan,18/11/2009,138,0,1,0,33,1,0,173
Pakistan,19/11/2009,59,0,0,0,36,1,0,96
Pakistan,20/11/2009,31,6,0,0,19,6,0,62
Pakistan,21/11/2009,62,0,0,0,49,8,0,119
Pakistan,22/11/2009,180,0,-4,0,56,9,0,241
Pakistan,23/11/2009,184,0,-6,0,45,8,0,231
Pakistan,24/11/2009,149,2,-5,0,153,11,0,310
Pakistan,25/11/2009,169,4,1,0,64,41,0,279
Pakistan,26/11/2009,117,0,0,0,25,11,0,153
Pakistan,27/11/2009,54,0,-2,0,50,12,0,114
Pakistan,28/11/2009,78,0,-6,0,18,4,0,94
Pakistan,29/11/2009,122,0,-5,0,25,9,0,151
Pakistan,30/11/2009,228,44,-1,0,35,8,0,314
Sierra Leone,01/11/2009,3,0,0,0,0,1,0,4
Sierra Leone,02/11/2009,17,0,2,0,0,2,0,21
Sierra Leone,03/11/2009,9,0,0,0,6,2,0,17
Sierra Leone,04/11/2009,5,0,0,0,10,0,0,15
Sierra Leone,05/11/2009,1,0,0,0,3,0,0,4
Sierra Leone,06/11/2009,6,0,0,0,0,0,0,6
Sierra Leone,07/11/2009,1,0,0,0,0,0,0,1
Sierra Leone,08/11/2009,0,0,0,0,0,0,0,0
Sierra Leone,09/11/2009,1,0,0,0,21,0,0,22
Sierra Leone,10/11/2009,22,0,0,0,23,3,0,48
Sierra Leone,11/11/2009,17,0,0,0,13,0,0,30
Sierra Leone,12/11/2009,0,0,0,0,0,1,0,1
Sierra Leone,16/11/2009,0,0,0,0,0,0,0,0
Sierra Leone,17/11/2009,8,0,0,0,6,2,0,16
Sierra Leone,18/11/2009,3,0,0,0,9,0,0,12
Sierra Leone,19/11/2009,0,0,0,0,3,0,0,3
Sierra Leone,20/11/2009,10,0,0,0,12,0,0,22
Sierra Leone,21/11/2009,0,0,0,0,0,2,0,2
Sierra Leone,22/11/2009,6,0,0,0,-2,1,0,5
Sierra Leone,23/11/2009,0,0,0,0,-2,1,0,-1
Sierra Leone,24/11/2009,2,0,0,0,0,0,0,2
Sierra Leone,25/11/2009,13,0,0,0,6,0,0,19
Sierra Leone,26/11/2009,6,0,0,0,3,1,0,10
Sierra Leone,27/11/2009,6,0,0,0,3,3,0,12
Sierra Leone,28/11/2009,1,0,0,0,3,2,0,6
Sierra Leone,29/11/2009,0,0,0,0,0,1,0,1
Sierra Leone,30/11/2009,0,0,0,0,0,0,0,0
Somalia,01/11/2009,55,0,0,0,1,22,0,78
Somalia,02/11/2009,79,0,0,0,17,2,0,98
Somalia,03/11/2009,14,0,0,0,1,2,0,17
Somalia,04/11/2009,74,0,0,0,11,1,0,86
Somalia,05/11/2009,79,0,0,0,76,2,0,157
Somalia,06/11/2009,58,4,2,0,80,4,0,148
Somalia,07/11/2009,17,2,0,0,43,2,0,64
Somalia,08/11/2009,8,0,0,0,22,0,0,30
Somalia,09/11/2009,66,0,0,0,7,6,0,79
Somalia,10/11/2009,76,0,0,0,66,4,0,146
Somalia,11/11/2009,65,2,0,0,111,8,0,186
Somalia,12/11/2009,12,0,0,0,36,0,0,48
Somalia,13/11/2009,0,0,0,0,15,1,0,16
Somalia,14/11/2009,9,0,1,0,10,0,0,20
Somalia,15/11/2009,3,0,0,0,-4,0,0,-1
Somalia,16/11/2009,6,0,0,0,13,1,0,20
Somalia,17/11/2009,72,0,0,0,39,5,0,116
Somalia,18/11/2009,229,2,0,0,84,22,0,337
Somalia,19/11/2009,50,0,0,0,17,11,0,78
Somalia,20/11/2009,51,0,0,0,10,3,0,64
Somalia,21/11/2009,62,0,0,0,7,2,0,71
Somalia,22/11/2009,39,0,2,0,13,1,0,55
Somalia,23/11/2009,62,0,2,0,20,1,0,85
Somalia,24/11/2009,92,0,0,0,49,7,0,148
Somalia,25/11/2009,58,0,0,0,46,1,0,105
Somalia,26/11/2009,46,0,0,0,-57,2,0,-9
Somalia,27/11/2009,29,0,0,0,-7,1,0,23
Somalia,28/11/2009,7,0,0,0,-1,0,0,6
Somalia,29/11/2009,17,0,0,0,-6,0,0,11
Somalia,30/11/2009,78,0,0,0,42,0,0,120
Syria,01/11/2009,5,0,0,0,3,0,0,8
Syria,02/11/2009,16,0,0,0,33,2,0,51
Syria,03/11/2009,13,0,3,0,60,1,0,77
Syria,04/11/2009,14,0,-3,0,12,2,0,25
Syria,05/11/2009,27,0,0,0,12,1,0,40
Syria,06/11/2009,18,0,0,0,7,0,0,25
Syria,07/11/2009,10,0,0,0,9,1,0,20
Syria,08/11/2009,11,0,0,0,3,0,0,14
Syria,09/11/2009,14,0,0,0,14,0,0,28
Syria,10/11/2009,12,0,2,0,27,0,0,41
Syria,11/11/2009,31,0,2,0,22,2,0,57
Syria,12/11/2009,10,0,0,0,3,3,0,16
Syria,13/11/2009,5,0,0,0,0,0,0,5
Syria,14/11/2009,8,0,0,0,-2,1,0,7
Syria,15/11/2009,6,0,0,0,12,1,0,19
Syria,16/11/2009,4,0,0,0,-2,3,0,5
Syria,17/11/2009,10,0,0,0,24,2,0,36
Syria,18/11/2009,10,0,0,0,18,0,0,28
Syria,19/11/2009,4,0,0,0,0,0,0,4
Syria,20/11/2009,1,0,0,0,0,0,0,1
Syria,21/11/2009,0,0,0,0,19,1,0,20
Syria,22/11/2009,4,0,0,0,15,0,0,19
Syria,23/11/2009,29,0,0,0,4,2,0,35
Syria,24/11/2009,26,0,0,0,13,6,0,45
Syria,25/11/2009,3,0,0,0,21,0,0,24
Syria,26/11/2009,55,0,0,0,40,3,0,98
Syria,27/11/2009,22,0,0,0,14,0,0,36
Syria,28/11/2009,7,0,0,0,3,0,0,10
Syria,29/11/2009,3,0,0,0,6,0,0,9
Syria,30/11/2009,-4,0,0,0,5,1,0,2
Yemen,01/11/2009,9,0,0,0,13,0,0,22
Yemen,02/11/2009,15,2,0,0,4,1,0,22
Yemen,03/11/2009,15,0,0,0,12,12,0,39
Yemen,04/11/2009,89,0,1,0,14,2,0,106
Yemen,05/11/2009,168,0,0,0,30,8,0,206
Yemen,06/11/2009,248,0,0,0,18,6,0,272
Yemen,07/11/2009,83,0,0,0,18,0,0,101
Yemen,08/11/2009,176,0,0,0,6,0,0,182
Yemen,09/11/2009,108,0,2,0,25,1,0,136
Yemen,10/11/2009,199,0,0,0,38,5,0,242
Yemen,11/11/2009,150,0,0,0,46,7,0,203
Yemen,12/11/2009,32,0,0,0,13,8,0,53
Yemen,13/11/2009,24,0,0,0,6,0,0,30
Yemen,14/11/2009,18,0,-2,0,18,0,0,34
Yemen,15/11/2009,13,0,0,0,0,2,0,15
Yemen,16/11/2009,10,0,0,0,-7,0,0,3
Yemen,17/11/2009,48,0,0,0,-9,2,0,41
Yemen,18/11/2009,100,0,-1,0,5,8,0,112
Yemen,19/11/2009,52,0,3,0,10,0,0,65
Yemen,20/11/2009,18,0,2,0,2,0,0,22
Yemen,21/11/2009,15,0,2,0,1,2,0,20
Yemen,22/11/2009,26,0,0,0,0,0,0,26
Yemen,23/11/2009,38,0,0,0,-4,1,0,35
Yemen,24/11/2009,30,2,0,0,6,10,0,48
Yemen,25/11/2009,50,2,0,0,22,6,0,80
Yemen,26/11/2009,42,0,2,0,0,1,0,45
Yemen,27/11/2009,16,0,0,0,6,0,0,22
Yemen,28/11/2009,0,0,0,0,-2,0,0,-2
Yemen,29/11/2009,36,0,0,0,3,0,0,39
Yemen,30/11/2009,26,4,0,0,4,2,0,36
Afghanistan,01/12/2012,60,4,2,0,52,9,0,127
Afghanistan,02/12/2012,161,0,-2,0,35,20,0,214
Afghanistan,03/12/2012,124,0,-1,0,26,9,0,158
Afghanistan,04/12/2012,113,0,9,0,61,11,0,194
Afghanistan,05/12/2012,136,0,1,0,55,18,0,210
Afghanistan,06/12/2012,210,0,1,0,-7,5,0,209
Afghanistan,07/12/2012,128,0,1,0,10,15,0,154
Afghanistan,08/12/2012,140,0,-2,0,11,8,0,157
Afghanistan,09/12/2012,96,0,-2,0,9,12,0,115
Afghanistan,10/12/2012,226,2,-1,0,52,24,0,303
Afghanistan,11/12/2012,171,0,-2,0,96,23,0,288
Afghanistan,12/12/2012,92,0,-4,0,30,24,0,142
Afghanistan,13/12/2012,209,2,2,0,32,81,0,326
Afghanistan,14/12/2012,122,0,-2,0,35,13,0,168
Afghanistan,15/12/2012,75,0,-2,0,18,14,0,105
Afghanistan,16/12/2012,47,0,0,0,10,4,0,61
Afghanistan,17/12/2012,119,0,0,0,14,11,0,144
Afghanistan,18/12/2012,150,2,0,0,39,3,0,194
Afghanistan,19/12/2012,169,0,0,0,40,22,0,231
Afghanistan,20/12/2012,137,0,2,0,57,18,0,214
Afghanistan,21/12/2012,96,2,-1,0,26,4,0,127
Afghanistan,22/12/2012,65,0,0,0,18,16,0,99
Afghanistan,23/12/2012,102,2,0,0,-2,8,0,110
Afghanistan,24/12/2012,139,0,0,0,7,7,0,153
Afghanistan,25/12/2012,109,0,0,0,-2,3,0,110
Afghanistan,26/12/2012,52,0,1,0,-2,6,0,57
Afghanistan,27/12/2012,56,0,0,0,9,2,0,67
Afghanistan,28/12/2012,77,2,-2,0,17,16,0,110
Afghanistan,29/12/2012,96,4,1,0,0,23,0,124
Afghanistan,30/12/2012,100,0,-1,0,38,19,0,156
Afghanistan,31/12/2012,216,0,0,0,-11,12,0,217
Albania,01/12/2012,2,0,0,0,0,0,0,2
Albania,02/12/2012,0,0,0,0,0,0,0,0
Albania,03/12/2012,2,0,0,0,0,0,0,2
Albania,04/12/2012,6,0,0,0,0,0,0,6
Albania,05/12/2012,0,0,0,0,6,0,0,6
Albania,06/12/2012,23,0,0,0,1,7,0,31
Albania,07/12/2012,8,0,0,0,0,0,0,8
Albania,08/12/2012,0,0,0,0,0,0,0,0
Albania,09/12/2012,0,0,0,0,6,2,0,8
Albania,10/12/2012,0,0,0,0,0,0,0,0
Albania,11/12/2012,2,0,0,0,9,0,0,11
Albania,12/12/2012,14,0,0,0,6,0,0,20
Albania,13/12/2012,1,0,1,0,3,0,0,5
Albania,14/12/2012,2,0,0,0,0,0,0,2
Albania,15/12/2012,0,0,0,0,9,1,0,10
Albania,16/12/2012,0,0,0,0,0,0,0,0
Albania,17/12/2012,0,0,0,0,3,0,0,3
Albania,18/12/2012,0,0,0,0,-4,0,0,-4
Albania,19/12/2012,2,0,0,0,0,0,0,2
Albania,20/12/2012,3,0,0,0,6,0,0,9
Albania,21/12/2012,2,0,0,0,0,0,0,2
Albania,24/12/2012,10,0,0,0,0,0,0,10
Albania,25/12/2012,2,0,0,0,0,0,0,2
Albania,26/12/2012,0,0,0,0,0,0,0,0
Albania,27/12/2012,1,0,0,0,0,0,0,1
Albania,28/12/2012,0,0,0,0,0,0,0,0
Albania,29/12/2012,1,0,1,0,0,1,0,3
Albania,30/12/2012,1,0,0,0,0,0,0,1
Albania,31/12/2012,11,0,0,0,1,0,0,12
Algeria,01/12/2012,0,0,0,0,0,0,0,0
Algeria,02/12/2012,0,0,0,0,3,0,0,3
Algeria,03/12/2012,19,0,0,0,3,0,0,22
Algeria,04/12/2012,6,0,0,0,12,0,0,18
Algeria,05/12/2012,21,0,0,0,9,0,0,30
Algeria,06/12/2012,-6,0,0,0,9,0,0,3
Algeria,07/12/2012,0,0,0,0,18,0,0,18
Algeria,08/12/2012,19,0,0,0,18,0,0,37
Algeria,09/12/2012,13,0,0,0,0,0,0,13
Algeria,10/12/2012,89,0,0,0,11,0,0,100
Algeria,11/12/2012,66,0,0,0,37,7,0,110
Algeria,12/12/2012,34,0,0,0,6,0,0,40
Algeria,13/12/2012,2,0,-2,0,9,0,0,9
Algeria,14/12/2012,0,0,0,0,0,0,0,0
Algeria,15/12/2012,4,0,-1,0,9,1,0,13
Algeria,16/12/2012,9,0,0,0,9,0,0,18
Algeria,17/12/2012,15,0,0,0,0,0,0,15
Algeria,18/12/2012,1,0,0,0,12,0,0,13
Algeria,19/12/2012,-4,0,0,0,-1,0,0,-5
Algeria,20/12/2012,9,4,0,0,-4,0,0,9
Algeria,21/12/2012,49,0,-1,0,11,4,0,63
Algeria,22/12/2012,7,0,0,0,6,2,0,15
Algeria,23/12/2012,6,0,0,0,18,0,0,24
Algeria,24/12/2012,108,0,-3,0,20,30,0,155
Algeria,25/12/2012,6,0,0,0,3,0,0,9
Algeria,26/12/2012,3,0,0,0,0,0,0,3
Algeria,27/12/2012,15,0,0,0,3,0,0,18
Algeria,28/12/2012,2,0,0,0,0,0,0,2
Algeria,29/12/2012,10,0,0,0,3,0,0,13
Algeria,30/12/2012,4,0,0,0,3,2,0,9
Algeria,31/12/2012,2,0,0,0,-2,10,0,10
Bangladesh,01/12/2012,24,0,-3,0,15,0,0,36
Bangladesh,02/12/2012,30,0,0,0,-9,4,0,25
Bangladesh,03/12/2012,23,0,0,0,7,6,0,36
Bangladesh,04/12/2012,31,0,0,0,48,1,0,80
Bangladesh,05/12/2012,15,0,0,0,8,4,0,27
Bangladesh,06/12/2012,31,0,0,0,19,3,0,53
Bangladesh,07/12/2012,26,0,-2,0,4,4,0,32
Bangladesh,08/12/2012,22,0,-1,0,0,2,0,23
Bangladesh,09/12/2012,16,0,0,0,4,5,0,25
Bangladesh,10/12/2012,37,0,0,0,7,4,0,48
Bangladesh,11/12/2012,22,0,-7,0,28,2,0,45
Bangladesh,12/12/2012,25,4,-4,0,7,8,0,40
Bangladesh,13/12/2012,18,0,-2,0,19,-4,0,31
Bangladesh,14/12/2012,28,0,-2,0,7,2,0,35
Bangladesh,15/12/2012,1,0,0,0,17,1,0,19
Bangladesh,16/12/2012,19,2,0,0,3,0,0,24
Bangladesh,17/12/2012,20,0,0,0,0,3,0,23
Bangladesh,18/12/2012,11,0,0,0,-4,10,0,17
Bangladesh,19/12/2012,4,0,1,0,7,2,0,14
Bangladesh,20/12/2012,49,0,0,0,23,0,0,72
Bangladesh,21/12/2012,15,0,0,0,0,1,0,16
Bangladesh,22/12/2012,12,0,-2,0,0,1,0,11
Bangladesh,23/12/2012,11,0,0,0,-5,1,0,7
Bangladesh,24/12/2012,55,0,0,0,-3,9,0,61
Bangladesh,25/12/2012,30,0,1,0,8,0,0,39
Bangladesh,26/12/2012,11,0,0,0,-3,0,0,8
Bangladesh,27/12/2012,17,0,0,0,4,1,0,22
Bangladesh,28/12/2012,18,0,0,0,6,0,0,24
Bangladesh,29/12/2012,32,0,0,0,23,4,0,59
Bangladesh,30/12/2012,16,0,-4,0,12,13,0,37
Bangladesh,31/12/2012,32,0,0,0,3,5,0,40
Cameroon,01/12/2012,0,0,0,0,0,0,0,0
Cameroon,02/12/2012,29,0,0,0,3,7,0,39
Cameroon,03/12/2012,22,0,0,0,-2,1,0,21
Cameroon,04/12/2012,35,0,0,0,0,1,0,36
Cameroon,05/12/2012,6,0,0,0,3,0,0,9
Cameroon,06/12/2012,1,0,0,0,6,0,0,7
Cameroon,07/12/2012,2,0,0,0,6,2,0,10
Cameroon,08/12/2012,0,0,0,0,0,0,0,0
Cameroon,10/12/2012,0,0,0,0,0,0,0,0
Cameroon,11/12/2012,0,0,0,0,0,2,0,2
Cameroon,12/12/2012,0,0,0,0,0,0,0,0
Cameroon,13/12/2012,15,0,0,0,12,0,0,27
Cameroon,14/12/2012,6,0,0,0,9,0,0,15
Cameroon,15/12/2012,0,0,0,0,0,0,0,0
Cameroon,16/12/2012,3,0,0,0,0,0,0,3
Cameroon,17/12/2012,3,0,0,0,0,0,0,3
Cameroon,18/12/2012,1,0,1,0,36,3,0,41
Cameroon,19/12/2012,0,0,1,0,6,0,0,7
Cameroon,20/12/2012,2,0,0,0,0,0,0,2
Cameroon,21/12/2012,0,0,0,0,0,0,0,0
Cameroon,23/12/2012,0,2,0,0,3,0,0,5
Cameroon,24/12/2012,0,0,0,0,3,0,0,3
Cameroon,26/12/2012,1,0,-2,0,0,0,0,-1
Cameroon,27/12/2012,5,0,0,0,3,0,0,8
Cameroon,28/12/2012,3,0,0,0,0,0,0,3
Cameroon,29/12/2012,6,0,0,0,0,0,0,6
Cameroon,30/12/2012,0,0,0,0,0,0,0,0
Cameroon,31/12/2012,10,0,0,0,0,0,0,10
China,01/12/2012,60,0,0,0,65,9,0,134
China,02/12/2012,99,4,-6,0,33,14,0,144
China,03/12/2012,194,2,-10,0,104,21,0,311
China,04/12/2012,164,12,-5,0,64,30,0,265
China,05/12/2012,173,0,4,0,20,12,0,209
China,06/12/2012,174,0,-12,0,31,12,0,205
China,07/12/2012,152,0,1,0,79,25,0,257
China,08/12/2012,74,0,0,0,57,14,0,145
China,09/12/2012,112,2,-1,0,46,16,0,175
China,10/12/2012,161,2,-6,0,74,21,0,252
China,11/12/2012,126,2,-20,0,128,22,0,258
China,12/12/2012,201,6,4,0,71,11,0,293
China,13/12/2012,120,0,5,0,29,11,0,165
China,14/12/2012,164,0,0,0,43,7,0,214
China,15/12/2012,148,8,-3,0,31,14,0,198
China,16/12/2012,173,0,-13,0,20,5,0,185
China,17/12/2012,134,0,-5,0,91,16,0,236
China,18/12/2012,180,0,0,0,81,9,0,270
China,19/12/2012,132,2,-6,0,60,29,0,217
China,20/12/2012,74,6,-6,0,45,31,0,150
China,21/12/2012,48,0,-2,0,76,25,0,147
China,22/12/2012,62,0,-2,0,99,16,0,175
China,23/12/2012,59,0,0,0,25,10,0,94
China,24/12/2012,94,0,0,0,31,7,0,132
China,25/12/2012,87,0,-1,0,78,14,0,178
China,26/12/2012,129,0,0,0,44,11,0,184
China,27/12/2012,150,2,-2,0,75,15,0,240
China,28/12/2012,107,0,-2,0,43,15,0,163
China,29/12/2012,76,2,-1,0,25,9,0,111
China,30/12/2012,62,0,-17,0,22,7,0,74
China,31/12/2012,86,0,1,0,36,10,0,133
Egypt,01/12/2012,61,0,0,0,15,15,0,91
Egypt,02/12/2012,65,0,7,0,24,32,0,128
Egypt,03/12/2012,96,0,0,0,4,34,0,134
Egypt,04/12/2012,101,0,2,0,19,32,0,154
Egypt,05/12/2012,165,0,-2,0,32,46,0,241
Egypt,06/12/2012,176,0,-1,0,63,35,0,273
Egypt,07/12/2012,130,2,0,0,45,33,0,210
Egypt,08/12/2012,620,0,-19,0,253,98,0,952
Egypt,09/12/2012,105,0,-2,0,12,24,0,139
Egypt,10/12/2012,64,4,-3,0,10,17,0,92
Egypt,11/12/2012,66,0,-5,0,68,35,0,164
Egypt,12/12/2012,67,0,0,0,56,39,0,162
Egypt,13/12/2012,107,0,0,0,55,19,0,181
Egypt,14/12/2012,60,0,1,0,0,16,0,77
Egypt,15/12/2012,51,0,3,0,26,13,0,93
Egypt,16/12/2012,73,0,-10,0,37,7,0,107
Egypt,17/12/2012,62,0,-7,0,22,22,0,99
Egypt,18/12/2012,54,0,-28,0,25,12,0,63
Egypt,19/12/2012,74,14,0,0,15,5,0,108
Egypt,20/12/2012,102,0,0,0,32,25,0,159
Egypt,21/12/2012,27,0,-8,0,38,4,0,61
Egypt,22/12/2012,35,0,-22,0,32,13,0,58
Egypt,23/12/2012,81,0,-3,0,18,23,0,119
Egypt,24/12/2012,83,0,2,0,10,12,0,107
Egypt,25/12/2012,78,0,-1,0,4,17,0,98
Egypt,26/12/2012,83,0,-14,0,36,18,0,123
Egypt,27/12/2012,37,0,-27,0,17,13,0,40
Egypt,28/12/2012,60,0,-19,0,22,4,0,67
Egypt,29/12/2012,42,0,-3,0,15,13,0,67
Egypt,30/12/2012,61,0,-10,0,46,6,0,103
Egypt,31/12/2012,70,0,0,0,108,22,0,200
Eritrea,01/12/2012,0,0,0,0,0,0,0,0
Eritrea,02/12/2012,0,0,0,0,0,0,0,0
Eritrea,03/12/2012,0,0,0,0,0,0,0,0
Eritrea,04/12/2012,17,0,3,0,6,0,0,26
Eritrea,05/12/2012,2,0,0,0,18,0,0,20
Eritrea,06/12/2012,0,0,0,0,4,0,0,4
Eritrea,07/12/2012,1,0,0,0,6,0,0,7
Eritrea,08/12/2012,-1,0,0,0,0,0,0,-1
Eritrea,09/12/2012,0,0,0,0,0,0,0,0
Eritrea,10/12/2012,0,0,0,0,0,0,0,0
Eritrea,11/12/2012,6,0,0,0,24,0,0,30
Eritrea,12/12/2012,3,0,0,0,0,0,0,3
Eritrea,13/12/2012,0,0,0,0,6,0,0,6
Eritrea,14/12/2012,1,0,0,0,6,0,0,7
Eritrea,15/12/2012,0,0,0,0,0,0,0,0
Eritrea,18/12/2012,2,0,0,0,3,0,0,5
Eritrea,19/12/2012,1,0,0,0,0,1,0,2
Eritrea,21/12/2012,0,0,0,0,0,0,0,0
Eritrea,23/12/2012,0,0,0,0,0,0,0,0
Eritrea,24/12/2012,0,0,0,0,3,0,0,3
Eritrea,25/12/2012,0,0,0,0,15,0,0,15
Eritrea,26/12/2012,0,0,0,0,3,0,0,3
Eritrea,27/12/2012,0,0,0,0,-4,0,0,-4
Eritrea,28/12/2012,1,0,0,0,24,0,0,25
Eritrea,29/12/2012,0,0,0,0,9,0,0,9
Eritrea,30/12/2012,3,0,0,0,0,0,0,3
Eritrea,31/12/2012,6,0,0,0,3,2,0,11
Georgia,01/12/2012,0,0,0,0,0,0,0,0
Georgia,02/12/2012,0,0,0,0,0,0,0,0
Georgia,03/12/2012,-1,0,-4,0,0,0,0,-5
Georgia,04/12/2012,1,0,0,0,-2,1,0,0
Georgia,05/12/2012,8,0,-2,0,0,0,0,6
Georgia,06/12/2012,0,0,0,0,0,0,0,0
Georgia,07/12/2012,3,0,0,0,0,0,0,3
Georgia,08/12/2012,7,0,1,0,-2,2,0,8
Georgia,10/12/2012,4,0,0,0,0,0,0,4
Georgia,11/12/2012,3,0,0,0,9,0,0,12
Georgia,12/12/2012,-2,0,0,0,0,0,0,-2
Georgia,13/12/2012,4,0,0,0,0,0,0,4
Georgia,14/12/2012,3,0,4,0,1,2,0,10
Georgia,15/12/2012,0,0,0,0,0,2,0,2
Georgia,16/12/2012,0,0,0,0,0,0,0,0
Georgia,17/12/2012,0,0,0,0,12,0,0,12
Georgia,18/12/2012,0,0,0,0,6,0,0,6
Georgia,19/12/2012,3,0,0,0,6,2,0,11
Georgia,20/12/2012,0,0,0,0,7,0,0,7
Georgia,21/12/2012,0,0,1,0,9,2,0,12
Georgia,22/12/2012,0,0,0,0,0,0,0,0
Georgia,23/12/2012,0,2,0,0,0,0,0,2
Georgia,24/12/2012,2,0,0,0,4,0,0,6
Georgia,25/12/2012,1,0,0,0,0,2,0,3
Georgia,26/12/2012,6,0,-2,0,0,0,0,4
Georgia,27/12/2012,-1,0,0,0,-5,0,0,-6
Georgia,28/12/2012,0,0,0,0,3,0,0,3
Georgia,29/12/2012,5,0,0,0,-2,0,0,3
Georgia,30/12/2012,4,0,0,0,-2,0,0,2
Georgia,31/12/2012,0,2,0,0,0,0,0,2
India,01/12/2012,52,0,-4,0,6,6,0,60
India,02/12/2012,33,0,-6,0,3,7,0,37
India,03/12/2012,57,0,-1,0,-2,17,0,71
India,04/12/2012,74,6,-3,0,15,13,0,105
India,05/12/2012,53,4,0,0,31,15,0,103
India,06/12/2012,97,0,-3,0,-1,10,0,103
India,07/12/2012,45,2,2,0,53,5,0,107
India,08/12/2012,59,0,0,0,32,11,0,102
India,09/12/2012,62,0,-3,0,10,7,0,76
India,10/12/2012,131,0,2,0,52,15,0,200
India,11/12/2012,60,0,-3,0,23,14,0,94
India,12/12/2012,80,0,0,0,3,10,0,93
India,13/12/2012,95,0,1,0,18,5,0,119
India,14/12/2012,35,0,1,0,11,3,0,50
India,15/12/2012,47,0,-2,0,14,9,0,68
India,16/12/2012,93,0,1,0,8,3,0,105
India,17/12/2012,39,0,-5,0,23,11,0,68
India,18/12/2012,62,0,-6,0,38,14,0,108
India,19/12/2012,71,0,-2,0,0,17,0,86
India,20/12/2012,35,2,-6,0,18,17,0,66
India,21/12/2012,45,0,2,0,19,17,0,83
India,22/12/2012,65,0,-1,0,28,34,0,126
India,23/12/2012,37,0,1,0,20,24,0,82
India,24/12/2012,50,0,1,0,18,19,0,88
India,25/12/2012,79,2,1,0,3,11,0,96
India,26/12/2012,20,4,0,0,4,6,0,34
India,27/12/2012,30,0,-5,0,15,16,0,56
India,28/12/2012,63,2,-5,0,-11,17,0,66
India,29/12/2012,85,0,-5,0,25,23,0,128
India,30/12/2012,46,0,-5,0,43,18,0,102
India,31/12/2012,87,0,-2,0,16,18,0,119
Iran,01/12/2012,43,0,-2,0,45,15,0,101
Iran,02/12/2012,63,0,0,0,38,3,0,104
Iran,03/12/2012,88,0,-2,0,60,19,0,165
Iran,04/12/2012,165,0,0,0,81,23,0,269
Iran,05/12/2012,71,0,0,0,90,11,0,172
Iran,06/12/2012,67,0,4,0,37,6,0,114
Iran,07/12/2012,38,0,-2,0,-8,6,0,34
Iran,08/12/2012,32,0,0,0,33,7,0,72
Iran,09/12/2012,89,0,0,0,27,13,0,129
Iran,10/12/2012,92,0,-4,0,55,5,0,148
Iran,11/12/2012,89,0,-2,0,102,5,0,194
Iran,12/12/2012,63,0,0,0,61,8,0,132
Iran,13/12/2012,507,0,-3,0,228,64,0,796
Iran,14/12/2012,77,2,-2,0,28,6,0,111
Iran,15/12/2012,78,4,1,0,16,8,0,107
Iran,16/12/2012,119,2,-4,0,27,8,0,152
Iran,17/12/2012,106,0,0,0,29,27,0,162
Iran,18/12/2012,97,0,0,0,-4,14,0,107
Iran,19/12/2012,70,0,-4,0,44,6,0,116
Iran,20/12/2012,69,0,0,0,27,8,0,104
Iran,21/12/2012,83,0,1,0,21,6,0,111
Iran,22/12/2012,77,0,-4,0,17,24,0,114
Iran,23/12/2012,69,0,1,0,38,11,0,119
Iran,24/12/2012,59,4,1,0,4,14,0,82
Iran,25/12/2012,76,0,2,0,42,5,0,125
Iran,26/12/2012,82,0,0,0,73,8,0,163
Iran,27/12/2012,94,0,2,0,36,7,0,139
Iran,28/12/2012,69,0,0,0,48,4,0,121
Iran,29/12/2012,33,0,0,0,36,5,0,74
Iran,30/12/2012,87,0,0,0,39,31,0,157
Iran,31/12/2012,62,0,0,0,36,7,0,105
Iraq,01/12/2012,81,0,0,0,36,2,0,119
Iraq,02/12/2012,79,0,0,0,8,2,0,89
Iraq,03/12/2012,90,6,0,0,51,2,0,149
Iraq,04/12/2012,95,0,0,0,-14,5,0,86
Iraq,05/12/2012,108,2,0,0,6,5,0,121
Iraq,06/12/2012,103,0,0,0,-5,5,0,103
Iraq,07/12/2012,35,2,0,0,37,22,0,96
Iraq,08/12/2012,39,0,0,0,35,6,0,80
Iraq,09/12/2012,37,2,0,0,22,0,0,61
Iraq,10/12/2012,84,0,-4,0,15,8,0,103
Iraq,11/12/2012,161,0,1,0,47,4,0,213
Iraq,12/12/2012,126,0,0,0,3,13,0,142
Iraq,13/12/2012,114,0,0,0,12,5,0,131
Iraq,14/12/2012,98,2,-2,0,11,2,0,111
Iraq,15/12/2012,56,0,-2,0,10,3,0,67
Iraq,16/12/2012,94,4,-2,0,87,5,0,188
Iraq,17/12/2012,113,0,0,0,21,2,0,136
Iraq,18/12/2012,91,0,0,0,15,2,0,108
Iraq,19/12/2012,77,4,-1,0,0,2,0,82
Iraq,20/12/2012,80,2,0,0,31,9,0,122
Iraq,21/12/2012,57,2,1,0,73,1,0,134
Iraq,22/12/2012,49,0,-4,0,20,4,0,69
Iraq,23/12/2012,21,0,-1,0,19,23,0,62
Iraq,24/12/2012,74,0,0,0,0,0,0,74
Iraq,25/12/2012,55,0,0,0,10,0,0,65
Iraq,26/12/2012,37,0,0,0,24,15,0,76
Iraq,27/12/2012,101,0,0,0,42,25,0,168
Iraq,28/12/2012,138,6,0,0,24,16,0,184
Iraq,29/12/2012,67,4,0,0,3,2,0,76
Iraq,30/12/2012,46,2,-26,0,25,11,0,58
Iraq,31/12/2012,38,0,0,0,-5,6,0,39
Morocco,01/12/2012,-1,0,0,0,-4,0,0,-5
Morocco,02/12/2012,1,0,0,0,3,0,0,4
Morocco,03/12/2012,8,0,0,0,5,0,0,13
Morocco,04/12/2012,11,0,1,0,27,0,0,39
Morocco,05/12/2012,6,0,0,0,7,0,0,13
Morocco,06/12/2012,27,0,0,0,-2,4,0,29
Morocco,07/12/2012,-2,0,0,0,12,0,0,10
Morocco,08/12/2012,2,0,0,0,3,0,0,5
Morocco,09/12/2012,39,0,0,0,33,0,0,72
Morocco,10/12/2012,15,0,-2,0,12,1,0,26
Morocco,11/12/2012,87,0,-2,0,33,7,0,125
Morocco,12/12/2012,35,0,0,0,5,0,0,40
Morocco,13/12/2012,10,0,0,0,21,2,0,33
Morocco,14/12/2012,19,0,0,0,7,0,0,26
Morocco,15/12/2012,1,0,0,0,0,1,0,2
Morocco,16/12/2012,14,0,0,0,6,0,0,20
Morocco,17/12/2012,6,2,0,0,9,0,0,17
Morocco,18/12/2012,8,0,0,0,-2,1,0,7
Morocco,19/12/2012,2,0,0,0,0,1,0,3
Morocco,20/12/2012,23,0,4,0,3,0,0,30
Morocco,21/12/2012,0,0,0,0,6,1,0,7
Morocco,22/12/2012,2,0,0,0,18,0,0,20
Morocco,23/12/2012,2,0,0,0,6,0,0,8
Morocco,24/12/2012,3,0,0,0,3,0,0,6
Morocco,25/12/2012,4,0,0,0,0,0,0,4
Morocco,26/12/2012,2,0,0,0,12,0,0,14
Morocco,27/12/2012,4,0,0,0,6,3,0,13
Morocco,28/12/2012,6,0,0,0,3,1,0,10
Morocco,29/12/2012,7,0,0,0,0,0,0,7
Morocco,30/12/2012,7,4,0,0,0,0,0,11
Morocco,31/12/2012,9,0,0,0,-6,0,0,3
Nigeria,01/12/2012,15,0,0,0,8,5,0,28
Nigeria,02/12/2012,15,0,0,0,3,3,0,21
Nigeria,03/12/2012,16,0,0,0,-2,1,0,15
Nigeria,04/12/2012,33,2,1,0,12,1,0,49
Nigeria,05/12/2012,32,4,-1,0,54,23,0,112
Nigeria,06/12/2012,10,4,0,0,21,6,0,41
Nigeria,07/12/2012,10,4,3,0,0,3,0,20
Nigeria,08/12/2012,18,0,2,0,3,2,0,25
Nigeria,09/12/2012,-2,4,1,0,24,5,0,32
Nigeria,10/12/2012,36,2,0,0,13,5,0,56
Nigeria,11/12/2012,30,0,-8,0,30,5,0,57
Nigeria,12/12/2012,24,0,-4,0,33,4,0,57
Nigeria,13/12/2012,36,0,2,0,30,7,0,75
Nigeria,14/12/2012,43,0,0,0,22,2,0,67
Nigeria,15/12/2012,11,0,0,0,14,1,0,26
Nigeria,16/12/2012,18,0,0,0,6,1,0,25
Nigeria,17/12/2012,48,0,1,0,1,5,0,55
Nigeria,18/12/2012,40,0,-4,0,76,0,0,112
Nigeria,19/12/2012,33,0,-3,0,40,7,0,77
Nigeria,20/12/2012,22,0,-6,0,17,6,0,39
Nigeria,21/12/2012,14,0,0,0,15,1,0,30
Nigeria,22/12/2012,14,0,0,0,12,0,0,26
Nigeria,23/12/2012,33,0,0,0,7,4,0,44
Nigeria,24/12/2012,27,0,-3,0,16,1,0,41
Nigeria,25/12/2012,17,0,0,0,7,1,0,25
Nigeria,26/12/2012,24,0,0,0,4,1,0,29
Nigeria,27/12/2012,12,0,0,0,25,3,0,40
Nigeria,28/12/2012,20,0,0,0,7,9,0,36
Nigeria,29/12/2012,10,0,0,0,20,9,0,39
Nigeria,30/12/2012,11,0,0,0,9,0,0,20
Nigeria,31/12/2012,25,0,-3,0,10,4,0,36
Pakistan,01/12/2012,34,0,3,0,51,2,0,90
Pakistan,02/12/2012,45,8,1,0,4,19,0,77
Pakistan,03/12/2012,44,0,-1,0,26,5,0,74
Pakistan,04/12/2012,75,2,-2,0,11,6,0,92
Pakistan,05/12/2012,35,0,0,0,38,7,0,80
Pakistan,06/12/2012,45,0,-6,0,1,5,0,45
Pakistan,07/12/2012,48,0,0,0,10,5,0,63
Pakistan,08/12/2012,105,0,0,0,13,22,0,140
Pakistan,09/12/2012,68,0,2,0,69,8,0,147
Pakistan,10/12/2012,90,0,-2,0,40,12,0,140
Pakistan,11/12/2012,107,0,3,0,74,13,0,197
Pakistan,12/12/2012,44,0,0,0,4,1,0,49
Pakistan,13/12/2012,101,2,0,0,73,8,0,184
Pakistan,14/12/2012,65,0,0,0,72,5,0,142
Pakistan,15/12/2012,63,0,0,0,55,16,0,134
Pakistan,16/12/2012,150,0,3,0,65,1,0,219
Pakistan,17/12/2012,75,0,4,0,43,10,0,132
Pakistan,18/12/2012,115,0,0,0,24,7,0,146
Pakistan,19/12/2012,98,0,0,0,49,5,0,152
Pakistan,20/12/2012,45,0,6,0,24,15,0,90
Pakistan,21/12/2012,46,2,0,0,10,5,0,63
Pakistan,22/12/2012,77,0,0,0,33,7,0,117
Pakistan,23/12/2012,61,0,2,0,15,2,0,80
Pakistan,24/12/2012,47,0,3,0,6,4,0,60
Pakistan,25/12/2012,47,0,1,0,30,8,0,86
Pakistan,26/12/2012,71,0,-2,0,2,21,0,92
Pakistan,27/12/2012,75,0,0,0,6,22,0,103
Pakistan,28/12/2012,72,2,-2,0,7,4,0,83
Pakistan,29/12/2012,29,0,0,0,56,12,0,97
Pakistan,30/12/2012,341,0,0,0,75,29,0,445
Pakistan,31/12/2012,42,0,0,0,-33,11,0,20
Sierra Leone,01/12/2012,-3,0,0,0,0,0,0,-3
Sierra Leone,02/12/2012,0,0,0,0,0,3,0,3
Sierra Leone,03/12/2012,1,2,0,0,6,0,0,9
Sierra Leone,04/12/2012,8,0,0,0,3,0,0,11
Sierra Leone,05/12/2012,7,2,0,0,0,0,0,9
Sierra Leone,06/12/2012,7,0,0,0,0,0,0,7
Sierra Leone,07/12/2012,2,0,0,0,7,0,0,9
Sierra Leone,08/12/2012,3,0,0,0,1,3,0,7
Sierra Leone,09/12/2012,0,0,0,0,0,0,0,0
Sierra Leone,10/12/2012,0,0,0,0,-2,0,0,-2
Sierra Leone,11/12/2012,1,0,0,0,0,0,0,1
Sierra Leone,12/12/2012,4,0,0,0,0,0,0,4
Sierra Leone,13/12/2012,15,2,0,0,3,0,0,20
Sierra Leone,14/12/2012,0,0,0,0,0,0,0,0
Sierra Leone,15/12/2012,0,0,0,0,0,0,0,0
Sierra Leone,16/12/2012,0,0,0,0,0,0,0,0
Sierra Leone,17/12/2012,5,0,0,0,0,0,0,5
Sierra Leone,18/12/2012,0,0,0,0,3,0,0,3
Sierra Leone,19/12/2012,0,0,0,0,0,0,0,0
Sierra Leone,20/12/2012,9,0,0,0,0,0,0,9
Sierra Leone,21/12/2012,15,0,0,0,0,0,0,15
Sierra Leone,22/12/2012,0,0,0,0,0,0,0,0
Sierra Leone,24/12/2012,2,0,0,0,0,0,0,2
Sierra Leone,25/12/2012,-1,0,0,0,0,0,0,-1
Sierra Leone,28/12/2012,0,0,0,0,0,0,0,0
Sierra Leone,29/12/2012,3,0,0,0,0,0,0,3
Somalia,01/12/2012,7,0,0,0,4,4,0,15
Somalia,02/12/2012,11,2,0,0,-9,0,0,4
Somalia,03/12/2012,41,0,0,0,6,0,0,47
Somalia,04/12/2012,20,0,0,0,0,0,0,20
Somalia,05/12/2012,25,0,0,0,6,3,0,34
Somalia,06/12/2012,21,0,0,0,0,0,0,21
Somalia,07/12/2012,28,0,0,0,13,6,0,47
Somalia,08/12/2012,6,0,0,0,-4,2,0,4
Somalia,09/12/2012,24,0,0,0,0,0,0,24
Somalia,10/12/2012,42,2,0,0,34,8,0,86
Somalia,11/12/2012,50,2,0,0,38,0,0,90
Somalia,12/12/2012,20,2,0,0,61,3,0,86
Somalia,13/12/2012,11,0,0,0,9,0,0,20
Somalia,14/12/2012,76,2,0,0,-1,12,0,89
Somalia,15/12/2012,5,0,0,0,4,3,0,12
Somalia,16/12/2012,17,0,0,0,8,0,0,25
Somalia,17/12/2012,26,0,2,0,-3,2,0,27
Somalia,18/12/2012,30,0,0,0,7,3,0,40
Somalia,19/12/2012,31,0,0,0,16,1,0,48
Somalia,20/12/2012,80,0,0,0,17,13,0,110
Somalia,21/12/2012,41,0,2,0,22,2,0,67
Somalia,22/12/2012,9,0,0,0,12,0,0,21
Somalia,23/12/2012,12,0,0,0,-4,0,0,8
Somalia,24/12/2012,11,2,0,0,6,0,0,19
Somalia,25/12/2012,13,0,0,0,-2,0,0,11
Somalia,26/12/2012,5,0,1,0,3,3,0,12
Somalia,27/12/2012,8,0,0,0,13,0,0,21
Somalia,28/12/2012,24,0,0,0,-5,6,0,25
Somalia,29/12/2012,15,0,0,0,8,0,0,23
Somalia,30/12/2012,17,0,0,0,-4,0,0,13
Somalia,31/12/2012,10,0,0,0,10,0,0,20
Syria,01/12/2012,87,0,0,0,17,1,0,105
Syria,02/12/2012,104,0,0,0,6,17,0,127
Syria,03/12/2012,292,0,3,0,26,29,0,350
Syria,04/12/2012,312,4,-3,0,56,26,0,395
Syria,05/12/2012,258,0,0,0,1,20,0,279
Syria,06/12/2012,311,0,0,0,19,13,0,343
Syria,07/12/2012,207,4,-4,0,-1,15,0,221
Syria,08/12/2012,263,0,-1,0,12,14,0,288
Syria,09/12/2012,237,0,-1,0,-11,9,0,234
Syria,10/12/2012,170,0,-1,0,48,30,0,247
Syria,11/12/2012,240,8,-2,0,41,21,0,308
Syria,12/12/2012,348,4,-14,0,39,20,0,397
Syria,13/12/2012,170,2,0,0,7,15,0,194
Syria,14/12/2012,272,20,-1,0,32,8,0,331
Syria,15/12/2012,122,0,0,0,15,9,0,146
Syria,16/12/2012,152,4,-2,0,23,24,0,201
Syria,17/12/2012,213,4,2,0,10,11,0,240
Syria,18/12/2012,293,0,-2,0,186,20,0,497
Syria,19/12/2012,387,24,-6,0,93,44,0,542
Syria,20/12/2012,284,8,2,0,68,11,0,373
Syria,21/12/2012,115,0,-3,0,23,14,0,149
Syria,22/12/2012,133,2,-14,0,31,17,0,169
Syria,23/12/2012,154,4,0,0,2,10,0,170
Syria,24/12/2012,185,4,-1,0,21,21,0,230
Syria,25/12/2012,195,0,-3,0,5,4,0,201
Syria,26/12/2012,346,4,1,0,38,20,0,409
Syria,27/12/2012,178,0,-10,0,24,14,0,206
Syria,28/12/2012,208,0,-5,0,33,37,0,273
Syria,29/12/2012,115,6,-19,0,2,14,0,118
Syria,30/12/2012,159,0,-13,0,51,7,0,204
Syria,31/12/2012,145,0,-8,0,16,6,0,159
Yemen,01/12/2012,62,0,0,0,1,3,0,66
Yemen,02/12/2012,9,0,0,0,3,0,0,12
Yemen,03/12/2012,17,0,0,0,3,0,0,20
Yemen,04/12/2012,19,0,0,0,3,1,0,23
Yemen,05/12/2012,0,0,0,0,0,2,0,2
Yemen,06/12/2012,13,0,0,0,6,5,0,24
Yemen,07/12/2012,5,0,0,0,3,1,0,9
Yemen,08/12/2012,18,0,0,0,3,9,0,30
Yemen,09/12/2012,35,2,1,0,0,4,0,42
Yemen,10/12/2012,11,2,0,0,6,0,0,19
Yemen,11/12/2012,20,0,0,0,-4,0,0,16
Yemen,12/12/2012,13,0,0,0,6,0,0,19
Yemen,13/12/2012,24,0,0,0,13,1,0,38
Yemen,14/12/2012,20,0,-10,0,5,7,0,22
Yemen,15/12/2012,14,0,0,0,6,6,0,26
Yemen,16/12/2012,1,0,0,0,6,0,0,7
Yemen,17/12/2012,25,0,0,0,0,1,0,26
Yemen,18/12/2012,27,0,0,0,12,1,0,40
Yemen,19/12/2012,24,0,0,0,-2,3,0,25
Yemen,20/12/2012,28,0,0,0,-10,0,0,18
Yemen,21/12/2012,21,0,0,0,-5,0,0,16
Yemen,22/12/2012,6,0,0,0,19,0,0,25
Yemen,23/12/2012,3,0,0,0,-3,0,0,0
Yemen,24/12/2012,10,0,0,0,-2,4,0,12
Yemen,25/12/2012,75,0,0,0,11,6,0,92
Yemen,26/12/2012,25,0,0,0,10,0,0,35
Yemen,27/12/2012,40,2,0,0,12,4,0,58
Yemen,28/12/2012,35,0,0,0,14,2,0,51
Yemen,29/12/2012,23,0,1,0,11,0,0,35
Yemen,30/12/2012,24,0,0,0,9,2,0,35
Yemen,31/12/2012,41,0,0,0,6,3,0,50
Afghanistan,01/06/2012,137,0,-1,0,13,15,0,164
Afghanistan,02/06/2012,213,0,-4,0,35,13,0,257
Afghanistan,03/06/2012,175,0,-5,0,29,5,0,204
Afghanistan,04/06/2012,194,2,-6,0,17,11,0,218
Afghanistan,05/06/2012,125,2,-5,0,17,7,0,146
Afghanistan,06/06/2012,320,6,0,0,36,73,0,435
Afghanistan,07/06/2012,86,0,0,0,15,6,0,107
Afghanistan,08/06/2012,220,4,0,0,49,13,0,286
Afghanistan,09/06/2012,239,0,-5,0,2,7,0,243
Afghanistan,10/06/2012,68,2,0,0,8,5,0,83
Afghanistan,11/06/2012,177,0,1,0,34,12,0,224
Afghanistan,12/06/2012,217,2,0,0,59,19,0,297
Afghanistan,13/06/2012,165,4,-4,0,85,12,0,262
Afghanistan,14/06/2012,167,0,6,0,27,17,0,217
Afghanistan,15/06/2012,156,0,1,0,25,8,0,190
Afghanistan,16/06/2012,222,0,0,0,7,35,0,264
Afghanistan,17/06/2012,144,0,0,0,-7,5,0,142
Afghanistan,18/06/2012,199,0,2,0,14,5,0,220
Afghanistan,19/06/2012,200,0,12,0,55,26,0,293
Afghanistan,20/06/2012,217,2,4,0,61,38,0,322
Afghanistan,21/06/2012,238,2,1,0,89,22,0,352
Afghanistan,22/06/2012,203,8,0,0,29,12,0,252
Afghanistan,23/06/2012,68,2,1,0,24,4,0,99
Afghanistan,24/06/2012,131,0,-2,0,18,6,0,153
Afghanistan,25/06/2012,138,0,-2,0,32,9,0,177
Afghanistan,26/06/2012,183,0,0,0,35,9,0,227
Afghanistan,27/06/2012,170,2,0,0,31,8,0,211
Afghanistan,28/06/2012,94,0,0,0,8,26,0,128
Afghanistan,29/06/2012,153,0,1,0,34,31,0,219
Afghanistan,30/06/2012,102,4,-4,0,20,11,0,133
Albania,01/06/2012,22,0,0,0,6,4,0,32
Albania,02/06/2012,6,0,0,0,3,0,0,9
Albania,03/06/2012,2,0,0,0,0,0,0,2
Albania,04/06/2012,18,0,2,0,6,0,0,26
Albania,05/06/2012,15,0,-7,0,11,2,0,21
Albania,06/06/2012,1,0,0,0,0,0,0,1
Albania,07/06/2012,0,0,0,0,0,0,0,0
Albania,08/06/2012,8,0,0,0,0,1,0,9
Albania,09/06/2012,3,0,0,0,0,0,0,3
Albania,10/06/2012,2,0,0,0,0,0,0,2
Albania,11/06/2012,5,0,-3,0,0,5,0,7
Albania,12/06/2012,2,0,0,0,21,1,0,24
Albania,13/06/2012,5,0,1,0,3,1,0,10
Albania,14/06/2012,2,0,0,0,3,0,0,5
Albania,15/06/2012,2,0,0,0,0,0,0,2
Albania,16/06/2012,2,0,0,0,0,0,0,2
Albania,17/06/2012,0,4,0,0,0,1,0,5
Albania,18/06/2012,2,0,-2,0,3,0,0,3
Albania,19/06/2012,25,0,0,0,3,0,0,28
Albania,20/06/2012,4,0,0,0,0,2,0,6
Albania,21/06/2012,7,0,0,0,0,0,0,7
Albania,22/06/2012,0,0,0,0,0,0,0,0
Albania,23/06/2012,0,0,-2,0,-2,0,0,-4
Albania,25/06/2012,2,0,0,0,4,1,0,7
Albania,26/06/2012,2,0,-3,0,0,0,0,-1
Albania,27/06/2012,0,0,0,0,0,0,0,0
Albania,28/06/2012,3,0,-1,0,3,2,0,7
Albania,29/06/2012,4,0,1,0,-4,0,0,1
Albania,30/06/2012,0,0,0,0,0,0,0,0
Algeria,01/06/2012,2,0,0,0,0,0,0,2
Algeria,02/06/2012,0,0,0,0,0,0,0,0
Algeria,03/06/2012,1,0,0,0,3,0,0,4
Algeria,04/06/2012,0,0,0,0,3,0,0,3
Algeria,05/06/2012,0,0,0,0,0,0,0,0
Algeria,06/06/2012,12,0,0,0,3,1,0,16
Algeria,07/06/2012,0,0,1,0,0,0,0,1
Algeria,08/06/2012,4,0,0,0,0,0,0,4
Algeria,09/06/2012,-3,0,0,0,6,4,0,7
Algeria,10/06/2012,11,0,0,0,6,1,0,18
Algeria,11/06/2012,58,0,-1,0,29,2,0,88
Algeria,12/06/2012,9,0,0,0,39,2,0,50
Algeria,13/06/2012,9,0,0,0,27,1,0,37
Algeria,14/06/2012,10,0,0,0,9,2,0,21
Algeria,15/06/2012,3,0,0,0,12,2,0,17
Algeria,16/06/2012,6,0,0,0,5,1,0,12
Algeria,17/06/2012,35,0,-8,0,0,0,0,27
Algeria,18/06/2012,46,0,-2,0,0,0,0,44
Algeria,19/06/2012,19,0,-2,0,0,3,0,20
Algeria,20/06/2012,55,0,0,0,21,4,0,80
Algeria,21/06/2012,19,0,0,0,-1,11,0,29
Algeria,22/06/2012,23,0,-2,0,3,0,0,24
Algeria,23/06/2012,23,0,-2,0,0,0,0,21
Algeria,24/06/2012,5,0,0,0,1,1,0,7
Algeria,25/06/2012,6,0,-6,0,17,0,0,17
Algeria,26/06/2012,6,0,-2,0,6,1,0,11
Algeria,27/06/2012,42,0,0,0,1,0,0,43
Algeria,28/06/2012,7,0,0,0,0,0,0,7
Algeria,29/06/2012,17,0,0,0,9,0,0,26
Algeria,30/06/2012,0,0,0,0,3,0,0,3
Bangladesh,01/06/2012,1,0,0,0,0,0,0,1
Bangladesh,02/06/2012,9,0,0,0,0,1,0,10
Bangladesh,03/06/2012,19,0,0,0,2,2,0,23
Bangladesh,04/06/2012,47,0,0,0,0,0,0,47
Bangladesh,05/06/2012,52,0,-2,0,15,9,0,74
Bangladesh,06/06/2012,27,0,-2,0,1,12,0,38
Bangladesh,07/06/2012,0,0,0,0,-2,0,0,-2
Bangladesh,08/06/2012,15,0,1,0,20,0,0,36
Bangladesh,09/06/2012,75,0,0,0,15,17,0,107
Bangladesh,10/06/2012,40,0,0,0,54,8,0,102
Bangladesh,11/06/2012,74,0,0,0,28,17,0,119
Bangladesh,12/06/2012,127,0,0,0,42,13,0,182
Bangladesh,13/06/2012,82,0,0,0,12,3,0,97
Bangladesh,14/06/2012,95,0,0,0,5,3,0,103
Bangladesh,15/06/2012,67,0,0,0,18,10,0,95
Bangladesh,16/06/2012,66,0,0,0,12,21,0,99
Bangladesh,17/06/2012,135,0,0,0,22,16,0,173
Bangladesh,18/06/2012,34,0,2,0,22,1,0,59
Bangladesh,19/06/2012,91,0,1,0,34,4,0,130
Bangladesh,20/06/2012,40,0,0,0,-1,4,0,43
Bangladesh,21/06/2012,79,0,0,0,40,8,0,127
Bangladesh,22/06/2012,-11,2,0,0,10,8,0,9
Bangladesh,23/06/2012,10,0,0,0,13,2,0,25
Bangladesh,24/06/2012,11,2,2,0,-4,4,0,15
Bangladesh,25/06/2012,1,0,0,0,9,2,0,12
Bangladesh,26/06/2012,25,0,0,0,34,5,0,64
Bangladesh,27/06/2012,19,0,0,0,6,1,0,26
Bangladesh,28/06/2012,29,0,0,0,4,1,0,34
Bangladesh,29/06/2012,29,2,0,0,10,2,0,43
Bangladesh,30/06/2012,8,0,0,0,4,2,0,14
Cameroon,01/06/2012,3,0,0,0,0,0,0,3
Cameroon,02/06/2012,0,0,0,0,0,0,0,0
Cameroon,04/06/2012,0,0,0,0,0,0,0,0
Cameroon,05/06/2012,0,0,0,0,0,0,0,0
Cameroon,06/06/2012,-1,0,0,0,0,0,0,-1
Cameroon,07/06/2012,0,0,0,0,0,0,0,0
Cameroon,08/06/2012,0,0,0,0,0,0,0,0
Cameroon,09/06/2012,6,2,0,0,3,0,0,11
Cameroon,10/06/2012,0,0,0,0,3,0,0,3
Cameroon,11/06/2012,0,0,0,0,0,0,0,0
Cameroon,12/06/2012,2,0,0,0,0,0,0,2
Cameroon,13/06/2012,6,0,0,0,-2,0,0,4
Cameroon,15/06/2012,0,0,0,0,0,0,0,0
Cameroon,16/06/2012,0,0,0,0,0,0,0,0
Cameroon,17/06/2012,0,0,0,0,0,0,0,0
Cameroon,18/06/2012,2,0,0,0,0,0,0,2
Cameroon,19/06/2012,6,2,0,0,0,0,0,8
Cameroon,20/06/2012,2,0,0,0,0,0,0,2
Cameroon,21/06/2012,5,0,-1,0,0,0,0,4
Cameroon,22/06/2012,0,0,0,0,3,0,0,3
Cameroon,23/06/2012,0,0,0,0,3,0,0,3
Cameroon,25/06/2012,6,2,0,0,0,2,0,10
Cameroon,26/06/2012,1,0,0,0,0,0,0,1
Cameroon,27/06/2012,0,0,0,0,0,0,0,0
Cameroon,28/06/2012,0,0,0,0,0,0,0,0
Cameroon,29/06/2012,0,0,0,0,0,0,0,0
China,01/06/2012,77,0,1,0,62,15,0,155
China,02/06/2012,150,2,0,0,75,10,0,237
China,03/06/2012,162,0,4,0,40,13,0,219
China,04/06/2012,164,4,-2,0,128,29,0,323
China,05/06/2012,220,6,1,0,121,31,0,379
China,06/06/2012,258,4,1,0,170,32,0,465
China,07/06/2012,73,0,0,0,50,3,0,126
China,08/06/2012,219,2,0,0,112,30,0,363
China,09/06/2012,93,2,0,0,10,8,0,113
China,10/06/2012,67,6,-3,0,27,13,0,110
China,11/06/2012,208,6,2,0,48,36,0,300
China,12/06/2012,143,0,-2,0,114,25,0,280
China,13/06/2012,166,0,-2,0,178,19,0,361
China,14/06/2012,178,2,3,0,68,19,0,270
China,15/06/2012,114,12,-6,0,84,14,0,218
China,16/06/2012,58,4,0,0,44,7,0,113
China,17/06/2012,55,2,-2,0,30,6,0,91
China,18/06/2012,152,4,0,0,97,15,0,268
China,19/06/2012,238,2,-3,0,77,14,0,328
China,20/06/2012,255,6,-1,0,150,15,0,425
China,21/06/2012,163,2,-11,0,72,18,0,244
China,22/06/2012,192,2,-4,0,42,21,0,253
China,23/06/2012,100,4,0,0,43,16,0,163
China,24/06/2012,74,0,0,0,49,24,0,147
China,25/06/2012,51,2,2,0,71,11,0,137
China,26/06/2012,122,6,-3,0,29,18,0,172
China,27/06/2012,149,6,-6,0,53,18,0,220
China,28/06/2012,102,2,-3,0,67,8,0,176
China,29/06/2012,171,2,12,0,57,24,0,266
China,30/06/2012,107,0,0,0,17,11,0,135
Egypt,01/06/2012,62,0,-4,0,29,4,0,91
Egypt,02/06/2012,91,0,-5,0,223,21,0,330
Egypt,03/06/2012,72,0,0,0,102,20,0,194
Egypt,04/06/2012,112,0,-5,0,105,15,0,227
Egypt,05/06/2012,69,0,-2,0,22,18,0,107
Egypt,06/06/2012,85,0,-3,0,80,37,0,199
Egypt,07/06/2012,12,0,0,0,0,3,0,15
Egypt,08/06/2012,59,0,0,0,41,34,0,134
Egypt,09/06/2012,73,0,0,0,22,5,0,100
Egypt,10/06/2012,85,0,-5,0,81,19,0,180
Egypt,11/06/2012,60,0,-3,0,38,21,0,116
Egypt,12/06/2012,31,0,-5,0,59,15,0,100
Egypt,13/06/2012,103,0,6,0,101,30,0,240
Egypt,14/06/2012,162,0,-6,0,99,32,0,287
Egypt,15/06/2012,128,4,-5,0,70,24,0,221
Egypt,16/06/2012,129,0,-10,0,57,32,0,208
Egypt,17/06/2012,123,0,-34,0,37,17,0,143
Egypt,18/06/2012,460,2,-27,0,58,35,0,528
Egypt,19/06/2012,318,2,-22,0,102,44,0,444
Egypt,20/06/2012,212,0,-9,0,66,31,0,300
Egypt,21/06/2012,164,2,-9,0,33,26,0,216
Egypt,22/06/2012,167,0,-2,0,37,25,0,227
Egypt,23/06/2012,119,0,-7,0,46,14,0,172
Egypt,24/06/2012,195,0,-8,0,32,52,0,271
Egypt,25/06/2012,120,2,-4,0,17,7,0,142
Egypt,26/06/2012,155,0,-8,0,97,31,0,275
Egypt,27/06/2012,68,2,-6,0,72,14,0,150
Egypt,28/06/2012,43,0,-3,0,47,17,0,104
Egypt,29/06/2012,75,2,-1,0,78,19,0,173
Egypt,30/06/2012,63,0,-3,0,-17,15,0,58
Eritrea,03/06/2012,0,0,0,0,5,4,0,9
Eritrea,04/06/2012,12,0,0,0,0,17,0,29
Eritrea,05/06/2012,1,0,0,0,9,3,0,13
Eritrea,06/06/2012,2,0,0,0,10,2,0,14
Eritrea,07/06/2012,0,0,0,0,0,0,0,0
Eritrea,08/06/2012,4,0,0,0,0,2,0,6
Eritrea,10/06/2012,3,0,-1,0,9,13,0,24
Eritrea,11/06/2012,8,0,-1,0,12,14,0,33
Eritrea,12/06/2012,1,0,0,0,3,0,0,4
Eritrea,13/06/2012,2,2,0,0,15,0,0,19
Eritrea,14/06/2012,3,0,0,0,0,2,0,5
Eritrea,15/06/2012,8,0,0,0,3,2,0,13
Eritrea,17/06/2012,16,0,0,0,6,0,0,22
Eritrea,18/06/2012,14,0,0,0,29,0,0,43
Eritrea,19/06/2012,4,0,0,0,0,0,0,4
Eritrea,20/06/2012,-1,0,0,0,4,0,0,3
Eritrea,21/06/2012,9,0,0,0,12,0,0,21
Eritrea,22/06/2012,3,0,0,0,-2,0,0,1
Eritrea,23/06/2012,0,0,0,0,3,0,0,3
Eritrea,24/06/2012,2,0,0,0,6,2,0,10
Eritrea,25/06/2012,2,0,0,0,6,2,0,10
Eritrea,26/06/2012,0,0,0,0,6,0,0,6
Eritrea,27/06/2012,0,0,0,0,12,0,0,12
Eritrea,28/06/2012,0,0,0,0,0,0,0,0
Eritrea,29/06/2012,4,4,0,0,-2,2,0,8
Eritrea,30/06/2012,0,0,0,0,3,0,0,3
Georgia,01/06/2012,10,0,0,0,0,1,0,11
Georgia,02/06/2012,15,0,0,0,9,3,0,27
Georgia,03/06/2012,14,0,0,0,-1,0,0,13
Georgia,04/06/2012,16,0,0,0,8,2,0,26
Georgia,05/06/2012,43,2,-4,0,16,3,0,60
Georgia,06/06/2012,50,2,-3,0,19,6,0,74
Georgia,07/06/2012,6,0,0,0,3,0,0,9
Georgia,08/06/2012,72,2,-2,0,28,3,0,103
Georgia,09/06/2012,28,0,1,0,6,2,0,37
Georgia,10/06/2012,22,0,0,0,-2,8,0,28
Georgia,11/06/2012,47,2,0,0,1,0,0,50
Georgia,12/06/2012,72,2,3,0,8,6,0,91
Georgia,13/06/2012,62,0,-2,0,19,6,0,85
Georgia,14/06/2012,24,2,0,0,7,0,0,33
Georgia,15/06/2012,46,2,0,0,34,4,0,86
Georgia,16/06/2012,23,0,0,0,8,1,0,32
Georgia,17/06/2012,20,2,-3,0,7,1,0,27
Georgia,18/06/2012,50,0,0,0,46,7,0,103
Georgia,19/06/2012,59,2,0,0,34,5,0,100
Georgia,20/06/2012,40,2,-2,0,26,6,0,72
Georgia,21/06/2012,14,0,-2,0,34,1,0,47
Georgia,22/06/2012,32,2,0,0,25,2,0,61
Georgia,23/06/2012,15,0,0,0,16,0,0,31
Georgia,24/06/2012,16,0,0,0,12,1,0,29
Georgia,25/06/2012,3,0,0,0,-2,0,0,1
Georgia,26/06/2012,92,0,0,0,25,7,0,124
Georgia,27/06/2012,54,2,-1,0,7,8,0,70
Georgia,28/06/2012,37,0,-2,0,15,2,0,52
Georgia,29/06/2012,59,0,1,0,15,10,0,85
Georgia,30/06/2012,15,0,-6,0,23,0,0,32
India,01/06/2012,45,0,-4,0,13,4,0,58
India,02/06/2012,41,0,2,0,11,16,0,70
India,03/06/2012,39,0,0,0,7,4,0,50
India,04/06/2012,55,0,-2,0,13,12,0,78
India,05/06/2012,84,2,0,0,19,5,0,110
India,06/06/2012,27,0,0,0,9,1,0,37
India,07/06/2012,10,0,1,0,3,2,0,16
India,08/06/2012,62,0,-4,0,35,10,0,103
India,09/06/2012,47,0,1,0,19,10,0,77
India,10/06/2012,109,2,0,0,31,8,0,150
India,11/06/2012,188,1,4,0,52,11,0,256
India,12/06/2012,110,4,-1,0,15,17,0,145
India,13/06/2012,62,4,-3,0,19,5,0,87
India,14/06/2012,32,0,0,0,9,5,0,46
India,15/06/2012,68,2,-2,0,82,10,0,160
India,16/06/2012,122,2,1,0,66,4,0,195
India,17/06/2012,43,0,1,0,23,5,0,72
India,18/06/2012,61,2,0,0,23,17,0,103
India,19/06/2012,46,2,-1,0,80,12,0,139
India,20/06/2012,83,4,2,0,27,14,0,130
India,21/06/2012,122,6,2,0,15,9,0,154
India,22/06/2012,63,0,0,0,17,11,0,91
India,23/06/2012,28,0,-2,0,2,1,0,29
India,24/06/2012,51,0,-1,0,17,7,0,74
India,25/06/2012,37,0,0,0,-1,7,0,43
India,26/06/2012,78,0,-10,0,13,17,0,98
India,27/06/2012,62,2,-5,0,14,7,0,80
India,28/06/2012,71,2,0,0,47,9,0,129
India,29/06/2012,71,2,-4,0,24,5,0,98
India,30/06/2012,60,2,-2,0,6,13,0,79
Iran,01/06/2012,42,0,0,0,21,9,0,72
Iran,02/06/2012,83,0,0,0,25,8,0,116
Iran,03/06/2012,71,0,0,0,4,7,0,82
Iran,04/06/2012,114,0,0,0,1,13,0,128
Iran,05/06/2012,115,0,-3,0,52,17,0,181
Iran,06/06/2012,131,0,0,0,15,42,0,188
Iran,07/06/2012,43,0,0,0,0,14,0,57
Iran,08/06/2012,120,4,-5,0,35,13,0,167
Iran,09/06/2012,60,0,2,0,32,11,0,105
Iran,10/06/2012,127,0,1,0,38,6,0,172
Iran,11/06/2012,178,0,-2,0,30,13,0,219
Iran,12/06/2012,144,2,2,0,91,10,0,249
Iran,13/06/2012,126,0,-8,0,63,6,0,187
Iran,14/06/2012,133,0,-2,0,52,16,0,199
Iran,15/06/2012,71,0,0,0,23,17,0,111
Iran,16/06/2012,56,0,0,0,44,13,0,113
Iran,17/06/2012,95,0,-1,0,25,8,0,127
Iran,18/06/2012,110,0,3,0,56,10,0,179
Iran,19/06/2012,139,0,-2,0,44,9,0,190
Iran,20/06/2012,177,0,0,0,155,13,0,345
Iran,21/06/2012,91,0,1,0,79,5,0,176
Iran,22/06/2012,194,0,3,0,83,4,0,284
Iran,23/06/2012,140,0,2,0,34,8,0,184
Iran,24/06/2012,145,0,-4,0,24,4,0,169
Iran,25/06/2012,75,0,-1,0,52,1,0,127
Iran,26/06/2012,152,0,4,0,51,14,0,221
Iran,27/06/2012,191,0,0,0,32,5,0,228
Iran,28/06/2012,135,0,2,0,30,18,0,185
Iran,29/06/2012,146,0,3,0,32,12,0,193
Iran,30/06/2012,76,0,1,0,41,9,0,127
Iraq,01/06/2012,97,4,2,0,-1,0,0,102
Iraq,02/06/2012,76,0,2,0,16,6,0,100
Iraq,03/06/2012,42,2,0,0,19,4,0,67
Iraq,04/06/2012,111,0,1,0,54,11,0,177
Iraq,05/06/2012,110,2,1,0,24,6,0,143
Iraq,06/06/2012,61,10,1,0,19,11,0,102
Iraq,07/06/2012,12,0,0,0,18,0,0,30
Iraq,08/06/2012,89,2,7,0,69,18,0,185
Iraq,09/06/2012,39,2,3,0,26,0,0,70
Iraq,10/06/2012,17,0,0,0,19,1,0,37
Iraq,11/06/2012,75,2,-3,0,75,9,0,158
Iraq,12/06/2012,125,4,-6,0,26,12,0,161
Iraq,13/06/2012,147,4,0,0,13,30,0,194
Iraq,14/06/2012,55,2,3,0,17,16,0,93
Iraq,15/06/2012,105,4,1,0,27,19,0,156
Iraq,16/06/2012,86,0,2,0,16,34,0,138
Iraq,17/06/2012,59,0,0,0,-2,2,0,59
Iraq,18/06/2012,106,12,0,0,7,7,0,132
Iraq,19/06/2012,213,0,0,0,22,25,0,260
Iraq,20/06/2012,161,0,0,0,28,3,0,192
Iraq,21/06/2012,89,0,2,0,57,2,0,150
Iraq,22/06/2012,78,0,0,0,36,10,0,124
Iraq,23/06/2012,78,0,0,0,9,4,0,91
Iraq,24/06/2012,137,2,-2,0,15,15,0,167
Iraq,25/06/2012,33,2,-4,0,22,5,0,58
Iraq,26/06/2012,109,2,-1,0,21,12,0,143
Iraq,27/06/2012,106,4,11,0,16,25,0,162
Iraq,28/06/2012,86,0,2,0,14,3,0,105
Iraq,29/06/2012,35,2,3,0,6,6,0,52
Iraq,30/06/2012,141,4,-12,0,13,11,0,157
Morocco,01/06/2012,1,0,0,0,0,0,0,1
Morocco,02/06/2012,0,0,0,0,20,0,0,20
Morocco,03/06/2012,6,0,2,0,-4,0,0,4
Morocco,04/06/2012,0,0,0,0,-2,0,0,-2
Morocco,05/06/2012,0,1,0,0,5,1,0,7
Morocco,06/06/2012,5,0,0,0,0,1,0,6
Morocco,07/06/2012,2,0,0,0,6,0,0,8
Morocco,08/06/2012,1,0,0,0,-2,1,0,0
Morocco,09/06/2012,0,0,0,0,0,5,0,5
Morocco,10/06/2012,1,0,0,0,-2,0,0,-1
Morocco,11/06/2012,0,0,0,0,3,0,0,3
Morocco,12/06/2012,5,0,0,0,-2,1,0,4
Morocco,13/06/2012,0,0,0,0,0,0,0,0
Morocco,14/06/2012,0,0,0,0,-2,1,0,-1
Morocco,15/06/2012,3,0,0,0,-1,2,0,4
Morocco,16/06/2012,4,0,0,0,5,0,0,9
Morocco,17/06/2012,2,0,0,0,0,0,0,2
Morocco,18/06/2012,2,4,1,0,-8,1,0,0
Morocco,19/06/2012,18,0,0,0,-2,1,0,17
Morocco,20/06/2012,6,0,0,0,0,0,0,6
Morocco,21/06/2012,5,0,0,0,-1,2,0,6
Morocco,22/06/2012,28,0,0,0,15,2,0,45
Morocco,23/06/2012,10,0,0,0,15,2,0,27
Morocco,24/06/2012,1,0,0,0,6,0,0,7
Morocco,25/06/2012,1,0,0,0,0,2,0,3
Morocco,26/06/2012,8,0,0,0,28,1,0,37
Morocco,27/06/2012,2,0,0,0,13,3,0,18
Morocco,28/06/2012,5,0,0,0,0,1,0,6
Morocco,29/06/2012,7,0,0,0,0,10,0,17
Morocco,30/06/2012,15,0,0,0,0,0,0,15
Nigeria,01/06/2012,24,0,-1,0,8,2,0,33
Nigeria,02/06/2012,10,0,0,0,9,0,0,19
Nigeria,03/06/2012,31,0,0,0,7,10,0,48
Nigeria,04/06/2012,34,0,1,0,22,0,0,57
Nigeria,05/06/2012,28,2,0,0,10,3,0,43
Nigeria,06/06/2012,32,2,1,0,12,2,0,49
Nigeria,07/06/2012,4,0,0,0,0,0,0,4
Nigeria,08/06/2012,16,0,0,0,18,1,0,35
Nigeria,09/06/2012,8,0,0,0,0,1,0,9
Nigeria,10/06/2012,72,0,0,0,12,18,0,102
Nigeria,11/06/2012,40,2,0,0,14,8,0,64
Nigeria,12/06/2012,25,2,0,0,8,7,0,42
Nigeria,13/06/2012,33,0,-1,0,24,5,0,61
Nigeria,14/06/2012,37,0,-4,0,39,9,0,81
Nigeria,15/06/2012,69,2,1,0,32,9,0,113
Nigeria,16/06/2012,18,0,0,0,19,1,0,38
Nigeria,17/06/2012,19,0,1,0,21,0,0,41
Nigeria,18/06/2012,31,0,3,0,29,7,0,70
Nigeria,19/06/2012,38,0,0,0,18,3,0,59
Nigeria,20/06/2012,50,0,0,0,21,8,0,79
Nigeria,21/06/2012,26,0,3,0,-4,5,0,30
Nigeria,22/06/2012,37,0,0,0,20,4,0,61
Nigeria,23/06/2012,10,0,0,0,-5,0,0,5
Nigeria,24/06/2012,25,0,0,0,3,1,0,29
Nigeria,25/06/2012,14,0,0,0,40,1,0,55
Nigeria,26/06/2012,36,0,1,0,31,4,0,72
Nigeria,27/06/2012,15,0,0,0,37,3,0,55
Nigeria,28/06/2012,38,6,0,0,37,0,0,81
Nigeria,29/06/2012,13,0,-2,0,6,1,0,18
Nigeria,30/06/2012,14,0,0,0,0,0,0,14
Pakistan,01/06/2012,96,0,0,0,5,2,0,103
Pakistan,02/06/2012,54,0,3,0,25,15,0,97
Pakistan,03/06/2012,101,0,-8,0,-2,5,0,96
Pakistan,04/06/2012,156,0,5,0,60,14,0,235
Pakistan,05/06/2012,312,0,-8,0,62,12,0,378
Pakistan,06/06/2012,227,0,7,0,43,6,0,283
Pakistan,07/06/2012,71,0,0,0,1,7,0,79
Pakistan,08/06/2012,153,0,-9,0,37,38,0,219
Pakistan,09/06/2012,164,4,2,0,43,6,0,219
Pakistan,10/06/2012,189,2,-4,0,74,14,0,275
Pakistan,11/06/2012,171,0,-1,0,47,18,0,235
Pakistan,12/06/2012,106,2,9,0,43,15,0,175
Pakistan,13/06/2012,137,2,3,0,43,9,0,194
Pakistan,14/06/2012,62,4,-5,0,36,2,0,99
Pakistan,15/06/2012,62,0,0,0,25,4,0,91
Pakistan,16/06/2012,47,0,3,0,18,12,0,80
Pakistan,17/06/2012,75,0,-1,0,29,6,0,109
Pakistan,18/06/2012,92,0,0,0,57,10,0,159
Pakistan,19/06/2012,157,0,-9,0,177,18,0,343
Pakistan,20/06/2012,128,8,3,0,110,9,0,258
Pakistan,21/06/2012,310,0,0,0,155,45,0,510
Pakistan,22/06/2012,170,0,-2,0,89,22,0,279
Pakistan,23/06/2012,86,0,0,0,45,10,0,141
Pakistan,24/06/2012,77,0,-2,0,35,6,0,116
Pakistan,25/06/2012,89,0,-3,0,63,0,0,149
Pakistan,26/06/2012,109,0,0,0,36,9,0,154
Pakistan,27/06/2012,105,0,7,0,43,13,0,168
Pakistan,28/06/2012,88,6,0,0,15,7,0,116
Pakistan,29/06/2012,116,0,3,0,30,11,0,160
Pakistan,30/06/2012,95,0,4,0,14,5,0,118
Sierra Leone,01/06/2012,0,0,0,0,3,0,0,3
Sierra Leone,02/06/2012,7,0,0,0,27,0,0,34
Sierra Leone,03/06/2012,7,0,0,0,9,0,0,16
Sierra Leone,04/06/2012,3,0,0,0,18,1,0,22
Sierra Leone,05/06/2012,3,0,0,0,6,0,0,9
Sierra Leone,06/06/2012,9,0,0,0,0,0,0,9
Sierra Leone,08/06/2012,7,0,0,0,0,0,0,7
Sierra Leone,09/06/2012,7,0,1,0,0,0,0,8
Sierra Leone,10/06/2012,1,0,0,0,-2,0,0,-1
Sierra Leone,11/06/2012,-2,0,0,0,0,0,0,-2
Sierra Leone,12/06/2012,0,0,0,0,3,0,0,3
Sierra Leone,13/06/2012,4,0,0,0,15,2,0,21
Sierra Leone,14/06/2012,1,0,0,0,9,0,0,10
Sierra Leone,15/06/2012,11,0,-1,0,10,0,0,20
Sierra Leone,16/06/2012,6,0,-2,0,0,0,0,4
Sierra Leone,17/06/2012,0,0,0,0,0,0,0,0
Sierra Leone,18/06/2012,-1,0,0,0,0,0,0,-1
Sierra Leone,19/06/2012,16,0,0,0,7,1,0,24
Sierra Leone,20/06/2012,4,0,0,0,3,0,0,7
Sierra Leone,21/06/2012,0,0,0,0,0,0,0,0
Sierra Leone,22/06/2012,1,0,0,0,15,0,0,16
Sierra Leone,23/06/2012,10,0,0,0,0,0,0,10
Sierra Leone,24/06/2012,1,0,0,0,0,0,0,1
Sierra Leone,25/06/2012,0,0,0,0,0,0,0,0
Sierra Leone,26/06/2012,-2,2,0,0,0,0,0,0
Sierra Leone,27/06/2012,6,0,0,0,1,0,0,7
Sierra Leone,28/06/2012,0,0,0,0,3,0,0,3
Sierra Leone,29/06/2012,5,0,0,0,0,0,0,5
Sierra Leone,30/06/2012,2,0,0,0,0,0,0,2
Somalia,01/06/2012,76,8,2,0,21,5,0,112
Somalia,02/06/2012,38,0,0,0,19,0,0,57
Somalia,03/06/2012,42,0,0,0,39,10,0,91
Somalia,04/06/2012,72,4,1,0,97,20,0,194
Somalia,05/06/2012,124,0,1,0,42,11,0,178
Somalia,06/06/2012,103,0,0,0,49,7,0,159
Somalia,07/06/2012,13,0,0,0,-4,10,0,19
Somalia,08/06/2012,50,2,-1,0,40,4,0,95
Somalia,09/06/2012,38,0,0,0,7,4,0,49
Somalia,10/06/2012,84,4,0,0,10,17,0,115
Somalia,11/06/2012,95,0,-2,0,50,12,0,155
Somalia,12/06/2012,59,2,-2,0,22,1,0,82
Somalia,13/06/2012,83,0,1,0,70,6,0,160
Somalia,14/06/2012,82,0,-2,0,30,2,0,112
Somalia,15/06/2012,45,0,0,0,13,1,0,59
Somalia,16/06/2012,90,0,-1,0,13,12,0,114
Somalia,17/06/2012,107,2,-1,0,9,12,0,129
Somalia,18/06/2012,85,2,-3,0,44,45,0,173
Somalia,19/06/2012,94,0,0,0,42,15,0,151
Somalia,20/06/2012,119,0,-2,0,43,9,0,169
Somalia,21/06/2012,84,0,-6,0,30,18,0,126
Somalia,22/06/2012,74,0,0,0,94,28,0,196
Somalia,23/06/2012,117,0,0,0,47,10,0,174
Somalia,24/06/2012,76,0,0,0,22,2,0,100
Somalia,25/06/2012,82,6,0,0,27,3,0,118
Somalia,26/06/2012,66,0,-2,0,71,18,0,153
Somalia,27/06/2012,71,8,2,0,100,17,0,198
Somalia,28/06/2012,102,0,-1,0,47,13,0,161
Somalia,29/06/2012,271,0,0,0,169,41,0,481
Somalia,30/06/2012,123,4,-2,0,43,11,0,179
Syria,01/06/2012,224,14,-9,0,33,20,0,282
Syria,02/06/2012,408,12,-7,0,102,55,0,570
Syria,03/06/2012,467,2,0,0,37,39,0,545
Syria,04/06/2012,272,0,-7,0,66,36,0,367
Syria,05/06/2012,239,0,-1,0,95,25,0,358
Syria,06/06/2012,496,0,-1,0,64,34,0,593
Syria,07/06/2012,126,0,-6,0,18,21,0,159
Syria,08/06/2012,540,4,0,0,51,62,0,657
Syria,09/06/2012,248,0,-12,0,42,24,0,302
Syria,10/06/2012,276,2,-4,0,75,17,0,366
Syria,11/06/2012,293,4,0,0,28,14,0,339
Syria,12/06/2012,270,16,-12,0,46,31,0,351
Syria,13/06/2012,535,0,7,0,34,33,0,609
Syria,14/06/2012,226,2,-1,0,25,36,0,288
Syria,15/06/2012,273,0,-9,0,84,61,0,409
Syria,16/06/2012,169,0,-5,0,36,17,0,217
Syria,17/06/2012,128,4,-4,0,27,29,0,184
Syria,18/06/2012,261,12,-8,0,-16,21,0,270
Syria,19/06/2012,300,4,0,0,27,33,0,364
Syria,20/06/2012,354,0,-12,0,35,10,0,387
Syria,21/06/2012,398,0,-16,0,-9,16,0,389
Syria,22/06/2012,500,0,-2,0,19,25,0,542
Syria,23/06/2012,354,0,-12,0,0,18,0,360
Syria,24/06/2012,528,0,-5,0,13,28,0,564
Syria,25/06/2012,381,0,2,0,14,9,0,406
Syria,26/06/2012,784,0,-12,0,214,36,0,1022
Syria,27/06/2012,449,6,-11,0,37,39,0,520
Syria,28/06/2012,399,6,-14,0,6,20,0,417
Syria,29/06/2012,327,4,-5,0,21,9,0,356
Syria,30/06/2012,214,6,-21,0,18,17,0,234
Yemen,01/06/2012,4,0,-6,0,3,4,0,5
Yemen,02/06/2012,25,0,-7,0,20,8,0,46
Yemen,03/06/2012,23,0,0,0,8,10,0,41
Yemen,04/06/2012,36,0,0,0,12,4,0,52
Yemen,05/06/2012,78,0,-6,0,3,0,0,75
Yemen,06/06/2012,70,0,-6,0,9,2,0,75
Yemen,07/06/2012,9,0,0,0,-4,0,0,5
Yemen,08/06/2012,22,0,-4,0,-1,0,0,17
Yemen,09/06/2012,27,0,3,0,7,2,0,39
Yemen,10/06/2012,38,0,1,0,3,1,0,43
Yemen,11/06/2012,88,0,3,0,-12,9,0,88
Yemen,12/06/2012,68,0,1,0,8,13,0,90
Yemen,13/06/2012,82,2,2,0,3,4,0,93
Yemen,14/06/2012,59,8,0,0,3,4,0,74
Yemen,15/06/2012,62,0,-2,0,7,3,0,70
Yemen,16/06/2012,56,0,0,0,13,39,0,108
Yemen,17/06/2012,47,0,0,0,4,31,0,82
Yemen,18/06/2012,116,0,1,0,11,50,0,178
Yemen,19/06/2012,58,0,-2,0,7,13,0,76
Yemen,20/06/2012,119,0,-3,0,0,2,0,118
Yemen,21/06/2012,48,0,-5,0,6,13,0,62
Yemen,22/06/2012,26,0,-6,0,33,9,0,62
Yemen,23/06/2012,19,2,0,0,3,4,0,28
Yemen,24/06/2012,17,0,-2,0,-1,0,0,14
Yemen,25/06/2012,11,0,0,0,9,2,0,22
Yemen,26/06/2012,45,0,0,0,5,1,0,51
Yemen,27/06/2012,7,0,1,0,9,2,0,19
Yemen,28/06/2012,28,0,-8,0,9,4,0,33
Yemen,29/06/2012,26,0,-1,0,8,0,0,33
Yemen,30/06/2012,25,0,-1,0,-1,0,0,23
Afghanistan,01/10/2010,355,4,1,0,31,47,0,438
Afghanistan,02/10/2010,449,6,0,0,5,29,0,489
Afghanistan,03/10/2010,276,2,0,0,99,49,0,426
Afghanistan,04/10/2010,416,12,-2,0,70,55,0,551
Afghanistan,05/10/2010,633,6,-6,0,164,59,0,856
Afghanistan,06/10/2010,575,2,5,0,96,45,0,723
Afghanistan,07/10/2010,341,2,4,0,75,19,0,441
Afghanistan,08/10/2010,434,0,-9,0,78,36,0,539
Afghanistan,09/10/2010,216,0,-2,0,72,25,0,311
Afghanistan,10/10/2010,161,2,-2,0,32,17,0,210
Afghanistan,11/10/2010,232,2,-6,0,75,30,0,333
Afghanistan,12/10/2010,236,0,1,0,63,22,0,322
Afghanistan,13/10/2010,161,0,1,0,21,15,0,198
Afghanistan,14/10/2010,442,2,-1,0,170,66,0,679
Afghanistan,15/10/2010,476,0,2,0,71,35,0,584
Afghanistan,16/10/2010,303,2,0,0,52,26,0,383
Afghanistan,17/10/2010,205,0,2,0,135,18,0,360
Afghanistan,18/10/2010,207,2,3,0,45,17,0,274
Afghanistan,19/10/2010,127,2,-2,0,3,5,0,135
Afghanistan,20/10/2010,66,0,0,0,-8,1,0,59
Afghanistan,21/10/2010,17,0,0,0,0,5,0,22
Afghanistan,22/10/2010,249,2,3,0,82,12,0,348
Afghanistan,23/10/2010,344,0,2,0,54,19,0,419
Afghanistan,24/10/2010,266,0,4,0,51,18,0,339
Afghanistan,25/10/2010,414,4,2,0,100,33,0,553
Afghanistan,26/10/2010,160,0,-1,0,102,40,0,301
Afghanistan,27/10/2010,254,12,-6,0,161,30,0,451
Afghanistan,28/10/2010,203,2,0,0,110,12,0,327
Afghanistan,29/10/2010,201,0,-3,0,84,20,0,302
Afghanistan,30/10/2010,87,0,-2,0,30,8,0,123
Afghanistan,31/10/2010,244,0,1,0,103,32,0,380
Albania,01/10/2010,1,0,-3,0,1,0,0,-1
Albania,02/10/2010,3,0,0,0,0,0,0,3
Albania,03/10/2010,28,0,0,0,12,0,0,40
Albania,04/10/2010,1,0,0,0,0,0,0,1
Albania,05/10/2010,13,0,0,0,0,1,0,14
Albania,06/10/2010,4,0,0,0,0,0,0,4
Albania,07/10/2010,-1,0,0,0,12,1,0,12
Albania,08/10/2010,3,0,0,0,0,2,0,5
Albania,09/10/2010,-1,0,0,0,0,0,0,-1
Albania,10/10/2010,0,0,0,0,6,0,0,6
Albania,11/10/2010,2,0,0,0,9,0,0,11
Albania,12/10/2010,7,0,0,0,1,0,0,8
Albania,13/10/2010,11,0,-1,0,3,0,0,13
Albania,14/10/2010,5,0,0,0,3,1,0,9
Albania,15/10/2010,0,0,-3,0,6,0,0,3
Albania,16/10/2010,3,0,0,0,6,0,0,9
Albania,17/10/2010,0,0,0,0,0,0,0,0
Albania,18/10/2010,0,0,0,0,5,0,0,5
Albania,19/10/2010,2,0,0,0,0,1,0,3
Albania,20/10/2010,0,0,0,0,0,0,0,0
Albania,21/10/2010,0,0,0,0,-2,0,0,-2
Albania,22/10/2010,4,0,0,0,-2,0,0,2
Albania,23/10/2010,16,0,0,0,6,0,0,22
Albania,24/10/2010,0,0,0,0,6,0,0,6
Albania,25/10/2010,3,0,0,0,6,0,0,9
Albania,26/10/2010,0,0,0,0,-2,0,0,-2
Albania,27/10/2010,2,0,0,0,-2,0,0,0
Albania,28/10/2010,0,0,0,0,0,0,0,0
Albania,29/10/2010,22,0,1,0,-1,0,0,22
Albania,30/10/2010,0,0,-1,0,0,0,0,-1
Albania,31/10/2010,0,0,0,0,-2,0,0,-2
Algeria,01/10/2010,10,0,0,0,18,6,0,34
Algeria,02/10/2010,0,0,0,0,6,0,0,6
Algeria,03/10/2010,2,0,0,0,12,2,0,16
Algeria,04/10/2010,17,0,0,0,1,0,0,18
Algeria,05/10/2010,17,0,0,0,22,1,0,40
Algeria,06/10/2010,21,0,0,0,43,1,0,65
Algeria,07/10/2010,1,0,0,0,9,1,0,11
Algeria,08/10/2010,10,0,0,0,-11,3,0,2
Algeria,09/10/2010,0,0,0,0,0,0,0,0
Algeria,10/10/2010,10,0,0,0,0,0,0,10
Algeria,11/10/2010,3,0,0,0,8,2,0,13
Algeria,12/10/2010,-2,0,0,0,-2,1,0,-3
Algeria,13/10/2010,2,0,-1,0,13,0,0,14
Algeria,14/10/2010,23,0,0,0,0,0,0,23
Algeria,15/10/2010,6,0,0,0,0,0,0,6
Algeria,16/10/2010,-1,0,0,0,3,0,0,2
Algeria,17/10/2010,13,0,0,0,27,0,0,40
Algeria,18/10/2010,11,0,0,0,30,0,0,41
Algeria,19/10/2010,9,0,0,0,6,0,0,15
Algeria,20/10/2010,2,0,0,0,0,0,0,2
Algeria,21/10/2010,0,0,0,0,-1,0,0,-1
Algeria,22/10/2010,3,0,0,0,0,0,0,3
Algeria,23/10/2010,0,0,0,0,6,0,0,6
Algeria,24/10/2010,0,0,0,0,6,0,0,6
Algeria,25/10/2010,0,0,0,0,0,0,0,0
Algeria,26/10/2010,20,0,-1,0,0,0,0,19
Algeria,27/10/2010,10,0,0,0,0,0,0,10
Algeria,28/10/2010,2,0,0,0,0,1,0,3
Algeria,29/10/2010,14,0,0,0,13,0,0,27
Algeria,30/10/2010,0,0,0,0,0,0,0,0
Algeria,31/10/2010,8,2,0,0,9,0,0,19
Bangladesh,01/10/2010,18,0,0,0,0,0,0,18
Bangladesh,02/10/2010,11,0,0,0,-2,1,0,10
Bangladesh,03/10/2010,27,0,0,0,0,0,0,27
Bangladesh,04/10/2010,9,0,-2,0,9,3,0,19
Bangladesh,05/10/2010,13,0,0,0,24,2,0,39
Bangladesh,06/10/2010,12,0,0,0,13,5,0,30
Bangladesh,07/10/2010,8,0,-2,0,2,2,0,10
Bangladesh,08/10/2010,16,0,0,0,2,1,0,19
Bangladesh,09/10/2010,17,0,1,0,2,3,0,23
Bangladesh,10/10/2010,19,0,1,0,15,5,0,40
Bangladesh,11/10/2010,13,0,2,0,1,0,0,16
Bangladesh,12/10/2010,15,0,0,0,1,9,0,25
Bangladesh,13/10/2010,13,0,0,0,12,2,0,27
Bangladesh,14/10/2010,21,0,1,0,6,8,0,36
Bangladesh,15/10/2010,-2,4,0,0,21,3,0,26
Bangladesh,16/10/2010,14,0,0,0,3,1,0,18
Bangladesh,17/10/2010,23,0,0,0,-6,4,0,21
Bangladesh,18/10/2010,11,0,0,0,12,0,0,23
Bangladesh,19/10/2010,14,2,-1,0,-8,5,0,12
Bangladesh,20/10/2010,0,0,0,0,9,0,0,9
Bangladesh,22/10/2010,24,2,0,0,-6,0,0,20
Bangladesh,23/10/2010,13,0,-1,0,8,0,0,20
Bangladesh,24/10/2010,6,0,0,0,3,0,0,9
Bangladesh,25/10/2010,44,0,0,0,51,2,0,97
Bangladesh,26/10/2010,8,0,0,0,3,0,0,11
Bangladesh,27/10/2010,12,0,-1,0,31,2,0,44
Bangladesh,28/10/2010,12,0,0,0,-2,2,0,12
Bangladesh,29/10/2010,4,0,0,0,3,1,0,8
Bangladesh,30/10/2010,1,0,1,0,1,1,0,4
Bangladesh,31/10/2010,22,0,-2,0,-4,5,0,21
Cameroon,01/10/2010,0,0,0,0,-3,0,0,-3
Cameroon,02/10/2010,5,0,0,0,2,0,0,7
Cameroon,03/10/2010,1,0,0,0,0,0,0,1
Cameroon,04/10/2010,0,0,0,0,1,0,0,1
Cameroon,05/10/2010,6,0,0,0,0,0,0,6
Cameroon,06/10/2010,3,0,0,0,0,1,0,4
Cameroon,07/10/2010,-1,0,0,0,9,3,0,11
Cameroon,08/10/2010,0,0,0,0,0,0,0,0
Cameroon,09/10/2010,0,0,0,0,0,0,0,0
Cameroon,10/10/2010,0,0,0,0,0,0,0,0
Cameroon,11/10/2010,1,0,0,0,0,0,0,1
Cameroon,12/10/2010,0,0,0,0,0,0,0,0
Cameroon,14/10/2010,-3,0,0,0,9,0,0,6
Cameroon,15/10/2010,11,0,0,0,3,0,0,14
Cameroon,16/10/2010,7,0,-2,0,0,0,0,5
Cameroon,17/10/2010,0,0,0,0,0,0,0,0
Cameroon,18/10/2010,1,0,0,0,0,0,0,1
Cameroon,23/10/2010,0,0,0,0,0,0,0,0
Cameroon,24/10/2010,1,0,0,0,6,0,0,7
Cameroon,25/10/2010,4,0,0,0,0,0,0,4
Cameroon,26/10/2010,2,0,0,0,0,0,0,2
Cameroon,27/10/2010,0,0,0,0,0,0,0,0
Cameroon,28/10/2010,0,0,0,0,0,0,0,0
Cameroon,29/10/2010,0,0,0,0,0,0,0,0
Cameroon,31/10/2010,3,0,0,0,0,0,0,3
China,01/10/2010,132,4,-3,0,5,26,0,164
China,02/10/2010,78,0,-1,0,29,6,0,112
China,03/10/2010,50,4,2,0,18,4,0,78
China,04/10/2010,155,12,1,0,10,12,0,190
China,05/10/2010,162,0,-3,0,30,12,0,201
China,06/10/2010,201,0,-1,0,68,27,0,295
China,07/10/2010,111,0,0,0,15,11,0,137
China,08/10/2010,131,20,-3,0,89,29,0,266
China,09/10/2010,83,0,-2,0,48,8,0,137
China,10/10/2010,76,0,-5,0,44,16,0,131
China,11/10/2010,129,4,1,0,14,21,0,169
China,12/10/2010,83,4,-1,0,22,20,0,128
China,13/10/2010,76,0,1,0,33,5,0,115
China,14/10/2010,165,10,1,0,34,16,0,226
China,15/10/2010,100,8,-2,0,54,18,0,178
China,16/10/2010,76,4,-3,0,27,15,0,119
China,17/10/2010,136,8,-1,0,22,28,0,193
China,18/10/2010,121,0,1,0,51,30,0,203
China,19/10/2010,57,2,0,0,43,13,0,115
China,20/10/2010,0,0,0,0,6,1,0,7
China,21/10/2010,22,0,0,0,5,1,0,28
China,22/10/2010,99,0,0,0,61,17,0,177
China,23/10/2010,88,0,-1,0,63,10,0,160
China,24/10/2010,70,0,1,0,27,16,0,114
China,25/10/2010,146,6,0,0,28,9,0,189
China,26/10/2010,97,4,-1,0,43,7,0,150
China,27/10/2010,60,6,-2,0,77,15,0,156
China,28/10/2010,124,2,-4,0,76,15,0,213
China,29/10/2010,169,4,2,0,56,16,0,247
China,30/10/2010,56,0,3,0,14,3,0,76
China,31/10/2010,119,0,-2,0,18,7,0,142
Egypt,01/10/2010,73,0,0,0,9,7,0,89
Egypt,02/10/2010,26,0,0,0,19,2,0,47
Egypt,03/10/2010,24,0,0,0,5,3,0,32
Egypt,04/10/2010,51,0,0,0,2,1,0,54
Egypt,05/10/2010,45,0,0,0,39,1,0,85
Egypt,06/10/2010,40,0,0,0,9,0,0,49
Egypt,07/10/2010,27,0,0,0,36,5,0,68
Egypt,08/10/2010,45,0,0,0,21,1,0,67
Egypt,09/10/2010,26,0,-4,0,37,0,0,59
Egypt,10/10/2010,23,0,-1,0,16,0,0,38
Egypt,11/10/2010,105,0,2,0,7,1,0,115
Egypt,12/10/2010,9,0,0,0,24,0,0,33
Egypt,13/10/2010,32,2,0,0,13,3,0,50
Egypt,14/10/2010,29,0,2,0,25,0,0,56
Egypt,15/10/2010,26,0,0,0,21,4,0,51
Egypt,16/10/2010,23,0,0,0,3,0,0,26
Egypt,17/10/2010,44,0,1,0,7,2,0,54
Egypt,18/10/2010,20,0,0,0,8,2,0,30
Egypt,19/10/2010,10,0,1,0,8,4,0,23
Egypt,20/10/2010,0,0,1,0,0,0,0,1
Egypt,21/10/2010,5,0,0,0,-2,1,0,4
Egypt,22/10/2010,43,4,4,0,4,1,0,56
Egypt,23/10/2010,12,0,2,0,21,5,0,40
Egypt,24/10/2010,28,0,0,0,38,1,0,67
Egypt,25/10/2010,17,0,0,0,22,0,0,39
Egypt,26/10/2010,38,0,-1,0,16,8,0,61
Egypt,27/10/2010,40,0,0,0,18,0,0,58
Egypt,28/10/2010,35,0,-1,0,12,6,0,52
Egypt,29/10/2010,27,0,0,0,28,6,0,61
Egypt,30/10/2010,87,0,0,0,-2,0,0,85
Egypt,31/10/2010,70,0,0,0,20,3,0,93
Eritrea,01/10/2010,7,0,0,0,0,0,0,7
Eritrea,02/10/2010,6,0,0,0,0,0,0,6
Eritrea,03/10/2010,0,0,0,0,0,0,0,0
Eritrea,04/10/2010,1,0,0,0,-2,0,0,-1
Eritrea,05/10/2010,0,0,0,0,1,1,0,2
Eritrea,06/10/2010,0,0,3,0,0,0,0,3
Eritrea,07/10/2010,5,0,1,0,0,0,0,6
Eritrea,08/10/2010,10,0,1,0,6,0,0,17
Eritrea,09/10/2010,0,0,0,0,0,0,0,0
Eritrea,10/10/2010,1,0,0,0,6,0,0,7
Eritrea,11/10/2010,2,0,0,0,0,0,0,2
Eritrea,12/10/2010,0,0,0,0,0,0,0,0
Eritrea,13/10/2010,1,0,0,0,0,0,0,1
Eritrea,14/10/2010,2,0,0,0,0,0,0,2
Eritrea,15/10/2010,1,0,0,0,0,0,0,1
Eritrea,16/10/2010,1,0,0,0,0,0,0,1
Eritrea,17/10/2010,0,0,0,0,0,0,0,0
Eritrea,18/10/2010,1,0,0,0,6,2,0,9
Eritrea,19/10/2010,1,0,0,0,1,0,0,2
Eritrea,21/10/2010,0,0,0,0,0,0,0,0
Eritrea,22/10/2010,0,0,0,0,0,0,0,0
Eritrea,23/10/2010,0,0,0,0,0,0,0,0
Eritrea,25/10/2010,0,0,0,0,0,0,0,0
Eritrea,27/10/2010,0,0,0,0,6,0,0,6
Eritrea,28/10/2010,2,0,0,0,3,0,0,5
Eritrea,29/10/2010,4,0,1,0,-2,0,0,3
Eritrea,30/10/2010,0,0,0,0,0,0,0,0
Georgia,01/10/2010,36,0,-4,0,14,3,0,49
Georgia,02/10/2010,17,0,0,0,6,0,0,23
Georgia,03/10/2010,45,0,0,0,2,3,0,50
Georgia,04/10/2010,99,0,0,0,44,10,0,153
Georgia,05/10/2010,59,0,1,0,31,4,0,95
Georgia,06/10/2010,30,0,0,0,4,1,0,35
Georgia,07/10/2010,19,2,0,0,3,5,0,29
Georgia,08/10/2010,34,4,0,0,0,4,0,42
Georgia,09/10/2010,10,0,0,0,-1,2,0,11
Georgia,10/10/2010,11,0,0,0,7,1,0,19
Georgia,11/10/2010,35,0,-1,0,11,2,0,47
Georgia,12/10/2010,25,0,1,0,19,4,0,49
Georgia,13/10/2010,9,0,0,0,13,1,0,23
Georgia,14/10/2010,14,0,-2,0,-8,2,0,6
Georgia,15/10/2010,30,0,0,0,25,7,0,62
Georgia,16/10/2010,31,2,-4,0,28,5,0,62
Georgia,17/10/2010,12,0,-2,0,-1,0,0,9
Georgia,18/10/2010,-2,0,0,0,10,3,0,11
Georgia,19/10/2010,4,0,-2,0,3,1,0,6
Georgia,20/10/2010,0,0,0,0,0,1,0,1
Georgia,21/10/2010,9,0,0,0,0,0,0,9
Georgia,22/10/2010,11,0,-2,0,4,0,0,13
Georgia,23/10/2010,34,0,-1,0,18,2,0,53
Georgia,24/10/2010,19,0,0,0,-2,0,0,17
Georgia,25/10/2010,31,2,0,0,13,2,0,48
Georgia,26/10/2010,30,2,0,0,8,4,0,44
Georgia,27/10/2010,34,0,0,0,-2,3,0,35
Georgia,28/10/2010,9,0,-2,0,9,2,0,18
Georgia,29/10/2010,44,0,0,0,31,4,0,79
Georgia,30/10/2010,0,0,0,0,3,0,0,3
Georgia,31/10/2010,33,0,1,0,3,2,0,39
India,01/10/2010,79,2,0,0,23,9,0,113
India,02/10/2010,11,0,0,0,19,5,0,35
India,03/10/2010,33,4,0,0,5,4,0,46
India,04/10/2010,16,2,0,0,11,7,0,36
India,05/10/2010,77,2,-1,0,20,11,0,109
India,06/10/2010,50,0,1,0,0,5,0,56
India,07/10/2010,52,0,2,0,16,5,0,75
India,08/10/2010,78,2,0,0,40,11,0,131
India,09/10/2010,90,0,0,0,12,16,0,118
India,10/10/2010,86,0,0,0,-4,-1,0,81
India,11/10/2010,48,2,-2,0,6,8,0,62
India,12/10/2010,10,2,0,0,4,0,0,16
India,13/10/2010,35,2,0,0,4,7,0,48
India,14/10/2010,35,2,-1,0,25,6,0,67
India,15/10/2010,49,4,0,0,18,5,0,76
India,16/10/2010,27,0,1,0,5,1,0,34
India,17/10/2010,45,0,-2,0,10,1,0,54
India,18/10/2010,41,0,0,0,16,4,0,61
India,19/10/2010,29,2,0,0,13,2,0,46
India,20/10/2010,1,0,0,0,0,0,0,1
India,21/10/2010,7,0,0,0,0,0,0,7
India,22/10/2010,49,0,0,0,3,11,0,63
India,23/10/2010,77,0,1,0,4,14,0,96
India,24/10/2010,45,0,0,0,-7,4,0,42
India,25/10/2010,66,4,-1,0,59,4,0,132
India,26/10/2010,23,0,0,0,6,4,0,33
India,27/10/2010,52,6,-2,0,10,3,0,69
India,28/10/2010,16,2,0,0,17,5,0,40
India,29/10/2010,57,0,1,0,11,3,0,72
India,30/10/2010,4,0,-2,0,15,3,0,20
India,31/10/2010,50,0,-4,0,23,3,0,72
Iran,01/10/2010,49,0,-10,0,-2,3,0,40
Iran,02/10/2010,63,0,3,0,46,7,0,119
Iran,03/10/2010,22,0,0,0,26,0,0,48
Iran,04/10/2010,65,0,-1,0,30,5,0,99
Iran,05/10/2010,49,0,0,0,25,6,0,80
Iran,06/10/2010,41,0,0,0,18,14,0,73
Iran,07/10/2010,62,0,1,0,18,8,0,89
Iran,08/10/2010,42,0,0,0,32,5,0,79
Iran,09/10/2010,54,0,0,0,19,7,0,80
Iran,10/10/2010,42,0,5,0,8,5,0,60
Iran,11/10/2010,171,0,-4,0,53,4,0,224
Iran,12/10/2010,82,0,0,0,29,10,0,121
Iran,13/10/2010,70,0,1,0,25,7,0,103
Iran,14/10/2010,251,0,0,0,103,16,0,370
Iran,15/10/2010,113,2,2,0,35,14,0,166
Iran,16/10/2010,25,0,0,0,9,5,0,39
Iran,17/10/2010,34,0,2,0,54,3,0,93
Iran,18/10/2010,66,0,0,0,34,14,0,114
Iran,19/10/2010,28,0,1,0,22,13,0,64
Iran,20/10/2010,6,0,0,0,18,7,0,31
Iran,21/10/2010,17,0,0,0,9,1,0,27
Iran,22/10/2010,79,0,0,0,25,12,0,116
Iran,23/10/2010,86,0,0,0,52,24,0,162
Iran,24/10/2010,79,0,0,0,33,11,0,123
Iran,25/10/2010,86,0,4,0,51,10,0,151
Iran,26/10/2010,67,0,-3,0,42,6,0,112
Iran,27/10/2010,106,10,2,0,66,7,0,191
Iran,28/10/2010,52,0,-5,0,14,8,0,69
Iran,29/10/2010,68,0,-1,0,18,4,0,89
Iran,30/10/2010,29,0,0,0,14,0,0,43
Iran,31/10/2010,59,0,0,0,26,9,0,94
Iraq,01/10/2010,100,2,-2,0,13,12,0,125
Iraq,02/10/2010,90,4,-8,0,16,11,0,113
Iraq,03/10/2010,111,2,0,0,40,12,0,165
Iraq,04/10/2010,174,2,3,0,49,8,0,236
Iraq,05/10/2010,156,2,0,0,17,26,0,201
Iraq,06/10/2010,175,4,-4,0,58,27,0,260
Iraq,07/10/2010,156,2,0,0,28,6,0,192
Iraq,08/10/2010,120,2,-2,0,9,19,0,148
Iraq,09/10/2010,30,6,1,0,14,3,0,54
Iraq,10/10/2010,120,2,0,0,17,9,0,148
Iraq,11/10/2010,186,2,0,0,0,6,0,194
Iraq,12/10/2010,90,0,2,0,14,15,0,121
Iraq,13/10/2010,56,0,0,0,9,11,0,76
Iraq,14/10/2010,119,0,-4,0,57,20,0,192
Iraq,15/10/2010,85,2,0,0,55,14,0,156
Iraq,16/10/2010,78,0,2,0,40,4,0,124
Iraq,17/10/2010,130,4,0,0,21,16,0,171
Iraq,18/10/2010,130,0,0,0,-6,6,0,130
Iraq,19/10/2010,34,0,4,0,-2,4,0,40
Iraq,20/10/2010,6,0,0,0,12,0,0,18
Iraq,21/10/2010,28,0,0,0,-4,3,0,27
Iraq,22/10/2010,197,0,3,0,44,25,0,269
Iraq,23/10/2010,171,2,0,0,142,37,0,352
Iraq,24/10/2010,144,0,-1,0,91,24,0,258
Iraq,25/10/2010,193,2,1,0,97,30,0,323
Iraq,26/10/2010,150,0,6,0,203,26,0,385
Iraq,27/10/2010,136,2,1,0,171,22,0,332
Iraq,28/10/2010,115,4,1,0,88,4,0,212
Iraq,29/10/2010,112,2,2,0,40,20,0,176
Iraq,30/10/2010,16,0,0,0,1,10,0,27
Iraq,31/10/2010,116,0,1,0,25,21,0,163
Morocco,01/10/2010,9,0,0,0,18,0,0,27
Morocco,02/10/2010,3,0,0,0,48,0,0,51
Morocco,03/10/2010,7,0,0,0,0,0,0,7
Morocco,04/10/2010,22,0,0,0,18,4,0,44
Morocco,05/10/2010,10,0,0,0,9,1,0,20
Morocco,06/10/2010,4,0,0,0,-2,4,0,6
Morocco,07/10/2010,3,0,0,0,18,0,0,21
Morocco,08/10/2010,3,0,0,0,24,0,0,27
Morocco,09/10/2010,-3,0,0,0,1,0,0,-2
Morocco,10/10/2010,2,0,0,0,0,0,0,2
Morocco,11/10/2010,9,0,0,0,-6,0,0,3
Morocco,12/10/2010,9,0,0,0,4,0,0,13
Morocco,13/10/2010,9,0,0,0,3,0,0,12
Morocco,14/10/2010,8,0,0,0,0,6,0,14
Morocco,15/10/2010,-5,0,0,0,13,0,0,8
Morocco,16/10/2010,11,0,0,0,6,0,0,17
Morocco,17/10/2010,33,0,0,0,0,0,0,33
Morocco,18/10/2010,5,0,0,0,40,0,0,45
Morocco,19/10/2010,2,0,0,0,9,0,0,11
Morocco,21/10/2010,1,0,0,0,-4,0,0,-3
Morocco,22/10/2010,12,0,0,0,3,3,0,18
Morocco,23/10/2010,2,0,0,0,0,0,0,2
Morocco,24/10/2010,0,0,0,0,12,0,0,12
Morocco,25/10/2010,13,0,0,0,3,0,0,16
Morocco,26/10/2010,11,0,0,0,0,1,0,12
Morocco,27/10/2010,3,0,0,0,0,0,0,3
Morocco,28/10/2010,5,0,0,0,12,0,0,17
Morocco,29/10/2010,4,0,0,0,7,13,0,24
Morocco,30/10/2010,2,0,-4,0,0,2,0,0
Morocco,31/10/2010,3,0,0,0,4,0,0,7
Nigeria,01/10/2010,33,0,0,0,-17,0,0,16
Nigeria,02/10/2010,10,0,-2,0,-2,2,0,8
Nigeria,03/10/2010,12,0,0,0,9,1,0,22
Nigeria,04/10/2010,14,0,0,0,10,2,0,26
Nigeria,05/10/2010,15,0,0,0,7,3,0,25
Nigeria,06/10/2010,7,0,1,0,3,1,0,12
Nigeria,07/10/2010,10,0,2,0,13,0,0,25
Nigeria,08/10/2010,31,0,0,0,27,4,0,62
Nigeria,09/10/2010,5,0,0,0,15,0,0,20
Nigeria,10/10/2010,10,4,0,0,0,1,0,15
Nigeria,11/10/2010,49,0,0,0,13,1,0,63
Nigeria,12/10/2010,21,0,1,0,21,14,0,57
Nigeria,13/10/2010,30,0,2,0,39,0,0,71
Nigeria,14/10/2010,22,2,3,0,54,10,0,91
Nigeria,15/10/2010,14,0,0,0,18,0,0,32
Nigeria,16/10/2010,3,0,0,0,21,2,0,26
Nigeria,17/10/2010,12,0,0,0,21,0,0,33
Nigeria,18/10/2010,14,0,2,0,6,1,0,23
Nigeria,19/10/2010,2,0,0,0,1,2,0,5
Nigeria,20/10/2010,3,0,0,0,0,0,0,3
Nigeria,21/10/2010,3,0,0,0,0,2,0,5
Nigeria,22/10/2010,19,0,0,0,4,5,0,28
Nigeria,23/10/2010,11,0,0,0,0,3,0,14
Nigeria,24/10/2010,-2,2,0,0,2,3,0,5
Nigeria,25/10/2010,23,0,-4,0,16,0,0,35
Nigeria,26/10/2010,17,0,0,0,15,3,0,35
Nigeria,27/10/2010,10,0,0,0,4,4,0,18
Nigeria,28/10/2010,27,0,-4,0,3,2,0,28
Nigeria,29/10/2010,15,0,0,0,14,4,0,33
Nigeria,30/10/2010,0,0,0,0,6,0,0,6
Nigeria,31/10/2010,31,2,0,0,10,2,0,45
Pakistan,01/10/2010,312,4,-4,0,23,31,0,366
Pakistan,02/10/2010,211,12,-2,0,22,5,0,248
Pakistan,03/10/2010,181,4,-1,0,26,11,0,221
Pakistan,04/10/2010,216,2,8,0,53,16,0,295
Pakistan,05/10/2010,245,6,1,0,209,65,0,526
Pakistan,06/10/2010,382,2,-2,0,158,58,0,598
Pakistan,07/10/2010,206,2,0,0,83,23,0,314
Pakistan,08/10/2010,239,0,-4,0,41,29,0,305
Pakistan,09/10/2010,118,0,-3,0,69,27,0,211
Pakistan,10/10/2010,138,0,0,0,32,17,0,187
Pakistan,11/10/2010,184,0,-2,0,40,11,0,233
Pakistan,12/10/2010,87,0,-3,0,99,5,0,188
Pakistan,13/10/2010,100,2,0,0,43,17,0,162
Pakistan,14/10/2010,129,6,0,0,53,25,0,213
Pakistan,15/10/2010,166,6,0,0,65,20,0,257
Pakistan,16/10/2010,120,0,1,0,34,6,0,161
Pakistan,17/10/2010,169,0,0,0,57,19,0,245
Pakistan,18/10/2010,81,0,0,0,28,7,0,116
Pakistan,19/10/2010,51,2,0,0,6,23,0,82
Pakistan,20/10/2010,41,0,0,0,3,14,0,58
Pakistan,21/10/2010,38,0,0,0,6,10,0,54
Pakistan,22/10/2010,134,0,0,0,47,25,0,206
Pakistan,23/10/2010,145,4,2,0,8,31,0,190
Pakistan,24/10/2010,97,0,0,0,15,11,0,123
Pakistan,25/10/2010,155,4,6,0,57,10,0,232
Pakistan,26/10/2010,42,2,-2,0,41,18,0,101
Pakistan,27/10/2010,97,4,-2,0,89,51,0,239
Pakistan,28/10/2010,80,2,0,0,77,33,0,192
Pakistan,29/10/2010,65,4,-3,0,25,9,0,100
Pakistan,30/10/2010,102,0,-2,0,19,3,0,122
Pakistan,31/10/2010,72,4,-6,0,23,1,0,94
Sierra Leone,01/10/2010,8,0,0,0,0,0,0,8
Sierra Leone,02/10/2010,11,0,0,0,12,0,0,23
Sierra Leone,03/10/2010,3,0,0,0,9,0,0,12
Sierra Leone,04/10/2010,2,0,0,0,0,0,0,2
Sierra Leone,05/10/2010,6,0,0,0,9,2,0,17
Sierra Leone,06/10/2010,1,0,0,0,3,2,0,6
Sierra Leone,07/10/2010,6,0,0,0,6,1,0,13
Sierra Leone,08/10/2010,2,0,0,0,12,0,0,14
Sierra Leone,09/10/2010,0,0,0,0,0,0,0,0
Sierra Leone,10/10/2010,0,0,0,0,-1,0,0,-1
Sierra Leone,11/10/2010,7,0,0,0,-2,2,0,7
Sierra Leone,12/10/2010,0,0,0,0,0,0,0,0
Sierra Leone,13/10/2010,0,0,0,0,0,0,0,0
Sierra Leone,14/10/2010,0,0,0,0,3,0,0,3
Sierra Leone,15/10/2010,0,0,0,0,0,2,0,2
Sierra Leone,16/10/2010,6,0,0,0,0,0,0,6
Sierra Leone,17/10/2010,0,0,0,0,0,0,0,0
Sierra Leone,18/10/2010,0,0,0,0,-2,0,0,-2
Sierra Leone,19/10/2010,3,0,0,0,3,1,0,7
Sierra Leone,21/10/2010,2,0,0,0,0,1,0,3
Sierra Leone,22/10/2010,6,0,0,0,0,0,0,6
Sierra Leone,23/10/2010,4,0,0,0,0,0,0,4
Sierra Leone,24/10/2010,0,0,0,0,0,0,0,0
Sierra Leone,25/10/2010,0,0,0,0,0,0,0,0
Sierra Leone,26/10/2010,3,0,0,0,3,0,0,6
Sierra Leone,27/10/2010,4,0,0,0,12,2,0,18
Sierra Leone,28/10/2010,2,0,0,0,1,0,0,3
Sierra Leone,29/10/2010,2,0,0,0,9,0,0,11
Sierra Leone,30/10/2010,0,0,0,0,-2,0,0,-2
Sierra Leone,31/10/2010,1,0,0,0,0,1,0,2
Somalia,01/10/2010,23,0,0,0,16,2,0,41
Somalia,02/10/2010,18,2,0,0,20,3,0,43
Somalia,03/10/2010,18,0,0,0,12,0,0,30
Somalia,04/10/2010,9,0,0,0,4,0,0,13
Somalia,05/10/2010,58,0,3,0,30,0,0,91
Somalia,06/10/2010,26,4,1,0,20,3,0,54
Somalia,07/10/2010,17,2,0,0,16,10,0,45
Somalia,08/10/2010,33,0,0,0,100,1,0,134
Somalia,09/10/2010,26,0,0,0,16,2,0,44
Somalia,10/10/2010,13,0,0,0,3,5,0,21
Somalia,11/10/2010,34,0,-3,0,3,7,0,41
Somalia,12/10/2010,49,0,0,0,35,0,0,84
Somalia,13/10/2010,33,0,-1,0,-3,1,0,30
Somalia,14/10/2010,18,0,0,0,10,0,0,28
Somalia,15/10/2010,32,0,-2,0,113,0,0,143
Somalia,16/10/2010,26,0,0,0,31,0,0,57
Somalia,17/10/2010,17,0,0,0,109,8,0,134
Somalia,18/10/2010,27,2,0,0,42,3,0,74
Somalia,19/10/2010,9,0,0,0,14,0,0,23
Somalia,20/10/2010,2,0,0,0,6,0,0,8
Somalia,21/10/2010,16,0,0,0,0,0,0,16
Somalia,22/10/2010,82,0,0,0,31,1,0,114
Somalia,23/10/2010,33,0,0,0,8,8,0,49
Somalia,24/10/2010,26,0,0,0,98,2,0,126
Somalia,25/10/2010,74,0,-6,0,19,0,0,87
Somalia,26/10/2010,83,2,-6,0,18,8,0,105
Somalia,27/10/2010,55,0,0,0,66,18,0,139
Somalia,28/10/2010,18,4,0,0,34,63,0,119
Somalia,29/10/2010,33,0,0,0,1,25,0,59
Somalia,30/10/2010,12,0,0,0,0,0,0,12
Somalia,31/10/2010,60,0,-16,0,57,3,0,104
Syria,01/10/2010,13,0,4,0,6,0,0,23
Syria,02/10/2010,12,0,0,0,0,2,0,14
Syria,03/10/2010,13,0,0,0,0,0,0,13
Syria,04/10/2010,20,0,0,0,27,0,0,47
Syria,05/10/2010,19,0,0,0,20,6,0,45
Syria,06/10/2010,25,0,0,0,21,2,0,48
Syria,07/10/2010,18,0,2,0,14,2,0,36
Syria,08/10/2010,38,0,0,0,6,1,0,45
Syria,09/10/2010,26,0,0,0,3,1,0,30
Syria,10/10/2010,8,0,0,0,0,1,0,9
Syria,11/10/2010,-3,0,0,0,-4,0,0,-7
Syria,12/10/2010,18,0,0,0,4,0,0,22
Syria,13/10/2010,-5,0,0,0,1,1,0,-3
Syria,14/10/2010,7,0,0,0,-6,0,0,1
Syria,15/10/2010,21,0,0,0,1,0,0,22
Syria,16/10/2010,11,0,0,0,9,3,0,23
Syria,17/10/2010,18,0,0,0,2,5,0,25
Syria,18/10/2010,11,4,0,0,9,0,0,24
Syria,19/10/2010,9,0,0,0,12,1,0,22
Syria,20/10/2010,-1,0,0,0,0,0,0,-1
Syria,21/10/2010,3,0,0,0,0,0,0,3
Syria,22/10/2010,14,0,0,0,6,0,0,20
Syria,23/10/2010,3,0,0,0,-1,1,0,3
Syria,24/10/2010,12,0,0,0,0,3,0,15
Syria,25/10/2010,13,0,0,0,23,4,0,40
Syria,26/10/2010,2,0,0,0,12,0,0,14
Syria,27/10/2010,10,0,0,0,3,0,0,13
Syria,28/10/2010,26,0,-4,0,4,10,0,36
Syria,29/10/2010,33,0,-2,0,6,2,0,39
Syria,30/10/2010,3,0,0,0,0,0,0,3
Syria,31/10/2010,10,0,0,0,4,0,0,14
Yemen,01/10/2010,19,0,0,0,9,0,0,28
Yemen,02/10/2010,3,0,0,0,0,0,0,3
Yemen,03/10/2010,5,0,0,0,0,0,0,5
Yemen,04/10/2010,47,0,0,0,-8,3,0,42
Yemen,05/10/2010,35,0,0,0,1,2,0,38
Yemen,06/10/2010,247,0,0,0,14,33,0,294
Yemen,07/10/2010,97,0,0,0,66,2,0,165
Yemen,08/10/2010,15,2,0,0,31,5,0,53
Yemen,09/10/2010,0,0,0,0,3,0,0,3
Yemen,10/10/2010,18,0,0,0,0,1,0,19
Yemen,11/10/2010,44,0,0,0,-6,10,0,48
Yemen,12/10/2010,43,0,0,0,24,1,0,68
Yemen,13/10/2010,25,0,0,0,0,0,0,25
Yemen,14/10/2010,7,0,0,0,3,0,0,10
Yemen,15/10/2010,33,0,0,0,7,5,0,45
Yemen,16/10/2010,34,0,0,0,14,8,0,56
Yemen,17/10/2010,77,0,0,0,0,7,0,84
Yemen,18/10/2010,27,0,0,0,10,0,0,37
Yemen,19/10/2010,14,0,0,0,0,2,0,16
Yemen,20/10/2010,2,0,0,0,0,0,0,2
Yemen,21/10/2010,4,0,0,0,0,1,0,5
Yemen,22/10/2010,24,0,0,0,12,0,0,36
Yemen,23/10/2010,31,0,0,0,4,0,0,35
Yemen,24/10/2010,5,0,0,0,-4,0,0,1
Yemen,25/10/2010,22,0,0,0,12,0,0,34
Yemen,26/10/2010,37,0,-2,0,34,0,0,69
Yemen,27/10/2010,14,0,0,0,22,4,0,40
Yemen,28/10/2010,6,0,0,0,22,0,0,28
Yemen,29/10/2010,273,0,2,0,62,15,0,352
Yemen,30/10/2010,192,0,1,0,98,9,0,300
Yemen,31/10/2010,260,0,1,0,149,21,0,431
Afghanistan,01/04/2010,121,0,0,0,25,9,0,155
Afghanistan,02/04/2010,78,0,-1,0,0,2,0,79
Afghanistan,03/04/2010,234,0,-1,0,1,2,0,236
Afghanistan,04/04/2010,47,0,0,0,0,9,0,56
Afghanistan,05/04/2010,107,0,-1,0,7,3,0,116
Afghanistan,06/04/2010,68,0,1,0,7,1,0,77
Afghanistan,07/04/2010,70,0,-6,0,19,4,0,87
Afghanistan,08/04/2010,89,0,0,0,49,10,0,148
Afghanistan,09/04/2010,74,0,0,0,6,17,0,97
Afghanistan,10/04/2010,81,0,-3,0,0,10,0,88
Afghanistan,11/04/2010,100,0,-4,0,-1,12,0,107
Afghanistan,12/04/2010,100,0,0,0,32,37,0,169
Afghanistan,13/04/2010,104,4,1,0,29,11,0,149
Afghanistan,14/04/2010,124,0,-4,0,28,8,0,156
Afghanistan,15/04/2010,126,0,-2,0,55,9,0,188
Afghanistan,16/04/2010,84,0,-2,0,1,24,0,107
Afghanistan,17/04/2010,96,0,0,0,13,3,0,112
Afghanistan,18/04/2010,44,0,0,0,12,6,0,62
Afghanistan,19/04/2010,54,0,-1,0,15,4,0,72
Afghanistan,20/04/2010,205,2,2,0,68,18,0,295
Afghanistan,21/04/2010,185,0,-2,0,61,20,0,264
Afghanistan,22/04/2010,140,0,0,0,29,25,0,194
Afghanistan,23/04/2010,197,0,-1,0,19,68,0,283
Afghanistan,24/04/2010,215,2,0,0,20,18,0,255
Afghanistan,25/04/2010,171,0,0,0,7,12,0,190
Afghanistan,26/04/2010,339,2,-4,0,-28,39,0,348
Afghanistan,27/04/2010,118,0,2,0,10,8,0,138
Afghanistan,28/04/2010,113,0,0,0,9,19,0,141
Afghanistan,29/04/2010,192,2,2,0,51,31,0,278
Afghanistan,30/04/2010,162,0,0,0,61,20,0,243
Albania,01/04/2010,4,0,0,0,3,0,0,7
Albania,02/04/2010,3,0,0,0,0,2,0,5
Albania,03/04/2010,6,0,0,0,0,0,0,6
Albania,05/04/2010,1,0,0,0,0,3,0,4
Albania,06/04/2010,11,0,0,0,-2,0,0,9
Albania,07/04/2010,4,0,0,0,3,0,0,7
Albania,08/04/2010,16,0,0,0,0,0,0,16
Albania,09/04/2010,2,0,0,0,0,0,0,2
Albania,10/04/2010,2,0,0,0,0,0,0,2
Albania,11/04/2010,2,0,0,0,0,0,0,2
Albania,12/04/2010,0,0,0,0,0,0,0,0
Albania,13/04/2010,0,0,0,0,0,0,0,0
Albania,14/04/2010,1,0,0,0,0,0,0,1
Albania,15/04/2010,0,0,0,0,9,0,0,9
Albania,16/04/2010,2,0,0,0,0,1,0,3
Albania,17/04/2010,0,0,0,0,0,0,0,0
Albania,18/04/2010,2,0,0,0,0,0,0,2
Albania,19/04/2010,2,0,0,0,0,1,0,3
Albania,20/04/2010,0,0,0,0,0,1,0,1
Albania,21/04/2010,10,0,-2,0,-2,0,0,6
Albania,22/04/2010,3,0,0,0,6,0,0,9
Albania,23/04/2010,7,0,0,0,6,8,0,21
Albania,24/04/2010,0,0,0,0,0,0,0,0
Albania,25/04/2010,0,0,0,0,0,0,0,0
Albania,26/04/2010,5,0,0,0,0,0,0,5
Albania,27/04/2010,-1,0,0,0,0,2,0,1
Albania,28/04/2010,3,0,0,0,0,0,0,3
Albania,29/04/2010,13,0,-2,0,24,0,0,35
Albania,30/04/2010,1,0,0,0,48,16,0,65
Algeria,01/04/2010,8,0,0,0,0,1,0,9
Algeria,02/04/2010,-2,0,0,0,0,1,0,-1
Algeria,03/04/2010,3,0,0,0,0,0,0,3
Algeria,04/04/2010,-1,0,0,0,0,0,0,-1
Algeria,05/04/2010,8,0,0,0,0,0,0,8
Algeria,06/04/2010,1,0,0,0,0,0,0,1
Algeria,07/04/2010,0,0,0,0,0,0,0,0
Algeria,08/04/2010,-1,0,0,0,0,0,0,-1
Algeria,09/04/2010,0,0,0,0,3,0,0,3
Algeria,10/04/2010,0,0,0,0,0,0,0,0
Algeria,11/04/2010,0,0,0,0,0,0,0,0
Algeria,12/04/2010,2,0,0,0,3,0,0,5
Algeria,13/04/2010,1,0,0,0,0,0,0,1
Algeria,14/04/2010,0,0,0,0,0,0,0,0
Algeria,15/04/2010,0,0,0,0,30,0,0,30
Algeria,16/04/2010,0,0,0,0,0,0,0,0
Algeria,17/04/2010,0,0,-1,0,0,0,0,-1
Algeria,18/04/2010,0,0,0,0,0,0,0,0
Algeria,19/04/2010,-1,0,0,0,3,0,0,2
Algeria,20/04/2010,5,0,0,0,3,1,0,9
Algeria,21/04/2010,3,0,0,0,0,1,0,4
Algeria,22/04/2010,15,0,0,0,27,3,0,45
Algeria,23/04/2010,16,0,0,0,22,0,0,38
Algeria,24/04/2010,1,0,0,0,3,0,0,4
Algeria,25/04/2010,0,0,0,0,0,0,0,0
Algeria,26/04/2010,2,0,0,0,10,2,0,14
Algeria,27/04/2010,2,0,0,0,9,4,0,15
Algeria,28/04/2010,-1,0,0,0,3,0,0,2
Algeria,29/04/2010,24,0,1,0,-4,0,0,21
Algeria,30/04/2010,0,0,0,0,9,0,0,9
Bangladesh,01/04/2010,7,0,0,0,3,0,0,10
Bangladesh,02/04/2010,2,0,3,0,9,0,0,14
Bangladesh,03/04/2010,8,0,0,0,4,2,0,14
Bangladesh,05/04/2010,0,0,1,0,0,2,0,3
Bangladesh,06/04/2010,0,0,0,0,0,0,0,0
Bangladesh,07/04/2010,0,0,0,0,0,0,0,0
Bangladesh,08/04/2010,7,0,0,0,0,0,0,7
Bangladesh,09/04/2010,3,0,0,0,8,0,0,11
Bangladesh,10/04/2010,-3,0,0,0,-2,0,0,-5
Bangladesh,11/04/2010,0,0,0,0,0,0,0,0
Bangladesh,12/04/2010,0,0,0,0,6,0,0,6
Bangladesh,13/04/2010,0,0,0,0,-1,1,0,0
Bangladesh,14/04/2010,4,0,0,0,-2,0,0,2
Bangladesh,15/04/2010,10,2,0,0,3,3,0,18
Bangladesh,16/04/2010,3,0,0,0,0,2,0,5
Bangladesh,19/04/2010,5,0,0,0,6,1,0,12
Bangladesh,20/04/2010,8,0,0,0,15,5,0,28
Bangladesh,21/04/2010,6,0,0,0,15,0,0,21
Bangladesh,22/04/2010,5,0,1,0,7,4,0,17
Bangladesh,23/04/2010,29,0,0,0,8,1,0,38
Bangladesh,24/04/2010,9,0,0,0,2,0,0,11
Bangladesh,25/04/2010,0,0,0,0,0,0,0,0
Bangladesh,26/04/2010,20,6,0,0,3,3,0,32
Bangladesh,27/04/2010,-1,0,0,0,-1,1,0,-1
Bangladesh,28/04/2010,2,0,0,0,3,0,0,5
Bangladesh,29/04/2010,14,0,1,0,13,7,0,35
Bangladesh,30/04/2010,22,0,-1,0,1,2,0,24
Cameroon,01/04/2010,0,0,0,0,0,0,0,0
Cameroon,02/04/2010,0,0,0,0,0,0,0,0
Cameroon,03/04/2010,5,0,0,0,0,0,0,5
Cameroon,14/04/2010,2,0,0,0,0,0,0,2
Cameroon,15/04/2010,0,0,0,0,0,0,0,0
Cameroon,20/04/2010,2,0,0,0,0,1,0,3
Cameroon,21/04/2010,0,0,0,0,0,0,0,0
Cameroon,22/04/2010,3,0,0,0,6,2,0,11
Cameroon,23/04/2010,1,0,0,0,3,0,0,4
Cameroon,24/04/2010,0,0,0,0,0,0,0,0
Cameroon,26/04/2010,0,0,0,0,0,1,0,1
Cameroon,27/04/2010,0,0,0,0,0,0,0,0
Cameroon,28/04/2010,11,0,0,0,0,0,0,11
Cameroon,29/04/2010,4,0,0,0,0,0,0,4
Cameroon,30/04/2010,0,0,0,0,3,0,0,3
China,01/04/2010,79,0,2,0,22,9,0,112
China,02/04/2010,30,0,-1,0,7,5,0,41
China,03/04/2010,73,0,-6,0,21,3,0,91
China,04/04/2010,25,0,0,0,-1,0,0,24
China,05/04/2010,33,0,1,0,19,4,0,57
China,06/04/2010,92,0,0,0,38,19,0,149
China,07/04/2010,55,0,0,0,40,11,0,106
China,08/04/2010,74,6,2,0,5,12,0,99
China,09/04/2010,41,0,-1,0,6,1,0,47
China,10/04/2010,15,6,0,0,-1,6,0,26
China,11/04/2010,1,0,0,0,6,1,0,8
China,12/04/2010,16,0,0,0,12,0,0,28
China,13/04/2010,48,0,1,0,22,1,0,72
China,14/04/2010,42,0,1,0,23,1,0,67
China,15/04/2010,77,0,-4,0,40,13,0,126
China,16/04/2010,25,0,-1,0,-1,2,0,25
China,17/04/2010,5,0,0,0,3,0,0,8
China,18/04/2010,10,0,-2,0,9,3,0,20
China,19/04/2010,32,0,-1,0,11,4,0,46
China,20/04/2010,128,4,4,0,51,17,0,204
China,21/04/2010,127,0,-1,0,56,8,0,190
China,22/04/2010,120,4,-3,0,17,11,0,149
China,23/04/2010,112,0,-3,0,30,17,0,156
China,24/04/2010,86,2,0,0,50,8,0,146
China,25/04/2010,34,0,1,0,20,6,0,61
China,26/04/2010,86,0,4,0,29,14,0,133
China,27/04/2010,18,2,0,0,21,6,0,47
China,28/04/2010,38,0,-2,0,39,8,0,83
China,29/04/2010,131,2,2,0,48,19,0,202
China,30/04/2010,44,2,0,0,13,30,0,89
Egypt,01/04/2010,36,0,1,0,21,4,0,62
Egypt,02/04/2010,9,0,0,0,12,1,0,22
Egypt,03/04/2010,70,0,0,0,45,2,0,117
Egypt,04/04/2010,39,0,0,0,10,1,0,50
Egypt,05/04/2010,23,0,0,0,0,0,0,23
Egypt,06/04/2010,8,0,0,0,12,9,0,29
Egypt,07/04/2010,2,0,1,0,3,0,0,6
Egypt,08/04/2010,25,0,0,0,15,0,0,40
Egypt,09/04/2010,11,0,0,0,6,0,0,17
Egypt,10/04/2010,-5,0,0,0,6,2,0,3
Egypt,11/04/2010,6,0,0,0,0,0,0,6
Egypt,12/04/2010,7,0,0,0,0,0,0,7
Egypt,13/04/2010,4,0,0,0,0,2,0,6
Egypt,14/04/2010,6,0,0,0,15,0,0,21
Egypt,15/04/2010,12,0,0,0,7,3,0,22
Egypt,16/04/2010,2,0,0,0,0,0,0,2
Egypt,17/04/2010,1,0,0,0,2,0,0,3
Egypt,18/04/2010,8,0,0,0,0,2,0,10
Egypt,19/04/2010,20,0,1,0,3,3,0,27
Egypt,20/04/2010,62,0,1,0,39,5,0,107
Egypt,21/04/2010,53,0,0,0,39,3,0,95
Egypt,22/04/2010,82,0,0,0,16,0,0,98
Egypt,23/04/2010,40,0,0,0,7,3,0,50
Egypt,24/04/2010,60,0,-2,0,32,0,0,90
Egypt,25/04/2010,17,0,0,0,2,4,0,23
Egypt,26/04/2010,23,0,1,0,14,6,0,44
Egypt,27/04/2010,26,0,0,0,1,2,0,29
Egypt,28/04/2010,57,0,1,0,10,0,0,68
Egypt,29/04/2010,140,0,3,0,24,9,0,176
Egypt,30/04/2010,82,0,4,0,27,0,0,113
Eritrea,01/04/2010,3,0,0,0,3,0,0,6
Eritrea,02/04/2010,0,0,1,0,6,4,0,11
Eritrea,03/04/2010,0,0,0,0,0,0,0,0
Eritrea,06/04/2010,2,0,0,0,0,0,0,2
Eritrea,08/04/2010,0,0,0,0,0,0,0,0
Eritrea,10/04/2010,7,0,0,0,3,0,0,10
Eritrea,11/04/2010,3,0,0,0,0,0,0,3
Eritrea,13/04/2010,0,0,0,0,0,0,0,0
Eritrea,14/04/2010,0,0,0,0,0,0,0,0
Eritrea,15/04/2010,6,0,0,0,-1,0,0,5
Eritrea,17/04/2010,0,0,0,0,0,0,0,0
Eritrea,18/04/2010,0,0,0,0,0,0,0,0
Eritrea,20/04/2010,0,0,0,0,0,0,0,0
Eritrea,21/04/2010,0,0,0,0,3,0,0,3
Eritrea,22/04/2010,3,0,0,0,0,0,0,3
Eritrea,23/04/2010,3,0,0,0,0,0,0,3
Eritrea,24/04/2010,3,0,0,0,0,5,0,8
Eritrea,25/04/2010,0,0,0,0,0,5,0,5
Eritrea,26/04/2010,8,0,0,0,3,4,0,15
Eritrea,27/04/2010,0,0,0,0,0,0,0,0
Eritrea,28/04/2010,3,0,0,0,0,0,0,3
Eritrea,29/04/2010,0,0,0,0,0,0,0,0
Eritrea,30/04/2010,0,0,0,0,3,0,0,3
Georgia,01/04/2010,7,0,1,0,1,1,0,10
Georgia,02/04/2010,13,0,0,0,0,1,0,14
Georgia,03/04/2010,7,0,0,0,2,0,0,9
Georgia,04/04/2010,5,0,0,0,-4,0,0,1
Georgia,05/04/2010,2,0,0,0,3,0,0,5
Georgia,06/04/2010,22,0,0,0,-1,2,0,23
Georgia,07/04/2010,-1,0,0,0,4,0,0,3
Georgia,08/04/2010,13,0,0,0,3,0,0,16
Georgia,09/04/2010,6,0,0,0,3,0,0,9
Georgia,10/04/2010,2,0,0,0,3,0,0,5
Georgia,11/04/2010,0,0,0,0,0,0,0,0
Georgia,12/04/2010,3,0,1,0,6,0,0,10
Georgia,13/04/2010,6,0,0,0,0,0,0,6
Georgia,14/04/2010,3,0,0,0,0,6,0,9
Georgia,15/04/2010,4,0,1,0,2,0,0,7
Georgia,16/04/2010,0,0,0,0,0,0,0,0
Georgia,17/04/2010,-1,0,0,0,0,0,0,-1
Georgia,18/04/2010,0,0,0,0,0,0,0,0
Georgia,19/04/2010,5,0,0,0,6,0,0,11
Georgia,20/04/2010,9,0,0,0,31,4,0,44
Georgia,21/04/2010,34,2,0,0,10,1,0,47
Georgia,22/04/2010,24,0,-12,0,30,4,0,46
Georgia,23/04/2010,25,0,0,0,16,1,0,42
Georgia,24/04/2010,2,0,0,0,0,2,0,4
Georgia,25/04/2010,4,0,0,0,0,0,0,4
Georgia,26/04/2010,4,0,0,0,30,4,0,38
Georgia,27/04/2010,0,0,0,0,0,0,0,0
Georgia,28/04/2010,0,0,0,0,4,0,0,4
Georgia,29/04/2010,4,0,0,0,0,0,0,4
Georgia,30/04/2010,16,2,-2,0,19,0,0,35
India,01/04/2010,29,0,0,0,3,1,0,33
India,02/04/2010,9,0,0,0,4,0,0,13
India,03/04/2010,25,0,-1,0,11,1,0,36
India,04/04/2010,0,0,0,0,0,0,0,0
India,05/04/2010,4,0,-2,0,-6,7,0,3
India,06/04/2010,58,0,0,0,6,9,0,73
India,07/04/2010,30,0,1,0,-4,0,0,27
India,08/04/2010,32,0,0,0,12,1,0,45
India,09/04/2010,11,0,0,0,2,4,0,17
India,10/04/2010,14,0,-2,0,3,0,0,15
India,11/04/2010,4,0,0,0,0,0,0,4
India,12/04/2010,32,0,0,0,3,0,0,35
India,13/04/2010,16,0,0,0,12,2,0,30
India,14/04/2010,22,0,0,0,9,4,0,35
India,15/04/2010,29,0,0,0,-3,5,0,31
India,16/04/2010,3,0,0,0,-1,0,0,2
India,17/04/2010,8,0,0,0,0,9,0,17
India,18/04/2010,3,0,0,0,0,3,0,6
India,19/04/2010,22,0,0,0,13,1,0,36
India,20/04/2010,44,0,-8,0,6,3,0,45
India,21/04/2010,20,0,-1,0,22,4,0,45
India,22/04/2010,30,2,1,0,0,4,0,37
India,23/04/2010,51,0,-6,0,11,7,0,63
India,24/04/2010,64,0,-2,0,5,0,0,67
India,25/04/2010,20,0,0,0,7,0,0,27
India,26/04/2010,11,0,-2,0,3,5,0,17
India,27/04/2010,22,0,0,0,0,1,0,23
India,28/04/2010,7,0,0,0,0,0,0,7
India,29/04/2010,72,2,1,0,3,10,0,88
India,30/04/2010,82,0,-2,0,10,6,0,96
Iran,01/04/2010,41,2,0,0,10,2,0,55
Iran,02/04/2010,44,0,1,0,36,1,0,82
Iran,03/04/2010,33,0,-2,0,5,9,0,45
Iran,04/04/2010,52,0,0,0,18,10,0,80
Iran,05/04/2010,51,0,-1,0,26,16,0,92
Iran,06/04/2010,50,4,0,0,29,5,0,88
Iran,07/04/2010,15,0,0,0,11,6,0,32
Iran,08/04/2010,30,0,-4,0,2,5,0,33
Iran,09/04/2010,25,0,-4,0,3,4,0,28
Iran,10/04/2010,15,0,-1,0,12,0,0,26
Iran,11/04/2010,11,0,2,0,2,0,0,15
Iran,12/04/2010,40,0,-3,0,15,4,0,56
Iran,13/04/2010,46,0,0,0,1,4,0,51
Iran,14/04/2010,34,0,0,0,16,-3,0,47
Iran,15/04/2010,65,0,1,0,53,4,0,123
Iran,16/04/2010,19,0,0,0,29,7,0,55
Iran,17/04/2010,28,0,0,0,8,0,0,36
Iran,18/04/2010,34,2,0,0,42,1,0,79
Iran,19/04/2010,46,0,3,0,74,2,0,125
Iran,20/04/2010,46,0,0,0,65,10,0,121
Iran,21/04/2010,93,4,-2,0,10,8,0,113
Iran,22/04/2010,73,0,1,0,50,15,0,139
Iran,23/04/2010,123,0,2,0,13,14,0,152
Iran,24/04/2010,57,0,-4,0,33,6,0,92
Iran,25/04/2010,60,0,0,0,7,5,0,72
Iran,26/04/2010,57,0,1,0,5,4,0,67
Iran,27/04/2010,26,0,-1,0,11,3,0,39
Iran,28/04/2010,8,0,0,0,3,1,0,12
Iran,29/04/2010,75,0,0,0,34,2,0,111
Iran,30/04/2010,37,0,2,0,0,10,0,49
Iraq,01/04/2010,51,0,-3,0,6,6,0,60
Iraq,02/04/2010,49,0,0,0,0,0,0,49
Iraq,03/04/2010,52,0,0,0,28,2,0,82
Iraq,04/04/2010,40,0,0,0,3,8,0,51
Iraq,05/04/2010,19,0,0,0,21,0,0,40
Iraq,06/04/2010,33,0,0,0,20,1,0,54
Iraq,07/04/2010,17,0,1,0,9,6,0,33
Iraq,08/04/2010,31,0,0,0,6,3,0,40
Iraq,09/04/2010,14,0,0,0,-2,0,0,12
Iraq,10/04/2010,26,0,3,0,0,4,0,33
Iraq,11/04/2010,38,0,-1,0,-1,0,0,36
Iraq,12/04/2010,5,0,-1,0,0,0,0,4
Iraq,13/04/2010,50,0,2,0,17,5,0,74
Iraq,14/04/2010,26,0,0,0,4,0,0,30
Iraq,15/04/2010,19,0,0,0,26,1,0,46
Iraq,16/04/2010,1,0,0,0,2,1,0,4
Iraq,17/04/2010,3,0,1,0,6,0,0,10
Iraq,18/04/2010,5,0,0,0,0,2,0,7
Iraq,19/04/2010,6,0,0,0,4,1,0,11
Iraq,20/04/2010,234,2,0,0,42,12,0,290
Iraq,21/04/2010,127,0,-2,0,46,6,0,177
Iraq,22/04/2010,47,0,-1,0,24,17,0,87
Iraq,23/04/2010,117,0,0,0,88,15,0,220
Iraq,24/04/2010,42,0,1,0,26,13,0,82
Iraq,25/04/2010,40,0,-1,0,10,5,0,54
Iraq,26/04/2010,114,0,-1,0,8,11,0,132
Iraq,27/04/2010,19,0,0,0,6,1,0,26
Iraq,28/04/2010,17,0,0,0,0,0,0,17
Iraq,29/04/2010,76,0,0,0,10,6,0,92
Iraq,30/04/2010,59,0,3,0,14,2,0,78
Morocco,01/04/2010,1,0,0,0,0,0,0,1
Morocco,02/04/2010,4,0,0,0,0,0,0,4
Morocco,03/04/2010,7,0,0,0,0,0,0,7
Morocco,04/04/2010,0,0,0,0,0,0,0,0
Morocco,06/04/2010,0,0,0,0,0,0,0,0
Morocco,07/04/2010,0,0,0,0,3,0,0,3
Morocco,08/04/2010,3,0,0,0,0,0,0,3
Morocco,09/04/2010,0,0,0,0,0,0,0,0
Morocco,10/04/2010,0,0,0,0,0,0,0,0
Morocco,12/04/2010,3,0,0,0,0,0,0,3
Morocco,13/04/2010,1,0,0,0,-3,0,0,-2
Morocco,14/04/2010,0,0,0,0,0,0,0,0
Morocco,15/04/2010,0,0,0,0,0,0,0,0
Morocco,16/04/2010,3,0,0,0,9,0,0,12
Morocco,17/04/2010,0,0,0,0,0,0,0,0
Morocco,18/04/2010,0,0,0,0,0,0,0,0
Morocco,19/04/2010,0,0,0,0,0,0,0,0
Morocco,20/04/2010,5,0,0,0,6,2,0,13
Morocco,21/04/2010,7,0,0,0,6,0,0,13
Morocco,22/04/2010,6,0,0,0,9,1,0,16
Morocco,23/04/2010,19,0,0,0,6,0,0,25
Morocco,24/04/2010,11,0,0,0,3,0,0,14
Morocco,25/04/2010,6,0,0,0,6,0,0,12
Morocco,26/04/2010,7,0,0,0,3,1,0,11
Morocco,27/04/2010,0,0,0,0,0,0,0,0
Morocco,29/04/2010,4,0,0,0,-5,0,0,-1
Morocco,30/04/2010,0,0,0,0,-2,0,0,-2
Nigeria,01/04/2010,4,0,0,0,0,0,0,4
Nigeria,02/04/2010,19,0,0,0,6,0,0,25
Nigeria,03/04/2010,18,0,0,0,15,0,0,33
Nigeria,04/04/2010,0,4,0,0,0,0,0,4
Nigeria,05/04/2010,13,0,0,0,-4,0,0,9
Nigeria,06/04/2010,6,0,2,0,-4,1,0,5
Nigeria,07/04/2010,11,0,0,0,-2,0,0,9
Nigeria,08/04/2010,18,0,0,0,27,3,0,48
Nigeria,09/04/2010,8,0,0,0,-12,0,0,-4
Nigeria,10/04/2010,7,0,0,0,0,4,0,11
Nigeria,11/04/2010,0,0,0,0,0,0,0,0
Nigeria,12/04/2010,5,0,0,0,0,0,0,5
Nigeria,13/04/2010,5,0,0,0,18,0,0,23
Nigeria,14/04/2010,5,0,0,0,5,1,0,11
Nigeria,15/04/2010,11,0,1,0,8,1,0,21
Nigeria,16/04/2010,20,0,0,0,0,0,0,20
Nigeria,17/04/2010,-3,0,0,0,0,0,0,-3
Nigeria,18/04/2010,4,0,0,0,0,0,0,4
Nigeria,19/04/2010,0,0,0,0,8,0,0,8
Nigeria,20/04/2010,18,0,1,0,10,2,0,31
Nigeria,21/04/2010,11,0,0,0,21,0,0,32
Nigeria,22/04/2010,12,0,0,0,0,3,0,15
Nigeria,23/04/2010,9,0,0,0,-6,1,0,4
Nigeria,24/04/2010,29,0,0,0,-1,2,0,30
Nigeria,25/04/2010,9,0,0,0,15,4,0,28
Nigeria,26/04/2010,54,2,-4,0,1,2,0,55
Nigeria,27/04/2010,2,0,-2,0,0,0,0,0
Nigeria,28/04/2010,13,0,-6,0,0,0,0,7
Nigeria,29/04/2010,36,0,-5,0,24,1,0,56
Nigeria,30/04/2010,22,0,-2,0,24,1,0,45
Pakistan,01/04/2010,45,0,0,0,30,6,0,81
Pakistan,02/04/2010,41,2,0,0,30,7,0,80
Pakistan,03/04/2010,11,0,0,0,5,2,0,18
Pakistan,04/04/2010,11,0,0,0,9,0,0,20
Pakistan,05/04/2010,32,0,0,0,0,0,0,32
Pakistan,06/04/2010,66,0,0,0,21,2,0,89
Pakistan,07/04/2010,6,0,0,0,3,0,0,9
Pakistan,08/04/2010,14,0,0,0,8,1,0,23
Pakistan,09/04/2010,2,0,-2,0,12,0,0,12
Pakistan,10/04/2010,12,0,0,0,11,1,0,24
Pakistan,11/04/2010,2,0,0,0,9,0,0,11
Pakistan,12/04/2010,48,0,0,0,6,3,0,57
Pakistan,13/04/2010,35,0,-2,0,24,4,0,61
Pakistan,14/04/2010,32,0,2,0,2,0,0,36
Pakistan,15/04/2010,13,0,0,0,5,4,0,22
Pakistan,16/04/2010,35,0,0,0,13,12,0,60
Pakistan,17/04/2010,28,0,0,0,0,4,0,32
Pakistan,18/04/2010,17,0,0,0,11,2,0,30
Pakistan,19/04/2010,21,0,-2,0,22,4,0,45
Pakistan,20/04/2010,73,0,-6,0,29,3,0,99
Pakistan,21/04/2010,41,0,-2,0,5,12,0,56
Pakistan,22/04/2010,42,0,2,0,22,13,0,79
Pakistan,23/04/2010,93,0,1,0,28,10,0,132
Pakistan,24/04/2010,105,0,0,0,15,14,0,134
Pakistan,25/04/2010,99,0,-1,0,9,5,0,112
Pakistan,26/04/2010,97,0,0,0,31,16,0,144
Pakistan,27/04/2010,7,0,0,0,16,2,0,25
Pakistan,28/04/2010,-1,0,0,0,0,4,0,3
Pakistan,29/04/2010,154,0,0,0,19,12,0,185
Pakistan,30/04/2010,93,0,1,0,30,17,0,141
Sierra Leone,01/04/2010,0,0,0,0,3,0,0,3
Sierra Leone,02/04/2010,-1,0,0,0,0,0,0,-1
Sierra Leone,03/04/2010,0,0,0,0,0,0,0,0
Sierra Leone,04/04/2010,1,0,0,0,0,0,0,1
Sierra Leone,05/04/2010,1,0,0,0,0,0,0,1
Sierra Leone,06/04/2010,0,0,0,0,0,0,0,0
Sierra Leone,07/04/2010,0,0,0,0,0,0,0,0
Sierra Leone,09/04/2010,0,0,0,0,0,0,0,0
Sierra Leone,13/04/2010,0,0,0,0,-2,0,0,-2
Sierra Leone,14/04/2010,1,0,0,0,0,0,0,1
Sierra Leone,15/04/2010,-2,0,0,0,0,0,0,-2
Sierra Leone,16/04/2010,0,0,0,0,0,0,0,0
Sierra Leone,17/04/2010,1,0,0,0,0,0,0,1
Sierra Leone,19/04/2010,0,0,0,0,0,0,0,0
Sierra Leone,20/04/2010,4,0,0,0,15,0,0,19
Sierra Leone,21/04/2010,1,0,0,0,0,0,0,1
Sierra Leone,22/04/2010,1,0,0,0,-4,1,0,-2
Sierra Leone,23/04/2010,8,0,0,0,3,1,0,12
Sierra Leone,24/04/2010,4,0,0,0,-2,0,0,2
Sierra Leone,25/04/2010,16,0,0,0,0,0,0,16
Sierra Leone,26/04/2010,2,0,0,0,6,2,0,10
Sierra Leone,27/04/2010,4,0,0,0,0,0,0,4
Sierra Leone,28/04/2010,0,0,0,0,0,0,0,0
Sierra Leone,29/04/2010,0,0,0,0,3,0,0,3
Sierra Leone,30/04/2010,8,0,0,0,0,1,0,9
Somalia,01/04/2010,53,0,0,0,27,2,0,82
Somalia,02/04/2010,26,0,0,0,3,9,0,38
Somalia,03/04/2010,51,0,-1,0,20,4,0,74
Somalia,04/04/2010,12,0,0,0,17,2,0,31
Somalia,05/04/2010,15,0,0,0,2,2,0,19
Somalia,06/04/2010,45,2,0,0,8,0,0,55
Somalia,07/04/2010,38,0,0,0,14,0,0,52
Somalia,08/04/2010,9,0,0,0,9,3,0,21
Somalia,09/04/2010,2,0,0,0,-1,0,0,1
Somalia,10/04/2010,21,0,0,0,10,1,0,32
Somalia,11/04/2010,11,0,0,0,-1,0,0,10
Somalia,12/04/2010,0,0,0,0,-4,0,0,-4
Somalia,13/04/2010,0,0,0,0,-4,0,0,-4
Somalia,14/04/2010,4,0,0,0,10,1,0,15
Somalia,15/04/2010,7,2,0,0,9,6,0,24
Somalia,16/04/2010,5,0,0,0,-5,0,0,0
Somalia,17/04/2010,12,0,0,0,0,0,0,12
Somalia,18/04/2010,0,0,0,0,3,0,0,3
Somalia,19/04/2010,1,0,0,0,12,1,0,14
Somalia,20/04/2010,58,0,-1,0,16,2,0,75
Somalia,21/04/2010,62,0,0,0,72,6,0,140
Somalia,22/04/2010,36,2,0,0,27,6,0,71
Somalia,23/04/2010,93,2,0,0,125,12,0,232
Somalia,24/04/2010,75,0,-1,0,63,7,0,144
Somalia,25/04/2010,22,0,0,0,3,0,0,25
Somalia,26/04/2010,28,0,0,0,25,0,0,53
Somalia,27/04/2010,22,0,0,0,25,0,0,47
Somalia,28/04/2010,41,0,0,0,7,0,0,48
Somalia,29/04/2010,29,0,-1,0,26,0,0,54
Somalia,30/04/2010,28,0,0,0,14,0,0,42
Syria,01/04/2010,11,0,0,0,-7,2,0,6
Syria,02/04/2010,0,0,0,0,-1,0,0,-1
Syria,03/04/2010,0,0,0,0,0,0,0,0
Syria,04/04/2010,6,0,0,0,3,0,0,9
Syria,05/04/2010,1,0,0,0,3,0,0,4
Syria,06/04/2010,3,0,0,0,0,4,0,7
Syria,07/04/2010,7,0,0,0,0,0,0,7
Syria,08/04/2010,12,0,0,0,-6,0,0,6
Syria,09/04/2010,11,0,0,0,9,0,0,20
Syria,10/04/2010,5,0,0,0,12,0,0,17
Syria,11/04/2010,0,0,0,0,0,0,0,0
Syria,12/04/2010,10,0,0,0,3,0,0,13
Syria,13/04/2010,12,0,0,0,1,0,0,13
Syria,14/04/2010,17,0,0,0,6,0,0,23
Syria,15/04/2010,12,0,2,0,0,0,0,14
Syria,16/04/2010,4,0,3,0,6,0,0,13
Syria,17/04/2010,6,0,0,0,0,0,0,6
Syria,18/04/2010,6,0,0,0,0,0,0,6
Syria,19/04/2010,9,0,0,0,0,2,0,11
Syria,20/04/2010,12,0,0,0,6,3,0,21
Syria,21/04/2010,58,0,0,0,16,4,0,78
Syria,22/04/2010,15,0,0,0,18,1,0,34
Syria,23/04/2010,33,0,0,0,9,0,0,42
Syria,24/04/2010,34,0,0,0,3,0,0,37
Syria,25/04/2010,13,0,0,0,0,0,0,13
Syria,26/04/2010,33,0,0,0,-3,0,0,30
Syria,27/04/2010,6,0,0,0,0,0,0,6
Syria,28/04/2010,4,0,0,0,11,0,0,15
Syria,29/04/2010,11,0,0,0,16,1,0,28
Syria,30/04/2010,23,0,-7,0,13,4,0,33
Yemen,01/04/2010,25,0,0,0,17,17,0,59
Yemen,02/04/2010,7,0,0,0,3,1,0,11
Yemen,03/04/2010,2,0,0,0,12,0,0,14
Yemen,04/04/2010,0,0,0,0,0,0,0,0
Yemen,05/04/2010,0,0,0,0,-4,0,0,-4
Yemen,06/04/2010,2,0,0,0,-2,4,0,4
Yemen,07/04/2010,30,0,0,0,7,0,0,37
Yemen,08/04/2010,22,0,0,0,0,0,0,22
Yemen,09/04/2010,13,0,0,0,0,0,0,13
Yemen,10/04/2010,2,0,0,0,0,4,0,6
Yemen,11/04/2010,-7,0,0,0,0,0,0,-7
Yemen,12/04/2010,3,0,0,0,9,0,0,12
Yemen,13/04/2010,0,0,0,0,0,0,0,0
Yemen,14/04/2010,3,0,0,0,5,0,0,8
Yemen,15/04/2010,10,0,-6,0,6,3,0,13
Yemen,16/04/2010,13,0,0,0,9,0,0,22
Yemen,17/04/2010,24,0,0,0,17,0,0,41
Yemen,18/04/2010,0,0,0,0,6,0,0,6
Yemen,19/04/2010,4,0,0,0,5,0,0,9
Yemen,20/04/2010,6,0,0,0,-4,2,0,4
Yemen,21/04/2010,20,0,0,0,-2,0,0,18
Yemen,22/04/2010,18,0,0,0,6,0,0,24
Yemen,23/04/2010,2,0,0,0,-1,0,0,1
Yemen,24/04/2010,9,0,0,0,19,2,0,30
Yemen,25/04/2010,13,0,0,0,3,2,0,18
Yemen,26/04/2010,69,0,0,0,6,4,0,79
Yemen,27/04/2010,-1,0,0,0,0,0,0,-1
Yemen,28/04/2010,15,0,0,0,0,3,0,18
Yemen,29/04/2010,20,2,0,0,19,0,0,41
Yemen,30/04/2010,0,0,0,0,6,6,0,12
Afghanistan,01/12/2010,255,10,3,0,55,8,0,331
Afghanistan,02/12/2010,362,0,2,0,103,23,0,490
Afghanistan,03/12/2010,326,0,-1,0,54,25,0,404
Afghanistan,04/12/2010,241,8,1,0,56,17,0,323
Afghanistan,05/12/2010,195,10,0,0,4,59,0,268
Afghanistan,06/12/2010,287,6,1,0,50,74,0,418
Afghanistan,07/12/2010,213,4,3,0,43,30,0,293
Afghanistan,08/12/2010,204,6,0,0,68,54,0,332
Afghanistan,09/12/2010,253,2,0,0,93,17,0,365
Afghanistan,10/12/2010,295,0,-1,0,66,37,0,397
Afghanistan,11/12/2010,240,0,0,0,83,32,0,355
Afghanistan,12/12/2010,225,2,-2,0,26,30,0,281
Afghanistan,13/12/2010,296,2,-5,0,16,69,0,378
Afghanistan,14/12/2010,354,0,1,0,62,37,0,454
Afghanistan,15/12/2010,405,0,1,0,93,71,0,570
Afghanistan,16/12/2010,390,0,1,0,65,40,0,496
Afghanistan,17/12/2010,390,0,0,0,56,43,0,489
Afghanistan,18/12/2010,315,0,-1,0,24,28,0,366
Afghanistan,19/12/2010,231,0,6,0,8,27,0,272
Afghanistan,20/12/2010,354,0,0,0,52,16,0,422
Afghanistan,21/12/2010,331,0,6,0,31,18,0,386
Afghanistan,22/12/2010,219,0,0,0,58,15,0,292
Afghanistan,23/12/2010,205,4,0,0,36,26,0,271
Afghanistan,24/12/2010,351,8,-1,0,48,24,0,430
Afghanistan,25/12/2010,261,0,2,0,31,88,0,382
Afghanistan,26/12/2010,162,8,1,0,27,34,0,232
Afghanistan,27/12/2010,302,0,3,0,113,44,0,462
Afghanistan,28/12/2010,515,4,-11,0,187,68,0,763
Afghanistan,29/12/2010,256,4,0,0,99,37,0,396
Afghanistan,30/12/2010,205,0,3,0,48,16,0,272
Afghanistan,31/12/2010,180,0,0,0,34,4,0,218
Albania,01/12/2010,5,0,0,0,0,0,0,5
Albania,02/12/2010,8,2,0,0,8,1,0,19
Albania,03/12/2010,22,0,0,0,9,0,0,31
Albania,04/12/2010,4,0,0,0,0,0,0,4
Albania,05/12/2010,9,0,0,0,-2,0,0,7
Albania,06/12/2010,3,0,0,0,-2,0,0,1
Albania,07/12/2010,10,0,0,0,0,0,0,10
Albania,08/12/2010,10,0,1,0,-8,7,0,10
Albania,09/12/2010,2,0,0,0,-2,1,0,1
Albania,10/12/2010,7,0,0,0,4,3,0,14
Albania,11/12/2010,2,0,-4,0,0,5,0,3
Albania,12/12/2010,30,0,-11,0,6,17,0,42
Albania,13/12/2010,24,0,-5,0,-6,5,0,18
Albania,14/12/2010,12,0,-1,0,-1,2,0,12
Albania,15/12/2010,36,0,-2,0,10,5,0,49
Albania,16/12/2010,22,0,-1,0,18,5,0,44
Albania,17/12/2010,21,0,-2,0,18,4,0,41
Albania,18/12/2010,78,0,0,0,12,0,0,90
Albania,19/12/2010,11,0,0,0,5,0,0,16
Albania,20/12/2010,16,0,0,0,12,-2,0,26
Albania,21/12/2010,16,0,3,0,12,0,0,31
Albania,22/12/2010,10,0,1,0,6,0,0,17
Albania,23/12/2010,3,0,0,0,-4,2,0,1
Albania,24/12/2010,0,0,0,0,3,0,0,3
Albania,25/12/2010,1,0,0,0,3,0,0,4
Albania,26/12/2010,1,0,0,0,3,4,0,8
Albania,27/12/2010,3,0,0,0,0,0,0,3
Albania,28/12/2010,-3,0,0,0,0,0,0,-3
Albania,29/12/2010,9,0,0,0,6,1,0,16
Albania,30/12/2010,2,0,0,0,-4,0,0,-2
Albania,31/12/2010,2,0,0,0,6,0,0,8
Algeria,01/12/2010,1,0,0,0,3,0,0,4
Algeria,02/12/2010,-5,0,0,0,2,0,0,-3
Algeria,03/12/2010,1,0,0,0,9,0,0,10
Algeria,04/12/2010,2,0,0,0,0,0,0,2
Algeria,05/12/2010,16,0,0,0,0,0,0,16
Algeria,06/12/2010,13,0,0,0,3,2,0,18
Algeria,07/12/2010,28,8,2,0,3,0,0,41
Algeria,08/12/2010,11,4,1,0,0,0,0,16
Algeria,09/12/2010,6,0,0,0,6,0,0,12
Algeria,10/12/2010,9,0,0,0,2,0,0,11
Algeria,11/12/2010,3,0,0,0,0,0,0,3
Algeria,12/12/2010,0,0,-4,0,0,0,0,-4
Algeria,13/12/2010,0,0,0,0,0,0,0,0
Algeria,14/12/2010,0,0,0,0,3,0,0,3
Algeria,15/12/2010,12,0,-1,0,8,7,0,26
Algeria,16/12/2010,2,0,0,0,0,2,0,4
Algeria,17/12/2010,1,0,-1,0,3,0,0,3
Algeria,18/12/2010,0,0,0,0,0,3,0,3
Algeria,19/12/2010,-9,0,0,0,-4,1,0,-12
Algeria,20/12/2010,3,0,-2,0,0,0,0,1
Algeria,21/12/2010,7,0,0,0,0,9,0,16
Algeria,22/12/2010,0,0,0,0,0,0,0,0
Algeria,23/12/2010,0,0,0,0,-4,0,0,-4
Algeria,24/12/2010,3,0,0,0,-2,0,0,1
Algeria,25/12/2010,-3,0,0,0,0,0,0,-3
Algeria,26/12/2010,-3,0,0,0,0,0,0,-3
Algeria,27/12/2010,15,0,0,0,3,5,0,23
Algeria,28/12/2010,11,0,0,0,0,0,0,11
Algeria,29/12/2010,43,0,0,0,6,0,0,49
Algeria,30/12/2010,2,0,0,0,6,0,0,8
Algeria,31/12/2010,2,0,0,0,3,4,0,9
Bangladesh,01/12/2010,14,0,0,0,12,0,0,26
Bangladesh,02/12/2010,29,0,1,0,11,0,0,41
Bangladesh,03/12/2010,9,2,0,0,0,2,0,13
Bangladesh,04/12/2010,13,0,0,0,-3,1,0,11
Bangladesh,05/12/2010,23,0,0,0,30,1,0,54
Bangladesh,06/12/2010,22,0,-4,0,8,0,0,26
Bangladesh,07/12/2010,38,6,1,0,13,3,0,61
Bangladesh,08/12/2010,2,0,-2,0,4,3,0,7
Bangladesh,09/12/2010,50,0,0,0,12,2,0,64
Bangladesh,10/12/2010,25,0,0,0,19,2,0,46
Bangladesh,11/12/2010,9,2,0,0,13,0,0,24
Bangladesh,12/12/2010,39,0,0,0,21,5,0,65
Bangladesh,13/12/2010,65,0,0,0,34,25,0,124
Bangladesh,14/12/2010,55,0,0,0,19,4,0,78
Bangladesh,15/12/2010,3,0,0,0,13,1,0,17
Bangladesh,16/12/2010,19,2,1,0,-4,1,0,19
Bangladesh,17/12/2010,21,0,0,0,-6,0,0,15
Bangladesh,18/12/2010,49,4,0,0,29,2,0,84
Bangladesh,19/12/2010,29,2,-2,0,44,2,0,75
Bangladesh,20/12/2010,33,2,0,0,42,4,0,81
Bangladesh,21/12/2010,60,0,0,0,36,3,0,99
Bangladesh,22/12/2010,8,0,0,0,9,5,0,22
Bangladesh,23/12/2010,11,0,0,0,48,3,0,62
Bangladesh,24/12/2010,6,0,0,0,6,2,0,14
Bangladesh,25/12/2010,8,0,0,0,7,2,0,17
Bangladesh,26/12/2010,27,0,0,0,7,2,0,36
Bangladesh,27/12/2010,53,0,1,0,1,4,0,59
Bangladesh,28/12/2010,6,0,0,0,8,0,0,14
Bangladesh,29/12/2010,28,0,0,0,2,9,0,39
Bangladesh,30/12/2010,33,0,0,0,28,3,0,64
Bangladesh,31/12/2010,20,0,0,0,9,2,0,31
Cameroon,01/12/2010,6,0,0,0,0,0,0,6
Cameroon,02/12/2010,0,0,0,0,0,0,0,0
Cameroon,03/12/2010,4,0,0,0,0,1,0,5
Cameroon,04/12/2010,0,0,0,0,0,0,0,0
Cameroon,05/12/2010,9,0,0,0,0,0,0,9
Cameroon,06/12/2010,0,0,0,0,0,0,0,0
Cameroon,07/12/2010,0,0,0,0,0,0,0,0
Cameroon,08/12/2010,0,0,0,0,12,0,0,12
Cameroon,09/12/2010,0,0,0,0,0,1,0,1
Cameroon,10/12/2010,3,0,0,0,0,1,0,4
Cameroon,11/12/2010,9,0,0,0,0,0,0,9
Cameroon,12/12/2010,1,0,0,0,0,0,0,1
Cameroon,13/12/2010,2,0,0,0,0,0,0,2
Cameroon,14/12/2010,0,0,0,0,9,0,0,9
Cameroon,15/12/2010,-4,0,0,0,0,0,0,-4
Cameroon,16/12/2010,0,0,0,0,0,0,0,0
Cameroon,17/12/2010,3,0,0,0,3,0,0,6
Cameroon,18/12/2010,1,0,0,0,0,0,0,1
Cameroon,19/12/2010,0,0,0,0,0,0,0,0
Cameroon,21/12/2010,2,0,0,0,0,0,0,2
Cameroon,22/12/2010,2,0,0,0,0,0,0,2
Cameroon,23/12/2010,0,0,0,0,0,0,0,0
Cameroon,24/12/2010,2,0,0,0,0,0,0,2
Cameroon,25/12/2010,1,0,0,0,0,0,0,1
Cameroon,26/12/2010,0,0,0,0,0,0,0,0
Cameroon,27/12/2010,0,0,0,0,0,0,0,0
Cameroon,28/12/2010,6,0,0,0,-2,0,0,4
Cameroon,29/12/2010,0,0,0,0,3,0,0,3
Cameroon,30/12/2010,21,0,0,0,0,0,0,21
Cameroon,31/12/2010,0,0,0,0,0,0,0,0
China,01/12/2010,147,8,-4,0,43,18,0,212
China,02/12/2010,113,2,2,0,40,28,0,185
China,03/12/2010,179,2,3,0,14,21,0,219
China,04/12/2010,108,0,0,0,31,15,0,154
China,05/12/2010,150,8,-2,0,33,12,0,201
China,06/12/2010,153,2,-9,0,54,17,0,217
China,07/12/2010,279,8,0,0,39,31,0,357
China,08/12/2010,243,4,-7,0,40,37,0,317
China,09/12/2010,211,6,0,0,98,11,0,326
China,10/12/2010,177,8,4,0,135,22,0,346
China,11/12/2010,99,4,3,0,-3,6,0,109
China,12/12/2010,123,4,3,0,45,14,0,189
China,13/12/2010,172,0,-6,0,28,24,0,218
China,14/12/2010,178,0,-6,0,40,7,0,219
China,15/12/2010,205,4,-1,0,78,44,0,330
China,16/12/2010,95,8,-2,0,36,26,0,163
China,17/12/2010,141,8,0,0,55,10,0,214
China,18/12/2010,235,0,5,0,54,22,0,316
China,19/12/2010,232,0,-6,0,33,24,0,283
China,20/12/2010,232,2,-12,0,134,13,0,369
China,21/12/2010,144,4,-2,0,45,9,0,200
China,22/12/2010,470,8,-5,0,375,62,0,910
China,23/12/2010,176,2,-2,0,68,16,0,260
China,24/12/2010,105,0,-16,0,54,11,0,154
China,25/12/2010,56,6,-2,0,31,10,0,101
China,26/12/2010,51,0,2,0,31,16,0,100
China,27/12/2010,87,4,-7,0,34,6,0,124
China,28/12/2010,137,0,-6,0,60,9,0,200
China,29/12/2010,142,0,-5,0,30,15,0,182
China,30/12/2010,119,2,1,0,132,16,0,270
China,31/12/2010,62,2,-1,0,37,6,0,106
Egypt,01/12/2010,39,0,3,0,31,10,0,83
Egypt,02/12/2010,53,0,0,0,27,9,0,89
Egypt,03/12/2010,81,0,-2,0,24,4,0,107
Egypt,04/12/2010,51,0,-1,0,13,8,0,71
Egypt,05/12/2010,50,0,2,0,36,7,0,95
Egypt,06/12/2010,52,4,0,0,18,5,0,79
Egypt,07/12/2010,80,2,0,0,-2,0,0,80
Egypt,08/12/2010,94,0,2,0,39,20,0,155
Egypt,09/12/2010,34,0,0,0,21,0,0,55
Egypt,10/12/2010,28,0,1,0,7,5,0,41
Egypt,11/12/2010,23,0,2,0,26,4,0,55
Egypt,12/12/2010,29,0,1,0,3,2,0,35
Egypt,13/12/2010,16,0,0,0,7,4,0,27
Egypt,14/12/2010,49,0,1,0,9,2,0,61
Egypt,15/12/2010,54,0,1,0,15,4,0,74
Egypt,16/12/2010,18,2,0,0,6,2,0,28
Egypt,17/12/2010,19,0,0,0,22,2,0,43
Egypt,18/12/2010,22,0,0,0,12,0,0,34
Egypt,19/12/2010,20,0,0,0,0,0,0,20
Egypt,20/12/2010,54,0,3,0,54,0,0,111
Egypt,21/12/2010,17,0,0,0,18,0,0,35
Egypt,22/12/2010,84,0,0,0,6,4,0,94
Egypt,23/12/2010,30,0,-2,0,21,9,0,58
Egypt,24/12/2010,40,0,0,0,24,5,0,69
Egypt,25/12/2010,34,0,-5,0,40,0,0,69
Egypt,26/12/2010,21,0,-1,0,18,6,0,44
Egypt,27/12/2010,44,0,0,0,6,6,0,56
Egypt,28/12/2010,54,0,0,0,15,2,0,71
Egypt,29/12/2010,23,0,-3,0,16,0,0,36
Egypt,30/12/2010,18,0,0,0,4,5,0,27
Egypt,31/12/2010,37,0,1,0,2,2,0,42
Eritrea,01/12/2010,15,0,0,0,1,0,0,16
Eritrea,02/12/2010,1,0,0,0,0,0,0,1
Eritrea,03/12/2010,1,0,0,0,0,0,0,1
Eritrea,05/12/2010,7,0,0,0,0,0,0,7
Eritrea,06/12/2010,1,0,0,0,9,0,0,10
Eritrea,07/12/2010,11,0,0,0,5,0,0,16
Eritrea,08/12/2010,25,0,0,0,46,3,0,74
Eritrea,09/12/2010,5,0,0,0,30,0,0,35
Eritrea,10/12/2010,11,0,0,0,25,1,0,37
Eritrea,11/12/2010,5,0,0,0,22,0,0,27
Eritrea,12/12/2010,11,0,0,0,3,0,0,14
Eritrea,13/12/2010,3,0,0,0,13,0,0,16
Eritrea,14/12/2010,6,0,0,0,3,1,0,10
Eritrea,15/12/2010,9,0,0,0,3,4,0,16
Eritrea,16/12/2010,2,0,0,0,1,4,0,7
Eritrea,18/12/2010,0,0,0,0,-2,0,0,-2
Eritrea,19/12/2010,0,0,0,0,9,0,0,9
Eritrea,20/12/2010,0,0,0,0,0,0,0,0
Eritrea,21/12/2010,1,0,0,0,0,0,0,1
Eritrea,22/12/2010,1,0,0,0,0,0,0,1
Eritrea,23/12/2010,0,0,0,0,0,3,0,3
Eritrea,24/12/2010,0,0,0,0,0,1,0,1
Eritrea,25/12/2010,2,0,0,0,0,0,0,2
Eritrea,26/12/2010,0,0,0,0,0,0,0,0
Eritrea,27/12/2010,2,0,0,0,6,0,0,8
Eritrea,28/12/2010,1,0,0,0,6,0,0,7
Eritrea,29/12/2010,11,0,0,0,9,0,0,20
Eritrea,30/12/2010,3,0,0,0,0,0,0,3
Eritrea,31/12/2010,2,0,0,0,0,0,0,2
Georgia,01/12/2010,28,0,0,0,37,6,0,71
Georgia,02/12/2010,45,0,-3,0,21,2,0,65
Georgia,03/12/2010,-3,0,0,0,0,0,0,-3
Georgia,04/12/2010,2,0,0,0,21,6,0,29
Georgia,05/12/2010,16,0,0,0,7,1,0,24
Georgia,06/12/2010,52,0,0,0,7,11,0,70
Georgia,07/12/2010,62,0,-2,0,25,7,0,92
Georgia,08/12/2010,52,4,0,0,30,5,0,91
Georgia,09/12/2010,36,4,0,0,26,9,0,75
Georgia,10/12/2010,34,0,0,0,35,3,0,72
Georgia,11/12/2010,27,0,0,0,13,4,0,44
Georgia,12/12/2010,21,2,0,0,-4,3,0,22
Georgia,13/12/2010,87,0,0,0,19,6,0,112
Georgia,14/12/2010,28,0,0,0,25,10,0,63
Georgia,15/12/2010,22,2,0,0,21,8,0,53
Georgia,16/12/2010,28,0,0,0,3,3,0,34
Georgia,17/12/2010,28,0,0,0,7,0,0,35
Georgia,18/12/2010,11,0,0,0,12,0,0,23
Georgia,19/12/2010,15,0,0,0,7,0,0,22
Georgia,20/12/2010,54,0,0,0,8,1,0,63
Georgia,21/12/2010,29,2,0,0,0,4,0,35
Georgia,22/12/2010,22,2,1,0,2,0,0,27
Georgia,23/12/2010,33,0,-4,0,13,1,0,43
Georgia,24/12/2010,11,0,0,0,-2,3,0,12
Georgia,25/12/2010,8,0,0,0,3,1,0,12
Georgia,26/12/2010,4,0,0,0,10,2,0,16
Georgia,27/12/2010,24,0,0,0,21,5,0,50
Georgia,28/12/2010,59,0,0,0,25,0,0,84
Georgia,29/12/2010,56,2,0,0,28,1,0,87
Georgia,30/12/2010,29,0,0,0,7,1,0,37
Georgia,31/12/2010,36,0,-2,0,28,15,0,77
India,01/12/2010,71,6,-5,0,23,10,0,105
India,02/12/2010,75,2,3,0,1,5,0,86
India,03/12/2010,84,2,2,0,-3,3,0,88
India,04/12/2010,48,0,0,0,-2,9,0,55
India,05/12/2010,58,2,-2,0,13,9,0,80
India,06/12/2010,90,4,-8,0,12,11,0,109
India,07/12/2010,59,4,1,0,6,21,0,91
India,08/12/2010,23,2,0,0,-4,4,0,25
India,09/12/2010,56,4,1,0,33,18,0,112
India,10/12/2010,73,4,-4,0,16,21,0,110
India,11/12/2010,72,2,1,0,16,2,0,93
India,12/12/2010,51,2,-1,0,20,8,0,80
India,13/12/2010,92,0,2,0,-3,10,0,101
India,14/12/2010,82,0,-7,0,1,7,0,83
India,15/12/2010,62,0,0,0,8,24,0,94
India,16/12/2010,60,2,-3,0,12,8,0,79
India,17/12/2010,57,4,1,0,57,2,0,121
India,18/12/2010,22,0,0,0,0,2,0,24
India,19/12/2010,42,0,-3,0,-3,5,0,41
India,20/12/2010,46,2,-3,0,22,14,0,81
India,21/12/2010,40,2,0,0,16,5,0,63
India,22/12/2010,76,2,-2,0,3,6,0,85
India,23/12/2010,65,0,-2,0,34,10,0,107
India,24/12/2010,67,2,0,0,40,5,0,114
India,25/12/2010,23,0,0,0,41,6,0,70
India,26/12/2010,46,0,-2,0,0,9,0,53
India,27/12/2010,71,4,-1,0,48,7,0,129
India,28/12/2010,42,0,-1,0,32,2,0,75
India,29/12/2010,57,0,-1,0,-8,5,0,53
India,30/12/2010,216,2,-5,0,214,33,0,460
India,31/12/2010,151,8,-6,0,127,21,0,301
Iran,01/12/2010,96,0,3,0,63,10,0,172
Iran,02/12/2010,65,2,-1,0,15,14,0,95
Iran,03/12/2010,137,2,2,0,6,15,0,162
Iran,04/12/2010,179,0,2,0,12,75,0,268
Iran,05/12/2010,75,0,0,0,10,34,0,119
Iran,06/12/2010,65,2,0,0,26,10,0,103
Iran,07/12/2010,118,0,2,0,49,20,0,189
Iran,08/12/2010,126,0,1,0,18,25,0,170
Iran,09/12/2010,105,0,1,0,40,5,0,151
Iran,10/12/2010,105,0,1,0,79,2,0,187
Iran,11/12/2010,58,0,11,0,53,7,0,129
Iran,12/12/2010,42,0,3,0,28,3,0,76
Iran,13/12/2010,77,0,-5,0,73,16,0,161
Iran,14/12/2010,76,0,1,0,30,14,0,121
Iran,15/12/2010,180,0,-2,0,76,32,0,286
Iran,16/12/2010,107,0,-1,0,53,20,0,179
Iran,17/12/2010,80,0,0,0,58,7,0,145
Iran,18/12/2010,45,0,0,0,27,12,0,84
Iran,19/12/2010,31,0,0,0,9,5,0,45
Iran,20/12/2010,114,0,-1,0,147,14,0,274
Iran,21/12/2010,74,0,0,0,113,10,0,197
Iran,22/12/2010,54,0,0,0,84,4,0,142
Iran,23/12/2010,72,0,0,0,45,3,0,120
Iran,24/12/2010,55,0,0,0,20,6,0,81
Iran,25/12/2010,34,0,-2,0,80,13,0,125
Iran,26/12/2010,49,0,0,0,55,8,0,112
Iran,27/12/2010,21,4,2,0,47,4,0,78
Iran,28/12/2010,48,0,2,0,69,4,0,123
Iran,29/12/2010,71,0,3,0,66,8,0,148
Iran,30/12/2010,112,0,3,0,71,6,0,192
Iran,31/12/2010,15,0,2,0,64,5,0,86
Iraq,01/12/2010,149,2,2,0,93,11,0,257
Iraq,02/12/2010,90,0,1,0,68,10,0,169
Iraq,03/12/2010,120,2,0,0,28,14,0,164
Iraq,04/12/2010,80,0,0,0,22,14,0,116
Iraq,05/12/2010,98,4,0,0,36,12,0,150
Iraq,06/12/2010,115,0,1,0,40,61,0,217
Iraq,07/12/2010,127,2,1,0,45,9,0,184
Iraq,08/12/2010,125,0,1,0,78,21,0,225
Iraq,09/12/2010,170,2,2,0,104,30,0,308
Iraq,10/12/2010,154,0,-2,0,86,31,0,269
Iraq,11/12/2010,67,0,3,0,39,5,0,114
Iraq,12/12/2010,48,0,-2,0,6,26,0,78
Iraq,13/12/2010,139,0,2,0,66,32,0,239
Iraq,14/12/2010,154,2,3,0,59,18,0,236
Iraq,15/12/2010,191,0,7,0,57,38,0,293
Iraq,16/12/2010,148,0,3,0,100,26,0,277
Iraq,17/12/2010,126,6,1,0,65,31,0,229
Iraq,18/12/2010,97,0,1,0,31,9,0,138
Iraq,19/12/2010,52,0,0,0,22,3,0,77
Iraq,20/12/2010,115,0,0,0,29,12,0,156
Iraq,21/12/2010,145,0,0,0,65,15,0,225
Iraq,22/12/2010,116,0,0,0,42,2,0,160
Iraq,23/12/2010,132,4,2,0,61,12,0,211
Iraq,24/12/2010,72,0,0,0,30,7,0,109
Iraq,25/12/2010,56,0,0,0,4,3,0,63
Iraq,26/12/2010,57,0,0,0,15,2,0,74
Iraq,27/12/2010,92,0,0,0,13,8,0,113
Iraq,28/12/2010,75,0,0,0,16,7,0,98
Iraq,29/12/2010,118,0,1,0,78,53,0,250
Iraq,30/12/2010,107,0,7,0,46,14,0,174
Iraq,31/12/2010,86,0,0,0,39,7,0,132
Morocco,01/12/2010,11,0,0,0,12,2,0,25
Morocco,02/12/2010,45,0,0,0,10,2,0,57
Morocco,03/12/2010,26,0,0,0,4,0,0,30
Morocco,04/12/2010,19,0,0,0,0,2,0,21
Morocco,05/12/2010,15,0,0,0,27,8,0,50
Morocco,06/12/2010,41,0,0,0,13,6,0,60
Morocco,07/12/2010,18,0,0,0,6,0,0,24
Morocco,08/12/2010,10,0,0,0,3,0,0,13
Morocco,09/12/2010,6,0,0,0,3,4,0,13
Morocco,10/12/2010,24,0,0,0,4,0,0,28
Morocco,11/12/2010,32,0,1,0,3,1,0,37
Morocco,12/12/2010,9,0,0,0,3,0,0,12
Morocco,13/12/2010,8,0,0,0,3,1,0,12
Morocco,14/12/2010,12,0,0,0,4,0,0,16
Morocco,15/12/2010,6,0,0,0,3,0,0,9
Morocco,16/12/2010,0,0,0,0,1,2,0,3
Morocco,17/12/2010,10,0,0,0,6,1,0,17
Morocco,18/12/2010,-5,0,0,0,0,0,0,-5
Morocco,19/12/2010,28,0,-2,0,-2,0,0,24
Morocco,20/12/2010,13,0,0,0,-2,0,0,11
Morocco,21/12/2010,1,0,-1,0,3,0,0,3
Morocco,22/12/2010,0,0,0,0,0,0,0,0
Morocco,23/12/2010,8,0,0,0,3,0,0,11
Morocco,24/12/2010,0,0,0,0,0,0,0,0
Morocco,25/12/2010,0,0,-2,0,0,0,0,-2
Morocco,26/12/2010,0,0,0,0,6,0,0,6
Morocco,27/12/2010,2,0,0,0,12,4,0,18
Morocco,28/12/2010,-1,0,0,0,0,0,0,-1
Morocco,29/12/2010,-1,0,0,0,0,0,0,-1
Morocco,30/12/2010,3,0,0,0,0,2,0,5
Morocco,31/12/2010,1,0,0,0,0,0,0,1
Nigeria,01/12/2010,56,0,0,0,36,2,0,94
Nigeria,02/12/2010,42,0,0,0,36,1,0,79
Nigeria,03/12/2010,61,0,0,0,22,1,0,84
Nigeria,04/12/2010,40,0,0,0,3,2,0,45
Nigeria,05/12/2010,26,0,0,0,8,6,0,40
Nigeria,06/12/2010,39,0,-3,0,74,1,0,111
Nigeria,07/12/2010,48,0,-1,0,40,15,0,102
Nigeria,08/12/2010,87,0,0,0,28,4,0,119
Nigeria,09/12/2010,44,0,5,0,37,2,0,88
Nigeria,10/12/2010,48,2,2,0,26,4,0,82
Nigeria,11/12/2010,31,0,0,0,10,0,0,41
Nigeria,12/12/2010,11,0,0,0,3,4,0,18
Nigeria,13/12/2010,24,0,2,0,32,0,0,58
Nigeria,14/12/2010,10,0,-4,0,7,4,0,17
Nigeria,15/12/2010,44,0,-8,0,42,2,0,80
Nigeria,16/12/2010,42,0,-4,0,46,9,0,93
Nigeria,17/12/2010,19,0,-4,0,30,7,0,52
Nigeria,18/12/2010,-3,0,0,0,2,0,0,-1
Nigeria,19/12/2010,6,0,0,0,14,0,0,20
Nigeria,20/12/2010,6,0,-8,0,18,5,0,21
Nigeria,21/12/2010,37,0,0,0,5,-2,0,40
Nigeria,22/12/2010,23,0,0,0,10,3,0,36
Nigeria,23/12/2010,46,0,0,0,22,3,0,71
Nigeria,24/12/2010,29,0,-2,0,-3,8,0,32
Nigeria,25/12/2010,113,0,-2,0,23,34,0,168
Nigeria,26/12/2010,120,2,-1,0,13,29,0,163
Nigeria,27/12/2010,111,0,-1,0,36,38,0,184
Nigeria,28/12/2010,40,0,-3,0,28,4,0,69
Nigeria,29/12/2010,30,0,-2,0,31,8,0,67
Nigeria,30/12/2010,25,0,-10,0,0,2,0,17
Nigeria,31/12/2010,28,0,-6,0,6,4,0,32
Pakistan,01/12/2010,185,2,5,0,85,18,0,295
Pakistan,02/12/2010,172,4,2,0,74,10,0,262
Pakistan,03/12/2010,203,2,-1,0,-8,10,0,206
Pakistan,04/12/2010,189,2,0,0,7,13,0,211
Pakistan,05/12/2010,117,2,0,0,6,9,0,134
Pakistan,06/12/2010,138,0,4,0,-7,57,0,192
Pakistan,07/12/2010,171,8,-1,0,96,36,0,310
Pakistan,08/12/2010,164,4,-6,0,36,43,0,241
Pakistan,09/12/2010,86,4,0,0,15,6,0,111
Pakistan,10/12/2010,140,0,0,0,43,11,0,194
Pakistan,11/12/2010,79,0,0,0,8,4,0,91
Pakistan,12/12/2010,85,0,0,0,19,4,0,108
Pakistan,13/12/2010,91,0,-7,0,22,7,0,113
Pakistan,14/12/2010,123,0,-12,0,24,16,0,151
Pakistan,15/12/2010,233,0,-1,0,40,40,0,312
Pakistan,16/12/2010,320,2,0,0,113,40,0,475
Pakistan,17/12/2010,155,2,-1,0,72,8,0,236
Pakistan,18/12/2010,176,4,0,0,24,11,0,215
Pakistan,19/12/2010,72,4,0,0,30,4,0,110
Pakistan,20/12/2010,131,4,0,0,63,19,0,217
Pakistan,21/12/2010,300,2,-3,0,11,6,0,316
Pakistan,22/12/2010,133,4,-8,0,23,9,0,161
Pakistan,23/12/2010,108,6,-4,0,68,30,0,208
Pakistan,24/12/2010,162,4,-10,0,109,25,0,290
Pakistan,25/12/2010,335,0,0,0,95,131,0,561
Pakistan,26/12/2010,96,0,1,0,58,17,0,172
Pakistan,27/12/2010,169,4,-3,0,55,12,0,237
Pakistan,28/12/2010,125,0,-13,0,35,23,0,170
Pakistan,29/12/2010,128,2,-1,0,34,6,0,169
Pakistan,30/12/2010,157,0,-3,0,113,32,0,299
Pakistan,31/12/2010,124,0,-4,0,59,12,0,191
Sierra Leone,01/12/2010,5,2,0,0,3,0,0,10
Sierra Leone,02/12/2010,6,0,0,0,0,0,0,6
Sierra Leone,03/12/2010,2,2,0,0,0,2,0,6
Sierra Leone,04/12/2010,4,0,0,0,0,0,0,4
Sierra Leone,05/12/2010,0,0,0,0,0,0,0,0
Sierra Leone,06/12/2010,10,0,0,0,-2,1,0,9
Sierra Leone,07/12/2010,2,0,0,0,-4,0,0,-2
Sierra Leone,08/12/2010,5,6,0,0,6,1,0,18
Sierra Leone,09/12/2010,11,0,0,0,0,0,0,11
Sierra Leone,10/12/2010,13,0,0,0,2,0,0,15
Sierra Leone,11/12/2010,0,0,0,0,0,0,0,0
Sierra Leone,12/12/2010,0,0,0,0,0,0,0,0
Sierra Leone,13/12/2010,4,0,0,0,-6,0,0,-2
Sierra Leone,14/12/2010,7,0,0,0,-8,0,0,-1
Sierra Leone,15/12/2010,2,0,0,0,13,2,0,17
Sierra Leone,16/12/2010,5,0,0,0,0,1,0,6
Sierra Leone,17/12/2010,4,0,0,0,8,0,0,12
Sierra Leone,18/12/2010,2,0,1,0,10,0,0,13
Sierra Leone,19/12/2010,0,0,0,0,4,0,0,4
Sierra Leone,20/12/2010,0,0,0,0,0,2,0,2
Sierra Leone,21/12/2010,6,2,0,0,3,0,0,11
Sierra Leone,22/12/2010,5,0,0,0,11,0,0,16
Sierra Leone,23/12/2010,2,0,0,0,-4,0,0,-2
Sierra Leone,24/12/2010,0,0,-6,0,0,0,0,-6
Sierra Leone,25/12/2010,10,0,-4,0,0,0,0,6
Sierra Leone,26/12/2010,6,0,-8,0,12,0,0,10
Sierra Leone,27/12/2010,10,0,-14,0,6,0,0,2
Sierra Leone,28/12/2010,25,0,-22,0,0,1,0,4
Sierra Leone,29/12/2010,1,0,-34,0,-2,3,0,-32
Sierra Leone,30/12/2010,-2,0,-4,0,0,0,0,-6
Sierra Leone,31/12/2010,8,0,0,0,0,0,0,8
Somalia,01/12/2010,53,0,0,0,-5,2,0,50
Somalia,02/12/2010,43,0,1,0,-3,5,0,46
Somalia,03/12/2010,53,0,0,0,37,2,0,92
Somalia,04/12/2010,18,0,0,0,33,0,0,51
Somalia,05/12/2010,19,0,0,0,81,2,0,102
Somalia,06/12/2010,39,2,3,0,108,2,0,154
Somalia,07/12/2010,29,4,1,0,49,2,0,85
Somalia,08/12/2010,59,0,1,0,64,2,0,126
Somalia,09/12/2010,48,0,0,0,75,5,0,128
Somalia,10/12/2010,69,0,0,0,51,4,0,124
Somalia,11/12/2010,25,0,0,0,33,4,0,62
Somalia,12/12/2010,82,0,0,0,47,10,0,139
Somalia,13/12/2010,28,2,0,0,39,2,0,71
Somalia,14/12/2010,74,0,0,0,42,8,0,124
Somalia,15/12/2010,55,2,0,0,17,7,0,81
Somalia,16/12/2010,35,2,0,0,7,3,0,47
Somalia,17/12/2010,30,6,-2,0,87,0,0,121
Somalia,18/12/2010,17,4,0,0,4,0,0,25
Somalia,19/12/2010,2,2,-2,0,0,0,0,2
Somalia,20/12/2010,21,0,0,0,15,4,0,40
Somalia,21/12/2010,34,4,0,0,19,14,0,71
Somalia,22/12/2010,36,4,0,0,18,1,0,59
Somalia,23/12/2010,30,0,0,0,47,4,0,81
Somalia,24/12/2010,22,0,0,0,20,1,0,43
Somalia,25/12/2010,71,0,-12,0,75,0,0,134
Somalia,26/12/2010,59,0,-11,0,71,15,0,134
Somalia,27/12/2010,112,0,0,0,39,6,0,157
Somalia,28/12/2010,117,0,-1,0,83,4,0,203
Somalia,29/12/2010,39,0,0,0,48,10,0,97
Somalia,30/12/2010,16,0,0,0,2,8,0,26
Somalia,31/12/2010,67,2,1,0,67,3,0,140
Syria,01/12/2010,36,0,0,0,3,0,0,39
Syria,02/12/2010,35,0,1,0,-10,3,0,29
Syria,03/12/2010,23,0,1,0,-3,0,0,21
Syria,04/12/2010,16,0,1,0,0,0,0,17
Syria,05/12/2010,7,0,0,0,12,0,0,19
Syria,06/12/2010,11,0,-3,0,8,0,0,16
Syria,07/12/2010,1,4,0,0,11,5,0,21
Syria,08/12/2010,5,0,0,0,12,0,0,17
Syria,09/12/2010,19,0,0,0,4,1,0,24
Syria,10/12/2010,16,4,-1,0,15,0,0,34
Syria,11/12/2010,4,0,2,0,-2,1,0,5
Syria,12/12/2010,-1,0,3,0,0,0,0,2
Syria,13/12/2010,16,0,0,0,9,0,0,25
Syria,14/12/2010,16,0,0,0,3,2,0,21
Syria,15/12/2010,5,0,0,0,9,1,0,15
Syria,16/12/2010,9,0,1,0,0,0,0,10
Syria,17/12/2010,23,0,0,0,4,3,0,30
Syria,18/12/2010,36,0,-1,0,3,2,0,40
Syria,19/12/2010,-14,0,-2,0,-10,0,0,-26
Syria,20/12/2010,27,0,0,0,10,2,0,39
Syria,21/12/2010,-5,0,-2,0,7,4,0,4
Syria,22/12/2010,19,0,0,0,15,8,0,42
Syria,23/12/2010,13,0,0,0,0,1,0,14
Syria,24/12/2010,13,0,0,0,1,1,0,15
Syria,25/12/2010,8,0,1,0,12,0,0,21
Syria,26/12/2010,-3,0,0,0,2,0,0,-1
Syria,27/12/2010,15,0,0,0,-3,3,0,15
Syria,28/12/2010,6,0,-3,0,13,0,0,16
Syria,29/12/2010,41,0,-2,0,24,0,0,63
Syria,30/12/2010,25,0,0,0,9,0,0,34
Syria,31/12/2010,-1,0,0,0,9,0,0,8
Yemen,01/12/2010,54,0,0,0,1,12,0,67
Yemen,02/12/2010,83,2,1,0,5,3,0,94
Yemen,03/12/2010,39,0,0,0,17,1,0,57
Yemen,04/12/2010,51,0,0,0,3,6,0,60
Yemen,05/12/2010,12,0,0,0,9,0,0,21
Yemen,06/12/2010,16,0,0,0,15,0,0,31
Yemen,07/12/2010,37,0,0,0,-8,4,0,33
Yemen,08/12/2010,62,0,0,0,7,1,0,70
Yemen,09/12/2010,39,0,0,0,0,0,0,39
Yemen,10/12/2010,19,0,0,0,-8,0,0,11
Yemen,11/12/2010,-1,0,0,0,7,0,0,6
Yemen,12/12/2010,17,0,-4,0,0,2,0,15
Yemen,13/12/2010,10,0,0,0,-4,15,0,21
Yemen,14/12/2010,17,0,0,0,0,0,0,17
Yemen,15/12/2010,16,0,1,0,11,3,0,31
Yemen,16/12/2010,10,0,0,0,13,0,0,23
Yemen,17/12/2010,15,0,0,0,9,8,0,32
Yemen,18/12/2010,4,0,0,0,-2,0,0,2
Yemen,19/12/2010,11,2,0,0,4,0,0,17
Yemen,20/12/2010,9,0,1,0,15,5,0,30
Yemen,21/12/2010,4,0,0,0,7,3,0,14
Yemen,22/12/2010,29,0,-2,0,59,1,0,87
Yemen,23/12/2010,15,0,0,0,19,4,0,38
Yemen,24/12/2010,13,0,0,0,9,0,0,22
Yemen,25/12/2010,8,0,0,0,0,0,0,8
Yemen,26/12/2010,14,0,-4,0,0,12,0,22
Yemen,27/12/2010,14,0,-3,0,-2,8,0,17
Yemen,28/12/2010,8,0,1,0,15,0,0,24
Yemen,29/12/2010,10,0,-2,0,5,0,0,13
Yemen,30/12/2010,9,0,0,0,-5,2,0,6
Yemen,31/12/2010,8,0,-6,0,-6,0,0,-4
Afghanistan,01/06/2010,221,2,-4,0,15,4,0,238
Afghanistan,02/06/2010,24,0,0,0,6,5,0,35
Afghanistan,03/06/2010,36,0,0,0,-1,6,0,41
Afghanistan,04/06/2010,66,0,0,0,7,11,0,84
Afghanistan,05/06/2010,54,0,0,0,23,8,0,85
Afghanistan,06/06/2010,184,0,1,0,32,14,0,231
Afghanistan,07/06/2010,121,0,0,0,7,20,0,148
Afghanistan,08/06/2010,306,0,-6,0,12,37,0,349
Afghanistan,09/06/2010,96,0,-2,0,3,6,0,103
Afghanistan,10/06/2010,200,2,-8,0,20,25,0,239
Afghanistan,11/06/2010,134,0,0,0,24,13,0,171
Afghanistan,12/06/2010,101,0,0,0,10,15,0,126
Afghanistan,13/06/2010,32,4,-1,0,0,1,0,36
Afghanistan,14/06/2010,78,2,0,0,2,4,0,86
Afghanistan,15/06/2010,143,2,0,0,37,13,0,195
Afghanistan,16/06/2010,106,0,0,0,23,3,0,132
Afghanistan,17/06/2010,114,6,2,0,-6,4,0,120
Afghanistan,18/06/2010,34,0,0,0,-5,1,0,30
Afghanistan,19/06/2010,186,2,-2,0,11,10,0,207
Afghanistan,20/06/2010,86,4,0,0,19,4,0,113
Afghanistan,21/06/2010,82,0,-4,0,8,5,0,91
Afghanistan,22/06/2010,165,0,3,0,62,11,0,241
Afghanistan,23/06/2010,244,0,0,0,12,11,0,267
Afghanistan,24/06/2010,110,0,-3,0,16,0,0,123
Afghanistan,25/06/2010,62,2,3,0,48,4,0,119
Afghanistan,26/06/2010,51,0,0,0,0,6,0,57
Afghanistan,27/06/2010,61,0,0,0,1,0,0,62
Afghanistan,28/06/2010,46,0,0,0,3,7,0,56
Afghanistan,29/06/2010,388,2,-11,0,31,26,0,436
Afghanistan,30/06/2010,152,0,-4,0,11,9,0,168
Albania,01/06/2010,5,0,0,0,0,0,0,5
Albania,02/06/2010,9,0,0,0,6,0,0,15
Albania,03/06/2010,2,0,0,0,10,0,0,12
Albania,04/06/2010,0,0,0,0,0,2,0,2
Albania,05/06/2010,2,0,0,0,0,0,0,2
Albania,06/06/2010,4,0,0,0,0,0,0,4
Albania,07/06/2010,0,0,0,0,0,0,0,0
Albania,08/06/2010,4,0,-1,0,0,0,0,3
Albania,09/06/2010,4,0,0,0,0,0,0,4
Albania,10/06/2010,8,0,0,0,0,0,0,8
Albania,11/06/2010,0,0,0,0,3,0,0,3
Albania,12/06/2010,0,0,0,0,0,1,0,1
Albania,14/06/2010,1,0,0,0,0,0,0,1
Albania,15/06/2010,6,0,2,0,3,0,0,11
Albania,16/06/2010,-1,0,0,0,0,0,0,-1
Albania,17/06/2010,3,0,0,0,0,0,0,3
Albania,18/06/2010,0,0,0,0,0,0,0,0
Albania,19/06/2010,2,0,0,0,0,0,0,2
Albania,20/06/2010,2,0,0,0,0,0,0,2
Albania,21/06/2010,0,0,0,0,0,4,0,4
Albania,22/06/2010,3,0,0,0,3,0,0,6
Albania,23/06/2010,-3,0,0,0,15,0,0,12
Albania,24/06/2010,0,0,0,0,9,0,0,9
Albania,25/06/2010,0,0,0,0,0,0,0,0
Albania,26/06/2010,0,0,0,0,0,0,0,0
Albania,27/06/2010,0,0,0,0,0,0,0,0
Albania,28/06/2010,0,0,0,0,0,0,0,0
Albania,29/06/2010,0,0,0,0,0,1,0,1
Albania,30/06/2010,0,0,0,0,0,0,0,0
Algeria,01/06/2010,8,0,0,0,3,0,0,11
Algeria,02/06/2010,6,0,0,0,30,2,0,38
Algeria,03/06/2010,0,0,0,0,6,0,0,6
Algeria,04/06/2010,0,0,0,0,3,0,0,3
Algeria,06/06/2010,15,0,0,0,3,1,0,19
Algeria,09/06/2010,0,0,0,0,0,1,0,1
Algeria,10/06/2010,0,0,0,0,0,0,0,0
Algeria,11/06/2010,0,0,0,0,6,0,0,6
Algeria,12/06/2010,18,0,0,0,0,0,0,18
Algeria,13/06/2010,2,0,0,0,0,0,0,2
Algeria,14/06/2010,0,0,0,0,0,0,0,0
Algeria,15/06/2010,6,0,0,0,0,0,0,6
Algeria,17/06/2010,0,0,0,0,0,0,0,0
Algeria,18/06/2010,10,0,0,0,3,0,0,13
Algeria,19/06/2010,31,0,0,0,0,0,0,31
Algeria,20/06/2010,0,0,0,0,15,0,0,15
Algeria,21/06/2010,0,0,0,0,3,0,0,3
Algeria,22/06/2010,4,0,0,0,0,0,0,4
Algeria,23/06/2010,2,0,0,0,3,0,0,5
Algeria,24/06/2010,0,0,0,0,0,0,0,0
Algeria,25/06/2010,6,0,0,0,0,0,0,6
Algeria,26/06/2010,0,0,0,0,0,0,0,0
Algeria,29/06/2010,0,0,0,0,1,0,0,1
Algeria,30/06/2010,9,0,1,0,0,0,0,10
Bangladesh,01/06/2010,1,0,0,0,21,0,0,22
Bangladesh,02/06/2010,0,0,0,0,4,0,0,4
Bangladesh,03/06/2010,2,0,0,0,15,0,0,17
Bangladesh,04/06/2010,21,0,0,0,9,0,0,30
Bangladesh,05/06/2010,0,0,0,0,0,0,0,0
Bangladesh,06/06/2010,-4,0,0,0,58,2,0,56
Bangladesh,07/06/2010,8,0,0,0,9,1,0,18
Bangladesh,08/06/2010,3,0,0,0,12,1,0,16
Bangladesh,09/06/2010,6,0,0,0,-3,0,0,3
Bangladesh,10/06/2010,5,0,-2,0,0,1,0,4
Bangladesh,11/06/2010,6,0,0,0,0,0,0,6
Bangladesh,12/06/2010,4,0,0,0,3,0,0,7
Bangladesh,13/06/2010,0,0,0,0,0,0,0,0
Bangladesh,14/06/2010,0,0,0,0,3,2,0,5
Bangladesh,15/06/2010,4,0,0,0,-8,0,0,-4
Bangladesh,16/06/2010,4,0,0,0,3,1,0,8
Bangladesh,17/06/2010,4,0,0,0,6,0,0,10
Bangladesh,18/06/2010,4,0,0,0,6,0,0,10
Bangladesh,19/06/2010,32,0,0,0,6,2,0,40
Bangladesh,20/06/2010,7,0,0,0,-1,0,0,6
Bangladesh,21/06/2010,-1,0,0,0,0,0,0,-1
Bangladesh,22/06/2010,14,0,0,0,15,9,0,38
Bangladesh,23/06/2010,2,0,0,0,6,0,0,8
Bangladesh,24/06/2010,0,0,0,0,0,0,0,0
Bangladesh,25/06/2010,4,0,0,0,7,2,0,13
Bangladesh,26/06/2010,0,0,0,0,3,0,0,3
Bangladesh,27/06/2010,0,0,0,0,0,0,0,0
Bangladesh,28/06/2010,0,0,0,0,0,0,0,0
Bangladesh,29/06/2010,11,0,0,0,9,1,0,21
Bangladesh,30/06/2010,3,0,-1,0,0,4,0,6
Cameroon,06/06/2010,0,0,0,0,0,0,0,0
Cameroon,07/06/2010,0,0,0,0,0,0,0,0
Cameroon,08/06/2010,0,0,0,0,0,0,0,0
Cameroon,15/06/2010,0,0,0,0,3,0,0,3
Cameroon,19/06/2010,8,0,0,0,0,0,0,8
Cameroon,20/06/2010,9,0,0,0,0,0,0,9
Cameroon,21/06/2010,7,0,0,0,3,0,0,10
Cameroon,22/06/2010,3,0,1,0,-18,0,0,-14
Cameroon,23/06/2010,0,0,0,0,0,0,0,0
Cameroon,26/06/2010,0,0,0,0,0,0,0,0
Cameroon,27/06/2010,0,0,0,0,0,0,0,0
Cameroon,29/06/2010,8,0,0,0,0,1,0,9
Cameroon,30/06/2010,0,0,0,0,0,0,0,0
China,01/06/2010,62,0,-6,0,52,4,0,112
China,02/06/2010,18,0,0,0,3,2,0,23
China,03/06/2010,13,0,-2,0,9,2,0,22
China,04/06/2010,73,8,-4,0,9,14,0,100
China,05/06/2010,40,0,0,0,-12,2,0,30
China,06/06/2010,55,0,0,0,3,5,0,63
China,07/06/2010,17,0,0,0,9,1,0,27
China,08/06/2010,86,6,-5,0,16,16,0,119
China,09/06/2010,34,0,0,0,13,4,0,51
China,10/06/2010,60,0,0,0,4,11,0,75
China,11/06/2010,42,0,-2,0,9,14,0,63
China,12/06/2010,24,0,0,0,4,0,0,28
China,13/06/2010,21,0,0,0,10,0,0,31
China,14/06/2010,22,0,1,0,8,10,0,41
China,15/06/2010,61,0,0,0,3,5,0,69
China,16/06/2010,36,0,0,0,3,2,0,41
China,17/06/2010,42,0,-4,0,32,12,0,82
China,18/06/2010,28,0,-6,0,12,1,0,35
China,19/06/2010,51,0,-2,0,19,7,0,75
China,20/06/2010,32,0,-7,0,-3,15,0,37
China,21/06/2010,49,0,-1,0,-3,6,0,51
China,22/06/2010,68,0,-3,0,20,2,0,87
China,23/06/2010,62,0,-7,0,28,8,0,91
China,24/06/2010,23,0,1,0,6,6,0,36
China,25/06/2010,57,2,-2,0,8,2,0,67
China,26/06/2010,14,0,0,0,3,2,0,19
China,27/06/2010,5,0,-2,0,1,3,0,7
China,28/06/2010,18,0,-2,0,3,2,0,21
China,29/06/2010,163,0,-3,0,137,42,0,339
China,30/06/2010,48,0,1,0,-7,3,0,45
Egypt,01/06/2010,97,0,-2,0,9,0,0,104
Egypt,02/06/2010,57,0,0,0,3,1,0,61
Egypt,03/06/2010,15,0,0,0,6,0,0,21
Egypt,04/06/2010,41,0,0,0,4,1,0,46
Egypt,05/06/2010,7,0,0,0,0,0,0,7
Egypt,06/06/2010,32,0,3,0,-1,2,0,36
Egypt,07/06/2010,23,0,0,0,18,2,0,43
Egypt,08/06/2010,16,0,0,0,17,3,0,36
Egypt,09/06/2010,24,0,0,0,10,1,0,35
Egypt,10/06/2010,29,0,0,0,0,0,0,29
Egypt,11/06/2010,25,0,0,0,3,4,0,32
Egypt,12/06/2010,11,0,0,0,3,1,0,15
Egypt,13/06/2010,2,0,0,0,3,0,0,5
Egypt,14/06/2010,15,0,0,0,4,0,0,19
Egypt,15/06/2010,6,0,-1,0,10,6,0,21
Egypt,16/06/2010,86,0,0,0,8,1,0,95
Egypt,17/06/2010,37,0,0,0,3,0,0,40
Egypt,18/06/2010,0,0,0,0,0,2,0,2
Egypt,19/06/2010,20,0,0,0,8,4,0,32
Egypt,20/06/2010,22,0,0,0,6,0,0,28
Egypt,21/06/2010,24,0,0,0,-5,4,0,23
Egypt,22/06/2010,6,0,0,0,6,4,0,16
Egypt,23/06/2010,17,0,0,0,9,4,0,30
Egypt,24/06/2010,11,0,0,0,0,1,0,12
Egypt,25/06/2010,14,0,0,0,7,0,0,21
Egypt,26/06/2010,6,0,0,0,0,2,0,8
Egypt,27/06/2010,4,0,0,0,-4,1,0,1
Egypt,28/06/2010,0,0,1,0,-4,0,0,-3
Egypt,29/06/2010,97,0,0,0,45,0,0,142
Egypt,30/06/2010,-3,0,0,0,4,0,0,1
Eritrea,01/06/2010,2,0,0,0,0,0,0,2
Eritrea,02/06/2010,-6,0,0,0,0,0,0,-6
Eritrea,03/06/2010,-6,0,0,0,0,0,0,-6
Eritrea,04/06/2010,2,0,0,0,0,0,0,2
Eritrea,05/06/2010,0,0,0,0,0,0,0,0
Eritrea,06/06/2010,1,0,0,0,0,0,0,1
Eritrea,07/06/2010,3,0,0,0,0,0,0,3
Eritrea,08/06/2010,0,2,0,0,6,0,0,8
Eritrea,09/06/2010,0,0,0,0,3,0,0,3
Eritrea,10/06/2010,0,0,0,0,0,0,0,0
Eritrea,11/06/2010,2,0,0,0,0,0,0,2
Eritrea,12/06/2010,4,0,0,0,0,0,0,4
Eritrea,14/06/2010,0,0,0,0,0,0,0,0
Eritrea,15/06/2010,0,0,0,0,0,0,0,0
Eritrea,16/06/2010,0,0,0,0,12,0,0,12
Eritrea,17/06/2010,0,0,0,0,0,0,0,0
Eritrea,18/06/2010,0,0,0,0,0,0,0,0
Eritrea,19/06/2010,0,0,0,0,5,0,0,5
Eritrea,21/06/2010,9,0,0,0,0,0,0,9
Eritrea,22/06/2010,0,0,0,0,0,0,0,0
Eritrea,23/06/2010,-1,0,0,0,12,0,0,11
Eritrea,25/06/2010,0,0,0,0,6,0,0,6
Eritrea,26/06/2010,-3,0,0,0,0,0,0,-3
Eritrea,27/06/2010,0,0,0,0,0,0,0,0
Eritrea,29/06/2010,44,0,0,0,3,0,0,47
Eritrea,30/06/2010,0,0,0,0,0,2,0,2
Georgia,01/06/2010,1,0,0,0,9,0,0,10
Georgia,02/06/2010,6,0,0,0,0,1,0,7
Georgia,03/06/2010,0,0,0,0,0,0,0,0
Georgia,04/06/2010,0,0,0,0,-2,0,0,-2
Georgia,05/06/2010,4,0,0,0,0,1,0,5
Georgia,06/06/2010,3,0,0,0,1,0,0,4
Georgia,07/06/2010,0,0,0,0,3,0,0,3
Georgia,08/06/2010,37,0,-2,0,0,3,0,38
Georgia,09/06/2010,8,0,0,0,3,0,0,11
Georgia,10/06/2010,9,0,0,0,6,0,0,15
Georgia,11/06/2010,2,2,0,0,7,3,0,14
Georgia,12/06/2010,3,0,0,0,0,0,0,3
Georgia,13/06/2010,0,0,0,0,0,1,0,1
Georgia,14/06/2010,2,0,0,0,3,0,0,5
Georgia,15/06/2010,0,0,0,0,3,0,0,3
Georgia,16/06/2010,0,0,0,0,0,0,0,0
Georgia,17/06/2010,17,0,0,0,18,0,0,35
Georgia,18/06/2010,3,2,0,0,0,1,0,6
Georgia,19/06/2010,12,0,0,0,1,1,0,14
Georgia,20/06/2010,17,0,0,0,1,1,0,19
Georgia,21/06/2010,3,0,0,0,-2,1,0,2
Georgia,22/06/2010,8,0,3,0,4,1,0,16
Georgia,23/06/2010,19,0,0,0,0,0,0,19
Georgia,24/06/2010,0,0,0,0,0,0,0,0
Georgia,25/06/2010,9,0,0,0,3,0,0,12
Georgia,26/06/2010,5,0,0,0,-1,0,0,4
Georgia,27/06/2010,0,0,0,0,0,0,0,0
Georgia,28/06/2010,1,0,0,0,3,0,0,4
Georgia,29/06/2010,54,0,0,0,-2,3,0,55
Georgia,30/06/2010,10,0,0,0,2,2,0,14
India,01/06/2010,18,0,-2,0,17,2,0,35
India,02/06/2010,10,0,0,0,1,1,0,12
India,03/06/2010,1,0,0,0,0,1,0,2
India,04/06/2010,49,0,1,0,9,4,0,63
India,05/06/2010,7,0,0,0,3,0,0,10
India,06/06/2010,20,0,0,0,3,2,0,25
India,07/06/2010,23,0,0,0,-6,0,0,17
India,08/06/2010,72,2,-2,0,12,14,0,98
India,09/06/2010,14,2,-1,0,12,0,0,27
India,10/06/2010,12,0,0,0,20,2,0,34
India,11/06/2010,13,2,0,0,15,1,0,31
India,12/06/2010,13,0,0,0,4,3,0,20
India,13/06/2010,14,0,0,0,9,0,0,23
India,14/06/2010,32,0,0,0,1,0,0,33
India,15/06/2010,12,0,0,0,8,0,0,20
India,16/06/2010,19,0,0,0,9,0,0,28
India,17/06/2010,46,0,0,0,24,0,0,70
India,18/06/2010,50,0,-4,0,29,3,0,78
India,19/06/2010,65,0,0,0,22,5,0,92
India,20/06/2010,53,0,0,0,6,3,0,62
India,21/06/2010,17,0,-2,0,8,4,0,27
India,22/06/2010,20,0,-2,0,10,2,0,30
India,23/06/2010,6,0,-3,0,1,1,0,5
India,24/06/2010,21,0,0,0,4,4,0,29
India,25/06/2010,29,4,0,0,-4,2,0,31
India,26/06/2010,8,0,0,0,0,0,0,8
India,27/06/2010,6,0,0,0,0,0,0,6
India,28/06/2010,0,0,0,0,-2,0,0,-2
India,29/06/2010,102,6,-1,0,54,31,0,192
India,30/06/2010,33,0,-2,0,4,3,0,38
Iran,01/06/2010,43,2,0,0,12,6,0,63
Iran,02/06/2010,34,0,0,0,12,0,0,46
Iran,03/06/2010,10,0,0,0,4,0,0,14
Iran,04/06/2010,25,0,-2,0,2,0,0,25
Iran,05/06/2010,33,0,0,0,0,0,0,33
Iran,06/06/2010,104,0,2,0,13,5,0,124
Iran,07/06/2010,88,0,-2,0,25,3,0,114
Iran,08/06/2010,75,0,5,0,38,24,0,142
Iran,09/06/2010,28,0,0,0,67,7,0,102
Iran,10/06/2010,54,0,4,0,25,22,0,105
Iran,11/06/2010,30,0,0,0,4,4,0,38
Iran,12/06/2010,23,0,1,0,2,2,0,28
Iran,13/06/2010,12,0,-4,0,-4,0,0,4
Iran,14/06/2010,33,0,4,0,11,8,0,56
Iran,15/06/2010,38,2,-4,0,-3,0,0,33
Iran,16/06/2010,10,0,1,0,9,2,0,22
Iran,17/06/2010,23,0,0,0,3,0,0,26
Iran,18/06/2010,27,2,2,0,5,0,0,36
Iran,19/06/2010,77,0,2,0,19,7,0,105
Iran,20/06/2010,51,0,-4,0,46,2,0,95
Iran,21/06/2010,18,0,-2,0,31,0,0,47
Iran,22/06/2010,41,0,-1,0,36,5,0,81
Iran,23/06/2010,18,0,-4,0,10,4,0,28
Iran,24/06/2010,32,0,0,0,5,5,0,42
Iran,25/06/2010,24,0,0,0,1,3,0,28
Iran,26/06/2010,7,0,0,0,0,2,0,9
Iran,27/06/2010,25,0,0,0,-1,0,0,24
Iran,28/06/2010,16,0,0,0,0,2,0,18
Iran,29/06/2010,68,0,-1,0,105,5,0,177
Iran,30/06/2010,59,0,0,0,4,1,0,64
Iraq,01/06/2010,89,2,0,0,2,9,0,102
Iraq,02/06/2010,17,0,0,0,0,1,0,18
Iraq,03/06/2010,36,0,0,0,3,0,0,39
Iraq,04/06/2010,62,0,-1,0,7,10,0,78
Iraq,05/06/2010,40,0,0,0,0,2,0,42
Iraq,06/06/2010,92,0,-2,0,15,2,0,107
Iraq,07/06/2010,49,0,0,0,4,4,0,57
Iraq,08/06/2010,94,0,8,0,35,2,0,139
Iraq,09/06/2010,7,0,0,0,0,4,0,11
Iraq,10/06/2010,56,0,1,0,9,1,0,67
Iraq,11/06/2010,43,0,0,0,16,4,0,63
Iraq,12/06/2010,8,0,0,0,12,1,0,21
Iraq,13/06/2010,11,0,-1,0,9,0,0,19
Iraq,14/06/2010,26,0,-1,0,-6,7,0,26
Iraq,15/06/2010,51,0,0,0,6,0,0,57
Iraq,16/06/2010,50,0,0,0,37,8,0,95
Iraq,17/06/2010,42,2,0,0,22,7,0,73
Iraq,18/06/2010,20,0,0,0,-1,0,0,19
Iraq,19/06/2010,245,0,0,0,17,13,0,275
Iraq,20/06/2010,120,0,0,0,19,1,0,140
Iraq,21/06/2010,111,0,-4,0,16,20,0,143
Iraq,22/06/2010,68,0,2,0,31,5,0,106
Iraq,23/06/2010,63,0,-4,0,16,13,0,88
Iraq,24/06/2010,58,0,-5,0,-2,3,0,54
Iraq,25/06/2010,66,0,0,0,12,9,0,87
Iraq,26/06/2010,2,0,0,0,6,11,0,19
Iraq,27/06/2010,26,0,0,0,3,0,0,29
Iraq,28/06/2010,17,0,0,0,7,3,0,27
Iraq,29/06/2010,106,0,0,0,86,20,0,212
Iraq,30/06/2010,65,0,0,0,14,0,0,79
Morocco,01/06/2010,0,0,0,0,3,0,0,3
Morocco,02/06/2010,0,0,0,0,9,0,0,9
Morocco,03/06/2010,14,0,0,0,18,0,0,32
Morocco,04/06/2010,0,0,0,0,0,0,0,0
Morocco,05/06/2010,3,0,0,0,0,0,0,3
Morocco,06/06/2010,2,0,0,0,0,0,0,2
Morocco,07/06/2010,7,0,0,0,9,0,0,16
Morocco,08/06/2010,5,0,0,0,6,1,0,12
Morocco,10/06/2010,0,0,0,0,3,0,0,3
Morocco,11/06/2010,2,0,0,0,3,0,0,5
Morocco,12/06/2010,0,0,0,0,0,0,0,0
Morocco,13/06/2010,6,0,0,0,3,0,0,9
Morocco,14/06/2010,5,0,0,0,0,0,0,5
Morocco,15/06/2010,21,0,0,0,2,6,0,29
Morocco,16/06/2010,0,0,0,0,0,0,0,0
Morocco,17/06/2010,0,0,0,0,0,1,0,1
Morocco,18/06/2010,-2,0,0,0,0,1,0,-1
Morocco,19/06/2010,3,0,0,0,0,0,0,3
Morocco,20/06/2010,6,0,0,0,1,0,0,7
Morocco,21/06/2010,0,0,0,0,0,0,0,0
Morocco,22/06/2010,0,0,0,0,0,0,0,0
Morocco,23/06/2010,0,0,0,0,6,0,0,6
Morocco,24/06/2010,1,0,-3,0,0,2,0,0
Morocco,25/06/2010,1,0,0,0,0,0,0,1
Morocco,26/06/2010,0,0,0,0,0,0,0,0
Morocco,27/06/2010,0,0,0,0,0,0,0,0
Morocco,28/06/2010,0,0,-1,0,0,0,0,-1
Morocco,29/06/2010,3,0,0,0,15,0,0,18
Morocco,30/06/2010,2,0,0,0,9,0,0,11
Nigeria,01/06/2010,2,2,0,0,6,5,0,15
Nigeria,02/06/2010,1,0,0,0,0,0,0,1
Nigeria,03/06/2010,0,0,0,0,0,0,0,0
Nigeria,04/06/2010,10,0,-2,0,25,0,0,33
Nigeria,05/06/2010,3,0,0,0,0,0,0,3
Nigeria,06/06/2010,15,0,0,0,9,1,0,25
Nigeria,07/06/2010,13,0,1,0,9,1,0,24
Nigeria,08/06/2010,17,0,1,0,6,8,0,32
Nigeria,09/06/2010,11,0,1,0,9,0,0,21
Nigeria,10/06/2010,10,0,1,0,9,1,0,21
Nigeria,11/06/2010,1,0,0,0,1,0,0,2
Nigeria,12/06/2010,-1,0,0,0,3,0,0,2
Nigeria,13/06/2010,0,0,0,0,0,0,0,0
Nigeria,14/06/2010,3,0,0,0,10,0,0,13
Nigeria,15/06/2010,6,0,0,0,12,0,0,18
Nigeria,16/06/2010,2,0,0,0,6,0,0,8
Nigeria,17/06/2010,8,0,0,0,16,1,0,25
Nigeria,18/06/2010,0,0,0,0,6,0,0,6
Nigeria,19/06/2010,11,0,0,0,2,1,0,14
Nigeria,20/06/2010,-2,0,0,0,0,0,0,-2
Nigeria,21/06/2010,8,0,0,0,3,1,0,12
Nigeria,22/06/2010,6,0,1,0,15,1,0,23
Nigeria,23/06/2010,14,0,0,0,12,0,0,26
Nigeria,24/06/2010,0,0,0,0,7,0,0,7
Nigeria,25/06/2010,3,0,0,0,7,3,0,13
Nigeria,26/06/2010,0,0,0,0,0,0,0,0
Nigeria,27/06/2010,10,0,0,0,3,0,0,13
Nigeria,28/06/2010,8,0,0,0,0,0,0,8
Nigeria,29/06/2010,29,0,1,0,13,4,0,47
Nigeria,30/06/2010,3,0,1,0,3,0,0,7
Pakistan,01/06/2010,231,0,1,0,22,27,0,281
Pakistan,02/06/2010,12,0,0,0,9,0,0,21
Pakistan,03/06/2010,40,0,0,0,15,0,0,55
Pakistan,04/06/2010,72,0,0,0,38,4,0,114
Pakistan,05/06/2010,24,0,0,0,1,0,0,25
Pakistan,06/06/2010,17,0,0,0,33,2,0,52
Pakistan,07/06/2010,40,0,-6,0,12,20,0,66
Pakistan,08/06/2010,106,0,-6,0,37,21,0,158
Pakistan,09/06/2010,39,0,0,0,1,0,0,40
Pakistan,10/06/2010,24,2,-2,0,17,8,0,49
Pakistan,11/06/2010,20,0,0,0,21,4,0,45
Pakistan,12/06/2010,38,0,0,0,0,0,0,38
Pakistan,13/06/2010,-2,0,0,0,0,0,0,-2
Pakistan,14/06/2010,54,0,0,0,28,0,0,82
Pakistan,15/06/2010,30,0,0,0,23,10,0,63
Pakistan,16/06/2010,45,0,0,0,26,6,0,77
Pakistan,17/06/2010,36,2,0,0,12,4,0,54
Pakistan,18/06/2010,6,0,0,0,15,0,0,21
Pakistan,19/06/2010,78,0,-3,0,32,2,0,109
Pakistan,20/06/2010,144,0,-2,0,47,45,0,234
Pakistan,21/06/2010,43,0,0,0,16,22,0,81
Pakistan,22/06/2010,70,0,0,0,14,6,0,90
Pakistan,23/06/2010,35,2,0,0,18,8,0,63
Pakistan,24/06/2010,23,0,0,0,22,0,0,45
Pakistan,25/06/2010,52,0,0,0,22,4,0,78
Pakistan,26/06/2010,4,0,2,0,37,2,0,45
Pakistan,27/06/2010,8,0,1,0,0,4,0,13
Pakistan,28/06/2010,22,0,0,0,1,3,0,26
Pakistan,29/06/2010,85,0,-2,0,91,5,0,179
Pakistan,30/06/2010,55,0,0,0,38,0,0,93
Sierra Leone,01/06/2010,4,0,0,0,0,2,0,6
Sierra Leone,04/06/2010,0,0,0,0,0,0,0,0
Sierra Leone,07/06/2010,0,0,0,0,0,0,0,0
Sierra Leone,08/06/2010,9,0,0,0,0,0,0,9
Sierra Leone,09/06/2010,0,0,0,0,0,0,0,0
Sierra Leone,10/06/2010,0,0,0,0,0,0,0,0
Sierra Leone,11/06/2010,0,0,0,0,0,0,0,0
Sierra Leone,12/06/2010,0,0,0,0,0,0,0,0
Sierra Leone,14/06/2010,0,0,0,0,0,0,0,0
Sierra Leone,15/06/2010,0,0,0,0,0,0,0,0
Sierra Leone,16/06/2010,0,0,0,0,0,0,0,0
Sierra Leone,17/06/2010,6,0,0,0,6,0,0,12
Sierra Leone,18/06/2010,0,0,0,0,0,0,0,0
Sierra Leone,20/06/2010,0,0,0,0,0,0,0,0
Sierra Leone,21/06/2010,0,0,0,0,0,0,0,0
Sierra Leone,22/06/2010,0,0,0,0,10,0,0,10
Sierra Leone,23/06/2010,2,0,0,0,0,0,0,2
Sierra Leone,25/06/2010,1,0,0,0,0,0,0,1
Sierra Leone,26/06/2010,0,0,0,0,0,0,0,0
Sierra Leone,27/06/2010,0,0,0,0,0,0,0,0
Sierra Leone,29/06/2010,3,0,0,0,0,0,0,3
Sierra Leone,30/06/2010,0,0,0,0,0,2,0,2
Somalia,01/06/2010,13,0,0,0,30,1,0,44
Somalia,02/06/2010,50,0,0,0,21,0,0,71
Somalia,03/06/2010,24,0,0,0,3,6,0,33
Somalia,04/06/2010,19,0,0,0,2,0,0,21
Somalia,05/06/2010,1,0,0,0,0,0,0,1
Somalia,06/06/2010,39,0,0,0,102,2,0,143
Somalia,07/06/2010,17,0,0,0,46,9,0,72
Somalia,08/06/2010,23,0,-6,0,18,7,0,42
Somalia,09/06/2010,9,0,0,0,6,0,0,15
Somalia,10/06/2010,-1,0,0,0,19,0,0,18
Somalia,11/06/2010,11,0,0,0,-5,2,0,8
Somalia,12/06/2010,9,0,0,0,-6,0,0,3
Somalia,13/06/2010,3,0,0,0,3,1,0,7
Somalia,14/06/2010,2,0,0,0,0,0,0,2
Somalia,15/06/2010,20,0,0,0,9,2,0,31
Somalia,16/06/2010,10,0,0,0,1,0,0,11
Somalia,17/06/2010,27,0,0,0,51,0,0,78
Somalia,18/06/2010,11,0,0,0,4,0,0,15
Somalia,19/06/2010,9,0,0,0,10,0,0,19
Somalia,20/06/2010,3,0,0,0,0,0,0,3
Somalia,21/06/2010,13,0,0,0,9,2,0,24
Somalia,22/06/2010,-1,0,0,0,6,0,0,5
Somalia,23/06/2010,15,0,0,0,3,0,0,18
Somalia,24/06/2010,8,0,0,0,12,2,0,22
Somalia,25/06/2010,15,0,0,0,28,0,0,43
Somalia,26/06/2010,0,0,0,0,-1,0,0,-1
Somalia,27/06/2010,0,0,0,0,3,0,0,3
Somalia,28/06/2010,0,0,0,0,6,0,0,6
Somalia,29/06/2010,18,0,0,0,34,3,0,55
Somalia,30/06/2010,3,0,0,0,8,0,0,11
Syria,01/06/2010,6,0,0,0,-4,0,0,2
Syria,02/06/2010,17,0,0,0,7,0,0,24
Syria,03/06/2010,14,0,1,0,10,0,0,25
Syria,04/06/2010,6,0,0,0,0,0,0,6
Syria,05/06/2010,2,0,0,0,0,4,0,6
Syria,06/06/2010,12,0,0,0,24,6,0,42
Syria,07/06/2010,20,0,0,0,0,0,0,20
Syria,08/06/2010,20,0,0,0,5,4,0,29
Syria,09/06/2010,9,0,0,0,4,0,0,13
Syria,10/06/2010,-2,0,0,0,0,0,0,-2
Syria,11/06/2010,-4,0,0,0,3,0,0,-1
Syria,12/06/2010,-5,0,0,0,0,0,0,-5
Syria,13/06/2010,-2,0,0,0,0,0,0,-2
Syria,14/06/2010,10,0,0,0,9,0,0,19
Syria,15/06/2010,0,0,0,0,-4,0,0,-4
Syria,16/06/2010,6,0,0,0,3,0,0,9
Syria,17/06/2010,16,0,0,0,45,0,0,61
Syria,18/06/2010,6,0,0,0,0,2,0,8
Syria,19/06/2010,10,0,0,0,3,2,0,15
Syria,20/06/2010,8,0,0,0,3,0,0,11
Syria,21/06/2010,18,0,0,0,-1,0,0,17
Syria,22/06/2010,7,0,0,0,9,0,0,16
Syria,23/06/2010,13,0,0,0,3,0,0,16
Syria,24/06/2010,2,0,0,0,-2,0,0,0
Syria,25/06/2010,0,0,0,0,0,0,0,0
Syria,26/06/2010,0,0,0,0,0,0,0,0
Syria,27/06/2010,0,0,0,0,0,0,0,0
Syria,28/06/2010,9,0,0,0,-4,0,0,5
Syria,29/06/2010,15,0,0,0,0,1,0,16
Syria,30/06/2010,-2,2,0,0,0,0,0,0
Yemen,01/06/2010,8,0,0,0,22,0,0,30
Yemen,02/06/2010,17,0,0,0,26,0,0,43
Yemen,03/06/2010,29,0,0,0,16,4,0,49
Yemen,04/06/2010,0,0,0,0,9,0,0,9
Yemen,05/06/2010,2,0,0,0,3,0,0,5
Yemen,06/06/2010,8,0,0,0,0,0,0,8
Yemen,07/06/2010,33,0,0,0,55,5,0,93
Yemen,08/06/2010,38,0,0,0,55,5,0,98
Yemen,09/06/2010,12,0,1,0,3,0,0,16
Yemen,10/06/2010,0,0,0,0,0,0,0,0
Yemen,11/06/2010,0,0,0,0,27,0,0,27
Yemen,13/06/2010,0,0,0,0,0,0,0,0
Yemen,14/06/2010,13,0,0,0,-5,0,0,8
Yemen,15/06/2010,0,0,0,0,6,0,0,6
Yemen,16/06/2010,14,0,0,0,3,0,0,17
Yemen,17/06/2010,0,0,0,0,9,0,0,9
Yemen,18/06/2010,0,0,0,0,0,0,0,0
Yemen,19/06/2010,116,0,0,0,-1,14,0,129
Yemen,20/06/2010,58,0,0,0,12,12,0,82
Yemen,21/06/2010,18,0,0,0,6,6,0,30
Yemen,22/06/2010,-1,0,0,0,37,0,0,36
Yemen,23/06/2010,5,0,0,0,0,0,0,5
Yemen,24/06/2010,-2,0,0,0,3,0,0,1
Yemen,25/06/2010,33,0,0,0,12,0,0,45
Yemen,26/06/2010,25,0,0,0,2,1,0,28
Yemen,27/06/2010,5,0,0,0,1,0,0,6
Yemen,28/06/2010,4,0,0,0,0,0,0,4
Yemen,29/06/2010,3,0,0,0,5,4,0,12
Yemen,30/06/2010,0,0,0,0,-3,7,0,4
Afghanistan,01/10/2012,298,0,0,0,28,106,0,432
Afghanistan,02/10/2012,193,0,0,0,34,8,0,235
Afghanistan,03/10/2012,147,2,1,0,-14,3,0,139
Afghanistan,04/10/2012,141,0,0,0,26,8,0,175
Afghanistan,05/10/2012,108,4,-8,0,52,14,0,170
Afghanistan,06/10/2012,227,2,0,0,140,30,0,399
Afghanistan,07/10/2012,131,0,-3,0,31,12,0,171
Afghanistan,08/10/2012,151,0,2,0,-3,14,0,164
Afghanistan,09/10/2012,217,0,-3,0,46,19,0,279
Afghanistan,10/10/2012,222,2,0,0,53,15,0,292
Afghanistan,11/10/2012,341,2,-1,0,121,16,0,479
Afghanistan,12/10/2012,267,2,-4,0,60,20,0,345
Afghanistan,13/10/2012,158,0,0,0,41,44,0,243
Afghanistan,14/10/2012,146,0,3,0,75,3,0,227
Afghanistan,15/10/2012,232,0,3,0,59,15,0,309
Afghanistan,16/10/2012,152,0,1,0,104,19,0,276
Afghanistan,17/10/2012,279,2,0,0,45,23,0,349
Afghanistan,18/10/2012,130,4,0,0,24,31,0,189
Afghanistan,19/10/2012,134,0,0,0,6,22,0,162
Afghanistan,20/10/2012,205,6,0,0,20,2,0,233
Afghanistan,21/10/2012,115,0,0,0,31,5,0,151
Afghanistan,22/10/2012,118,2,0,0,43,7,0,170
Afghanistan,23/10/2012,183,6,1,0,16,11,0,217
Afghanistan,24/10/2012,128,2,1,0,43,5,0,179
Afghanistan,25/10/2012,129,4,-1,0,33,10,0,175
Afghanistan,26/10/2012,137,4,1,0,6,29,0,177
Afghanistan,27/10/2012,106,2,1,0,18,22,0,149
Afghanistan,28/10/2012,84,0,-2,0,21,11,0,114
Afghanistan,29/10/2012,82,2,0,0,0,9,0,93
Afghanistan,30/10/2012,143,2,0,0,41,1,0,187
Afghanistan,31/10/2012,107,0,-3,0,28,12,0,144
Albania,01/10/2012,-4,0,0,0,0,0,0,-4
Albania,02/10/2012,-2,0,0,0,0,0,0,-2
Albania,03/10/2012,9,0,0,0,0,0,0,9
Albania,04/10/2012,6,0,0,0,0,0,0,6
Albania,05/10/2012,7,0,1,0,3,1,0,12
Albania,06/10/2012,9,0,0,0,0,3,0,12
Albania,07/10/2012,-1,0,0,0,0,0,0,-1
Albania,08/10/2012,2,0,0,0,6,0,0,8
Albania,09/10/2012,-1,0,0,0,0,0,0,-1
Albania,10/10/2012,24,0,0,0,3,3,0,30
Albania,11/10/2012,3,0,-1,0,5,0,0,7
Albania,12/10/2012,5,0,0,0,0,0,0,5
Albania,13/10/2012,4,0,0,0,0,0,0,4
Albania,14/10/2012,3,0,0,0,0,0,0,3
Albania,15/10/2012,21,0,0,0,0,0,0,21
Albania,16/10/2012,22,0,0,0,6,0,0,28
Albania,17/10/2012,13,0,0,0,3,0,0,16
Albania,18/10/2012,6,0,0,0,6,0,0,12
Albania,19/10/2012,3,0,-1,0,0,1,0,3
Albania,20/10/2012,-2,0,0,0,0,0,0,-2
Albania,21/10/2012,0,0,0,0,0,0,0,0
Albania,22/10/2012,10,0,0,0,-2,5,0,13
Albania,23/10/2012,0,0,0,0,3,0,0,3
Albania,24/10/2012,2,0,-1,0,-2,0,0,-1
Albania,25/10/2012,8,0,0,0,3,1,0,12
Albania,26/10/2012,0,0,0,0,3,0,0,3
Albania,27/10/2012,0,0,0,0,0,0,0,0
Albania,28/10/2012,0,0,0,0,0,0,0,0
Albania,29/10/2012,3,0,0,0,0,0,0,3
Albania,30/10/2012,7,0,0,0,0,0,0,7
Albania,31/10/2012,13,0,-2,0,9,1,0,21
Algeria,01/10/2012,12,0,0,0,12,0,0,24
Algeria,02/10/2012,686,6,-17,0,204,100,0,979
Algeria,03/10/2012,3,0,0,0,0,2,0,5
Algeria,04/10/2012,4,0,0,0,0,0,0,4
Algeria,05/10/2012,11,0,0,0,0,0,0,11
Algeria,06/10/2012,10,0,0,0,0,0,0,10
Algeria,07/10/2012,1,0,0,0,21,0,0,22
Algeria,08/10/2012,8,0,0,0,6,0,0,14
Algeria,09/10/2012,3,0,-6,0,0,0,0,-3
Algeria,10/10/2012,-1,0,0,0,0,0,0,-1
Algeria,11/10/2012,3,2,0,0,3,2,0,10
Algeria,12/10/2012,0,0,0,0,0,0,0,0
Algeria,13/10/2012,9,0,0,0,0,0,0,9
Algeria,14/10/2012,42,0,0,0,4,0,0,46
Algeria,15/10/2012,13,0,0,0,9,0,0,22
Algeria,16/10/2012,6,0,0,0,9,0,0,15
Algeria,17/10/2012,34,0,0,0,3,1,0,38
Algeria,18/10/2012,0,0,0,0,3,0,0,3
Algeria,19/10/2012,20,0,0,0,-1,2,0,21
Algeria,20/10/2012,4,0,0,0,3,0,0,7
Algeria,21/10/2012,12,0,2,0,6,1,0,21
Algeria,22/10/2012,9,2,0,0,3,0,0,14
Algeria,23/10/2012,5,2,0,0,0,1,0,8
Algeria,24/10/2012,9,0,0,0,38,3,0,50
Algeria,25/10/2012,20,0,0,0,31,1,0,52
Algeria,26/10/2012,-1,0,0,0,0,0,0,-1
Algeria,27/10/2012,5,0,0,0,0,1,0,6
Algeria,28/10/2012,15,0,0,0,0,1,0,16
Algeria,29/10/2012,17,0,0,0,3,0,0,20
Algeria,30/10/2012,5,0,0,0,6,1,0,12
Algeria,31/10/2012,5,0,0,0,-2,0,0,3
Bangladesh,01/10/2012,65,0,-6,0,20,8,0,87
Bangladesh,02/10/2012,29,0,-2,0,4,2,0,33
Bangladesh,03/10/2012,59,0,0,0,13,14,0,86
Bangladesh,04/10/2012,31,0,0,0,28,10,0,69
Bangladesh,05/10/2012,32,0,0,0,9,23,0,64
Bangladesh,06/10/2012,30,0,0,0,7,7,0,44
Bangladesh,07/10/2012,19,0,4,0,8,0,0,31
Bangladesh,08/10/2012,14,0,0,0,29,9,0,52
Bangladesh,09/10/2012,11,0,0,0,28,16,0,55
Bangladesh,10/10/2012,20,0,0,0,12,12,0,44
Bangladesh,11/10/2012,4,0,0,0,10,7,0,21
Bangladesh,12/10/2012,46,0,1,0,7,5,0,59
Bangladesh,13/10/2012,17,0,-2,0,21,13,0,49
Bangladesh,14/10/2012,20,0,0,0,2,0,0,22
Bangladesh,15/10/2012,60,0,-1,0,22,13,0,94
Bangladesh,16/10/2012,29,0,0,0,21,1,0,51
Bangladesh,17/10/2012,63,0,1,0,24,4,0,92
Bangladesh,18/10/2012,24,0,0,0,57,7,0,88
Bangladesh,19/10/2012,30,0,0,0,57,17,0,104
Bangladesh,20/10/2012,20,2,0,0,46,9,0,77
Bangladesh,21/10/2012,9,0,-4,0,30,2,0,37
Bangladesh,22/10/2012,32,0,1,0,19,5,0,57
Bangladesh,23/10/2012,67,0,3,0,18,5,0,93
Bangladesh,24/10/2012,36,0,0,0,11,7,0,54
Bangladesh,25/10/2012,98,0,0,0,6,7,0,111
Bangladesh,26/10/2012,152,0,0,0,36,13,0,201
Bangladesh,27/10/2012,88,0,0,0,-1,16,0,103
Bangladesh,28/10/2012,87,0,0,0,3,5,0,95
Bangladesh,29/10/2012,83,0,-2,0,8,9,0,98
Bangladesh,30/10/2012,62,0,-1,0,31,6,0,98
Bangladesh,31/10/2012,83,0,0,0,11,3,0,97
Cameroon,01/10/2012,0,0,0,0,0,0,0,0
Cameroon,02/10/2012,0,0,0,0,0,0,0,0
Cameroon,03/10/2012,7,0,0,0,0,0,0,7
Cameroon,04/10/2012,0,0,0,0,0,0,0,0
Cameroon,05/10/2012,0,0,0,0,0,0,0,0
Cameroon,06/10/2012,0,0,0,0,0,0,0,0
Cameroon,08/10/2012,0,0,0,0,0,0,0,0
Cameroon,09/10/2012,3,0,0,0,0,0,0,3
Cameroon,10/10/2012,5,0,0,0,0,0,0,5
Cameroon,12/10/2012,1,0,0,0,0,0,0,1
Cameroon,13/10/2012,0,0,0,0,0,0,0,0
Cameroon,14/10/2012,0,0,0,0,0,0,0,0
Cameroon,15/10/2012,2,0,0,0,0,0,0,2
Cameroon,17/10/2012,0,0,0,0,0,0,0,0
Cameroon,18/10/2012,0,0,0,0,0,0,0,0
Cameroon,19/10/2012,5,0,0,0,0,0,0,5
Cameroon,20/10/2012,0,0,0,0,3,0,0,3
Cameroon,21/10/2012,0,0,0,0,0,0,0,0
Cameroon,22/10/2012,-1,0,0,0,3,0,0,2
Cameroon,23/10/2012,0,0,0,0,0,0,0,0
Cameroon,24/10/2012,23,0,0,0,15,0,0,38
Cameroon,25/10/2012,3,0,0,0,3,0,0,6
Cameroon,26/10/2012,0,0,0,0,6,0,0,6
Cameroon,27/10/2012,0,0,0,0,0,0,0,0
Cameroon,29/10/2012,0,0,0,0,0,0,0,0
Cameroon,30/10/2012,-6,0,0,0,0,0,0,-6
Cameroon,31/10/2012,2,0,0,0,-2,0,0,0
China,01/10/2012,161,0,-2,0,51,25,0,235
China,02/10/2012,179,0,-2,0,77,22,0,276
China,03/10/2012,159,0,-11,0,44,19,0,211
China,04/10/2012,174,0,1,0,79,27,0,281
China,05/10/2012,121,2,-5,0,68,12,0,198
China,06/10/2012,64,2,-3,0,9,18,0,90
China,07/10/2012,63,4,0,0,56,15,0,138
China,08/10/2012,992,4,-3,0,281,97,0,1371
China,09/10/2012,186,4,-2,0,81,29,0,298
China,10/10/2012,178,0,0,0,31,17,0,226
China,11/10/2012,185,0,-5,0,68,21,0,269
China,12/10/2012,141,0,5,0,62,11,0,219
China,13/10/2012,67,0,1,0,60,8,0,136
China,14/10/2012,65,0,-10,0,23,6,0,84
China,15/10/2012,128,10,1,0,91,15,0,245
China,16/10/2012,343,6,0,0,54,11,0,414
China,17/10/2012,259,2,-4,0,82,28,0,367
China,18/10/2012,165,6,-1,0,45,21,0,236
China,19/10/2012,158,2,-4,0,59,13,0,228
China,20/10/2012,122,4,3,0,30,8,0,167
China,21/10/2012,112,0,-6,0,27,16,0,149
China,22/10/2012,253,4,-8,0,24,13,0,286
China,23/10/2012,172,2,-6,0,44,16,0,228
China,24/10/2012,171,0,-7,0,132,23,0,319
China,25/10/2012,132,0,0,0,78,20,0,230
China,26/10/2012,149,2,-3,0,67,31,0,246
China,27/10/2012,78,0,-2,0,30,9,0,115
China,28/10/2012,116,4,-1,0,29,20,0,168
China,29/10/2012,192,2,-6,0,90,30,0,308
China,30/10/2012,171,0,1,0,78,24,0,274
China,31/10/2012,149,2,1,0,27,7,0,186
Egypt,01/10/2012,54,0,0,0,32,9,0,95
Egypt,02/10/2012,81,0,-5,0,20,11,0,107
Egypt,03/10/2012,70,0,1,0,24,8,0,103
Egypt,04/10/2012,99,0,3,0,119,14,0,235
Egypt,05/10/2012,163,0,4,0,60,24,0,251
Egypt,06/10/2012,39,0,-2,0,89,6,0,132
Egypt,07/10/2012,32,0,-2,0,48,10,0,88
Egypt,08/10/2012,111,2,1,0,40,25,0,179
Egypt,09/10/2012,58,2,1,0,86,17,0,164
Egypt,10/10/2012,70,0,3,0,40,24,0,137
Egypt,11/10/2012,63,4,-3,0,14,17,0,95
Egypt,12/10/2012,95,6,2,0,59,25,0,187
Egypt,13/10/2012,104,0,0,0,24,20,0,148
Egypt,14/10/2012,98,0,-2,0,20,14,0,130
Egypt,15/10/2012,124,0,-2,0,61,33,0,216
Egypt,16/10/2012,65,0,-2,0,31,18,0,112
Egypt,17/10/2012,47,0,-9,0,15,8,0,61
Egypt,18/10/2012,38,0,1,0,11,25,0,75
Egypt,19/10/2012,33,0,-6,0,8,16,0,51
Egypt,20/10/2012,42,0,0,0,23,14,0,79
Egypt,21/10/2012,43,0,1,0,8,12,0,64
Egypt,22/10/2012,140,0,-1,0,37,10,0,186
Egypt,23/10/2012,129,4,-5,0,9,10,0,147
Egypt,24/10/2012,162,0,0,0,20,18,0,200
Egypt,25/10/2012,201,0,2,0,8,25,0,236
Egypt,26/10/2012,40,0,0,0,16,9,0,65
Egypt,27/10/2012,57,0,-1,0,-1,12,0,67
Egypt,28/10/2012,90,0,0,0,-2,14,0,102
Egypt,29/10/2012,23,0,-1,0,5,8,0,35
Egypt,30/10/2012,31,8,0,0,0,8,0,47
Egypt,31/10/2012,22,0,0,0,15,6,0,43
Eritrea,01/10/2012,0,0,0,0,0,0,0,0
Eritrea,02/10/2012,3,0,0,0,0,0,0,3
Eritrea,05/10/2012,0,0,0,0,9,0,0,9
Eritrea,07/10/2012,0,0,0,0,9,0,0,9
Eritrea,08/10/2012,1,0,0,0,0,0,0,1
Eritrea,09/10/2012,1,0,0,0,-5,0,0,-4
Eritrea,10/10/2012,0,0,0,0,3,0,0,3
Eritrea,11/10/2012,0,0,0,0,6,0,0,6
Eritrea,12/10/2012,0,0,0,0,-1,0,0,-1
Eritrea,15/10/2012,0,0,0,0,0,7,0,7
Eritrea,16/10/2012,0,0,0,0,3,7,0,10
Eritrea,17/10/2012,0,0,0,0,0,0,0,0
Eritrea,18/10/2012,2,0,0,0,12,3,0,17
Eritrea,19/10/2012,0,0,0,0,6,0,0,6
Eritrea,20/10/2012,0,0,0,0,0,0,0,0
Eritrea,23/10/2012,0,0,0,0,0,0,0,0
Eritrea,24/10/2012,14,0,0,0,3,0,0,17
Eritrea,25/10/2012,3,2,0,0,0,0,0,5
Eritrea,26/10/2012,2,0,0,0,0,0,0,2
Eritrea,27/10/2012,0,0,0,0,0,0,0,0
Eritrea,28/10/2012,0,0,0,0,-2,0,0,-2
Eritrea,29/10/2012,0,0,0,0,-2,0,0,-2
Eritrea,31/10/2012,0,0,0,0,8,0,0,8
Georgia,01/10/2012,0,0,0,0,0,0,0,0
Georgia,02/10/2012,4,0,-2,0,0,0,0,2
Georgia,03/10/2012,0,0,0,0,0,0,0,0
Georgia,04/10/2012,1,0,0,0,0,0,0,1
Georgia,05/10/2012,0,0,0,0,0,0,0,0
Georgia,06/10/2012,1,0,0,0,0,0,0,1
Georgia,07/10/2012,6,0,0,0,0,0,0,6
Georgia,08/10/2012,2,0,0,0,0,1,0,3
Georgia,09/10/2012,0,2,0,0,0,0,0,2
Georgia,10/10/2012,3,0,0,0,0,0,0,3
Georgia,11/10/2012,-1,0,-4,0,-1,0,0,-6
Georgia,13/10/2012,2,0,0,0,0,0,0,2
Georgia,14/10/2012,0,0,0,0,0,0,0,0
Georgia,15/10/2012,0,2,0,0,0,1,0,3
Georgia,17/10/2012,0,0,0,0,0,1,0,1
Georgia,18/10/2012,2,0,0,0,0,1,0,3
Georgia,19/10/2012,0,0,0,0,0,0,0,0
Georgia,20/10/2012,1,0,0,0,0,0,0,1
Georgia,21/10/2012,0,0,0,0,3,0,0,3
Georgia,22/10/2012,0,0,0,0,0,0,0,0
Georgia,23/10/2012,0,0,0,0,0,0,0,0
Georgia,24/10/2012,0,0,0,0,0,0,0,0
Georgia,25/10/2012,0,2,0,0,3,0,0,5
Georgia,26/10/2012,-3,2,0,0,3,0,0,2
Georgia,27/10/2012,0,0,0,0,0,0,0,0
Georgia,28/10/2012,0,0,0,0,0,0,0,0
Georgia,29/10/2012,2,0,0,0,0,1,0,3
Georgia,30/10/2012,0,0,0,0,0,1,0,1
Georgia,31/10/2012,2,2,0,0,0,0,0,4
India,01/10/2012,79,2,1,0,13,7,0,102
India,02/10/2012,82,0,-1,0,9,15,0,105
India,03/10/2012,45,0,-5,0,10,7,0,57
India,04/10/2012,80,2,-2,0,16,10,0,106
India,05/10/2012,76,4,0,0,31,11,0,122
India,06/10/2012,45,0,0,0,22,11,0,78
India,07/10/2012,62,2,1,0,13,12,0,90
India,08/10/2012,56,4,-8,0,11,11,0,74
India,09/10/2012,65,2,-3,0,25,9,0,98
India,10/10/2012,23,0,2,0,-8,1,0,18
India,11/10/2012,22,0,1,0,9,1,0,33
India,12/10/2012,95,6,-8,0,23,17,0,133
India,13/10/2012,51,0,-4,0,3,6,0,56
India,14/10/2012,52,0,-5,0,20,15,0,82
India,15/10/2012,91,0,-1,0,9,19,0,118
India,16/10/2012,94,2,-24,0,4,6,0,82
India,17/10/2012,46,0,-10,0,24,8,0,68
India,18/10/2012,62,2,0,0,30,8,0,102
India,19/10/2012,117,0,0,0,8,15,0,140
India,20/10/2012,87,0,-2,0,11,22,0,118
India,21/10/2012,26,0,-1,0,1,12,0,38
India,22/10/2012,91,0,-7,0,44,24,0,152
India,23/10/2012,65,0,-7,0,23,8,0,89
India,24/10/2012,62,0,0,0,34,19,0,115
India,25/10/2012,43,0,0,0,40,11,0,94
India,26/10/2012,103,2,-16,0,51,19,0,159
India,27/10/2012,32,2,-14,0,2,4,0,26
India,28/10/2012,63,2,-1,0,7,12,0,83
India,29/10/2012,69,2,-1,0,27,18,0,115
India,30/10/2012,78,0,1,0,11,6,0,96
India,31/10/2012,63,0,-1,0,10,3,0,75
Iran,01/10/2012,209,0,-1,0,127,86,0,421
Iran,02/10/2012,301,2,4,0,160,31,0,498
Iran,03/10/2012,131,6,-3,0,41,36,0,211
Iran,04/10/2012,129,2,1,0,30,10,0,172
Iran,05/10/2012,103,0,-1,0,13,7,0,122
Iran,06/10/2012,74,2,1,0,29,3,0,109
Iran,07/10/2012,138,0,-2,0,46,4,0,186
Iran,08/10/2012,140,6,0,0,38,15,0,199
Iran,09/10/2012,142,4,10,0,30,18,0,204
Iran,10/10/2012,97,2,2,0,29,16,0,146
Iran,11/10/2012,245,4,2,0,9,22,0,282
Iran,12/10/2012,199,0,0,0,38,21,0,258
Iran,13/10/2012,57,0,3,0,26,5,0,91
Iran,14/10/2012,66,4,1,0,7,22,0,100
Iran,15/10/2012,114,0,4,0,46,10,0,174
Iran,16/10/2012,103,10,3,0,23,2,0,141
Iran,17/10/2012,174,4,2,0,57,4,0,241
Iran,18/10/2012,98,6,4,0,55,8,0,171
Iran,19/10/2012,84,0,3,0,38,18,0,143
Iran,20/10/2012,108,0,3,0,49,7,0,167
Iran,21/10/2012,178,0,5,0,18,9,0,210
Iran,22/10/2012,921,4,-10,0,403,84,0,1402
Iran,23/10/2012,162,6,-1,0,36,28,0,231
Iran,24/10/2012,138,2,1,0,9,7,0,157
Iran,25/10/2012,88,0,2,0,37,13,0,140
Iran,26/10/2012,69,0,-1,0,53,16,0,137
Iran,27/10/2012,142,0,0,0,30,15,0,187
Iran,28/10/2012,109,0,1,0,22,8,0,140
Iran,29/10/2012,126,2,1,0,4,17,0,150
Iran,30/10/2012,111,0,-5,0,25,24,0,155
Iran,31/10/2012,115,0,-5,0,46,27,0,183
Iraq,01/10/2012,145,0,0,0,21,27,0,193
Iraq,02/10/2012,110,0,-6,0,17,18,0,139
Iraq,03/10/2012,111,4,-1,0,33,9,0,156
Iraq,04/10/2012,195,4,0,0,32,11,0,242
Iraq,05/10/2012,92,2,0,0,3,9,0,106
Iraq,06/10/2012,44,0,0,0,0,6,0,50
Iraq,07/10/2012,32,0,-1,0,-2,4,0,33
Iraq,08/10/2012,64,2,0,0,16,3,0,85
Iraq,09/10/2012,66,2,0,0,28,8,0,104
Iraq,10/10/2012,57,2,-1,0,31,1,0,90
Iraq,11/10/2012,80,0,0,0,33,3,0,116
Iraq,12/10/2012,129,0,0,0,59,6,0,194
Iraq,13/10/2012,60,0,0,0,23,4,0,87
Iraq,14/10/2012,77,0,0,0,40,2,0,119
Iraq,15/10/2012,69,0,1,0,23,8,0,101
Iraq,16/10/2012,134,0,2,0,-1,10,0,145
Iraq,17/10/2012,89,2,-2,0,12,6,0,107
Iraq,18/10/2012,126,0,4,0,19,8,0,157
Iraq,19/10/2012,93,0,1,0,78,14,0,186
Iraq,20/10/2012,62,0,0,0,17,3,0,82
Iraq,21/10/2012,146,0,0,0,31,17,0,194
Iraq,22/10/2012,126,2,0,0,31,9,0,168
Iraq,23/10/2012,99,0,0,0,46,23,0,168
Iraq,24/10/2012,103,0,-1,0,40,2,0,144
Iraq,25/10/2012,96,0,0,0,31,5,0,132
Iraq,26/10/2012,48,0,0,0,10,20,0,78
Iraq,27/10/2012,70,0,0,0,-3,0,0,67
Iraq,28/10/2012,32,0,0,0,19,1,0,52
Iraq,29/10/2012,62,0,-1,0,7,6,0,74
Iraq,30/10/2012,108,0,-1,0,15,0,0,122
Iraq,31/10/2012,81,0,-2,0,46,3,0,128
Morocco,01/10/2012,11,0,0,0,-6,4,0,9
Morocco,02/10/2012,24,0,0,0,-2,4,0,26
Morocco,03/10/2012,0,0,1,0,15,4,0,20
Morocco,04/10/2012,42,0,1,0,19,9,0,71
Morocco,05/10/2012,479,2,-9,0,150,95,0,717
Morocco,06/10/2012,4,0,0,0,3,2,0,9
Morocco,07/10/2012,0,0,0,0,12,0,0,12
Morocco,08/10/2012,9,0,0,0,5,0,0,14
Morocco,09/10/2012,6,0,0,0,6,2,0,14
Morocco,10/10/2012,-1,0,0,0,9,2,0,10
Morocco,11/10/2012,-3,0,0,0,0,0,0,-3
Morocco,12/10/2012,1,0,0,0,0,0,0,1
Morocco,13/10/2012,1,0,0,0,7,0,0,8
Morocco,14/10/2012,2,0,0,0,-2,0,0,0
Morocco,15/10/2012,-1,0,0,0,4,2,0,5
Morocco,16/10/2012,2,0,0,0,3,0,0,5
Morocco,17/10/2012,4,0,0,0,12,1,0,17
Morocco,18/10/2012,8,0,0,0,4,4,0,16
Morocco,19/10/2012,11,2,0,0,-10,1,0,4
Morocco,20/10/2012,2,0,0,0,9,0,0,11
Morocco,21/10/2012,-1,0,0,0,0,0,0,-1
Morocco,22/10/2012,5,0,0,0,0,0,0,5
Morocco,23/10/2012,13,0,0,0,13,0,0,26
Morocco,24/10/2012,9,0,0,0,3,1,0,13
Morocco,25/10/2012,11,0,0,0,9,0,0,20
Morocco,26/10/2012,9,0,0,0,15,0,0,24
Morocco,27/10/2012,0,0,0,0,21,1,0,22
Morocco,28/10/2012,3,0,0,0,13,0,0,16
Morocco,29/10/2012,8,0,0,0,6,0,0,14
Morocco,30/10/2012,1,0,0,0,1,1,0,3
Morocco,31/10/2012,2,0,0,0,0,0,0,2
Nigeria,01/10/2012,54,0,1,0,23,9,0,87
Nigeria,02/10/2012,66,2,1,0,18,1,0,88
Nigeria,03/10/2012,80,0,2,0,14,11,0,107
Nigeria,04/10/2012,58,0,1,0,3,21,0,83
Nigeria,05/10/2012,40,0,1,0,22,6,0,69
Nigeria,06/10/2012,10,2,0,0,5,1,0,18
Nigeria,07/10/2012,18,0,0,0,14,3,0,35
Nigeria,08/10/2012,16,0,0,0,-1,2,0,17
Nigeria,09/10/2012,17,0,0,0,7,1,0,25
Nigeria,10/10/2012,31,0,0,0,21,3,0,55
Nigeria,11/10/2012,68,0,0,0,23,0,0,91
Nigeria,12/10/2012,22,2,1,0,4,0,0,29
Nigeria,13/10/2012,23,0,0,0,3,1,0,27
Nigeria,14/10/2012,37,0,2,0,6,0,0,45
Nigeria,15/10/2012,29,0,-4,0,40,10,0,75
Nigeria,16/10/2012,22,0,0,0,10,4,0,36
Nigeria,17/10/2012,39,0,1,0,13,7,0,60
Nigeria,18/10/2012,57,0,1,0,3,13,0,74
Nigeria,19/10/2012,16,0,0,0,3,1,0,20
Nigeria,20/10/2012,16,0,1,0,20,1,0,38
Nigeria,21/10/2012,16,0,0,0,11,3,0,30
Nigeria,22/10/2012,43,0,0,0,6,3,0,52
Nigeria,23/10/2012,14,0,-1,0,24,1,0,38
Nigeria,24/10/2012,37,0,0,0,22,-1,0,58
Nigeria,25/10/2012,29,0,0,0,12,2,0,43
Nigeria,26/10/2012,13,0,2,0,21,2,0,38
Nigeria,27/10/2012,0,0,0,0,15,5,0,20
Nigeria,28/10/2012,16,0,0,0,33,1,0,50
Nigeria,29/10/2012,21,0,0,0,14,8,0,43
Nigeria,30/10/2012,27,0,-1,0,15,0,0,41
Nigeria,31/10/2012,33,0,0,0,16,2,0,51
Pakistan,01/10/2012,130,0,0,0,36,21,0,187
Pakistan,02/10/2012,96,0,0,0,-1,4,0,99
Pakistan,03/10/2012,84,0,0,0,23,5,0,112
Pakistan,04/10/2012,101,0,0,0,23,15,0,139
Pakistan,05/10/2012,103,0,0,0,22,13,0,138
Pakistan,06/10/2012,82,0,-6,0,14,6,0,96
Pakistan,07/10/2012,38,0,0,0,6,6,0,50
Pakistan,08/10/2012,52,0,0,0,0,2,0,54
Pakistan,09/10/2012,119,0,2,0,20,17,0,158
Pakistan,10/10/2012,129,0,3,0,20,8,0,160
Pakistan,11/10/2012,179,0,3,0,28,22,0,232
Pakistan,12/10/2012,154,0,1,0,74,9,0,238
Pakistan,13/10/2012,153,2,0,0,15,27,0,197
Pakistan,14/10/2012,65,0,1,0,14,5,0,85
Pakistan,15/10/2012,173,8,-1,0,44,14,0,238
Pakistan,16/10/2012,293,0,0,0,25,12,0,330
Pakistan,17/10/2012,143,0,3,0,33,11,0,190
Pakistan,18/10/2012,98,0,1,0,58,3,0,160
Pakistan,19/10/2012,201,0,2,0,16,20,0,239
Pakistan,20/10/2012,153,0,0,0,21,19,0,193
Pakistan,21/10/2012,103,0,0,0,12,30,0,145
Pakistan,22/10/2012,212,2,0,0,52,7,0,273
Pakistan,23/10/2012,151,2,0,0,39,18,0,210
Pakistan,24/10/2012,138,0,-2,0,53,3,0,192
Pakistan,25/10/2012,84,0,0,0,17,5,0,106
Pakistan,26/10/2012,160,0,-8,0,7,5,0,164
Pakistan,27/10/2012,56,0,0,0,0,5,0,61
Pakistan,28/10/2012,93,0,-2,0,3,0,0,94
Pakistan,29/10/2012,97,0,0,0,7,9,0,113
Pakistan,30/10/2012,70,0,-4,0,19,6,0,91
Pakistan,31/10/2012,79,2,-1,0,25,9,0,114
Sierra Leone,01/10/2012,5,0,0,0,0,2,0,7
Sierra Leone,02/10/2012,1,0,0,0,0,0,0,1
Sierra Leone,03/10/2012,1,0,0,0,3,0,0,4
Sierra Leone,04/10/2012,2,0,0,0,0,0,0,2
Sierra Leone,05/10/2012,3,0,0,0,0,0,0,3
Sierra Leone,06/10/2012,3,0,0,0,0,0,0,3
Sierra Leone,07/10/2012,2,0,0,0,0,0,0,2
Sierra Leone,08/10/2012,-1,0,0,0,12,0,0,11
Sierra Leone,09/10/2012,4,0,0,0,1,0,0,5
Sierra Leone,10/10/2012,11,0,0,0,0,0,0,11
Sierra Leone,11/10/2012,4,0,0,0,0,0,0,4
Sierra Leone,12/10/2012,-2,0,0,0,9,0,0,7
Sierra Leone,13/10/2012,7,0,0,0,9,0,0,16
Sierra Leone,15/10/2012,1,0,0,0,0,1,0,2
Sierra Leone,16/10/2012,0,0,0,0,0,0,0,0
Sierra Leone,17/10/2012,3,0,0,0,0,0,0,3
Sierra Leone,18/10/2012,-1,0,0,0,3,0,0,2
Sierra Leone,19/10/2012,9,0,0,0,3,0,0,12
Sierra Leone,20/10/2012,1,0,0,0,0,0,0,1
Sierra Leone,21/10/2012,0,0,0,0,3,0,0,3
Sierra Leone,22/10/2012,0,0,0,0,0,0,0,0
Sierra Leone,23/10/2012,0,0,0,0,0,0,0,0
Sierra Leone,24/10/2012,11,0,0,0,6,0,0,17
Sierra Leone,26/10/2012,0,0,0,0,0,0,0,0
Sierra Leone,29/10/2012,0,0,0,0,0,0,0,0
Sierra Leone,30/10/2012,7,0,0,0,0,1,0,8
Sierra Leone,31/10/2012,2,0,0,0,0,1,0,3
Somalia,01/10/2012,150,0,0,0,32,27,0,209
Somalia,02/10/2012,116,0,3,0,18,4,0,141
Somalia,03/10/2012,38,2,0,0,25,15,0,80
Somalia,04/10/2012,44,0,2,0,43,3,0,92
Somalia,05/10/2012,45,0,0,0,62,2,0,109
Somalia,06/10/2012,36,0,0,0,22,1,0,59
Somalia,07/10/2012,62,0,0,0,7,1,0,70
Somalia,08/10/2012,49,0,0,0,51,4,0,104
Somalia,09/10/2012,64,0,-2,0,52,17,0,131
Somalia,10/10/2012,59,2,0,0,54,6,0,121
Somalia,11/10/2012,51,0,0,0,42,8,0,101
Somalia,12/10/2012,60,1,1,0,25,11,0,98
Somalia,13/10/2012,27,0,-2,0,18,7,0,50
Somalia,14/10/2012,41,0,0,0,16,1,0,58
Somalia,15/10/2012,83,0,0,0,31,5,0,119
Somalia,16/10/2012,76,0,0,0,33,8,0,117
Somalia,17/10/2012,117,0,0,0,50,13,0,180
Somalia,18/10/2012,71,0,1,0,76,8,0,156
Somalia,19/10/2012,74,4,-1,0,60,19,0,156
Somalia,20/10/2012,69,4,1,0,53,10,0,137
Somalia,21/10/2012,72,0,-6,0,7,7,0,80
Somalia,22/10/2012,115,0,-10,0,12,19,0,136
Somalia,23/10/2012,63,0,1,0,17,12,0,93
Somalia,24/10/2012,90,0,0,0,29,4,0,123
Somalia,25/10/2012,89,0,-4,0,36,6,0,127
Somalia,26/10/2012,78,4,0,0,7,10,0,99
Somalia,27/10/2012,52,0,0,0,21,7,0,80
Somalia,28/10/2012,60,0,0,0,18,13,0,91
Somalia,29/10/2012,85,0,1,0,15,5,0,106
Somalia,30/10/2012,66,0,1,0,25,3,0,95
Somalia,31/10/2012,83,0,4,0,36,12,0,135
Syria,01/10/2012,208,0,-33,0,18,32,0,225
Syria,02/10/2012,308,2,-4,0,96,24,0,426
Syria,03/10/2012,452,0,-3,0,55,20,0,524
Syria,04/10/2012,723,0,-2,0,41,34,0,796
Syria,05/10/2012,459,2,-3,0,6,35,0,499
Syria,06/10/2012,265,2,-6,0,31,16,0,308
Syria,07/10/2012,266,0,-8,0,39,13,0,310
Syria,08/10/2012,395,2,-5,0,65,21,0,478
Syria,09/10/2012,376,0,0,0,23,24,0,423
Syria,10/10/2012,762,10,-6,0,202,57,0,1025
Syria,11/10/2012,391,2,-6,0,64,12,0,463
Syria,12/10/2012,310,0,11,0,48,24,0,393
Syria,13/10/2012,110,4,-3,0,30,9,0,150
Syria,14/10/2012,405,1,4,0,100,43,0,553
Syria,15/10/2012,233,2,-4,0,58,22,0,311
Syria,16/10/2012,161,6,0,0,167,33,0,367
Syria,17/10/2012,265,10,3,0,94,20,0,392
Syria,18/10/2012,196,12,4,0,82,19,0,313
Syria,19/10/2012,351,2,0,0,53,97,0,503
Syria,20/10/2012,409,0,-13,0,121,36,0,553
Syria,21/10/2012,407,0,-12,0,89,56,0,540
Syria,22/10/2012,576,10,-13,0,55,65,0,693
Syria,23/10/2012,408,6,0,0,92,82,0,588
Syria,24/10/2012,292,4,-15,0,49,27,0,357
Syria,25/10/2012,267,0,-13,0,17,16,0,287
Syria,26/10/2012,250,0,1,0,27,6,0,284
Syria,27/10/2012,114,0,-7,0,17,14,0,138
Syria,28/10/2012,154,4,-2,0,33,16,0,205
Syria,29/10/2012,226,0,-3,0,1,11,0,235
Syria,30/10/2012,199,4,-6,0,55,17,0,269
Syria,31/10/2012,158,4,0,0,-5,7,0,164
Yemen,01/10/2012,41,0,0,0,2,3,0,46
Yemen,02/10/2012,71,0,0,0,25,4,0,100
Yemen,03/10/2012,37,0,1,0,12,0,0,50
Yemen,04/10/2012,13,0,0,0,12,0,0,25
Yemen,05/10/2012,23,0,0,0,70,4,0,97
Yemen,06/10/2012,41,0,0,0,117,2,0,160
Yemen,07/10/2012,16,0,-2,0,55,6,0,75
Yemen,08/10/2012,3,0,2,0,6,0,0,11
Yemen,09/10/2012,5,0,0,0,23,6,0,34
Yemen,10/10/2012,0,0,0,0,9,0,0,9
Yemen,11/10/2012,51,0,-3,0,1,18,0,67
Yemen,12/10/2012,11,0,0,0,-3,6,0,14
Yemen,13/10/2012,9,0,0,0,15,1,0,25
Yemen,14/10/2012,6,0,0,0,24,3,0,33
Yemen,15/10/2012,25,0,1,0,3,2,0,31
Yemen,16/10/2012,22,0,1,0,46,10,0,79
Yemen,17/10/2012,27,0,0,0,13,4,0,44
Yemen,18/10/2012,43,0,0,0,27,0,0,70
Yemen,19/10/2012,65,0,0,0,19,13,0,97
Yemen,20/10/2012,21,0,0,0,21,4,0,46
Yemen,21/10/2012,11,0,0,0,0,3,0,14
Yemen,22/10/2012,66,0,0,0,3,9,0,78
Yemen,23/10/2012,41,0,0,0,12,7,0,60
Yemen,24/10/2012,28,0,0,0,27,4,0,59
Yemen,25/10/2012,14,0,0,0,-6,2,0,10
Yemen,26/10/2012,32,0,0,0,0,1,0,33
Yemen,27/10/2012,23,0,0,0,2,0,0,25
Yemen,28/10/2012,30,0,0,0,6,0,0,36
Yemen,29/10/2012,21,0,0,0,0,0,0,21
Yemen,30/10/2012,2,0,0,0,0,0,0,2
Yemen,31/10/2012,3,0,0,0,9,0,0,12
Afghanistan,01/04/2012,70,0,-6,0,18,10,0,92
Afghanistan,02/04/2012,221,8,2,0,58,17,0,306
Afghanistan,03/04/2012,281,4,-2,0,83,17,0,383
Afghanistan,04/04/2012,206,2,-2,0,101,28,0,335
Afghanistan,05/04/2012,217,0,-7,0,72,25,0,307
Afghanistan,06/04/2012,129,0,-2,0,9,17,0,153
Afghanistan,07/04/2012,152,2,-3,0,11,14,0,176
Afghanistan,08/04/2012,210,0,1,0,18,11,0,240
Afghanistan,09/04/2012,141,0,0,0,35,11,0,187
Afghanistan,10/04/2012,195,6,1,0,71,28,0,301
Afghanistan,11/04/2012,81,0,3,0,23,14,0,121
Afghanistan,12/04/2012,112,0,4,0,64,9,0,189
Afghanistan,13/04/2012,162,2,0,0,48,28,0,240
Afghanistan,14/04/2012,141,2,0,0,23,3,0,169
Afghanistan,15/04/2012,414,0,-2,0,27,6,0,445
Afghanistan,16/04/2012,216,8,0,0,18,17,0,259
Afghanistan,17/04/2012,152,4,-4,0,87,24,0,263
Afghanistan,18/04/2012,408,10,1,0,111,29,0,559
Afghanistan,19/04/2012,222,2,0,0,111,21,0,356
Afghanistan,20/04/2012,58,4,0,0,33,3,0,98
Afghanistan,21/04/2012,81,0,0,0,20,17,0,118
Afghanistan,22/04/2012,54,0,0,0,13,12,0,79
Afghanistan,23/04/2012,160,0,-4,0,20,19,0,195
Afghanistan,24/04/2012,241,2,-2,0,56,2,0,299
Afghanistan,25/04/2012,135,0,3,0,33,24,0,195
Afghanistan,26/04/2012,347,0,-4,0,83,15,0,441
Afghanistan,27/04/2012,296,4,-10,0,87,33,0,410
Afghanistan,28/04/2012,436,0,0,0,12,20,0,468
Afghanistan,29/04/2012,297,2,0,0,66,5,0,370
Afghanistan,30/04/2012,319,2,0,0,21,27,0,369
Albania,01/04/2012,0,0,0,0,0,0,0,0
Albania,02/04/2012,5,0,0,0,-4,0,0,1
Albania,03/04/2012,3,0,0,0,6,0,0,9
Albania,04/04/2012,2,0,-3,0,3,6,0,8
Albania,05/04/2012,23,2,1,0,0,0,0,26
Albania,06/04/2012,2,0,-2,0,0,1,0,1
Albania,07/04/2012,2,0,0,0,0,0,0,2
Albania,08/04/2012,6,0,1,0,0,0,0,7
Albania,09/04/2012,1,0,0,0,6,2,0,9
Albania,10/04/2012,10,0,0,0,6,0,0,16
Albania,11/04/2012,13,0,0,0,9,3,0,25
Albania,12/04/2012,27,0,0,0,9,0,0,36
Albania,13/04/2012,33,0,0,0,7,4,0,44
Albania,14/04/2012,11,0,0,0,12,6,0,29
Albania,15/04/2012,0,0,0,0,0,0,0,0
Albania,16/04/2012,30,0,0,0,-2,4,0,32
Albania,17/04/2012,32,0,0,0,18,11,0,61
Albania,18/04/2012,38,0,0,0,12,14,0,64
Albania,19/04/2012,8,0,-2,0,-3,0,0,3
Albania,20/04/2012,10,0,0,0,0,0,0,10
Albania,21/04/2012,10,0,-2,0,0,0,0,8
Albania,22/04/2012,9,0,0,0,3,0,0,12
Albania,23/04/2012,6,0,0,0,0,6,0,12
Albania,24/04/2012,9,0,0,0,0,8,0,17
Albania,25/04/2012,12,0,-3,0,6,7,0,22
Albania,26/04/2012,3,0,0,0,0,0,0,3
Albania,27/04/2012,3,0,0,0,0,0,0,3
Albania,28/04/2012,0,0,0,0,3,0,0,3
Albania,29/04/2012,0,0,0,0,0,0,0,0
Albania,30/04/2012,4,0,0,0,0,0,0,4
Algeria,01/04/2012,-4,0,0,0,13,0,0,9
Algeria,02/04/2012,81,0,0,0,12,2,0,95
Algeria,03/04/2012,34,0,0,0,4,4,0,42
Algeria,04/04/2012,27,0,0,0,20,0,0,47
Algeria,05/04/2012,24,0,0,0,11,0,0,35
Algeria,06/04/2012,105,0,-5,0,28,2,0,130
Algeria,07/04/2012,56,0,-4,0,13,0,0,65
Algeria,08/04/2012,13,0,-2,0,-5,1,0,7
Algeria,09/04/2012,68,0,-2,0,9,6,0,81
Algeria,10/04/2012,15,0,0,0,9,1,0,25
Algeria,11/04/2012,13,0,1,0,21,0,0,35
Algeria,12/04/2012,19,0,0,0,18,2,0,39
Algeria,13/04/2012,7,0,1,0,0,1,0,9
Algeria,14/04/2012,1,0,0,0,0,0,0,1
Algeria,15/04/2012,10,0,0,0,9,0,0,19
Algeria,16/04/2012,9,0,-1,0,8,0,0,16
Algeria,17/04/2012,9,0,-1,0,-16,0,0,-8
Algeria,18/04/2012,3,0,3,0,-6,0,0,0
Algeria,19/04/2012,16,0,0,0,1,0,0,17
Algeria,20/04/2012,1,0,0,0,2,0,0,3
Algeria,21/04/2012,5,0,0,0,-4,2,0,3
Algeria,22/04/2012,4,0,0,0,-1,0,0,3
Algeria,23/04/2012,27,0,2,0,-16,4,0,17
Algeria,24/04/2012,6,0,0,0,25,0,0,31
Algeria,25/04/2012,6,0,0,0,15,1,0,22
Algeria,26/04/2012,8,0,0,0,-4,3,0,7
Algeria,27/04/2012,12,0,1,0,15,3,0,31
Algeria,28/04/2012,3,0,0,0,0,0,0,3
Algeria,29/04/2012,7,0,0,0,6,0,0,13
Algeria,30/04/2012,31,0,0,0,7,-1,0,37
Bangladesh,01/04/2012,12,0,0,0,15,0,0,27
Bangladesh,02/04/2012,17,0,0,0,3,1,0,21
Bangladesh,03/04/2012,19,0,0,0,3,2,0,24
Bangladesh,04/04/2012,9,0,0,0,3,4,0,16
Bangladesh,05/04/2012,5,0,0,0,0,4,0,9
Bangladesh,06/04/2012,6,0,0,0,-2,2,0,6
Bangladesh,07/04/2012,10,2,2,0,19,1,0,34
Bangladesh,08/04/2012,2,2,0,0,0,1,0,5
Bangladesh,09/04/2012,5,2,0,0,1,1,0,9
Bangladesh,10/04/2012,3,0,0,0,26,8,0,37
Bangladesh,11/04/2012,15,0,0,0,7,2,0,24
Bangladesh,12/04/2012,28,0,0,0,2,5,0,35
Bangladesh,13/04/2012,21,0,-4,0,24,2,0,43
Bangladesh,14/04/2012,20,0,-4,0,9,0,0,25
Bangladesh,15/04/2012,13,2,0,0,7,0,0,22
Bangladesh,16/04/2012,47,0,-2,0,24,5,0,74
Bangladesh,17/04/2012,32,0,-14,0,15,8,0,41
Bangladesh,18/04/2012,29,0,-6,0,13,2,0,38
Bangladesh,19/04/2012,29,0,0,0,4,9,0,42
Bangladesh,20/04/2012,7,0,0,0,7,2,0,16
Bangladesh,21/04/2012,33,0,-2,0,13,4,0,48
Bangladesh,22/04/2012,27,0,0,0,15,2,0,44
Bangladesh,23/04/2012,62,0,-2,0,4,2,0,66
Bangladesh,24/04/2012,34,0,0,0,6,0,0,40
Bangladesh,25/04/2012,16,0,0,0,-9,0,0,7
Bangladesh,26/04/2012,11,0,0,0,-3,0,0,8
Bangladesh,27/04/2012,9,0,0,0,8,0,0,17
Bangladesh,28/04/2012,9,0,0,0,8,5,0,22
Bangladesh,29/04/2012,22,0,-3,0,11,0,0,30
Bangladesh,30/04/2012,32,2,0,0,21,2,0,57
Cameroon,01/04/2012,0,0,0,0,0,0,0,0
Cameroon,02/04/2012,0,0,0,0,0,4,0,4
Cameroon,03/04/2012,5,0,0,0,1,3,0,9
Cameroon,05/04/2012,9,0,0,0,6,0,0,15
Cameroon,06/04/2012,6,0,0,0,0,0,0,6
Cameroon,07/04/2012,6,0,0,0,0,0,0,6
Cameroon,08/04/2012,3,0,0,0,0,0,0,3
Cameroon,09/04/2012,4,0,0,0,0,0,0,4
Cameroon,10/04/2012,0,0,0,0,0,0,0,0
Cameroon,11/04/2012,0,0,0,0,0,0,0,0
Cameroon,12/04/2012,9,0,0,0,0,0,0,9
Cameroon,13/04/2012,0,0,0,0,0,0,0,0
Cameroon,14/04/2012,0,0,0,0,0,0,0,0
Cameroon,16/04/2012,0,0,-2,0,0,0,0,-2
Cameroon,17/04/2012,0,0,0,0,0,0,0,0
Cameroon,18/04/2012,0,0,0,0,0,0,0,0
Cameroon,19/04/2012,0,0,0,0,0,0,0,0
Cameroon,21/04/2012,4,0,0,0,-4,0,0,0
Cameroon,22/04/2012,0,0,0,0,0,0,0,0
Cameroon,23/04/2012,3,0,0,0,0,0,0,3
Cameroon,24/04/2012,2,0,0,0,-4,0,0,-2
Cameroon,25/04/2012,0,0,0,0,0,0,0,0
Cameroon,26/04/2012,7,0,0,0,0,0,0,7
Cameroon,27/04/2012,2,0,0,0,0,0,0,2
Cameroon,28/04/2012,0,0,0,0,0,0,0,0
Cameroon,29/04/2012,2,0,0,0,0,0,0,2
Cameroon,30/04/2012,1,0,0,0,3,0,0,4
China,01/04/2012,76,4,0,0,38,9,0,127
China,02/04/2012,145,4,-2,0,40,25,0,212
China,03/04/2012,94,4,-14,0,83,21,0,188
China,04/04/2012,162,6,-1,0,65,9,0,241
China,05/04/2012,132,4,3,0,49,26,0,214
China,06/04/2012,121,2,-1,0,48,12,0,182
China,07/04/2012,133,2,1,0,27,6,0,169
China,08/04/2012,133,0,2,0,43,8,0,186
China,09/04/2012,187,0,-15,0,34,14,0,220
China,10/04/2012,136,6,-9,0,28,22,0,183
China,11/04/2012,165,2,5,0,59,14,0,245
China,12/04/2012,158,0,7,0,93,21,0,279
China,13/04/2012,168,2,2,0,51,19,0,242
China,14/04/2012,127,4,-3,0,37,25,0,190
China,15/04/2012,202,0,0,0,3,6,0,211
China,16/04/2012,87,4,3,0,31,29,0,154
China,17/04/2012,158,4,-13,0,65,26,0,240
China,18/04/2012,174,8,-10,0,43,8,0,223
China,19/04/2012,361,4,-16,0,146,35,0,530
China,20/04/2012,82,0,-4,0,38,8,0,124
China,21/04/2012,45,4,1,0,6,8,0,64
China,22/04/2012,141,0,-1,0,32,10,0,182
China,23/04/2012,208,6,-5,0,69,21,0,299
China,24/04/2012,98,2,-12,0,33,21,0,142
China,25/04/2012,182,2,2,0,64,21,0,271
China,26/04/2012,264,0,-3,0,101,32,0,394
China,27/04/2012,170,4,4,0,18,32,0,228
China,28/04/2012,88,0,1,0,22,18,0,129
China,29/04/2012,158,2,3,0,63,18,0,244
China,30/04/2012,176,4,3,0,78,34,0,295
Egypt,01/04/2012,25,0,-4,0,13,4,0,38
Egypt,02/04/2012,39,0,-1,0,33,20,0,91
Egypt,03/04/2012,61,2,0,0,13,6,0,82
Egypt,04/04/2012,30,0,0,0,36,15,0,81
Egypt,05/04/2012,131,0,0,0,43,22,0,196
Egypt,06/04/2012,39,2,-10,0,55,12,0,98
Egypt,07/04/2012,91,0,-6,0,64,10,0,159
Egypt,08/04/2012,108,0,-7,0,23,5,0,129
Egypt,09/04/2012,144,0,-19,0,46,23,0,194
Egypt,10/04/2012,80,0,-2,0,94,15,0,187
Egypt,11/04/2012,48,0,-10,0,44,11,0,93
Egypt,12/04/2012,54,0,-8,0,96,8,0,150
Egypt,13/04/2012,48,0,1,0,41,9,0,99
Egypt,14/04/2012,36,0,0,0,37,12,0,85
Egypt,15/04/2012,135,0,-12,0,90,16,0,229
Egypt,16/04/2012,42,0,-2,0,42,4,0,86
Egypt,17/04/2012,43,0,-7,0,73,11,0,120
Egypt,18/04/2012,67,4,-2,0,23,14,0,106
Egypt,19/04/2012,51,0,2,0,-8,11,0,56
Egypt,20/04/2012,30,0,-1,0,-3,1,0,27
Egypt,21/04/2012,65,0,-13,0,43,9,0,104
Egypt,22/04/2012,73,0,-8,0,22,15,0,102
Egypt,23/04/2012,130,0,-2,0,75,6,0,209
Egypt,24/04/2012,73,0,-3,0,142,8,0,220
Egypt,25/04/2012,62,0,1,0,93,6,0,162
Egypt,26/04/2012,51,0,0,0,37,13,0,101
Egypt,27/04/2012,49,0,0,0,50,21,0,120
Egypt,28/04/2012,64,0,-1,0,54,29,0,146
Egypt,29/04/2012,70,0,-9,0,68,25,0,154
Egypt,30/04/2012,86,0,-2,0,19,18,0,121
Eritrea,01/04/2012,3,0,0,0,3,4,0,10
Eritrea,03/04/2012,7,0,0,0,3,0,0,10
Eritrea,04/04/2012,2,0,0,0,0,0,0,2
Eritrea,05/04/2012,0,0,0,0,0,0,0,0
Eritrea,06/04/2012,0,0,-1,0,0,0,0,-1
Eritrea,07/04/2012,4,0,0,0,0,0,0,4
Eritrea,08/04/2012,0,0,0,0,0,0,0,0
Eritrea,09/04/2012,0,0,0,0,0,0,0,0
Eritrea,12/04/2012,0,0,-1,0,3,0,0,2
Eritrea,13/04/2012,0,0,0,0,0,0,0,0
Eritrea,15/04/2012,0,0,0,0,0,0,0,0
Eritrea,16/04/2012,0,0,0,0,0,0,0,0
Eritrea,17/04/2012,-5,0,0,0,0,0,0,-5
Eritrea,18/04/2012,-7,0,4,0,15,0,0,12
Eritrea,19/04/2012,0,0,3,0,3,0,0,6
Eritrea,20/04/2012,3,0,0,0,-2,0,0,1
Eritrea,21/04/2012,0,0,0,0,-2,0,0,-2
Eritrea,22/04/2012,4,0,0,0,0,2,0,6
Eritrea,23/04/2012,-1,0,0,0,0,0,0,-1
Eritrea,24/04/2012,0,0,0,0,0,0,0,0
Eritrea,25/04/2012,0,0,0,0,0,1,0,1
Eritrea,26/04/2012,11,0,0,0,-2,0,0,9
Eritrea,27/04/2012,2,0,0,0,12,0,0,14
Eritrea,28/04/2012,0,0,0,0,0,0,0,0
Eritrea,29/04/2012,0,0,0,0,0,0,0,0
Eritrea,30/04/2012,0,0,0,0,0,0,0,0
Georgia,01/04/2012,22,0,0,0,7,0,0,29
Georgia,02/04/2012,44,0,0,0,19,5,0,68
Georgia,03/04/2012,55,0,0,0,2,3,0,60
Georgia,04/04/2012,88,0,0,0,18,6,0,112
Georgia,05/04/2012,55,8,0,0,12,21,0,96
Georgia,06/04/2012,29,2,1,0,15,0,0,47
Georgia,07/04/2012,29,0,0,0,10,0,0,39
Georgia,08/04/2012,16,0,0,0,12,0,0,28
Georgia,09/04/2012,34,2,-1,0,22,7,0,64
Georgia,10/04/2012,67,0,0,0,32,4,0,103
Georgia,11/04/2012,24,0,0,0,28,2,0,54
Georgia,12/04/2012,16,0,0,0,15,2,0,33
Georgia,13/04/2012,33,0,0,0,20,11,0,64
Georgia,14/04/2012,-1,0,0,0,7,5,0,11
Georgia,15/04/2012,10,4,0,0,4,2,0,20
Georgia,16/04/2012,28,0,0,0,5,3,0,36
Georgia,17/04/2012,60,0,-1,0,34,15,0,108
Georgia,18/04/2012,42,2,-1,0,38,6,0,87
Georgia,19/04/2012,66,2,0,0,32,2,0,102
Georgia,20/04/2012,5,4,0,0,0,0,0,9
Georgia,21/04/2012,14,6,1,0,0,1,0,22
Georgia,22/04/2012,15,2,0,0,3,2,0,22
Georgia,23/04/2012,33,0,-1,0,21,1,0,54
Georgia,24/04/2012,70,0,0,0,33,1,0,104
Georgia,25/04/2012,50,6,0,0,29,3,0,88
Georgia,26/04/2012,73,0,0,0,36,5,0,114
Georgia,27/04/2012,40,0,-2,0,45,8,0,91
Georgia,28/04/2012,11,0,1,0,9,22,0,43
Georgia,29/04/2012,3,0,0,0,3,6,0,12
Georgia,30/04/2012,40,0,-4,0,53,10,0,99
India,01/04/2012,37,6,0,0,12,4,0,59
India,02/04/2012,96,2,-8,0,4,12,0,106
India,03/04/2012,70,6,-1,0,1,20,0,96
India,04/04/2012,86,0,3,0,33,10,0,132
India,05/04/2012,34,0,-4,0,26,18,0,74
India,06/04/2012,54,2,0,0,12,8,0,76
India,07/04/2012,93,2,1,0,26,11,0,133
India,08/04/2012,60,2,-2,0,14,2,0,76
India,09/04/2012,117,0,1,0,56,19,0,193
India,10/04/2012,57,2,-8,0,24,17,0,92
India,11/04/2012,69,0,0,0,26,5,0,100
India,12/04/2012,69,0,0,0,21,17,0,107
India,13/04/2012,44,2,0,0,16,17,0,79
India,14/04/2012,42,0,-1,0,9,7,0,57
India,15/04/2012,81,0,0,0,21,11,0,113
India,16/04/2012,100,0,-6,0,16,19,0,129
India,17/04/2012,72,2,3,0,9,6,0,92
India,18/04/2012,106,4,-5,0,4,28,0,137
India,19/04/2012,170,2,3,0,27,34,0,236
India,20/04/2012,67,0,1,0,49,10,0,127
India,21/04/2012,79,0,-4,0,29,17,0,121
India,22/04/2012,89,0,-3,0,47,12,0,145
India,23/04/2012,69,0,2,0,-2,11,0,80
India,24/04/2012,40,4,-5,0,14,9,0,62
India,25/04/2012,120,4,-4,0,46,13,0,179
India,26/04/2012,106,0,0,0,57,14,0,177
India,27/04/2012,69,2,0,0,40,15,0,126
India,28/04/2012,40,0,-1,0,22,7,0,68
India,29/04/2012,56,0,0,0,28,11,0,95
India,30/04/2012,73,4,-1,0,30,15,0,121
Iran,01/04/2012,65,0,-1,0,38,19,0,121
Iran,02/04/2012,107,0,2,0,69,14,0,192
Iran,03/04/2012,138,4,3,0,115,17,0,277
Iran,04/04/2012,133,0,7,0,90,15,0,245
Iran,05/04/2012,163,0,4,0,59,25,0,251
Iran,06/04/2012,74,0,0,0,45,15,0,134
Iran,07/04/2012,54,0,1,0,27,9,0,91
Iran,08/04/2012,153,0,-3,0,70,13,0,233
Iran,09/04/2012,153,0,-8,0,33,15,0,193
Iran,10/04/2012,71,0,-4,0,70,21,0,158
Iran,11/04/2012,122,2,4,0,33,14,0,175
Iran,12/04/2012,102,2,1,0,12,5,0,122
Iran,13/04/2012,73,2,6,0,35,14,0,130
Iran,14/04/2012,80,0,1,0,13,16,0,110
Iran,15/04/2012,119,0,-4,0,30,6,0,151
Iran,16/04/2012,104,1,3,0,36,7,0,151
Iran,17/04/2012,75,2,-3,0,21,8,0,103
Iran,18/04/2012,85,0,4,0,60,18,0,167
Iran,19/04/2012,117,2,6,0,31,15,0,171
Iran,20/04/2012,26,0,0,0,-13,6,0,19
Iran,21/04/2012,45,0,0,0,3,2,0,50
Iran,22/04/2012,93,0,1,0,65,5,0,164
Iran,23/04/2012,121,2,1,0,28,9,0,161
Iran,24/04/2012,117,0,-3,0,17,8,0,139
Iran,25/04/2012,119,2,0,0,42,12,0,175
Iran,26/04/2012,124,0,0,0,46,18,0,188
Iran,27/04/2012,184,1,-1,0,48,23,0,255
Iran,28/04/2012,97,0,-3,0,22,10,0,126
Iran,29/04/2012,93,0,1,0,57,12,0,163
Iran,30/04/2012,117,0,-10,0,48,9,0,164
Iraq,01/04/2012,31,4,0,0,16,3,0,54
Iraq,02/04/2012,85,0,2,0,28,10,0,125
Iraq,03/04/2012,77,0,1,0,6,5,0,89
Iraq,04/04/2012,82,0,-4,0,25,6,0,109
Iraq,05/04/2012,112,0,3,0,13,27,0,155
Iraq,06/04/2012,51,0,-2,0,9,36,0,94
Iraq,07/04/2012,77,0,0,0,44,37,0,158
Iraq,08/04/2012,48,2,0,0,8,11,0,69
Iraq,09/04/2012,48,6,0,0,33,10,0,97
Iraq,10/04/2012,91,0,0,0,42,7,0,140
Iraq,11/04/2012,65,4,0,0,12,4,0,85
Iraq,12/04/2012,60,0,0,0,16,6,0,82
Iraq,13/04/2012,58,0,0,0,24,19,0,101
Iraq,14/04/2012,42,2,0,0,8,10,0,62
Iraq,15/04/2012,62,4,-2,0,-1,4,0,67
Iraq,16/04/2012,71,0,0,0,11,3,0,85
Iraq,17/04/2012,91,0,-2,0,49,9,0,147
Iraq,18/04/2012,67,0,0,0,34,0,0,101
Iraq,19/04/2012,72,2,-1,0,54,6,0,133
Iraq,20/04/2012,97,0,0,0,23,10,0,130
Iraq,21/04/2012,53,0,0,0,5,12,0,70
Iraq,22/04/2012,45,2,2,0,33,6,0,88
Iraq,23/04/2012,69,0,1,0,11,2,0,83
Iraq,24/04/2012,99,0,-3,0,46,10,0,152
Iraq,25/04/2012,179,2,1,0,65,10,0,257
Iraq,26/04/2012,100,4,1,0,38,15,0,158
Iraq,27/04/2012,111,6,1,0,61,16,0,195
Iraq,28/04/2012,82,2,2,0,6,8,0,100
Iraq,29/04/2012,88,0,0,0,12,5,0,105
Iraq,30/04/2012,167,0,-1,0,33,17,0,216
Morocco,01/04/2012,2,0,0,0,0,2,0,4
Morocco,02/04/2012,4,2,0,0,3,4,0,13
Morocco,03/04/2012,12,0,0,0,12,1,0,25
Morocco,04/04/2012,12,0,0,0,3,4,0,19
Morocco,05/04/2012,2,0,-4,0,3,6,0,7
Morocco,06/04/2012,2,0,0,0,0,3,0,5
Morocco,07/04/2012,2,0,0,0,18,0,0,20
Morocco,08/04/2012,3,0,0,0,1,4,0,8
Morocco,09/04/2012,10,0,-2,0,8,0,0,16
Morocco,10/04/2012,1,0,0,0,6,1,0,8
Morocco,11/04/2012,20,0,-2,0,7,2,0,27
Morocco,12/04/2012,15,2,0,0,13,11,0,41
Morocco,13/04/2012,2,0,1,0,9,2,0,14
Morocco,14/04/2012,9,0,0,0,10,4,0,23
Morocco,15/04/2012,3,0,0,0,3,0,0,6
Morocco,16/04/2012,16,0,0,0,-3,5,0,18
Morocco,17/04/2012,19,0,0,0,6,1,0,26
Morocco,18/04/2012,27,0,0,0,9,17,0,53
Morocco,19/04/2012,7,0,0,0,6,4,0,17
Morocco,20/04/2012,5,4,0,0,0,0,0,9
Morocco,21/04/2012,6,2,0,0,0,2,0,10
Morocco,22/04/2012,4,0,0,0,-2,2,0,4
Morocco,23/04/2012,-5,0,0,0,6,0,0,1
Morocco,24/04/2012,8,0,0,0,12,2,0,22
Morocco,25/04/2012,2,0,0,0,0,2,0,4
Morocco,26/04/2012,10,0,0,0,6,5,0,21
Morocco,27/04/2012,20,0,0,0,15,2,0,37
Morocco,28/04/2012,11,0,1,0,19,0,0,31
Morocco,29/04/2012,9,0,0,0,-1,1,0,9
Morocco,30/04/2012,1,0,0,0,0,0,0,1
Nigeria,01/04/2012,11,0,0,0,5,6,0,22
Nigeria,02/04/2012,46,2,1,0,7,10,0,66
Nigeria,03/04/2012,71,0,0,0,32,0,0,103
Nigeria,04/04/2012,53,0,-6,0,9,6,0,62
Nigeria,05/04/2012,32,0,1,0,25,10,0,68
Nigeria,06/04/2012,2,0,-2,0,3,0,0,3
Nigeria,07/04/2012,12,0,-16,0,0,1,0,-3
Nigeria,08/04/2012,49,0,-6,0,9,4,0,56
Nigeria,09/04/2012,53,0,0,0,9,3,0,65
Nigeria,10/04/2012,15,0,0,0,11,3,0,29
Nigeria,11/04/2012,21,0,1,0,14,1,0,37
Nigeria,12/04/2012,19,0,2,0,42,4,0,67
Nigeria,13/04/2012,25,2,0,0,27,7,0,61
Nigeria,14/04/2012,21,0,0,0,9,0,0,30
Nigeria,15/04/2012,46,0,-2,0,0,4,0,48
Nigeria,16/04/2012,54,0,-5,0,20,2,0,71
Nigeria,17/04/2012,48,0,-6,0,34,3,0,79
Nigeria,18/04/2012,27,2,-1,0,-6,3,0,25
Nigeria,19/04/2012,25,0,0,0,47,3,0,75
Nigeria,20/04/2012,13,0,1,0,12,0,0,26
Nigeria,21/04/2012,11,0,0,0,3,1,0,15
Nigeria,22/04/2012,30,0,0,0,36,3,0,69
Nigeria,23/04/2012,31,2,3,0,49,0,0,85
Nigeria,24/04/2012,32,0,0,0,39,7,0,78
Nigeria,25/04/2012,48,4,-2,0,39,3,0,92
Nigeria,26/04/2012,72,0,-4,0,106,6,0,180
Nigeria,27/04/2012,41,0,2,0,40,7,0,90
Nigeria,28/04/2012,9,0,0,0,6,1,0,16
Nigeria,29/04/2012,-7,0,1,0,9,1,0,4
Nigeria,30/04/2012,58,0,0,0,15,15,0,88
Pakistan,01/04/2012,35,4,0,0,9,10,0,58
Pakistan,02/04/2012,70,6,0,0,15,4,0,95
Pakistan,03/04/2012,61,8,0,0,46,10,0,125
Pakistan,04/04/2012,83,0,0,0,127,30,0,240
Pakistan,05/04/2012,106,0,-2,0,86,11,0,201
Pakistan,06/04/2012,82,0,-6,0,58,15,0,149
Pakistan,07/04/2012,48,4,-1,0,19,10,0,80
Pakistan,08/04/2012,81,0,0,0,46,8,0,135
Pakistan,09/04/2012,61,2,-1,0,25,5,0,92
Pakistan,10/04/2012,49,2,2,0,15,19,0,87
Pakistan,11/04/2012,49,0,0,0,30,17,0,96
Pakistan,12/04/2012,83,0,-4,0,64,3,0,146
Pakistan,13/04/2012,73,0,0,0,41,1,0,115
Pakistan,14/04/2012,95,0,-2,0,23,12,0,128
Pakistan,15/04/2012,128,0,0,0,45,11,0,184
Pakistan,16/04/2012,122,2,0,0,25,20,0,169
Pakistan,17/04/2012,133,0,-4,0,44,12,0,185
Pakistan,18/04/2012,113,0,0,0,53,21,0,187
Pakistan,19/04/2012,98,2,3,0,25,1,0,129
Pakistan,20/04/2012,33,0,-1,0,28,3,0,63
Pakistan,21/04/2012,60,4,1,0,27,0,0,92
Pakistan,22/04/2012,53,0,0,0,25,11,0,89
Pakistan,23/04/2012,105,2,0,0,58,18,0,183
Pakistan,24/04/2012,44,0,1,0,24,15,0,84
Pakistan,25/04/2012,110,0,-7,0,64,5,0,172
Pakistan,26/04/2012,201,0,-29,0,280,19,0,471
Pakistan,27/04/2012,156,0,-24,0,113,15,0,260
Pakistan,28/04/2012,125,0,-19,0,49,13,0,168
Pakistan,29/04/2012,302,0,-3,0,245,31,0,575
Pakistan,30/04/2012,342,2,-7,0,150,31,0,518
Sierra Leone,01/04/2012,1,2,0,0,0,0,0,3
Sierra Leone,02/04/2012,0,0,0,0,3,0,0,3
Sierra Leone,03/04/2012,0,0,0,0,4,1,0,5
Sierra Leone,04/04/2012,18,0,0,0,0,0,0,18
Sierra Leone,05/04/2012,16,0,0,0,7,0,0,23
Sierra Leone,06/04/2012,8,0,0,0,0,0,0,8
Sierra Leone,07/04/2012,1,0,0,0,0,0,0,1
Sierra Leone,08/04/2012,0,0,0,0,0,0,0,0
Sierra Leone,09/04/2012,0,0,0,0,0,0,0,0
Sierra Leone,10/04/2012,0,0,0,0,0,0,0,0
Sierra Leone,11/04/2012,7,0,0,0,0,0,0,7
Sierra Leone,12/04/2012,8,0,0,0,0,2,0,10
Sierra Leone,13/04/2012,0,0,0,0,0,0,0,0
Sierra Leone,14/04/2012,0,0,0,0,-1,0,0,-1
Sierra Leone,15/04/2012,0,0,0,0,0,0,0,0
Sierra Leone,16/04/2012,6,0,1,0,0,0,0,7
Sierra Leone,17/04/2012,1,0,1,0,21,0,0,23
Sierra Leone,18/04/2012,8,0,0,0,24,2,0,34
Sierra Leone,19/04/2012,4,0,0,0,0,0,0,4
Sierra Leone,20/04/2012,0,0,0,0,-4,1,0,-3
Sierra Leone,21/04/2012,0,0,0,0,0,0,0,0
Sierra Leone,22/04/2012,1,0,-6,0,12,0,0,7
Sierra Leone,23/04/2012,3,0,0,0,3,0,0,6
Sierra Leone,24/04/2012,2,0,0,0,0,0,0,2
Sierra Leone,25/04/2012,27,0,0,0,21,7,0,55
Sierra Leone,26/04/2012,120,0,-3,0,370,33,0,520
Sierra Leone,27/04/2012,57,0,0,0,87,7,0,151
Sierra Leone,28/04/2012,7,0,0,0,45,4,0,56
Sierra Leone,29/04/2012,3,0,0,0,11,4,0,18
Sierra Leone,30/04/2012,3,0,0,0,21,2,0,26
Somalia,01/04/2012,75,2,-2,0,21,9,0,105
Somalia,02/04/2012,116,0,0,0,31,5,0,152
Somalia,03/04/2012,92,0,-4,0,26,16,0,130
Somalia,04/04/2012,54,0,-1,0,41,17,0,111
Somalia,05/04/2012,82,0,-2,0,37,5,0,122
Somalia,06/04/2012,84,0,-1,0,27,3,0,113
Somalia,07/04/2012,58,0,0,0,16,3,0,77
Somalia,08/04/2012,42,2,0,0,16,8,0,68
Somalia,09/04/2012,74,0,0,0,35,6,0,115
Somalia,10/04/2012,70,2,0,0,6,16,0,94
Somalia,11/04/2012,43,0,-1,0,39,6,0,87
Somalia,12/04/2012,82,0,-5,0,49,8,0,134
Somalia,13/04/2012,59,2,-2,0,39,7,0,105
Somalia,14/04/2012,41,0,-2,0,5,5,0,49
Somalia,15/04/2012,38,0,1,0,16,6,0,61
Somalia,16/04/2012,92,4,0,0,27,8,0,131
Somalia,17/04/2012,84,0,-3,0,-4,7,0,84
Somalia,18/04/2012,95,0,-4,0,-22,4,0,73
Somalia,19/04/2012,120,0,1,0,21,8,0,150
Somalia,20/04/2012,41,0,0,0,-4,1,0,38
Somalia,21/04/2012,77,2,-1,0,27,16,0,121
Somalia,22/04/2012,27,0,-1,0,17,4,0,47
Somalia,23/04/2012,131,0,3,0,2,14,0,150
Somalia,24/04/2012,54,0,-4,0,5,10,0,65
Somalia,25/04/2012,74,0,0,0,26,9,0,109
Somalia,26/04/2012,94,0,-5,0,68,7,0,164
Somalia,27/04/2012,152,10,-1,0,73,15,0,249
Somalia,28/04/2012,69,0,-2,0,70,1,0,138
Somalia,29/04/2012,181,0,-2,0,11,15,0,205
Somalia,30/04/2012,125,0,0,0,66,13,0,204
Syria,01/04/2012,245,2,-10,0,10,15,0,262
Syria,02/04/2012,241,0,-11,0,6,18,0,254
Syria,03/04/2012,125,0,-5,0,20,28,0,168
Syria,04/04/2012,134,2,-11,0,11,19,0,155
Syria,05/04/2012,171,2,-8,0,-11,37,0,191
Syria,06/04/2012,138,2,-5,0,6,21,0,162
Syria,07/04/2012,148,0,-7,0,8,13,0,162
Syria,08/04/2012,114,0,1,0,2,22,0,139
Syria,09/04/2012,640,20,-1,0,26,58,0,743
Syria,10/04/2012,329,22,2,0,12,30,0,395
Syria,11/04/2012,242,8,2,0,17,35,0,304
Syria,12/04/2012,248,2,1,0,22,32,0,305
Syria,13/04/2012,202,0,3,0,17,26,0,248
Syria,14/04/2012,205,2,5,0,28,25,0,265
Syria,15/04/2012,154,2,1,0,39,20,0,216
Syria,16/04/2012,278,0,4,0,23,21,0,326
Syria,17/04/2012,197,2,0,0,29,33,0,261
Syria,18/04/2012,200,0,-2,0,46,39,0,283
Syria,19/04/2012,169,4,-12,0,29,20,0,210
Syria,20/04/2012,130,2,-7,0,17,30,0,172
Syria,21/04/2012,193,0,1,0,-2,28,0,220
Syria,22/04/2012,161,6,-6,0,4,11,0,176
Syria,23/04/2012,167,4,0,0,102,55,0,328
Syria,24/04/2012,178,0,2,0,74,15,0,269
Syria,25/04/2012,148,2,-3,0,45,13,0,205
Syria,26/04/2012,218,2,5,0,52,16,0,293
Syria,27/04/2012,186,4,3,0,30,16,0,239
Syria,28/04/2012,80,0,-2,0,24,18,0,120
Syria,29/04/2012,114,0,-6,0,35,22,0,165
Syria,30/04/2012,127,1,-9,0,10,23,0,152
Yemen,01/04/2012,9,0,1,0,3,0,0,13
Yemen,02/04/2012,48,0,-2,0,46,0,0,92
Yemen,03/04/2012,30,0,-4,0,7,1,0,34
Yemen,04/04/2012,32,0,0,0,27,0,0,59
Yemen,05/04/2012,31,0,0,0,6,0,0,37
Yemen,06/04/2012,16,0,0,0,7,11,0,34
Yemen,07/04/2012,65,0,-4,0,33,6,0,100
Yemen,08/04/2012,5,0,-4,0,12,0,0,13
Yemen,09/04/2012,33,0,0,0,18,2,0,53
Yemen,10/04/2012,43,0,-2,0,92,12,0,145
Yemen,11/04/2012,27,0,4,0,21,0,0,52
Yemen,12/04/2012,41,0,-1,0,14,1,0,55
Yemen,13/04/2012,21,0,0,0,17,4,0,42
Yemen,14/04/2012,45,0,0,0,13,7,0,65
Yemen,15/04/2012,7,0,0,0,0,11,0,18
Yemen,16/04/2012,14,0,0,0,10,0,0,24
Yemen,17/04/2012,44,0,2,0,48,3,0,97
Yemen,18/04/2012,62,0,1,0,11,6,0,80
Yemen,19/04/2012,53,0,0,0,7,3,0,63
Yemen,20/04/2012,9,0,0,0,6,0,0,15
Yemen,21/04/2012,45,0,0,0,9,4,0,58
Yemen,22/04/2012,31,0,0,0,39,4,0,74
Yemen,23/04/2012,21,0,0,0,2,1,0,24
Yemen,24/04/2012,14,0,-4,0,9,4,0,23
Yemen,25/04/2012,10,0,0,0,3,24,0,37
Yemen,26/04/2012,105,0,-4,0,17,18,0,136
Yemen,27/04/2012,55,0,-1,0,45,10,0,109
Yemen,28/04/2012,42,0,-6,0,0,8,0,44
Yemen,29/04/2012,118,0,0,0,-5,4,0,117
Yemen,30/04/2012,107,0,-4,0,-2,10,0,111
Afghanistan,01/07/2009,94,6,0,0,22,6,0,128
Afghanistan,02/07/2009,207,0,0,0,20,16,0,243
Afghanistan,03/07/2009,261,4,-2,0,13,26,0,302
Afghanistan,04/07/2009,92,0,-5,0,39,13,0,139
Afghanistan,05/07/2009,139,0,1,0,39,7,0,186
Afghanistan,06/07/2009,160,2,-2,0,51,30,0,241
Afghanistan,07/07/2009,163,0,-4,0,18,18,0,195
Afghanistan,08/07/2009,152,0,0,0,22,7,0,181
Afghanistan,09/07/2009,114,4,0,0,17,30,0,165
Afghanistan,10/07/2009,275,0,0,0,26,25,0,326
Afghanistan,11/07/2009,201,2,-1,0,28,2,0,232
Afghanistan,12/07/2009,146,0,0,0,21,11,0,178
Afghanistan,13/07/2009,221,2,-5,0,26,8,0,252
Afghanistan,14/07/2009,331,0,0,0,26,16,0,373
Afghanistan,15/07/2009,286,0,-3,0,39,6,0,328
Afghanistan,16/07/2009,202,2,-1,0,28,8,0,239
Afghanistan,17/07/2009,212,0,0,0,28,23,0,263
Afghanistan,18/07/2009,111,0,0,0,35,20,0,166
Afghanistan,19/07/2009,180,0,-2,0,26,14,0,218
Afghanistan,20/07/2009,189,0,0,0,33,16,0,238
Afghanistan,21/07/2009,103,0,-4,0,19,10,0,128
Afghanistan,22/07/2009,229,0,-4,0,121,12,0,358
Afghanistan,23/07/2009,185,2,2,0,28,17,0,234
Afghanistan,24/07/2009,378,0,0,0,36,9,0,423
Afghanistan,25/07/2009,197,2,0,0,38,19,0,256
Afghanistan,26/07/2009,143,6,0,0,58,8,0,215
Afghanistan,27/07/2009,366,4,0,0,43,17,0,430
Afghanistan,28/07/2009,317,2,-2,0,86,27,0,430
Afghanistan,29/07/2009,256,0,1,0,47,22,0,326
Afghanistan,30/07/2009,355,0,0,0,123,21,0,499
Afghanistan,31/07/2009,493,6,2,0,119,39,0,659
Albania,01/07/2009,5,0,0,0,-2,0,0,3
Albania,02/07/2009,0,0,0,0,0,0,0,0
Albania,03/07/2009,0,0,0,0,0,0,0,0
Albania,04/07/2009,2,0,0,0,-2,0,0,0
Albania,05/07/2009,0,0,0,0,1,0,0,1
Albania,06/07/2009,5,0,0,0,0,1,0,6
Albania,07/07/2009,0,0,0,0,0,0,0,0
Albania,08/07/2009,-2,0,0,0,13,0,0,11
Albania,09/07/2009,9,0,0,0,15,0,0,24
Albania,10/07/2009,2,0,0,0,3,0,0,5
Albania,11/07/2009,0,0,0,0,0,0,0,0
Albania,12/07/2009,0,0,0,0,1,0,0,1
Albania,13/07/2009,19,0,0,0,1,0,0,20
Albania,14/07/2009,9,0,-2,0,3,2,0,12
Albania,15/07/2009,1,0,0,0,6,0,0,7
Albania,16/07/2009,14,0,0,0,-6,0,0,8
Albania,17/07/2009,-1,0,0,0,0,0,0,-1
Albania,18/07/2009,9,0,0,0,1,5,0,15
Albania,19/07/2009,-1,2,0,0,0,0,0,1
Albania,20/07/2009,-1,0,2,0,-4,0,0,-3
Albania,21/07/2009,6,0,0,0,-2,0,0,4
Albania,22/07/2009,10,0,0,0,0,0,0,10
Albania,23/07/2009,8,0,0,0,15,0,0,23
Albania,24/07/2009,-1,0,0,0,31,0,0,30
Albania,25/07/2009,4,0,-2,0,0,0,0,2
Albania,26/07/2009,2,0,0,0,0,0,0,2
Albania,27/07/2009,2,0,0,0,1,0,0,3
Albania,28/07/2009,6,0,0,0,3,1,0,10
Albania,29/07/2009,2,0,0,0,0,0,0,2
Albania,30/07/2009,-5,0,0,0,12,2,0,9
Albania,31/07/2009,6,0,0,0,-2,3,0,7
Algeria,01/07/2009,6,0,0,0,-2,2,0,6
Algeria,02/07/2009,10,0,0,0,0,0,0,10
Algeria,03/07/2009,-27,0,-1,0,3,3,0,-22
Algeria,04/07/2009,-16,0,0,0,0,1,0,-15
Algeria,05/07/2009,1,0,1,0,-2,0,0,0
Algeria,06/07/2009,1,0,0,0,3,0,0,4
Algeria,07/07/2009,15,0,0,0,3,0,0,18
Algeria,08/07/2009,7,0,0,0,0,0,0,7
Algeria,09/07/2009,0,0,0,0,0,0,0,0
Algeria,10/07/2009,2,0,0,0,12,0,0,14
Algeria,11/07/2009,0,0,0,0,3,0,0,3
Algeria,12/07/2009,7,0,0,0,3,0,0,10
Algeria,13/07/2009,23,0,0,0,3,0,0,26
Algeria,14/07/2009,50,0,0,0,-4,2,0,48
Algeria,15/07/2009,13,0,0,0,0,0,0,13
Algeria,16/07/2009,3,0,0,0,0,3,0,6
Algeria,17/07/2009,2,0,1,0,0,0,0,3
Algeria,18/07/2009,8,0,0,0,-6,0,0,2
Algeria,19/07/2009,5,0,0,0,-4,0,0,1
Algeria,20/07/2009,17,0,0,0,0,0,0,17
Algeria,21/07/2009,40,0,0,0,10,2,0,52
Algeria,22/07/2009,6,0,0,0,6,2,0,14
Algeria,23/07/2009,12,0,0,0,0,0,0,12
Algeria,24/07/2009,21,0,0,0,-4,0,0,17
Algeria,25/07/2009,4,0,0,0,0,0,0,4
Algeria,26/07/2009,0,0,0,0,3,0,0,3
Algeria,27/07/2009,7,0,0,0,-4,0,0,3
Algeria,28/07/2009,-3,0,0,0,10,0,0,7
Algeria,29/07/2009,3,0,0,0,-3,0,0,0
Algeria,30/07/2009,2,0,0,0,0,0,0,2
Algeria,31/07/2009,1,0,0,0,3,0,0,4
Bangladesh,01/07/2009,-5,0,0,0,15,0,0,10
Bangladesh,02/07/2009,9,0,0,0,0,0,0,9
Bangladesh,03/07/2009,6,0,0,0,6,0,0,12
Bangladesh,04/07/2009,-1,0,0,0,0,1,0,0
Bangladesh,05/07/2009,2,0,0,0,0,4,0,6
Bangladesh,06/07/2009,0,0,0,0,3,0,0,3
Bangladesh,07/07/2009,6,2,0,0,6,0,0,14
Bangladesh,08/07/2009,1,2,0,0,3,0,0,6
Bangladesh,09/07/2009,6,0,0,0,0,1,0,7
Bangladesh,10/07/2009,2,0,0,0,3,0,0,5
Bangladesh,11/07/2009,12,0,0,0,3,0,0,15
Bangladesh,12/07/2009,12,0,0,0,-2,0,0,10
Bangladesh,13/07/2009,11,2,0,0,3,2,0,18
Bangladesh,14/07/2009,3,0,0,0,3,0,0,6
Bangladesh,15/07/2009,2,0,0,0,0,5,0,7
Bangladesh,16/07/2009,7,0,0,0,0,0,0,7
Bangladesh,17/07/2009,7,0,1,0,0,1,0,9
Bangladesh,18/07/2009,-14,0,-1,0,15,0,0,0
Bangladesh,19/07/2009,2,0,0,0,6,2,0,10
Bangladesh,20/07/2009,2,0,0,0,0,2,0,4
Bangladesh,21/07/2009,4,0,0,0,-2,0,0,2
Bangladesh,22/07/2009,12,0,0,0,-2,5,0,15
Bangladesh,23/07/2009,-8,0,0,0,-26,0,0,-34
Bangladesh,24/07/2009,15,0,0,0,4,0,0,19
Bangladesh,25/07/2009,22,0,0,0,15,0,0,37
Bangladesh,26/07/2009,22,0,0,0,4,1,0,27
Bangladesh,27/07/2009,11,0,-2,0,-1,2,0,10
Bangladesh,28/07/2009,12,0,0,0,0,1,0,13
Bangladesh,29/07/2009,9,0,0,0,-12,1,0,-2
Bangladesh,30/07/2009,17,0,0,0,9,2,0,28
Bangladesh,31/07/2009,16,2,0,0,4,5,0,27
Cameroon,01/07/2009,-1,0,0,0,0,0,0,-1
Cameroon,02/07/2009,0,0,0,0,0,0,0,0
Cameroon,03/07/2009,3,0,0,0,0,0,0,3
Cameroon,06/07/2009,3,0,0,0,0,0,0,3
Cameroon,07/07/2009,0,0,0,0,-2,0,0,-2
Cameroon,08/07/2009,0,0,0,0,0,0,0,0
Cameroon,09/07/2009,0,0,0,0,0,0,0,0
Cameroon,10/07/2009,2,0,0,0,0,0,0,2
Cameroon,11/07/2009,0,0,0,0,0,0,0,0
Cameroon,12/07/2009,0,0,0,0,0,0,0,0
Cameroon,13/07/2009,0,0,0,0,0,0,0,0
Cameroon,14/07/2009,6,0,0,0,3,0,0,9
Cameroon,15/07/2009,7,0,0,0,0,0,0,7
Cameroon,16/07/2009,2,0,0,0,0,0,0,2
Cameroon,17/07/2009,0,0,0,0,0,0,0,0
Cameroon,18/07/2009,-1,0,0,0,0,0,0,-1
Cameroon,20/07/2009,2,0,0,0,0,0,0,2
Cameroon,21/07/2009,0,0,0,0,6,0,0,6
Cameroon,22/07/2009,0,0,0,0,0,0,0,0
Cameroon,23/07/2009,0,0,0,0,0,0,0,0
Cameroon,24/07/2009,-1,0,0,0,3,0,0,2
Cameroon,25/07/2009,0,0,0,0,0,0,0,0
Cameroon,26/07/2009,0,0,0,0,0,0,0,0
Cameroon,27/07/2009,15,0,0,0,0,4,0,19
Cameroon,28/07/2009,3,0,0,0,0,0,0,3
Cameroon,29/07/2009,0,0,0,0,0,0,0,0
Cameroon,30/07/2009,3,0,0,0,0,0,0,3
Cameroon,31/07/2009,6,0,0,0,6,0,0,12
China,01/07/2009,39,2,0,0,37,17,0,95
China,02/07/2009,69,0,-5,0,17,11,0,92
China,03/07/2009,68,0,0,0,39,2,0,109
China,04/07/2009,39,0,2,0,-2,4,0,43
China,05/07/2009,106,0,0,0,18,15,0,139
China,06/07/2009,201,0,1,0,102,68,0,372
China,07/07/2009,209,0,2,0,197,65,0,473
China,08/07/2009,184,0,-1,0,97,66,0,346
China,09/07/2009,97,4,-2,0,61,34,0,194
China,10/07/2009,124,2,7,0,78,50,0,261
China,11/07/2009,100,0,0,0,42,23,0,165
China,12/07/2009,68,2,0,0,22,23,0,115
China,13/07/2009,218,2,-2,0,15,84,0,317
China,14/07/2009,129,0,6,0,58,16,0,209
China,15/07/2009,52,0,-4,0,94,16,0,158
China,16/07/2009,94,4,-1,0,163,15,0,275
China,17/07/2009,107,2,1,0,90,17,0,217
China,18/07/2009,91,0,0,0,36,3,0,130
China,19/07/2009,105,0,3,0,42,21,0,171
China,20/07/2009,90,6,0,0,70,17,0,183
China,21/07/2009,42,2,3,0,17,8,0,72
China,22/07/2009,60,0,2,0,37,19,0,118
China,23/07/2009,68,0,2,0,40,9,0,119
China,24/07/2009,127,0,0,0,67,33,0,227
China,25/07/2009,89,0,-1,0,42,13,0,143
China,26/07/2009,70,0,-2,0,40,14,0,122
China,27/07/2009,168,0,-3,0,48,23,0,236
China,28/07/2009,173,2,-3,0,83,32,0,287
China,29/07/2009,158,8,-8,0,94,33,0,285
China,30/07/2009,159,2,-1,0,91,27,0,278
China,31/07/2009,107,6,0,0,83,23,0,219
Egypt,01/07/2009,14,0,0,0,25,3,0,42
Egypt,02/07/2009,23,4,0,0,14,1,0,42
Egypt,03/07/2009,11,0,0,0,3,0,0,14
Egypt,04/07/2009,6,0,0,0,-4,0,0,2
Egypt,05/07/2009,18,0,0,0,6,2,0,26
Egypt,06/07/2009,34,0,0,0,36,1,0,71
Egypt,07/07/2009,18,0,-6,0,5,0,0,17
Egypt,08/07/2009,18,0,0,0,6,0,0,24
Egypt,09/07/2009,28,0,0,0,21,4,0,53
Egypt,10/07/2009,21,0,0,0,-6,3,0,18
Egypt,11/07/2009,29,0,0,0,3,0,0,32
Egypt,12/07/2009,18,0,-4,0,19,0,0,33
Egypt,13/07/2009,59,0,0,0,14,0,0,73
Egypt,14/07/2009,26,0,0,0,26,7,0,59
Egypt,15/07/2009,4,0,0,0,11,3,0,18
Egypt,16/07/2009,16,0,0,0,18,0,0,34
Egypt,17/07/2009,28,0,-2,0,3,4,0,33
Egypt,18/07/2009,30,0,0,0,12,3,0,45
Egypt,19/07/2009,28,0,0,0,13,0,0,41
Egypt,20/07/2009,15,0,0,0,3,2,0,20
Egypt,21/07/2009,19,0,0,0,4,0,0,23
Egypt,22/07/2009,14,0,-2,0,6,1,0,19
Egypt,23/07/2009,32,0,-3,0,6,0,0,35
Egypt,24/07/2009,9,0,-4,0,8,3,0,16
Egypt,25/07/2009,11,0,1,0,15,1,0,28
Egypt,26/07/2009,23,0,0,0,12,3,0,38
Egypt,27/07/2009,25,0,0,0,12,2,0,39
Egypt,28/07/2009,41,0,0,0,29,3,0,73
Egypt,29/07/2009,11,0,0,0,3,2,0,16
Egypt,30/07/2009,30,0,0,0,27,7,0,64
Egypt,31/07/2009,48,0,0,0,25,0,0,73
Eritrea,01/07/2009,6,0,0,0,3,1,0,10
Eritrea,02/07/2009,0,0,0,0,0,0,0,0
Eritrea,03/07/2009,0,0,0,0,0,0,0,0
Eritrea,04/07/2009,1,0,0,0,0,0,0,1
Eritrea,05/07/2009,0,0,0,0,0,1,0,1
Eritrea,06/07/2009,13,0,0,0,0,0,0,13
Eritrea,07/07/2009,1,0,0,0,-6,0,0,-5
Eritrea,08/07/2009,3,0,0,0,0,2,0,5
Eritrea,09/07/2009,21,0,0,0,0,2,0,23
Eritrea,10/07/2009,39,0,0,0,0,0,0,39
Eritrea,11/07/2009,3,0,0,0,0,0,0,3
Eritrea,12/07/2009,24,0,0,0,0,0,0,24
Eritrea,13/07/2009,9,0,0,0,0,0,0,9
Eritrea,14/07/2009,6,0,0,0,0,0,0,6
Eritrea,15/07/2009,0,0,0,0,0,0,0,0
Eritrea,16/07/2009,6,0,0,0,9,0,0,15
Eritrea,17/07/2009,0,0,0,0,0,0,0,0
Eritrea,18/07/2009,0,0,0,0,0,0,0,0
Eritrea,20/07/2009,0,0,0,0,0,5,0,5
Eritrea,22/07/2009,4,0,0,0,0,2,0,6
Eritrea,24/07/2009,0,0,0,0,-2,0,0,-2
Eritrea,25/07/2009,0,0,0,0,-6,0,0,-6
Eritrea,26/07/2009,2,0,0,0,0,0,0,2
Eritrea,27/07/2009,0,0,0,0,0,0,0,0
Eritrea,28/07/2009,3,0,0,0,0,0,0,3
Eritrea,29/07/2009,5,0,0,0,0,0,0,5
Eritrea,30/07/2009,3,0,0,0,0,0,0,3
Eritrea,31/07/2009,16,0,1,0,0,0,0,17
Georgia,01/07/2009,7,0,0,0,-3,0,0,4
Georgia,02/07/2009,15,0,1,0,11,0,0,27
Georgia,03/07/2009,1,0,0,0,3,0,0,4
Georgia,04/07/2009,0,0,0,0,0,2,0,2
Georgia,05/07/2009,1,0,0,0,0,0,0,1
Georgia,06/07/2009,6,0,0,0,4,0,0,10
Georgia,07/07/2009,3,0,0,0,0,1,0,4
Georgia,08/07/2009,15,0,0,0,0,0,0,15
Georgia,09/07/2009,26,0,0,0,0,1,0,27
Georgia,10/07/2009,15,0,0,0,3,0,0,18
Georgia,11/07/2009,1,0,0,0,-4,0,0,-3
Georgia,12/07/2009,1,0,0,0,0,0,0,1
Georgia,13/07/2009,13,0,0,0,3,0,0,16
Georgia,14/07/2009,10,0,0,0,9,0,0,19
Georgia,15/07/2009,2,0,0,0,-2,0,0,0
Georgia,16/07/2009,8,0,0,0,-6,0,0,2
Georgia,17/07/2009,1,0,0,0,6,0,0,7
Georgia,18/07/2009,0,0,0,0,0,0,0,0
Georgia,19/07/2009,3,0,0,0,0,0,0,3
Georgia,20/07/2009,-3,0,0,0,0,2,0,-1
Georgia,21/07/2009,4,0,-2,0,0,0,0,2
Georgia,22/07/2009,1,0,0,0,0,4,0,5
Georgia,23/07/2009,12,0,0,0,4,2,0,18
Georgia,24/07/2009,2,0,1,0,3,5,0,11
Georgia,25/07/2009,10,0,0,0,0,2,0,12
Georgia,26/07/2009,6,0,0,0,0,3,0,9
Georgia,27/07/2009,11,0,0,0,9,6,0,26
Georgia,28/07/2009,16,0,-1,0,3,4,0,22
Georgia,29/07/2009,31,0,2,0,-3,1,0,31
Georgia,30/07/2009,28,0,0,0,5,1,0,34
Georgia,31/07/2009,10,0,-1,0,16,1,0,26
India,01/07/2009,25,0,0,0,4,2,0,31
India,02/07/2009,23,0,2,0,3,1,0,29
India,03/07/2009,21,0,0,0,3,2,0,26
India,04/07/2009,4,0,0,0,-3,2,0,3
India,05/07/2009,19,0,0,0,0,3,0,22
India,06/07/2009,31,0,-4,0,3,3,0,33
India,07/07/2009,20,0,0,0,16,5,0,41
India,08/07/2009,30,0,0,0,2,3,0,35
India,09/07/2009,18,0,-2,0,4,4,0,24
India,10/07/2009,5,0,0,0,7,3,0,15
India,11/07/2009,30,0,1,0,15,0,0,46
India,12/07/2009,20,0,0,0,2,11,0,33
India,13/07/2009,33,2,0,0,3,5,0,43
India,14/07/2009,36,0,0,0,8,5,0,49
India,15/07/2009,20,0,0,0,-2,3,0,21
India,16/07/2009,32,0,0,0,0,7,0,39
India,17/07/2009,13,0,0,0,5,1,0,19
India,18/07/2009,32,0,0,0,0,0,0,32
India,19/07/2009,32,0,0,0,-8,4,0,28
India,20/07/2009,6,0,0,0,1,2,0,9
India,21/07/2009,25,0,0,0,7,4,0,36
India,22/07/2009,36,0,0,0,-4,0,0,32
India,23/07/2009,32,0,0,0,1,2,0,35
India,24/07/2009,48,0,-1,0,8,2,0,57
India,25/07/2009,27,0,0,0,27,1,0,55
India,26/07/2009,45,2,3,0,13,7,0,70
India,27/07/2009,37,2,1,0,3,3,0,46
India,28/07/2009,52,2,-5,0,1,9,0,59
India,29/07/2009,5,0,0,0,5,2,0,12
India,30/07/2009,46,0,0,0,7,4,0,57
India,31/07/2009,48,0,-9,0,11,13,0,63
Iran,01/07/2009,72,0,8,0,35,7,0,122
Iran,02/07/2009,61,0,-1,0,23,4,0,87
Iran,03/07/2009,80,0,-1,0,33,4,0,116
Iran,04/07/2009,55,0,1,0,37,7,0,100
Iran,05/07/2009,46,0,2,0,25,11,0,84
Iran,06/07/2009,73,2,1,0,-4,9,0,81
Iran,07/07/2009,71,0,-1,0,3,7,0,80
Iran,08/07/2009,53,0,0,0,37,2,0,92
Iran,09/07/2009,69,0,-2,0,19,3,0,89
Iran,10/07/2009,45,0,0,0,54,2,0,101
Iran,11/07/2009,15,0,1,0,45,1,0,62
Iran,12/07/2009,32,2,1,0,23,3,0,61
Iran,13/07/2009,34,0,0,0,8,5,0,47
Iran,14/07/2009,65,0,0,0,8,5,0,78
Iran,15/07/2009,92,0,0,0,21,9,0,122
Iran,16/07/2009,60,0,-9,0,83,5,0,139
Iran,17/07/2009,80,0,0,0,19,17,0,116
Iran,18/07/2009,77,0,-1,0,16,12,0,104
Iran,19/07/2009,31,0,4,0,-10,4,0,29
Iran,20/07/2009,53,0,2,0,26,9,0,90
Iran,21/07/2009,15,0,4,0,6,5,0,30
Iran,22/07/2009,111,0,2,0,9,19,0,141
Iran,23/07/2009,83,0,1,0,14,18,0,116
Iran,24/07/2009,131,0,1,0,62,17,0,211
Iran,25/07/2009,132,0,-3,0,39,28,0,196
Iran,26/07/2009,54,0,-3,0,21,21,0,93
Iran,27/07/2009,107,2,-4,0,27,15,0,147
Iran,28/07/2009,180,0,1,0,60,14,0,255
Iran,29/07/2009,129,0,0,0,43,5,0,177
Iran,30/07/2009,180,0,-1,0,117,23,0,319
Iran,31/07/2009,116,0,1,0,81,31,0,229
Iraq,01/07/2009,54,0,0,0,27,1,0,82
Iraq,02/07/2009,118,0,-7,0,10,8,0,129
Iraq,03/07/2009,85,0,-2,0,6,4,0,93
Iraq,04/07/2009,63,6,-3,0,15,2,0,83
Iraq,05/07/2009,26,0,0,0,1,6,0,33
Iraq,06/07/2009,57,2,0,0,22,5,0,86
Iraq,07/07/2009,45,0,-6,0,6,2,0,47
Iraq,08/07/2009,52,0,0,0,-2,7,0,57
Iraq,09/07/2009,103,6,0,0,12,6,0,127
Iraq,10/07/2009,112,0,0,0,61,21,0,194
Iraq,11/07/2009,55,0,1,0,19,9,0,84
Iraq,12/07/2009,48,0,1,0,17,3,0,69
Iraq,13/07/2009,120,4,5,0,60,10,0,199
Iraq,14/07/2009,171,0,2,0,30,1,0,204
Iraq,15/07/2009,89,0,0,0,25,0,0,114
Iraq,16/07/2009,93,0,0,0,34,3,0,130
Iraq,17/07/2009,51,0,1,0,0,9,0,61
Iraq,18/07/2009,84,0,0,0,4,9,0,97
Iraq,19/07/2009,62,0,0,0,18,10,0,90
Iraq,20/07/2009,93,0,1,0,17,10,0,121
Iraq,21/07/2009,58,0,-2,0,16,3,0,75
Iraq,22/07/2009,119,0,-4,0,20,7,0,142
Iraq,23/07/2009,52,0,0,0,9,7,0,68
Iraq,24/07/2009,90,6,0,0,27,10,0,133
Iraq,25/07/2009,94,0,0,0,-5,0,0,89
Iraq,26/07/2009,123,0,-4,0,27,3,0,149
Iraq,27/07/2009,112,0,2,0,-20,10,0,104
Iraq,28/07/2009,144,0,7,0,13,9,0,173
Iraq,29/07/2009,104,0,-1,0,1,16,0,120
Iraq,30/07/2009,99,0,-2,0,33,15,0,145
Iraq,31/07/2009,59,0,-2,0,23,4,0,84
Morocco,01/07/2009,0,0,0,0,3,0,0,3
Morocco,02/07/2009,1,0,0,0,12,0,0,13
Morocco,03/07/2009,0,0,0,0,6,0,0,6
Morocco,04/07/2009,0,0,0,0,0,2,0,2
Morocco,05/07/2009,3,0,0,0,9,0,0,12
Morocco,06/07/2009,-1,0,0,0,-2,0,0,-3
Morocco,07/07/2009,8,0,0,0,3,6,0,17
Morocco,08/07/2009,2,0,0,0,0,0,0,2
Morocco,09/07/2009,0,0,0,0,0,0,0,0
Morocco,10/07/2009,3,0,0,0,30,0,0,33
Morocco,11/07/2009,3,0,0,0,9,0,0,12
Morocco,12/07/2009,0,0,0,0,6,0,0,6
Morocco,13/07/2009,0,0,0,0,-5,1,0,-4
Morocco,14/07/2009,4,0,0,0,1,0,0,5
Morocco,15/07/2009,1,0,0,0,3,0,0,4
Morocco,16/07/2009,0,0,0,0,0,0,0,0
Morocco,17/07/2009,2,0,0,0,7,0,0,9
Morocco,18/07/2009,2,0,0,0,0,0,0,2
Morocco,19/07/2009,8,0,0,0,0,5,0,13
Morocco,20/07/2009,2,0,0,0,0,0,0,2
Morocco,21/07/2009,-1,0,0,0,0,0,0,-1
Morocco,22/07/2009,0,0,0,0,0,0,0,0
Morocco,23/07/2009,1,0,0,0,3,0,0,4
Morocco,24/07/2009,3,0,0,0,6,0,0,9
Morocco,25/07/2009,2,0,0,0,9,0,0,11
Morocco,26/07/2009,0,0,0,0,3,0,0,3
Morocco,27/07/2009,-1,0,0,0,-2,0,0,-3
Morocco,28/07/2009,1,0,0,0,30,0,0,31
Morocco,29/07/2009,7,0,0,0,18,0,0,25
Morocco,30/07/2009,5,0,0,0,18,0,0,23
Morocco,31/07/2009,22,0,0,0,59,0,0,81
Nigeria,01/07/2009,19,0,0,0,7,1,0,27
Nigeria,02/07/2009,35,0,-2,0,6,0,0,39
Nigeria,03/07/2009,16,0,0,0,1,4,0,21
Nigeria,04/07/2009,1,0,0,0,0,0,0,1
Nigeria,05/07/2009,3,0,0,0,3,0,0,6
Nigeria,06/07/2009,12,0,0,0,6,2,0,20
Nigeria,07/07/2009,13,0,0,0,-2,0,0,11
Nigeria,08/07/2009,9,0,0,0,3,0,0,12
Nigeria,09/07/2009,8,0,-2,0,-2,0,0,4
Nigeria,10/07/2009,8,0,0,0,9,0,0,17
Nigeria,11/07/2009,4,0,0,0,3,0,0,7
Nigeria,12/07/2009,3,0,0,0,0,0,0,3
Nigeria,13/07/2009,1,0,2,0,35,0,0,38
Nigeria,14/07/2009,10,0,0,0,36,1,0,47
Nigeria,15/07/2009,13,0,0,0,4,5,0,22
Nigeria,16/07/2009,25,0,0,0,4,1,0,30
Nigeria,17/07/2009,4,0,0,0,3,4,0,11
Nigeria,18/07/2009,6,0,0,0,6,0,0,12
Nigeria,19/07/2009,0,0,0,0,0,4,0,4
Nigeria,20/07/2009,21,4,0,0,9,4,0,38
Nigeria,21/07/2009,1,0,0,0,10,0,0,11
Nigeria,22/07/2009,11,0,0,0,3,0,0,14
Nigeria,23/07/2009,0,0,0,0,3,0,0,3
Nigeria,24/07/2009,5,0,2,0,17,1,0,25
Nigeria,25/07/2009,5,0,0,0,2,2,0,9
Nigeria,26/07/2009,195,0,0,0,12,0,0,207
Nigeria,27/07/2009,69,2,0,0,12,6,0,89
Nigeria,28/07/2009,93,0,3,0,22,2,0,120
Nigeria,29/07/2009,65,0,2,0,37,2,0,106
Nigeria,30/07/2009,42,0,4,0,13,6,0,65
Nigeria,31/07/2009,38,0,2,0,15,2,0,57
Pakistan,01/07/2009,44,0,0,0,0,0,0,44
Pakistan,02/07/2009,60,0,0,0,20,8,0,88
Pakistan,03/07/2009,68,4,1,0,14,8,0,95
Pakistan,04/07/2009,60,0,0,0,3,24,0,87
Pakistan,05/07/2009,119,0,-2,0,15,9,0,141
Pakistan,06/07/2009,74,0,-2,0,25,3,0,100
Pakistan,07/07/2009,105,0,0,0,15,8,0,128
Pakistan,08/07/2009,39,0,0,0,54,10,0,103
Pakistan,09/07/2009,40,0,0,0,29,6,0,75
Pakistan,10/07/2009,100,0,0,0,57,5,0,162
Pakistan,11/07/2009,97,0,0,0,35,0,0,132
Pakistan,12/07/2009,68,0,0,0,16,3,0,87
Pakistan,13/07/2009,56,0,0,0,54,2,0,112
Pakistan,14/07/2009,108,2,0,0,14,1,0,125
Pakistan,15/07/2009,109,0,0,0,1,4,0,114
Pakistan,16/07/2009,72,2,-5,0,15,2,0,86
Pakistan,17/07/2009,75,0,1,0,30,10,0,116
Pakistan,18/07/2009,51,0,1,0,27,9,0,88
Pakistan,19/07/2009,54,0,0,0,9,21,0,84
Pakistan,20/07/2009,89,0,0,0,31,15,0,135
Pakistan,21/07/2009,39,2,-2,0,18,4,0,61
Pakistan,22/07/2009,130,0,0,0,72,17,0,219
Pakistan,23/07/2009,154,2,0,0,65,8,0,229
Pakistan,24/07/2009,99,0,0,0,34,13,0,146
Pakistan,25/07/2009,107,0,0,0,13,31,0,151
Pakistan,26/07/2009,86,0,-2,0,44,10,0,138
Pakistan,27/07/2009,94,0,0,0,56,0,0,150
Pakistan,28/07/2009,155,0,-7,0,75,11,0,234
Pakistan,29/07/2009,196,0,-1,0,135,8,0,338
Pakistan,30/07/2009,156,0,2,0,-14,9,0,153
Pakistan,31/07/2009,131,2,2,0,59,9,0,203
Sierra Leone,01/07/2009,6,0,0,0,0,0,0,6
Sierra Leone,02/07/2009,3,0,0,0,9,0,0,12
Sierra Leone,03/07/2009,2,0,0,0,12,0,0,14
Sierra Leone,04/07/2009,0,0,0,0,0,0,0,0
Sierra Leone,06/07/2009,2,0,0,0,0,0,0,2
Sierra Leone,07/07/2009,5,0,0,0,0,1,0,6
Sierra Leone,08/07/2009,0,0,0,0,6,0,0,6
Sierra Leone,09/07/2009,3,0,-2,0,3,0,0,4
Sierra Leone,10/07/2009,4,0,0,0,0,0,0,4
Sierra Leone,11/07/2009,1,0,0,0,0,0,0,1
Sierra Leone,12/07/2009,2,0,0,0,0,0,0,2
Sierra Leone,13/07/2009,25,0,0,0,7,1,0,33
Sierra Leone,14/07/2009,40,0,0,0,31,4,0,75
Sierra Leone,15/07/2009,7,0,0,0,-2,4,0,9
Sierra Leone,16/07/2009,3,6,0,0,6,2,0,17
Sierra Leone,20/07/2009,16,0,0,0,9,2,0,27
Sierra Leone,21/07/2009,15,0,0,0,3,0,0,18
Sierra Leone,22/07/2009,10,0,0,0,0,0,0,10
Sierra Leone,23/07/2009,8,0,0,0,0,0,0,8
Sierra Leone,24/07/2009,5,0,0,0,6,0,0,11
Sierra Leone,25/07/2009,9,0,0,0,0,0,0,9
Sierra Leone,26/07/2009,0,0,0,0,0,1,0,1
Sierra Leone,27/07/2009,13,0,0,0,3,3,0,19
Sierra Leone,28/07/2009,0,0,0,0,9,0,0,9
Sierra Leone,29/07/2009,1,0,0,0,-2,0,0,-1
Sierra Leone,30/07/2009,5,0,0,0,12,0,0,17
Sierra Leone,31/07/2009,5,0,0,0,0,0,0,5
Somalia,01/07/2009,17,0,2,0,4,1,0,24
Somalia,02/07/2009,24,0,0,0,0,0,0,24
Somalia,03/07/2009,13,0,0,0,12,2,0,27
Somalia,04/07/2009,5,0,0,0,3,0,0,8
Somalia,05/07/2009,9,0,0,0,0,0,0,9
Somalia,06/07/2009,19,0,0,0,-8,0,0,11
Somalia,07/07/2009,22,0,0,0,2,1,0,25
Somalia,08/07/2009,12,0,-2,0,0,0,0,10
Somalia,09/07/2009,8,0,0,0,9,4,0,21
Somalia,10/07/2009,32,0,0,0,3,1,0,36
Somalia,11/07/2009,15,2,0,0,-4,0,0,13
Somalia,12/07/2009,35,0,0,0,9,0,0,44
Somalia,13/07/2009,30,2,0,0,40,3,0,75
Somalia,14/07/2009,29,0,0,0,30,6,0,65
Somalia,15/07/2009,36,0,0,0,12,0,0,48
Somalia,16/07/2009,11,0,0,0,-5,4,0,10
Somalia,17/07/2009,10,2,0,0,33,0,0,45
Somalia,18/07/2009,16,0,0,0,-12,0,0,4
Somalia,19/07/2009,0,0,0,0,2,0,0,2
Somalia,20/07/2009,16,0,0,0,9,2,0,27
Somalia,21/07/2009,29,2,0,0,7,0,0,38
Somalia,22/07/2009,79,0,0,0,9,13,0,101
Somalia,23/07/2009,52,0,0,0,24,0,0,76
Somalia,24/07/2009,105,0,0,0,40,3,0,148
Somalia,25/07/2009,63,0,0,0,38,3,0,104
Somalia,26/07/2009,40,0,0,0,7,0,0,47
Somalia,27/07/2009,77,0,0,0,31,2,0,110
Somalia,28/07/2009,77,0,0,0,-3,15,0,89
Somalia,29/07/2009,72,0,0,0,10,0,0,82
Somalia,30/07/2009,9,0,0,0,37,4,0,50
Somalia,31/07/2009,38,0,-1,0,29,3,0,69
Syria,01/07/2009,1,0,0,0,16,0,0,17
Syria,02/07/2009,6,0,2,0,12,0,0,20
Syria,03/07/2009,6,0,1,0,0,1,0,8
Syria,04/07/2009,0,0,0,0,9,0,0,9
Syria,05/07/2009,8,0,0,0,0,0,0,8
Syria,06/07/2009,19,0,0,0,-2,0,0,17
Syria,07/07/2009,7,0,0,0,3,0,0,10
Syria,08/07/2009,-2,0,0,0,0,0,0,-2
Syria,09/07/2009,12,0,0,0,3,6,0,21
Syria,10/07/2009,15,0,0,0,-6,2,0,11
Syria,11/07/2009,-6,0,0,0,0,0,0,-6
Syria,12/07/2009,1,0,0,0,0,0,0,1
Syria,13/07/2009,35,0,0,0,36,0,0,71
Syria,14/07/2009,15,0,0,0,24,0,0,39
Syria,15/07/2009,19,0,0,0,18,0,0,37
Syria,16/07/2009,18,0,0,0,0,0,0,18
Syria,17/07/2009,7,0,0,0,0,2,0,9
Syria,18/07/2009,0,0,0,0,0,0,0,0
Syria,19/07/2009,3,0,0,0,3,0,0,6
Syria,20/07/2009,6,0,0,0,0,0,0,6
Syria,21/07/2009,7,0,0,0,15,0,0,22
Syria,22/07/2009,4,0,0,0,3,1,0,8
Syria,23/07/2009,12,0,0,0,6,0,0,18
Syria,24/07/2009,34,0,0,0,34,0,0,68
Syria,25/07/2009,19,0,3,0,3,0,0,25
Syria,26/07/2009,9,0,1,0,7,0,0,17
Syria,27/07/2009,18,0,0,0,6,0,0,24
Syria,28/07/2009,8,0,0,0,3,1,0,12
Syria,29/07/2009,22,0,0,0,-2,7,0,27
Syria,30/07/2009,26,0,0,0,19,9,0,54
Syria,31/07/2009,1,2,0,0,15,1,0,19
Yemen,01/07/2009,20,0,0,0,17,0,0,37
Yemen,02/07/2009,4,0,0,0,12,0,0,16
Yemen,03/07/2009,11,0,2,0,0,0,0,13
Yemen,04/07/2009,3,0,0,0,6,2,0,11
Yemen,05/07/2009,4,0,0,0,0,2,0,6
Yemen,06/07/2009,7,0,2,0,3,2,0,14
Yemen,07/07/2009,5,0,1,0,15,6,0,27
Yemen,08/07/2009,-1,0,0,0,0,0,0,-1
Yemen,09/07/2009,1,0,0,0,1,0,0,2
Yemen,10/07/2009,0,0,0,0,0,0,0,0
Yemen,11/07/2009,0,0,0,0,0,0,0,0
Yemen,12/07/2009,0,0,0,0,0,0,0,0
Yemen,13/07/2009,17,0,0,0,28,4,0,49
Yemen,14/07/2009,21,0,0,0,7,1,0,29
Yemen,15/07/2009,24,0,0,0,-1,3,0,26
Yemen,16/07/2009,0,0,0,0,-2,5,0,3
Yemen,17/07/2009,2,0,0,0,0,4,0,6
Yemen,18/07/2009,2,0,0,0,0,0,0,2
Yemen,19/07/2009,0,0,0,0,0,0,0,0
Yemen,20/07/2009,-2,0,0,0,0,0,0,-2
Yemen,21/07/2009,12,0,0,0,0,0,0,12
Yemen,22/07/2009,6,0,0,0,-5,0,0,1
Yemen,23/07/2009,5,0,0,0,1,0,0,6
Yemen,24/07/2009,27,0,0,0,1,6,0,34
Yemen,25/07/2009,1,0,0,0,0,0,0,1
Yemen,26/07/2009,10,0,0,0,0,0,0,10
Yemen,27/07/2009,6,0,0,0,21,1,0,28
Yemen,28/07/2009,27,4,0,0,-1,6,0,36
Yemen,29/07/2009,5,2,0,0,-4,0,0,3
Yemen,30/07/2009,3,0,0,0,3,1,0,7
Yemen,31/07/2009,2,0,0,0,6,0,0,8
Afghanistan,01/08/2007,233,0,0,0,78,17,0,328
Afghanistan,02/08/2007,70,0,0,0,20,3,0,93
Afghanistan,03/08/2007,53,0,0,0,42,2,0,97
Afghanistan,04/08/2007,123,6,0,0,9,34,0,172
Afghanistan,05/08/2007,93,0,0,0,54,6,0,153
Afghanistan,06/08/2007,125,0,-3,0,21,18,0,161
Afghanistan,07/08/2007,171,0,-2,0,14,12,0,195
Afghanistan,08/08/2007,131,0,-4,0,12,5,0,144
Afghanistan,09/08/2007,49,0,0,0,18,4,0,71
Afghanistan,10/08/2007,78,0,0,0,-2,9,0,85
Afghanistan,11/08/2007,66,0,-1,0,-25,4,0,44
Afghanistan,12/08/2007,97,2,0,0,-2,3,0,100
Afghanistan,13/08/2007,96,0,0,0,33,16,0,145
Afghanistan,14/08/2007,65,0,0,0,-5,7,0,67
Afghanistan,15/08/2007,105,0,0,0,7,9,0,121
Afghanistan,16/08/2007,117,0,0,0,55,12,0,184
Afghanistan,17/08/2007,171,0,0,0,33,67,0,271
Afghanistan,18/08/2007,135,0,0,0,54,25,0,214
Afghanistan,19/08/2007,88,0,0,0,6,3,0,97
Afghanistan,20/08/2007,73,0,0,0,-19,7,0,61
Afghanistan,21/08/2007,68,0,0,0,-5,10,0,73
Afghanistan,22/08/2007,111,0,1,0,28,11,0,151
Afghanistan,23/08/2007,143,8,0,0,14,6,0,171
Afghanistan,24/08/2007,128,0,2,0,9,22,0,161
Afghanistan,25/08/2007,96,0,0,0,33,5,0,134
Afghanistan,26/08/2007,122,0,7,0,10,10,0,149
Afghanistan,27/08/2007,71,0,0,0,-2,4,0,73
Afghanistan,28/08/2007,63,0,-4,0,-5,5,0,59
Afghanistan,29/08/2007,38,0,0,0,-1,0,0,37
Afghanistan,30/08/2007,25,0,0,0,-6,9,0,28
Afghanistan,31/08/2007,57,0,0,0,-13,2,0,46
Albania,01/08/2007,10,0,0,0,0,1,0,11
Albania,02/08/2007,-1,0,0,0,0,0,0,-1
Albania,03/08/2007,1,0,0,0,0,0,0,1
Albania,04/08/2007,2,0,0,0,0,0,0,2
Albania,05/08/2007,50,0,0,0,0,0,0,50
Albania,06/08/2007,40,0,-3,0,0,0,0,37
Albania,07/08/2007,17,0,0,0,0,2,0,19
Albania,08/08/2007,5,0,-2,0,7,2,0,12
Albania,09/08/2007,6,0,-1,0,0,0,0,5
Albania,10/08/2007,5,0,-1,0,3,2,0,9
Albania,11/08/2007,8,0,-2,0,3,1,0,10
Albania,12/08/2007,10,0,-6,0,6,1,0,11
Albania,13/08/2007,18,0,-3,0,0,0,0,15
Albania,14/08/2007,8,0,-1,0,-2,2,0,7
Albania,15/08/2007,13,0,0,0,-2,0,0,11
Albania,16/08/2007,17,0,0,0,3,1,0,21
Albania,17/08/2007,2,0,0,0,0,0,0,2
Albania,18/08/2007,4,4,0,0,-4,0,0,4
Albania,19/08/2007,6,0,0,0,0,0,0,6
Albania,20/08/2007,4,0,0,0,0,0,0,4
Albania,21/08/2007,22,0,-3,0,0,2,0,21
Albania,22/08/2007,0,0,-1,0,0,0,0,-1
Albania,23/08/2007,6,0,0,0,0,4,0,10
Albania,24/08/2007,40,0,0,0,6,1,0,47
Albania,25/08/2007,8,0,0,0,0,0,0,8
Albania,26/08/2007,2,0,-1,0,3,0,0,4
Albania,27/08/2007,11,0,0,0,0,0,0,11
Albania,28/08/2007,19,0,-4,0,0,0,0,15
Albania,29/08/2007,4,0,3,0,2,0,0,9
Albania,30/08/2007,11,0,-3,0,6,0,0,14
Albania,31/08/2007,8,0,0,0,0,0,0,8
Algeria,01/08/2007,0,0,0,0,3,0,0,3
Algeria,02/08/2007,0,0,0,0,45,0,0,45
Algeria,03/08/2007,2,0,0,0,0,0,0,2
Algeria,04/08/2007,0,0,0,0,3,0,0,3
Algeria,05/08/2007,0,0,0,0,0,0,0,0
Algeria,06/08/2007,-2,0,0,0,0,0,0,-2
Algeria,07/08/2007,4,4,0,0,6,0,0,14
Algeria,08/08/2007,8,0,0,0,10,0,0,18
Algeria,09/08/2007,0,0,0,0,0,2,0,2
Algeria,10/08/2007,4,0,0,0,3,2,0,9
Algeria,11/08/2007,0,0,0,0,0,0,0,0
Algeria,12/08/2007,8,0,0,0,9,0,0,17
Algeria,13/08/2007,4,0,0,0,3,0,0,7
Algeria,14/08/2007,0,0,0,0,0,0,0,0
Algeria,15/08/2007,0,0,0,0,12,0,0,12
Algeria,16/08/2007,0,0,0,0,0,0,0,0
Algeria,17/08/2007,0,0,0,0,0,0,0,0
Algeria,18/08/2007,0,0,0,0,9,0,0,9
Algeria,19/08/2007,0,0,0,0,0,0,0,0
Algeria,20/08/2007,6,0,0,0,0,0,0,6
Algeria,21/08/2007,16,0,0,0,3,0,0,19
Algeria,22/08/2007,3,0,0,0,0,0,0,3
Algeria,23/08/2007,14,0,0,0,6,4,0,24
Algeria,24/08/2007,0,0,0,0,0,0,0,0
Algeria,25/08/2007,6,0,0,0,-4,0,0,2
Algeria,26/08/2007,3,0,0,0,0,0,0,3
Algeria,27/08/2007,-1,0,0,0,0,0,0,-1
Algeria,28/08/2007,0,0,0,0,0,0,0,0
Algeria,29/08/2007,-8,0,0,0,18,0,0,10
Algeria,30/08/2007,2,0,0,0,0,6,0,8
Bangladesh,01/08/2007,0,0,0,0,3,0,0,3
Bangladesh,02/08/2007,19,0,0,0,12,0,0,31
Bangladesh,03/08/2007,19,0,0,0,0,0,0,19
Bangladesh,04/08/2007,17,0,0,0,3,0,0,20
Bangladesh,05/08/2007,9,0,0,0,1,1,0,11
Bangladesh,06/08/2007,20,4,0,0,4,6,0,34
Bangladesh,07/08/2007,-1,0,0,0,0,2,0,1
Bangladesh,08/08/2007,9,8,0,0,0,0,0,17
Bangladesh,09/08/2007,-1,0,0,0,-10,12,0,1
Bangladesh,10/08/2007,30,2,0,0,5,4,0,41
Bangladesh,11/08/2007,29,0,0,0,-4,6,0,31
Bangladesh,12/08/2007,43,0,0,0,6,5,0,54
Bangladesh,13/08/2007,7,0,1,0,11,6,0,25
Bangladesh,14/08/2007,8,0,0,0,6,0,0,14
Bangladesh,15/08/2007,7,0,0,0,0,0,0,7
Bangladesh,16/08/2007,3,0,0,0,0,0,0,3
Bangladesh,17/08/2007,11,0,0,0,3,6,0,20
Bangladesh,18/08/2007,4,0,1,0,0,0,0,5
Bangladesh,19/08/2007,0,0,0,0,6,0,0,6
Bangladesh,20/08/2007,6,0,0,0,12,1,0,19
Bangladesh,21/08/2007,7,0,-6,0,15,0,0,16
Bangladesh,22/08/2007,21,0,0,0,0,1,0,22
Bangladesh,23/08/2007,9,0,0,0,10,6,0,25
Bangladesh,24/08/2007,6,0,0,0,3,1,0,10
Bangladesh,25/08/2007,1,0,0,0,12,0,0,13
Bangladesh,26/08/2007,35,0,0,0,3,2,0,40
Bangladesh,27/08/2007,12,0,0,0,42,0,0,54
Bangladesh,28/08/2007,11,0,0,0,21,9,0,41
Bangladesh,29/08/2007,8,0,-4,0,3,0,0,7
Bangladesh,30/08/2007,9,0,0,0,-5,1,0,5
Bangladesh,31/08/2007,0,0,0,0,3,0,0,3
Cameroon,01/08/2007,0,0,0,0,0,0,0,0
Cameroon,02/08/2007,0,0,0,0,0,0,0,0
Cameroon,03/08/2007,8,0,0,0,0,0,0,8
Cameroon,07/08/2007,0,0,0,0,0,0,0,0
Cameroon,09/08/2007,0,0,0,0,0,0,0,0
Cameroon,10/08/2007,0,0,0,0,0,0,0,0
Cameroon,11/08/2007,3,0,0,0,3,0,0,6
Cameroon,12/08/2007,2,0,0,0,0,0,0,2
Cameroon,15/08/2007,1,0,0,0,-4,0,0,-3
Cameroon,16/08/2007,1,0,0,0,0,0,0,1
Cameroon,19/08/2007,0,0,0,0,0,0,0,0
Cameroon,22/08/2007,0,0,0,0,0,0,0,0
Cameroon,23/08/2007,0,0,0,0,0,0,0,0
Cameroon,24/08/2007,0,0,0,0,0,0,0,0
Cameroon,31/08/2007,0,0,0,0,0,0,0,0
China,01/08/2007,42,0,2,0,16,20,0,80
China,02/08/2007,23,0,0,0,24,4,0,51
China,03/08/2007,35,0,-4,0,3,1,0,35
China,04/08/2007,11,0,2,0,4,1,0,18
China,05/08/2007,18,0,-2,0,19,0,0,35
China,06/08/2007,65,2,-1,0,32,9,0,107
China,07/08/2007,36,0,0,0,22,2,0,60
China,08/08/2007,85,0,0,0,21,3,0,109
China,09/08/2007,9,0,0,0,6,12,0,27
China,10/08/2007,57,2,1,0,-1,5,0,64
China,11/08/2007,42,0,-2,0,-1,3,0,42
China,12/08/2007,31,0,0,0,4,6,0,41
China,13/08/2007,8,0,0,0,18,7,0,33
China,14/08/2007,28,0,1,0,30,8,0,67
China,15/08/2007,40,0,0,0,17,9,0,66
China,16/08/2007,75,2,0,0,23,9,0,109
China,17/08/2007,58,0,-2,0,1,5,0,62
China,18/08/2007,26,0,0,0,7,2,0,35
China,19/08/2007,18,0,0,0,8,4,0,30
China,20/08/2007,90,0,0,0,-4,2,0,88
China,21/08/2007,58,4,0,0,61,12,0,135
China,22/08/2007,187,0,0,0,9,11,0,207
China,23/08/2007,87,0,0,0,26,4,0,117
China,24/08/2007,25,0,1,0,14,0,0,40
China,25/08/2007,2,0,0,0,-16,0,0,-14
China,26/08/2007,8,0,0,0,-1,1,0,8
China,27/08/2007,18,0,0,0,0,0,0,18
China,28/08/2007,12,0,0,0,3,0,0,15
China,29/08/2007,23,0,0,0,0,4,0,27
China,30/08/2007,6,0,0,0,8,0,0,14
China,31/08/2007,4,0,-2,0,25,10,0,37
Egypt,01/08/2007,33,0,0,0,-24,8,0,17
Egypt,02/08/2007,42,0,0,0,10,18,0,70
Egypt,03/08/2007,20,0,0,0,4,0,0,24
Egypt,04/08/2007,12,0,0,0,2,0,0,14
Egypt,05/08/2007,32,0,0,0,-4,1,0,29
Egypt,06/08/2007,5,0,0,0,7,0,0,12
Egypt,07/08/2007,13,0,0,0,5,0,0,18
Egypt,08/08/2007,50,0,4,0,36,4,0,94
Egypt,09/08/2007,-6,0,0,0,-2,0,0,-8
Egypt,10/08/2007,37,0,0,0,15,0,0,52
Egypt,11/08/2007,33,0,0,0,1,0,0,34
Egypt,12/08/2007,7,0,0,0,-2,0,0,5
Egypt,13/08/2007,3,0,0,0,-1,0,0,2
Egypt,14/08/2007,9,0,0,0,6,0,0,15
Egypt,15/08/2007,10,0,0,0,-3,4,0,11
Egypt,16/08/2007,8,0,0,0,12,0,0,20
Egypt,17/08/2007,11,0,0,0,15,2,0,28
Egypt,18/08/2007,0,0,0,0,0,0,0,0
Egypt,19/08/2007,13,0,0,0,1,0,0,14
Egypt,20/08/2007,13,0,0,0,5,0,0,18
Egypt,21/08/2007,13,0,0,0,9,0,0,22
Egypt,22/08/2007,13,0,0,0,4,1,0,18
Egypt,23/08/2007,43,0,0,0,44,2,0,89
Egypt,24/08/2007,36,0,0,0,3,6,0,45
Egypt,25/08/2007,20,2,0,0,-3,0,0,19
Egypt,26/08/2007,21,0,0,0,-2,0,0,19
Egypt,27/08/2007,7,0,-8,0,3,0,0,2
Egypt,28/08/2007,12,0,0,0,16,0,0,28
Egypt,29/08/2007,1,0,0,0,6,1,0,8
Egypt,30/08/2007,-1,0,0,0,22,0,0,21
Egypt,31/08/2007,4,0,0,0,7,0,0,11
Eritrea,03/08/2007,0,0,0,0,0,0,0,0
Eritrea,04/08/2007,6,0,2,0,0,0,0,8
Eritrea,05/08/2007,0,0,0,0,0,0,0,0
Eritrea,06/08/2007,2,0,0,0,0,0,0,2
Eritrea,08/08/2007,0,0,0,0,6,0,0,6
Eritrea,11/08/2007,0,0,0,0,0,0,0,0
Eritrea,13/08/2007,0,0,0,0,0,0,0,0
Eritrea,15/08/2007,0,0,0,0,0,0,0,0
Eritrea,16/08/2007,0,0,0,0,0,0,0,0
Eritrea,17/08/2007,0,0,0,0,6,0,0,6
Eritrea,18/08/2007,0,0,0,0,0,0,0,0
Eritrea,20/08/2007,5,0,0,0,0,0,0,5
Eritrea,21/08/2007,1,0,0,0,3,0,0,4
Eritrea,22/08/2007,25,0,0,0,0,0,0,25
Eritrea,23/08/2007,0,0,0,0,0,0,0,0
Eritrea,24/08/2007,6,0,0,0,0,0,0,6
Eritrea,25/08/2007,1,0,0,0,0,0,0,1
Eritrea,26/08/2007,1,0,0,0,0,0,0,1
Eritrea,28/08/2007,1,0,0,0,0,0,0,1
Eritrea,29/08/2007,0,0,0,0,0,0,0,0
Eritrea,30/08/2007,21,0,0,0,-12,0,0,9
Eritrea,31/08/2007,0,0,0,0,0,0,0,0
Georgia,01/08/2007,9,0,0,0,-2,1,0,8
Georgia,02/08/2007,1,0,0,0,0,0,0,1
Georgia,03/08/2007,4,0,0,0,0,0,0,4
Georgia,04/08/2007,0,4,0,0,6,0,0,10
Georgia,05/08/2007,0,0,0,0,0,0,0,0
Georgia,06/08/2007,5,0,0,0,6,0,0,11
Georgia,07/08/2007,0,0,0,0,0,0,0,0
Georgia,08/08/2007,6,0,0,0,12,0,0,18
Georgia,09/08/2007,1,0,0,0,0,0,0,1
Georgia,10/08/2007,10,0,-2,0,19,1,0,28
Georgia,11/08/2007,0,0,0,0,0,0,0,0
Georgia,12/08/2007,3,0,0,0,0,0,0,3
Georgia,13/08/2007,21,0,0,0,0,0,0,21
Georgia,14/08/2007,0,0,0,0,3,0,0,3
Georgia,15/08/2007,4,0,0,0,0,0,0,4
Georgia,16/08/2007,2,0,0,0,6,0,0,8
Georgia,17/08/2007,1,0,0,0,0,3,0,4
Georgia,18/08/2007,6,0,0,0,0,2,0,8
Georgia,19/08/2007,4,0,0,0,0,0,0,4
Georgia,20/08/2007,5,0,0,0,9,0,0,14
Georgia,21/08/2007,5,0,-4,0,3,4,0,8
Georgia,22/08/2007,23,0,0,0,5,4,0,32
Georgia,23/08/2007,3,0,0,0,0,1,0,4
Georgia,24/08/2007,28,0,1,0,21,2,0,52
Georgia,25/08/2007,1,0,0,0,12,2,0,15
Georgia,26/08/2007,0,0,0,0,3,0,0,3
Georgia,27/08/2007,0,0,0,0,0,0,0,0
Georgia,28/08/2007,0,0,0,0,0,0,0,0
Georgia,29/08/2007,0,0,0,0,3,0,0,3
Georgia,30/08/2007,0,0,0,0,0,0,0,0
Georgia,31/08/2007,3,0,0,0,0,0,0,3
India,01/08/2007,20,0,8,0,0,1,0,29
India,02/08/2007,16,0,1,0,5,0,0,22
India,03/08/2007,44,2,0,0,31,12,0,89
India,04/08/2007,13,0,0,0,-4,0,0,9
India,05/08/2007,26,0,0,0,7,0,0,33
India,06/08/2007,24,0,0,0,10,0,0,34
India,07/08/2007,4,0,0,0,0,0,0,4
India,08/08/2007,13,4,0,0,24,6,0,47
India,09/08/2007,12,0,0,0,0,0,0,12
India,10/08/2007,20,0,0,0,22,1,0,43
India,11/08/2007,27,0,0,0,7,0,0,34
India,12/08/2007,16,0,0,0,-2,0,0,14
India,13/08/2007,24,0,-2,0,-8,3,0,17
India,14/08/2007,22,0,0,0,2,0,0,24
India,15/08/2007,20,0,0,0,18,0,0,38
India,16/08/2007,3,0,-2,0,1,3,0,5
India,17/08/2007,28,0,0,0,7,0,0,35
India,18/08/2007,6,0,1,0,9,0,0,16
India,19/08/2007,0,0,0,0,6,0,0,6
India,20/08/2007,25,0,0,0,3,0,0,28
India,21/08/2007,33,2,-4,0,-2,5,0,34
India,22/08/2007,49,0,0,0,6,6,0,61
India,23/08/2007,9,0,0,0,-2,3,0,10
India,24/08/2007,12,4,0,0,4,3,0,23
India,25/08/2007,27,0,-2,0,12,1,0,38
India,26/08/2007,21,0,0,0,-2,1,0,20
India,27/08/2007,-4,0,0,0,3,0,0,-1
India,28/08/2007,10,0,0,0,1,0,0,11
India,29/08/2007,0,0,0,0,0,0,0,0
India,30/08/2007,3,0,0,0,0,0,0,3
India,31/08/2007,6,0,0,0,4,1,0,11
Iran,01/08/2007,31,0,0,0,6,3,0,40
Iran,02/08/2007,30,0,0,0,4,2,0,36
Iran,03/08/2007,8,0,0,0,12,5,0,25
Iran,04/08/2007,8,0,0,0,36,9,0,53
Iran,05/08/2007,16,0,0,0,-5,2,0,13
Iran,06/08/2007,64,0,2,0,28,4,0,98
Iran,07/08/2007,13,0,-2,0,5,2,0,18
Iran,08/08/2007,15,0,1,0,0,2,0,18
Iran,09/08/2007,-13,0,0,0,12,0,0,-1
Iran,10/08/2007,11,0,0,0,9,1,0,21
Iran,11/08/2007,0,0,0,0,-4,7,0,3
Iran,12/08/2007,48,2,-2,0,3,0,0,51
Iran,13/08/2007,50,4,0,0,27,4,0,85
Iran,14/08/2007,62,0,2,0,18,0,0,82
Iran,15/08/2007,45,0,0,0,24,6,0,75
Iran,16/08/2007,40,0,0,0,15,6,0,61
Iran,17/08/2007,10,0,0,0,0,3,0,13
Iran,18/08/2007,25,0,0,0,1,0,0,26
Iran,19/08/2007,30,0,-2,0,3,2,0,33
Iran,20/08/2007,22,0,0,0,7,1,0,30
Iran,21/08/2007,58,0,1,0,-3,9,0,65
Iran,22/08/2007,46,0,3,0,17,19,0,85
Iran,23/08/2007,43,0,-2,0,28,4,0,73
Iran,24/08/2007,32,0,0,0,0,0,0,32
Iran,25/08/2007,15,0,1,0,1,8,0,25
Iran,26/08/2007,39,0,0,0,7,0,0,46
Iran,27/08/2007,13,0,0,0,3,2,0,18
Iran,28/08/2007,10,0,0,0,9,1,0,20
Iran,29/08/2007,24,0,0,0,4,5,0,33
Iran,30/08/2007,17,0,-1,0,-2,0,0,14
Iran,31/08/2007,7,0,0,0,9,4,0,20
Iraq,01/08/2007,288,0,-2,0,43,19,0,348
Iraq,02/08/2007,97,0,-8,0,50,26,0,165
Iraq,03/08/2007,290,2,-6,0,192,57,0,535
Iraq,04/08/2007,96,0,0,0,34,14,0,144
Iraq,05/08/2007,192,2,-6,0,18,23,0,229
Iraq,06/08/2007,150,0,-15,0,23,19,0,177
Iraq,07/08/2007,100,0,1,0,-7,6,0,100
Iraq,08/08/2007,142,2,1,0,11,15,0,171
Iraq,09/08/2007,14,0,0,0,5,0,0,19
Iraq,10/08/2007,160,2,-4,0,18,5,0,181
Iraq,11/08/2007,65,0,-2,0,7,13,0,83
Iraq,12/08/2007,75,0,0,0,10,15,0,100
Iraq,13/08/2007,129,0,-4,0,55,6,0,186
Iraq,14/08/2007,113,0,-6,0,11,2,0,120
Iraq,15/08/2007,113,6,2,0,27,16,0,164
Iraq,16/08/2007,128,0,0,0,15,22,0,165
Iraq,17/08/2007,106,2,0,0,36,6,0,150
Iraq,18/08/2007,117,0,-1,0,50,9,0,175
Iraq,19/08/2007,52,0,0,0,64,6,0,122
Iraq,20/08/2007,162,0,3,0,59,16,0,240
Iraq,21/08/2007,110,12,0,0,114,32,0,268
Iraq,22/08/2007,76,14,4,0,74,38,0,206
Iraq,23/08/2007,118,2,-2,0,31,14,0,163
Iraq,24/08/2007,148,0,-2,0,72,13,0,231
Iraq,25/08/2007,86,0,0,0,26,10,0,122
Iraq,26/08/2007,66,4,-8,0,7,39,0,108
Iraq,27/08/2007,47,0,-12,0,24,11,0,70
Iraq,28/08/2007,34,0,1,0,-2,5,0,38
Iraq,29/08/2007,41,0,1,0,7,2,0,51
Iraq,30/08/2007,24,14,0,0,6,0,0,44
Iraq,31/08/2007,58,0,0,0,-2,4,0,60
Morocco,01/08/2007,0,0,0,0,9,0,0,9
Morocco,02/08/2007,2,0,0,0,0,0,0,2
Morocco,03/08/2007,0,0,0,0,1,0,0,1
Morocco,04/08/2007,0,0,0,0,1,0,0,1
Morocco,05/08/2007,0,0,0,0,0,0,0,0
Morocco,06/08/2007,1,0,0,0,29,0,0,30
Morocco,07/08/2007,-6,0,0,0,9,0,0,3
Morocco,08/08/2007,13,0,0,0,7,0,0,20
Morocco,09/08/2007,12,0,0,0,12,0,0,24
Morocco,10/08/2007,-10,0,0,0,15,0,0,5
Morocco,11/08/2007,0,0,0,0,15,0,0,15
Morocco,12/08/2007,2,0,0,0,12,0,0,14
Morocco,13/08/2007,0,0,0,0,0,0,0,0
Morocco,14/08/2007,5,0,0,0,0,0,0,5
Morocco,15/08/2007,11,0,0,0,42,0,0,53
Morocco,16/08/2007,5,0,0,0,0,0,0,5
Morocco,17/08/2007,0,0,0,0,0,0,0,0
Morocco,18/08/2007,3,0,0,0,0,0,0,3
Morocco,19/08/2007,0,0,0,0,0,0,0,0
Morocco,20/08/2007,2,0,0,0,0,0,0,2
Morocco,21/08/2007,-1,0,0,0,6,0,0,5
Morocco,22/08/2007,15,0,0,0,22,1,0,38
Morocco,23/08/2007,9,0,0,0,3,0,0,12
Morocco,24/08/2007,37,0,-2,0,0,0,0,35
Morocco,25/08/2007,0,0,0,0,0,0,0,0
Morocco,26/08/2007,0,0,0,0,0,0,0,0
Morocco,27/08/2007,6,0,0,0,0,0,0,6
Morocco,28/08/2007,0,0,2,0,0,0,0,2
Morocco,31/08/2007,0,0,0,0,0,0,0,0
Nigeria,01/08/2007,-9,0,0,0,0,0,0,-9
Nigeria,02/08/2007,-3,0,0,0,0,0,0,-3
Nigeria,03/08/2007,31,0,0,0,15,0,0,46
Nigeria,04/08/2007,0,0,0,0,0,0,0,0
Nigeria,05/08/2007,0,0,0,0,3,0,0,3
Nigeria,06/08/2007,3,0,0,0,6,0,0,9
Nigeria,07/08/2007,0,0,0,0,0,0,0,0
Nigeria,08/08/2007,8,0,0,0,9,0,0,17
Nigeria,09/08/2007,0,0,0,0,30,5,0,35
Nigeria,10/08/2007,7,4,0,0,6,1,0,18
Nigeria,11/08/2007,0,0,0,0,3,1,0,4
Nigeria,12/08/2007,4,0,0,0,0,0,0,4
Nigeria,13/08/2007,8,0,0,0,6,0,0,14
Nigeria,14/08/2007,1,0,0,0,0,0,0,1
Nigeria,15/08/2007,7,0,0,0,0,1,0,8
Nigeria,16/08/2007,22,0,0,0,3,1,0,26
Nigeria,17/08/2007,7,0,0,0,9,0,0,16
Nigeria,18/08/2007,0,0,0,0,6,0,0,6
Nigeria,19/08/2007,12,0,0,0,0,2,0,14
Nigeria,20/08/2007,9,0,0,0,12,0,0,21
Nigeria,21/08/2007,24,0,0,0,3,4,0,31
Nigeria,22/08/2007,18,0,0,0,6,3,0,27
Nigeria,23/08/2007,19,0,0,0,-2,1,0,18
Nigeria,24/08/2007,4,0,0,0,3,1,0,8
Nigeria,25/08/2007,0,0,0,0,0,0,0,0
Nigeria,26/08/2007,0,0,0,0,0,0,0,0
Nigeria,27/08/2007,-2,0,0,0,0,0,0,-2
Nigeria,28/08/2007,4,0,0,0,0,0,0,4
Nigeria,29/08/2007,0,0,0,0,0,0,0,0
Nigeria,30/08/2007,4,0,0,0,0,0,0,4
Nigeria,31/08/2007,2,0,0,0,0,0,0,2
Pakistan,01/08/2007,38,0,0,0,12,4,0,54
Pakistan,02/08/2007,30,0,1,0,19,6,0,56
Pakistan,03/08/2007,59,0,2,0,65,4,0,130
Pakistan,04/08/2007,28,0,-1,0,25,3,0,55
Pakistan,05/08/2007,77,4,0,0,17,2,0,100
Pakistan,06/08/2007,80,0,1,0,14,6,0,101
Pakistan,07/08/2007,27,0,0,0,27,4,0,58
Pakistan,08/08/2007,42,0,0,0,19,0,0,61
Pakistan,09/08/2007,27,0,-4,0,19,4,0,46
Pakistan,10/08/2007,64,8,-2,0,3,3,0,76
Pakistan,11/08/2007,30,0,0,0,13,6,0,49
Pakistan,12/08/2007,67,2,0,0,-4,2,0,67
Pakistan,13/08/2007,54,0,0,0,-4,8,0,58
Pakistan,14/08/2007,23,0,-4,0,0,0,0,19
Pakistan,15/08/2007,50,0,0,0,31,5,0,86
Pakistan,16/08/2007,68,0,-2,0,64,3,0,133
Pakistan,17/08/2007,28,0,-2,0,3,2,0,31
Pakistan,18/08/2007,23,0,0,0,32,4,0,59
Pakistan,19/08/2007,34,0,0,0,-5,8,0,37
Pakistan,20/08/2007,36,0,0,0,-16,7,0,27
Pakistan,21/08/2007,20,0,0,0,15,1,0,36
Pakistan,22/08/2007,47,0,1,0,28,2,0,78
Pakistan,23/08/2007,26,2,-2,0,-2,1,0,25
Pakistan,24/08/2007,34,0,-1,0,32,1,0,66
Pakistan,25/08/2007,22,0,-4,0,8,1,0,27
Pakistan,26/08/2007,79,0,-3,0,47,8,0,131
Pakistan,27/08/2007,62,0,-2,0,4,0,0,64
Pakistan,28/08/2007,29,0,0,0,8,0,0,37
Pakistan,29/08/2007,14,0,-2,0,-6,0,0,6
Pakistan,30/08/2007,34,0,-12,0,6,0,0,28
Pakistan,31/08/2007,4,0,0,0,6,2,0,12
Sierra Leone,01/08/2007,0,0,0,0,0,0,0,0
Sierra Leone,02/08/2007,6,0,0,0,18,5,0,29
Sierra Leone,03/08/2007,2,0,0,0,6,0,0,8
Sierra Leone,04/08/2007,0,0,0,0,0,0,0,0
Sierra Leone,05/08/2007,0,0,0,0,9,0,0,9
Sierra Leone,06/08/2007,2,0,0,0,0,6,0,8
Sierra Leone,07/08/2007,-1,0,0,0,0,0,0,-1
Sierra Leone,08/08/2007,0,0,0,0,0,0,0,0
Sierra Leone,09/08/2007,2,0,0,0,-4,0,0,-2
Sierra Leone,10/08/2007,0,0,1,0,0,0,0,1
Sierra Leone,11/08/2007,6,0,0,0,4,2,0,12
Sierra Leone,12/08/2007,7,0,-6,0,0,1,0,2
Sierra Leone,13/08/2007,4,0,-6,0,0,4,0,2
Sierra Leone,14/08/2007,2,0,0,0,0,0,0,2
Sierra Leone,15/08/2007,3,0,0,0,0,0,0,3
Sierra Leone,16/08/2007,5,0,0,0,15,0,0,20
Sierra Leone,18/08/2007,0,0,0,0,6,1,0,7
Sierra Leone,19/08/2007,0,0,0,0,6,0,0,6
Sierra Leone,20/08/2007,2,0,-4,0,17,0,0,15
Sierra Leone,21/08/2007,0,0,0,0,6,0,0,6
Sierra Leone,22/08/2007,4,0,-4,0,0,0,0,0
Sierra Leone,23/08/2007,0,0,0,0,0,0,0,0
Sierra Leone,24/08/2007,0,0,0,0,-2,0,0,-2
Sierra Leone,25/08/2007,3,0,0,0,6,0,0,9
Sierra Leone,27/08/2007,0,0,0,0,0,0,0,0
Sierra Leone,29/08/2007,0,0,0,0,0,0,0,0
Somalia,01/08/2007,17,0,0,0,18,3,0,38
Somalia,02/08/2007,12,0,0,0,6,0,0,18
Somalia,03/08/2007,8,0,0,0,3,8,0,19
Somalia,04/08/2007,5,0,0,0,0,0,0,5
Somalia,05/08/2007,1,0,0,0,-6,0,0,-5
Somalia,06/08/2007,5,0,0,0,0,2,0,7
Somalia,07/08/2007,0,0,0,0,0,0,0,0
Somalia,08/08/2007,0,0,0,0,0,0,0,0
Somalia,09/08/2007,2,0,0,0,0,0,0,2
Somalia,10/08/2007,5,0,0,0,3,0,0,8
Somalia,11/08/2007,7,0,0,0,6,0,0,13
Somalia,12/08/2007,2,0,0,0,0,0,0,2
Somalia,13/08/2007,10,0,0,0,11,0,0,21
Somalia,14/08/2007,37,0,0,0,-4,0,0,33
Somalia,15/08/2007,13,0,0,0,6,0,0,19
Somalia,16/08/2007,6,0,0,0,0,3,0,9
Somalia,17/08/2007,-2,0,0,0,6,0,0,4
Somalia,18/08/2007,4,0,0,0,0,2,0,6
Somalia,19/08/2007,-1,0,0,0,0,2,0,1
Somalia,20/08/2007,6,0,0,0,-6,0,0,0
Somalia,21/08/2007,5,0,0,0,0,0,0,5
Somalia,22/08/2007,-3,0,0,0,-19,6,0,-16
Somalia,23/08/2007,3,0,0,0,-13,4,0,-6
Somalia,24/08/2007,22,0,0,0,0,0,0,22
Somalia,25/08/2007,-1,0,0,0,0,0,0,-1
Somalia,26/08/2007,0,0,0,0,0,2,0,2
Somalia,27/08/2007,8,0,0,0,0,0,0,8
Somalia,28/08/2007,3,0,0,0,12,2,0,17
Somalia,29/08/2007,0,4,0,0,6,2,0,12
Somalia,30/08/2007,8,0,0,0,0,0,0,8
Somalia,31/08/2007,0,0,0,0,0,0,0,0
Syria,01/08/2007,9,0,0,0,0,0,0,9
Syria,02/08/2007,3,0,0,0,0,0,0,3
Syria,03/08/2007,23,0,1,0,2,0,0,26
Syria,04/08/2007,26,0,1,0,15,2,0,44
Syria,05/08/2007,13,0,0,0,0,5,0,18
Syria,06/08/2007,52,0,0,0,12,1,0,65
Syria,07/08/2007,15,0,0,0,-6,0,0,9
Syria,08/08/2007,12,0,0,0,1,0,0,13
Syria,09/08/2007,-1,0,0,0,16,0,0,15
Syria,10/08/2007,13,0,0,0,23,0,0,36
Syria,11/08/2007,-3,0,0,0,-2,0,0,-5
Syria,12/08/2007,1,0,0,0,0,0,0,1
Syria,13/08/2007,5,0,0,0,18,0,0,23
Syria,14/08/2007,14,0,0,0,11,0,0,25
Syria,15/08/2007,24,0,2,0,16,0,0,42
Syria,16/08/2007,30,0,0,0,5,2,0,37
Syria,17/08/2007,24,0,0,0,0,1,0,25
Syria,18/08/2007,26,2,0,0,6,0,0,34
Syria,19/08/2007,17,4,0,0,0,0,0,21
Syria,20/08/2007,47,0,0,0,0,0,0,47
Syria,21/08/2007,61,4,2,0,1,2,0,70
Syria,22/08/2007,8,0,1,0,0,2,0,11
Syria,23/08/2007,13,0,2,0,0,0,0,15
Syria,24/08/2007,0,0,0,0,0,0,0,0
Syria,25/08/2007,17,0,0,0,-1,6,0,22
Syria,26/08/2007,12,0,0,0,6,4,0,22
Syria,27/08/2007,14,0,0,0,-6,3,0,11
Syria,28/08/2007,6,0,0,0,21,0,0,27
Syria,29/08/2007,3,0,0,0,0,0,0,3
Syria,30/08/2007,1,0,0,0,0,0,0,1
Syria,31/08/2007,4,0,0,0,0,0,0,4
Yemen,01/08/2007,1,0,0,0,0,0,0,1
Yemen,02/08/2007,8,0,0,0,30,0,0,38
Yemen,03/08/2007,9,0,0,0,9,0,0,18
Yemen,04/08/2007,0,0,0,0,0,0,0,0
Yemen,06/08/2007,9,0,0,0,7,2,0,18
Yemen,07/08/2007,0,0,0,0,0,0,0,0
Yemen,08/08/2007,8,0,0,0,0,0,0,8
Yemen,09/08/2007,0,0,0,0,0,0,0,0
Yemen,10/08/2007,11,0,0,0,3,0,0,14
Yemen,11/08/2007,-10,0,0,0,-2,1,0,-11
Yemen,13/08/2007,14,0,0,0,0,0,0,14
Yemen,15/08/2007,2,0,0,0,0,0,0,2
Yemen,16/08/2007,0,0,0,0,3,0,0,3
Yemen,17/08/2007,1,0,0,0,0,0,0,1
Yemen,18/08/2007,0,0,0,0,0,2,0,2
Yemen,19/08/2007,8,0,0,0,0,0,0,8
Yemen,20/08/2007,0,0,0,0,0,0,0,0
Yemen,21/08/2007,0,0,0,0,3,0,0,3
Yemen,22/08/2007,4,0,0,0,0,0,0,4
Yemen,23/08/2007,-4,0,0,0,36,0,0,32
Yemen,24/08/2007,0,0,0,0,0,0,0,0
Yemen,25/08/2007,0,0,0,0,0,0,0,0
Yemen,26/08/2007,0,0,0,0,0,2,0,2
Yemen,27/08/2007,2,0,0,0,6,2,0,10
Yemen,28/08/2007,0,0,0,0,0,0,0,0
Yemen,29/08/2007,3,0,0,0,0,0,0,3
Yemen,30/08/2007,0,0,0,0,0,0,0,0
Afghanistan,01/09/2007,32,0,0,0,-13,7,0,26
Afghanistan,02/09/2007,13,0,0,0,10,3,0,26
Afghanistan,03/09/2007,32,0,0,0,9,2,0,43
Afghanistan,04/09/2007,203,2,-1,0,69,30,0,303
Afghanistan,05/09/2007,118,0,0,0,36,32,0,186
Afghanistan,06/09/2007,116,2,0,0,24,7,0,149
Afghanistan,07/09/2007,55,0,1,0,35,2,0,93
Afghanistan,08/09/2007,133,2,0,0,-1,9,0,143
Afghanistan,09/09/2007,87,4,0,0,8,4,0,103
Afghanistan,10/09/2007,157,0,-4,0,14,24,0,191
Afghanistan,11/09/2007,171,0,-1,0,13,23,0,206
Afghanistan,12/09/2007,216,2,-28,0,64,10,0,264
Afghanistan,13/09/2007,79,0,-12,0,8,0,0,75
Afghanistan,14/09/2007,86,0,-16,0,29,13,0,112
Afghanistan,15/09/2007,46,0,-4,0,6,3,0,51
Afghanistan,16/09/2007,63,0,0,0,6,5,0,74
Afghanistan,17/09/2007,174,0,-2,0,0,26,0,198
Afghanistan,18/09/2007,106,2,0,0,10,3,0,121
Afghanistan,19/09/2007,119,4,2,0,13,26,0,164
Afghanistan,20/09/2007,198,0,0,0,27,11,0,236
Afghanistan,21/09/2007,187,0,0,0,14,9,0,210
Afghanistan,22/09/2007,78,0,2,0,4,8,0,92
Afghanistan,23/09/2007,50,0,-12,0,44,19,0,101
Afghanistan,24/09/2007,31,0,-10,0,16,8,0,45
Afghanistan,25/09/2007,123,0,-5,0,15,3,0,136
Afghanistan,26/09/2007,188,4,3,0,21,6,0,222
Afghanistan,27/09/2007,139,0,-4,0,72,5,0,212
Afghanistan,28/09/2007,15,0,0,0,25,4,0,44
Afghanistan,29/09/2007,39,0,0,0,-9,3,0,33
Afghanistan,30/09/2007,37,0,0,0,0,1,0,38
Albania,01/09/2007,0,0,0,0,0,0,0,0
Albania,02/09/2007,0,0,-1,0,0,0,0,-1
Albania,03/09/2007,0,0,0,0,0,0,0,0
Albania,04/09/2007,18,0,-2,0,3,2,0,21
Albania,05/09/2007,27,0,-1,0,0,2,0,28
Albania,06/09/2007,34,0,0,0,9,0,0,43
Albania,07/09/2007,0,0,0,0,6,2,0,8
Albania,08/09/2007,8,0,0,0,0,0,0,8
Albania,09/09/2007,36,0,0,0,0,0,0,36
Albania,10/09/2007,38,0,-1,0,4,3,0,44
Albania,11/09/2007,46,0,-3,0,0,1,0,44
Albania,12/09/2007,-2,0,0,0,0,0,0,-2
Albania,13/09/2007,8,0,0,0,6,0,0,14
Albania,14/09/2007,15,0,-1,0,0,0,0,14
Albania,15/09/2007,7,0,0,0,0,0,0,7
Albania,16/09/2007,0,0,-1,0,0,0,0,-1
Albania,17/09/2007,9,0,0,0,0,0,0,9
Albania,18/09/2007,15,0,-3,0,3,2,0,17
Albania,19/09/2007,14,0,0,0,24,0,0,38
Albania,20/09/2007,4,0,-1,0,0,0,0,3
Albania,21/09/2007,2,0,3,0,0,0,0,5
Albania,22/09/2007,8,0,0,0,0,4,0,12
Albania,23/09/2007,12,0,0,0,0,3,0,15
Albania,24/09/2007,30,0,-1,0,0,1,0,30
Albania,25/09/2007,5,0,0,0,6,2,0,13
Albania,26/09/2007,31,0,0,0,28,2,0,61
Albania,27/09/2007,39,0,-1,0,12,1,0,51
Albania,28/09/2007,4,0,0,0,0,3,0,7
Albania,29/09/2007,6,0,0,0,3,2,0,11
Albania,30/09/2007,1,0,0,0,0,0,0,1
Algeria,01/09/2007,0,0,0,0,0,2,0,2
Algeria,02/09/2007,2,0,0,0,0,0,0,2
Algeria,03/09/2007,0,0,0,0,0,0,0,0
Algeria,04/09/2007,12,0,0,0,3,6,0,21
Algeria,05/09/2007,2,0,0,0,6,4,0,12
Algeria,06/09/2007,17,0,0,0,6,1,0,24
Algeria,07/09/2007,3,0,0,0,0,2,0,5
Algeria,08/09/2007,43,0,0,0,0,8,0,51
Algeria,09/09/2007,16,0,0,0,13,0,0,29
Algeria,10/09/2007,25,2,0,0,0,1,0,28
Algeria,11/09/2007,25,0,0,0,9,0,0,34
Algeria,12/09/2007,4,0,1,0,-2,12,0,15
Algeria,13/09/2007,19,4,0,0,6,0,0,29
Algeria,14/09/2007,7,2,0,0,3,3,0,15
Algeria,15/09/2007,0,0,0,0,3,0,0,3
Algeria,16/09/2007,2,0,0,0,0,0,0,2
Algeria,17/09/2007,32,0,0,0,6,0,0,38
Algeria,18/09/2007,0,0,0,0,0,0,0,0
Algeria,19/09/2007,3,0,0,0,6,0,0,9
Algeria,20/09/2007,10,0,0,0,0,0,0,10
Algeria,21/09/2007,2,0,0,0,7,12,0,21
Algeria,22/09/2007,10,0,0,0,0,0,0,10
Algeria,23/09/2007,5,0,0,0,0,0,0,5
Algeria,24/09/2007,4,0,0,0,0,0,0,4
Algeria,25/09/2007,3,0,0,0,6,0,0,9
Algeria,26/09/2007,0,0,0,0,0,3,0,3
Algeria,27/09/2007,9,0,0,0,0,0,0,9
Algeria,28/09/2007,-2,0,0,0,12,0,0,10
Algeria,29/09/2007,0,0,0,0,0,1,0,1
Algeria,30/09/2007,4,0,0,0,0,1,0,5
Bangladesh,01/09/2007,6,0,0,0,-1,0,0,5
Bangladesh,02/09/2007,1,0,0,0,0,0,0,1
Bangladesh,03/09/2007,7,0,0,0,0,0,0,7
Bangladesh,04/09/2007,29,0,0,0,45,0,0,74
Bangladesh,05/09/2007,4,4,0,0,6,2,0,16
Bangladesh,06/09/2007,36,0,0,0,30,1,0,67
Bangladesh,07/09/2007,0,0,0,0,0,0,0,0
Bangladesh,08/09/2007,3,2,0,0,18,0,0,23
Bangladesh,09/09/2007,23,0,0,0,30,2,0,55
Bangladesh,10/09/2007,13,4,0,0,12,0,0,29
Bangladesh,11/09/2007,10,0,0,0,3,2,0,15
Bangladesh,12/09/2007,0,0,-4,0,7,0,0,3
Bangladesh,13/09/2007,42,0,0,0,12,0,0,54
Bangladesh,14/09/2007,4,2,0,0,0,0,0,6
Bangladesh,15/09/2007,2,0,0,0,0,0,0,2
Bangladesh,16/09/2007,5,0,0,0,3,0,0,8
Bangladesh,17/09/2007,24,2,2,0,31,11,0,70
Bangladesh,18/09/2007,14,0,0,0,24,3,0,41
Bangladesh,19/09/2007,7,0,-4,0,6,2,0,11
Bangladesh,20/09/2007,11,0,0,0,16,0,0,27
Bangladesh,21/09/2007,3,0,1,0,9,0,0,13
Bangladesh,22/09/2007,0,0,0,0,0,1,0,1
Bangladesh,23/09/2007,2,0,1,0,-1,1,0,3
Bangladesh,24/09/2007,8,0,0,0,12,0,0,20
Bangladesh,25/09/2007,2,0,-2,0,-1,3,0,2
Bangladesh,26/09/2007,9,0,0,0,35,0,0,44
Bangladesh,27/09/2007,7,0,0,0,27,3,0,37
Bangladesh,28/09/2007,0,0,0,0,0,0,0,0
Bangladesh,29/09/2007,0,0,0,0,14,0,0,14
Bangladesh,30/09/2007,-2,12,-1,0,4,0,0,13
Cameroon,04/09/2007,2,0,0,0,6,2,0,10
Cameroon,05/09/2007,0,0,0,0,0,0,0,0
Cameroon,06/09/2007,0,0,0,0,0,0,0,0
Cameroon,08/09/2007,4,0,0,0,0,0,0,4
Cameroon,09/09/2007,2,0,0,0,0,0,0,2
Cameroon,10/09/2007,0,0,0,0,0,0,0,0
Cameroon,11/09/2007,0,0,0,0,0,0,0,0
Cameroon,12/09/2007,0,0,0,0,0,0,0,0
Cameroon,14/09/2007,9,0,0,0,0,0,0,9
Cameroon,17/09/2007,1,0,0,0,6,0,0,7
Cameroon,18/09/2007,0,0,0,0,0,0,0,0
Cameroon,20/09/2007,0,0,0,0,0,0,0,0
Cameroon,26/09/2007,0,0,0,0,3,0,0,3
Cameroon,28/09/2007,0,0,0,0,0,0,0,0
China,01/09/2007,11,0,0,0,6,0,0,17
China,02/09/2007,0,0,0,0,3,0,0,3
China,03/09/2007,10,0,0,0,-2,3,0,11
China,04/09/2007,161,0,-4,0,60,14,0,231
China,05/09/2007,69,8,2,0,39,5,0,123
China,06/09/2007,38,0,0,0,12,4,0,54
China,07/09/2007,19,0,0,0,-4,2,0,17
China,08/09/2007,154,0,-2,0,12,11,0,175
China,09/09/2007,169,0,2,0,22,16,0,209
China,10/09/2007,50,0,4,0,15,7,0,76
China,11/09/2007,73,0,0,0,24,7,0,104
China,12/09/2007,88,2,-4,0,32,6,0,124
China,13/09/2007,31,0,-2,0,15,3,0,47
China,14/09/2007,50,0,-1,0,27,4,0,80
China,15/09/2007,16,0,0,0,6,6,0,28
China,16/09/2007,4,0,0,0,0,0,0,4
China,17/09/2007,73,2,1,0,18,10,0,104
China,18/09/2007,48,0,0,0,42,7,0,97
China,19/09/2007,64,4,0,0,33,9,0,110
China,20/09/2007,69,0,0,0,28,17,0,114
China,21/09/2007,60,4,1,0,40,5,0,110
China,22/09/2007,73,0,-2,0,13,7,0,91
China,23/09/2007,32,0,-2,0,12,8,0,50
China,24/09/2007,20,0,0,0,0,5,0,25
China,25/09/2007,132,0,1,0,88,40,0,261
China,26/09/2007,117,2,-2,0,56,18,0,191
China,27/09/2007,90,4,-4,0,43,7,0,140
China,28/09/2007,37,0,1,0,15,2,0,55
China,29/09/2007,35,0,0,0,3,3,0,41
China,30/09/2007,32,0,3,0,0,0,0,35
Egypt,01/09/2007,14,0,0,0,0,0,0,14
Egypt,02/09/2007,19,0,0,0,48,0,0,67
Egypt,03/09/2007,2,0,0,0,3,0,0,5
Egypt,04/09/2007,8,0,0,0,6,0,0,14
Egypt,05/09/2007,25,0,0,0,-4,0,0,21
Egypt,06/09/2007,66,0,0,0,3,0,0,69
Egypt,07/09/2007,12,0,0,0,6,2,0,20
Egypt,08/09/2007,3,0,0,0,9,3,0,15
Egypt,09/09/2007,25,0,-2,0,6,0,0,29
Egypt,10/09/2007,5,0,0,0,30,0,0,35
Egypt,11/09/2007,7,0,0,0,13,0,0,20
Egypt,12/09/2007,12,0,0,0,18,2,0,32
Egypt,13/09/2007,11,2,0,0,0,0,0,13
Egypt,14/09/2007,4,0,-1,0,11,2,0,16
Egypt,15/09/2007,6,0,0,0,-1,2,0,7
Egypt,16/09/2007,0,0,0,0,0,0,0,0
Egypt,17/09/2007,48,0,0,0,15,3,0,66
Egypt,18/09/2007,7,0,0,0,11,1,0,19
Egypt,19/09/2007,31,0,0,0,3,3,0,37
Egypt,20/09/2007,27,0,-1,0,3,9,0,38
Egypt,21/09/2007,26,0,0,0,-2,0,0,24
Egypt,22/09/2007,11,0,0,0,-2,0,0,9
Egypt,23/09/2007,16,0,0,0,12,3,0,31
Egypt,24/09/2007,2,0,0,0,9,2,0,13
Egypt,25/09/2007,28,0,0,0,19,1,0,48
Egypt,26/09/2007,8,0,0,0,13,0,0,21
Egypt,27/09/2007,23,0,0,0,10,1,0,34
Egypt,28/09/2007,19,0,0,0,0,5,0,24
Egypt,29/09/2007,8,0,0,0,9,0,0,17
Egypt,30/09/2007,13,0,0,0,23,0,0,36
Eritrea,01/09/2007,8,0,0,0,0,0,0,8
Eritrea,04/09/2007,7,0,0,0,3,0,0,10
Eritrea,05/09/2007,0,0,0,0,0,0,0,0
Eritrea,06/09/2007,0,0,0,0,0,0,0,0
Eritrea,07/09/2007,3,0,0,0,0,0,0,3
Eritrea,08/09/2007,0,0,0,0,0,0,0,0
Eritrea,09/09/2007,2,0,0,0,0,0,0,2
Eritrea,10/09/2007,23,0,0,0,1,0,0,24
Eritrea,11/09/2007,6,0,0,0,9,0,0,15
Eritrea,12/09/2007,6,0,0,0,0,0,0,6
Eritrea,13/09/2007,0,0,0,0,-1,0,0,-1
Eritrea,14/09/2007,0,0,0,0,0,0,0,0
Eritrea,15/09/2007,4,0,0,0,0,0,0,4
Eritrea,16/09/2007,14,0,0,0,0,0,0,14
Eritrea,17/09/2007,30,0,0,0,9,0,0,39
Eritrea,18/09/2007,3,0,0,0,3,0,0,6
Eritrea,19/09/2007,5,0,0,0,0,0,0,5
Eritrea,20/09/2007,1,0,0,0,0,0,0,1
Eritrea,21/09/2007,0,0,0,0,0,0,0,0
Eritrea,22/09/2007,2,0,0,0,0,0,0,2
Eritrea,23/09/2007,0,0,0,0,0,0,0,0
Eritrea,24/09/2007,0,0,0,0,0,0,0,0
Eritrea,25/09/2007,11,0,1,0,0,0,0,12
Eritrea,26/09/2007,3,0,0,0,0,0,0,3
Eritrea,29/09/2007,2,0,0,0,0,0,0,2
Georgia,01/09/2007,-1,0,0,0,0,0,0,-1
Georgia,02/09/2007,0,0,0,0,0,0,0,0
Georgia,04/09/2007,7,0,0,0,9,1,0,17
Georgia,05/09/2007,0,0,0,0,9,0,0,9
Georgia,06/09/2007,15,0,0,0,-2,0,0,13
Georgia,07/09/2007,6,0,0,0,0,0,0,6
Georgia,08/09/2007,3,2,0,0,6,0,0,11
Georgia,09/09/2007,0,0,0,0,0,0,0,0
Georgia,10/09/2007,3,0,0,0,3,0,0,6
Georgia,11/09/2007,10,0,0,0,3,0,0,13
Georgia,12/09/2007,6,0,0,0,9,0,0,15
Georgia,13/09/2007,2,0,0,0,0,0,0,2
Georgia,14/09/2007,9,0,0,0,6,2,0,17
Georgia,16/09/2007,2,0,0,0,0,0,0,2
Georgia,17/09/2007,8,0,0,0,6,0,0,14
Georgia,18/09/2007,10,0,0,0,9,0,0,19
Georgia,19/09/2007,4,0,0,0,3,1,0,8
Georgia,20/09/2007,2,0,0,0,3,1,0,6
Georgia,21/09/2007,3,0,0,0,2,2,0,7
Georgia,22/09/2007,2,0,0,0,6,0,0,8
Georgia,23/09/2007,6,0,0,0,0,0,0,6
Georgia,24/09/2007,3,0,0,0,0,0,0,3
Georgia,25/09/2007,14,0,0,0,-2,0,0,12
Georgia,26/09/2007,13,0,0,0,3,1,0,17
Georgia,27/09/2007,50,0,0,0,9,0,0,59
Georgia,28/09/2007,8,0,0,0,4,4,0,16
Georgia,29/09/2007,2,0,0,0,-2,0,0,0
Georgia,30/09/2007,0,0,0,0,0,1,0,1
India,01/09/2007,13,0,0,0,0,0,0,13
India,02/09/2007,0,0,0,0,0,0,0,0
India,03/09/2007,0,0,0,0,0,0,0,0
India,04/09/2007,42,4,-3,0,4,4,0,51
India,05/09/2007,28,2,-1,0,20,0,0,49
India,06/09/2007,17,0,-2,0,9,3,0,27
India,07/09/2007,19,0,0,0,18,4,0,41
India,08/09/2007,25,0,1,0,13,4,0,43
India,09/09/2007,14,0,0,0,2,0,0,16
India,10/09/2007,14,0,2,0,3,1,0,20
India,11/09/2007,16,0,0,0,0,1,0,17
India,12/09/2007,23,0,-1,0,15,3,0,40
India,13/09/2007,40,0,0,0,0,0,0,40
India,14/09/2007,22,0,0,0,8,1,0,31
India,15/09/2007,6,0,0,0,-1,1,0,6
India,16/09/2007,9,0,0,0,0,0,0,9
India,17/09/2007,19,2,-4,0,21,9,0,47
India,18/09/2007,32,0,-2,0,-4,5,0,31
India,19/09/2007,50,0,-2,0,37,5,0,90
India,20/09/2007,39,0,-5,0,22,6,0,62
India,21/09/2007,31,2,0,0,-1,3,0,35
India,22/09/2007,12,0,0,0,5,0,0,17
India,23/09/2007,16,0,-1,0,5,1,0,21
India,24/09/2007,6,0,0,0,-2,4,0,8
India,25/09/2007,39,0,-2,0,0,3,0,40
India,26/09/2007,35,0,-5,0,9,3,0,42
India,27/09/2007,16,0,-2,0,0,2,0,16
India,28/09/2007,14,0,0,0,0,0,0,14
India,29/09/2007,3,0,0,0,3,0,0,6
India,30/09/2007,16,0,0,0,0,0,0,16
Iran,01/09/2007,25,0,0,0,24,1,0,50
Iran,02/09/2007,14,0,0,0,0,0,0,14
Iran,03/09/2007,8,0,0,0,-6,2,0,4
Iran,04/09/2007,122,2,0,0,26,5,0,155
Iran,05/09/2007,44,0,0,0,21,10,0,75
Iran,06/09/2007,61,0,0,0,13,3,0,77
Iran,07/09/2007,27,0,0,0,3,0,0,30
Iran,08/09/2007,65,0,0,0,6,3,0,74
Iran,09/09/2007,60,0,1,0,4,2,0,67
Iran,10/09/2007,79,0,0,0,16,9,0,104
Iran,11/09/2007,69,0,0,0,-20,5,0,54
Iran,12/09/2007,39,0,-3,0,24,7,0,67
Iran,13/09/2007,34,0,1,0,12,3,0,50
Iran,14/09/2007,26,0,0,0,31,0,0,57
Iran,15/09/2007,14,2,0,0,4,2,0,22
Iran,16/09/2007,22,0,0,0,-8,0,0,14
Iran,17/09/2007,139,2,1,0,0,16,0,158
Iran,18/09/2007,117,0,3,0,47,11,0,178
Iran,19/09/2007,105,0,-1,0,21,31,0,156
Iran,20/09/2007,103,0,2,0,49,19,0,173
Iran,21/09/2007,101,0,-3,0,44,23,0,165
Iran,22/09/2007,50,0,0,0,25,18,0,93
Iran,23/09/2007,92,0,4,0,9,10,0,115
Iran,24/09/2007,87,0,0,0,14,11,0,112
Iran,25/09/2007,176,0,0,0,51,32,0,259
Iran,26/09/2007,107,8,1,0,-3,11,0,124
Iran,27/09/2007,60,0,1,0,5,3,0,69
Iran,28/09/2007,12,0,0,0,3,0,0,15
Iran,29/09/2007,2,0,-2,0,0,4,0,4
Iran,30/09/2007,14,0,1,0,2,0,0,17
Iraq,01/09/2007,65,0,-2,0,-2,1,0,62
Iraq,02/09/2007,37,0,-2,0,10,0,0,45
Iraq,03/09/2007,5,2,0,0,8,0,0,15
Iraq,04/09/2007,488,0,-15,0,157,44,0,674
Iraq,05/09/2007,218,0,-13,0,36,20,0,261
Iraq,06/09/2007,110,0,2,0,70,12,0,194
Iraq,07/09/2007,68,0,0,0,12,3,0,83
Iraq,08/09/2007,108,0,0,0,38,50,0,196
Iraq,09/09/2007,134,0,1,0,22,15,0,172
Iraq,10/09/2007,346,2,-3,0,21,12,0,378
Iraq,11/09/2007,326,0,5,0,15,16,0,362
Iraq,12/09/2007,121,0,-6,0,29,16,0,160
Iraq,13/09/2007,49,0,-4,0,-2,2,0,45
Iraq,14/09/2007,160,0,-8,0,79,27,0,258
Iraq,15/09/2007,54,0,0,0,5,7,0,66
Iraq,16/09/2007,51,0,0,0,6,9,0,66
Iraq,17/09/2007,176,2,0,0,52,31,0,261
Iraq,18/09/2007,131,0,0,0,32,27,0,190
Iraq,19/09/2007,158,0,0,0,39,27,0,224
Iraq,20/09/2007,201,0,-3,0,73,22,0,293
Iraq,21/09/2007,224,4,2,0,6,20,0,256
Iraq,22/09/2007,112,0,1,0,2,10,0,125
Iraq,23/09/2007,91,2,5,0,15,4,0,117
Iraq,24/09/2007,49,4,1,0,11,10,0,75
Iraq,25/09/2007,137,0,-4,0,21,17,0,171
Iraq,26/09/2007,232,4,0,0,59,9,0,304
Iraq,27/09/2007,149,0,1,0,21,10,0,181
Iraq,28/09/2007,139,4,0,0,15,3,0,161
Iraq,29/09/2007,85,0,0,0,9,6,0,100
Iraq,30/09/2007,86,0,0,0,9,2,0,97
Morocco,01/09/2007,0,0,0,0,6,0,0,6
Morocco,03/09/2007,2,0,0,0,0,0,0,2
Morocco,04/09/2007,13,0,0,0,0,3,0,16
Morocco,05/09/2007,1,0,-2,0,0,1,0,0
Morocco,06/09/2007,0,0,0,0,0,0,0,0
Morocco,07/09/2007,3,0,0,0,0,0,0,3
Morocco,08/09/2007,3,0,0,0,0,0,0,3
Morocco,09/09/2007,18,0,0,0,16,2,0,36
Morocco,10/09/2007,3,0,0,0,-4,1,0,0
Morocco,11/09/2007,4,0,0,0,0,0,0,4
Morocco,12/09/2007,7,0,0,0,9,2,0,18
Morocco,13/09/2007,-1,0,0,0,0,0,0,-1
Morocco,14/09/2007,8,0,2,0,3,0,0,13
Morocco,15/09/2007,2,0,0,0,0,0,0,2
Morocco,16/09/2007,0,0,0,0,0,0,0,0
Morocco,17/09/2007,8,0,0,0,3,0,0,11
Morocco,18/09/2007,-2,0,0,0,18,0,0,16
Morocco,19/09/2007,2,0,0,0,0,0,0,2
Morocco,20/09/2007,2,0,0,0,3,0,0,5
Morocco,21/09/2007,0,0,0,0,3,0,0,3
Morocco,22/09/2007,4,0,0,0,0,0,0,4
Morocco,23/09/2007,0,0,0,0,3,0,0,3
Morocco,24/09/2007,3,0,0,0,0,0,0,3
Morocco,25/09/2007,0,0,0,0,0,0,0,0
Morocco,26/09/2007,8,0,0,0,0,0,0,8
Morocco,27/09/2007,0,0,0,0,0,0,0,0
Morocco,28/09/2007,2,0,2,0,0,0,0,4
Morocco,29/09/2007,0,0,0,0,0,0,0,0
Nigeria,02/09/2007,0,0,1,0,1,0,0,2
Nigeria,04/09/2007,4,0,0,0,2,3,0,9
Nigeria,05/09/2007,8,0,0,0,3,0,0,11
Nigeria,06/09/2007,4,0,0,0,-3,0,0,1
Nigeria,08/09/2007,0,0,0,0,0,0,0,0
Nigeria,09/09/2007,0,0,0,0,0,1,0,1
Nigeria,10/09/2007,7,0,-2,0,9,4,0,18
Nigeria,11/09/2007,3,0,0,0,0,1,0,4
Nigeria,12/09/2007,2,0,0,0,0,0,0,2
Nigeria,13/09/2007,0,0,0,0,0,0,0,0
Nigeria,14/09/2007,3,0,0,0,3,0,0,6
Nigeria,15/09/2007,0,0,0,0,0,0,0,0
Nigeria,17/09/2007,25,0,0,0,-4,0,0,21
Nigeria,18/09/2007,18,0,-4,0,0,1,0,15
Nigeria,19/09/2007,41,0,-4,0,6,1,0,44
Nigeria,20/09/2007,7,0,-2,0,0,0,0,5
Nigeria,21/09/2007,2,0,0,0,15,4,0,21
Nigeria,22/09/2007,7,8,0,0,-6,0,0,9
Nigeria,23/09/2007,1,0,0,0,12,1,0,14
Nigeria,24/09/2007,9,0,0,0,3,4,0,16
Nigeria,25/09/2007,22,0,0,0,9,0,0,31
Nigeria,26/09/2007,42,0,0,0,9,4,0,55
Nigeria,27/09/2007,23,0,2,0,33,0,0,58
Nigeria,28/09/2007,7,0,0,0,3,1,0,11
Nigeria,29/09/2007,-1,0,2,0,12,0,0,13
Nigeria,30/09/2007,3,0,0,0,0,0,0,3
Pakistan,01/09/2007,28,0,-2,0,-3,11,0,34
Pakistan,02/09/2007,12,0,0,0,6,4,0,22
Pakistan,03/09/2007,4,0,0,0,4,4,0,12
Pakistan,04/09/2007,63,2,-5,0,44,12,0,116
Pakistan,05/09/2007,73,0,0,0,48,12,0,133
Pakistan,06/09/2007,47,0,0,0,46,0,0,93
Pakistan,07/09/2007,2,0,2,0,44,5,0,53
Pakistan,08/09/2007,22,0,0,0,52,0,0,74
Pakistan,09/09/2007,55,0,-1,0,25,8,0,87
Pakistan,10/09/2007,119,0,-4,0,149,15,0,279
Pakistan,11/09/2007,61,0,0,0,126,20,0,207
Pakistan,12/09/2007,42,0,-4,0,39,13,0,90
Pakistan,13/09/2007,8,0,0,0,6,0,0,14
Pakistan,14/09/2007,34,0,-5,0,47,3,0,79
Pakistan,15/09/2007,9,0,-2,0,21,0,0,28
Pakistan,16/09/2007,1,0,1,0,9,3,0,14
Pakistan,17/09/2007,50,0,-14,0,50,17,0,103
Pakistan,18/09/2007,53,2,-7,0,6,4,0,58
Pakistan,19/09/2007,40,0,-2,0,53,4,0,95
Pakistan,20/09/2007,40,0,-12,0,40,4,0,72
Pakistan,21/09/2007,29,0,0,0,28,1,0,58
Pakistan,22/09/2007,38,0,0,0,0,1,0,39
Pakistan,23/09/2007,14,0,0,0,2,7,0,23
Pakistan,24/09/2007,14,0,-6,0,3,4,0,15
Pakistan,25/09/2007,36,0,-2,0,9,5,0,48
Pakistan,26/09/2007,74,0,-6,0,14,1,0,83
Pakistan,27/09/2007,24,4,-2,0,82,9,0,117
Pakistan,28/09/2007,5,0,0,0,-5,4,0,4
Pakistan,29/09/2007,24,12,0,0,1,0,0,37
Pakistan,30/09/2007,3,0,0,0,0,0,0,3
Sierra Leone,03/09/2007,0,0,0,0,0,0,0,0
Sierra Leone,04/09/2007,2,0,-4,0,6,0,0,4
Sierra Leone,05/09/2007,0,0,0,0,0,2,0,2
Sierra Leone,06/09/2007,2,0,0,0,3,0,0,5
Sierra Leone,07/09/2007,2,0,0,0,6,0,0,8
Sierra Leone,08/09/2007,0,0,1,0,0,0,0,1
Sierra Leone,09/09/2007,-2,0,0,0,3,0,0,1
Sierra Leone,10/09/2007,0,0,-2,0,0,1,0,-1
Sierra Leone,11/09/2007,1,0,0,0,0,1,0,2
Sierra Leone,12/09/2007,0,0,0,0,0,0,0,0
Sierra Leone,13/09/2007,0,0,-4,0,0,0,0,-4
Sierra Leone,15/09/2007,0,0,-2,0,0,0,0,-2
Sierra Leone,16/09/2007,0,0,0,0,-4,0,0,-4
Sierra Leone,17/09/2007,10,0,3,0,6,2,0,21
Sierra Leone,18/09/2007,6,0,0,0,6,0,0,12
Sierra Leone,19/09/2007,7,0,0,0,9,2,0,18
Sierra Leone,20/09/2007,3,0,0,0,-1,0,0,2
Sierra Leone,21/09/2007,2,0,0,0,-4,0,0,-2
Sierra Leone,22/09/2007,0,0,0,0,3,0,0,3
Sierra Leone,23/09/2007,8,0,0,0,0,0,0,8
Sierra Leone,24/09/2007,2,0,0,0,6,0,0,8
Sierra Leone,25/09/2007,-5,0,0,0,6,4,0,5
Sierra Leone,26/09/2007,2,0,0,0,0,0,0,2
Sierra Leone,27/09/2007,0,0,0,0,3,0,0,3
Somalia,01/09/2007,1,0,0,0,0,0,0,1
Somalia,02/09/2007,-2,0,0,0,0,0,0,-2
Somalia,03/09/2007,0,0,0,0,6,0,0,6
Somalia,04/09/2007,8,0,2,0,7,0,0,17
Somalia,05/09/2007,24,0,0,0,16,0,0,40
Somalia,06/09/2007,7,0,0,0,-2,0,0,5
Somalia,07/09/2007,6,0,0,0,0,0,0,6
Somalia,08/09/2007,16,0,0,0,0,1,0,17
Somalia,09/09/2007,5,0,0,0,3,5,0,13
Somalia,10/09/2007,0,0,0,0,18,0,0,18
Somalia,11/09/2007,17,0,0,0,-6,2,0,13
Somalia,12/09/2007,17,0,0,0,0,0,0,17
Somalia,13/09/2007,2,0,0,0,0,0,0,2
Somalia,14/09/2007,1,0,0,0,0,2,0,3
Somalia,15/09/2007,4,0,0,0,6,0,0,10
Somalia,16/09/2007,0,0,0,0,0,0,0,0
Somalia,17/09/2007,3,0,0,0,0,0,0,3
Somalia,18/09/2007,-4,0,0,0,-1,2,0,-3
Somalia,19/09/2007,20,4,0,0,9,0,0,33
Somalia,20/09/2007,21,0,0,0,-2,0,0,19
Somalia,21/09/2007,7,0,0,0,0,0,0,7
Somalia,22/09/2007,12,0,0,0,0,0,0,12
Somalia,23/09/2007,0,0,0,0,0,0,0,0
Somalia,24/09/2007,4,0,0,0,0,0,0,4
Somalia,25/09/2007,1,2,0,0,0,0,0,3
Somalia,26/09/2007,23,0,0,0,0,1,0,24
Somalia,27/09/2007,3,2,0,0,0,2,0,7
Somalia,28/09/2007,0,0,0,0,0,0,0,0
Somalia,29/09/2007,0,0,0,0,0,0,0,0
Somalia,30/09/2007,6,0,0,0,0,0,0,6
Syria,01/09/2007,2,0,0,0,0,0,0,2
Syria,02/09/2007,-6,0,0,0,0,0,0,-6
Syria,03/09/2007,-5,0,0,0,-4,2,0,-7
Syria,04/09/2007,72,0,2,0,-2,5,0,77
Syria,05/09/2007,38,0,-3,0,0,1,0,36
Syria,06/09/2007,106,0,-1,0,12,2,0,119
Syria,07/09/2007,7,0,0,0,0,0,0,7
Syria,08/09/2007,17,0,0,0,6,0,0,23
Syria,09/09/2007,22,0,-4,0,8,1,0,27
Syria,10/09/2007,46,0,-4,0,4,2,0,48
Syria,11/09/2007,70,0,0,0,-5,3,0,68
Syria,12/09/2007,48,0,0,0,0,7,0,55
Syria,13/09/2007,23,0,0,0,0,0,0,23
Syria,14/09/2007,13,0,-6,0,0,0,0,7
Syria,15/09/2007,11,0,-4,0,0,0,0,7
Syria,16/09/2007,15,0,0,0,24,0,0,39
Syria,17/09/2007,47,0,0,0,36,1,0,84
Syria,18/09/2007,89,0,-5,0,0,0,0,84
Syria,19/09/2007,179,0,2,0,15,36,0,232
Syria,20/09/2007,142,0,-5,0,10,24,0,171
Syria,21/09/2007,152,0,0,0,9,0,0,161
Syria,22/09/2007,11,0,0,0,30,2,0,43
Syria,23/09/2007,57,0,0,0,21,3,0,81
Syria,24/09/2007,52,0,-6,0,0,3,0,49
Syria,25/09/2007,70,0,-6,0,23,3,0,90
Syria,26/09/2007,39,0,0,0,18,3,0,60
Syria,27/09/2007,35,0,-5,0,-10,2,0,22
Syria,28/09/2007,20,0,-2,0,0,0,0,18
Syria,29/09/2007,4,0,0,0,0,0,0,4
Syria,30/09/2007,0,0,0,0,36,0,0,36
Yemen,01/09/2007,4,4,0,0,18,5,0,31
Yemen,03/09/2007,11,0,0,0,0,1,0,12
Yemen,04/09/2007,8,0,0,0,9,0,0,17
Yemen,05/09/2007,0,0,0,0,0,0,0,0
Yemen,06/09/2007,-1,0,0,0,3,0,0,2
Yemen,07/09/2007,14,0,0,0,11,0,0,25
Yemen,08/09/2007,3,0,0,0,7,0,0,10
Yemen,09/09/2007,4,0,-4,0,6,0,0,6
Yemen,10/09/2007,15,0,0,0,15,0,0,30
Yemen,11/09/2007,3,0,0,0,0,0,0,3
Yemen,12/09/2007,-1,0,0,0,0,0,0,-1
Yemen,13/09/2007,6,0,0,0,12,0,0,18
Yemen,14/09/2007,46,0,-4,0,-2,2,0,42
Yemen,15/09/2007,6,2,0,0,6,4,0,18
Yemen,17/09/2007,5,0,0,0,3,0,0,8
Yemen,18/09/2007,-1,0,0,0,0,0,0,-1
Yemen,19/09/2007,0,0,0,0,-2,0,0,-2
Yemen,20/09/2007,4,0,0,0,0,0,0,4
Yemen,23/09/2007,0,0,0,0,0,0,0,0
Yemen,24/09/2007,0,0,0,0,0,0,0,0
Yemen,25/09/2007,7,0,0,0,6,3,0,16
Yemen,26/09/2007,9,0,0,0,0,0,0,9
Yemen,27/09/2007,0,0,0,0,0,0,0,0
Yemen,28/09/2007,0,0,0,0,0,0,0,0
Yemen,30/09/2007,15,0,0,0,18,0,0,33
Afghanistan,01/12/2009,666,2,1,0,130,87,0,886
Afghanistan,02/12/2009,898,6,-12,0,49,83,0,1024
Afghanistan,03/12/2009,762,16,-6,0,65,54,0,891
Afghanistan,04/12/2009,599,10,-3,0,41,49,0,696
Afghanistan,05/12/2009,279,0,1,0,12,26,0,318
Afghanistan,06/12/2009,237,2,-4,0,49,16,0,300
Afghanistan,07/12/2009,402,4,0,0,48,110,0,564
Afghanistan,08/12/2009,418,12,-13,0,123,64,0,604
Afghanistan,09/12/2009,334,2,-14,0,168,21,0,511
Afghanistan,10/12/2009,433,2,-6,0,198,76,0,703
Afghanistan,11/12/2009,332,10,-14,0,70,41,0,439
Afghanistan,12/12/2009,236,6,-6,0,63,26,0,325
Afghanistan,13/12/2009,267,2,-8,0,31,9,0,301
Afghanistan,14/12/2009,264,0,-8,0,89,15,0,360
Afghanistan,15/12/2009,441,0,1,0,30,73,0,545
Afghanistan,16/12/2009,315,6,-13,0,95,43,0,446
Afghanistan,17/12/2009,325,2,-8,0,67,47,0,433
Afghanistan,18/12/2009,280,0,-3,0,59,28,0,364
Afghanistan,19/12/2009,233,0,-2,0,81,16,0,328
Afghanistan,20/12/2009,121,0,0,0,25,3,0,149
Afghanistan,21/12/2009,133,0,-5,0,60,19,0,207
Afghanistan,22/12/2009,230,0,-1,0,30,33,0,292
Afghanistan,23/12/2009,236,2,0,0,28,15,0,281
Afghanistan,24/12/2009,301,0,1,0,53,153,0,508
Afghanistan,25/12/2009,231,0,0,0,98,11,0,340
Afghanistan,26/12/2009,214,0,-2,0,38,5,0,255
Afghanistan,27/12/2009,200,0,-11,0,37,6,0,232
Afghanistan,28/12/2009,276,2,-2,0,36,34,0,346
Afghanistan,29/12/2009,215,0,0,0,6,23,0,244
Afghanistan,30/12/2009,245,0,-2,0,9,21,0,273
Afghanistan,31/12/2009,374,4,4,0,8,43,0,433
Albania,01/12/2009,21,0,2,0,12,1,0,36
Albania,02/12/2009,17,0,0,0,1,1,0,19
Albania,03/12/2009,-13,0,0,0,0,2,0,-11
Albania,04/12/2009,-5,0,0,0,0,0,0,-5
Albania,05/12/2009,15,0,0,0,3,0,0,18
Albania,06/12/2009,22,0,0,0,10,0,0,32
Albania,07/12/2009,14,0,0,0,6,0,0,20
Albania,08/12/2009,7,0,-2,0,3,2,0,10
Albania,09/12/2009,4,0,0,0,3,0,0,7
Albania,10/12/2009,11,0,-4,0,15,0,0,22
Albania,11/12/2009,35,0,0,0,9,0,0,44
Albania,12/12/2009,4,0,0,0,0,0,0,4
Albania,13/12/2009,5,0,0,0,0,0,0,5
Albania,14/12/2009,6,0,0,0,-2,3,0,7
Albania,15/12/2009,14,0,0,0,2,1,0,17
Albania,16/12/2009,21,0,0,0,3,0,0,24
Albania,17/12/2009,6,0,0,0,0,0,0,6
Albania,18/12/2009,9,0,0,0,3,0,0,12
Albania,19/12/2009,3,0,-1,0,3,0,0,5
Albania,20/12/2009,0,0,0,0,0,0,0,0
Albania,21/12/2009,0,0,0,0,4,7,0,11
Albania,22/12/2009,2,0,0,0,18,0,0,20
Albania,23/12/2009,0,0,0,0,0,0,0,0
Albania,24/12/2009,1,0,0,0,12,0,0,13
Albania,25/12/2009,0,0,0,0,6,0,0,6
Albania,26/12/2009,6,0,0,0,0,0,0,6
Albania,27/12/2009,0,0,0,0,0,0,0,0
Albania,28/12/2009,9,0,1,0,3,0,0,13
Albania,29/12/2009,6,0,0,0,3,0,0,9
Albania,30/12/2009,3,0,0,0,3,0,0,6
Albania,31/12/2009,23,0,0,0,0,0,0,23
Algeria,01/12/2009,12,0,-2,0,22,0,0,32
Algeria,02/12/2009,10,0,0,0,9,0,0,19
Algeria,03/12/2009,8,0,0,0,11,0,0,19
Algeria,04/12/2009,17,0,0,0,5,0,0,22
Algeria,05/12/2009,3,0,0,0,-4,0,0,-1
Algeria,06/12/2009,1,0,0,0,-1,0,0,0
Algeria,07/12/2009,4,0,0,0,21,3,0,28
Algeria,08/12/2009,3,0,0,0,3,0,0,6
Algeria,09/12/2009,-1,0,0,0,30,4,0,33
Algeria,10/12/2009,-7,0,0,0,6,3,0,2
Algeria,11/12/2009,12,0,0,0,0,1,0,13
Algeria,12/12/2009,4,2,0,0,0,3,0,9
Algeria,13/12/2009,1,2,0,0,6,0,0,9
Algeria,14/12/2009,4,0,0,0,6,2,0,12
Algeria,15/12/2009,11,0,0,0,4,4,0,19
Algeria,16/12/2009,9,0,0,0,6,0,0,15
Algeria,17/12/2009,7,0,0,0,0,0,0,7
Algeria,18/12/2009,8,0,0,0,31,0,0,39
Algeria,19/12/2009,1,0,0,0,18,0,0,19
Algeria,20/12/2009,3,0,0,0,0,2,0,5
Algeria,21/12/2009,2,0,0,0,10,4,0,16
Algeria,22/12/2009,2,0,0,0,4,3,0,9
Algeria,23/12/2009,5,0,0,0,18,0,0,23
Algeria,24/12/2009,16,0,0,0,3,4,0,23
Algeria,25/12/2009,0,0,0,0,1,0,0,1
Algeria,26/12/2009,0,0,0,0,0,0,0,0
Algeria,27/12/2009,11,0,0,0,6,0,0,17
Algeria,28/12/2009,5,0,0,0,15,0,0,20
Algeria,29/12/2009,12,0,0,0,13,0,0,25
Algeria,30/12/2009,0,0,0,0,9,1,0,10
Algeria,31/12/2009,7,0,0,0,-4,0,0,3
Bangladesh,01/12/2009,9,0,0,0,10,0,0,19
Bangladesh,02/12/2009,25,4,0,0,25,0,0,54
Bangladesh,03/12/2009,61,0,0,0,5,4,0,70
Bangladesh,04/12/2009,87,0,1,0,55,5,0,148
Bangladesh,05/12/2009,56,0,0,0,58,1,0,115
Bangladesh,06/12/2009,46,2,-2,0,-5,0,0,41
Bangladesh,07/12/2009,26,0,0,0,6,2,0,34
Bangladesh,08/12/2009,15,0,-2,0,40,0,0,53
Bangladesh,09/12/2009,31,0,-2,0,26,7,0,62
Bangladesh,10/12/2009,12,0,0,0,3,4,0,19
Bangladesh,11/12/2009,12,0,0,0,0,0,0,12
Bangladesh,12/12/2009,2,0,0,0,0,3,0,5
Bangladesh,13/12/2009,7,0,-2,0,15,4,0,24
Bangladesh,14/12/2009,15,0,-3,0,30,5,0,47
Bangladesh,15/12/2009,12,0,0,0,17,4,0,33
Bangladesh,16/12/2009,19,0,-3,0,0,2,0,18
Bangladesh,17/12/2009,10,0,-1,0,11,5,0,25
Bangladesh,18/12/2009,35,0,-1,0,10,5,0,49
Bangladesh,19/12/2009,13,0,0,0,9,0,0,22
Bangladesh,20/12/2009,10,0,0,0,16,0,0,26
Bangladesh,21/12/2009,7,0,0,0,7,0,0,14
Bangladesh,22/12/2009,12,0,0,0,19,2,0,33
Bangladesh,23/12/2009,12,2,0,0,6,2,0,22
Bangladesh,24/12/2009,3,0,0,0,9,0,0,12
Bangladesh,25/12/2009,4,0,0,0,15,5,0,24
Bangladesh,26/12/2009,6,0,0,0,21,2,0,29
Bangladesh,27/12/2009,13,0,0,0,11,1,0,25
Bangladesh,28/12/2009,2,0,0,0,0,0,0,2
Bangladesh,29/12/2009,15,0,-2,0,14,3,0,30
Bangladesh,30/12/2009,1,0,-1,0,5,0,0,5
Bangladesh,31/12/2009,5,0,0,0,4,0,0,9
Cameroon,01/12/2009,31,0,0,0,0,0,0,31
Cameroon,02/12/2009,22,0,0,0,0,0,0,22
Cameroon,03/12/2009,7,0,0,0,3,0,0,10
Cameroon,04/12/2009,-2,0,0,0,0,0,0,-2
Cameroon,05/12/2009,0,0,0,0,0,0,0,0
Cameroon,07/12/2009,0,0,0,0,0,0,0,0
Cameroon,08/12/2009,6,0,0,0,6,0,0,12
Cameroon,09/12/2009,0,0,0,0,3,0,0,3
Cameroon,10/12/2009,0,0,0,0,3,0,0,3
Cameroon,11/12/2009,4,0,0,0,0,0,0,4
Cameroon,12/12/2009,0,0,0,0,0,0,0,0
Cameroon,13/12/2009,3,0,0,0,0,2,0,5
Cameroon,14/12/2009,0,0,0,0,0,0,0,0
Cameroon,15/12/2009,2,0,0,0,6,0,0,8
Cameroon,16/12/2009,3,0,0,0,0,0,0,3
Cameroon,17/12/2009,2,0,0,0,0,0,0,2
Cameroon,18/12/2009,2,0,0,0,3,0,0,5
Cameroon,19/12/2009,0,0,0,0,0,4,0,4
Cameroon,21/12/2009,-1,0,2,0,6,0,0,7
Cameroon,22/12/2009,2,0,0,0,1,0,0,3
Cameroon,23/12/2009,0,0,0,0,0,0,0,0
Cameroon,24/12/2009,0,0,0,0,0,0,0,0
Cameroon,25/12/2009,-1,0,0,0,0,0,0,-1
Cameroon,26/12/2009,0,0,0,0,0,0,0,0
Cameroon,27/12/2009,0,0,0,0,0,0,0,0
Cameroon,28/12/2009,1,0,0,0,0,0,0,1
Cameroon,29/12/2009,0,0,0,0,0,2,0,2
Cameroon,30/12/2009,2,0,0,0,0,0,0,2
Cameroon,31/12/2009,1,0,0,0,0,0,0,1
China,01/12/2009,202,4,-7,0,67,11,0,277
China,02/12/2009,163,0,3,0,62,19,0,247
China,03/12/2009,146,2,-6,0,92,13,0,247
China,04/12/2009,104,0,0,0,89,28,0,221
China,05/12/2009,92,4,2,0,30,13,0,141
China,06/12/2009,114,0,0,0,21,7,0,142
China,07/12/2009,146,4,-16,0,54,17,0,205
China,08/12/2009,89,0,-3,0,9,16,0,111
China,09/12/2009,186,0,2,0,26,18,0,232
China,10/12/2009,115,0,-13,0,25,17,0,144
China,11/12/2009,100,4,-2,0,77,5,0,184
China,12/12/2009,65,6,3,0,27,16,0,117
China,13/12/2009,92,4,3,0,86,15,0,200
China,14/12/2009,123,2,1,0,173,17,0,316
China,15/12/2009,90,4,-2,0,128,14,0,234
China,16/12/2009,124,0,-14,0,115,24,0,249
China,17/12/2009,203,0,-4,0,111,31,0,341
China,18/12/2009,188,0,-3,0,141,28,0,354
China,19/12/2009,100,0,-7,0,110,16,0,219
China,20/12/2009,115,2,2,0,28,23,0,170
China,21/12/2009,124,4,3,0,88,15,0,234
China,22/12/2009,218,0,1,0,78,19,0,316
China,23/12/2009,234,8,3,0,85,16,0,346
China,24/12/2009,136,8,-3,0,76,27,0,244
China,25/12/2009,39,2,-3,0,29,5,0,72
China,26/12/2009,53,0,5,0,-1,11,0,68
China,27/12/2009,52,8,5,0,20,9,0,94
China,28/12/2009,106,6,-7,0,66,15,0,186
China,29/12/2009,172,2,-2,0,173,25,0,370
China,30/12/2009,149,0,-1,0,33,21,0,202
China,31/12/2009,83,0,-8,0,40,9,0,124
Egypt,01/12/2009,30,0,-1,0,10,3,0,42
Egypt,02/12/2009,10,0,0,0,12,5,0,27
Egypt,03/12/2009,14,0,0,0,38,8,0,60
Egypt,04/12/2009,26,0,0,0,29,1,0,56
Egypt,05/12/2009,12,0,0,0,5,1,0,18
Egypt,06/12/2009,15,0,-2,0,23,2,0,38
Egypt,07/12/2009,34,0,0,0,50,3,0,87
Egypt,08/12/2009,25,0,0,0,27,4,0,56
Egypt,09/12/2009,27,2,0,0,-4,3,0,28
Egypt,10/12/2009,52,2,2,0,-4,8,0,60
Egypt,11/12/2009,71,0,0,0,7,0,0,78
Egypt,12/12/2009,16,0,-1,0,30,0,0,45
Egypt,13/12/2009,38,0,0,0,1,3,0,42
Egypt,14/12/2009,52,0,0,0,15,0,0,67
Egypt,15/12/2009,24,0,0,0,19,2,0,45
Egypt,16/12/2009,40,0,0,0,26,2,0,68
Egypt,17/12/2009,55,0,0,0,39,5,0,99
Egypt,18/12/2009,29,0,0,0,13,1,0,43
Egypt,19/12/2009,36,0,0,0,17,10,0,63
Egypt,20/12/2009,32,0,0,0,3,2,0,37
Egypt,21/12/2009,82,0,-5,0,23,1,0,101
Egypt,22/12/2009,39,0,2,0,15,5,0,61
Egypt,23/12/2009,34,0,2,0,47,2,0,85
Egypt,24/12/2009,54,0,0,0,7,7,0,68
Egypt,25/12/2009,27,4,0,0,-9,2,0,24
Egypt,26/12/2009,17,0,0,0,21,0,0,38
Egypt,27/12/2009,56,2,0,0,-2,8,0,64
Egypt,28/12/2009,57,0,-1,0,-5,9,0,60
Egypt,29/12/2009,28,0,0,0,9,8,0,45
Egypt,30/12/2009,52,0,0,0,8,0,0,60
Egypt,31/12/2009,14,0,-2,0,32,5,0,49
Eritrea,01/12/2009,19,0,1,0,0,0,0,20
Eritrea,02/12/2009,0,0,0,0,3,0,0,3
Eritrea,03/12/2009,18,0,0,0,1,3,0,22
Eritrea,04/12/2009,9,0,0,0,2,0,0,11
Eritrea,05/12/2009,0,0,0,0,0,0,0,0
Eritrea,06/12/2009,15,0,0,0,0,0,0,15
Eritrea,07/12/2009,6,0,0,0,0,0,0,6
Eritrea,08/12/2009,2,0,0,0,48,0,0,50
Eritrea,09/12/2009,0,0,0,0,30,0,0,30
Eritrea,10/12/2009,2,0,0,0,43,0,0,45
Eritrea,11/12/2009,0,0,0,0,36,0,0,36
Eritrea,12/12/2009,3,0,0,0,6,0,0,9
Eritrea,13/12/2009,0,0,0,0,0,0,0,0
Eritrea,14/12/2009,0,0,0,0,17,0,0,17
Eritrea,15/12/2009,0,0,0,0,0,0,0,0
Eritrea,16/12/2009,5,0,0,0,0,2,0,7
Eritrea,17/12/2009,6,0,0,0,4,1,0,11
Eritrea,18/12/2009,1,0,0,0,6,0,0,7
Eritrea,19/12/2009,9,0,0,0,0,0,0,9
Eritrea,20/12/2009,1,0,0,0,0,0,0,1
Eritrea,21/12/2009,3,0,0,0,0,0,0,3
Eritrea,22/12/2009,6,0,0,0,9,0,0,15
Eritrea,23/12/2009,0,0,0,0,8,0,0,8
Eritrea,24/12/2009,7,0,0,0,4,2,0,13
Eritrea,25/12/2009,0,0,0,0,0,0,0,0
Eritrea,26/12/2009,4,0,2,0,0,0,0,6
Eritrea,27/12/2009,2,0,0,0,0,0,0,2
Eritrea,28/12/2009,8,0,0,0,0,0,0,8
Eritrea,29/12/2009,9,0,-1,0,3,0,0,11
Eritrea,30/12/2009,11,0,0,0,21,3,0,35
Eritrea,31/12/2009,3,0,0,0,0,0,0,3
Georgia,01/12/2009,42,0,-5,0,7,7,0,51
Georgia,02/12/2009,41,2,0,0,19,3,0,65
Georgia,03/12/2009,34,0,-5,0,6,5,0,40
Georgia,04/12/2009,24,0,2,0,26,6,0,58
Georgia,05/12/2009,9,0,2,0,0,1,0,12
Georgia,06/12/2009,4,0,0,0,0,0,0,4
Georgia,07/12/2009,24,0,2,0,15,0,0,41
Georgia,08/12/2009,21,0,1,0,24,2,0,48
Georgia,09/12/2009,22,0,-4,0,31,6,0,55
Georgia,10/12/2009,19,2,-1,0,8,6,0,34
Georgia,11/12/2009,5,2,0,0,20,4,0,31
Georgia,12/12/2009,17,0,0,0,9,0,0,26
Georgia,13/12/2009,-1,0,0,0,9,0,0,8
Georgia,14/12/2009,27,0,-4,0,43,8,0,74
Georgia,15/12/2009,18,4,-2,0,54,6,0,80
Georgia,16/12/2009,30,2,-2,0,36,2,0,68
Georgia,17/12/2009,14,0,-2,0,-5,3,0,10
Georgia,18/12/2009,24,0,0,0,-8,3,0,19
Georgia,19/12/2009,-1,0,-1,0,-11,0,0,-13
Georgia,20/12/2009,6,0,0,0,3,0,0,9
Georgia,21/12/2009,19,0,0,0,10,2,0,31
Georgia,22/12/2009,5,4,-6,0,11,4,0,18
Georgia,23/12/2009,27,2,-2,0,19,6,0,52
Georgia,24/12/2009,12,0,0,0,9,3,0,24
Georgia,25/12/2009,1,0,0,0,0,0,0,1
Georgia,26/12/2009,13,0,0,0,9,0,0,22
Georgia,27/12/2009,5,0,0,0,3,0,0,8
Georgia,28/12/2009,21,0,0,0,4,1,0,26
Georgia,29/12/2009,16,0,0,0,1,3,0,20
Georgia,30/12/2009,14,0,1,0,3,4,0,22
Georgia,31/12/2009,11,0,0,0,7,3,0,21
India,01/12/2009,60,0,-4,0,-2,14,0,68
India,02/12/2009,10,0,-2,0,6,0,0,14
India,03/12/2009,84,10,0,0,-9,3,0,88
India,04/12/2009,96,4,-1,0,12,21,0,132
India,05/12/2009,84,0,1,0,36,5,0,126
India,06/12/2009,85,0,1,0,-1,6,0,91
India,07/12/2009,90,0,1,0,26,21,0,138
India,08/12/2009,71,0,-10,0,14,7,0,82
India,09/12/2009,75,0,3,0,12,10,0,100
India,10/12/2009,47,0,0,0,25,10,0,82
India,11/12/2009,98,2,1,0,9,16,0,126
India,12/12/2009,44,0,-3,0,16,11,0,68
India,13/12/2009,55,0,-2,0,5,11,0,69
India,14/12/2009,81,0,-4,0,8,9,0,94
India,15/12/2009,79,0,-5,0,20,13,0,107
India,16/12/2009,81,12,2,0,42,15,0,152
India,17/12/2009,32,2,-2,0,19,9,0,60
India,18/12/2009,86,0,0,0,23,4,0,113
India,19/12/2009,47,2,-5,0,13,8,0,65
India,20/12/2009,29,2,1,0,3,6,0,41
India,21/12/2009,54,0,0,0,28,2,0,84
India,22/12/2009,37,0,-1,0,17,4,0,57
India,23/12/2009,62,2,1,0,4,9,0,78
India,24/12/2009,36,2,1,0,14,9,0,62
India,25/12/2009,43,2,1,0,2,5,0,53
India,26/12/2009,62,2,1,0,4,17,0,86
India,27/12/2009,63,0,-4,0,19,13,0,91
India,28/12/2009,48,2,-8,0,-6,4,0,40
India,29/12/2009,48,2,1,0,3,3,0,57
India,30/12/2009,31,4,0,0,17,9,0,61
India,31/12/2009,22,0,-2,0,13,25,0,58
Iran,01/12/2009,192,0,0,0,114,3,0,309
Iran,02/12/2009,65,0,0,0,49,9,0,123
Iran,03/12/2009,90,0,0,0,37,11,0,138
Iran,04/12/2009,53,0,-8,0,13,0,0,58
Iran,05/12/2009,25,0,0,0,18,2,0,45
Iran,06/12/2009,36,0,0,0,12,2,0,50
Iran,07/12/2009,41,2,0,0,23,13,0,79
Iran,08/12/2009,73,4,0,0,77,6,0,160
Iran,09/12/2009,71,0,-1,0,75,8,0,153
Iran,10/12/2009,93,0,2,0,46,11,0,152
Iran,11/12/2009,71,0,5,0,32,13,0,121
Iran,12/12/2009,36,0,0,0,32,0,0,68
Iran,13/12/2009,44,0,0,0,82,11,0,137
Iran,14/12/2009,65,0,1,0,131,18,0,215
Iran,15/12/2009,110,0,0,0,42,45,0,197
Iran,16/12/2009,138,0,1,0,45,7,0,191
Iran,17/12/2009,100,0,2,0,49,7,0,158
Iran,18/12/2009,236,2,1,0,98,14,0,351
Iran,19/12/2009,102,2,0,0,62,8,0,174
Iran,20/12/2009,71,0,1,0,24,8,0,104
Iran,21/12/2009,173,0,1,0,66,31,0,271
Iran,22/12/2009,95,0,0,0,34,14,0,143
Iran,23/12/2009,66,0,3,0,47,19,0,135
Iran,24/12/2009,92,0,2,0,38,8,0,140
Iran,25/12/2009,29,0,2,0,22,1,0,54
Iran,26/12/2009,52,0,0,0,30,-1,0,81
Iran,27/12/2009,101,0,-1,0,32,18,0,150
Iran,28/12/2009,147,0,1,0,109,26,0,283
Iran,29/12/2009,174,0,0,0,140,38,0,352
Iran,30/12/2009,146,0,2,0,97,20,0,265
Iran,31/12/2009,148,0,0,0,90,12,0,250
Iraq,01/12/2009,155,64,1,0,103,23,0,346
Iraq,02/12/2009,162,0,-4,0,72,24,0,254
Iraq,03/12/2009,146,2,0,0,44,25,0,217
Iraq,04/12/2009,144,2,0,0,13,4,0,163
Iraq,05/12/2009,118,0,-1,0,37,6,0,160
Iraq,06/12/2009,35,0,-1,0,4,4,0,42
Iraq,07/12/2009,142,12,2,0,20,12,0,188
Iraq,08/12/2009,101,0,0,0,41,25,0,167
Iraq,09/12/2009,99,0,5,0,32,12,0,148
Iraq,10/12/2009,183,2,1,0,43,13,0,242
Iraq,11/12/2009,163,2,0,0,17,10,0,192
Iraq,12/12/2009,86,0,1,0,-8,9,0,88
Iraq,13/12/2009,41,0,1,0,22,20,0,84
Iraq,14/12/2009,134,0,-1,0,126,17,0,276
Iraq,15/12/2009,149,4,1,0,32,12,0,198
Iraq,16/12/2009,86,0,0,0,8,9,0,103
Iraq,17/12/2009,182,2,5,0,65,9,0,263
Iraq,18/12/2009,200,2,0,0,49,7,0,258
Iraq,19/12/2009,73,2,-1,0,61,6,0,141
Iraq,20/12/2009,17,0,0,0,39,1,0,57
Iraq,21/12/2009,63,2,1,0,36,6,0,108
Iraq,22/12/2009,63,2,-2,0,61,20,0,144
Iraq,23/12/2009,74,0,-2,0,15,18,0,105
Iraq,24/12/2009,96,2,-2,0,26,15,0,137
Iraq,25/12/2009,72,0,0,0,5,11,0,88
Iraq,26/12/2009,39,0,-2,0,5,10,0,52
Iraq,27/12/2009,73,0,0,0,24,8,0,105
Iraq,28/12/2009,95,2,1,0,28,31,0,157
Iraq,29/12/2009,76,0,-4,0,37,4,0,113
Iraq,30/12/2009,96,10,2,0,29,24,0,161
Iraq,31/12/2009,78,2,1,0,3,6,0,90
Morocco,01/12/2009,13,0,0,0,-4,0,0,9
Morocco,02/12/2009,2,0,-1,0,25,1,0,27
Morocco,03/12/2009,0,0,0,0,13,0,0,13
Morocco,04/12/2009,46,0,2,0,0,2,0,50
Morocco,05/12/2009,77,0,0,0,0,3,0,80
Morocco,06/12/2009,60,0,0,0,0,1,0,61
Morocco,07/12/2009,69,0,0,0,9,13,0,91
Morocco,08/12/2009,20,0,0,0,7,2,0,29
Morocco,09/12/2009,35,0,0,0,15,2,0,52
Morocco,10/12/2009,40,0,0,0,9,7,0,56
Morocco,11/12/2009,49,0,0,0,0,12,0,61
Morocco,12/12/2009,17,0,0,0,0,6,0,23
Morocco,13/12/2009,13,0,0,0,-4,2,0,11
Morocco,14/12/2009,40,0,1,0,10,11,0,62
Morocco,15/12/2009,22,0,0,0,6,5,0,33
Morocco,16/12/2009,11,2,1,0,19,0,0,33
Morocco,17/12/2009,27,2,0,0,15,6,0,50
Morocco,18/12/2009,84,0,0,0,22,9,0,115
Morocco,19/12/2009,21,0,0,0,20,4,0,45
Morocco,20/12/2009,12,0,0,0,9,0,0,21
Morocco,21/12/2009,7,0,0,0,3,2,0,12
Morocco,22/12/2009,-3,0,0,0,3,0,0,0
Morocco,23/12/2009,29,0,-1,0,4,0,0,32
Morocco,24/12/2009,5,0,0,0,0,0,0,5
Morocco,25/12/2009,8,0,0,0,0,0,0,8
Morocco,26/12/2009,4,0,0,0,0,0,0,4
Morocco,27/12/2009,3,0,0,0,0,0,0,3
Morocco,28/12/2009,6,0,0,0,9,0,0,15
Morocco,29/12/2009,33,0,0,0,10,2,0,45
Morocco,30/12/2009,6,0,0,0,2,0,0,8
Morocco,31/12/2009,2,0,0,0,3,0,0,5
Nigeria,01/12/2009,25,0,0,0,-2,0,0,23
Nigeria,02/12/2009,17,0,2,0,22,3,0,44
Nigeria,03/12/2009,36,0,-2,0,3,3,0,40
Nigeria,04/12/2009,24,0,-1,0,6,0,0,29
Nigeria,05/12/2009,11,0,1,0,16,3,0,31
Nigeria,06/12/2009,16,0,0,0,14,1,0,31
Nigeria,07/12/2009,26,0,0,0,1,7,0,34
Nigeria,08/12/2009,22,0,0,0,19,6,0,47
Nigeria,09/12/2009,33,0,0,0,10,2,0,45
Nigeria,10/12/2009,8,0,1,0,11,2,0,22
Nigeria,11/12/2009,34,0,-1,0,15,2,0,50
Nigeria,12/12/2009,16,0,0,0,-2,0,0,14
Nigeria,13/12/2009,18,0,3,0,21,0,0,42
Nigeria,14/12/2009,19,0,0,0,12,1,0,32
Nigeria,15/12/2009,13,0,0,0,-4,0,0,9
Nigeria,16/12/2009,4,0,0,0,1,1,0,6
Nigeria,17/12/2009,37,0,0,0,7,0,0,44
Nigeria,18/12/2009,44,0,0,0,18,0,0,62
Nigeria,19/12/2009,7,0,0,0,0,0,0,7
Nigeria,20/12/2009,28,0,-4,0,6,0,0,30
Nigeria,21/12/2009,40,0,-3,0,17,4,0,58
Nigeria,22/12/2009,34,0,2,0,9,0,0,45
Nigeria,23/12/2009,13,0,0,0,22,1,0,36
Nigeria,24/12/2009,27,0,0,0,-2,3,0,28
Nigeria,25/12/2009,45,0,1,0,9,8,0,63
Nigeria,26/12/2009,227,0,-1,0,98,88,0,412
Nigeria,27/12/2009,245,0,-2,0,157,107,0,507
Nigeria,28/12/2009,270,0,3,0,146,43,0,462
Nigeria,29/12/2009,289,0,6,0,108,24,0,427
Nigeria,30/12/2009,281,4,5,0,131,44,0,465
Nigeria,31/12/2009,163,0,3,0,87,10,0,263
Pakistan,01/12/2009,267,64,0,0,46,12,0,389
Pakistan,02/12/2009,182,4,0,0,18,24,0,228
Pakistan,03/12/2009,270,0,-2,0,20,12,0,300
Pakistan,04/12/2009,192,2,1,0,40,16,0,251
Pakistan,05/12/2009,79,2,1,0,32,14,0,128
Pakistan,06/12/2009,139,2,-2,0,22,22,0,183
Pakistan,07/12/2009,181,0,0,0,106,23,0,310
Pakistan,08/12/2009,90,0,0,0,74,19,0,183
Pakistan,09/12/2009,134,6,0,0,156,7,0,303
Pakistan,10/12/2009,98,2,0,0,116,6,0,222
Pakistan,11/12/2009,207,0,-4,0,219,5,0,427
Pakistan,12/12/2009,117,0,0,0,49,3,0,169
Pakistan,13/12/2009,72,6,-1,0,37,6,0,120
Pakistan,14/12/2009,108,2,-6,0,132,19,0,255
Pakistan,15/12/2009,111,0,-1,0,71,24,0,205
Pakistan,16/12/2009,161,0,-3,0,74,16,0,248
Pakistan,17/12/2009,215,0,-3,0,110,9,0,331
Pakistan,18/12/2009,114,0,2,0,125,2,0,243
Pakistan,19/12/2009,20,0,-3,0,52,8,0,77
Pakistan,20/12/2009,101,0,-4,0,20,5,0,122
Pakistan,21/12/2009,85,0,-10,0,27,4,0,106
Pakistan,22/12/2009,98,2,-1,0,19,10,0,128
Pakistan,23/12/2009,123,0,-2,0,42,7,0,170
Pakistan,24/12/2009,91,0,0,0,15,23,0,129
Pakistan,25/12/2009,81,0,0,0,32,3,0,116
Pakistan,26/12/2009,56,0,-7,0,5,13,0,67
Pakistan,27/12/2009,92,0,-3,0,14,13,0,116
Pakistan,28/12/2009,72,0,1,0,32,19,0,124
Pakistan,29/12/2009,66,0,-2,0,34,4,0,102
Pakistan,30/12/2009,166,0,0,0,37,38,0,241
Pakistan,31/12/2009,195,0,0,0,6,31,0,232
Sierra Leone,01/12/2009,1,0,0,0,0,0,0,1
Sierra Leone,02/12/2009,30,0,0,0,6,1,0,37
Sierra Leone,03/12/2009,5,0,0,0,0,0,0,5
Sierra Leone,04/12/2009,5,0,0,0,6,1,0,12
Sierra Leone,05/12/2009,1,0,0,0,6,0,0,7
Sierra Leone,06/12/2009,0,0,0,0,9,0,0,9
Sierra Leone,07/12/2009,0,0,0,0,6,0,0,6
Sierra Leone,08/12/2009,2,0,1,0,0,0,0,3
Sierra Leone,09/12/2009,2,0,0,0,1,0,0,3
Sierra Leone,10/12/2009,0,0,0,0,0,0,0,0
Sierra Leone,11/12/2009,1,0,0,0,0,0,0,1
Sierra Leone,12/12/2009,0,2,-2,0,-2,0,0,-2
Sierra Leone,13/12/2009,6,0,-2,0,0,0,0,4
Sierra Leone,14/12/2009,0,0,0,0,9,0,0,9
Sierra Leone,15/12/2009,0,2,0,0,0,0,0,2
Sierra Leone,16/12/2009,-2,2,0,0,6,0,0,6
Sierra Leone,17/12/2009,3,0,0,0,9,0,0,12
Sierra Leone,18/12/2009,1,0,0,0,4,0,0,5
Sierra Leone,19/12/2009,0,0,0,0,0,0,0,0
Sierra Leone,20/12/2009,0,0,0,0,0,0,0,0
Sierra Leone,21/12/2009,2,0,0,0,0,0,0,2
Sierra Leone,22/12/2009,0,0,0,0,0,0,0,0
Sierra Leone,23/12/2009,1,0,0,0,0,0,0,1
Sierra Leone,25/12/2009,0,0,0,0,0,0,0,0
Sierra Leone,26/12/2009,0,0,0,0,0,0,0,0
Sierra Leone,28/12/2009,-1,0,0,0,0,0,0,-1
Sierra Leone,29/12/2009,0,0,0,0,0,0,0,0
Sierra Leone,30/12/2009,0,0,0,0,-4,0,0,-4
Sierra Leone,31/12/2009,0,0,0,0,-4,0,0,-4
Somalia,01/12/2009,57,0,0,0,75,10,0,142
Somalia,02/12/2009,49,4,0,0,19,0,0,72
Somalia,03/12/2009,61,2,0,0,31,14,0,108
Somalia,04/12/2009,15,0,0,0,19,7,0,41
Somalia,05/12/2009,26,0,0,0,6,0,0,32
Somalia,06/12/2009,12,0,0,0,-2,3,0,13
Somalia,07/12/2009,92,0,0,0,21,2,0,115
Somalia,08/12/2009,20,0,1,0,28,0,0,49
Somalia,09/12/2009,12,0,0,0,12,5,0,29
Somalia,10/12/2009,10,0,0,0,5,39,0,54
Somalia,11/12/2009,34,0,0,0,14,11,0,59
Somalia,12/12/2009,52,0,0,0,6,0,0,58
Somalia,13/12/2009,56,0,0,0,4,4,0,64
Somalia,14/12/2009,40,0,0,0,-2,5,0,43
Somalia,15/12/2009,19,0,2,0,30,0,0,51
Somalia,16/12/2009,55,0,0,0,-3,4,0,56
Somalia,17/12/2009,65,0,0,0,52,3,0,120
Somalia,18/12/2009,65,0,0,0,-31,6,0,40
Somalia,19/12/2009,20,0,0,0,-7,3,0,16
Somalia,20/12/2009,9,0,0,0,-1,0,0,8
Somalia,21/12/2009,22,0,0,0,4,1,0,27
Somalia,22/12/2009,27,0,0,0,-1,0,0,26
Somalia,23/12/2009,17,0,0,0,4,9,0,30
Somalia,24/12/2009,31,0,0,0,-1,1,0,31
Somalia,25/12/2009,55,0,0,0,-11,0,0,44
Somalia,26/12/2009,8,0,0,0,-2,4,0,10
Somalia,27/12/2009,18,0,0,0,2,0,0,20
Somalia,28/12/2009,36,0,0,0,-1,4,0,39
Somalia,29/12/2009,144,0,3,0,52,1,0,200
Somalia,30/12/2009,160,0,2,0,3,9,0,174
Somalia,31/12/2009,53,0,0,0,18,8,0,79
Syria,01/12/2009,6,0,0,0,-2,0,0,4
Syria,02/12/2009,8,2,0,0,10,2,0,22
Syria,03/12/2009,25,2,0,0,7,3,0,37
Syria,04/12/2009,8,0,0,0,0,0,0,8
Syria,05/12/2009,4,0,0,0,0,0,0,4
Syria,06/12/2009,2,0,0,0,0,0,0,2
Syria,07/12/2009,9,0,0,0,0,1,0,10
Syria,08/12/2009,5,0,0,0,15,0,0,20
Syria,09/12/2009,22,0,0,0,-2,1,0,21
Syria,10/12/2009,14,0,1,0,6,0,0,21
Syria,11/12/2009,18,0,0,0,1,3,0,22
Syria,12/12/2009,17,0,0,0,-3,3,0,17
Syria,13/12/2009,9,0,0,0,6,0,0,15
Syria,14/12/2009,19,0,0,0,51,2,0,72
Syria,15/12/2009,25,0,0,0,15,0,0,40
Syria,16/12/2009,20,0,0,0,3,0,0,23
Syria,17/12/2009,41,0,0,0,1,0,0,42
Syria,18/12/2009,40,0,0,0,6,0,0,46
Syria,19/12/2009,12,0,0,0,4,0,0,16
Syria,20/12/2009,4,0,0,0,3,3,0,10
Syria,21/12/2009,7,0,0,0,-1,27,0,33
Syria,22/12/2009,6,0,0,0,12,2,0,20
Syria,23/12/2009,43,0,0,0,20,6,0,69
Syria,24/12/2009,32,0,0,0,0,0,0,32
Syria,25/12/2009,4,0,0,0,7,0,0,11
Syria,26/12/2009,-3,0,0,0,0,0,0,-3
Syria,27/12/2009,12,0,0,0,21,0,0,33
Syria,28/12/2009,5,0,0,0,29,0,0,34
Syria,29/12/2009,25,0,0,0,7,5,0,37
Syria,30/12/2009,5,0,0,0,6,4,0,15
Syria,31/12/2009,3,0,0,0,-2,1,0,2
Yemen,01/12/2009,64,2,0,0,5,0,0,71
Yemen,02/12/2009,86,4,0,0,9,2,0,101
Yemen,03/12/2009,37,0,0,0,7,0,0,44
Yemen,04/12/2009,48,0,0,0,9,2,0,59
Yemen,05/12/2009,29,0,0,0,3,2,0,34
Yemen,06/12/2009,33,0,0,0,-2,0,0,31
Yemen,07/12/2009,86,0,0,0,0,0,0,86
Yemen,08/12/2009,36,0,1,0,18,1,0,56
Yemen,09/12/2009,6,0,0,0,24,0,0,30
Yemen,10/12/2009,18,0,1,0,42,0,0,61
Yemen,11/12/2009,36,0,0,0,12,1,0,49
Yemen,12/12/2009,25,0,-2,0,6,0,0,29
Yemen,13/12/2009,20,0,0,0,4,4,0,28
Yemen,14/12/2009,32,0,0,0,6,1,0,39
Yemen,15/12/2009,70,4,0,0,27,1,0,102
Yemen,16/12/2009,32,0,0,0,5,0,0,37
Yemen,17/12/2009,14,0,0,0,-8,6,0,12
Yemen,18/12/2009,58,0,0,0,-2,4,0,60
Yemen,19/12/2009,61,2,0,0,4,14,0,81
Yemen,20/12/2009,117,0,0,0,-29,9,0,97
Yemen,21/12/2009,44,0,0,0,-14,0,0,30
Yemen,22/12/2009,104,0,0,0,21,11,0,136
Yemen,23/12/2009,56,0,0,0,10,4,0,70
Yemen,24/12/2009,217,0,0,0,35,32,0,284
Yemen,25/12/2009,37,0,0,0,15,6,0,58
Yemen,26/12/2009,103,0,0,0,30,32,0,165
Yemen,27/12/2009,237,0,0,0,58,66,0,361
Yemen,28/12/2009,323,0,0,0,88,58,0,469
Yemen,29/12/2009,478,16,3,0,64,19,0,580
Yemen,30/12/2009,300,4,0,0,25,38,0,367
Yemen,31/12/2009,211,0,1,0,-18,17,0,211
Afghanistan,01/06/2009,163,4,0,0,43,12,0,222
Afghanistan,02/06/2009,288,0,1,0,48,34,0,371
Afghanistan,03/06/2009,247,0,-3,0,34,19,0,297
Afghanistan,04/06/2009,180,4,2,0,-9,14,0,191
Afghanistan,05/06/2009,269,4,-2,0,57,19,0,347
Afghanistan,06/06/2009,196,0,0,0,74,48,0,318
Afghanistan,07/06/2009,157,2,2,0,28,7,0,196
Afghanistan,08/06/2009,190,4,-4,0,47,26,0,263
Afghanistan,09/06/2009,164,0,1,0,80,6,0,251
Afghanistan,10/06/2009,155,6,0,0,37,7,0,205
Afghanistan,11/06/2009,282,6,0,0,29,13,0,330
Afghanistan,12/06/2009,269,0,0,0,53,23,0,345
Afghanistan,13/06/2009,186,0,0,0,20,20,0,226
Afghanistan,14/06/2009,413,0,0,0,26,20,0,459
Afghanistan,15/06/2009,241,0,0,0,16,20,0,277
Afghanistan,16/06/2009,226,0,-1,0,38,13,0,276
Afghanistan,17/06/2009,237,2,0,0,22,13,0,274
Afghanistan,18/06/2009,174,0,2,0,9,30,0,215
Afghanistan,19/06/2009,210,4,1,0,22,23,0,260
Afghanistan,20/06/2009,185,0,0,0,12,7,0,204
Afghanistan,21/06/2009,174,0,-2,0,1,11,0,184
Afghanistan,22/06/2009,308,6,0,0,27,12,0,353
Afghanistan,23/06/2009,384,12,0,0,27,15,0,438
Afghanistan,24/06/2009,319,0,-3,0,29,11,0,356
Afghanistan,25/06/2009,154,2,-4,0,36,11,0,199
Afghanistan,26/06/2009,130,14,-2,0,22,11,0,175
Afghanistan,27/06/2009,162,4,1,0,16,16,0,199
Afghanistan,28/06/2009,144,8,1,0,24,15,0,192
Afghanistan,29/06/2009,273,0,-1,0,73,14,0,359
Afghanistan,30/06/2009,47,0,1,0,7,20,0,75
Albania,01/06/2009,5,0,0,0,4,0,0,9
Albania,02/06/2009,2,0,0,0,1,1,0,4
Albania,03/06/2009,4,0,0,0,0,0,0,4
Albania,04/06/2009,4,0,0,0,-4,2,0,2
Albania,05/06/2009,3,0,0,0,0,0,0,3
Albania,06/06/2009,4,0,0,0,0,0,0,4
Albania,07/06/2009,10,0,0,0,0,0,0,10
Albania,08/06/2009,6,0,0,0,0,3,0,9
Albania,09/06/2009,10,0,0,0,0,0,0,10
Albania,10/06/2009,13,0,0,0,4,0,0,17
Albania,11/06/2009,12,0,0,0,18,0,0,30
Albania,12/06/2009,26,0,0,0,23,1,0,50
Albania,13/06/2009,6,0,0,0,-4,0,0,2
Albania,14/06/2009,4,0,0,0,9,0,0,13
Albania,15/06/2009,8,0,-1,0,0,0,0,7
Albania,16/06/2009,3,0,0,0,6,5,0,14
Albania,17/06/2009,4,0,0,0,0,0,0,4
Albania,18/06/2009,27,0,0,0,9,0,0,36
Albania,19/06/2009,15,0,0,0,0,1,0,16
Albania,20/06/2009,1,0,0,0,0,0,0,1
Albania,21/06/2009,0,0,0,0,0,0,0,0
Albania,22/06/2009,6,0,0,0,0,0,0,6
Albania,23/06/2009,4,0,0,0,0,3,0,7
Albania,24/06/2009,13,0,0,0,10,6,0,29
Albania,25/06/2009,0,0,-2,0,12,6,0,16
Albania,26/06/2009,4,0,0,0,8,4,0,16
Albania,27/06/2009,3,0,0,0,0,4,0,7
Albania,28/06/2009,0,0,0,0,0,1,0,1
Albania,29/06/2009,-1,0,-1,0,0,0,0,-2
Albania,30/06/2009,0,0,0,0,0,0,0,0
Algeria,01/06/2009,0,0,0,0,0,0,0,0
Algeria,02/06/2009,1,0,0,0,0,0,0,1
Algeria,03/06/2009,33,0,-2,0,29,0,0,60
Algeria,04/06/2009,47,0,-2,0,6,0,0,51
Algeria,05/06/2009,27,0,0,0,-2,1,0,26
Algeria,06/06/2009,16,0,0,0,9,0,0,25
Algeria,07/06/2009,0,0,0,0,0,5,0,5
Algeria,08/06/2009,6,0,0,0,9,3,0,18
Algeria,09/06/2009,8,0,0,0,6,2,0,16
Algeria,10/06/2009,2,0,0,0,13,0,0,15
Algeria,11/06/2009,0,0,0,0,14,1,0,15
Algeria,12/06/2009,-4,0,0,0,0,0,0,-4
Algeria,13/06/2009,0,0,-1,0,-2,0,0,-3
Algeria,14/06/2009,5,0,0,0,-3,0,0,2
Algeria,15/06/2009,1,0,0,0,0,0,0,1
Algeria,16/06/2009,3,0,0,0,0,0,0,3
Algeria,17/06/2009,27,0,0,0,13,4,0,44
Algeria,18/06/2009,40,0,0,0,9,12,0,61
Algeria,19/06/2009,20,0,0,0,3,2,0,25
Algeria,20/06/2009,4,0,0,0,0,0,0,4
Algeria,21/06/2009,0,0,0,0,0,2,0,2
Algeria,22/06/2009,5,0,0,0,0,0,0,5
Algeria,23/06/2009,6,0,0,0,4,0,0,10
Algeria,24/06/2009,2,0,0,0,1,0,0,3
Algeria,25/06/2009,5,0,0,0,36,3,0,44
Algeria,26/06/2009,4,0,0,0,0,0,0,4
Algeria,27/06/2009,0,0,0,0,0,0,0,0
Algeria,28/06/2009,0,0,0,0,0,0,0,0
Algeria,29/06/2009,0,0,0,0,3,0,0,3
Algeria,30/06/2009,3,0,0,0,15,0,0,18
Bangladesh,01/06/2009,4,0,0,0,6,0,0,10
Bangladesh,02/06/2009,0,0,-10,0,6,0,0,-4
Bangladesh,03/06/2009,12,0,-2,0,12,0,0,22
Bangladesh,04/06/2009,12,0,-2,0,-1,0,0,9
Bangladesh,05/06/2009,20,0,0,0,10,1,0,31
Bangladesh,06/06/2009,2,0,0,0,5,0,0,7
Bangladesh,07/06/2009,10,0,0,0,0,1,0,11
Bangladesh,08/06/2009,21,0,0,0,1,4,0,26
Bangladesh,09/06/2009,6,0,0,0,-1,1,0,6
Bangladesh,10/06/2009,20,0,0,0,6,1,0,27
Bangladesh,11/06/2009,7,0,0,0,15,7,0,29
Bangladesh,12/06/2009,13,0,1,0,-1,0,0,13
Bangladesh,13/06/2009,13,0,0,0,3,0,0,16
Bangladesh,14/06/2009,15,2,3,0,9,1,0,30
Bangladesh,15/06/2009,13,0,0,0,-2,2,0,13
Bangladesh,16/06/2009,13,0,0,0,-2,2,0,13
Bangladesh,17/06/2009,3,0,0,0,3,0,0,6
Bangladesh,18/06/2009,6,0,0,0,3,6,0,15
Bangladesh,19/06/2009,7,0,0,0,0,0,0,7
Bangladesh,20/06/2009,18,0,0,0,-4,4,0,18
Bangladesh,21/06/2009,3,0,0,0,0,4,0,7
Bangladesh,22/06/2009,14,0,0,0,3,2,0,19
Bangladesh,23/06/2009,16,0,-2,0,9,0,0,23
Bangladesh,24/06/2009,8,0,0,0,0,0,0,8
Bangladesh,25/06/2009,21,0,0,0,12,2,0,35
Bangladesh,26/06/2009,5,0,0,0,3,0,0,8
Bangladesh,27/06/2009,2,0,0,0,0,0,0,2
Bangladesh,28/06/2009,23,0,0,0,3,0,0,26
Bangladesh,29/06/2009,8,0,0,0,3,2,0,13
Bangladesh,30/06/2009,6,0,0,0,-2,1,0,5
Cameroon,01/06/2009,0,0,0,0,0,0,0,0
Cameroon,02/06/2009,-1,0,0,0,9,0,0,8
Cameroon,03/06/2009,0,0,0,0,0,0,0,0
Cameroon,04/06/2009,9,0,0,0,0,0,0,9
Cameroon,05/06/2009,0,0,0,0,0,0,0,0
Cameroon,06/06/2009,0,0,-2,0,0,0,0,-2
Cameroon,07/06/2009,0,0,0,0,3,0,0,3
Cameroon,08/06/2009,0,0,0,0,3,0,0,3
Cameroon,09/06/2009,0,0,0,0,0,0,0,0
Cameroon,10/06/2009,0,0,0,0,0,2,0,2
Cameroon,11/06/2009,0,0,0,0,0,0,0,0
Cameroon,12/06/2009,0,0,0,0,0,0,0,0
Cameroon,13/06/2009,0,0,1,0,0,0,0,1
Cameroon,14/06/2009,0,0,0,0,0,0,0,0
Cameroon,15/06/2009,4,0,0,0,0,0,0,4
Cameroon,16/06/2009,0,0,0,0,3,0,0,3
Cameroon,17/06/2009,0,0,0,0,3,0,0,3
Cameroon,18/06/2009,0,0,0,0,0,0,0,0
Cameroon,19/06/2009,0,0,0,0,0,0,0,0
Cameroon,20/06/2009,4,0,0,0,0,0,0,4
Cameroon,21/06/2009,0,0,0,0,0,0,0,0
Cameroon,22/06/2009,2,0,0,0,0,0,0,2
Cameroon,23/06/2009,0,0,0,0,0,0,0,0
Cameroon,24/06/2009,0,0,0,0,0,0,0,0
Cameroon,25/06/2009,3,0,0,0,9,0,0,12
Cameroon,26/06/2009,0,0,0,0,0,0,0,0
Cameroon,29/06/2009,3,0,0,0,3,0,0,6
Cameroon,30/06/2009,0,0,0,0,0,0,0,0
China,01/06/2009,69,0,-1,0,78,19,0,165
China,02/06/2009,125,6,-2,0,75,35,0,239
China,03/06/2009,105,2,0,0,73,8,0,188
China,04/06/2009,99,0,-14,0,57,6,0,148
China,05/06/2009,121,2,-4,0,41,11,0,171
China,06/06/2009,43,0,-10,0,18,9,0,60
China,07/06/2009,61,0,-5,0,21,5,0,82
China,08/06/2009,136,0,-4,0,149,22,0,303
China,09/06/2009,93,6,2,0,100,8,0,209
China,10/06/2009,76,2,0,0,88,19,0,185
China,11/06/2009,96,0,1,0,49,15,0,161
China,12/06/2009,116,8,1,0,40,2,0,167
China,13/06/2009,65,8,0,0,-3,8,0,78
China,14/06/2009,42,0,0,0,7,12,0,61
China,15/06/2009,91,0,0,0,20,16,0,127
China,16/06/2009,139,0,-8,0,97,11,0,239
China,17/06/2009,63,6,2,0,19,6,0,96
China,18/06/2009,88,0,-1,0,76,30,0,193
China,19/06/2009,98,0,-5,0,142,15,0,250
China,20/06/2009,65,0,-3,0,86,7,0,155
China,21/06/2009,43,0,0,0,50,9,0,102
China,22/06/2009,60,0,0,0,29,4,0,93
China,23/06/2009,107,4,2,0,80,14,0,207
China,24/06/2009,103,4,2,0,50,7,0,166
China,25/06/2009,93,8,-3,0,54,18,0,170
China,26/06/2009,50,4,3,0,38,8,0,103
China,27/06/2009,42,4,1,0,19,9,0,75
China,28/06/2009,32,0,0,0,25,3,0,60
China,29/06/2009,50,0,0,0,20,10,0,80
China,30/06/2009,85,0,0,0,-5,3,0,83
Egypt,01/06/2009,39,0,0,0,30,5,0,74
Egypt,02/06/2009,68,0,0,0,7,7,0,82
Egypt,03/06/2009,46,0,2,0,13,8,0,69
Egypt,04/06/2009,31,0,2,0,1,10,0,44
Egypt,05/06/2009,20,0,-3,0,9,2,0,28
Egypt,06/06/2009,6,0,0,0,12,3,0,21
Egypt,07/06/2009,5,0,0,0,6,5,0,16
Egypt,08/06/2009,46,4,-1,0,25,6,0,80
Egypt,09/06/2009,7,0,1,0,9,6,0,23
Egypt,10/06/2009,10,0,0,0,1,0,0,11
Egypt,11/06/2009,19,0,0,0,15,5,0,39
Egypt,12/06/2009,19,0,0,0,6,0,0,25
Egypt,13/06/2009,2,0,0,0,15,0,0,17
Egypt,14/06/2009,8,0,-4,0,14,5,0,23
Egypt,15/06/2009,46,0,-1,0,1,0,0,46
Egypt,16/06/2009,42,0,-2,0,19,7,0,66
Egypt,17/06/2009,21,0,-4,0,-5,3,0,15
Egypt,18/06/2009,11,0,-4,0,19,1,0,27
Egypt,19/06/2009,10,0,1,0,-10,0,0,1
Egypt,20/06/2009,17,0,0,0,0,1,0,18
Egypt,21/06/2009,19,0,0,0,9,0,0,28
Egypt,22/06/2009,27,0,0,0,22,0,0,49
Egypt,23/06/2009,24,0,0,0,-5,1,0,20
Egypt,24/06/2009,86,0,0,0,15,2,0,103
Egypt,25/06/2009,62,0,0,0,11,5,0,78
Egypt,26/06/2009,22,0,0,0,6,1,0,29
Egypt,27/06/2009,14,0,0,0,2,0,0,16
Egypt,28/06/2009,14,0,0,0,19,0,0,33
Egypt,29/06/2009,14,0,-4,0,6,0,0,16
Egypt,30/06/2009,20,0,0,0,9,0,0,29
Eritrea,01/06/2009,4,0,0,0,0,0,0,4
Eritrea,02/06/2009,0,0,0,0,7,0,0,7
Eritrea,03/06/2009,0,0,0,0,0,0,0,0
Eritrea,04/06/2009,2,0,1,0,3,0,0,6
Eritrea,05/06/2009,2,0,1,0,0,0,0,3
Eritrea,06/06/2009,0,0,0,0,-3,0,0,-3
Eritrea,07/06/2009,0,0,0,0,0,0,0,0
Eritrea,08/06/2009,6,0,0,0,0,0,0,6
Eritrea,09/06/2009,17,0,0,0,3,4,0,24
Eritrea,10/06/2009,23,0,3,0,0,2,0,28
Eritrea,11/06/2009,0,0,0,0,0,0,0,0
Eritrea,12/06/2009,6,0,3,0,0,0,0,9
Eritrea,13/06/2009,6,0,0,0,0,0,0,6
Eritrea,14/06/2009,2,0,0,0,0,0,0,2
Eritrea,15/06/2009,9,0,0,0,0,0,0,9
Eritrea,16/06/2009,4,0,0,0,0,0,0,4
Eritrea,17/06/2009,7,0,0,0,0,0,0,7
Eritrea,18/06/2009,6,0,0,0,0,0,0,6
Eritrea,19/06/2009,0,0,0,0,0,0,0,0
Eritrea,20/06/2009,0,0,0,0,0,0,0,0
Eritrea,21/06/2009,5,0,0,0,3,0,0,8
Eritrea,22/06/2009,14,0,0,0,0,0,0,14
Eritrea,23/06/2009,3,0,0,0,0,0,0,3
Eritrea,24/06/2009,0,0,0,0,0,0,0,0
Eritrea,25/06/2009,21,0,0,0,0,0,0,21
Eritrea,26/06/2009,15,0,0,0,0,0,0,15
Eritrea,27/06/2009,33,0,0,0,0,0,0,33
Eritrea,28/06/2009,12,0,0,0,6,2,0,20
Eritrea,29/06/2009,4,0,0,0,0,4,0,8
Georgia,01/06/2009,15,0,0,0,12,5,0,32
Georgia,02/06/2009,22,0,-2,0,15,5,0,40
Georgia,03/06/2009,11,2,0,0,-2,0,0,11
Georgia,04/06/2009,16,0,0,0,3,1,0,20
Georgia,05/06/2009,27,0,0,0,-4,6,0,29
Georgia,06/06/2009,9,0,0,0,0,0,0,9
Georgia,07/06/2009,16,0,0,0,1,0,0,17
Georgia,08/06/2009,4,0,1,0,6,2,0,13
Georgia,09/06/2009,11,2,0,0,3,1,0,17
Georgia,10/06/2009,8,0,0,0,15,0,0,23
Georgia,11/06/2009,6,0,0,0,9,2,0,17
Georgia,12/06/2009,9,2,0,0,-2,2,0,11
Georgia,13/06/2009,8,0,0,0,0,0,0,8
Georgia,14/06/2009,8,0,0,0,10,0,0,18
Georgia,15/06/2009,13,0,0,0,6,2,0,21
Georgia,16/06/2009,18,0,0,0,19,12,0,49
Georgia,17/06/2009,6,0,1,0,-1,1,0,7
Georgia,18/06/2009,5,0,0,0,6,7,0,18
Georgia,19/06/2009,10,0,0,0,6,2,0,18
Georgia,20/06/2009,13,0,-4,0,13,6,0,28
Georgia,21/06/2009,7,0,0,0,12,0,0,19
Georgia,22/06/2009,7,0,0,0,0,2,0,9
Georgia,23/06/2009,25,0,0,0,12,0,0,37
Georgia,24/06/2009,5,0,0,0,6,1,0,12
Georgia,25/06/2009,2,0,0,0,9,3,0,14
Georgia,26/06/2009,2,0,-2,0,0,1,0,1
Georgia,27/06/2009,1,0,2,0,0,0,0,3
Georgia,28/06/2009,6,0,0,0,0,0,0,6
Georgia,29/06/2009,3,0,0,0,0,0,0,3
Georgia,30/06/2009,5,0,0,0,18,0,0,23
India,01/06/2009,36,0,-7,0,31,17,0,77
India,02/06/2009,45,2,-18,0,24,8,0,61
India,03/06/2009,40,0,-13,0,7,8,0,42
India,04/06/2009,39,2,0,0,21,10,0,72
India,05/06/2009,56,0,-1,0,16,6,0,77
India,06/06/2009,23,0,-1,0,9,0,0,31
India,07/06/2009,35,0,0,0,16,8,0,59
India,08/06/2009,58,0,-1,0,19,5,0,81
India,09/06/2009,52,0,0,0,13,12,0,77
India,10/06/2009,35,2,1,0,3,14,0,55
India,11/06/2009,54,0,0,0,10,6,0,70
India,12/06/2009,58,0,0,0,6,2,0,66
India,13/06/2009,48,0,0,0,0,9,0,57
India,14/06/2009,33,0,-1,0,16,1,0,49
India,15/06/2009,36,0,-1,0,25,4,0,64
India,16/06/2009,36,0,-1,0,21,9,0,65
India,17/06/2009,47,2,-4,0,28,7,0,80
India,18/06/2009,27,2,0,0,4,11,0,44
India,19/06/2009,22,0,0,0,1,3,0,26
India,20/06/2009,30,0,-1,0,14,0,0,43
India,21/06/2009,17,0,0,0,-1,2,0,18
India,22/06/2009,67,4,1,0,4,6,0,82
India,23/06/2009,72,0,-1,0,33,11,0,115
India,24/06/2009,49,2,-3,0,14,0,0,62
India,25/06/2009,50,0,-3,0,30,5,0,82
India,26/06/2009,14,0,0,0,4,15,0,33
India,27/06/2009,24,2,-1,0,10,2,0,37
India,28/06/2009,17,0,2,0,0,0,0,19
India,29/06/2009,49,0,0,0,6,1,0,56
India,30/06/2009,15,0,0,0,16,0,0,31
Iran,01/06/2009,47,0,0,0,26,22,0,95
Iran,02/06/2009,96,0,1,0,10,3,0,110
Iran,03/06/2009,56,0,5,0,44,0,0,105
Iran,04/06/2009,138,0,1,0,34,24,0,197
Iran,05/06/2009,75,0,2,0,-5,5,0,77
Iran,06/06/2009,64,0,3,0,20,3,0,90
Iran,07/06/2009,38,0,2,0,14,2,0,56
Iran,08/06/2009,34,0,-3,0,12,10,0,53
Iran,09/06/2009,59,0,3,0,3,7,0,72
Iran,10/06/2009,66,2,-1,0,24,12,0,103
Iran,11/06/2009,51,0,1,0,68,5,0,125
Iran,12/06/2009,68,0,1,0,53,25,0,147
Iran,13/06/2009,86,2,0,0,16,18,0,122
Iran,14/06/2009,121,0,-5,0,34,25,0,175
Iran,15/06/2009,117,0,-2,0,72,35,0,222
Iran,16/06/2009,138,6,4,0,113,34,0,295
Iran,17/06/2009,126,2,8,0,159,39,0,334
Iran,18/06/2009,134,0,3,0,73,29,0,239
Iran,19/06/2009,122,0,3,0,48,36,0,209
Iran,20/06/2009,167,4,14,0,10,46,0,241
Iran,21/06/2009,212,0,0,0,44,38,0,294
Iran,22/06/2009,165,4,8,0,89,44,0,310
Iran,23/06/2009,195,2,8,0,93,41,0,339
Iran,24/06/2009,166,0,7,0,114,35,0,322
Iran,25/06/2009,163,0,6,0,104,48,0,321
Iran,26/06/2009,124,4,-2,0,68,28,0,222
Iran,27/06/2009,64,0,2,0,51,23,0,140
Iran,28/06/2009,63,0,1,0,55,14,0,133
Iran,29/06/2009,33,0,-1,0,13,11,0,56
Iran,30/06/2009,56,2,4,0,24,3,0,89
Iraq,01/06/2009,79,0,-4,0,24,15,0,114
Iraq,02/06/2009,90,0,0,0,19,27,0,136
Iraq,03/06/2009,110,4,0,0,49,16,0,179
Iraq,04/06/2009,126,4,-1,0,21,6,0,156
Iraq,05/06/2009,103,2,0,0,29,8,0,142
Iraq,06/06/2009,18,0,-6,0,9,9,0,30
Iraq,07/06/2009,20,0,-4,0,12,2,0,30
Iraq,08/06/2009,55,0,-2,0,-8,5,0,50
Iraq,09/06/2009,58,6,-2,0,-64,6,0,4
Iraq,10/06/2009,105,6,-4,0,41,13,0,161
Iraq,11/06/2009,82,0,-2,0,37,3,0,120
Iraq,12/06/2009,102,0,0,0,48,1,0,151
Iraq,13/06/2009,51,0,-6,0,40,3,0,88
Iraq,14/06/2009,75,0,0,0,33,4,0,112
Iraq,15/06/2009,6,0,-1,0,43,13,0,61
Iraq,16/06/2009,166,0,0,0,40,26,0,232
Iraq,17/06/2009,124,2,0,0,-11,12,0,127
Iraq,18/06/2009,118,0,-7,0,35,23,0,169
Iraq,19/06/2009,66,0,-10,0,21,14,0,91
Iraq,20/06/2009,77,0,-3,0,43,36,0,153
Iraq,21/06/2009,84,0,0,0,50,6,0,140
Iraq,22/06/2009,81,0,0,0,42,11,0,134
Iraq,23/06/2009,119,2,2,0,33,7,0,163
Iraq,24/06/2009,48,8,-1,0,6,0,0,61
Iraq,25/06/2009,57,8,1,0,5,10,0,81
Iraq,26/06/2009,31,0,1,0,2,7,0,41
Iraq,27/06/2009,41,0,0,0,0,2,0,43
Iraq,28/06/2009,14,0,1,0,6,8,0,29
Iraq,29/06/2009,58,0,0,0,6,0,0,64
Iraq,30/06/2009,42,2,4,0,26,8,0,82
Morocco,01/06/2009,3,0,0,0,0,0,0,3
Morocco,02/06/2009,-2,0,0,0,0,0,0,-2
Morocco,03/06/2009,5,0,0,0,1,2,0,8
Morocco,04/06/2009,2,0,0,0,0,3,0,5
Morocco,05/06/2009,3,0,0,0,6,0,0,9
Morocco,06/06/2009,23,0,0,0,0,0,0,23
Morocco,07/06/2009,17,0,0,0,0,0,0,17
Morocco,08/06/2009,8,0,0,0,0,0,0,8
Morocco,09/06/2009,0,0,0,0,12,0,0,12
Morocco,10/06/2009,16,0,0,0,3,1,0,20
Morocco,11/06/2009,0,0,0,0,0,0,0,0
Morocco,12/06/2009,4,0,0,0,0,1,0,5
Morocco,13/06/2009,1,0,0,0,0,0,0,1
Morocco,14/06/2009,-6,0,0,0,0,0,0,-6
Morocco,15/06/2009,0,0,0,0,3,0,0,3
Morocco,16/06/2009,-2,0,0,0,11,4,0,13
Morocco,17/06/2009,10,0,0,0,6,1,0,17
Morocco,18/06/2009,3,0,0,0,0,1,0,4
Morocco,19/06/2009,0,0,0,0,3,1,0,4
Morocco,20/06/2009,3,0,0,0,3,1,0,7
Morocco,21/06/2009,6,0,0,0,0,0,0,6
Morocco,22/06/2009,6,0,0,0,0,0,0,6
Morocco,23/06/2009,5,0,0,0,9,0,0,14
Morocco,24/06/2009,6,0,0,0,4,0,0,10
Morocco,25/06/2009,12,0,-2,0,22,6,0,38
Morocco,26/06/2009,0,0,0,0,6,0,0,6
Morocco,27/06/2009,0,0,0,0,-2,0,0,-2
Morocco,28/06/2009,0,0,0,0,6,0,0,6
Morocco,29/06/2009,7,0,0,0,0,0,0,7
Morocco,30/06/2009,0,0,0,0,0,1,0,1
Nigeria,01/06/2009,18,0,1,0,10,1,0,30
Nigeria,02/06/2009,13,0,0,0,-4,4,0,13
Nigeria,03/06/2009,36,0,0,0,15,3,0,54
Nigeria,04/06/2009,15,0,4,0,9,6,0,34
Nigeria,05/06/2009,5,0,0,0,7,0,0,12
Nigeria,06/06/2009,4,0,0,0,2,0,0,6
Nigeria,07/06/2009,24,0,0,0,0,0,0,24
Nigeria,08/06/2009,27,0,0,0,5,2,0,34
Nigeria,09/06/2009,23,0,0,0,30,3,0,56
Nigeria,10/06/2009,71,0,0,0,11,6,0,88
Nigeria,11/06/2009,-4,0,1,0,15,1,0,13
Nigeria,12/06/2009,19,0,0,0,10,10,0,39
Nigeria,13/06/2009,9,0,0,0,15,1,0,25
Nigeria,14/06/2009,4,0,0,0,9,0,0,13
Nigeria,15/06/2009,18,0,0,0,9,2,0,29
Nigeria,16/06/2009,25,0,0,0,-9,0,0,16
Nigeria,17/06/2009,9,0,2,0,0,1,0,12
Nigeria,18/06/2009,54,0,2,0,31,3,0,90
Nigeria,19/06/2009,48,0,0,0,5,3,0,56
Nigeria,20/06/2009,30,4,0,0,0,4,0,38
Nigeria,21/06/2009,12,4,0,0,1,0,0,17
Nigeria,22/06/2009,24,0,0,0,19,6,0,49
Nigeria,23/06/2009,17,0,-1,0,1,3,0,20
Nigeria,24/06/2009,22,0,0,0,30,-1,0,51
Nigeria,25/06/2009,37,0,0,0,13,3,0,53
Nigeria,26/06/2009,2,0,0,0,9,2,0,13
Nigeria,27/06/2009,6,0,0,0,6,0,0,12
Nigeria,28/06/2009,4,0,0,0,-7,0,0,-3
Nigeria,29/06/2009,2,0,2,0,10,3,0,17
Nigeria,30/06/2009,23,0,0,0,9,0,0,32
Pakistan,01/06/2009,127,0,0,0,58,16,0,201
Pakistan,02/06/2009,107,0,-6,0,28,10,0,139
Pakistan,03/06/2009,132,0,-5,0,31,33,0,191
Pakistan,04/06/2009,101,2,3,0,15,4,0,125
Pakistan,05/06/2009,56,2,0,0,38,7,0,103
Pakistan,06/06/2009,82,0,0,0,37,46,0,165
Pakistan,07/06/2009,52,2,0,0,17,7,0,78
Pakistan,08/06/2009,70,0,0,0,25,5,0,100
Pakistan,09/06/2009,92,2,0,0,50,14,0,158
Pakistan,10/06/2009,54,0,0,0,33,0,0,87
Pakistan,11/06/2009,46,0,-4,0,30,8,0,80
Pakistan,12/06/2009,66,0,1,0,67,16,0,150
Pakistan,13/06/2009,32,0,0,0,27,6,0,65
Pakistan,14/06/2009,44,0,0,0,39,21,0,104
Pakistan,15/06/2009,56,2,0,0,9,4,0,71
Pakistan,16/06/2009,141,4,0,0,109,4,0,258
Pakistan,17/06/2009,69,0,0,0,7,4,0,80
Pakistan,18/06/2009,69,0,0,0,24,2,0,95
Pakistan,19/06/2009,44,0,0,0,31,6,0,81
Pakistan,20/06/2009,49,0,0,0,21,8,0,78
Pakistan,21/06/2009,42,0,0,0,24,13,0,79
Pakistan,22/06/2009,68,2,0,0,25,8,0,103
Pakistan,23/06/2009,112,4,-1,0,57,12,0,184
Pakistan,24/06/2009,71,0,1,0,7,14,0,93
Pakistan,25/06/2009,59,0,0,0,26,7,0,92
Pakistan,26/06/2009,61,0,1,0,2,8,0,72
Pakistan,27/06/2009,77,0,0,0,9,2,0,88
Pakistan,28/06/2009,41,0,0,0,6,6,0,53
Pakistan,29/06/2009,87,0,0,0,33,1,0,121
Pakistan,30/06/2009,52,0,1,0,25,9,0,87
Sierra Leone,01/06/2009,0,0,0,0,3,0,0,3
Sierra Leone,02/06/2009,0,0,0,0,0,0,0,0
Sierra Leone,03/06/2009,3,0,0,0,9,1,0,13
Sierra Leone,04/06/2009,0,0,0,0,3,0,0,3
Sierra Leone,05/06/2009,0,0,0,0,0,0,0,0
Sierra Leone,06/06/2009,0,0,0,0,3,0,0,3
Sierra Leone,07/06/2009,0,0,0,0,0,0,0,0
Sierra Leone,08/06/2009,7,0,0,0,6,1,0,14
Sierra Leone,09/06/2009,1,0,0,0,0,3,0,4
Sierra Leone,10/06/2009,-1,0,0,0,9,0,0,8
Sierra Leone,11/06/2009,-9,0,0,0,0,2,0,-7
Sierra Leone,12/06/2009,0,0,0,0,0,0,0,0
Sierra Leone,13/06/2009,1,0,0,0,0,0,0,1
Sierra Leone,14/06/2009,0,0,0,0,0,0,0,0
Sierra Leone,15/06/2009,0,0,0,0,0,0,0,0
Sierra Leone,16/06/2009,6,0,-1,0,0,0,0,5
Sierra Leone,17/06/2009,3,0,0,0,0,0,0,3
Sierra Leone,18/06/2009,9,0,0,0,1,0,0,10
Sierra Leone,19/06/2009,0,0,0,0,0,0,0,0
Sierra Leone,22/06/2009,0,0,0,0,0,0,0,0
Sierra Leone,23/06/2009,2,0,0,0,0,0,0,2
Sierra Leone,24/06/2009,10,0,0,0,-4,0,0,6
Sierra Leone,25/06/2009,2,0,0,0,0,0,0,2
Sierra Leone,27/06/2009,2,0,0,0,0,0,0,2
Sierra Leone,28/06/2009,6,0,0,0,0,0,0,6
Sierra Leone,29/06/2009,0,0,0,0,0,0,0,0
Sierra Leone,30/06/2009,0,0,0,0,0,0,0,0
Somalia,01/06/2009,44,0,0,0,33,5,0,82
Somalia,02/06/2009,21,0,0,0,15,11,0,47
Somalia,03/06/2009,26,0,0,0,10,12,0,48
Somalia,04/06/2009,7,0,0,0,9,2,0,18
Somalia,05/06/2009,21,0,0,0,7,1,0,29
Somalia,06/06/2009,18,0,0,0,24,0,0,42
Somalia,07/06/2009,2,0,0,0,-8,0,0,-6
Somalia,08/06/2009,23,0,0,0,13,1,0,37
Somalia,09/06/2009,64,0,0,0,0,11,0,75
Somalia,10/06/2009,43,4,0,0,31,2,0,80
Somalia,11/06/2009,8,2,0,0,20,1,0,31
Somalia,12/06/2009,32,2,0,0,48,6,0,88
Somalia,13/06/2009,14,0,0,0,7,8,0,29
Somalia,14/06/2009,17,0,0,0,0,4,0,21
Somalia,15/06/2009,18,0,0,0,14,8,0,40
Somalia,16/06/2009,35,0,0,0,4,10,0,49
Somalia,17/06/2009,29,4,1,0,-2,1,0,33
Somalia,18/06/2009,105,10,0,0,23,18,0,156
Somalia,19/06/2009,95,0,0,0,15,2,0,112
Somalia,20/06/2009,25,0,0,0,10,4,0,39
Somalia,21/06/2009,24,0,0,0,43,5,0,72
Somalia,22/06/2009,73,0,0,0,51,8,0,132
Somalia,23/06/2009,31,0,-1,0,27,0,0,57
Somalia,24/06/2009,25,0,0,0,8,1,0,34
Somalia,25/06/2009,27,0,0,0,4,2,0,33
Somalia,26/06/2009,41,0,0,0,9,8,0,58
Somalia,27/06/2009,19,0,0,0,0,1,0,20
Somalia,28/06/2009,4,0,0,0,-1,1,0,4
Somalia,29/06/2009,48,0,1,0,-5,2,0,46
Somalia,30/06/2009,31,0,0,0,18,0,0,49
Syria,01/06/2009,1,0,0,0,0,0,0,1
Syria,02/06/2009,29,0,0,0,3,6,0,38
Syria,03/06/2009,5,0,0,0,0,3,0,8
Syria,04/06/2009,11,0,1,0,3,6,0,21
Syria,05/06/2009,31,0,1,0,6,2,0,40
Syria,06/06/2009,-2,0,0,0,0,2,0,0
Syria,07/06/2009,7,0,2,0,5,5,0,19
Syria,08/06/2009,17,0,-8,0,20,9,0,38
Syria,09/06/2009,25,0,-2,0,13,5,0,41
Syria,10/06/2009,26,0,1,0,9,2,0,38
Syria,11/06/2009,19,0,0,0,12,2,0,33
Syria,12/06/2009,-4,0,0,0,-1,0,0,-5
Syria,13/06/2009,6,0,0,0,-2,1,0,5
Syria,14/06/2009,-1,0,0,0,3,-1,0,1
Syria,15/06/2009,14,0,0,0,0,4,0,18
Syria,16/06/2009,4,0,0,0,9,3,0,16
Syria,17/06/2009,23,0,0,0,0,0,0,23
Syria,18/06/2009,42,0,-2,0,3,0,0,43
Syria,19/06/2009,4,0,0,0,3,1,0,8
Syria,20/06/2009,8,0,0,0,3,0,0,11
Syria,21/06/2009,19,0,0,0,6,0,0,25
Syria,22/06/2009,3,0,0,0,12,2,0,17
Syria,23/06/2009,1,0,0,0,44,0,0,45
Syria,24/06/2009,1,0,0,0,3,0,0,4
Syria,25/06/2009,11,0,-2,0,24,0,0,33
Syria,26/06/2009,7,0,1,0,0,0,0,8
Syria,27/06/2009,7,0,0,0,0,3,0,10
Syria,28/06/2009,13,0,1,0,0,0,0,14
Syria,29/06/2009,23,0,-4,0,0,3,0,22
Syria,30/06/2009,9,0,0,0,0,0,0,9
Yemen,01/06/2009,35,0,-1,0,2,1,0,37
Yemen,02/06/2009,15,0,0,0,39,7,0,61
Yemen,03/06/2009,50,0,0,0,27,6,0,83
Yemen,04/06/2009,4,0,0,0,19,2,0,25
Yemen,05/06/2009,19,0,0,0,11,0,0,30
Yemen,06/06/2009,3,0,0,0,-8,1,0,-4
Yemen,07/06/2009,13,2,1,0,-8,3,0,11
Yemen,08/06/2009,10,0,0,0,33,4,0,47
Yemen,09/06/2009,9,0,0,0,18,4,0,31
Yemen,10/06/2009,10,0,0,0,9,4,0,23
Yemen,11/06/2009,13,0,-1,0,45,0,0,57
Yemen,12/06/2009,29,0,0,0,7,1,0,37
Yemen,13/06/2009,18,0,0,0,5,2,0,25
Yemen,14/06/2009,24,0,0,0,84,0,0,108
Yemen,15/06/2009,93,0,0,0,88,17,0,198
Yemen,16/06/2009,137,0,0,0,80,20,0,237
Yemen,17/06/2009,13,0,0,0,17,9,0,39
Yemen,18/06/2009,13,0,0,0,30,7,0,50
Yemen,19/06/2009,41,0,0,0,0,0,0,41
Yemen,20/06/2009,35,0,0,0,4,0,0,39
Yemen,21/06/2009,60,0,0,0,13,8,0,81
Yemen,22/06/2009,22,0,0,0,15,3,0,40
Yemen,23/06/2009,26,0,0,0,15,1,0,42
Yemen,24/06/2009,8,0,0,0,1,4,0,13
Yemen,25/06/2009,17,0,0,0,3,0,0,20
Yemen,26/06/2009,6,0,0,0,12,0,0,18
Yemen,27/06/2009,8,0,0,0,-4,0,0,4
Yemen,28/06/2009,3,0,3,0,6,0,0,12
Yemen,29/06/2009,2,0,0,0,9,0,0,11
Yemen,30/06/2009,18,0,0,0,3,0,0,21
Afghanistan,01/05/2012,295,3,2,0,54,16,0,370
Afghanistan,02/05/2012,180,4,0,0,60,26,0,270
Afghanistan,03/05/2012,176,2,1,0,35,24,0,238
Afghanistan,04/05/2012,345,0,0,0,13,45,0,403
Afghanistan,05/05/2012,165,0,0,0,24,16,0,205
Afghanistan,06/05/2012,234,2,0,0,22,26,0,284
Afghanistan,07/05/2012,365,2,-1,0,98,28,0,492
Afghanistan,08/05/2012,346,2,-4,0,63,21,0,428
Afghanistan,09/05/2012,191,0,1,0,60,21,0,273
Afghanistan,10/05/2012,39,0,-5,0,12,6,0,52
Afghanistan,11/05/2012,174,2,0,0,46,0,0,222
Afghanistan,12/05/2012,200,0,-6,0,-7,13,0,200
Afghanistan,13/05/2012,203,0,0,0,-4,13,0,212
Afghanistan,14/05/2012,173,4,-2,0,39,14,0,228
Afghanistan,15/05/2012,205,4,0,0,60,35,0,304
Afghanistan,16/05/2012,178,0,0,0,73,9,0,260
Afghanistan,17/05/2012,274,2,0,0,68,40,0,384
Afghanistan,18/05/2012,130,4,3,0,31,40,0,208
Afghanistan,19/05/2012,174,8,-1,0,55,54,0,290
Afghanistan,20/05/2012,257,4,-1,0,79,30,0,369
Afghanistan,21/05/2012,375,32,-4,0,103,50,0,556
Afghanistan,22/05/2012,291,4,-20,0,46,35,0,356
Afghanistan,23/05/2012,305,4,-6,0,111,19,0,433
Afghanistan,24/05/2012,231,6,3,0,114,17,0,371
Afghanistan,25/05/2012,223,2,0,0,72,17,0,314
Afghanistan,26/05/2012,175,0,-4,0,42,4,0,217
Afghanistan,27/05/2012,294,2,-4,0,22,13,0,327
Afghanistan,28/05/2012,408,0,-5,0,37,25,0,465
Afghanistan,29/05/2012,372,0,0,0,21,3,0,396
Afghanistan,30/05/2012,226,4,3,0,34,14,0,281
Afghanistan,31/05/2012,121,0,0,0,18,23,0,162
Albania,01/05/2012,31,0,0,0,33,0,0,64
Albania,02/05/2012,7,0,-5,0,42,0,0,44
Albania,03/05/2012,8,0,-2,0,17,0,0,23
Albania,04/05/2012,45,0,-2,0,38,10,0,91
Albania,05/05/2012,4,0,1,0,9,4,0,18
Albania,06/05/2012,19,0,0,0,12,2,0,33
Albania,07/05/2012,28,0,-2,0,3,3,0,32
Albania,08/05/2012,16,0,0,0,10,0,0,26
Albania,09/05/2012,0,0,0,0,1,2,0,3
Albania,10/05/2012,2,0,0,0,6,0,0,8
Albania,11/05/2012,34,0,0,0,12,14,0,60
Albania,12/05/2012,8,0,0,0,-2,0,0,6
Albania,13/05/2012,0,0,0,0,3,0,0,3
Albania,14/05/2012,5,0,0,0,0,0,0,5
Albania,15/05/2012,16,0,1,0,-2,2,0,17
Albania,16/05/2012,5,0,0,0,6,0,0,11
Albania,17/05/2012,26,0,-2,0,12,0,0,36
Albania,18/05/2012,9,0,0,0,0,1,0,10
Albania,19/05/2012,0,0,0,0,3,0,0,3
Albania,20/05/2012,14,0,0,0,0,0,0,14
Albania,21/05/2012,7,0,0,0,0,2,0,9
Albania,22/05/2012,6,0,-2,0,6,0,0,10
Albania,23/05/2012,9,0,0,0,1,1,0,11
Albania,24/05/2012,8,0,0,0,6,0,0,14
Albania,25/05/2012,9,0,0,0,-4,0,0,5
Albania,26/05/2012,0,0,0,0,6,0,0,6
Albania,27/05/2012,1,0,0,0,0,0,0,1
Albania,28/05/2012,5,0,0,0,9,0,0,14
Albania,29/05/2012,2,0,-1,0,0,1,0,2
Albania,30/05/2012,2,0,0,0,3,1,0,6
Albania,31/05/2012,11,0,0,0,6,0,0,17
Algeria,01/05/2012,5,0,0,0,6,2,0,13
Algeria,02/05/2012,6,0,0,0,16,0,0,22
Algeria,03/05/2012,11,0,-4,0,22,0,0,29
Algeria,04/05/2012,24,0,2,0,86,6,0,118
Algeria,05/05/2012,55,0,0,0,61,5,0,121
Algeria,06/05/2012,4,0,0,0,5,3,0,12
Algeria,07/05/2012,39,0,1,0,6,8,0,54
Algeria,08/05/2012,17,0,0,0,2,0,0,19
Algeria,09/05/2012,3,0,-2,0,15,3,0,19
Algeria,10/05/2012,15,0,4,0,3,10,0,32
Algeria,11/05/2012,18,0,-2,0,14,2,0,32
Algeria,12/05/2012,12,0,2,0,3,5,0,22
Algeria,13/05/2012,-2,0,0,0,9,3,0,10
Algeria,14/05/2012,5,0,0,0,3,1,0,9
Algeria,15/05/2012,0,0,0,0,0,0,0,0
Algeria,16/05/2012,9,0,0,0,6,0,0,15
Algeria,17/05/2012,11,0,0,0,13,4,0,28
Algeria,18/05/2012,8,0,0,0,0,-4,0,4
Algeria,19/05/2012,4,0,0,0,0,0,0,4
Algeria,20/05/2012,2,0,0,0,12,8,0,22
Algeria,21/05/2012,-2,0,0,0,15,4,0,17
Algeria,22/05/2012,23,0,0,0,15,0,0,38
Algeria,23/05/2012,13,0,0,0,3,0,0,16
Algeria,24/05/2012,4,0,0,0,6,0,0,10
Algeria,25/05/2012,18,0,0,0,6,9,0,33
Algeria,26/05/2012,4,0,0,0,9,2,0,15
Algeria,27/05/2012,4,0,0,0,3,0,0,7
Algeria,28/05/2012,8,0,0,0,7,0,0,15
Algeria,29/05/2012,12,0,1,0,0,3,0,16
Algeria,30/05/2012,19,0,-2,0,-2,3,0,18
Algeria,31/05/2012,9,0,0,0,-3,0,0,6
Bangladesh,01/05/2012,21,0,2,0,13,2,0,38
Bangladesh,02/05/2012,29,0,-4,0,12,6,0,43
Bangladesh,03/05/2012,38,0,0,0,7,1,0,46
Bangladesh,04/05/2012,10,0,0,0,15,2,0,27
Bangladesh,05/05/2012,6,0,0,0,9,-4,0,11
Bangladesh,06/05/2012,20,0,0,0,6,0,0,26
Bangladesh,07/05/2012,24,0,0,0,19,0,0,43
Bangladesh,08/05/2012,18,0,0,0,17,0,0,35
Bangladesh,09/05/2012,15,0,-4,0,3,0,0,14
Bangladesh,10/05/2012,3,0,-4,0,0,0,0,-1
Bangladesh,11/05/2012,10,0,0,0,27,0,0,37
Bangladesh,12/05/2012,1,0,0,0,25,1,0,27
Bangladesh,13/05/2012,26,0,0,0,61,11,0,98
Bangladesh,14/05/2012,38,0,0,0,21,9,0,68
Bangladesh,15/05/2012,23,0,0,0,49,1,0,73
Bangladesh,16/05/2012,25,0,0,0,19,2,0,46
Bangladesh,17/05/2012,20,2,0,0,9,1,0,32
Bangladesh,18/05/2012,10,0,0,0,13,8,0,31
Bangladesh,19/05/2012,7,0,0,0,0,1,0,8
Bangladesh,20/05/2012,7,0,0,0,9,1,0,17
Bangladesh,21/05/2012,4,0,0,0,3,0,0,7
Bangladesh,22/05/2012,9,0,0,0,4,1,0,14
Bangladesh,23/05/2012,18,0,0,0,7,0,0,25
Bangladesh,24/05/2012,-4,0,0,0,3,0,0,-1
Bangladesh,25/05/2012,7,0,0,0,1,0,0,8
Bangladesh,26/05/2012,1,0,0,0,-4,1,0,-2
Bangladesh,27/05/2012,19,0,2,0,5,9,0,35
Bangladesh,28/05/2012,17,0,1,0,26,1,0,45
Bangladesh,29/05/2012,20,0,1,0,3,0,0,24
Bangladesh,30/05/2012,13,0,0,0,1,1,0,15
Bangladesh,31/05/2012,9,0,0,0,16,2,0,27
Cameroon,01/05/2012,24,0,0,0,0,0,0,24
Cameroon,02/05/2012,1,0,0,0,-4,0,0,-3
Cameroon,03/05/2012,0,0,0,0,0,0,0,0
Cameroon,04/05/2012,4,0,0,0,18,0,0,22
Cameroon,05/05/2012,2,0,0,0,0,0,0,2
Cameroon,06/05/2012,5,0,0,0,0,0,0,5
Cameroon,07/05/2012,2,0,0,0,-2,0,0,0
Cameroon,08/05/2012,4,0,0,0,0,0,0,4
Cameroon,09/05/2012,10,2,2,0,13,0,0,27
Cameroon,10/05/2012,0,0,0,0,6,0,0,6
Cameroon,11/05/2012,0,0,0,0,0,0,0,0
Cameroon,12/05/2012,0,0,0,0,0,0,0,0
Cameroon,13/05/2012,6,0,0,0,0,0,0,6
Cameroon,14/05/2012,3,0,0,0,-2,0,0,1
Cameroon,15/05/2012,9,0,0,0,0,0,0,9
Cameroon,16/05/2012,0,0,0,0,0,0,0,0
Cameroon,17/05/2012,0,0,0,0,0,0,0,0
Cameroon,18/05/2012,3,0,0,0,0,2,0,5
Cameroon,19/05/2012,0,0,0,0,0,1,0,1
Cameroon,20/05/2012,1,0,0,0,0,0,0,1
Cameroon,21/05/2012,0,0,0,0,0,0,0,0
Cameroon,22/05/2012,6,0,-1,0,0,1,0,6
Cameroon,23/05/2012,13,0,-1,0,-2,1,0,11
Cameroon,24/05/2012,6,0,0,0,6,0,0,12
Cameroon,25/05/2012,0,0,0,0,3,0,0,3
Cameroon,26/05/2012,2,0,0,0,3,0,0,5
Cameroon,27/05/2012,0,0,0,0,0,0,0,0
Cameroon,28/05/2012,2,0,0,0,0,0,0,2
Cameroon,29/05/2012,0,0,0,0,0,1,0,1
Cameroon,30/05/2012,6,0,0,0,0,0,0,6
Cameroon,31/05/2012,0,0,0,0,0,0,0,0
China,01/05/2012,133,4,-3,0,59,21,0,214
China,02/05/2012,177,4,2,0,72,13,0,268
China,03/05/2012,154,8,1,0,21,16,0,200
China,04/05/2012,173,6,5,0,71,24,0,279
China,05/05/2012,59,4,1,0,12,16,0,92
China,06/05/2012,101,2,-4,0,18,43,0,160
China,07/05/2012,146,2,6,0,119,13,0,286
China,08/05/2012,124,4,-4,0,33,13,0,170
China,09/05/2012,167,0,-1,0,85,18,0,269
China,10/05/2012,89,0,1,0,28,20,0,138
China,11/05/2012,157,2,4,0,102,41,0,306
China,12/05/2012,104,14,0,0,28,27,0,173
China,13/05/2012,123,4,-6,0,58,18,0,197
China,14/05/2012,176,10,-13,0,74,19,0,266
China,15/05/2012,157,2,-6,0,155,27,0,335
China,16/05/2012,187,8,5,0,89,11,0,300
China,17/05/2012,134,10,-1,0,68,9,0,220
China,18/05/2012,150,2,1,0,171,12,0,336
China,19/05/2012,52,0,1,0,32,13,0,98
China,20/05/2012,101,8,-1,0,-19,6,0,95
China,21/05/2012,139,12,-1,0,61,25,0,236
China,22/05/2012,146,0,-5,0,85,39,0,265
China,23/05/2012,156,2,-7,0,161,15,0,327
China,24/05/2012,150,10,2,0,88,16,0,266
China,25/05/2012,131,4,3,0,57,12,0,207
China,26/05/2012,80,0,-2,0,25,11,0,114
China,27/05/2012,105,2,-1,0,0,21,0,127
China,28/05/2012,173,2,-8,0,63,37,0,267
China,29/05/2012,263,0,-8,0,76,33,0,364
China,30/05/2012,212,4,-3,0,98,43,0,354
China,31/05/2012,105,4,-5,0,82,16,0,202
Egypt,01/05/2012,59,2,-2,0,39,13,0,111
Egypt,02/05/2012,64,0,5,0,13,23,0,105
Egypt,03/05/2012,37,2,-13,0,32,7,0,65
Egypt,04/05/2012,79,2,-2,0,51,22,0,152
Egypt,05/05/2012,96,0,-4,0,67,17,0,176
Egypt,06/05/2012,41,0,-10,0,40,26,0,97
Egypt,07/05/2012,85,0,-10,0,31,8,0,114
Egypt,08/05/2012,56,0,5,0,59,17,0,137
Egypt,09/05/2012,60,0,-8,0,16,9,0,77
Egypt,10/05/2012,8,0,0,0,0,4,0,12
Egypt,11/05/2012,56,0,-3,0,25,11,0,89
Egypt,12/05/2012,55,2,-4,0,30,36,0,119
Egypt,13/05/2012,106,2,-6,0,23,14,0,139
Egypt,14/05/2012,55,2,-2,0,25,32,0,112
Egypt,15/05/2012,41,2,-11,0,22,7,0,61
Egypt,16/05/2012,55,0,-2,0,52,8,0,113
Egypt,17/05/2012,53,6,-7,0,55,12,0,119
Egypt,18/05/2012,31,2,-4,0,19,9,0,57
Egypt,19/05/2012,30,0,-2,0,36,11,0,75
Egypt,20/05/2012,10,0,1,0,24,22,0,57
Egypt,21/05/2012,61,0,0,0,47,26,0,134
Egypt,22/05/2012,72,0,-5,0,41,21,0,129
Egypt,23/05/2012,85,0,1,0,52,34,0,172
Egypt,24/05/2012,37,0,-9,0,64,32,0,124
Egypt,25/05/2012,74,0,-1,0,51,27,0,151
Egypt,26/05/2012,72,2,-1,0,10,13,0,96
Egypt,27/05/2012,73,0,0,0,46,11,0,130
Egypt,28/05/2012,101,0,-2,0,2,35,0,136
Egypt,29/05/2012,69,0,-2,0,26,28,0,121
Egypt,30/05/2012,41,0,1,0,46,15,0,103
Egypt,31/05/2012,24,0,1,0,11,24,0,60
Eritrea,01/05/2012,5,0,0,0,0,0,0,5
Eritrea,02/05/2012,3,0,0,0,43,2,0,48
Eritrea,03/05/2012,9,0,0,0,11,0,0,20
Eritrea,04/05/2012,9,0,0,0,8,0,0,17
Eritrea,06/05/2012,13,0,0,0,0,0,0,13
Eritrea,07/05/2012,3,0,0,0,7,0,0,10
Eritrea,08/05/2012,0,0,0,0,0,0,0,0
Eritrea,09/05/2012,4,0,0,0,3,2,0,9
Eritrea,10/05/2012,6,0,0,0,0,0,0,6
Eritrea,11/05/2012,1,0,0,0,0,2,0,3
Eritrea,12/05/2012,9,0,0,0,0,2,0,11
Eritrea,13/05/2012,0,0,1,0,0,0,0,1
Eritrea,14/05/2012,0,0,0,0,0,0,0,0
Eritrea,15/05/2012,6,0,0,0,9,4,0,19
Eritrea,16/05/2012,6,0,0,0,15,4,0,25
Eritrea,17/05/2012,1,0,0,0,21,15,0,37
Eritrea,18/05/2012,1,0,0,0,1,3,0,5
Eritrea,19/05/2012,0,0,0,0,3,0,0,3
Eritrea,20/05/2012,1,0,0,0,12,0,0,13
Eritrea,21/05/2012,20,0,0,0,6,4,0,30
Eritrea,22/05/2012,26,0,0,0,0,0,0,26
Eritrea,23/05/2012,0,0,0,0,-2,0,0,-2
Eritrea,24/05/2012,3,0,0,0,12,16,0,31
Eritrea,25/05/2012,0,0,0,0,4,3,0,7
Eritrea,26/05/2012,0,0,0,0,3,0,0,3
Eritrea,27/05/2012,0,0,0,0,3,0,0,3
Eritrea,28/05/2012,0,0,0,0,3,4,0,7
Eritrea,29/05/2012,0,0,0,0,0,6,0,6
Eritrea,30/05/2012,-2,0,0,0,7,0,0,5
Eritrea,31/05/2012,1,0,0,0,0,0,0,1
Georgia,01/05/2012,46,6,4,0,49,9,0,114
Georgia,02/05/2012,37,2,-5,0,26,4,0,64
Georgia,03/05/2012,20,2,-9,0,29,12,0,54
Georgia,04/05/2012,27,4,-1,0,32,6,0,68
Georgia,05/05/2012,19,4,0,0,10,1,0,34
Georgia,06/05/2012,11,0,0,0,16,1,0,28
Georgia,07/05/2012,35,4,-12,0,13,8,0,48
Georgia,08/05/2012,43,0,-4,0,18,9,0,66
Georgia,09/05/2012,55,2,0,0,13,11,0,81
Georgia,10/05/2012,7,0,0,0,0,0,0,7
Georgia,11/05/2012,30,2,0,0,18,1,0,51
Georgia,12/05/2012,14,0,0,0,15,1,0,30
Georgia,13/05/2012,5,2,-2,0,9,1,0,15
Georgia,14/05/2012,62,2,-4,0,37,1,0,98
Georgia,15/05/2012,74,0,0,0,63,3,0,140
Georgia,16/05/2012,36,2,-2,0,13,5,0,54
Georgia,17/05/2012,57,0,0,0,23,4,0,84
Georgia,18/05/2012,38,0,-4,0,27,5,0,66
Georgia,19/05/2012,22,0,-4,0,-2,4,0,20
Georgia,20/05/2012,-1,2,0,0,0,1,0,2
Georgia,21/05/2012,65,0,-3,0,22,5,0,89
Georgia,22/05/2012,66,2,0,0,11,3,0,82
Georgia,23/05/2012,16,2,-5,0,2,6,0,21
Georgia,24/05/2012,39,4,0,0,-2,5,0,46
Georgia,25/05/2012,27,0,0,0,2,1,0,30
Georgia,26/05/2012,10,0,-2,0,3,1,0,12
Georgia,27/05/2012,10,2,1,0,1,4,0,18
Georgia,28/05/2012,57,0,1,0,14,6,0,78
Georgia,29/05/2012,32,0,0,0,28,5,0,65
Georgia,30/05/2012,52,2,1,0,21,8,0,84
Georgia,31/05/2012,15,0,0,0,-5,1,0,11
India,01/05/2012,64,2,1,0,28,5,0,100
India,02/05/2012,89,4,-3,0,5,9,0,104
India,03/05/2012,84,4,-4,0,17,12,0,113
India,04/05/2012,59,2,-3,0,41,15,0,114
India,05/05/2012,66,8,3,0,31,7,0,115
India,06/05/2012,50,2,2,0,20,6,0,80
India,07/05/2012,60,0,1,0,29,18,0,108
India,08/05/2012,78,0,-3,0,22,10,0,107
India,09/05/2012,88,2,-7,0,27,11,0,121
India,10/05/2012,32,0,0,0,10,5,0,47
India,11/05/2012,71,0,-6,0,21,7,0,93
India,12/05/2012,30,0,-2,0,14,14,0,56
India,13/05/2012,65,0,-7,0,38,8,0,104
India,14/05/2012,74,0,5,0,33,3,0,115
India,15/05/2012,86,2,2,0,67,7,0,164
India,16/05/2012,39,2,0,0,10,11,0,62
India,17/05/2012,50,0,-3,0,42,6,0,95
India,18/05/2012,43,0,1,0,39,5,0,88
India,19/05/2012,68,0,-1,0,10,4,0,81
India,20/05/2012,36,2,-2,0,9,5,0,50
India,21/05/2012,64,4,-1,0,31,9,0,107
India,22/05/2012,64,4,-3,0,28,6,0,99
India,23/05/2012,93,2,-4,0,21,14,0,126
India,24/05/2012,65,0,-3,0,20,7,0,89
India,25/05/2012,45,0,-3,0,31,8,0,81
India,26/05/2012,56,0,3,0,39,10,0,108
India,27/05/2012,98,2,-1,0,15,12,0,126
India,28/05/2012,62,2,-1,0,25,11,0,99
India,29/05/2012,94,0,-4,0,46,13,0,149
India,30/05/2012,88,2,-1,0,41,12,0,142
India,31/05/2012,65,0,-1,0,11,9,0,84
Iran,01/05/2012,65,0,-12,0,71,8,0,132
Iran,02/05/2012,95,0,0,0,47,11,0,153
Iran,03/05/2012,178,0,3,0,118,12,0,311
Iran,04/05/2012,128,0,-2,0,69,10,0,205
Iran,05/05/2012,88,0,7,0,50,8,0,153
Iran,06/05/2012,116,0,3,0,64,11,0,194
Iran,07/05/2012,107,0,1,0,76,12,0,196
Iran,08/05/2012,138,0,2,0,61,12,0,213
Iran,09/05/2012,105,0,-1,0,32,15,0,151
Iran,10/05/2012,44,0,0,0,0,6,0,50
Iran,11/05/2012,117,2,0,0,55,14,0,188
Iran,12/05/2012,69,0,2,0,-11,20,0,80
Iran,13/05/2012,81,0,0,0,18,9,0,108
Iran,14/05/2012,120,0,0,0,43,4,0,167
Iran,15/05/2012,104,0,0,0,51,13,0,168
Iran,16/05/2012,74,2,-4,0,60,16,0,148
Iran,17/05/2012,139,2,-2,0,30,16,0,185
Iran,18/05/2012,131,0,3,0,25,9,0,168
Iran,19/05/2012,68,0,1,0,33,14,0,116
Iran,20/05/2012,71,0,0,0,16,14,0,101
Iran,21/05/2012,142,2,0,0,86,5,0,235
Iran,22/05/2012,39,0,0,0,92,24,0,155
Iran,23/05/2012,137,0,1,0,131,2,0,271
Iran,24/05/2012,130,0,-3,0,74,14,0,215
Iran,25/05/2012,105,6,0,0,74,35,0,220
Iran,26/05/2012,49,0,2,0,51,3,0,105
Iran,27/05/2012,47,2,0,0,129,5,0,183
Iran,28/05/2012,103,2,0,0,76,9,0,190
Iran,29/05/2012,124,0,0,0,85,16,0,225
Iran,30/05/2012,114,0,1,0,98,9,0,222
Iran,31/05/2012,87,0,0,0,44,6,0,137
Iraq,01/05/2012,118,0,-2,0,21,10,0,147
Iraq,02/05/2012,118,0,-5,0,25,5,0,143
Iraq,03/05/2012,150,2,0,0,22,10,0,184
Iraq,04/05/2012,100,0,1,0,19,11,0,131
Iraq,05/05/2012,60,2,0,0,54,2,0,118
Iraq,06/05/2012,111,0,0,0,15,0,0,126
Iraq,07/05/2012,55,0,1,0,19,5,0,80
Iraq,08/05/2012,138,4,-2,0,62,4,0,206
Iraq,09/05/2012,74,0,3,0,60,4,0,141
Iraq,10/05/2012,15,0,0,0,3,3,0,21
Iraq,11/05/2012,89,0,-4,0,36,25,0,146
Iraq,12/05/2012,91,0,1,0,14,3,0,109
Iraq,13/05/2012,65,0,0,0,8,1,0,74
Iraq,14/05/2012,139,0,2,0,22,7,0,170
Iraq,15/05/2012,174,0,3,0,45,25,0,247
Iraq,16/05/2012,113,0,3,0,53,10,0,179
Iraq,17/05/2012,166,0,-1,0,79,14,0,258
Iraq,18/05/2012,103,0,0,0,39,10,0,152
Iraq,19/05/2012,91,2,0,0,37,5,0,135
Iraq,20/05/2012,24,0,0,0,12,9,0,45
Iraq,21/05/2012,112,0,0,0,28,17,0,157
Iraq,22/05/2012,64,0,-17,0,43,2,0,92
Iraq,23/05/2012,84,0,-6,0,48,9,0,135
Iraq,24/05/2012,119,0,-7,0,28,13,0,153
Iraq,25/05/2012,142,2,3,0,19,4,0,170
Iraq,26/05/2012,137,0,-2,0,6,11,0,152
Iraq,27/05/2012,123,2,0,0,1,23,0,149
Iraq,28/05/2012,219,12,7,0,28,17,0,283
Iraq,29/05/2012,151,0,1,0,26,15,0,193
Iraq,30/05/2012,71,2,-10,0,27,4,0,94
Iraq,31/05/2012,43,0,0,0,17,4,0,64
Morocco,01/05/2012,10,0,0,0,9,0,0,19
Morocco,02/05/2012,0,2,0,0,12,3,0,17
Morocco,03/05/2012,0,0,-1,0,24,3,0,26
Morocco,04/05/2012,28,0,0,0,8,0,0,36
Morocco,05/05/2012,-2,0,0,0,0,1,0,-1
Morocco,06/05/2012,6,0,0,0,0,3,0,9
Morocco,07/05/2012,4,0,0,0,0,0,0,4
Morocco,08/05/2012,23,0,0,0,12,0,0,35
Morocco,09/05/2012,10,0,0,0,9,8,0,27
Morocco,10/05/2012,2,0,0,0,0,0,0,2
Morocco,11/05/2012,2,0,0,0,6,1,0,9
Morocco,12/05/2012,8,2,0,0,9,0,0,19
Morocco,13/05/2012,2,0,0,0,0,0,0,2
Morocco,14/05/2012,2,0,0,0,-4,0,0,-2
Morocco,15/05/2012,-3,0,0,0,6,2,0,5
Morocco,16/05/2012,9,0,0,0,7,2,0,18
Morocco,17/05/2012,1,0,0,0,12,0,0,13
Morocco,18/05/2012,-8,0,0,0,3,1,0,-4
Morocco,19/05/2012,-1,0,0,0,0,0,0,-1
Morocco,20/05/2012,10,0,0,0,0,1,0,11
Morocco,21/05/2012,10,0,0,0,9,1,0,20
Morocco,22/05/2012,2,0,0,0,0,2,0,4
Morocco,23/05/2012,12,0,0,0,3,3,0,18
Morocco,24/05/2012,11,0,0,0,1,1,0,13
Morocco,25/05/2012,22,0,-2,0,12,2,0,34
Morocco,26/05/2012,6,0,0,0,6,0,0,12
Morocco,27/05/2012,26,0,0,0,0,2,0,28
Morocco,28/05/2012,6,0,0,0,-1,2,0,7
Morocco,29/05/2012,22,0,0,0,0,0,0,22
Morocco,30/05/2012,10,0,0,0,-3,2,0,9
Morocco,31/05/2012,11,0,0,0,-3,0,0,8
Nigeria,01/05/2012,20,0,0,0,22,5,0,47
Nigeria,02/05/2012,34,0,-9,0,15,9,0,49
Nigeria,03/05/2012,42,0,-4,0,30,2,0,70
Nigeria,04/05/2012,21,0,-1,0,11,9,0,40
Nigeria,05/05/2012,34,0,-1,0,26,5,0,64
Nigeria,06/05/2012,22,0,0,0,11,5,0,38
Nigeria,07/05/2012,31,0,2,0,11,2,0,46
Nigeria,08/05/2012,67,2,-1,0,30,4,0,102
Nigeria,09/05/2012,44,2,0,0,16,9,0,71
Nigeria,10/05/2012,28,0,2,0,5,0,0,35
Nigeria,11/05/2012,22,0,0,0,6,7,0,35
Nigeria,12/05/2012,30,0,1,0,6,5,0,42
Nigeria,13/05/2012,5,0,0,0,19,8,0,32
Nigeria,14/05/2012,58,2,0,0,37,10,0,107
Nigeria,15/05/2012,74,2,4,0,44,0,0,124
Nigeria,16/05/2012,41,0,1,0,50,7,0,99
Nigeria,17/05/2012,38,0,0,0,21,1,0,60
Nigeria,18/05/2012,12,0,0,0,11,2,0,25
Nigeria,19/05/2012,13,0,0,0,1,2,0,16
Nigeria,20/05/2012,22,0,0,0,3,6,0,31
Nigeria,21/05/2012,15,2,0,0,-2,8,0,23
Nigeria,22/05/2012,45,0,0,0,12,2,0,59
Nigeria,23/05/2012,39,2,2,0,30,6,0,79
Nigeria,24/05/2012,27,0,1,0,47,5,0,80
Nigeria,25/05/2012,19,6,0,0,4,2,0,31
Nigeria,26/05/2012,23,0,1,0,8,0,0,32
Nigeria,27/05/2012,14,0,0,0,3,4,0,21
Nigeria,28/05/2012,35,2,0,0,21,10,0,68
Nigeria,29/05/2012,30,0,0,0,14,4,0,48
Nigeria,30/05/2012,33,0,-3,0,156,4,0,190
Nigeria,31/05/2012,10,0,1,0,44,1,0,56
Pakistan,01/05/2012,351,4,1,0,114,24,0,494
Pakistan,02/05/2012,176,0,1,0,15,42,0,234
Pakistan,03/05/2012,192,0,0,0,70,19,0,281
Pakistan,04/05/2012,287,0,1,0,53,49,0,390
Pakistan,05/05/2012,170,6,-6,0,70,14,0,254
Pakistan,06/05/2012,73,4,-4,0,22,4,0,99
Pakistan,07/05/2012,109,0,-8,0,90,13,0,204
Pakistan,08/05/2012,152,4,-7,0,40,7,0,196
Pakistan,09/05/2012,107,0,-2,0,132,20,0,257
Pakistan,10/05/2012,72,0,0,0,46,9,0,127
Pakistan,11/05/2012,63,4,0,0,51,8,0,126
Pakistan,12/05/2012,68,2,0,0,28,4,0,102
Pakistan,13/05/2012,114,0,2,0,40,9,0,165
Pakistan,14/05/2012,110,0,0,0,28,18,0,156
Pakistan,15/05/2012,128,0,0,0,52,32,0,212
Pakistan,16/05/2012,114,0,-2,0,44,16,0,172
Pakistan,17/05/2012,90,2,1,0,48,12,0,153
Pakistan,18/05/2012,90,0,-3,0,24,6,0,117
Pakistan,19/05/2012,90,0,-1,0,43,11,0,143
Pakistan,20/05/2012,85,2,1,0,117,10,0,215
Pakistan,21/05/2012,186,0,-10,0,123,22,0,321
Pakistan,22/05/2012,125,2,-18,0,64,12,0,185
Pakistan,23/05/2012,78,2,1,0,90,6,0,177
Pakistan,24/05/2012,97,0,-8,0,103,27,0,219
Pakistan,25/05/2012,142,2,-9,0,107,15,0,257
Pakistan,26/05/2012,29,0,0,0,73,5,0,107
Pakistan,27/05/2012,36,0,0,0,39,2,0,77
Pakistan,28/05/2012,122,4,1,0,167,7,0,301
Pakistan,29/05/2012,220,0,-4,0,69,3,0,288
Pakistan,30/05/2012,95,0,-1,0,73,7,0,174
Pakistan,31/05/2012,17,0,0,0,15,5,0,37
Sierra Leone,01/05/2012,3,0,0,0,42,2,0,47
Sierra Leone,02/05/2012,15,2,0,0,9,0,0,26
Sierra Leone,03/05/2012,8,0,-4,0,23,4,0,31
Sierra Leone,04/05/2012,11,0,0,0,9,5,0,25
Sierra Leone,05/05/2012,0,0,0,0,0,0,0,0
Sierra Leone,06/05/2012,3,0,0,0,10,0,0,13
Sierra Leone,07/05/2012,1,0,0,0,25,1,0,27
Sierra Leone,08/05/2012,8,0,0,0,9,0,0,17
Sierra Leone,09/05/2012,0,0,0,0,9,1,0,10
Sierra Leone,10/05/2012,0,0,0,0,1,2,0,3
Sierra Leone,11/05/2012,7,0,0,0,21,2,0,30
Sierra Leone,12/05/2012,1,0,0,0,6,0,0,7
Sierra Leone,13/05/2012,0,0,0,0,3,0,0,3
Sierra Leone,14/05/2012,12,0,0,0,6,0,0,18
Sierra Leone,15/05/2012,12,0,0,0,9,1,0,22
Sierra Leone,16/05/2012,25,0,0,0,43,5,0,73
Sierra Leone,17/05/2012,15,0,0,0,37,4,0,56
Sierra Leone,18/05/2012,4,0,0,0,15,0,0,19
Sierra Leone,19/05/2012,2,0,0,0,0,0,0,2
Sierra Leone,21/05/2012,0,0,0,0,0,0,0,0
Sierra Leone,22/05/2012,8,0,0,0,12,2,0,22
Sierra Leone,23/05/2012,21,0,0,0,6,2,0,29
Sierra Leone,24/05/2012,2,0,0,0,3,0,0,5
Sierra Leone,25/05/2012,4,0,0,0,0,0,0,4
Sierra Leone,26/05/2012,0,0,0,0,0,0,0,0
Sierra Leone,27/05/2012,3,0,0,0,8,1,0,12
Sierra Leone,28/05/2012,1,0,0,0,39,0,0,40
Sierra Leone,29/05/2012,5,0,0,0,39,2,0,46
Sierra Leone,30/05/2012,21,0,-3,0,372,7,0,397
Sierra Leone,31/05/2012,14,0,0,0,66,4,0,84
Somalia,01/05/2012,145,0,0,0,33,19,0,197
Somalia,02/05/2012,51,6,4,0,54,18,0,133
Somalia,03/05/2012,190,10,-7,0,53,18,0,264
Somalia,04/05/2012,126,2,0,0,78,32,0,238
Somalia,05/05/2012,45,0,0,0,22,15,0,82
Somalia,06/05/2012,50,0,0,0,46,3,0,99
Somalia,07/05/2012,62,0,-2,0,9,6,0,75
Somalia,08/05/2012,61,0,1,0,18,5,0,85
Somalia,09/05/2012,64,0,0,0,14,7,0,85
Somalia,10/05/2012,35,0,0,0,7,1,0,43
Somalia,11/05/2012,67,2,-3,0,4,16,0,86
Somalia,12/05/2012,19,0,0,0,34,9,0,62
Somalia,13/05/2012,60,2,0,0,4,18,0,84
Somalia,14/05/2012,70,2,-3,0,27,19,0,115
Somalia,15/05/2012,175,4,-4,0,43,41,0,259
Somalia,16/05/2012,165,4,-7,0,68,23,0,253
Somalia,17/05/2012,67,0,-1,0,43,5,0,114
Somalia,18/05/2012,58,2,0,0,44,7,0,111
Somalia,19/05/2012,49,0,1,0,33,10,0,93
Somalia,20/05/2012,37,0,0,0,27,3,0,67
Somalia,21/05/2012,69,0,-3,0,32,10,0,108
Somalia,22/05/2012,88,0,-9,0,82,11,0,172
Somalia,23/05/2012,118,0,-8,0,49,4,0,163
Somalia,24/05/2012,96,2,-1,0,43,13,0,153
Somalia,25/05/2012,91,2,-2,0,31,18,0,140
Somalia,26/05/2012,63,0,0,0,12,12,0,87
Somalia,27/05/2012,30,0,-1,0,45,11,0,85
Somalia,28/05/2012,99,0,0,0,2,18,0,119
Somalia,29/05/2012,109,0,0,0,80,13,0,202
Somalia,30/05/2012,119,0,0,0,58,14,0,191
Somalia,31/05/2012,88,0,0,0,63,9,0,160
Syria,01/05/2012,163,0,1,0,49,11,0,224
Syria,02/05/2012,193,0,0,0,36,24,0,253
Syria,03/05/2012,102,0,3,0,39,12,0,156
Syria,04/05/2012,145,0,-5,0,33,19,0,192
Syria,05/05/2012,28,0,-2,0,-6,8,0,28
Syria,06/05/2012,192,2,1,0,31,37,0,263
Syria,07/05/2012,162,2,-14,0,35,41,0,226
Syria,08/05/2012,132,6,0,0,97,19,0,254
Syria,09/05/2012,218,2,-5,0,32,27,0,274
Syria,10/05/2012,47,0,0,0,-3,22,0,66
Syria,11/05/2012,95,0,0,0,59,21,0,175
Syria,12/05/2012,66,0,4,0,-9,11,0,72
Syria,13/05/2012,201,0,0,0,16,5,0,222
Syria,14/05/2012,349,0,1,0,84,35,0,469
Syria,15/05/2012,346,0,-4,0,87,31,0,460
Syria,16/05/2012,277,4,-2,0,88,8,0,375
Syria,17/05/2012,234,0,-24,0,188,16,0,414
Syria,18/05/2012,112,0,-6,0,10,2,0,118
Syria,19/05/2012,121,0,0,0,36,52,0,209
Syria,20/05/2012,138,0,-1,0,30,42,0,209
Syria,21/05/2012,434,4,1,0,29,43,0,511
Syria,22/05/2012,248,0,-8,0,89,15,0,344
Syria,23/05/2012,196,2,-7,0,82,47,0,320
Syria,24/05/2012,334,4,-7,0,61,34,0,426
Syria,25/05/2012,274,2,-6,0,30,31,0,331
Syria,26/05/2012,393,4,-2,0,49,18,0,462
Syria,27/05/2012,416,2,-3,0,47,18,0,480
Syria,28/05/2012,360,2,0,0,38,17,0,417
Syria,29/05/2012,759,4,-5,0,213,71,0,1042
Syria,30/05/2012,579,4,-10,0,185,63,0,821
Syria,31/05/2012,387,0,-8,0,53,32,0,464
Yemen,01/05/2012,81,0,0,0,33,8,0,122
Yemen,02/05/2012,66,2,0,0,-4,7,0,71
Yemen,03/05/2012,66,0,-6,0,10,2,0,72
Yemen,04/05/2012,45,0,-4,0,-15,10,0,36
Yemen,05/05/2012,89,0,-1,0,37,0,0,125
Yemen,06/05/2012,83,0,1,0,5,0,0,89
Yemen,07/05/2012,90,0,0,0,14,7,0,111
Yemen,08/05/2012,168,0,-4,0,35,23,0,222
Yemen,09/05/2012,145,0,-1,0,24,14,0,182
Yemen,10/05/2012,52,0,0,0,-1,2,0,53
Yemen,11/05/2012,48,0,0,0,9,3,0,60
Yemen,12/05/2012,30,0,-2,0,14,0,0,42
Yemen,13/05/2012,106,0,0,0,11,7,0,124
Yemen,14/05/2012,88,0,0,0,3,10,0,101
Yemen,15/05/2012,33,0,0,0,15,22,0,70
Yemen,16/05/2012,45,2,2,0,-4,5,0,50
Yemen,17/05/2012,77,0,0,0,10,4,0,91
Yemen,18/05/2012,53,2,0,0,-10,14,0,59
Yemen,19/05/2012,21,4,0,0,-6,7,0,26
Yemen,20/05/2012,36,0,0,0,0,1,0,37
Yemen,21/05/2012,67,0,-1,0,1,18,0,85
Yemen,22/05/2012,73,0,0,0,3,13,0,89
Yemen,23/05/2012,63,0,-2,0,0,1,0,62
Yemen,24/05/2012,92,2,-6,0,14,12,0,114
Yemen,25/05/2012,57,0,0,0,11,42,0,110
Yemen,26/05/2012,37,0,0,0,65,8,0,110
Yemen,27/05/2012,72,2,-8,0,-4,8,0,70
Yemen,28/05/2012,57,0,-4,0,3,7,0,63
Yemen,29/05/2012,44,0,0,0,-3,10,0,51
Yemen,30/05/2012,46,0,-6,0,6,1,0,47
Yemen,31/05/2012,35,0,-4,0,14,4,0,49
Afghanistan,01/11/2012,96,0,0,0,37,26,0,159
Afghanistan,02/11/2012,96,0,-1,0,31,8,0,134
Afghanistan,03/11/2012,86,6,0,0,9,12,0,113
Afghanistan,04/11/2012,46,0,0,0,4,5,0,55
Afghanistan,05/11/2012,205,0,0,0,56,26,0,287
Afghanistan,06/11/2012,143,0,0,0,21,31,0,195
Afghanistan,07/11/2012,128,0,-3,0,28,30,0,183
Afghanistan,08/11/2012,78,0,1,0,18,19,0,116
Afghanistan,09/11/2012,199,4,-13,0,20,12,0,222
Afghanistan,10/11/2012,211,0,-6,0,53,5,0,263
Afghanistan,11/11/2012,362,0,-11,0,40,7,0,398
Afghanistan,12/11/2012,447,6,7,0,44,19,0,523
Afghanistan,13/11/2012,348,0,-34,0,60,35,0,409
Afghanistan,14/11/2012,297,2,-25,0,-4,37,0,307
Afghanistan,15/11/2012,247,0,-13,0,23,14,0,271
Afghanistan,16/11/2012,232,2,2,0,1,31,0,268
Afghanistan,17/11/2012,127,2,-2,0,43,3,0,173
Afghanistan,18/11/2012,116,0,1,0,4,6,0,127
Afghanistan,19/11/2012,182,6,-7,0,3,10,0,194
Afghanistan,20/11/2012,147,0,-1,0,156,16,0,318
Afghanistan,21/11/2012,131,0,0,0,59,21,0,211
Afghanistan,22/11/2012,96,0,5,0,22,5,0,128
Afghanistan,23/11/2012,62,0,2,0,3,13,0,80
Afghanistan,24/11/2012,100,0,-2,0,9,0,0,107
Afghanistan,25/11/2012,53,0,0,0,12,2,0,67
Afghanistan,26/11/2012,98,2,-5,0,17,11,0,123
Afghanistan,27/11/2012,102,2,-20,0,26,10,0,120
Afghanistan,28/11/2012,106,0,-13,0,25,12,0,130
Afghanistan,29/11/2012,152,10,1,0,63,21,0,247
Afghanistan,30/11/2012,124,2,0,0,25,6,0,157
Albania,01/11/2012,7,0,0,0,3,0,0,10
Albania,02/11/2012,0,0,0,0,0,5,0,5
Albania,03/11/2012,2,0,0,0,3,1,0,6
Albania,04/11/2012,-1,0,0,0,0,0,0,-1
Albania,05/11/2012,0,0,0,0,3,0,0,3
Albania,06/11/2012,7,0,-1,0,3,0,0,9
Albania,07/11/2012,2,0,0,0,0,2,0,4
Albania,08/11/2012,2,0,-1,0,3,0,0,4
Albania,09/11/2012,11,0,-2,0,-2,1,0,8
Albania,10/11/2012,0,0,0,0,0,0,0,0
Albania,11/11/2012,4,0,0,0,2,0,0,6
Albania,12/11/2012,-10,0,0,0,3,2,0,-5
Albania,13/11/2012,-1,0,0,0,0,0,0,-1
Albania,14/11/2012,6,0,0,0,0,0,0,6
Albania,15/11/2012,3,0,0,0,0,0,0,3
Albania,16/11/2012,5,0,0,0,12,0,0,17
Albania,17/11/2012,3,0,0,0,0,0,0,3
Albania,18/11/2012,0,0,0,0,-2,0,0,-2
Albania,19/11/2012,0,0,0,0,9,0,0,9
Albania,20/11/2012,11,0,0,0,12,2,0,25
Albania,21/11/2012,2,0,0,0,3,2,0,7
Albania,22/11/2012,16,0,0,0,18,4,0,38
Albania,23/11/2012,3,0,0,0,0,0,0,3
Albania,24/11/2012,0,0,-1,0,3,4,0,6
Albania,25/11/2012,6,0,-2,0,0,2,0,6
Albania,26/11/2012,11,0,-1,0,3,3,0,16
Albania,27/11/2012,10,0,0,0,33,0,0,43
Albania,28/11/2012,2,0,0,0,12,2,0,16
Albania,29/11/2012,19,0,-2,0,22,2,0,41
Albania,30/11/2012,0,0,0,0,1,0,0,1
Algeria,01/11/2012,6,0,0,0,0,0,0,6
Algeria,02/11/2012,66,0,0,0,23,10,0,99
Algeria,03/11/2012,4,0,0,0,0,3,0,7
Algeria,04/11/2012,7,0,0,0,0,0,0,7
Algeria,05/11/2012,33,0,-6,0,37,10,0,74
Algeria,06/11/2012,7,2,-1,0,0,0,0,8
Algeria,07/11/2012,0,0,0,0,0,0,0,0
Algeria,08/11/2012,4,0,0,0,6,2,0,12
Algeria,09/11/2012,6,0,0,0,0,0,0,6
Algeria,10/11/2012,5,0,0,0,0,0,0,5
Algeria,11/11/2012,29,0,0,0,0,0,0,29
Algeria,12/11/2012,551,2,-8,0,109,50,0,704
Algeria,13/11/2012,18,0,0,0,3,0,0,21
Algeria,14/11/2012,10,0,-2,0,15,0,0,23
Algeria,15/11/2012,0,0,0,0,3,0,0,3
Algeria,16/11/2012,4,0,0,0,6,0,0,10
Algeria,17/11/2012,9,0,1,0,3,2,0,15
Algeria,18/11/2012,0,0,0,0,6,0,0,6
Algeria,19/11/2012,7,0,1,0,2,0,0,10
Algeria,20/11/2012,1046,8,0,0,221,126,0,1401
Algeria,21/11/2012,0,0,0,0,15,0,0,15
Algeria,22/11/2012,4,0,1,0,15,0,0,20
Algeria,23/11/2012,7,0,0,0,-8,0,0,-1
Algeria,24/11/2012,7,0,0,0,-1,0,0,6
Algeria,25/11/2012,4,0,0,0,0,1,0,5
Algeria,26/11/2012,0,0,0,0,0,0,0,0
Algeria,27/11/2012,6,0,-4,0,-1,0,0,1
Algeria,28/11/2012,3,0,0,0,3,0,0,6
Algeria,29/11/2012,0,0,0,0,3,1,0,4
Algeria,30/11/2012,14,0,1,0,9,2,0,26
Bangladesh,01/11/2012,65,0,-4,0,16,6,0,83
Bangladesh,02/11/2012,51,0,0,0,11,2,0,64
Bangladesh,03/11/2012,16,0,1,0,-1,3,0,19
Bangladesh,04/11/2012,11,0,0,0,6,1,0,18
Bangladesh,05/11/2012,59,0,-2,0,20,1,0,78
Bangladesh,06/11/2012,40,0,0,0,5,1,0,46
Bangladesh,07/11/2012,35,0,0,0,14,5,0,54
Bangladesh,08/11/2012,36,0,1,0,12,2,0,51
Bangladesh,09/11/2012,57,0,-2,0,12,-1,0,66
Bangladesh,10/11/2012,26,0,2,0,0,1,0,29
Bangladesh,11/11/2012,24,0,0,0,-1,6,0,29
Bangladesh,12/11/2012,26,2,0,0,21,3,0,52
Bangladesh,13/11/2012,56,0,0,0,21,4,0,81
Bangladesh,14/11/2012,39,0,0,0,11,3,0,53
Bangladesh,15/11/2012,14,0,0,0,3,4,0,21
Bangladesh,16/11/2012,19,0,0,0,17,1,0,37
Bangladesh,17/11/2012,14,0,0,0,20,1,0,35
Bangladesh,18/11/2012,74,0,0,0,8,18,0,100
Bangladesh,19/11/2012,20,0,2,0,9,16,0,47
Bangladesh,20/11/2012,6,0,0,0,3,0,0,9
Bangladesh,21/11/2012,30,0,1,0,15,0,0,46
Bangladesh,22/11/2012,34,0,0,0,4,4,0,42
Bangladesh,23/11/2012,22,0,-2,0,3,1,0,24
Bangladesh,24/11/2012,34,0,1,0,8,8,0,51
Bangladesh,25/11/2012,97,0,0,0,18,6,0,121
Bangladesh,26/11/2012,68,0,0,0,-10,15,0,73
Bangladesh,27/11/2012,24,0,2,0,21,3,0,50
Bangladesh,28/11/2012,21,0,0,0,23,4,0,48
Bangladesh,29/11/2012,50,0,0,0,24,2,0,76
Bangladesh,30/11/2012,24,0,2,0,24,3,0,53
Cameroon,01/11/2012,0,0,0,0,0,0,0,0
Cameroon,02/11/2012,2,0,0,0,0,0,0,2
Cameroon,03/11/2012,0,0,0,0,0,0,0,0
Cameroon,04/11/2012,0,0,0,0,-4,0,0,-4
Cameroon,05/11/2012,0,0,0,0,-2,0,0,-2
Cameroon,06/11/2012,2,0,0,0,6,1,0,9
Cameroon,07/11/2012,18,0,0,0,0,0,0,18
Cameroon,08/11/2012,5,0,-4,0,0,0,0,1
Cameroon,09/11/2012,3,0,0,0,0,0,0,3
Cameroon,10/11/2012,2,0,0,0,-2,0,0,0
Cameroon,11/11/2012,0,0,0,0,-2,0,0,-2
Cameroon,12/11/2012,8,0,0,0,0,0,0,8
Cameroon,13/11/2012,0,0,0,0,4,0,0,4
Cameroon,14/11/2012,3,2,0,0,0,0,0,5
Cameroon,15/11/2012,3,0,0,0,3,0,0,6
Cameroon,16/11/2012,10,0,1,0,9,0,0,20
Cameroon,17/11/2012,0,0,0,0,0,2,0,2
Cameroon,18/11/2012,5,0,0,0,6,0,0,11
Cameroon,19/11/2012,0,0,0,0,0,0,0,0
Cameroon,20/11/2012,3,0,0,0,-2,0,0,1
Cameroon,21/11/2012,0,0,0,0,3,0,0,3
Cameroon,22/11/2012,0,0,0,0,3,1,0,4
Cameroon,23/11/2012,0,0,0,0,0,0,0,0
Cameroon,24/11/2012,0,0,0,0,-2,0,0,-2
Cameroon,25/11/2012,0,0,0,0,3,0,0,3
Cameroon,26/11/2012,4,0,0,0,0,0,0,4
Cameroon,27/11/2012,-2,0,0,0,3,0,0,1
Cameroon,28/11/2012,0,0,0,0,0,0,0,0
Cameroon,29/11/2012,0,0,0,0,6,0,0,6
Cameroon,30/11/2012,0,0,0,0,15,0,0,15
China,01/11/2012,195,8,-2,0,73,32,0,306
China,02/11/2012,83,2,0,0,55,19,0,159
China,03/11/2012,77,0,-1,0,14,10,0,100
China,04/11/2012,342,0,6,0,139,70,0,557
China,05/11/2012,138,0,-2,0,74,29,0,239
China,06/11/2012,134,6,2,0,39,33,0,214
China,07/11/2012,123,2,-6,0,36,7,0,162
China,08/11/2012,165,2,1,0,36,30,0,234
China,09/11/2012,147,4,-4,0,90,18,0,255
China,10/11/2012,112,0,-4,0,34,12,0,154
China,11/11/2012,76,4,1,0,17,16,0,114
China,12/11/2012,73,2,2,0,23,29,0,129
China,13/11/2012,91,10,-3,0,62,16,0,176
China,14/11/2012,146,14,-3,0,81,23,0,261
China,15/11/2012,79,0,5,0,19,15,0,118
China,16/11/2012,136,4,3,0,36,20,0,199
China,17/11/2012,84,2,1,0,26,6,0,119
China,18/11/2012,93,8,-6,0,25,12,0,132
China,19/11/2012,175,2,-1,0,36,9,0,221
China,20/11/2012,133,2,-4,0,25,15,0,171
China,21/11/2012,133,4,-3,0,100,14,0,248
China,22/11/2012,88,2,-1,0,38,6,0,133
China,23/11/2012,122,2,0,0,8,12,0,144
China,24/11/2012,47,4,2,0,19,6,0,78
China,25/11/2012,58,6,1,0,-3,6,0,68
China,26/11/2012,97,0,-2,0,34,26,0,155
China,27/11/2012,176,2,7,0,76,18,0,279
China,28/11/2012,194,6,-4,0,73,11,0,280
China,29/11/2012,171,4,1,0,70,41,0,287
China,30/11/2012,130,0,8,0,31,26,0,195
Egypt,01/11/2012,50,0,0,0,19,6,0,75
Egypt,02/11/2012,49,0,0,0,9,7,0,65
Egypt,03/11/2012,183,0,0,0,33,10,0,226
Egypt,04/11/2012,75,0,0,0,27,2,0,104
Egypt,05/11/2012,68,0,-4,0,16,11,0,91
Egypt,06/11/2012,95,2,-1,0,27,13,0,136
Egypt,07/11/2012,57,0,1,0,38,10,0,106
Egypt,08/11/2012,58,0,0,0,54,18,0,130
Egypt,09/11/2012,50,0,0,0,26,4,0,80
Egypt,10/11/2012,63,2,0,0,-9,7,0,63
Egypt,11/11/2012,79,2,0,0,28,7,0,116
Egypt,12/11/2012,177,0,-2,0,23,4,0,202
Egypt,13/11/2012,109,0,0,0,12,9,0,130
Egypt,14/11/2012,220,0,0,0,33,38,0,291
Egypt,15/11/2012,376,4,1,0,15,45,0,441
Egypt,16/11/2012,471,0,0,0,16,50,0,537
Egypt,17/11/2012,250,2,-6,0,38,19,0,303
Egypt,18/11/2012,185,0,1,0,35,19,0,240
Egypt,19/11/2012,220,6,-1,0,26,41,0,292
Egypt,20/11/2012,126,0,2,0,25,34,0,187
Egypt,21/11/2012,215,8,1,0,23,16,0,263
Egypt,22/11/2012,150,2,-2,0,41,11,0,202
Egypt,23/11/2012,274,0,0,0,31,33,0,338
Egypt,24/11/2012,177,0,4,0,33,18,0,232
Egypt,25/11/2012,198,0,-2,0,30,30,0,256
Egypt,26/11/2012,171,0,-3,0,45,26,0,239
Egypt,27/11/2012,94,4,-6,0,37,41,0,170
Egypt,28/11/2012,165,0,0,0,70,43,0,278
Egypt,29/11/2012,103,0,-4,0,43,44,0,186
Egypt,30/11/2012,81,0,1,0,23,28,0,133
Eritrea,01/11/2012,0,0,0,0,0,3,0,3
Eritrea,02/11/2012,2,0,0,0,0,0,0,2
Eritrea,03/11/2012,0,0,0,0,7,0,0,7
Eritrea,04/11/2012,0,0,0,0,0,0,0,0
Eritrea,05/11/2012,0,0,0,0,0,0,0,0
Eritrea,06/11/2012,6,0,0,0,0,0,0,6
Eritrea,07/11/2012,2,0,-1,0,0,0,0,1
Eritrea,08/11/2012,0,0,0,0,15,0,0,15
Eritrea,09/11/2012,0,0,0,0,0,0,0,0
Eritrea,11/11/2012,0,0,0,0,6,0,0,6
Eritrea,12/11/2012,3,0,0,0,0,0,0,3
Eritrea,13/11/2012,13,0,0,0,0,0,0,13
Eritrea,14/11/2012,11,0,0,0,0,0,0,11
Eritrea,15/11/2012,0,0,0,0,15,0,0,15
Eritrea,16/11/2012,0,0,0,0,0,0,0,0
Eritrea,17/11/2012,1,0,0,0,0,0,0,1
Eritrea,18/11/2012,7,0,0,0,0,0,0,7
Eritrea,19/11/2012,0,0,0,0,0,0,0,0
Eritrea,20/11/2012,0,0,0,0,0,0,0,0
Eritrea,21/11/2012,8,0,0,0,0,0,0,8
Eritrea,22/11/2012,0,0,0,0,6,0,0,6
Eritrea,23/11/2012,3,0,0,0,0,0,0,3
Eritrea,24/11/2012,2,0,0,0,12,0,0,14
Eritrea,25/11/2012,1,0,0,0,0,0,0,1
Eritrea,26/11/2012,3,0,0,0,3,0,0,6
Eritrea,27/11/2012,0,0,0,0,0,0,0,0
Georgia,01/11/2012,2,0,0,0,0,0,0,2
Georgia,02/11/2012,0,0,0,0,0,1,0,1
Georgia,03/11/2012,-1,0,0,0,0,1,0,0
Georgia,04/11/2012,13,0,0,0,0,2,0,15
Georgia,05/11/2012,2,0,-2,0,3,1,0,4
Georgia,06/11/2012,0,0,-2,0,-2,1,0,-3
Georgia,07/11/2012,14,0,-2,0,15,0,0,27
Georgia,08/11/2012,4,0,0,0,12,1,0,17
Georgia,09/11/2012,0,0,0,0,6,0,0,6
Georgia,10/11/2012,-1,0,0,0,0,0,0,-1
Georgia,11/11/2012,2,0,0,0,0,0,0,2
Georgia,12/11/2012,7,0,0,0,0,1,0,8
Georgia,13/11/2012,1,0,0,0,0,0,0,1
Georgia,14/11/2012,9,0,0,0,0,0,0,9
Georgia,15/11/2012,11,0,0,0,15,0,0,26
Georgia,16/11/2012,0,0,-2,0,0,0,0,-2
Georgia,17/11/2012,0,0,0,0,0,0,0,0
Georgia,18/11/2012,0,0,0,0,0,0,0,0
Georgia,19/11/2012,1,0,0,0,0,0,0,1
Georgia,20/11/2012,2,0,0,0,12,0,0,14
Georgia,21/11/2012,8,0,0,0,0,0,0,8
Georgia,22/11/2012,2,0,0,0,1,0,0,3
Georgia,23/11/2012,-3,0,0,0,0,0,0,-3
Georgia,24/11/2012,1,0,0,0,0,0,0,1
Georgia,25/11/2012,0,0,0,0,0,0,0,0
Georgia,26/11/2012,0,0,0,0,0,0,0,0
Georgia,27/11/2012,0,0,0,0,0,0,0,0
Georgia,28/11/2012,-1,0,0,0,1,0,0,0
Georgia,29/11/2012,0,0,0,0,0,3,0,3
Georgia,30/11/2012,-1,0,0,0,3,0,0,2
India,01/11/2012,68,4,2,0,31,2,0,107
India,02/11/2012,62,0,-4,0,22,6,0,86
India,03/11/2012,74,2,0,0,42,11,0,129
India,04/11/2012,44,4,0,0,2,11,0,61
India,05/11/2012,27,0,-2,0,-1,5,0,29
India,06/11/2012,58,4,-4,0,25,11,0,94
India,07/11/2012,64,4,0,0,19,12,0,99
India,08/11/2012,57,2,-2,0,1,19,0,77
India,09/11/2012,36,2,-4,0,15,13,0,62
India,10/11/2012,15,0,-5,0,17,8,0,35
India,11/11/2012,56,2,3,0,-4,18,0,75
India,12/11/2012,34,4,1,0,11,12,0,62
India,13/11/2012,37,2,0,0,4,5,0,48
India,14/11/2012,69,0,1,0,16,7,0,93
India,15/11/2012,42,2,-1,0,-1,14,0,56
India,16/11/2012,47,4,3,0,33,5,0,92
India,17/11/2012,41,0,-9,0,34,4,0,70
India,18/11/2012,59,2,0,0,3,4,0,68
India,19/11/2012,58,2,-1,0,0,9,0,68
India,20/11/2012,44,4,-2,0,28,13,0,87
India,21/11/2012,53,0,-2,0,6,5,0,62
India,22/11/2012,63,4,0,0,7,11,0,85
India,23/11/2012,40,0,0,0,14,11,0,65
India,24/11/2012,52,6,0,0,0,16,0,74
India,25/11/2012,65,0,0,0,13,10,0,88
India,26/11/2012,64,0,-4,0,9,12,0,81
India,27/11/2012,37,6,0,0,16,3,0,62
India,28/11/2012,103,0,2,0,15,14,0,134
India,29/11/2012,53,2,0,0,-6,22,0,71
India,30/11/2012,49,4,0,0,17,17,0,87
Iran,01/11/2012,108,0,-1,0,29,8,0,144
Iran,02/11/2012,83,0,-4,0,29,13,0,121
Iran,03/11/2012,64,0,0,0,21,6,0,91
Iran,04/11/2012,59,0,2,0,7,3,0,71
Iran,05/11/2012,113,0,1,0,14,26,0,154
Iran,06/11/2012,105,0,0,0,4,13,0,122
Iran,07/11/2012,136,0,-3,0,44,16,0,193
Iran,08/11/2012,199,0,3,0,27,22,0,251
Iran,09/11/2012,166,0,4,0,69,15,0,254
Iran,10/11/2012,63,0,-2,0,59,4,0,124
Iran,11/11/2012,84,0,1,0,37,7,0,129
Iran,12/11/2012,135,2,4,0,48,14,0,203
Iran,13/11/2012,57,0,1,0,32,18,0,108
Iran,14/11/2012,137,0,16,0,12,9,0,174
Iran,15/11/2012,137,0,1,0,54,19,0,211
Iran,16/11/2012,100,0,1,0,58,7,0,166
Iran,17/11/2012,106,0,0,0,25,13,0,144
Iran,18/11/2012,106,0,0,0,5,10,0,121
Iran,19/11/2012,138,0,1,0,29,21,0,189
Iran,20/11/2012,225,0,1,0,41,10,0,277
Iran,21/11/2012,173,0,-4,0,37,21,0,227
Iran,22/11/2012,132,2,-1,0,30,16,0,179
Iran,23/11/2012,86,0,3,0,26,-3,0,112
Iran,24/11/2012,99,0,8,0,20,2,0,129
Iran,25/11/2012,106,0,0,0,12,4,0,122
Iran,26/11/2012,86,0,0,0,18,11,0,115
Iran,27/11/2012,88,0,1,0,4,4,0,97
Iran,28/11/2012,64,2,2,0,8,12,0,88
Iran,29/11/2012,89,8,1,0,18,23,0,139
Iran,30/11/2012,57,2,-1,0,36,10,0,104
Iraq,01/11/2012,59,0,2,0,54,14,0,129
Iraq,02/11/2012,112,2,0,0,31,11,0,156
Iraq,03/11/2012,56,6,0,0,13,7,0,82
Iraq,04/11/2012,24,6,0,0,20,10,0,60
Iraq,05/11/2012,83,0,0,0,43,11,0,137
Iraq,06/11/2012,91,0,0,0,19,25,0,135
Iraq,07/11/2012,109,0,0,0,31,9,0,149
Iraq,08/11/2012,80,0,2,0,68,11,0,161
Iraq,09/11/2012,175,0,-5,0,76,7,0,253
Iraq,10/11/2012,260,6,-6,0,44,17,0,321
Iraq,11/11/2012,224,4,-8,0,30,9,0,259
Iraq,12/11/2012,206,2,0,0,35,14,0,257
Iraq,13/11/2012,186,10,-8,0,62,19,0,269
Iraq,14/11/2012,111,2,1,0,15,6,0,135
Iraq,15/11/2012,148,0,-2,0,11,4,0,161
Iraq,16/11/2012,250,0,-2,0,41,13,0,302
Iraq,17/11/2012,136,2,-2,0,8,6,0,150
Iraq,18/11/2012,155,0,3,0,-7,3,0,154
Iraq,19/11/2012,92,0,0,0,11,2,0,105
Iraq,20/11/2012,153,6,2,0,59,4,0,224
Iraq,21/11/2012,45,0,2,0,36,2,0,85
Iraq,22/11/2012,103,6,7,0,7,7,0,130
Iraq,23/11/2012,68,0,0,0,21,2,0,91
Iraq,24/11/2012,26,0,0,0,6,7,0,39
Iraq,25/11/2012,51,0,0,0,-10,1,0,42
Iraq,26/11/2012,63,0,1,0,27,13,0,104
Iraq,27/11/2012,108,0,0,0,42,5,0,155
Iraq,28/11/2012,109,0,3,0,46,17,0,175
Iraq,29/11/2012,117,0,0,0,51,16,0,184
Iraq,30/11/2012,64,2,2,0,73,2,0,143
Morocco,01/11/2012,5,0,0,0,0,0,0,5
Morocco,02/11/2012,41,0,0,0,16,5,0,62
Morocco,03/11/2012,2,0,0,0,0,0,0,2
Morocco,04/11/2012,3,0,0,0,0,0,0,3
Morocco,05/11/2012,435,26,-6,0,198,92,0,745
Morocco,06/11/2012,701,0,5,0,323,114,0,1143
Morocco,07/11/2012,3,0,0,0,9,0,0,12
Morocco,08/11/2012,25,0,0,0,6,2,0,33
Morocco,09/11/2012,8,0,-1,0,3,3,0,13
Morocco,10/11/2012,0,0,0,0,0,0,0,0
Morocco,11/11/2012,3,0,0,0,3,2,0,8
Morocco,12/11/2012,14,0,0,0,6,0,0,20
Morocco,13/11/2012,0,0,0,0,0,0,0,0
Morocco,14/11/2012,-1,0,0,0,3,1,0,3
Morocco,15/11/2012,5,0,0,0,0,0,0,5
Morocco,16/11/2012,6,0,0,0,-2,0,0,4
Morocco,17/11/2012,0,0,0,0,0,0,0,0
Morocco,18/11/2012,10,0,0,0,3,4,0,17
Morocco,19/11/2012,32,0,0,0,12,2,0,46
Morocco,20/11/2012,46,0,0,0,3,0,0,49
Morocco,21/11/2012,116,0,-3,0,21,18,0,152
Morocco,22/11/2012,5,0,0,0,-2,0,0,3
Morocco,23/11/2012,6,0,0,0,9,0,0,15
Morocco,24/11/2012,4,0,0,0,0,1,0,5
Morocco,25/11/2012,6,0,0,0,0,0,0,6
Morocco,26/11/2012,8,0,0,0,-4,0,0,4
Morocco,27/11/2012,10,0,0,0,15,0,0,25
Morocco,28/11/2012,6,0,-1,0,11,6,0,22
Morocco,29/11/2012,17,0,0,0,8,2,0,27
Morocco,30/11/2012,7,0,0,0,6,0,0,13
Nigeria,01/11/2012,27,0,0,0,-7,10,0,30
Nigeria,02/11/2012,18,0,0,0,26,2,0,46
Nigeria,03/11/2012,29,0,-2,0,-4,0,0,23
Nigeria,04/11/2012,21,0,0,0,12,1,0,34
Nigeria,05/11/2012,51,0,-7,0,13,12,0,69
Nigeria,06/11/2012,22,0,0,0,15,1,0,38
Nigeria,07/11/2012,15,0,0,0,27,1,0,43
Nigeria,08/11/2012,43,0,-2,0,40,3,0,84
Nigeria,09/11/2012,53,0,-1,0,24,9,0,85
Nigeria,10/11/2012,19,0,-3,0,6,1,0,23
Nigeria,11/11/2012,47,0,0,0,16,1,0,64
Nigeria,12/11/2012,80,0,0,0,17,12,0,109
Nigeria,13/11/2012,59,2,1,0,31,6,0,99
Nigeria,14/11/2012,49,0,1,0,8,2,0,60
Nigeria,15/11/2012,20,0,0,0,2,5,0,27
Nigeria,16/11/2012,31,8,-1,0,9,5,0,52
Nigeria,17/11/2012,18,0,0,0,57,1,0,76
Nigeria,18/11/2012,6,0,1,0,4,5,0,16
Nigeria,19/11/2012,25,2,-1,0,31,3,0,60
Nigeria,20/11/2012,23,0,-2,0,32,2,0,55
Nigeria,21/11/2012,42,0,0,0,34,8,0,84
Nigeria,22/11/2012,11,0,0,0,-1,4,0,14
Nigeria,23/11/2012,13,0,0,0,7,3,0,23
Nigeria,24/11/2012,11,0,0,0,12,1,0,24
Nigeria,25/11/2012,14,2,0,0,9,7,0,32
Nigeria,26/11/2012,23,0,0,0,17,0,0,40
Nigeria,27/11/2012,43,0,0,0,13,5,0,61
Nigeria,28/11/2012,52,0,-2,0,9,3,0,62
Nigeria,29/11/2012,20,0,0,0,-2,1,0,19
Nigeria,30/11/2012,6,0,1,0,3,2,0,12
Pakistan,01/11/2012,52,0,-1,0,15,2,0,68
Pakistan,02/11/2012,67,0,4,0,36,15,0,122
Pakistan,03/11/2012,70,0,2,0,11,7,0,90
Pakistan,04/11/2012,75,0,2,0,16,1,0,94
Pakistan,05/11/2012,108,0,0,0,78,12,0,198
Pakistan,06/11/2012,154,0,0,0,60,8,0,222
Pakistan,07/11/2012,64,0,-7,0,30,9,0,96
Pakistan,08/11/2012,81,0,-5,0,40,5,0,121
Pakistan,09/11/2012,131,2,-3,0,22,8,0,160
Pakistan,10/11/2012,95,0,1,0,8,5,0,109
Pakistan,11/11/2012,66,0,0,0,9,3,0,78
Pakistan,12/11/2012,103,4,3,0,18,17,0,145
Pakistan,13/11/2012,132,3,3,0,23,23,0,184
Pakistan,14/11/2012,172,6,-1,0,63,23,0,263
Pakistan,15/11/2012,211,0,-4,0,72,18,0,297
Pakistan,16/11/2012,152,4,2,0,49,20,0,227
Pakistan,17/11/2012,51,0,1,0,17,4,0,73
Pakistan,18/11/2012,59,0,0,0,-3,4,0,60
Pakistan,19/11/2012,52,0,0,0,36,2,0,90
Pakistan,20/11/2012,172,4,1,0,36,6,0,219
Pakistan,21/11/2012,363,0,5,0,115,18,0,501
Pakistan,22/11/2012,144,6,1,0,16,5,0,172
Pakistan,23/11/2012,48,0,4,0,25,3,0,80
Pakistan,24/11/2012,49,0,0,0,23,10,0,82
Pakistan,25/11/2012,107,0,0,0,19,7,0,133
Pakistan,26/11/2012,109,4,3,0,36,15,0,167
Pakistan,27/11/2012,106,0,-5,0,39,28,0,168
Pakistan,28/11/2012,61,2,-12,0,31,27,0,109
Pakistan,29/11/2012,19,0,-4,0,27,22,0,64
Pakistan,30/11/2012,69,8,-4,0,63,10,0,146
Sierra Leone,01/11/2012,0,0,0,0,0,3,0,3
Sierra Leone,02/11/2012,3,0,0,0,1,1,0,5
Sierra Leone,03/11/2012,0,0,0,0,0,0,0,0
Sierra Leone,04/11/2012,7,0,0,0,0,0,0,7
Sierra Leone,05/11/2012,25,0,0,0,0,0,0,25
Sierra Leone,06/11/2012,2,0,0,0,0,0,0,2
Sierra Leone,07/11/2012,2,0,0,0,0,0,0,2
Sierra Leone,08/11/2012,7,0,0,0,10,0,0,17
Sierra Leone,09/11/2012,7,0,0,0,0,2,0,9
Sierra Leone,10/11/2012,0,0,0,0,0,0,0,0
Sierra Leone,11/11/2012,0,0,0,0,0,0,0,0
Sierra Leone,12/11/2012,3,0,0,0,3,0,0,6
Sierra Leone,13/11/2012,4,0,1,0,1,1,0,7
Sierra Leone,14/11/2012,17,0,-6,0,3,1,0,15
Sierra Leone,15/11/2012,5,0,3,0,0,0,0,8
Sierra Leone,16/11/2012,1,0,0,0,4,2,0,7
Sierra Leone,17/11/2012,0,0,0,0,2,5,0,7
Sierra Leone,18/11/2012,0,0,0,0,0,2,0,2
Sierra Leone,19/11/2012,23,0,0,0,0,3,0,26
Sierra Leone,20/11/2012,4,0,0,0,6,1,0,11
Sierra Leone,21/11/2012,3,0,0,0,-4,0,0,-1
Sierra Leone,22/11/2012,1,0,0,0,0,1,0,2
Sierra Leone,23/11/2012,12,0,-2,0,3,0,0,13
Sierra Leone,24/11/2012,3,0,-2,0,0,1,0,2
Sierra Leone,25/11/2012,4,0,0,0,3,1,0,8
Sierra Leone,26/11/2012,15,0,-1,0,-6,2,0,10
Sierra Leone,27/11/2012,4,0,1,0,6,2,0,13
Sierra Leone,28/11/2012,2,0,0,0,1,3,0,6
Sierra Leone,29/11/2012,8,0,0,0,0,7,0,15
Sierra Leone,30/11/2012,0,0,0,0,0,0,0,0
Somalia,01/11/2012,20,0,0,0,12,8,0,40
Somalia,02/11/2012,74,0,0,0,39,11,0,124
Somalia,03/11/2012,42,2,0,0,7,6,0,57
Somalia,04/11/2012,167,0,0,0,10,7,0,184
Somalia,05/11/2012,46,0,0,0,34,15,0,95
Somalia,06/11/2012,129,0,1,0,27,12,0,169
Somalia,07/11/2012,102,2,-2,0,31,9,0,142
Somalia,08/11/2012,76,4,0,0,9,0,0,89
Somalia,09/11/2012,37,0,0,0,3,0,0,40
Somalia,10/11/2012,3,0,0,0,3,1,0,7
Somalia,11/11/2012,36,4,0,0,3,2,0,45
Somalia,12/11/2012,-5,0,0,0,3,2,0,0
Somalia,13/11/2012,13,0,0,0,15,2,0,30
Somalia,14/11/2012,49,0,0,0,39,0,0,88
Somalia,15/11/2012,17,0,0,0,13,4,0,34
Somalia,16/11/2012,25,0,0,0,12,0,0,37
Somalia,17/11/2012,10,0,0,0,9,0,0,19
Somalia,18/11/2012,41,0,0,0,7,8,0,56
Somalia,19/11/2012,151,0,0,0,35,3,0,189
Somalia,20/11/2012,141,0,0,0,67,10,0,218
Somalia,21/11/2012,43,0,0,0,0,11,0,54
Somalia,22/11/2012,15,0,0,0,4,0,0,19
Somalia,23/11/2012,884,2,-4,0,274,139,0,1295
Somalia,24/11/2012,23,0,0,0,7,0,0,30
Somalia,25/11/2012,60,0,0,0,-2,0,0,58
Somalia,26/11/2012,67,0,0,0,12,0,0,79
Somalia,27/11/2012,17,0,0,0,27,5,0,49
Somalia,28/11/2012,22,0,0,0,-1,2,0,23
Somalia,29/11/2012,60,0,0,0,3,2,0,65
Somalia,30/11/2012,15,0,0,0,0,2,0,17
Syria,01/11/2012,244,0,-7,0,9,15,0,261
Syria,02/11/2012,216,0,-2,0,26,44,0,284
Syria,03/11/2012,62,0,0,0,16,14,0,92
Syria,04/11/2012,255,0,8,0,56,41,0,360
Syria,05/11/2012,251,2,-2,0,85,88,0,424
Syria,06/11/2012,305,0,4,0,-9,55,0,355
Syria,07/11/2012,201,4,-2,0,7,12,0,222
Syria,08/11/2012,405,0,-20,0,8,12,0,405
Syria,09/11/2012,320,14,-6,0,24,10,0,362
Syria,10/11/2012,572,10,0,0,140,31,0,753
Syria,11/11/2012,355,6,-2,0,37,6,0,402
Syria,12/11/2012,378,14,2,0,76,12,0,482
Syria,13/11/2012,253,16,-1,0,45,21,0,334
Syria,14/11/2012,270,2,5,0,38,35,0,350
Syria,15/11/2012,171,0,7,0,80,21,0,279
Syria,16/11/2012,173,2,-4,0,43,12,0,226
Syria,17/11/2012,225,0,0,0,24,24,0,273
Syria,18/11/2012,130,0,0,0,8,12,0,150
Syria,19/11/2012,206,6,1,0,6,24,0,243
Syria,20/11/2012,221,8,1,0,24,11,0,265
Syria,21/11/2012,190,0,1,0,10,21,0,222
Syria,22/11/2012,137,0,3,0,-1,9,0,148
Syria,23/11/2012,212,0,3,0,23,13,0,251
Syria,24/11/2012,143,0,1,0,24,3,0,171
Syria,25/11/2012,121,0,0,0,22,4,0,147
Syria,26/11/2012,166,0,0,0,10,6,0,182
Syria,27/11/2012,174,6,0,0,19,12,0,211
Syria,28/11/2012,204,4,-2,0,44,25,0,275
Syria,29/11/2012,197,1,-2,0,7,19,0,222
Syria,30/11/2012,224,6,-5,0,51,9,0,285
Yemen,01/11/2012,5,0,0,0,0,4,0,9
Yemen,02/11/2012,6,0,2,0,0,1,0,9
Yemen,03/11/2012,18,0,0,0,6,0,0,24
Yemen,04/11/2012,24,0,0,0,-1,1,0,24
Yemen,05/11/2012,68,0,0,0,9,10,0,87
Yemen,06/11/2012,8,0,0,0,6,5,0,19
Yemen,07/11/2012,22,0,0,0,30,3,0,55
Yemen,08/11/2012,11,0,0,0,3,2,0,16
Yemen,09/11/2012,0,0,0,0,3,1,0,4
Yemen,10/11/2012,-1,0,0,0,0,0,0,-1
Yemen,11/11/2012,8,0,0,0,0,0,0,8
Yemen,12/11/2012,3,0,0,0,0,1,0,4
Yemen,13/11/2012,4,0,0,0,3,0,0,7
Yemen,14/11/2012,0,0,0,0,6,0,0,6
Yemen,15/11/2012,1,0,0,0,0,0,0,1
Yemen,16/11/2012,17,0,0,0,-2,2,0,17
Yemen,17/11/2012,-2,0,-2,0,0,0,0,-4
Yemen,18/11/2012,4,0,0,0,0,0,0,4
Yemen,19/11/2012,10,0,0,0,0,2,0,12
Yemen,20/11/2012,16,0,0,0,6,3,0,25
Yemen,21/11/2012,15,0,0,0,0,0,0,15
Yemen,22/11/2012,10,0,0,0,4,2,0,16
Yemen,23/11/2012,12,0,-2,0,0,3,0,13
Yemen,24/11/2012,6,0,0,0,6,0,0,12
Yemen,25/11/2012,29,0,0,0,3,0,0,32
Yemen,26/11/2012,4,0,0,0,4,0,0,8
Yemen,27/11/2012,2,0,0,0,3,5,0,10
Yemen,28/11/2012,81,0,-2,0,1,2,0,82
Yemen,29/11/2012,24,0,0,0,1,6,0,31
Yemen,30/11/2012,14,0,0,0,0,1,0,15
Afghanistan,01/07/2010,191,0,-2,0,46,18,0,253
Afghanistan,02/07/2010,142,2,-1,0,0,12,0,155
Afghanistan,03/07/2010,72,0,-2,0,17,2,0,89
Afghanistan,04/07/2010,216,0,3,0,24,14,0,257
Afghanistan,05/07/2010,245,4,-4,0,39,55,0,339
Afghanistan,06/07/2010,103,6,0,0,79,7,0,195
Afghanistan,07/07/2010,281,2,-9,0,67,28,0,369
Afghanistan,08/07/2010,101,6,3,0,27,56,0,193
Afghanistan,09/07/2010,243,2,-6,0,43,31,0,313
Afghanistan,10/07/2010,279,4,0,0,31,33,0,347
Afghanistan,11/07/2010,59,0,0,0,6,3,0,68
Afghanistan,12/07/2010,113,4,0,0,20,9,0,146
Afghanistan,13/07/2010,77,0,0,0,17,5,0,99
Afghanistan,14/07/2010,162,0,0,0,0,22,0,184
Afghanistan,15/07/2010,73,0,0,0,13,6,0,92
Afghanistan,16/07/2010,75,0,0,0,0,9,0,84
Afghanistan,17/07/2010,85,0,0,0,6,18,0,109
Afghanistan,18/07/2010,101,0,2,0,2,18,0,123
Afghanistan,19/07/2010,126,0,-4,0,6,12,0,140
Afghanistan,20/07/2010,83,2,4,0,11,6,0,106
Afghanistan,21/07/2010,103,0,0,0,14,4,0,121
Afghanistan,22/07/2010,89,0,-4,0,-1,0,0,84
Afghanistan,23/07/2010,35,4,0,0,5,8,0,52
Afghanistan,24/07/2010,80,0,1,0,18,1,0,100
Afghanistan,25/07/2010,115,0,1,0,10,15,0,141
Afghanistan,26/07/2010,139,2,0,0,9,12,0,162
Afghanistan,27/07/2010,91,0,1,0,-3,15,0,104
Afghanistan,28/07/2010,152,0,4,0,23,10,0,189
Afghanistan,29/07/2010,338,0,0,0,77,39,0,454
Afghanistan,30/07/2010,314,0,6,0,86,17,0,423
Afghanistan,31/07/2010,242,4,-4,0,48,20,0,310
Albania,01/07/2010,2,0,0,0,0,0,0,2
Albania,02/07/2010,47,0,0,0,6,3,0,56
Albania,03/07/2010,16,0,0,0,0,0,0,16
Albania,04/07/2010,8,0,0,0,0,0,0,8
Albania,05/07/2010,96,0,3,0,3,18,0,120
Albania,06/07/2010,2,0,1,0,0,0,0,3
Albania,07/07/2010,4,0,0,0,0,0,0,4
Albania,08/07/2010,4,0,0,0,0,0,0,4
Albania,09/07/2010,5,0,0,0,0,0,0,5
Albania,10/07/2010,1,0,0,0,0,0,0,1
Albania,11/07/2010,0,0,0,0,0,1,0,1
Albania,12/07/2010,10,0,0,0,6,0,0,16
Albania,13/07/2010,0,0,0,0,9,0,0,9
Albania,14/07/2010,5,0,0,0,0,0,0,5
Albania,15/07/2010,4,0,-1,0,0,0,0,3
Albania,16/07/2010,1,0,0,0,15,0,0,16
Albania,17/07/2010,0,0,1,0,0,0,0,1
Albania,18/07/2010,0,0,0,0,3,0,0,3
Albania,19/07/2010,9,0,0,0,0,6,0,15
Albania,20/07/2010,3,0,0,0,0,0,0,3
Albania,21/07/2010,13,0,0,0,18,0,0,31
Albania,22/07/2010,41,0,-4,0,3,2,0,42
Albania,23/07/2010,19,0,0,0,0,0,0,19
Albania,24/07/2010,0,0,0,0,0,0,0,0
Albania,25/07/2010,2,0,0,0,3,0,0,5
Albania,26/07/2010,5,0,0,0,0,0,0,5
Albania,27/07/2010,2,0,0,0,0,0,0,2
Albania,28/07/2010,3,0,0,0,0,0,0,3
Albania,29/07/2010,32,0,0,0,0,1,0,33
Albania,30/07/2010,12,0,0,0,9,0,0,21
Albania,31/07/2010,9,0,0,0,0,0,0,9
Algeria,01/07/2010,15,0,0,0,6,0,0,21
Algeria,02/07/2010,9,0,0,0,0,0,0,9
Algeria,03/07/2010,4,0,0,0,8,0,0,12
Algeria,04/07/2010,0,0,0,0,0,0,0,0
Algeria,05/07/2010,6,0,0,0,0,0,0,6
Algeria,06/07/2010,0,0,0,0,0,0,0,0
Algeria,07/07/2010,2,0,0,0,2,0,0,4
Algeria,08/07/2010,5,0,0,0,3,2,0,10
Algeria,09/07/2010,0,0,0,0,0,0,0,0
Algeria,10/07/2010,0,0,0,0,3,0,0,3
Algeria,11/07/2010,0,0,0,0,-1,0,0,-1
Algeria,12/07/2010,6,0,0,0,0,3,0,9
Algeria,13/07/2010,2,0,0,0,3,0,0,5
Algeria,14/07/2010,1,0,0,0,9,0,0,10
Algeria,16/07/2010,0,0,0,0,0,0,0,0
Algeria,17/07/2010,0,0,0,0,3,0,0,3
Algeria,18/07/2010,0,0,0,0,3,0,0,3
Algeria,19/07/2010,13,0,0,0,0,0,0,13
Algeria,20/07/2010,15,0,0,0,4,2,0,21
Algeria,21/07/2010,6,0,0,0,6,0,0,12
Algeria,22/07/2010,-2,0,0,0,0,0,0,-2
Algeria,23/07/2010,0,0,0,0,0,0,0,0
Algeria,24/07/2010,0,0,0,0,0,0,0,0
Algeria,25/07/2010,10,0,0,0,12,0,0,22
Algeria,26/07/2010,12,0,0,0,22,1,0,35
Algeria,27/07/2010,8,0,0,0,-2,0,0,6
Algeria,28/07/2010,9,0,0,0,11,0,0,20
Algeria,29/07/2010,7,0,0,0,3,0,0,10
Algeria,30/07/2010,1,0,0,0,3,0,0,4
Algeria,31/07/2010,0,0,0,0,6,0,0,6
Bangladesh,01/07/2010,6,0,0,0,9,0,0,15
Bangladesh,02/07/2010,0,0,0,0,1,0,0,1
Bangladesh,03/07/2010,3,0,0,0,2,0,0,5
Bangladesh,04/07/2010,17,0,0,0,9,0,0,26
Bangladesh,05/07/2010,30,0,1,0,10,7,0,48
Bangladesh,06/07/2010,13,0,0,0,13,0,0,26
Bangladesh,07/07/2010,6,0,3,0,9,4,0,22
Bangladesh,08/07/2010,0,0,0,0,3,0,0,3
Bangladesh,09/07/2010,2,0,0,0,15,1,0,18
Bangladesh,10/07/2010,31,0,0,0,16,2,0,49
Bangladesh,11/07/2010,1,0,0,0,12,0,0,13
Bangladesh,12/07/2010,2,0,0,0,0,0,0,2
Bangladesh,13/07/2010,0,0,0,0,0,3,0,3
Bangladesh,14/07/2010,7,0,-4,0,28,0,0,31
Bangladesh,15/07/2010,1,0,0,0,-2,0,0,-1
Bangladesh,16/07/2010,0,0,0,0,-2,0,0,-2
Bangladesh,17/07/2010,0,0,0,0,0,0,0,0
Bangladesh,18/07/2010,0,0,0,0,3,0,0,3
Bangladesh,19/07/2010,-1,0,0,0,15,0,0,14
Bangladesh,20/07/2010,3,0,0,0,3,0,0,6
Bangladesh,21/07/2010,14,0,0,0,3,2,0,19
Bangladesh,22/07/2010,15,0,0,0,-5,0,0,10
Bangladesh,23/07/2010,3,0,0,0,15,0,0,18
Bangladesh,24/07/2010,1,0,0,0,-5,0,0,-4
Bangladesh,25/07/2010,8,0,0,0,-14,6,0,0
Bangladesh,26/07/2010,0,0,0,0,6,1,0,7
Bangladesh,27/07/2010,-2,0,0,0,0,0,0,-2
Bangladesh,28/07/2010,11,0,0,0,0,6,0,17
Bangladesh,29/07/2010,34,0,-2,0,37,8,0,77
Bangladesh,30/07/2010,17,0,1,0,6,1,0,25
Bangladesh,31/07/2010,11,0,-2,0,10,4,0,23
Cameroon,01/07/2010,0,0,0,0,0,0,0,0
Cameroon,02/07/2010,0,0,0,0,0,0,0,0
Cameroon,04/07/2010,9,0,0,0,-2,0,0,7
Cameroon,05/07/2010,10,0,0,0,-6,0,0,4
Cameroon,06/07/2010,9,0,0,0,0,0,0,9
Cameroon,07/07/2010,13,0,-2,0,7,0,0,18
Cameroon,08/07/2010,0,0,0,0,0,0,0,0
Cameroon,09/07/2010,0,0,0,0,0,0,0,0
Cameroon,10/07/2010,5,0,0,0,0,0,0,5
Cameroon,11/07/2010,3,0,0,0,0,0,0,3
Cameroon,12/07/2010,0,0,0,0,0,0,0,0
Cameroon,16/07/2010,6,0,0,0,3,0,0,9
Cameroon,18/07/2010,0,0,0,0,0,0,0,0
Cameroon,19/07/2010,0,0,0,0,0,0,0,0
Cameroon,20/07/2010,1,0,0,0,0,0,0,1
Cameroon,21/07/2010,0,0,0,0,0,0,0,0
Cameroon,22/07/2010,0,0,0,0,0,0,0,0
Cameroon,25/07/2010,0,0,0,0,0,0,0,0
Cameroon,28/07/2010,0,0,0,0,0,0,0,0
Cameroon,29/07/2010,1,0,0,0,9,0,0,10
Cameroon,30/07/2010,9,0,0,0,0,0,0,9
China,01/07/2010,100,0,-3,0,56,5,0,158
China,02/07/2010,47,0,-2,0,5,6,0,56
China,03/07/2010,36,0,0,0,0,0,0,36
China,04/07/2010,58,0,-1,0,10,12,0,79
China,05/07/2010,118,2,-7,0,61,13,0,187
China,06/07/2010,91,2,-2,0,33,10,0,134
China,07/07/2010,101,0,-5,0,68,21,0,185
China,08/07/2010,71,4,-4,0,69,15,0,155
China,09/07/2010,127,6,-10,0,106,17,0,246
China,10/07/2010,58,0,-6,0,37,12,0,101
China,11/07/2010,10,0,0,0,2,0,0,12
China,12/07/2010,15,0,-2,0,10,6,0,29
China,13/07/2010,27,0,1,0,-5,2,0,25
China,14/07/2010,44,0,-2,0,34,10,0,86
China,15/07/2010,41,0,0,0,7,3,0,51
China,16/07/2010,44,0,0,0,22,1,0,67
China,17/07/2010,20,0,0,0,8,0,0,28
China,18/07/2010,20,0,0,0,6,0,0,26
China,19/07/2010,71,0,0,0,0,11,0,82
China,20/07/2010,31,0,-1,0,16,5,0,51
China,21/07/2010,103,2,-1,0,53,7,0,164
China,22/07/2010,43,2,-1,0,-3,6,0,47
China,23/07/2010,35,4,-2,0,12,3,0,52
China,24/07/2010,32,0,0,0,20,4,0,56
China,25/07/2010,76,0,2,0,27,0,0,105
China,26/07/2010,32,0,-1,0,9,4,0,44
China,27/07/2010,23,0,-2,0,36,2,0,59
China,28/07/2010,66,0,-2,0,25,3,0,92
China,29/07/2010,119,0,-2,0,76,20,0,213
China,30/07/2010,150,4,-2,0,98,31,0,281
China,31/07/2010,111,2,2,0,13,9,0,137
Egypt,01/07/2010,32,0,0,0,13,0,0,45
Egypt,02/07/2010,11,0,0,0,0,2,0,13
Egypt,03/07/2010,0,0,0,0,7,0,0,7
Egypt,04/07/2010,45,0,0,0,12,0,0,57
Egypt,05/07/2010,26,0,0,0,-8,3,0,21
Egypt,06/07/2010,10,0,0,0,5,0,0,15
Egypt,07/07/2010,46,0,0,0,4,0,0,50
Egypt,08/07/2010,10,0,2,0,9,6,0,27
Egypt,09/07/2010,9,2,3,0,3,3,0,20
Egypt,10/07/2010,4,0,0,0,-1,0,0,3
Egypt,11/07/2010,11,0,1,0,-4,5,0,13
Egypt,12/07/2010,15,0,0,0,1,0,0,16
Egypt,13/07/2010,13,0,0,0,-5,2,0,10
Egypt,14/07/2010,18,0,6,0,7,1,0,32
Egypt,15/07/2010,1,0,0,0,19,1,0,21
Egypt,16/07/2010,1,0,0,0,9,0,0,10
Egypt,17/07/2010,4,0,0,0,-2,0,0,2
Egypt,18/07/2010,12,0,1,0,0,3,0,16
Egypt,19/07/2010,45,0,5,0,14,2,0,66
Egypt,20/07/2010,12,0,0,0,0,0,0,12
Egypt,21/07/2010,0,0,-10,0,22,11,0,23
Egypt,22/07/2010,7,0,1,0,-9,0,0,-1
Egypt,23/07/2010,14,0,-1,0,-4,0,0,9
Egypt,24/07/2010,0,0,0,0,1,0,0,1
Egypt,25/07/2010,6,0,0,0,1,0,0,7
Egypt,26/07/2010,13,0,0,0,3,2,0,18
Egypt,27/07/2010,-2,0,0,0,0,0,0,-2
Egypt,28/07/2010,-1,0,0,0,-2,0,0,-3
Egypt,29/07/2010,40,2,-5,0,10,3,0,50
Egypt,30/07/2010,34,2,-2,0,6,0,0,40
Egypt,31/07/2010,130,0,0,0,12,0,0,142
Eritrea,01/07/2010,0,0,0,0,0,0,0,0
Eritrea,02/07/2010,0,0,0,0,0,0,0,0
Eritrea,03/07/2010,0,0,0,0,3,0,0,3
Eritrea,04/07/2010,0,0,0,0,6,0,0,6
Eritrea,05/07/2010,3,0,0,0,0,0,0,3
Eritrea,06/07/2010,0,0,0,0,0,0,0,0
Eritrea,07/07/2010,8,0,0,0,3,0,0,11
Eritrea,08/07/2010,0,0,0,0,0,0,0,0
Eritrea,09/07/2010,4,0,0,0,-2,0,0,2
Eritrea,10/07/2010,-3,0,0,0,0,0,0,-3
Eritrea,11/07/2010,0,0,0,0,0,0,0,0
Eritrea,12/07/2010,5,0,0,0,6,1,0,12
Eritrea,13/07/2010,2,0,0,0,0,0,0,2
Eritrea,16/07/2010,0,0,0,0,0,0,0,0
Eritrea,19/07/2010,2,2,0,0,9,0,0,13
Eritrea,20/07/2010,5,0,0,0,0,0,0,5
Eritrea,21/07/2010,4,0,0,0,0,0,0,4
Eritrea,22/07/2010,0,0,0,0,-6,0,0,-6
Eritrea,23/07/2010,0,0,0,0,0,0,0,0
Eritrea,24/07/2010,-8,0,0,0,0,0,0,-8
Eritrea,25/07/2010,0,0,0,0,0,1,0,1
Eritrea,27/07/2010,0,0,0,0,0,0,0,0
Eritrea,28/07/2010,0,0,0,0,3,0,0,3
Eritrea,29/07/2010,14,0,0,0,0,2,0,16
Eritrea,30/07/2010,1,0,0,0,0,0,0,1
Eritrea,31/07/2010,0,0,0,0,0,0,0,0
Georgia,01/07/2010,0,0,0,0,0,0,0,0
Georgia,02/07/2010,0,0,0,0,0,0,0,0
Georgia,03/07/2010,1,0,0,0,3,0,0,4
Georgia,04/07/2010,4,0,0,0,1,3,0,8
Georgia,05/07/2010,12,0,-2,0,22,0,0,32
Georgia,06/07/2010,13,0,0,0,-1,0,0,12
Georgia,07/07/2010,25,2,0,0,24,11,0,62
Georgia,08/07/2010,9,4,0,0,7,7,0,27
Georgia,09/07/2010,2,0,1,0,24,3,0,30
Georgia,10/07/2010,7,2,0,0,0,0,0,9
Georgia,11/07/2010,2,0,0,0,0,2,0,4
Georgia,12/07/2010,6,0,0,0,3,4,0,13
Georgia,13/07/2010,0,0,0,0,0,0,0,0
Georgia,14/07/2010,11,0,0,0,9,0,0,20
Georgia,15/07/2010,5,0,-4,0,2,1,0,4
Georgia,16/07/2010,7,0,0,0,0,0,0,7
Georgia,17/07/2010,6,0,0,0,-2,2,0,6
Georgia,18/07/2010,12,0,0,0,6,0,0,18
Georgia,19/07/2010,24,6,0,0,2,9,0,41
Georgia,20/07/2010,2,0,0,0,0,0,0,2
Georgia,21/07/2010,34,2,-1,0,6,9,0,50
Georgia,22/07/2010,8,0,0,0,-3,2,0,7
Georgia,23/07/2010,11,2,4,0,0,1,0,18
Georgia,24/07/2010,3,0,0,0,0,0,0,3
Georgia,25/07/2010,8,0,0,0,9,4,0,21
Georgia,26/07/2010,3,0,0,0,0,0,0,3
Georgia,27/07/2010,4,0,0,0,0,0,0,4
Georgia,28/07/2010,3,0,0,0,7,1,0,11
Georgia,29/07/2010,10,0,-1,0,25,5,0,39
Georgia,30/07/2010,27,2,0,0,33,3,0,65
Georgia,31/07/2010,30,2,0,0,2,7,0,41
India,01/07/2010,34,4,-3,0,9,21,0,65
India,02/07/2010,9,2,0,0,6,7,0,24
India,03/07/2010,26,0,0,0,3,0,0,29
India,04/07/2010,15,0,0,0,8,15,0,38
India,05/07/2010,41,2,-4,0,26,4,0,69
India,06/07/2010,45,2,0,0,24,3,0,74
India,07/07/2010,74,0,2,0,2,7,0,85
India,08/07/2010,29,0,0,0,5,5,0,39
India,09/07/2010,41,0,-2,0,11,4,0,54
India,10/07/2010,52,0,-1,0,35,4,0,90
India,11/07/2010,7,0,0,0,0,2,0,9
India,12/07/2010,47,0,0,0,17,3,0,67
India,13/07/2010,8,0,0,0,1,2,0,11
India,14/07/2010,13,0,0,0,17,2,0,32
India,15/07/2010,7,0,0,0,-1,5,0,11
India,16/07/2010,14,2,0,0,3,5,0,24
India,17/07/2010,6,0,0,0,0,0,0,6
India,18/07/2010,12,0,0,0,4,3,0,19
India,19/07/2010,38,0,-3,0,1,7,0,43
India,20/07/2010,28,0,-1,0,10,6,0,43
India,21/07/2010,18,0,1,0,7,5,0,31
India,22/07/2010,12,0,0,0,3,0,0,15
India,23/07/2010,32,0,0,0,7,6,0,45
India,24/07/2010,16,0,0,0,2,0,0,18
India,25/07/2010,26,0,-2,0,22,5,0,51
India,26/07/2010,4,0,0,0,0,0,0,4
India,27/07/2010,6,0,0,0,12,0,0,18
India,28/07/2010,44,0,0,0,21,1,0,66
India,29/07/2010,102,0,1,0,21,5,0,129
India,30/07/2010,56,0,0,0,62,13,0,131
India,31/07/2010,91,4,2,0,17,15,0,129
Iran,01/07/2010,49,0,1,0,31,16,0,97
Iran,02/07/2010,12,0,0,0,8,4,0,24
Iran,03/07/2010,35,0,0,0,3,0,0,38
Iran,04/07/2010,41,0,0,0,26,5,0,72
Iran,05/07/2010,57,0,1,0,24,13,0,95
Iran,06/07/2010,10,0,1,0,28,0,0,39
Iran,07/07/2010,58,0,-1,0,37,24,0,118
Iran,08/07/2010,37,0,-2,0,3,29,0,67
Iran,09/07/2010,59,0,1,0,72,33,0,165
Iran,10/07/2010,29,0,1,0,67,38,0,135
Iran,11/07/2010,8,0,0,0,16,12,0,36
Iran,12/07/2010,34,0,1,0,36,8,0,79
Iran,13/07/2010,17,0,2,0,39,0,0,58
Iran,14/07/2010,34,0,-3,0,53,8,0,92
Iran,15/07/2010,10,0,0,0,31,2,0,43
Iran,16/07/2010,33,0,0,0,-1,10,0,42
Iran,17/07/2010,20,0,0,0,13,4,0,37
Iran,18/07/2010,38,0,0,0,19,5,0,62
Iran,19/07/2010,48,0,0,0,29,25,0,102
Iran,20/07/2010,41,0,0,0,23,2,0,66
Iran,21/07/2010,45,0,0,0,18,0,0,63
Iran,22/07/2010,41,0,-2,0,8,8,0,55
Iran,23/07/2010,9,0,0,0,6,0,0,15
Iran,24/07/2010,5,0,0,0,0,0,0,5
Iran,25/07/2010,25,0,0,0,5,0,0,30
Iran,26/07/2010,16,0,0,0,30,9,0,55
Iran,27/07/2010,26,0,0,0,18,1,0,45
Iran,28/07/2010,13,0,0,0,7,0,0,20
Iran,29/07/2010,71,2,8,0,30,8,0,119
Iran,30/07/2010,107,4,-2,0,87,15,0,211
Iran,31/07/2010,63,0,0,0,11,4,0,78
Iraq,01/07/2010,66,0,1,0,6,10,0,83
Iraq,02/07/2010,60,0,1,0,13,7,0,81
Iraq,03/07/2010,50,0,2,0,5,2,0,59
Iraq,04/07/2010,41,0,0,0,3,3,0,47
Iraq,05/07/2010,104,2,0,0,11,9,0,126
Iraq,06/07/2010,92,0,0,0,2,4,0,98
Iraq,07/07/2010,119,2,1,0,4,17,0,143
Iraq,08/07/2010,54,0,4,0,6,4,0,68
Iraq,09/07/2010,145,0,-1,0,22,0,0,166
Iraq,10/07/2010,95,0,1,0,18,6,0,120
Iraq,11/07/2010,15,0,0,0,0,0,0,15
Iraq,12/07/2010,20,0,-1,0,28,4,0,51
Iraq,13/07/2010,14,0,0,0,14,2,0,30
Iraq,14/07/2010,60,0,0,0,1,4,0,65
Iraq,15/07/2010,33,4,0,0,0,0,0,37
Iraq,16/07/2010,41,0,0,0,7,6,0,54
Iraq,17/07/2010,18,0,0,0,-2,0,0,16
Iraq,18/07/2010,23,0,0,0,0,6,0,29
Iraq,19/07/2010,53,2,1,0,18,49,0,123
Iraq,20/07/2010,85,2,-4,0,3,32,0,118
Iraq,21/07/2010,76,0,0,0,19,7,0,102
Iraq,22/07/2010,62,0,0,0,-1,9,0,70
Iraq,23/07/2010,18,0,0,0,3,0,0,21
Iraq,24/07/2010,22,0,0,0,9,7,0,38
Iraq,25/07/2010,25,0,0,0,9,2,0,36
Iraq,26/07/2010,47,2,0,0,24,0,0,73
Iraq,27/07/2010,21,0,0,0,7,5,0,33
Iraq,28/07/2010,29,0,-2,0,21,10,0,58
Iraq,29/07/2010,101,2,1,0,63,15,0,182
Iraq,30/07/2010,188,2,2,0,89,26,0,307
Iraq,31/07/2010,91,2,1,0,62,4,0,160
Morocco,01/07/2010,0,0,0,0,0,0,0,0
Morocco,02/07/2010,2,0,0,0,0,0,0,2
Morocco,03/07/2010,15,0,0,0,0,0,0,15
Morocco,04/07/2010,0,0,0,0,0,0,0,0
Morocco,05/07/2010,7,0,0,0,0,0,0,7
Morocco,07/07/2010,8,0,0,0,0,0,0,8
Morocco,08/07/2010,0,0,0,0,0,0,0,0
Morocco,09/07/2010,9,0,0,0,3,0,0,12
Morocco,10/07/2010,0,0,0,0,3,0,0,3
Morocco,11/07/2010,3,0,0,0,0,0,0,3
Morocco,12/07/2010,3,0,0,0,1,0,0,4
Morocco,13/07/2010,3,0,0,0,6,0,0,9
Morocco,14/07/2010,4,0,0,0,3,0,0,7
Morocco,15/07/2010,2,0,0,0,0,0,0,2
Morocco,16/07/2010,0,0,0,0,0,0,0,0
Morocco,17/07/2010,3,0,0,0,3,6,0,12
Morocco,18/07/2010,0,0,0,0,0,0,0,0
Morocco,19/07/2010,0,0,0,0,6,0,0,6
Morocco,20/07/2010,0,0,0,0,0,0,0,0
Morocco,21/07/2010,7,0,0,0,2,0,0,9
Morocco,22/07/2010,0,0,0,0,0,0,0,0
Morocco,23/07/2010,8,0,0,0,6,0,0,14
Morocco,24/07/2010,8,0,0,0,6,0,0,14
Morocco,26/07/2010,0,0,0,0,6,0,0,6
Morocco,27/07/2010,0,0,0,0,0,0,0,0
Morocco,28/07/2010,6,0,0,0,0,0,0,6
Morocco,29/07/2010,8,0,0,0,5,0,0,13
Morocco,30/07/2010,10,0,0,0,-2,0,0,8
Morocco,31/07/2010,0,0,0,0,-8,0,0,-8
Nigeria,01/07/2010,8,0,0,0,0,0,0,8
Nigeria,02/07/2010,-3,0,-1,0,0,0,0,-4
Nigeria,03/07/2010,8,0,0,0,9,0,0,17
Nigeria,04/07/2010,4,0,0,0,14,2,0,20
Nigeria,05/07/2010,7,0,0,0,6,2,0,15
Nigeria,06/07/2010,1,0,0,0,3,0,0,4
Nigeria,07/07/2010,8,0,0,0,14,0,0,22
Nigeria,08/07/2010,-3,0,0,0,7,1,0,5
Nigeria,09/07/2010,35,0,0,0,-9,0,0,26
Nigeria,10/07/2010,7,0,0,0,1,0,0,8
Nigeria,11/07/2010,0,0,0,0,0,0,0,0
Nigeria,12/07/2010,0,0,0,0,18,2,0,20
Nigeria,13/07/2010,0,0,0,0,0,0,0,0
Nigeria,14/07/2010,14,0,0,0,-4,0,0,10
Nigeria,15/07/2010,0,0,0,0,0,0,0,0
Nigeria,16/07/2010,0,0,0,0,0,3,0,3
Nigeria,17/07/2010,2,0,0,0,6,0,0,8
Nigeria,18/07/2010,13,0,0,0,8,0,0,21
Nigeria,19/07/2010,-3,0,0,0,-2,2,0,-3
Nigeria,20/07/2010,8,0,-1,0,6,1,0,14
Nigeria,21/07/2010,23,0,-1,0,8,0,0,30
Nigeria,22/07/2010,4,0,0,0,6,0,0,10
Nigeria,23/07/2010,0,0,0,0,-1,0,0,-1
Nigeria,24/07/2010,8,0,0,0,0,0,0,8
Nigeria,25/07/2010,3,0,0,0,0,0,0,3
Nigeria,26/07/2010,0,0,0,0,12,0,0,12
Nigeria,27/07/2010,0,0,0,0,0,0,0,0
Nigeria,28/07/2010,12,0,0,0,12,0,0,24
Nigeria,29/07/2010,24,2,-2,0,43,6,0,73
Nigeria,30/07/2010,20,2,1,0,16,2,0,41
Nigeria,31/07/2010,10,0,2,0,12,7,0,31
Pakistan,01/07/2010,34,0,0,0,10,1,0,45
Pakistan,02/07/2010,32,0,0,0,32,6,0,70
Pakistan,03/07/2010,22,0,0,0,0,1,0,23
Pakistan,04/07/2010,21,0,0,0,29,4,0,54
Pakistan,05/07/2010,80,0,0,0,27,4,0,111
Pakistan,06/07/2010,26,0,0,0,31,5,0,62
Pakistan,07/07/2010,125,2,-5,0,125,28,0,275
Pakistan,08/07/2010,56,0,1,0,51,13,0,121
Pakistan,09/07/2010,60,4,-5,0,11,38,0,108
Pakistan,10/07/2010,184,0,0,0,-1,21,0,204
Pakistan,11/07/2010,40,0,0,0,1,1,0,42
Pakistan,12/07/2010,20,0,0,0,21,2,0,43
Pakistan,13/07/2010,31,0,0,0,10,0,0,41
Pakistan,14/07/2010,50,0,1,0,24,1,0,76
Pakistan,15/07/2010,19,0,0,0,7,0,0,26
Pakistan,16/07/2010,35,0,0,0,12,3,0,50
Pakistan,17/07/2010,20,0,0,0,6,0,0,26
Pakistan,18/07/2010,33,0,0,0,24,3,0,60
Pakistan,19/07/2010,111,0,0,0,41,14,0,166
Pakistan,20/07/2010,3,0,0,0,9,0,0,12
Pakistan,21/07/2010,66,0,0,0,10,1,0,77
Pakistan,22/07/2010,35,0,0,0,1,0,0,36
Pakistan,23/07/2010,22,0,0,0,9,2,0,33
Pakistan,24/07/2010,16,0,1,0,0,0,0,17
Pakistan,25/07/2010,57,0,0,0,16,2,0,75
Pakistan,26/07/2010,57,4,-2,0,23,4,0,86
Pakistan,27/07/2010,40,0,1,0,-4,0,0,37
Pakistan,28/07/2010,102,0,0,0,6,10,0,118
Pakistan,29/07/2010,207,0,1,0,15,22,0,245
Pakistan,30/07/2010,75,2,-1,0,58,11,0,145
Pakistan,31/07/2010,166,0,3,0,68,24,0,261
Sierra Leone,01/07/2010,27,0,0,0,36,1,0,64
Sierra Leone,02/07/2010,11,0,0,0,0,1,0,12
Sierra Leone,03/07/2010,0,0,0,0,0,1,0,1
Sierra Leone,04/07/2010,0,0,0,0,0,0,0,0
Sierra Leone,05/07/2010,8,0,0,0,0,0,0,8
Sierra Leone,06/07/2010,0,0,0,0,-2,2,0,0
Sierra Leone,07/07/2010,3,0,0,0,1,0,0,4
Sierra Leone,08/07/2010,0,0,0,0,0,0,0,0
Sierra Leone,09/07/2010,0,0,2,0,0,0,0,2
Sierra Leone,10/07/2010,0,0,0,0,0,0,0,0
Sierra Leone,11/07/2010,0,0,0,0,3,0,0,3
Sierra Leone,12/07/2010,0,0,0,0,-2,0,0,-2
Sierra Leone,13/07/2010,1,0,2,0,0,0,0,3
Sierra Leone,14/07/2010,0,0,0,0,0,1,0,1
Sierra Leone,16/07/2010,0,0,0,0,3,0,0,3
Sierra Leone,17/07/2010,0,0,0,0,0,0,0,0
Sierra Leone,19/07/2010,4,0,0,0,6,0,0,10
Sierra Leone,20/07/2010,7,0,0,0,3,0,0,10
Sierra Leone,21/07/2010,6,0,0,0,-2,0,0,4
Sierra Leone,22/07/2010,2,0,0,0,-2,0,0,0
Sierra Leone,25/07/2010,1,0,0,0,0,0,0,1
Sierra Leone,26/07/2010,0,0,0,0,0,0,0,0
Sierra Leone,27/07/2010,0,0,0,0,0,0,0,0
Sierra Leone,28/07/2010,0,0,0,0,0,0,0,0
Sierra Leone,29/07/2010,0,0,0,0,-2,0,0,-2
Sierra Leone,30/07/2010,11,0,-2,0,-4,0,0,5
Sierra Leone,31/07/2010,2,0,0,0,0,0,0,2
Somalia,01/07/2010,8,0,0,0,0,6,0,14
Somalia,02/07/2010,17,0,-3,0,12,1,0,27
Somalia,03/07/2010,0,0,0,0,0,1,0,1
Somalia,04/07/2010,9,0,0,0,15,0,0,24
Somalia,05/07/2010,44,0,0,0,12,7,0,63
Somalia,06/07/2010,15,0,0,0,25,0,0,40
Somalia,07/07/2010,7,0,0,0,18,2,0,27
Somalia,08/07/2010,10,0,0,0,1,0,0,11
Somalia,09/07/2010,9,0,0,0,-2,0,0,7
Somalia,10/07/2010,11,0,0,0,3,3,0,17
Somalia,11/07/2010,1,0,0,0,0,3,0,4
Somalia,12/07/2010,13,2,0,0,7,6,0,28
Somalia,13/07/2010,18,0,0,0,6,5,0,29
Somalia,14/07/2010,-2,0,0,0,0,0,0,-2
Somalia,15/07/2010,7,0,0,0,9,3,0,19
Somalia,16/07/2010,5,0,0,0,0,0,0,5
Somalia,17/07/2010,17,0,0,0,6,1,0,24
Somalia,18/07/2010,3,0,0,0,3,0,0,6
Somalia,19/07/2010,18,0,0,0,-2,0,0,16
Somalia,20/07/2010,33,0,0,0,-2,2,0,33
Somalia,21/07/2010,52,0,0,0,-2,15,0,65
Somalia,22/07/2010,8,0,0,0,7,0,0,15
Somalia,23/07/2010,0,0,0,0,0,1,0,1
Somalia,24/07/2010,1,0,0,0,0,0,0,1
Somalia,25/07/2010,34,6,-2,0,6,2,0,46
Somalia,26/07/2010,34,0,0,0,21,2,0,57
Somalia,27/07/2010,11,0,0,0,15,1,0,27
Somalia,28/07/2010,17,0,0,0,23,1,0,41
Somalia,29/07/2010,43,0,0,0,-30,11,0,24
Somalia,30/07/2010,21,0,0,0,-9,0,0,12
Somalia,31/07/2010,7,0,0,0,-5,0,0,2
Syria,01/07/2010,17,0,0,0,10,0,0,27
Syria,02/07/2010,0,0,0,0,0,2,0,2
Syria,03/07/2010,-2,0,0,0,3,0,0,1
Syria,04/07/2010,5,0,0,0,31,0,0,36
Syria,05/07/2010,2,0,3,0,19,0,0,24
Syria,06/07/2010,20,0,0,0,13,0,0,33
Syria,07/07/2010,27,4,0,0,33,5,0,69
Syria,08/07/2010,6,0,0,0,0,0,0,6
Syria,09/07/2010,18,0,0,0,-4,0,0,14
Syria,10/07/2010,5,0,0,0,0,0,0,5
Syria,11/07/2010,3,0,1,0,3,0,0,7
Syria,12/07/2010,0,0,0,0,0,0,0,0
Syria,13/07/2010,9,0,0,0,15,0,0,24
Syria,14/07/2010,0,0,0,0,9,0,0,9
Syria,15/07/2010,0,0,0,0,0,0,0,0
Syria,16/07/2010,0,0,0,0,0,0,0,0
Syria,17/07/2010,0,0,0,0,0,0,0,0
Syria,18/07/2010,3,0,0,0,9,0,0,12
Syria,19/07/2010,13,0,0,0,46,3,0,62
Syria,20/07/2010,0,0,0,0,18,0,0,18
Syria,21/07/2010,14,0,1,0,12,3,0,30
Syria,22/07/2010,22,0,0,0,39,0,0,61
Syria,23/07/2010,-3,0,0,0,3,0,0,0
Syria,24/07/2010,0,0,0,0,0,0,0,0
Syria,25/07/2010,4,0,0,0,3,0,0,7
Syria,26/07/2010,0,2,-1,0,0,0,0,1
Syria,27/07/2010,0,0,0,0,0,0,0,0
Syria,28/07/2010,0,0,0,0,0,0,0,0
Syria,29/07/2010,-7,2,0,0,-4,4,0,-5
Syria,30/07/2010,12,2,0,0,30,0,0,44
Syria,31/07/2010,19,0,3,0,68,2,0,92
Yemen,01/07/2010,3,0,0,0,0,0,0,3
Yemen,02/07/2010,5,0,0,0,3,0,0,8
Yemen,03/07/2010,0,0,0,0,0,0,0,0
Yemen,04/07/2010,19,0,0,0,-2,0,0,17
Yemen,05/07/2010,26,0,0,0,-4,0,0,22
Yemen,06/07/2010,11,0,0,0,3,1,0,15
Yemen,07/07/2010,63,0,0,0,48,4,0,115
Yemen,08/07/2010,6,0,0,0,18,0,0,24
Yemen,09/07/2010,25,0,0,0,-10,1,0,16
Yemen,10/07/2010,3,0,0,0,0,0,0,3
Yemen,11/07/2010,1,0,2,0,21,0,0,24
Yemen,12/07/2010,8,0,0,0,16,0,0,24
Yemen,13/07/2010,2,0,0,0,-2,0,0,0
Yemen,14/07/2010,7,0,0,0,12,0,0,19
Yemen,15/07/2010,0,0,0,0,0,0,0,0
Yemen,16/07/2010,3,0,0,0,3,2,0,8
Yemen,17/07/2010,3,0,0,0,0,0,0,3
Yemen,18/07/2010,0,0,0,0,-2,0,0,-2
Yemen,19/07/2010,2,0,0,0,0,0,0,2
Yemen,20/07/2010,9,0,0,0,3,1,0,13
Yemen,21/07/2010,11,0,0,0,3,2,0,16
Yemen,22/07/2010,20,0,0,0,-7,2,0,15
Yemen,23/07/2010,-2,0,0,0,3,0,0,1
Yemen,24/07/2010,-2,0,0,0,0,0,0,-2
Yemen,25/07/2010,5,0,0,0,3,0,0,8
Yemen,26/07/2010,30,0,0,0,0,0,0,30
Yemen,27/07/2010,3,0,0,0,0,2,0,5
Yemen,28/07/2010,2,0,0,0,12,0,0,14
Yemen,29/07/2010,11,0,0,0,-1,2,0,12
Yemen,30/07/2010,16,0,0,0,-1,0,0,15
Yemen,31/07/2010,14,0,0,0,7,0,0,21
Afghanistan,01/03/2010,72,0,0,0,15,30,0,117
Afghanistan,02/03/2010,117,0,0,0,54,3,0,174
Afghanistan,03/03/2010,51,0,0,0,35,0,0,86
Afghanistan,04/03/2010,105,2,0,0,19,3,0,129
Afghanistan,05/03/2010,77,4,2,0,49,14,0,146
Afghanistan,06/03/2010,51,2,0,0,23,12,0,88
Afghanistan,07/03/2010,112,6,2,0,19,14,0,153
Afghanistan,08/03/2010,80,0,0,0,48,16,0,144
Afghanistan,09/03/2010,52,2,0,0,30,2,0,86
Afghanistan,10/03/2010,87,0,-1,0,23,6,0,115
Afghanistan,11/03/2010,92,0,0,0,12,7,0,111
Afghanistan,12/03/2010,55,0,0,0,18,11,0,84
Afghanistan,13/03/2010,29,0,-4,0,3,28,0,56
Afghanistan,14/03/2010,37,0,0,0,24,5,0,66
Afghanistan,15/03/2010,76,0,-2,0,9,2,0,85
Afghanistan,16/03/2010,83,0,-3,0,14,13,0,107
Afghanistan,17/03/2010,144,0,-1,0,20,18,0,181
Afghanistan,18/03/2010,94,0,0,0,43,13,0,150
Afghanistan,19/03/2010,40,0,0,0,4,4,0,48
Afghanistan,20/03/2010,35,0,0,0,12,2,0,49
Afghanistan,21/03/2010,118,0,1,0,59,35,0,213
Afghanistan,22/03/2010,28,0,0,0,2,8,0,38
Afghanistan,23/03/2010,98,0,0,0,27,14,0,139
Afghanistan,24/03/2010,110,0,-1,0,23,7,0,139
Afghanistan,25/03/2010,53,4,0,0,16,3,0,76
Afghanistan,26/03/2010,167,0,1,0,0,19,0,187
Afghanistan,27/03/2010,60,0,-1,0,2,1,0,62
Afghanistan,28/03/2010,50,0,0,0,23,4,0,77
Afghanistan,29/03/2010,78,0,0,0,4,6,0,88
Afghanistan,30/03/2010,103,2,0,0,43,15,0,163
Afghanistan,31/03/2010,193,0,0,0,48,5,0,246
Albania,01/03/2010,4,0,0,0,3,0,0,7
Albania,02/03/2010,4,0,4,0,0,1,0,9
Albania,03/03/2010,0,0,0,0,0,1,0,1
Albania,04/03/2010,0,0,0,0,0,0,0,0
Albania,05/03/2010,2,0,0,0,9,0,0,11
Albania,06/03/2010,9,0,0,0,0,0,0,9
Albania,08/03/2010,-1,0,0,0,0,0,0,-1
Albania,09/03/2010,-1,0,0,0,0,0,0,-1
Albania,10/03/2010,2,0,0,0,0,0,0,2
Albania,11/03/2010,2,0,0,0,0,0,0,2
Albania,12/03/2010,0,0,0,0,0,0,0,0
Albania,13/03/2010,3,0,0,0,0,0,0,3
Albania,14/03/2010,3,0,0,0,0,0,0,3
Albania,15/03/2010,5,0,0,0,9,0,0,14
Albania,16/03/2010,0,0,0,0,3,1,0,4
Albania,17/03/2010,0,0,0,0,19,0,0,19
Albania,18/03/2010,1,0,0,0,0,0,0,1
Albania,19/03/2010,0,0,0,0,0,0,0,0
Albania,20/03/2010,2,0,0,0,0,0,0,2
Albania,21/03/2010,0,0,0,0,0,0,0,0
Albania,22/03/2010,1,0,0,0,6,0,0,7
Albania,23/03/2010,0,0,0,0,0,0,0,0
Albania,24/03/2010,8,0,0,0,0,0,0,8
Albania,25/03/2010,15,0,0,0,0,1,0,16
Albania,26/03/2010,2,0,0,0,0,0,0,2
Albania,27/03/2010,0,0,0,0,0,0,0,0
Albania,28/03/2010,4,0,1,0,0,3,0,8
Albania,29/03/2010,0,0,0,0,-2,0,0,-2
Albania,30/03/2010,6,0,0,0,-2,2,0,6
Albania,31/03/2010,2,0,0,0,0,0,0,2
Algeria,02/03/2010,9,0,0,0,0,0,0,9
Algeria,03/03/2010,0,0,0,0,2,0,0,2
Algeria,04/03/2010,1,0,0,0,0,0,0,1
Algeria,05/03/2010,2,0,0,0,0,0,0,2
Algeria,07/03/2010,2,0,0,0,3,0,0,5
Algeria,08/03/2010,0,0,0,0,1,0,0,1
Algeria,09/03/2010,8,0,0,0,9,0,0,17
Algeria,10/03/2010,0,0,0,0,0,0,0,0
Algeria,11/03/2010,19,0,0,0,24,0,0,43
Algeria,12/03/2010,0,0,0,0,6,0,0,6
Algeria,13/03/2010,5,0,0,0,28,4,0,37
Algeria,14/03/2010,0,0,0,0,3,0,0,3
Algeria,15/03/2010,0,0,0,0,17,0,0,17
Algeria,16/03/2010,18,0,-2,0,24,1,0,41
Algeria,17/03/2010,0,0,0,0,0,0,0,0
Algeria,18/03/2010,0,0,0,0,0,0,0,0
Algeria,19/03/2010,2,0,0,0,0,0,0,2
Algeria,20/03/2010,4,0,0,0,6,0,0,10
Algeria,21/03/2010,0,0,0,0,3,0,0,3
Algeria,22/03/2010,1,0,0,0,0,0,0,1
Algeria,23/03/2010,0,0,0,0,0,0,0,0
Algeria,24/03/2010,0,0,0,0,0,0,0,0
Algeria,26/03/2010,0,0,0,0,12,1,0,13
Algeria,27/03/2010,0,0,0,0,0,0,0,0
Algeria,28/03/2010,-1,0,0,0,0,0,0,-1
Algeria,29/03/2010,0,0,0,0,15,0,0,15
Algeria,30/03/2010,2,0,0,0,-6,0,0,-4
Algeria,31/03/2010,5,0,0,0,0,0,0,5
Bangladesh,01/03/2010,4,0,0,0,3,0,0,7
Bangladesh,02/03/2010,52,0,-1,0,22,21,0,94
Bangladesh,03/03/2010,12,0,0,0,9,7,0,28
Bangladesh,04/03/2010,6,0,0,0,6,2,0,14
Bangladesh,05/03/2010,16,0,0,0,1,8,0,25
Bangladesh,07/03/2010,0,0,0,0,0,0,0,0
Bangladesh,08/03/2010,0,0,0,0,0,3,0,3
Bangladesh,09/03/2010,1,0,0,0,3,1,0,5
Bangladesh,10/03/2010,4,0,0,0,12,2,0,18
Bangladesh,11/03/2010,12,0,0,0,0,0,0,12
Bangladesh,13/03/2010,5,0,0,0,9,0,0,14
Bangladesh,14/03/2010,2,0,0,0,0,1,0,3
Bangladesh,15/03/2010,-2,0,0,0,-6,0,0,-8
Bangladesh,16/03/2010,6,0,0,0,6,1,0,13
Bangladesh,17/03/2010,2,0,0,0,9,7,0,18
Bangladesh,18/03/2010,-4,0,0,0,0,0,0,-4
Bangladesh,19/03/2010,1,0,0,0,4,1,0,6
Bangladesh,20/03/2010,8,0,0,0,0,9,0,17
Bangladesh,21/03/2010,22,0,1,0,0,0,0,23
Bangladesh,22/03/2010,2,0,0,0,3,0,0,5
Bangladesh,23/03/2010,1,0,0,0,0,1,0,2
Bangladesh,24/03/2010,6,0,0,0,4,0,0,10
Bangladesh,25/03/2010,0,0,0,0,0,2,0,2
Bangladesh,26/03/2010,7,0,0,0,0,0,0,7
Bangladesh,28/03/2010,3,0,0,0,0,0,0,3
Bangladesh,29/03/2010,2,0,1,0,3,0,0,6
Bangladesh,30/03/2010,2,0,0,0,0,0,0,2
Bangladesh,31/03/2010,0,0,0,0,-1,0,0,-1
Cameroon,01/03/2010,0,0,0,0,9,0,0,9
Cameroon,02/03/2010,0,0,0,0,9,0,0,9
Cameroon,06/03/2010,2,0,0,0,0,0,0,2
Cameroon,07/03/2010,0,0,0,0,3,0,0,3
Cameroon,09/03/2010,0,0,0,0,0,0,0,0
Cameroon,10/03/2010,-2,0,0,0,0,0,0,-2
Cameroon,11/03/2010,-1,0,0,0,0,0,0,-1
Cameroon,13/03/2010,0,0,0,0,0,0,0,0
Cameroon,14/03/2010,0,0,0,0,0,0,0,0
Cameroon,15/03/2010,0,0,0,0,0,0,0,0
Cameroon,16/03/2010,12,0,0,0,0,0,0,12
Cameroon,17/03/2010,0,0,0,0,0,0,0,0
Cameroon,18/03/2010,0,0,0,0,0,0,0,0
Cameroon,19/03/2010,0,0,0,0,0,0,0,0
Cameroon,21/03/2010,0,0,0,0,0,0,0,0
Cameroon,22/03/2010,0,0,0,0,-2,0,0,-2
Cameroon,23/03/2010,1,0,0,0,0,0,0,1
Cameroon,24/03/2010,0,0,0,0,3,0,0,3
Cameroon,26/03/2010,-5,0,0,0,0,0,0,-5
Cameroon,27/03/2010,0,0,0,0,0,0,0,0
Cameroon,28/03/2010,0,0,0,0,0,0,0,0
Cameroon,29/03/2010,6,0,0,0,3,0,0,9
Cameroon,30/03/2010,3,0,0,0,0,0,0,3
Cameroon,31/03/2010,0,0,0,0,-2,0,0,-2
China,01/03/2010,8,0,-4,0,13,0,0,17
China,02/03/2010,33,0,0,0,13,3,0,49
China,03/03/2010,18,0,0,0,2,6,0,26
China,04/03/2010,64,0,-4,0,27,0,0,87
China,05/03/2010,58,0,-6,0,26,2,0,80
China,06/03/2010,9,0,0,0,0,1,0,10
China,07/03/2010,40,0,0,0,11,7,0,58
China,08/03/2010,14,0,1,0,13,6,0,34
China,09/03/2010,56,0,1,0,25,6,0,88
China,10/03/2010,75,12,-8,0,25,6,0,110
China,11/03/2010,61,0,-1,0,36,1,0,97
China,12/03/2010,13,0,0,0,-10,3,0,6
China,13/03/2010,23,0,-2,0,13,4,0,38
China,14/03/2010,6,0,1,0,9,0,0,16
China,15/03/2010,38,0,-3,0,26,5,0,66
China,16/03/2010,32,0,2,0,69,3,0,106
China,17/03/2010,22,0,1,0,2,1,0,26
China,18/03/2010,21,4,-4,0,3,2,0,26
China,19/03/2010,20,0,-2,0,9,6,0,33
China,20/03/2010,-8,2,0,0,6,0,0,0
China,21/03/2010,32,0,1,0,24,2,0,59
China,22/03/2010,28,0,1,0,34,7,0,70
China,23/03/2010,86,4,-1,0,89,16,0,194
China,24/03/2010,52,2,-1,0,32,3,0,88
China,25/03/2010,37,0,3,0,26,2,0,68
China,26/03/2010,88,0,1,0,62,5,0,156
China,27/03/2010,25,0,1,0,-3,3,0,26
China,28/03/2010,17,0,0,0,6,4,0,27
China,29/03/2010,53,0,-1,0,39,2,0,93
China,30/03/2010,35,4,0,0,5,9,0,53
China,31/03/2010,49,2,-1,0,2,1,0,53
Egypt,01/03/2010,7,0,0,0,3,0,0,10
Egypt,02/03/2010,27,0,0,0,11,0,0,38
Egypt,03/03/2010,11,0,0,0,3,0,0,14
Egypt,04/03/2010,8,0,0,0,0,0,0,8
Egypt,05/03/2010,4,0,0,0,0,0,0,4
Egypt,06/03/2010,0,0,-4,0,6,0,0,2
Egypt,07/03/2010,19,0,-3,0,9,0,0,25
Egypt,08/03/2010,3,0,0,0,4,0,0,7
Egypt,09/03/2010,2,0,0,0,3,0,0,5
Egypt,10/03/2010,4,0,0,0,-4,0,0,0
Egypt,11/03/2010,11,0,0,0,9,2,0,22
Egypt,12/03/2010,1,0,0,0,15,0,0,16
Egypt,13/03/2010,5,0,0,0,24,0,0,29
Egypt,14/03/2010,2,0,0,0,9,0,0,11
Egypt,15/03/2010,8,0,0,0,12,0,0,20
Egypt,16/03/2010,14,0,-8,0,9,2,0,17
Egypt,17/03/2010,19,0,1,0,6,7,0,33
Egypt,18/03/2010,3,0,0,0,6,2,0,11
Egypt,19/03/2010,13,0,0,0,0,0,0,13
Egypt,20/03/2010,0,0,0,0,0,0,0,0
Egypt,21/03/2010,19,0,0,0,5,2,0,26
Egypt,22/03/2010,9,0,0,0,12,0,0,21
Egypt,23/03/2010,44,0,0,0,40,2,0,86
Egypt,24/03/2010,10,0,-6,0,9,2,0,15
Egypt,25/03/2010,4,0,-7,0,3,1,0,1
Egypt,26/03/2010,14,0,0,0,12,0,0,26
Egypt,27/03/2010,-1,0,0,0,2,0,0,1
Egypt,28/03/2010,9,0,0,0,0,0,0,9
Egypt,29/03/2010,9,0,0,0,3,0,0,12
Egypt,30/03/2010,5,0,-2,0,0,0,0,3
Egypt,31/03/2010,4,0,0,0,16,0,0,20
Eritrea,01/03/2010,0,0,0,0,6,0,0,6
Eritrea,02/03/2010,1,0,0,0,0,3,0,4
Eritrea,03/03/2010,3,0,0,0,0,0,0,3
Eritrea,05/03/2010,0,4,0,0,0,0,0,4
Eritrea,06/03/2010,0,0,0,0,0,0,0,0
Eritrea,07/03/2010,2,0,0,0,0,0,0,2
Eritrea,10/03/2010,1,0,0,0,6,0,0,7
Eritrea,11/03/2010,0,0,0,0,9,0,0,9
Eritrea,13/03/2010,6,0,0,0,0,0,0,6
Eritrea,14/03/2010,0,0,0,0,0,0,0,0
Eritrea,15/03/2010,0,0,0,0,0,0,0,0
Eritrea,16/03/2010,4,0,0,0,0,0,0,4
Eritrea,17/03/2010,10,0,0,0,0,0,0,10
Eritrea,18/03/2010,0,0,0,0,0,0,0,0
Eritrea,19/03/2010,0,0,0,0,0,0,0,0
Eritrea,20/03/2010,3,0,0,0,0,0,0,3
Eritrea,23/03/2010,0,0,0,0,0,0,0,0
Eritrea,24/03/2010,-1,0,0,0,0,3,0,2
Eritrea,25/03/2010,0,0,0,0,0,0,0,0
Eritrea,26/03/2010,0,0,0,0,9,5,0,14
Eritrea,27/03/2010,2,0,0,0,0,0,0,2
Eritrea,28/03/2010,0,0,0,0,0,0,0,0
Eritrea,29/03/2010,0,0,0,0,0,0,0,0
Eritrea,30/03/2010,0,0,0,0,0,0,0,0
Eritrea,31/03/2010,3,0,0,0,0,0,0,3
Georgia,01/03/2010,0,0,0,0,0,0,0,0
Georgia,02/03/2010,3,0,0,0,0,1,0,4
Georgia,03/03/2010,3,0,0,0,0,0,0,3
Georgia,04/03/2010,-1,0,0,0,6,0,0,5
Georgia,05/03/2010,0,0,0,0,-2,2,0,0
Georgia,06/03/2010,1,0,0,0,-2,1,0,0
Georgia,07/03/2010,0,0,0,0,12,0,0,12
Georgia,08/03/2010,0,0,0,0,0,0,0,0
Georgia,09/03/2010,12,0,0,0,3,0,0,15
Georgia,10/03/2010,4,0,0,0,6,0,0,10
Georgia,11/03/2010,3,2,0,0,0,1,0,6
Georgia,12/03/2010,0,0,0,0,0,0,0,0
Georgia,14/03/2010,0,0,0,0,0,0,0,0
Georgia,15/03/2010,2,0,0,0,0,1,0,3
Georgia,16/03/2010,13,0,0,0,2,3,0,18
Georgia,17/03/2010,3,0,0,0,15,2,0,20
Georgia,18/03/2010,5,0,-2,0,0,0,0,3
Georgia,19/03/2010,2,0,0,0,0,3,0,5
Georgia,20/03/2010,-1,0,0,0,0,0,0,-1
Georgia,21/03/2010,2,0,0,0,-2,0,0,0
Georgia,22/03/2010,1,0,0,0,0,0,0,1
Georgia,23/03/2010,4,0,1,0,9,0,0,14
Georgia,24/03/2010,-2,0,0,0,0,0,0,-2
Georgia,25/03/2010,-1,0,0,0,0,0,0,-1
Georgia,26/03/2010,14,0,1,0,15,4,0,34
Georgia,27/03/2010,3,0,0,0,0,0,0,3
Georgia,28/03/2010,0,0,0,0,3,0,0,3
Georgia,29/03/2010,0,0,0,0,0,0,0,0
Georgia,30/03/2010,7,0,1,0,6,1,0,15
Georgia,31/03/2010,0,0,0,0,0,0,0,0
India,01/03/2010,-2,0,0,0,0,0,0,-2
India,02/03/2010,8,0,0,0,-2,0,0,6
India,03/03/2010,9,0,0,0,0,0,0,9
India,04/03/2010,24,0,-1,0,12,0,0,35
India,05/03/2010,25,0,0,0,4,0,0,29
India,06/03/2010,8,0,0,0,0,0,0,8
India,07/03/2010,27,0,0,0,43,3,0,73
India,08/03/2010,11,0,-2,0,3,0,0,12
India,09/03/2010,28,2,0,0,16,11,0,57
India,10/03/2010,26,0,-1,0,10,2,0,37
India,11/03/2010,11,0,-5,0,12,7,0,25
India,12/03/2010,12,0,0,0,3,0,0,15
India,13/03/2010,14,0,0,0,9,5,0,28
India,14/03/2010,0,0,0,0,6,0,0,6
India,15/03/2010,20,0,0,0,0,1,0,21
India,16/03/2010,43,2,-3,0,12,0,0,54
India,17/03/2010,16,0,0,0,-2,1,0,15
India,18/03/2010,9,0,0,0,0,0,0,9
India,19/03/2010,7,0,-1,0,-2,0,0,4
India,20/03/2010,6,0,0,0,5,0,0,11
India,21/03/2010,25,0,0,0,31,0,0,56
India,22/03/2010,5,4,1,0,0,0,0,10
India,23/03/2010,17,0,1,0,18,2,0,38
India,24/03/2010,19,2,0,0,15,2,0,38
India,25/03/2010,22,2,0,0,12,0,0,36
India,26/03/2010,23,0,0,0,2,3,0,28
India,27/03/2010,11,0,0,0,-4,1,0,8
India,28/03/2010,1,0,0,0,3,0,0,4
India,29/03/2010,22,0,0,0,5,3,0,30
India,30/03/2010,18,0,-1,0,21,2,0,40
India,31/03/2010,13,0,0,0,6,0,0,19
Iran,01/03/2010,31,0,1,0,27,3,0,62
Iran,02/03/2010,18,0,0,0,12,3,0,33
Iran,03/03/2010,38,0,0,0,16,4,0,58
Iran,04/03/2010,17,0,5,0,10,0,0,32
Iran,05/03/2010,23,0,0,0,19,0,0,42
Iran,06/03/2010,19,0,-7,0,13,18,0,43
Iran,07/03/2010,37,0,0,0,27,14,0,78
Iran,08/03/2010,15,0,1,0,27,1,0,44
Iran,09/03/2010,45,0,0,0,44,6,0,95
Iran,10/03/2010,81,0,1,0,36,8,0,126
Iran,11/03/2010,34,0,0,0,10,2,0,46
Iran,12/03/2010,38,0,0,0,2,0,0,40
Iran,13/03/2010,33,0,0,0,14,5,0,52
Iran,14/03/2010,6,0,0,0,0,4,0,10
Iran,15/03/2010,26,0,0,0,24,0,0,50
Iran,16/03/2010,50,14,0,0,23,0,0,87
Iran,17/03/2010,21,2,0,0,6,-1,0,28
Iran,18/03/2010,7,0,0,0,-2,1,0,6
Iran,19/03/2010,27,6,0,0,7,0,0,40
Iran,20/03/2010,8,0,0,0,5,0,0,13
Iran,21/03/2010,38,0,0,0,18,7,0,63
Iran,22/03/2010,17,0,2,0,19,1,0,39
Iran,23/03/2010,54,4,2,0,-4,1,0,57
Iran,24/03/2010,21,0,1,0,15,0,0,37
Iran,25/03/2010,24,0,0,0,-2,0,0,22
Iran,26/03/2010,9,0,1,0,4,0,0,14
Iran,27/03/2010,14,0,0,0,3,0,0,17
Iran,28/03/2010,15,0,0,0,0,3,0,18
Iran,29/03/2010,24,0,-1,0,7,1,0,31
Iran,30/03/2010,39,0,1,0,-9,3,0,34
Iran,31/03/2010,28,0,1,0,12,1,0,42
Iraq,01/03/2010,18,0,0,0,0,13,0,31
Iraq,02/03/2010,23,0,2,0,12,5,0,42
Iraq,03/03/2010,3,0,0,0,15,1,0,19
Iraq,04/03/2010,49,0,0,0,10,10,0,69
Iraq,05/03/2010,20,0,3,0,16,18,0,57
Iraq,06/03/2010,61,0,2,0,1,8,0,72
Iraq,07/03/2010,60,0,1,0,15,30,0,106
Iraq,08/03/2010,1,0,0,0,12,7,0,20
Iraq,09/03/2010,57,0,0,0,2,2,0,61
Iraq,10/03/2010,20,0,0,0,5,2,0,27
Iraq,11/03/2010,76,2,0,0,5,1,0,84
Iraq,12/03/2010,10,2,2,0,3,4,0,21
Iraq,13/03/2010,14,0,0,0,17,4,0,35
Iraq,14/03/2010,1,0,0,0,0,5,0,6
Iraq,15/03/2010,58,0,0,0,12,1,0,71
Iraq,16/03/2010,38,0,0,0,14,4,0,56
Iraq,17/03/2010,30,0,0,0,4,0,0,34
Iraq,18/03/2010,17,0,-1,0,0,2,0,18
Iraq,19/03/2010,31,0,0,0,0,4,0,35
Iraq,20/03/2010,6,0,0,0,0,3,0,9
Iraq,21/03/2010,7,0,5,0,34,23,0,69
Iraq,22/03/2010,29,0,0,0,0,3,0,32
Iraq,23/03/2010,47,0,0,0,2,5,0,54
Iraq,24/03/2010,7,0,0,0,6,3,0,16
Iraq,25/03/2010,39,0,-1,0,-3,3,0,38
Iraq,26/03/2010,21,2,0,0,12,4,0,39
Iraq,27/03/2010,-5,0,-4,0,-2,0,0,-11
Iraq,28/03/2010,7,0,0,0,-7,0,0,0
Iraq,29/03/2010,6,0,0,0,3,-1,0,8
Iraq,30/03/2010,52,0,0,0,19,0,0,71
Iraq,31/03/2010,7,0,0,0,0,1,0,8
Morocco,02/03/2010,3,0,0,0,3,0,0,6
Morocco,03/03/2010,0,0,0,0,0,0,0,0
Morocco,04/03/2010,6,0,0,0,3,0,0,9
Morocco,05/03/2010,6,0,0,0,0,0,0,6
Morocco,06/03/2010,0,0,0,0,0,0,0,0
Morocco,07/03/2010,0,0,0,0,0,0,0,0
Morocco,08/03/2010,11,0,0,0,3,0,0,14
Morocco,09/03/2010,0,0,0,0,0,0,0,0
Morocco,10/03/2010,0,0,0,0,3,1,0,4
Morocco,11/03/2010,2,0,0,0,3,0,0,5
Morocco,12/03/2010,0,0,0,0,0,0,0,0
Morocco,13/03/2010,0,0,0,0,0,0,0,0
Morocco,14/03/2010,0,0,0,0,3,0,0,3
Morocco,15/03/2010,6,0,0,0,0,0,0,6
Morocco,16/03/2010,13,0,0,0,0,0,0,13
Morocco,17/03/2010,3,0,0,0,0,0,0,3
Morocco,18/03/2010,0,0,0,0,6,0,0,6
Morocco,19/03/2010,2,0,0,0,0,0,0,2
Morocco,21/03/2010,-3,0,0,0,6,0,0,3
Morocco,22/03/2010,0,0,0,0,0,0,0,0
Morocco,23/03/2010,0,0,0,0,3,0,0,3
Morocco,24/03/2010,0,0,0,0,3,0,0,3
Morocco,26/03/2010,6,0,0,0,0,2,0,8
Morocco,27/03/2010,0,0,0,0,0,0,0,0
Morocco,28/03/2010,0,0,0,0,0,0,0,0
Morocco,29/03/2010,0,0,0,0,3,0,0,3
Morocco,30/03/2010,6,0,0,0,0,0,0,6
Morocco,31/03/2010,10,0,0,0,0,1,0,11
Nigeria,01/03/2010,18,0,0,0,0,0,0,18
Nigeria,02/03/2010,8,0,0,0,0,0,0,8
Nigeria,03/03/2010,4,0,0,0,0,1,0,5
Nigeria,04/03/2010,3,0,-2,0,0,1,0,2
Nigeria,05/03/2010,5,0,0,0,15,0,0,20
Nigeria,06/03/2010,2,0,0,0,3,0,0,5
Nigeria,07/03/2010,-2,0,0,0,3,0,0,1
Nigeria,08/03/2010,36,0,0,0,12,0,0,48
Nigeria,09/03/2010,41,0,1,0,13,1,0,56
Nigeria,10/03/2010,25,0,0,0,13,0,0,38
Nigeria,11/03/2010,33,0,-6,0,6,1,0,34
Nigeria,12/03/2010,2,0,1,0,-2,1,0,2
Nigeria,13/03/2010,2,0,0,0,19,1,0,22
Nigeria,15/03/2010,3,0,0,0,6,0,0,9
Nigeria,16/03/2010,18,0,0,0,0,3,0,21
Nigeria,17/03/2010,7,0,1,0,1,0,0,9
Nigeria,18/03/2010,1,0,0,0,4,0,0,5
Nigeria,19/03/2010,2,0,0,0,-1,2,0,3
Nigeria,20/03/2010,4,0,0,0,0,0,0,4
Nigeria,21/03/2010,0,0,0,0,-4,1,0,-3
Nigeria,22/03/2010,18,0,0,0,7,0,0,25
Nigeria,23/03/2010,3,0,0,0,25,0,0,28
Nigeria,24/03/2010,0,0,0,0,6,0,0,6
Nigeria,25/03/2010,10,0,0,0,9,0,0,19
Nigeria,26/03/2010,6,0,0,0,12,0,0,18
Nigeria,27/03/2010,0,0,0,0,0,0,0,0
Nigeria,28/03/2010,1,0,0,0,0,0,0,1
Nigeria,29/03/2010,0,0,0,0,10,0,0,10
Nigeria,30/03/2010,4,0,0,0,12,0,0,16
Nigeria,31/03/2010,4,0,0,0,0,0,0,4
Pakistan,01/03/2010,10,0,1,0,15,6,0,32
Pakistan,02/03/2010,37,4,-4,0,30,3,0,70
Pakistan,03/03/2010,16,0,0,0,7,0,0,23
Pakistan,04/03/2010,48,0,0,0,16,13,0,77
Pakistan,05/03/2010,51,0,0,0,6,9,0,66
Pakistan,06/03/2010,3,0,0,0,15,1,0,19
Pakistan,07/03/2010,33,0,0,0,12,4,0,49
Pakistan,08/03/2010,14,0,-2,0,0,0,0,12
Pakistan,09/03/2010,25,0,0,0,-2,3,0,26
Pakistan,10/03/2010,59,0,-5,0,13,0,0,67
Pakistan,11/03/2010,15,0,0,0,27,4,0,46
Pakistan,12/03/2010,41,0,0,0,18,7,0,66
Pakistan,13/03/2010,33,0,0,0,8,19,0,60
Pakistan,14/03/2010,25,0,0,0,9,0,0,34
Pakistan,15/03/2010,32,0,0,0,18,3,0,53
Pakistan,16/03/2010,50,0,1,0,19,0,0,70
Pakistan,17/03/2010,24,0,0,0,37,2,0,63
Pakistan,18/03/2010,12,0,0,0,24,0,0,36
Pakistan,19/03/2010,53,0,0,0,35,4,0,92
Pakistan,20/03/2010,16,0,0,0,30,2,0,48
Pakistan,21/03/2010,50,8,0,0,14,7,0,79
Pakistan,22/03/2010,48,0,-3,0,35,7,0,87
Pakistan,23/03/2010,46,4,0,0,1,0,0,51
Pakistan,24/03/2010,34,2,0,0,15,1,0,52
Pakistan,25/03/2010,21,0,0,0,48,4,0,73
Pakistan,26/03/2010,80,0,0,0,18,17,0,115
Pakistan,27/03/2010,3,0,0,0,6,0,0,9
Pakistan,28/03/2010,12,0,0,0,9,1,0,22
Pakistan,29/03/2010,21,0,0,0,21,2,0,44
Pakistan,30/03/2010,45,0,1,0,32,13,0,91
Pakistan,31/03/2010,54,0,-1,0,14,2,0,69
Sierra Leone,02/03/2010,0,0,0,0,6,0,0,6
Sierra Leone,03/03/2010,0,0,0,0,0,0,0,0
Sierra Leone,04/03/2010,0,0,0,0,0,0,0,0
Sierra Leone,05/03/2010,2,0,0,0,0,0,0,2
Sierra Leone,07/03/2010,0,0,0,0,0,0,0,0
Sierra Leone,09/03/2010,0,0,1,0,0,0,0,1
Sierra Leone,10/03/2010,0,0,0,0,3,0,0,3
Sierra Leone,11/03/2010,0,0,0,0,9,0,0,9
Sierra Leone,12/03/2010,0,0,0,0,3,0,0,3
Sierra Leone,13/03/2010,0,0,0,0,6,0,0,6
Sierra Leone,14/03/2010,3,0,0,0,0,0,0,3
Sierra Leone,15/03/2010,0,0,0,0,0,0,0,0
Sierra Leone,16/03/2010,2,0,0,0,4,0,0,6
Sierra Leone,17/03/2010,0,0,0,0,0,0,0,0
Sierra Leone,18/03/2010,0,0,0,0,0,0,0,0
Sierra Leone,19/03/2010,2,0,0,0,0,1,0,3
Sierra Leone,20/03/2010,2,0,0,0,3,0,0,5
Sierra Leone,22/03/2010,3,0,0,0,0,0,0,3
Sierra Leone,23/03/2010,3,0,0,0,3,0,0,6
Sierra Leone,24/03/2010,0,0,0,0,0,0,0,0
Sierra Leone,25/03/2010,4,0,0,0,0,0,0,4
Sierra Leone,26/03/2010,7,0,0,0,3,0,0,10
Sierra Leone,27/03/2010,0,0,0,0,0,0,0,0
Sierra Leone,29/03/2010,9,0,0,0,0,0,0,9
Sierra Leone,30/03/2010,0,0,0,0,0,0,0,0
Sierra Leone,31/03/2010,0,0,0,0,0,1,0,1
Somalia,01/03/2010,0,0,0,0,-4,1,0,-3
Somalia,02/03/2010,7,0,0,0,15,0,0,22
Somalia,03/03/2010,0,0,0,0,20,0,0,20
Somalia,04/03/2010,20,0,0,0,10,0,0,30
Somalia,05/03/2010,19,0,0,0,-3,5,0,21
Somalia,06/03/2010,3,0,0,0,4,0,0,7
Somalia,07/03/2010,11,0,0,0,9,0,0,20
Somalia,08/03/2010,5,2,0,0,2,0,0,9
Somalia,09/03/2010,0,0,0,0,26,0,0,26
Somalia,10/03/2010,17,0,0,0,27,6,0,50
Somalia,11/03/2010,6,0,0,0,6,0,0,12
Somalia,12/03/2010,0,0,0,0,21,0,0,21
Somalia,13/03/2010,4,0,0,0,9,0,0,13
Somalia,14/03/2010,7,0,0,0,4,2,0,13
Somalia,15/03/2010,15,0,0,0,4,0,0,19
Somalia,16/03/2010,16,0,0,0,7,2,0,25
Somalia,17/03/2010,10,0,0,0,-4,0,0,6
Somalia,18/03/2010,13,0,0,0,18,0,0,31
Somalia,19/03/2010,17,0,0,0,4,0,0,21
Somalia,20/03/2010,21,0,0,0,-6,0,0,15
Somalia,22/03/2010,10,0,0,0,19,0,0,29
Somalia,23/03/2010,9,0,0,0,4,0,0,13
Somalia,24/03/2010,25,0,-2,0,37,1,0,61
Somalia,25/03/2010,40,0,0,0,20,2,0,62
Somalia,26/03/2010,37,0,0,0,12,0,0,49
Somalia,27/03/2010,9,0,0,0,3,0,0,12
Somalia,28/03/2010,9,0,0,0,3,0,0,12
Somalia,29/03/2010,22,0,0,0,6,0,0,28
Somalia,30/03/2010,101,0,0,0,32,0,0,133
Somalia,31/03/2010,16,0,0,0,12,0,0,28
Syria,01/03/2010,9,0,0,0,0,3,0,12
Syria,02/03/2010,6,0,-1,0,-4,3,0,4
Syria,03/03/2010,8,0,0,0,-4,0,0,4
Syria,04/03/2010,5,0,0,0,0,0,0,5
Syria,05/03/2010,11,0,0,0,0,3,0,14
Syria,06/03/2010,8,0,0,0,0,3,0,11
Syria,07/03/2010,7,0,0,0,9,3,0,19
Syria,08/03/2010,2,2,0,0,-1,2,0,5
Syria,09/03/2010,13,0,0,0,0,1,0,14
Syria,10/03/2010,14,0,0,0,0,2,0,16
Syria,11/03/2010,9,0,0,0,0,0,0,9
Syria,12/03/2010,0,0,0,0,0,0,0,0
Syria,13/03/2010,0,0,0,0,0,0,0,0
Syria,14/03/2010,2,0,0,0,0,0,0,2
Syria,15/03/2010,9,0,0,0,0,0,0,9
Syria,16/03/2010,0,0,0,0,0,0,0,0
Syria,17/03/2010,12,0,0,0,0,0,0,12
Syria,18/03/2010,1,0,0,0,0,0,0,1
Syria,19/03/2010,3,0,0,0,0,0,0,3
Syria,20/03/2010,0,0,0,0,0,0,0,0
Syria,21/03/2010,2,0,0,0,0,0,0,2
Syria,22/03/2010,20,0,0,0,6,0,0,26
Syria,23/03/2010,0,0,0,0,3,0,0,3
Syria,24/03/2010,4,0,0,0,5,0,0,9
Syria,25/03/2010,4,0,0,0,3,2,0,9
Syria,26/03/2010,14,0,-1,0,0,0,0,13
Syria,27/03/2010,12,0,-4,0,0,0,0,8
Syria,28/03/2010,-1,0,0,0,0,0,0,-1
Syria,29/03/2010,25,0,0,0,4,4,0,33
Syria,30/03/2010,6,0,0,0,0,3,0,9
Syria,31/03/2010,0,0,0,0,0,0,0,0
Yemen,02/03/2010,0,0,0,0,0,0,0,0
Yemen,03/03/2010,-3,0,1,0,0,0,0,-2
Yemen,04/03/2010,0,0,0,0,3,0,0,3
Yemen,05/03/2010,2,0,0,0,0,0,0,2
Yemen,06/03/2010,0,0,0,0,0,0,0,0
Yemen,07/03/2010,11,0,0,0,0,6,0,17
Yemen,08/03/2010,0,0,0,0,0,0,0,0
Yemen,09/03/2010,0,0,0,0,3,0,0,3
Yemen,10/03/2010,6,0,0,0,0,0,0,6
Yemen,11/03/2010,15,0,0,0,6,4,0,25
Yemen,12/03/2010,9,0,1,0,39,0,0,49
Yemen,13/03/2010,24,0,0,0,9,0,0,33
Yemen,14/03/2010,22,0,0,0,12,1,0,35
Yemen,15/03/2010,1,0,0,0,3,0,0,4
Yemen,16/03/2010,29,0,0,0,9,0,0,38
Yemen,17/03/2010,4,0,-1,0,0,2,0,5
Yemen,18/03/2010,61,0,0,0,-8,21,0,74
Yemen,19/03/2010,29,0,0,0,24,1,0,54
Yemen,20/03/2010,7,0,0,0,0,0,0,7
Yemen,21/03/2010,0,0,0,0,3,2,0,5
Yemen,22/03/2010,5,0,0,0,14,1,0,20
Yemen,23/03/2010,18,0,0,0,11,5,0,34
Yemen,24/03/2010,18,0,0,0,11,0,0,29
Yemen,25/03/2010,30,0,0,0,48,0,0,78
Yemen,26/03/2010,0,2,0,0,6,0,0,8
Yemen,27/03/2010,1,0,0,0,0,0,0,1
Yemen,28/03/2010,8,0,0,0,0,0,0,8
Yemen,29/03/2010,1,0,0,0,0,1,0,2
Yemen,30/03/2010,11,0,0,0,20,9,0,40
Yemen,31/03/2010,11,0,0,0,0,0,0,11
Afghanistan,01/01/2012,90,0,0,0,-9,12,0,93
Afghanistan,02/01/2012,141,4,-4,0,41,5,0,187
Afghanistan,03/01/2012,190,0,0,0,42,71,0,303
Afghanistan,04/01/2012,96,0,0,0,32,9,0,137
Afghanistan,05/01/2012,240,0,1,0,136,37,0,414
Afghanistan,06/01/2012,185,4,1,0,-3,17,0,204
Afghanistan,07/01/2012,150,0,0,0,3,11,0,164
Afghanistan,08/01/2012,109,4,0,0,3,7,0,123
Afghanistan,09/01/2012,226,12,-6,0,55,11,0,298
Afghanistan,10/01/2012,250,2,0,0,74,19,0,345
Afghanistan,11/01/2012,321,0,1,0,66,19,0,407
Afghanistan,12/01/2012,223,0,8,0,79,38,0,348
Afghanistan,13/01/2012,280,0,5,0,61,19,0,365
Afghanistan,14/01/2012,79,0,0,0,5,15,0,99
Afghanistan,15/01/2012,52,0,1,0,42,8,0,103
Afghanistan,16/01/2012,135,0,0,0,37,20,0,192
Afghanistan,17/01/2012,120,0,1,0,37,6,0,164
Afghanistan,18/01/2012,175,0,0,0,26,21,0,222
Afghanistan,19/01/2012,196,2,3,0,-4,38,0,235
Afghanistan,20/01/2012,265,0,0,0,74,23,0,362
Afghanistan,21/01/2012,175,0,0,0,24,7,0,206
Afghanistan,22/01/2012,37,0,1,0,15,2,0,55
Afghanistan,23/01/2012,82,0,1,0,9,0,0,92
Afghanistan,24/01/2012,162,0,-8,0,11,6,0,171
Afghanistan,25/01/2012,459,10,2,0,102,38,0,611
Afghanistan,26/01/2012,296,0,-2,0,47,41,0,382
Afghanistan,27/01/2012,284,0,-1,0,33,7,0,323
Afghanistan,28/01/2012,40,4,0,0,24,14,0,82
Afghanistan,29/01/2012,140,4,0,0,67,15,0,226
Afghanistan,30/01/2012,219,10,2,0,40,20,0,291
Afghanistan,31/01/2012,213,0,-1,0,68,28,0,308
Albania,01/01/2012,2,0,0,0,0,0,0,2
Albania,02/01/2012,25,0,-1,0,0,0,0,24
Albania,03/01/2012,13,0,0,0,0,0,0,13
Albania,04/01/2012,0,0,0,0,-2,0,0,-2
Albania,05/01/2012,5,0,-1,0,15,2,0,21
Albania,06/01/2012,15,0,-5,0,18,5,0,33
Albania,07/01/2012,2,0,0,0,0,10,0,12
Albania,08/01/2012,0,0,0,0,0,0,0,0
Albania,09/01/2012,25,0,0,0,0,2,0,27
Albania,10/01/2012,2,0,0,0,6,3,0,11
Albania,11/01/2012,9,0,0,0,30,14,0,53
Albania,12/01/2012,5,0,0,0,3,3,0,11
Albania,13/01/2012,6,0,0,0,0,2,0,8
Albania,14/01/2012,9,0,-2,0,0,7,0,14
Albania,15/01/2012,9,0,-2,0,0,0,0,7
Albania,16/01/2012,4,0,1,0,6,2,0,13
Albania,17/01/2012,10,0,0,0,35,3,0,48
Albania,18/01/2012,0,0,0,0,6,0,0,6
Albania,19/01/2012,2,0,0,0,0,0,0,2
Albania,20/01/2012,2,0,-2,0,-4,0,0,-4
Albania,21/01/2012,4,0,-2,0,-8,0,0,-6
Albania,22/01/2012,0,0,0,0,0,0,0,0
Albania,23/01/2012,6,0,0,0,0,0,0,6
Albania,24/01/2012,13,0,0,0,9,0,0,22
Albania,25/01/2012,53,0,0,0,19,4,0,76
Albania,26/01/2012,4,0,-1,0,0,0,0,3
Albania,27/01/2012,12,0,-2,0,3,0,0,13
Albania,28/01/2012,0,0,0,0,0,0,0,0
Albania,29/01/2012,0,0,0,0,3,0,0,3
Albania,30/01/2012,4,0,0,0,0,1,0,5
Albania,31/01/2012,5,0,0,0,-1,5,0,9
Algeria,01/01/2012,7,0,0,0,0,0,0,7
Algeria,02/01/2012,5,0,0,0,15,0,0,20
Algeria,03/01/2012,15,0,0,0,12,0,0,27
Algeria,04/01/2012,0,0,2,0,0,2,0,4
Algeria,05/01/2012,13,0,0,0,-2,1,0,12
Algeria,06/01/2012,7,0,0,0,18,2,0,27
Algeria,07/01/2012,21,0,0,0,4,0,0,25
Algeria,08/01/2012,15,0,-1,0,0,0,0,14
Algeria,09/01/2012,8,0,0,0,0,0,0,8
Algeria,10/01/2012,14,0,2,0,0,2,0,18
Algeria,11/01/2012,41,0,0,0,13,30,0,84
Algeria,12/01/2012,78,0,1,0,-16,20,0,83
Algeria,13/01/2012,24,0,0,0,-11,0,0,13
Algeria,14/01/2012,35,0,0,0,-3,0,0,32
Algeria,15/01/2012,2,0,0,0,0,0,0,2
Algeria,16/01/2012,0,0,0,0,0,0,0,0
Algeria,17/01/2012,34,0,0,0,33,0,0,67
Algeria,18/01/2012,29,0,0,0,6,0,0,35
Algeria,19/01/2012,66,0,0,0,9,2,0,77
Algeria,20/01/2012,56,0,0,0,5,3,0,64
Algeria,21/01/2012,0,0,0,0,7,1,0,8
Algeria,22/01/2012,4,0,0,0,3,0,0,7
Algeria,23/01/2012,12,0,0,0,0,0,0,12
Algeria,24/01/2012,14,0,-2,0,9,1,0,22
Algeria,25/01/2012,16,0,-2,0,6,3,0,23
Algeria,26/01/2012,4,0,0,0,-2,2,0,4
Algeria,27/01/2012,6,0,0,0,3,0,0,9
Algeria,28/01/2012,6,0,0,0,-2,1,0,5
Algeria,29/01/2012,4,0,0,0,3,0,0,7
Algeria,30/01/2012,5,0,0,0,0,1,0,6
Algeria,31/01/2012,22,0,0,0,0,2,0,24
Bangladesh,01/01/2012,6,0,2,0,-2,4,0,10
Bangladesh,02/01/2012,26,2,0,0,18,5,0,51
Bangladesh,03/01/2012,29,0,-1,0,19,3,0,50
Bangladesh,04/01/2012,19,0,0,0,15,2,0,36
Bangladesh,05/01/2012,7,0,0,0,17,2,0,26
Bangladesh,06/01/2012,29,0,0,0,23,0,0,52
Bangladesh,07/01/2012,20,0,0,0,9,0,0,29
Bangladesh,08/01/2012,20,0,0,0,4,0,0,24
Bangladesh,09/01/2012,13,0,0,0,8,4,0,25
Bangladesh,10/01/2012,15,0,-1,0,-2,1,0,13
Bangladesh,11/01/2012,14,0,3,0,4,3,0,24
Bangladesh,12/01/2012,6,0,1,0,4,9,0,20
Bangladesh,13/01/2012,15,0,0,0,-2,2,0,15
Bangladesh,14/01/2012,15,0,0,0,3,12,0,30
Bangladesh,15/01/2012,13,0,0,0,4,0,0,17
Bangladesh,16/01/2012,11,2,-1,0,0,7,0,19
Bangladesh,17/01/2012,22,0,0,0,5,0,0,27
Bangladesh,18/01/2012,15,0,-1,0,27,2,0,43
Bangladesh,19/01/2012,24,0,0,0,47,2,0,73
Bangladesh,20/01/2012,11,0,1,0,18,0,0,30
Bangladesh,21/01/2012,16,0,0,0,0,0,0,16
Bangladesh,22/01/2012,2,0,0,0,3,1,0,6
Bangladesh,23/01/2012,0,0,0,0,12,0,0,12
Bangladesh,24/01/2012,20,0,2,0,9,2,0,33
Bangladesh,25/01/2012,39,0,2,0,30,1,0,72
Bangladesh,26/01/2012,20,0,1,0,6,0,0,27
Bangladesh,27/01/2012,12,0,0,0,0,2,0,14
Bangladesh,28/01/2012,11,0,0,0,21,0,0,32
Bangladesh,29/01/2012,12,0,0,0,6,0,0,18
Bangladesh,30/01/2012,9,0,0,0,21,0,0,30
Bangladesh,31/01/2012,12,0,0,0,21,1,0,34
Cameroon,01/01/2012,7,0,0,0,0,0,0,7
Cameroon,02/01/2012,2,0,0,0,0,0,0,2
Cameroon,03/01/2012,12,0,0,0,0,0,0,12
Cameroon,04/01/2012,0,0,0,0,0,0,0,0
Cameroon,05/01/2012,3,0,0,0,6,1,0,10
Cameroon,06/01/2012,24,0,0,0,3,3,0,30
Cameroon,07/01/2012,2,0,0,0,3,0,0,5
Cameroon,08/01/2012,5,0,0,0,0,0,0,5
Cameroon,09/01/2012,5,0,0,0,6,1,0,12
Cameroon,10/01/2012,3,0,0,0,0,0,0,3
Cameroon,11/01/2012,4,0,0,0,0,0,0,4
Cameroon,12/01/2012,1,0,0,0,0,0,0,1
Cameroon,13/01/2012,0,0,0,0,0,1,0,1
Cameroon,14/01/2012,0,0,0,0,0,0,0,0
Cameroon,16/01/2012,0,0,0,0,0,0,0,0
Cameroon,17/01/2012,0,0,0,0,-4,0,0,-4
Cameroon,18/01/2012,1,0,0,0,3,0,0,4
Cameroon,19/01/2012,6,0,0,0,9,0,0,15
Cameroon,20/01/2012,3,0,0,0,-2,0,0,1
Cameroon,21/01/2012,0,0,0,0,0,0,0,0
Cameroon,23/01/2012,0,0,0,0,0,0,0,0
Cameroon,24/01/2012,-2,0,0,0,0,0,0,-2
Cameroon,25/01/2012,0,0,0,0,4,0,0,4
Cameroon,26/01/2012,-1,0,0,0,0,1,0,0
Cameroon,27/01/2012,3,0,0,0,2,0,0,5
Cameroon,28/01/2012,2,0,0,0,0,0,0,2
Cameroon,29/01/2012,5,0,0,0,0,0,0,5
Cameroon,30/01/2012,18,0,0,0,0,0,0,18
Cameroon,31/01/2012,4,0,0,0,0,0,0,4
China,01/01/2012,64,0,0,0,8,6,0,78
China,02/01/2012,84,0,-4,0,49,4,0,133
China,03/01/2012,113,0,1,0,69,14,0,197
China,04/01/2012,159,0,-2,0,51,25,0,233
China,05/01/2012,149,2,-1,0,40,24,0,214
China,06/01/2012,202,4,-2,0,61,30,0,295
China,07/01/2012,76,0,2,0,61,9,0,148
China,08/01/2012,149,0,-7,0,42,9,0,193
China,09/01/2012,115,2,-6,0,69,17,0,197
China,10/01/2012,109,2,7,0,44,15,0,177
China,11/01/2012,192,0,3,0,-22,23,0,196
China,12/01/2012,164,0,6,0,60,19,0,249
China,13/01/2012,153,0,-1,0,99,18,0,269
China,14/01/2012,63,2,0,0,30,9,0,104
China,15/01/2012,99,6,9,0,42,12,0,168
China,16/01/2012,86,2,-1,0,60,17,0,164
China,17/01/2012,170,0,-8,0,110,39,0,311
China,18/01/2012,246,0,-7,0,57,25,0,321
China,19/01/2012,131,0,0,0,76,25,0,232
China,20/01/2012,139,0,-2,0,74,12,0,223
China,21/01/2012,70,0,3,0,30,10,0,113
China,22/01/2012,21,0,0,0,6,1,0,28
China,23/01/2012,39,0,1,0,19,1,0,60
China,24/01/2012,161,0,-12,0,30,10,0,189
China,25/01/2012,489,4,-9,0,135,59,0,678
China,26/01/2012,162,6,-4,0,75,17,0,256
China,27/01/2012,228,2,-1,0,50,31,0,310
China,28/01/2012,97,2,1,0,39,12,0,151
China,29/01/2012,158,0,0,0,88,8,0,254
China,30/01/2012,261,0,4,0,165,20,0,450
China,31/01/2012,160,2,-5,0,111,37,0,305
Egypt,01/01/2012,98,0,-6,0,20,27,0,139
Egypt,02/01/2012,41,0,0,0,40,28,0,109
Egypt,03/01/2012,92,0,-1,0,52,32,0,175
Egypt,04/01/2012,51,0,1,0,8,14,0,74
Egypt,05/01/2012,106,0,-5,0,80,31,0,212
Egypt,06/01/2012,55,0,-2,0,67,16,0,136
Egypt,07/01/2012,49,0,0,0,34,5,0,88
Egypt,08/01/2012,101,0,1,0,22,8,0,132
Egypt,09/01/2012,449,10,4,0,274,64,0,801
Egypt,10/01/2012,405,4,-4,0,196,91,0,692
Egypt,11/01/2012,159,4,-24,0,87,44,0,270
Egypt,12/01/2012,69,0,-2,0,20,18,0,105
Egypt,13/01/2012,37,0,-5,0,4,15,0,51
Egypt,14/01/2012,39,0,-5,0,10,12,0,56
Egypt,15/01/2012,50,0,-4,0,-9,11,0,48
Egypt,16/01/2012,87,0,-4,0,11,15,0,109
Egypt,17/01/2012,94,0,0,0,17,19,0,130
Egypt,18/01/2012,46,2,1,0,53,11,0,113
Egypt,19/01/2012,57,2,0,0,17,11,0,87
Egypt,20/01/2012,21,0,-4,0,-7,11,0,21
Egypt,21/01/2012,36,0,-10,0,16,15,0,57
Egypt,22/01/2012,4,0,-4,0,2,1,0,3
Egypt,23/01/2012,16,0,-8,0,13,17,0,38
Egypt,24/01/2012,46,0,-18,0,16,23,0,67
Egypt,25/01/2012,163,8,-42,0,62,76,0,267
Egypt,26/01/2012,69,0,-2,0,93,10,0,170
Egypt,27/01/2012,51,0,2,0,49,13,0,115
Egypt,28/01/2012,37,0,-17,0,28,18,0,66
Egypt,29/01/2012,51,0,-4,0,25,14,0,86
Egypt,30/01/2012,67,0,-7,0,51,17,0,128
Egypt,31/01/2012,64,0,-3,0,60,16,0,137
Eritrea,02/01/2012,0,0,0,0,0,0,0,0
Eritrea,03/01/2012,0,0,0,0,0,0,0,0
Eritrea,04/01/2012,3,0,0,0,6,0,0,9
Eritrea,05/01/2012,4,0,0,0,0,0,0,4
Eritrea,06/01/2012,0,0,0,0,-2,0,0,-2
Eritrea,07/01/2012,0,0,0,0,0,0,0,0
Eritrea,08/01/2012,0,0,0,0,0,0,0,0
Eritrea,09/01/2012,0,0,0,0,0,0,0,0
Eritrea,10/01/2012,4,6,0,0,10,0,0,20
Eritrea,11/01/2012,0,0,0,0,-7,1,0,-6
Eritrea,12/01/2012,9,0,0,0,0,0,0,9
Eritrea,13/01/2012,12,0,0,0,0,0,0,12
Eritrea,14/01/2012,0,0,0,0,0,0,0,0
Eritrea,16/01/2012,12,0,0,0,30,0,0,42
Eritrea,17/01/2012,82,0,0,0,21,0,0,103
Eritrea,18/01/2012,137,0,0,0,9,0,0,146
Eritrea,19/01/2012,45,0,0,0,4,0,0,49
Eritrea,20/01/2012,9,0,0,0,6,5,0,20
Eritrea,22/01/2012,3,0,0,0,0,0,0,3
Eritrea,23/01/2012,3,0,0,0,0,0,0,3
Eritrea,24/01/2012,11,0,0,0,0,0,0,11
Eritrea,25/01/2012,42,0,0,0,-3,0,0,39
Eritrea,26/01/2012,0,0,0,0,15,0,0,15
Eritrea,27/01/2012,8,0,0,0,0,2,0,10
Eritrea,28/01/2012,11,0,0,0,-2,0,0,9
Eritrea,29/01/2012,0,0,0,0,0,0,0,0
Eritrea,30/01/2012,0,2,0,0,3,0,0,5
Eritrea,31/01/2012,0,0,0,0,8,1,0,9
Georgia,01/01/2012,7,0,0,0,0,1,0,8
Georgia,02/01/2012,17,2,0,0,-2,2,0,19
Georgia,03/01/2012,22,0,0,0,6,1,0,29
Georgia,04/01/2012,23,0,0,0,5,1,0,29
Georgia,05/01/2012,28,0,0,0,21,2,0,51
Georgia,06/01/2012,44,2,0,0,8,9,0,63
Georgia,07/01/2012,71,0,0,0,12,10,0,93
Georgia,08/01/2012,13,0,-1,0,-2,4,0,14
Georgia,09/01/2012,19,4,0,0,-13,0,0,10
Georgia,10/01/2012,18,0,3,0,12,3,0,36
Georgia,11/01/2012,15,0,0,0,18,4,0,37
Georgia,12/01/2012,16,0,0,0,4,1,0,21
Georgia,13/01/2012,19,0,0,0,13,2,0,34
Georgia,14/01/2012,2,0,0,0,3,0,0,5
Georgia,15/01/2012,28,0,0,0,-2,2,0,28
Georgia,16/01/2012,25,0,2,0,-4,1,0,24
Georgia,17/01/2012,62,4,0,0,27,12,0,105
Georgia,18/01/2012,31,0,0,0,21,0,0,52
Georgia,19/01/2012,27,6,0,0,6,1,0,40
Georgia,20/01/2012,44,4,-2,0,44,6,0,96
Georgia,21/01/2012,6,0,0,0,9,0,0,15
Georgia,22/01/2012,0,0,0,0,3,0,0,3
Georgia,23/01/2012,4,0,0,0,6,2,0,12
Georgia,24/01/2012,6,0,0,0,12,4,0,22
Georgia,25/01/2012,104,4,-2,0,46,9,0,161
Georgia,26/01/2012,52,0,-5,0,44,3,0,94
Georgia,27/01/2012,22,0,-1,0,12,4,0,37
Georgia,28/01/2012,9,2,0,0,3,1,0,15
Georgia,29/01/2012,25,0,0,0,16,3,0,44
Georgia,30/01/2012,52,0,0,0,19,13,0,84
Georgia,31/01/2012,52,2,1,0,15,6,0,76
India,01/01/2012,30,2,-1,0,26,6,0,63
India,02/01/2012,46,0,0,0,18,5,0,69
India,03/01/2012,37,4,-1,0,-2,7,0,45
India,04/01/2012,47,2,1,0,42,10,0,102
India,05/01/2012,57,0,1,0,17,4,0,79
India,06/01/2012,38,0,2,0,8,11,0,59
India,07/01/2012,57,2,0,0,25,1,0,85
India,08/01/2012,36,0,0,0,20,13,0,69
India,09/01/2012,60,0,-4,0,0,13,0,69
India,10/01/2012,65,0,-3,0,13,11,0,86
India,11/01/2012,33,0,-2,0,15,12,0,58
India,12/01/2012,28,2,7,0,1,10,0,48
India,13/01/2012,44,0,3,0,25,5,0,77
India,14/01/2012,20,2,0,0,24,13,0,59
India,15/01/2012,54,0,1,0,11,4,0,70
India,16/01/2012,13,0,0,0,-3,1,0,11
India,17/01/2012,71,0,-6,0,12,10,0,87
India,18/01/2012,95,0,-6,0,4,5,0,98
India,19/01/2012,47,2,1,0,15,6,0,71
India,20/01/2012,44,2,1,0,21,3,0,71
India,21/01/2012,34,0,-3,0,12,4,0,47
India,22/01/2012,25,0,0,0,6,1,0,32
India,23/01/2012,5,0,-1,0,4,1,0,9
India,24/01/2012,78,4,0,0,30,18,0,130
India,25/01/2012,242,10,3,0,122,35,0,412
India,26/01/2012,108,0,-1,0,53,10,0,170
India,27/01/2012,68,4,0,0,7,7,0,86
India,28/01/2012,40,0,0,0,26,2,0,68
India,29/01/2012,99,2,0,0,50,1,0,152
India,30/01/2012,109,0,1,0,24,7,0,141
India,31/01/2012,95,0,-1,0,35,18,0,147
Iran,01/01/2012,128,0,0,0,18,2,0,148
Iran,02/01/2012,164,4,5,0,65,18,0,256
Iran,03/01/2012,164,4,-1,0,86,5,0,258
Iran,04/01/2012,120,0,1,0,110,10,0,241
Iran,05/01/2012,189,0,0,0,46,14,0,249
Iran,06/01/2012,290,0,7,0,161,74,0,532
Iran,07/01/2012,156,4,0,0,87,19,0,266
Iran,08/01/2012,57,0,0,0,33,14,0,104
Iran,09/01/2012,209,0,2,0,161,15,0,387
Iran,10/01/2012,242,8,-1,0,161,12,0,422
Iran,11/01/2012,177,0,8,0,35,14,0,234
Iran,12/01/2012,228,0,-1,0,70,12,0,309
Iran,13/01/2012,182,0,-2,0,105,28,0,313
Iran,14/01/2012,111,0,1,0,3,19,0,134
Iran,15/01/2012,97,6,-15,0,11,25,0,124
Iran,16/01/2012,727,22,1,0,247,118,0,1115
Iran,17/01/2012,447,4,-6,0,160,91,0,696
Iran,18/01/2012,397,2,-1,0,129,49,0,576
Iran,19/01/2012,342,12,0,0,208,42,0,604
Iran,20/01/2012,120,0,-1,0,89,21,0,229
Iran,21/01/2012,52,0,-2,0,10,14,0,74
Iran,22/01/2012,22,0,0,0,-2,2,0,22
Iran,23/01/2012,54,0,0,0,16,2,0,72
Iran,24/01/2012,100,0,1,0,37,18,0,156
Iran,25/01/2012,434,8,7,0,263,37,0,749
Iran,26/01/2012,194,0,5,0,60,16,0,275
Iran,27/01/2012,187,0,3,0,34,23,0,247
Iran,28/01/2012,114,0,2,0,67,15,0,198
Iran,29/01/2012,124,2,-3,0,89,9,0,221
Iran,30/01/2012,174,0,2,0,59,36,0,271
Iran,31/01/2012,176,0,-8,0,39,17,0,224
Iraq,01/01/2012,66,0,0,0,11,19,0,96
Iraq,02/01/2012,182,0,-4,0,50,17,0,245
Iraq,03/01/2012,160,0,2,0,5,7,0,174
Iraq,04/01/2012,151,0,9,0,18,7,0,185
Iraq,05/01/2012,223,0,1,0,45,16,0,285
Iraq,06/01/2012,146,0,1,0,14,15,0,176
Iraq,07/01/2012,105,0,0,0,12,13,0,130
Iraq,08/01/2012,78,4,0,0,-4,11,0,89
Iraq,09/01/2012,86,0,-10,0,46,9,0,131
Iraq,10/01/2012,79,0,0,0,38,9,0,126
Iraq,11/01/2012,132,2,0,0,5,9,0,148
Iraq,12/01/2012,110,0,-1,0,35,11,0,155
Iraq,13/01/2012,134,0,1,0,76,19,0,230
Iraq,14/01/2012,82,2,0,0,11,39,0,134
Iraq,15/01/2012,131,0,-2,0,68,19,0,216
Iraq,16/01/2012,117,0,2,0,30,56,0,205
Iraq,17/01/2012,172,2,-1,0,100,7,0,280
Iraq,18/01/2012,115,2,-2,0,40,14,0,169
Iraq,19/01/2012,72,0,1,0,3,12,0,88
Iraq,20/01/2012,49,0,2,0,18,12,0,81
Iraq,21/01/2012,85,0,2,0,38,5,0,130
Iraq,22/01/2012,4,0,0,0,3,0,0,7
Iraq,23/01/2012,10,0,0,0,0,1,0,11
Iraq,24/01/2012,72,0,0,0,31,9,0,112
Iraq,25/01/2012,290,2,1,0,191,44,0,528
Iraq,26/01/2012,100,0,-1,0,59,28,0,186
Iraq,27/01/2012,110,0,1,0,26,9,0,146
Iraq,28/01/2012,99,2,0,0,39,17,0,157
Iraq,29/01/2012,133,0,0,0,41,16,0,190
Iraq,30/01/2012,90,2,1,0,95,28,0,216
Iraq,31/01/2012,106,0,-1,0,49,12,0,166
Morocco,01/01/2012,9,0,0,0,0,0,0,9
Morocco,02/01/2012,11,0,0,0,0,0,0,11
Morocco,03/01/2012,10,0,0,0,1,0,0,11
Morocco,04/01/2012,7,0,0,0,3,0,0,10
Morocco,05/01/2012,4,0,0,0,1,2,0,7
Morocco,06/01/2012,5,0,0,0,-3,2,0,4
Morocco,07/01/2012,4,0,0,0,-5,0,0,-1
Morocco,08/01/2012,0,0,0,0,1,0,0,1
Morocco,09/01/2012,2,0,0,0,0,0,0,2
Morocco,10/01/2012,-1,0,0,0,0,0,0,-1
Morocco,11/01/2012,4,0,0,0,3,0,0,7
Morocco,12/01/2012,14,0,0,0,8,1,0,23
Morocco,13/01/2012,0,0,0,0,18,2,0,20
Morocco,14/01/2012,0,0,0,0,-2,1,0,-1
Morocco,15/01/2012,3,0,0,0,0,1,0,4
Morocco,16/01/2012,1,0,0,0,9,0,0,10
Morocco,17/01/2012,6,0,0,0,24,0,0,30
Morocco,18/01/2012,21,0,0,0,6,2,0,29
Morocco,19/01/2012,1,0,0,0,0,7,0,8
Morocco,20/01/2012,0,0,0,0,3,0,0,3
Morocco,21/01/2012,0,0,0,0,3,12,0,15
Morocco,22/01/2012,0,2,0,0,0,0,0,2
Morocco,23/01/2012,0,0,0,0,0,0,0,0
Morocco,24/01/2012,2,0,0,0,0,0,0,2
Morocco,25/01/2012,2,0,-2,0,-1,0,0,-1
Morocco,26/01/2012,2,0,0,0,-2,1,0,1
Morocco,27/01/2012,10,0,-2,0,4,3,0,15
Morocco,28/01/2012,9,0,-2,0,3,0,0,10
Morocco,29/01/2012,0,0,0,0,0,0,0,0
Morocco,30/01/2012,16,0,0,0,3,4,0,23
Morocco,31/01/2012,10,0,-4,0,9,4,0,19
Nigeria,01/01/2012,24,0,0,0,25,1,0,50
Nigeria,02/01/2012,21,0,0,0,15,6,0,42
Nigeria,03/01/2012,32,0,0,0,12,2,0,46
Nigeria,04/01/2012,21,0,0,0,12,3,0,36
Nigeria,05/01/2012,52,0,0,0,13,8,0,73
Nigeria,06/01/2012,51,0,0,0,0,9,0,60
Nigeria,07/01/2012,44,0,0,0,9,6,0,59
Nigeria,08/01/2012,18,0,0,0,13,5,0,36
Nigeria,09/01/2012,36,0,0,0,22,16,0,74
Nigeria,10/01/2012,56,0,1,0,16,5,0,78
Nigeria,11/01/2012,57,0,1,0,13,11,0,82
Nigeria,12/01/2012,45,0,1,0,6,14,0,66
Nigeria,13/01/2012,32,2,4,0,6,6,0,50
Nigeria,14/01/2012,29,0,-9,0,3,0,0,23
Nigeria,15/01/2012,44,0,-2,0,7,13,0,62
Nigeria,16/01/2012,50,2,-2,0,11,5,0,66
Nigeria,17/01/2012,55,0,-2,0,23,12,0,88
Nigeria,18/01/2012,33,0,3,0,12,2,0,50
Nigeria,19/01/2012,24,0,3,0,5,9,0,41
Nigeria,20/01/2012,23,0,-1,0,27,3,0,52
Nigeria,21/01/2012,12,0,0,0,0,7,0,19
Nigeria,22/01/2012,3,0,0,0,0,0,0,3
Nigeria,23/01/2012,7,0,0,0,0,0,0,7
Nigeria,24/01/2012,21,0,-2,0,5,5,0,29
Nigeria,25/01/2012,76,0,0,0,42,9,0,127
Nigeria,26/01/2012,54,2,3,0,24,6,0,89
Nigeria,27/01/2012,66,0,-1,0,6,3,0,74
Nigeria,28/01/2012,-4,0,0,0,4,0,0,0
Nigeria,29/01/2012,14,0,0,0,6,0,0,20
Nigeria,30/01/2012,36,0,0,0,32,7,0,75
Nigeria,31/01/2012,38,2,0,0,28,3,0,71
Pakistan,01/01/2012,71,0,0,0,19,19,0,109
Pakistan,02/01/2012,60,2,-2,0,27,19,0,106
Pakistan,03/01/2012,170,0,0,0,20,7,0,197
Pakistan,04/01/2012,93,0,1,0,65,4,0,163
Pakistan,05/01/2012,105,4,-2,0,106,14,0,227
Pakistan,06/01/2012,60,0,2,0,68,6,0,136
Pakistan,07/01/2012,81,8,-1,0,25,12,0,125
Pakistan,08/01/2012,39,0,-12,0,1,-2,0,26
Pakistan,09/01/2012,131,4,-6,0,31,16,0,176
Pakistan,10/01/2012,140,0,-4,0,47,15,0,198
Pakistan,11/01/2012,129,2,4,0,47,21,0,203
Pakistan,12/01/2012,153,6,-7,0,26,6,0,184
Pakistan,13/01/2012,60,14,3,0,53,5,0,135
Pakistan,14/01/2012,49,0,0,0,3,6,0,58
Pakistan,15/01/2012,74,0,0,0,31,8,0,113
Pakistan,16/01/2012,162,2,-23,0,38,18,0,197
Pakistan,17/01/2012,126,0,-17,0,63,6,0,178
Pakistan,18/01/2012,100,0,1,0,78,2,0,181
Pakistan,19/01/2012,84,2,-8,0,79,9,0,166
Pakistan,20/01/2012,63,2,0,0,41,2,0,108
Pakistan,21/01/2012,55,0,0,0,18,2,0,75
Pakistan,22/01/2012,27,0,0,0,19,3,0,49
Pakistan,23/01/2012,54,2,-8,0,57,2,0,107
Pakistan,24/01/2012,312,4,-10,0,168,25,0,499
Pakistan,25/01/2012,558,6,-18,0,178,42,0,766
Pakistan,26/01/2012,107,0,-5,0,8,21,0,131
Pakistan,27/01/2012,164,4,-2,0,60,16,0,242
Pakistan,28/01/2012,90,0,1,0,74,11,0,176
Pakistan,29/01/2012,84,0,2,0,30,21,0,137
Pakistan,30/01/2012,74,0,-3,0,206,5,0,282
Pakistan,31/01/2012,120,0,-1,0,27,7,0,153
Sierra Leone,04/01/2012,3,0,2,0,-4,0,0,1
Sierra Leone,05/01/2012,1,0,-2,0,-4,0,0,-5
Sierra Leone,06/01/2012,9,0,0,0,15,6,0,30
Sierra Leone,07/01/2012,0,0,0,0,0,0,0,0
Sierra Leone,08/01/2012,0,0,0,0,0,0,0,0
Sierra Leone,09/01/2012,-1,0,0,0,0,2,0,1
Sierra Leone,10/01/2012,2,0,-2,0,9,0,0,9
Sierra Leone,11/01/2012,0,0,0,0,0,0,0,0
Sierra Leone,12/01/2012,0,0,0,0,0,0,0,0
Sierra Leone,13/01/2012,1,0,0,0,1,0,0,2
Sierra Leone,14/01/2012,2,0,0,0,3,0,0,5
Sierra Leone,15/01/2012,2,0,0,0,0,0,0,2
Sierra Leone,16/01/2012,-1,0,0,0,0,0,0,-1
Sierra Leone,17/01/2012,0,0,0,0,3,3,0,6
Sierra Leone,18/01/2012,2,0,0,0,-2,9,0,9
Sierra Leone,19/01/2012,0,0,0,0,6,1,0,7
Sierra Leone,20/01/2012,12,0,0,0,3,1,0,16
Sierra Leone,21/01/2012,0,0,0,0,0,0,0,0
Sierra Leone,23/01/2012,0,0,0,0,0,0,0,0
Sierra Leone,24/01/2012,3,0,0,0,-2,0,0,1
Sierra Leone,25/01/2012,1,0,0,0,3,1,0,5
Sierra Leone,26/01/2012,4,0,0,0,0,1,0,5
Sierra Leone,27/01/2012,0,0,0,0,6,0,0,6
Sierra Leone,28/01/2012,4,0,0,0,-2,0,0,2
Sierra Leone,29/01/2012,0,0,0,0,0,4,0,4
Sierra Leone,30/01/2012,0,0,0,0,3,0,0,3
Sierra Leone,31/01/2012,3,0,0,0,0,0,0,3
Somalia,01/01/2012,94,0,0,0,20,4,0,118
Somalia,02/01/2012,25,0,0,0,9,0,0,34
Somalia,03/01/2012,49,0,-2,0,8,3,0,58
Somalia,04/01/2012,66,0,0,0,13,4,0,83
Somalia,05/01/2012,66,0,-4,0,18,13,0,93
Somalia,06/01/2012,32,0,0,0,33,3,0,68
Somalia,07/01/2012,124,0,0,0,15,2,0,141
Somalia,08/01/2012,35,0,0,0,22,4,0,61
Somalia,09/01/2012,71,0,0,0,30,2,0,103
Somalia,10/01/2012,77,0,0,0,75,21,0,173
Somalia,11/01/2012,43,0,0,0,28,12,0,83
Somalia,12/01/2012,185,0,1,0,53,33,0,272
Somalia,13/01/2012,119,0,1,0,30,13,0,163
Somalia,14/01/2012,35,0,0,0,6,1,0,42
Somalia,15/01/2012,64,0,0,0,12,2,0,78
Somalia,16/01/2012,42,0,0,0,28,0,0,70
Somalia,17/01/2012,43,0,3,0,23,7,0,76
Somalia,18/01/2012,55,0,0,0,30,0,0,85
Somalia,19/01/2012,56,0,0,0,29,7,0,92
Somalia,20/01/2012,9,0,0,0,3,3,0,15
Somalia,21/01/2012,11,0,0,0,6,0,0,17
Somalia,22/01/2012,2,6,0,0,-2,1,0,7
Somalia,23/01/2012,14,0,0,0,1,4,0,19
Somalia,24/01/2012,51,0,0,0,6,0,0,57
Somalia,25/01/2012,294,0,-2,0,164,21,0,477
Somalia,26/01/2012,154,2,2,0,86,8,0,252
Somalia,27/01/2012,80,4,0,0,23,8,0,115
Somalia,28/01/2012,80,2,0,0,5,0,0,87
Somalia,29/01/2012,70,0,0,0,35,3,0,108
Somalia,30/01/2012,112,8,0,0,88,2,0,210
Somalia,31/01/2012,81,4,-1,0,65,4,0,153
Syria,01/01/2012,42,0,0,0,-10,14,0,46
Syria,02/01/2012,141,0,1,0,26,15,0,183
Syria,03/01/2012,126,2,-10,0,6,18,0,142
Syria,04/01/2012,86,4,-1,0,20,16,0,125
Syria,05/01/2012,87,12,-9,0,-5,11,0,96
Syria,06/01/2012,91,8,-4,0,7,31,0,133
Syria,07/01/2012,22,2,-2,0,4,7,0,33
Syria,08/01/2012,101,0,0,0,4,33,0,138
Syria,09/01/2012,105,0,-2,0,-8,24,0,119
Syria,10/01/2012,118,4,-6,0,27,16,0,159
Syria,11/01/2012,263,0,-4,0,-3,44,0,300
Syria,12/01/2012,276,4,0,0,17,17,0,314
Syria,13/01/2012,237,0,1,0,15,14,0,267
Syria,14/01/2012,133,0,-9,0,25,10,0,159
Syria,15/01/2012,107,0,-8,0,4,15,0,118
Syria,16/01/2012,120,0,-2,0,16,7,0,141
Syria,17/01/2012,117,2,-20,0,3,10,0,112
Syria,18/01/2012,112,0,-9,0,61,13,0,177
Syria,19/01/2012,94,4,-3,0,51,7,0,153
Syria,20/01/2012,68,2,0,0,-9,2,0,63
Syria,21/01/2012,104,0,-2,0,27,15,0,144
Syria,22/01/2012,17,0,-4,0,9,0,0,22
Syria,23/01/2012,100,0,-2,0,-6,2,0,94
Syria,24/01/2012,147,0,-20,0,-18,15,0,124
Syria,25/01/2012,348,0,-44,0,35,48,0,387
Syria,26/01/2012,69,0,-32,0,0,18,0,55
Syria,27/01/2012,188,0,-23,0,24,34,0,223
Syria,28/01/2012,162,0,-21,0,46,34,0,221
Syria,29/01/2012,111,0,-5,0,11,15,0,132
Syria,30/01/2012,243,0,-13,0,54,19,0,303
Syria,31/01/2012,301,4,-24,0,19,39,0,339
Yemen,01/01/2012,15,0,0,0,4,1,0,20
Yemen,02/01/2012,19,0,0,0,6,15,0,40
Yemen,03/01/2012,6,0,0,0,3,8,0,17
Yemen,04/01/2012,39,0,-2,0,-2,8,0,43
Yemen,05/01/2012,21,0,-8,0,-3,1,0,11
Yemen,06/01/2012,14,0,0,0,12,8,0,34
Yemen,07/01/2012,8,0,-1,0,4,0,0,11
Yemen,08/01/2012,6,0,-4,0,8,7,0,17
Yemen,09/01/2012,44,4,-4,0,20,4,0,68
Yemen,10/01/2012,51,0,-6,0,8,6,0,59
Yemen,11/01/2012,34,0,-4,0,4,5,0,39
Yemen,12/01/2012,31,0,-2,0,18,2,0,49
Yemen,13/01/2012,57,0,0,0,9,10,0,76
Yemen,14/01/2012,27,0,-4,0,0,5,0,28
Yemen,15/01/2012,3,0,0,0,-4,1,0,0
Yemen,16/01/2012,15,0,0,0,10,4,0,29
Yemen,17/01/2012,26,0,-6,0,7,2,0,29
Yemen,18/01/2012,15,0,-8,0,12,7,0,26
Yemen,19/01/2012,27,0,-2,0,7,1,0,33
Yemen,20/01/2012,37,0,-2,0,1,4,0,40
Yemen,21/01/2012,23,0,-4,0,-2,4,0,21
Yemen,22/01/2012,1,0,-14,0,-4,2,0,-15
Yemen,23/01/2012,8,0,-2,0,6,2,0,14
Yemen,24/01/2012,12,0,-5,0,14,8,0,29
Yemen,25/01/2012,91,0,-20,0,31,14,0,116
Yemen,26/01/2012,33,4,-6,0,0,3,0,34
Yemen,27/01/2012,25,0,0,0,-12,2,0,15
Yemen,28/01/2012,17,2,0,0,0,2,0,21
Yemen,29/01/2012,22,0,0,0,-1,0,0,21
Yemen,30/01/2012,28,0,-2,0,7,1,0,34
Yemen,31/01/2012,53,0,0,0,-3,2,0,52
Afghanistan,01/02/2009,150,4,-6,0,51,5,0,204
Afghanistan,02/02/2009,150,0,-8,0,126,34,0,302
Afghanistan,03/02/2009,218,12,-3,0,145,14,0,386
Afghanistan,04/02/2009,282,22,6,0,99,17,0,426
Afghanistan,05/02/2009,123,6,-16,0,34,15,0,162
Afghanistan,06/02/2009,283,0,-1,0,38,44,0,364
Afghanistan,07/02/2009,217,0,1,0,54,17,0,289
Afghanistan,08/02/2009,307,2,3,0,38,17,0,367
Afghanistan,09/02/2009,381,0,0,0,55,26,0,462
Afghanistan,10/02/2009,505,6,0,0,18,14,0,543
Afghanistan,11/02/2009,434,0,-4,0,26,33,0,489
Afghanistan,12/02/2009,168,4,2,0,30,17,0,221
Afghanistan,13/02/2009,170,0,0,0,34,22,0,226
Afghanistan,14/02/2009,245,0,0,0,20,31,0,296
Afghanistan,15/02/2009,197,0,0,0,0,9,0,206
Afghanistan,16/02/2009,291,0,0,0,32,31,0,354
Afghanistan,17/02/2009,389,0,-5,0,28,26,0,438
Afghanistan,18/02/2009,351,2,0,0,37,21,0,411
Afghanistan,19/02/2009,267,0,-6,0,64,35,0,360
Afghanistan,20/02/2009,159,6,-3,0,14,21,0,197
Afghanistan,21/02/2009,144,0,0,0,59,29,0,232
Afghanistan,22/02/2009,53,4,0,0,6,4,0,67
Afghanistan,23/02/2009,211,8,0,0,59,11,0,289
Afghanistan,24/02/2009,86,0,1,0,47,6,0,140
Afghanistan,25/02/2009,190,4,-10,0,41,11,0,236
Afghanistan,26/02/2009,158,24,-6,0,69,20,0,265
Afghanistan,27/02/2009,198,16,0,0,76,7,0,297
Afghanistan,28/02/2009,201,0,3,0,31,23,0,258
Albania,01/02/2009,-1,0,0,0,3,0,0,2
Albania,02/02/2009,0,0,0,0,6,0,0,6
Albania,03/02/2009,11,0,1,0,3,4,0,19
Albania,04/02/2009,6,0,0,0,0,0,0,6
Albania,05/02/2009,6,0,0,0,3,1,0,10
Albania,06/02/2009,3,0,1,0,-2,0,0,2
Albania,07/02/2009,4,0,-1,0,-2,0,0,1
Albania,08/02/2009,20,0,0,0,1,0,0,21
Albania,09/02/2009,30,0,0,0,-2,0,0,28
Albania,10/02/2009,33,0,0,0,0,6,0,39
Albania,11/02/2009,-2,0,0,0,-2,4,0,0
Albania,12/02/2009,9,0,0,0,3,0,0,12
Albania,13/02/2009,6,2,0,0,8,1,0,17
Albania,14/02/2009,11,0,0,0,0,0,0,11
Albania,15/02/2009,-12,0,0,0,0,0,0,-12
Albania,16/02/2009,21,0,-6,0,3,4,0,22
Albania,17/02/2009,47,0,-1,0,15,5,0,66
Albania,18/02/2009,11,0,0,0,-20,1,0,-8
Albania,19/02/2009,20,2,0,0,-9,2,0,15
Albania,20/02/2009,6,0,-2,0,0,0,0,4
Albania,21/02/2009,13,0,0,0,-1,1,0,13
Albania,22/02/2009,3,0,0,0,12,0,0,15
Albania,23/02/2009,37,0,-10,0,25,0,0,52
Albania,24/02/2009,14,0,-8,0,21,0,0,27
Albania,25/02/2009,24,0,0,0,21,2,0,47
Albania,26/02/2009,48,2,-1,0,108,13,0,170
Albania,27/02/2009,11,0,-1,0,29,0,0,39
Albania,28/02/2009,0,0,0,0,0,0,0,0
Algeria,01/02/2009,0,0,0,0,0,0,0,0
Algeria,02/02/2009,1,0,0,0,0,2,0,3
Algeria,03/02/2009,-2,0,0,0,11,2,0,11
Algeria,04/02/2009,3,0,0,0,0,5,0,8
Algeria,05/02/2009,1,0,0,0,10,4,0,15
Algeria,06/02/2009,13,0,0,0,0,1,0,14
Algeria,07/02/2009,7,0,-2,0,0,0,0,5
Algeria,08/02/2009,3,0,0,0,0,0,0,3
Algeria,09/02/2009,15,0,0,0,0,0,0,15
Algeria,10/02/2009,3,0,0,0,0,0,0,3
Algeria,11/02/2009,0,0,0,0,-2,2,0,0
Algeria,12/02/2009,13,0,0,0,6,2,0,21
Algeria,13/02/2009,4,0,0,0,3,1,0,8
Algeria,14/02/2009,14,0,0,0,3,4,0,21
Algeria,15/02/2009,2,0,0,0,0,0,0,2
Algeria,16/02/2009,1,0,0,0,9,2,0,12
Algeria,17/02/2009,5,0,0,0,6,0,0,11
Algeria,18/02/2009,3,0,2,0,28,1,0,34
Algeria,19/02/2009,11,0,0,0,10,0,0,21
Algeria,20/02/2009,-2,0,0,0,10,0,0,8
Algeria,21/02/2009,6,0,0,0,9,0,0,15
Algeria,22/02/2009,5,0,0,0,0,0,0,5
Algeria,23/02/2009,3,0,0,0,-7,0,0,-4
Algeria,24/02/2009,4,0,0,0,6,0,0,10
Algeria,25/02/2009,9,0,0,0,0,0,0,9
Algeria,26/02/2009,0,0,0,0,9,0,0,9
Algeria,27/02/2009,20,0,0,0,22,1,0,43
Algeria,28/02/2009,22,0,0,0,-4,0,0,18
Bangladesh,01/02/2009,7,0,0,0,6,1,0,14
Bangladesh,02/02/2009,8,0,0,0,36,0,0,44
Bangladesh,03/02/2009,19,0,2,0,12,3,0,36
Bangladesh,04/02/2009,44,2,0,0,26,2,0,74
Bangladesh,05/02/2009,13,0,0,0,0,0,0,13
Bangladesh,06/02/2009,16,0,-1,0,9,13,0,37
Bangladesh,07/02/2009,13,0,0,0,3,4,0,20
Bangladesh,08/02/2009,10,0,-1,0,21,3,0,33
Bangladesh,09/02/2009,36,0,0,0,21,0,0,57
Bangladesh,10/02/2009,16,0,-1,0,-2,0,0,13
Bangladesh,11/02/2009,21,0,0,0,10,1,0,32
Bangladesh,12/02/2009,18,0,0,0,9,1,0,28
Bangladesh,13/02/2009,1,0,0,0,0,0,0,1
Bangladesh,14/02/2009,12,0,1,0,14,2,0,29
Bangladesh,15/02/2009,16,0,1,0,-3,2,0,16
Bangladesh,16/02/2009,12,0,0,0,6,4,0,22
Bangladesh,17/02/2009,10,2,-2,0,1,0,0,11
Bangladesh,18/02/2009,17,4,0,0,13,0,0,34
Bangladesh,19/02/2009,13,0,0,0,-2,4,0,15
Bangladesh,20/02/2009,7,0,-2,0,-1,0,0,4
Bangladesh,21/02/2009,5,0,2,0,3,2,0,12
Bangladesh,22/02/2009,-3,0,0,0,0,0,0,-3
Bangladesh,23/02/2009,24,2,0,0,4,7,0,37
Bangladesh,24/02/2009,14,0,0,0,6,3,0,23
Bangladesh,25/02/2009,19,0,-4,0,6,4,0,25
Bangladesh,26/02/2009,45,0,0,0,10,8,0,63
Bangladesh,27/02/2009,19,0,0,0,9,1,0,29
Bangladesh,28/02/2009,8,0,0,0,12,0,0,20
Cameroon,02/02/2009,4,0,0,0,3,-2,0,5
Cameroon,03/02/2009,0,0,0,0,3,0,0,3
Cameroon,04/02/2009,5,0,0,0,3,4,0,12
Cameroon,05/02/2009,3,0,-1,0,3,3,0,8
Cameroon,06/02/2009,3,0,0,0,3,3,0,9
Cameroon,07/02/2009,3,0,0,0,6,0,0,9
Cameroon,08/02/2009,4,0,0,0,0,0,0,4
Cameroon,09/02/2009,5,2,0,0,0,0,0,7
Cameroon,10/02/2009,0,0,0,0,0,0,0,0
Cameroon,11/02/2009,0,0,0,0,0,0,0,0
Cameroon,12/02/2009,0,0,0,0,0,0,0,0
Cameroon,13/02/2009,1,0,0,0,0,0,0,1
Cameroon,14/02/2009,0,0,0,0,0,0,0,0
Cameroon,15/02/2009,-1,0,0,0,-2,0,0,-3
Cameroon,16/02/2009,3,0,1,0,6,0,0,10
Cameroon,17/02/2009,0,0,0,0,0,0,0,0
Cameroon,18/02/2009,12,0,0,0,6,0,0,18
Cameroon,19/02/2009,0,0,0,0,3,0,0,3
Cameroon,20/02/2009,2,0,0,0,3,0,0,5
Cameroon,21/02/2009,0,0,0,0,0,0,0,0
Cameroon,23/02/2009,9,0,0,0,6,0,0,15
Cameroon,24/02/2009,-3,0,0,0,0,0,0,-3
Cameroon,25/02/2009,3,0,0,0,3,0,0,6
Cameroon,26/02/2009,-1,0,0,0,0,0,0,-1
Cameroon,27/02/2009,2,0,0,0,-2,0,0,0
Cameroon,28/02/2009,2,0,0,0,3,0,0,5
China,01/02/2009,60,2,1,0,5,9,0,77
China,02/02/2009,102,0,-1,0,73,24,0,198
China,03/02/2009,73,2,0,0,46,16,0,137
China,04/02/2009,124,2,3,0,46,7,0,182
China,05/02/2009,28,0,0,0,19,4,0,51
China,06/02/2009,41,2,-2,0,11,3,0,55
China,07/02/2009,59,0,1,0,41,7,0,108
China,08/02/2009,84,0,0,0,7,7,0,98
China,09/02/2009,111,4,0,0,36,32,0,183
China,10/02/2009,108,8,4,0,61,17,0,198
China,11/02/2009,112,2,6,0,38,8,0,166
China,12/02/2009,128,2,6,0,37,20,0,193
China,13/02/2009,64,0,-4,0,9,6,0,75
China,14/02/2009,61,0,-4,0,-20,1,0,38
China,15/02/2009,45,0,0,0,4,8,0,57
China,16/02/2009,89,0,0,0,9,9,0,107
China,17/02/2009,64,0,-1,0,32,12,0,107
China,18/02/2009,135,6,0,0,20,10,0,171
China,19/02/2009,47,2,-4,0,39,12,0,96
China,20/02/2009,83,0,-1,0,26,28,0,136
China,21/02/2009,16,0,0,0,11,19,0,46
China,22/02/2009,20,0,0,0,7,6,0,33
China,23/02/2009,32,0,1,0,-2,26,0,57
China,24/02/2009,42,0,0,0,-4,5,0,43
China,25/02/2009,82,0,0,0,41,15,0,138
China,26/02/2009,147,4,-3,0,53,28,0,229
China,27/02/2009,80,0,0,0,8,13,0,101
China,28/02/2009,25,0,0,0,18,18,0,61
Egypt,01/02/2009,127,0,2,0,20,1,0,150
Egypt,02/02/2009,92,0,3,0,-5,18,0,108
Egypt,03/02/2009,87,0,0,0,6,10,0,103
Egypt,04/02/2009,15,0,0,0,10,4,0,29
Egypt,05/02/2009,51,0,-2,0,1,22,0,72
Egypt,06/02/2009,40,0,0,0,4,1,0,45
Egypt,07/02/2009,52,0,0,0,-10,0,0,42
Egypt,08/02/2009,55,0,0,0,1,3,0,59
Egypt,09/02/2009,89,2,1,0,-1,2,0,93
Egypt,10/02/2009,31,0,0,0,7,0,0,38
Egypt,11/02/2009,4,0,-2,0,50,2,0,54
Egypt,12/02/2009,9,0,0,0,48,4,0,61
Egypt,13/02/2009,25,0,-4,0,21,5,0,47
Egypt,14/02/2009,53,0,1,0,10,2,0,66
Egypt,15/02/2009,48,0,0,0,7,1,0,56
Egypt,16/02/2009,94,0,-4,0,9,3,0,102
Egypt,17/02/2009,31,0,1,0,13,2,0,47
Egypt,18/02/2009,85,0,0,0,16,9,0,110
Egypt,19/02/2009,88,0,1,0,-13,0,0,76
Egypt,20/02/2009,55,2,1,0,6,3,0,67
Egypt,21/02/2009,8,0,0,0,18,10,0,36
Egypt,22/02/2009,39,0,0,0,-2,5,0,42
Egypt,23/02/2009,32,0,0,0,-2,6,0,36
Egypt,24/02/2009,18,0,0,0,-1,0,0,17
Egypt,25/02/2009,40,0,0,0,7,2,0,49
Egypt,26/02/2009,28,4,0,0,8,2,0,42
Egypt,27/02/2009,65,4,-2,0,12,0,0,79
Egypt,28/02/2009,54,2,3,0,12,8,0,79
Eritrea,01/02/2009,-2,0,0,0,3,0,0,1
Eritrea,02/02/2009,13,0,0,0,6,0,0,19
Eritrea,03/02/2009,2,0,0,0,0,0,0,2
Eritrea,04/02/2009,0,0,0,0,13,0,0,13
Eritrea,05/02/2009,0,0,0,0,1,0,0,1
Eritrea,06/02/2009,0,0,0,0,0,0,0,0
Eritrea,07/02/2009,16,0,0,0,0,1,0,17
Eritrea,08/02/2009,15,0,0,0,0,0,0,15
Eritrea,09/02/2009,0,0,0,0,1,0,0,1
Eritrea,10/02/2009,-4,0,0,0,9,0,0,5
Eritrea,11/02/2009,5,0,0,0,0,0,0,5
Eritrea,12/02/2009,0,0,0,0,9,0,0,9
Eritrea,13/02/2009,2,0,0,0,3,0,0,5
Eritrea,14/02/2009,0,0,0,0,0,0,0,0
Eritrea,15/02/2009,0,0,0,0,0,0,0,0
Eritrea,16/02/2009,0,0,0,0,0,0,0,0
Eritrea,17/02/2009,6,0,0,0,0,0,0,6
Eritrea,18/02/2009,0,0,0,0,0,0,0,0
Eritrea,20/02/2009,0,0,0,0,0,0,0,0
Eritrea,21/02/2009,21,0,0,0,0,0,0,21
Eritrea,22/02/2009,0,0,0,0,-2,0,0,-2
Eritrea,23/02/2009,6,0,0,0,0,0,0,6
Eritrea,24/02/2009,-2,0,0,0,0,0,0,-2
Eritrea,25/02/2009,-5,0,0,0,33,0,0,28
Eritrea,26/02/2009,2,0,0,0,6,0,0,8
Eritrea,27/02/2009,-2,0,0,0,6,1,0,5
Georgia,01/02/2009,7,0,0,0,-2,0,0,5
Georgia,02/02/2009,7,0,-1,0,10,0,0,16
Georgia,03/02/2009,12,0,0,0,0,0,0,12
Georgia,04/02/2009,9,0,0,0,-2,1,0,8
Georgia,05/02/2009,11,0,0,0,16,6,0,33
Georgia,06/02/2009,1,0,-2,0,13,1,0,13
Georgia,07/02/2009,3,0,0,0,5,3,0,11
Georgia,08/02/2009,6,0,0,0,0,0,0,6
Georgia,09/02/2009,6,0,0,0,6,0,0,12
Georgia,10/02/2009,14,2,0,0,21,0,0,37
Georgia,11/02/2009,9,0,0,0,1,2,0,12
Georgia,12/02/2009,13,0,0,0,3,1,0,17
Georgia,13/02/2009,11,0,1,0,6,1,0,19
Georgia,14/02/2009,1,2,0,0,-2,2,0,3
Georgia,15/02/2009,0,0,0,0,0,0,0,0
Georgia,16/02/2009,13,0,0,0,-2,2,0,13
Georgia,17/02/2009,11,0,1,0,9,2,0,23
Georgia,18/02/2009,2,0,1,0,1,1,0,5
Georgia,19/02/2009,9,0,0,0,12,2,0,23
Georgia,20/02/2009,9,0,0,0,1,0,0,10
Georgia,21/02/2009,5,0,0,0,-8,0,0,-3
Georgia,23/02/2009,7,0,0,0,0,0,0,7
Georgia,24/02/2009,10,0,0,0,6,0,0,16
Georgia,25/02/2009,9,0,0,0,0,4,0,13
Georgia,26/02/2009,9,0,0,0,1,2,0,12
Georgia,27/02/2009,5,0,0,0,12,2,0,19
Georgia,28/02/2009,4,0,0,0,6,2,0,12
India,01/02/2009,34,0,-1,0,13,0,0,46
India,02/02/2009,54,0,0,0,26,16,0,96
India,03/02/2009,49,2,0,0,26,12,0,89
India,04/02/2009,46,0,0,0,23,9,0,78
India,05/02/2009,33,0,0,0,13,1,0,47
India,06/02/2009,39,0,-1,0,9,2,0,49
India,07/02/2009,49,10,0,0,6,12,0,77
India,08/02/2009,29,6,-1,0,13,3,0,50
India,09/02/2009,53,0,1,0,21,6,0,81
India,10/02/2009,33,2,-1,0,7,4,0,45
India,11/02/2009,42,0,0,0,20,14,0,76
India,12/02/2009,32,0,0,0,4,9,0,45
India,13/02/2009,10,0,-1,0,3,3,0,15
India,14/02/2009,10,0,-2,0,12,4,0,24
India,15/02/2009,25,0,-2,0,15,1,0,39
India,16/02/2009,18,0,0,0,12,6,0,36
India,17/02/2009,48,2,3,0,15,3,0,71
India,18/02/2009,70,0,-2,0,19,3,0,90
India,19/02/2009,45,0,-3,0,7,3,0,52
India,20/02/2009,92,0,-1,0,7,11,0,109
India,21/02/2009,22,0,0,0,19,1,0,42
India,22/02/2009,20,0,0,0,1,0,0,21
India,23/02/2009,35,0,-2,0,8,2,0,43
India,24/02/2009,18,0,0,0,3,4,0,25
India,25/02/2009,54,2,-2,0,11,6,0,71
India,26/02/2009,22,0,-1,0,19,6,0,46
India,27/02/2009,43,0,-2,0,9,8,0,58
India,28/02/2009,54,0,0,0,32,20,0,106
Iran,01/02/2009,45,0,0,0,14,4,0,63
Iran,02/02/2009,138,0,0,0,111,15,0,264
Iran,03/02/2009,113,0,0,0,44,28,0,185
Iran,04/02/2009,90,2,2,0,12,4,0,110
Iran,05/02/2009,101,0,0,0,25,19,0,145
Iran,06/02/2009,144,2,0,0,35,1,0,182
Iran,07/02/2009,108,2,3,0,48,3,0,164
Iran,08/02/2009,95,0,-2,0,80,4,0,177
Iran,09/02/2009,75,0,1,0,40,7,0,123
Iran,10/02/2009,72,0,4,0,37,10,0,123
Iran,11/02/2009,59,4,-2,0,15,9,0,85
Iran,12/02/2009,44,0,-1,0,12,5,0,60
Iran,13/02/2009,73,0,2,0,8,37,0,120
Iran,14/02/2009,50,2,2,0,11,1,0,66
Iran,15/02/2009,64,0,0,0,1,6,0,71
Iran,16/02/2009,45,6,0,0,3,10,0,64
Iran,17/02/2009,25,0,0,0,2,3,0,30
Iran,18/02/2009,20,0,3,0,23,20,0,66
Iran,19/02/2009,156,0,2,0,35,18,0,211
Iran,20/02/2009,21,0,0,0,-6,16,0,31
Iran,21/02/2009,36,0,0,0,25,2,0,63
Iran,22/02/2009,34,0,0,0,27,3,0,64
Iran,23/02/2009,18,0,1,0,4,1,0,24
Iran,24/02/2009,58,0,-1,0,25,2,0,84
Iran,25/02/2009,17,0,0,0,54,3,0,74
Iran,26/02/2009,57,0,0,0,24,5,0,86
Iran,27/02/2009,44,0,0,0,28,1,0,73
Iran,28/02/2009,3,0,0,0,18,1,0,22
Iraq,01/02/2009,40,0,-5,0,26,14,0,75
Iraq,02/02/2009,78,0,0,0,11,25,0,114
Iraq,03/02/2009,118,0,-2,0,43,25,0,184
Iraq,04/02/2009,103,0,2,0,14,21,0,140
Iraq,05/02/2009,40,0,-10,0,31,4,0,65
Iraq,06/02/2009,102,2,-2,0,26,15,0,143
Iraq,07/02/2009,169,0,0,0,30,11,0,210
Iraq,08/02/2009,76,2,-2,0,25,19,0,120
Iraq,09/02/2009,67,0,1,0,16,24,0,108
Iraq,10/02/2009,92,0,-1,0,18,14,0,123
Iraq,11/02/2009,73,0,0,0,22,4,0,99
Iraq,12/02/2009,135,0,0,0,39,33,0,207
Iraq,13/02/2009,59,0,-2,0,-4,18,0,71
Iraq,14/02/2009,60,0,0,0,3,1,0,64
Iraq,15/02/2009,126,0,0,0,10,5,0,141
Iraq,16/02/2009,119,0,0,0,-4,29,0,144
Iraq,17/02/2009,76,0,-1,0,1,26,0,102
Iraq,18/02/2009,169,2,1,0,43,33,0,248
Iraq,19/02/2009,52,0,1,0,40,6,0,99
Iraq,20/02/2009,121,0,0,0,36,7,0,164
Iraq,21/02/2009,104,0,0,0,23,6,0,133
Iraq,22/02/2009,13,0,0,0,-1,1,0,13
Iraq,23/02/2009,73,0,0,0,27,5,0,105
Iraq,24/02/2009,21,0,0,0,-2,0,0,19
Iraq,25/02/2009,79,4,-6,0,28,16,0,121
Iraq,26/02/2009,123,6,-10,0,99,12,0,230
Iraq,27/02/2009,101,6,-1,0,43,24,0,173
Iraq,28/02/2009,60,0,-1,0,47,18,0,124
Morocco,01/02/2009,2,0,0,0,-4,0,0,-2
Morocco,02/02/2009,14,0,0,0,5,0,0,19
Morocco,03/02/2009,13,0,-1,0,0,3,0,15
Morocco,04/02/2009,6,0,0,0,15,1,0,22
Morocco,05/02/2009,5,0,0,0,6,1,0,12
Morocco,06/02/2009,4,0,0,0,29,0,0,33
Morocco,07/02/2009,2,0,0,0,4,0,0,6
Morocco,08/02/2009,3,0,0,0,0,0,0,3
Morocco,09/02/2009,2,0,0,0,0,0,0,2
Morocco,10/02/2009,5,0,0,0,3,0,0,8
Morocco,11/02/2009,2,0,0,0,2,0,0,4
Morocco,12/02/2009,17,0,0,0,18,2,0,37
Morocco,13/02/2009,6,0,0,0,6,4,0,16
Morocco,14/02/2009,6,0,0,0,-4,7,0,9
Morocco,15/02/2009,2,0,0,0,0,1,0,3
Morocco,16/02/2009,1,0,0,0,12,0,0,13
Morocco,17/02/2009,9,0,0,0,30,0,0,39
Morocco,18/02/2009,5,0,0,0,16,0,0,21
Morocco,19/02/2009,6,0,0,0,6,0,0,12
Morocco,20/02/2009,3,0,0,0,0,0,0,3
Morocco,21/02/2009,-2,0,0,0,21,1,0,20
Morocco,22/02/2009,5,0,0,0,4,2,0,11
Morocco,23/02/2009,10,0,-5,0,40,3,0,48
Morocco,24/02/2009,7,0,0,0,27,4,0,38
Morocco,25/02/2009,5,0,0,0,18,0,0,23
Morocco,26/02/2009,0,0,0,0,25,0,0,25
Morocco,27/02/2009,15,0,0,0,24,1,0,40
Morocco,28/02/2009,0,0,0,0,0,2,0,2
Nigeria,01/02/2009,17,0,1,0,10,1,0,29
Nigeria,02/02/2009,39,0,1,0,2,0,0,42
Nigeria,03/02/2009,44,0,0,0,3,3,0,50
Nigeria,04/02/2009,44,0,0,0,15,4,0,63
Nigeria,05/02/2009,0,0,-2,0,12,2,0,12
Nigeria,06/02/2009,17,0,0,0,18,1,0,36
Nigeria,07/02/2009,39,0,-2,0,30,1,0,68
Nigeria,08/02/2009,14,0,-1,0,7,8,0,28
Nigeria,09/02/2009,19,0,1,0,12,8,0,40
Nigeria,10/02/2009,15,0,2,0,18,6,0,41
Nigeria,11/02/2009,33,2,-2,0,15,3,0,51
Nigeria,12/02/2009,23,0,0,0,30,3,0,56
Nigeria,13/02/2009,15,2,1,0,21,5,0,44
Nigeria,14/02/2009,18,0,1,0,4,5,0,28
Nigeria,15/02/2009,19,0,0,0,0,3,0,22
Nigeria,16/02/2009,26,0,0,0,9,0,0,35
Nigeria,17/02/2009,27,0,0,0,1,6,0,34
Nigeria,18/02/2009,8,0,0,0,15,2,0,25
Nigeria,19/02/2009,32,0,-1,0,6,2,0,39
Nigeria,20/02/2009,26,0,0,0,-4,4,0,26
Nigeria,21/02/2009,36,0,0,0,15,1,0,52
Nigeria,22/02/2009,24,0,0,0,12,0,0,36
Nigeria,23/02/2009,12,0,0,0,0,4,0,16
Nigeria,24/02/2009,7,0,0,0,9,0,0,16
Nigeria,25/02/2009,25,0,0,0,12,1,0,38
Nigeria,26/02/2009,7,0,0,0,10,0,0,17
Nigeria,27/02/2009,20,0,0,0,3,2,0,25
Nigeria,28/02/2009,7,0,1,0,-2,0,0,6
Pakistan,01/02/2009,107,0,0,0,24,18,0,149
Pakistan,02/02/2009,152,0,0,0,117,45,0,314
Pakistan,03/02/2009,146,2,1,0,75,11,0,235
Pakistan,04/02/2009,156,0,0,0,82,9,0,247
Pakistan,05/02/2009,84,0,0,0,47,13,0,144
Pakistan,06/02/2009,113,0,-5,0,43,15,0,166
Pakistan,07/02/2009,132,0,1,0,38,9,0,180
Pakistan,08/02/2009,160,6,0,0,28,18,0,212
Pakistan,09/02/2009,252,0,0,0,104,16,0,372
Pakistan,10/02/2009,163,2,0,0,70,6,0,241
Pakistan,11/02/2009,196,4,-2,0,84,17,0,299
Pakistan,12/02/2009,190,0,-3,0,62,30,0,279
Pakistan,13/02/2009,95,0,0,0,39,8,0,142
Pakistan,14/02/2009,119,0,-2,0,117,20,0,254
Pakistan,15/02/2009,102,0,0,0,43,21,0,166
Pakistan,16/02/2009,128,0,0,0,37,3,0,168
Pakistan,17/02/2009,123,0,1,0,32,1,0,157
Pakistan,18/02/2009,144,0,1,0,40,12,0,197
Pakistan,19/02/2009,77,6,0,0,23,6,0,112
Pakistan,20/02/2009,77,0,0,0,61,17,0,155
Pakistan,21/02/2009,95,0,1,0,22,16,0,134
Pakistan,22/02/2009,34,0,0,0,46,11,0,91
Pakistan,23/02/2009,163,0,0,0,156,9,0,328
Pakistan,24/02/2009,64,0,0,0,59,8,0,131
Pakistan,25/02/2009,180,2,1,0,116,7,0,306
Pakistan,26/02/2009,142,0,-1,0,67,2,0,210
Pakistan,27/02/2009,68,2,1,0,41,13,0,125
Pakistan,28/02/2009,52,0,0,0,19,8,0,79
Sierra Leone,01/02/2009,2,0,0,0,3,0,0,5
Sierra Leone,02/02/2009,3,0,0,0,3,0,0,6
Sierra Leone,03/02/2009,1,0,0,0,3,3,0,7
Sierra Leone,04/02/2009,1,0,0,0,0,3,0,4
Sierra Leone,05/02/2009,1,0,0,0,0,0,0,1
Sierra Leone,06/02/2009,0,0,0,0,0,0,0,0
Sierra Leone,07/02/2009,0,0,0,0,-2,0,0,-2
Sierra Leone,08/02/2009,0,0,0,0,0,0,0,0
Sierra Leone,09/02/2009,7,0,0,0,0,0,0,7
Sierra Leone,10/02/2009,8,0,0,0,0,0,0,8
Sierra Leone,11/02/2009,2,0,0,0,0,0,0,2
Sierra Leone,12/02/2009,13,0,0,0,0,0,0,13
Sierra Leone,13/02/2009,1,0,0,0,0,0,0,1
Sierra Leone,14/02/2009,2,0,0,0,3,0,0,5
Sierra Leone,15/02/2009,0,0,0,0,0,0,0,0
Sierra Leone,16/02/2009,0,0,0,0,0,0,0,0
Sierra Leone,17/02/2009,5,0,0,0,-5,0,0,0
Sierra Leone,18/02/2009,0,0,0,0,0,0,0,0
Sierra Leone,19/02/2009,0,0,0,0,0,0,0,0
Sierra Leone,20/02/2009,0,0,0,0,0,0,0,0
Sierra Leone,21/02/2009,0,0,0,0,0,0,0,0
Sierra Leone,23/02/2009,0,0,0,0,-1,0,0,-1
Sierra Leone,24/02/2009,0,0,0,0,0,0,0,0
Sierra Leone,25/02/2009,3,0,0,0,228,3,0,234
Sierra Leone,26/02/2009,7,0,0,0,30,0,0,37
Sierra Leone,27/02/2009,-1,0,0,0,10,0,0,9
Sierra Leone,28/02/2009,12,0,0,0,0,0,0,12
Somalia,01/02/2009,21,0,0,0,5,1,0,27
Somalia,02/02/2009,26,2,0,0,-18,0,0,10
Somalia,03/02/2009,50,4,3,0,-20,0,0,37
Somalia,04/02/2009,51,2,-1,0,9,0,0,61
Somalia,05/02/2009,87,2,0,0,-27,6,0,68
Somalia,06/02/2009,47,2,1,0,-29,0,0,21
Somalia,07/02/2009,34,2,0,0,29,0,0,65
Somalia,08/02/2009,9,0,0,0,-18,1,0,-8
Somalia,09/02/2009,46,0,0,0,33,2,0,81
Somalia,10/02/2009,22,0,0,0,3,0,0,25
Somalia,11/02/2009,25,0,0,0,-11,0,0,14
Somalia,12/02/2009,65,0,0,0,64,0,0,129
Somalia,13/02/2009,69,0,0,0,78,3,0,150
Somalia,14/02/2009,20,0,0,0,32,0,0,52
Somalia,15/02/2009,1,0,0,0,-4,1,0,-2
Somalia,16/02/2009,24,0,0,0,7,0,0,31
Somalia,17/02/2009,3,0,2,0,-2,0,0,3
Somalia,18/02/2009,23,0,2,0,-1,9,0,33
Somalia,19/02/2009,51,0,0,0,-30,6,0,27
Somalia,20/02/2009,31,0,0,0,22,4,0,57
Somalia,21/02/2009,4,2,0,0,-2,4,0,8
Somalia,22/02/2009,11,0,0,0,14,0,0,25
Somalia,23/02/2009,18,0,0,0,1,5,0,24
Somalia,24/02/2009,26,0,0,0,0,0,0,26
Somalia,25/02/2009,26,0,0,0,2,0,0,28
Somalia,26/02/2009,40,0,0,0,21,2,0,63
Somalia,27/02/2009,10,0,0,0,6,2,0,18
Somalia,28/02/2009,2,0,0,0,0,0,0,2
Syria,01/02/2009,8,4,0,0,0,0,0,12
Syria,02/02/2009,15,0,0,0,0,4,0,19
Syria,03/02/2009,13,0,0,0,5,2,0,20
Syria,04/02/2009,6,0,0,0,0,0,0,6
Syria,05/02/2009,6,0,0,0,2,0,0,8
Syria,06/02/2009,5,0,0,0,3,3,0,11
Syria,07/02/2009,6,0,0,0,9,0,0,15
Syria,08/02/2009,5,0,0,0,0,0,0,5
Syria,09/02/2009,23,0,-4,0,9,8,0,36
Syria,10/02/2009,136,0,2,0,12,1,0,151
Syria,11/02/2009,16,0,0,0,15,2,0,33
Syria,12/02/2009,20,0,0,0,7,0,0,27
Syria,13/02/2009,5,0,0,0,-2,5,0,8
Syria,14/02/2009,-1,0,0,0,9,1,0,9
Syria,15/02/2009,9,0,0,0,16,0,0,25
Syria,16/02/2009,14,0,0,0,-2,3,0,15
Syria,17/02/2009,24,0,0,0,3,3,0,30
Syria,18/02/2009,18,0,0,0,6,7,0,31
Syria,19/02/2009,12,0,0,0,-4,6,0,14
Syria,20/02/2009,3,0,0,0,9,0,0,12
Syria,21/02/2009,20,0,0,0,0,0,0,20
Syria,22/02/2009,6,0,0,0,0,2,0,8
Syria,23/02/2009,21,0,0,0,6,3,0,30
Syria,24/02/2009,5,0,0,0,3,3,0,11
Syria,25/02/2009,-1,0,0,0,18,1,0,18
Syria,26/02/2009,19,0,0,0,9,0,0,28
Syria,27/02/2009,-4,0,0,0,8,2,0,6
Syria,28/02/2009,10,0,0,0,5,1,0,16
Yemen,01/02/2009,7,0,0,0,-1,2,0,8
Yemen,02/02/2009,5,0,0,0,2,8,0,15
Yemen,03/02/2009,8,0,0,0,4,0,0,12
Yemen,04/02/2009,4,0,0,0,19,1,0,24
Yemen,05/02/2009,10,0,0,0,10,4,0,24
Yemen,06/02/2009,4,0,0,0,46,10,0,60
Yemen,07/02/2009,11,0,0,0,16,2,0,29
Yemen,08/02/2009,6,0,0,0,-3,0,0,3
Yemen,09/02/2009,0,0,0,0,3,2,0,5
Yemen,10/02/2009,4,0,3,0,0,0,0,7
Yemen,11/02/2009,4,0,1,0,3,3,0,11
Yemen,12/02/2009,29,0,-3,0,10,7,0,43
Yemen,13/02/2009,9,0,0,0,0,0,0,9
Yemen,14/02/2009,3,0,0,0,0,1,0,4
Yemen,15/02/2009,0,0,0,0,0,1,0,1
Yemen,16/02/2009,3,0,0,0,0,10,0,13
Yemen,17/02/2009,-1,0,0,0,-2,4,0,1
Yemen,18/02/2009,0,0,0,0,16,4,0,20
Yemen,19/02/2009,26,0,1,0,-6,5,0,26
Yemen,20/02/2009,4,0,0,0,-1,4,0,7
Yemen,21/02/2009,7,2,2,0,15,0,0,26
Yemen,22/02/2009,-3,0,0,0,9,0,0,6
Yemen,23/02/2009,13,0,0,0,1,5,0,19
Yemen,24/02/2009,11,0,0,0,7,2,0,20
Yemen,25/02/2009,23,0,-2,0,6,1,0,28
Yemen,26/02/2009,8,0,0,0,0,1,0,9
Yemen,27/02/2009,10,0,0,0,0,0,0,10
Yemen,28/02/2009,0,4,0,0,0,1,0,5
Afghanistan,01/03/2009,193,0,7,0,51,21,0,272
Afghanistan,02/03/2009,151,4,-9,0,34,13,0,193
Afghanistan,03/03/2009,81,2,3,0,8,5,0,99
Afghanistan,04/03/2009,99,4,-1,0,11,5,0,118
Afghanistan,05/03/2009,145,0,-3,0,8,22,0,172
Afghanistan,06/03/2009,71,4,1,0,13,13,0,102
Afghanistan,07/03/2009,36,0,-1,0,7,7,0,49
Afghanistan,08/03/2009,169,0,1,0,35,10,0,215
Afghanistan,09/03/2009,305,8,2,0,48,33,0,396
Afghanistan,10/03/2009,286,10,1,0,108,26,0,431
Afghanistan,11/03/2009,150,0,0,0,36,15,0,201
Afghanistan,12/03/2009,205,0,0,0,59,6,0,270
Afghanistan,13/03/2009,183,0,-4,0,35,14,0,228
Afghanistan,14/03/2009,184,0,1,0,27,14,0,226
Afghanistan,15/03/2009,193,10,2,0,26,33,0,264
Afghanistan,16/03/2009,186,8,0,0,32,44,0,270
Afghanistan,17/03/2009,146,2,-1,0,53,54,0,254
Afghanistan,18/03/2009,255,4,-1,0,69,30,0,357
Afghanistan,19/03/2009,154,4,0,0,45,30,0,233
Afghanistan,20/03/2009,303,0,-2,0,68,36,0,405
Afghanistan,21/03/2009,194,14,2,0,33,25,0,268
Afghanistan,22/03/2009,125,10,1,0,34,6,0,176
Afghanistan,23/03/2009,210,8,-1,0,53,31,0,301
Afghanistan,24/03/2009,197,2,1,0,-1,25,0,224
Afghanistan,25/03/2009,246,0,0,0,5,15,0,266
Afghanistan,26/03/2009,313,0,1,0,15,65,0,394
Afghanistan,27/03/2009,466,6,-1,0,6,72,0,549
Afghanistan,28/03/2009,361,2,0,0,24,41,0,428
Afghanistan,29/03/2009,154,2,-2,0,36,21,0,211
Afghanistan,30/03/2009,229,4,-1,0,44,52,0,328
Afghanistan,31/03/2009,498,10,1,0,77,31,0,617
Albania,01/03/2009,6,0,0,0,0,0,0,6
Albania,02/03/2009,13,0,0,0,19,0,0,32
Albania,03/03/2009,10,0,0,0,3,10,0,23
Albania,04/03/2009,35,0,0,0,60,0,0,95
Albania,05/03/2009,25,4,0,0,4,8,0,41
Albania,06/03/2009,-2,0,0,0,-2,0,0,-4
Albania,07/03/2009,2,0,0,0,0,0,0,2
Albania,08/03/2009,-1,0,0,0,0,0,0,-1
Albania,09/03/2009,1,0,3,0,3,4,0,11
Albania,10/03/2009,7,0,0,0,6,1,0,14
Albania,11/03/2009,6,0,0,0,9,0,0,15
Albania,12/03/2009,2,0,0,0,6,5,0,13
Albania,13/03/2009,30,0,0,0,8,2,0,40
Albania,14/03/2009,24,0,0,0,-4,7,0,27
Albania,15/03/2009,0,0,0,0,-2,1,0,-1
Albania,16/03/2009,3,0,0,0,9,2,0,14
Albania,17/03/2009,34,0,-4,0,24,9,0,63
Albania,18/03/2009,38,0,0,0,4,5,0,47
Albania,19/03/2009,36,0,-4,0,11,1,0,44
Albania,20/03/2009,23,2,-2,0,6,1,0,30
Albania,21/03/2009,11,0,0,0,11,2,0,24
Albania,22/03/2009,4,0,-4,0,-5,10,0,5
Albania,23/03/2009,10,0,0,0,3,5,0,18
Albania,24/03/2009,36,0,-3,0,15,2,0,50
Albania,25/03/2009,0,0,0,0,6,8,0,14
Albania,26/03/2009,0,0,0,0,1,1,0,2
Albania,27/03/2009,23,0,0,0,4,5,0,32
Albania,28/03/2009,0,0,0,0,6,0,0,6
Albania,29/03/2009,0,0,0,0,0,0,0,0
Albania,30/03/2009,2,0,0,0,0,1,0,3
Albania,31/03/2009,0,0,0,0,0,0,0,0
Algeria,01/03/2009,10,0,0,0,3,0,0,13
Algeria,02/03/2009,14,0,0,0,4,0,0,18
Algeria,03/03/2009,0,0,0,0,4,0,0,4
Algeria,04/03/2009,2,0,0,0,0,0,0,2
Algeria,05/03/2009,1,0,0,0,0,0,0,1
Algeria,06/03/2009,0,0,0,0,0,0,0,0
Algeria,07/03/2009,0,0,0,0,0,3,0,3
Algeria,08/03/2009,1,0,-1,0,3,0,0,3
Algeria,09/03/2009,11,0,0,0,3,0,0,14
Algeria,10/03/2009,5,0,0,0,3,0,0,8
Algeria,11/03/2009,2,0,0,0,0,1,0,3
Algeria,12/03/2009,-1,0,0,0,6,1,0,6
Algeria,13/03/2009,8,0,0,0,0,0,0,8
Algeria,14/03/2009,1,0,0,0,1,0,0,2
Algeria,15/03/2009,7,0,0,0,0,0,0,7
Algeria,16/03/2009,7,0,0,0,6,0,0,13
Algeria,17/03/2009,9,0,0,0,0,0,0,9
Algeria,18/03/2009,22,0,0,0,3,2,0,27
Algeria,19/03/2009,3,0,0,0,0,0,0,3
Algeria,20/03/2009,5,0,0,0,0,2,0,7
Algeria,21/03/2009,0,0,0,0,6,5,0,11
Algeria,22/03/2009,6,0,0,0,3,0,0,9
Algeria,23/03/2009,3,0,-2,0,26,0,0,27
Algeria,24/03/2009,0,0,-1,0,15,0,0,14
Algeria,25/03/2009,2,0,1,0,0,0,0,3
Algeria,26/03/2009,4,0,0,0,0,0,0,4
Algeria,27/03/2009,2,0,0,0,0,0,0,2
Algeria,28/03/2009,0,0,0,0,-2,0,0,-2
Algeria,29/03/2009,1,0,0,0,0,0,0,1
Algeria,30/03/2009,13,0,0,0,9,0,0,22
Algeria,31/03/2009,5,0,0,0,-1,0,0,4
Bangladesh,01/03/2009,9,0,-2,0,15,0,0,22
Bangladesh,02/03/2009,13,6,0,0,13,2,0,34
Bangladesh,03/03/2009,8,0,0,0,6,0,0,14
Bangladesh,04/03/2009,9,0,0,0,3,1,0,13
Bangladesh,05/03/2009,31,0,0,0,1,10,0,42
Bangladesh,06/03/2009,2,0,0,0,3,2,0,7
Bangladesh,07/03/2009,2,0,0,0,3,2,0,7
Bangladesh,08/03/2009,8,0,0,0,0,2,0,10
Bangladesh,09/03/2009,41,0,0,0,6,7,0,54
Bangladesh,10/03/2009,8,0,0,0,28,3,0,39
Bangladesh,11/03/2009,6,0,0,0,0,0,0,6
Bangladesh,12/03/2009,4,0,0,0,1,8,0,13
Bangladesh,13/03/2009,25,0,0,0,7,8,0,40
Bangladesh,14/03/2009,25,0,0,0,0,10,0,35
Bangladesh,15/03/2009,15,0,-2,0,6,8,0,27
Bangladesh,16/03/2009,30,0,0,0,5,0,0,35
Bangladesh,17/03/2009,12,2,0,0,24,0,0,38
Bangladesh,18/03/2009,7,2,0,0,12,0,0,21
Bangladesh,19/03/2009,4,0,0,0,12,1,0,17
Bangladesh,20/03/2009,10,0,0,0,7,0,0,17
Bangladesh,21/03/2009,0,0,-2,0,0,0,0,-2
Bangladesh,22/03/2009,10,0,0,0,3,6,0,19
Bangladesh,23/03/2009,16,0,0,0,9,3,0,28
Bangladesh,24/03/2009,10,0,0,0,0,0,0,10
Bangladesh,25/03/2009,23,0,0,0,-2,1,0,22
Bangladesh,26/03/2009,35,0,0,0,19,1,0,55
Bangladesh,27/03/2009,1,0,-3,0,7,1,0,6
Bangladesh,28/03/2009,10,0,0,0,5,6,0,21
Bangladesh,29/03/2009,30,0,0,0,21,6,0,57
Bangladesh,30/03/2009,14,0,0,0,2,4,0,20
Bangladesh,31/03/2009,11,0,0,0,0,0,0,11
Cameroon,01/03/2009,6,0,0,0,0,5,0,11
Cameroon,02/03/2009,1,0,0,0,0,0,0,1
Cameroon,04/03/2009,2,0,0,0,0,0,0,2
Cameroon,05/03/2009,0,0,0,0,0,0,0,0
Cameroon,06/03/2009,2,0,0,0,3,0,0,5
Cameroon,07/03/2009,0,0,0,0,3,0,0,3
Cameroon,08/03/2009,0,0,0,0,0,0,0,0
Cameroon,09/03/2009,3,0,0,0,3,0,0,6
Cameroon,10/03/2009,1,0,0,0,0,0,0,1
Cameroon,11/03/2009,0,0,0,0,3,0,0,3
Cameroon,12/03/2009,1,0,0,0,-2,1,0,0
Cameroon,13/03/2009,0,0,0,0,0,0,0,0
Cameroon,14/03/2009,0,0,0,0,3,2,0,5
Cameroon,15/03/2009,2,0,0,0,12,2,0,16
Cameroon,16/03/2009,5,0,0,0,0,0,0,5
Cameroon,17/03/2009,18,0,0,0,1,1,0,20
Cameroon,18/03/2009,34,0,0,0,9,3,0,46
Cameroon,19/03/2009,12,0,0,0,3,0,0,15
Cameroon,20/03/2009,18,0,0,0,1,2,0,21
Cameroon,21/03/2009,0,0,0,0,0,0,0,0
Cameroon,22/03/2009,9,0,0,0,0,0,0,9
Cameroon,23/03/2009,5,0,0,0,3,0,0,8
Cameroon,24/03/2009,2,0,0,0,0,0,0,2
Cameroon,25/03/2009,2,0,0,0,0,0,0,2
Cameroon,26/03/2009,0,0,0,0,0,0,0,0
Cameroon,27/03/2009,0,0,0,0,0,0,0,0
Cameroon,28/03/2009,0,0,0,0,0,0,0,0
Cameroon,29/03/2009,2,0,0,0,0,0,0,2
Cameroon,30/03/2009,0,0,0,0,0,0,0,0
Cameroon,31/03/2009,2,0,0,0,0,0,0,2
China,01/03/2009,109,0,0,0,59,8,0,176
China,02/03/2009,34,2,0,0,40,16,0,92
China,03/03/2009,12,0,0,0,19,1,0,32
China,04/03/2009,160,10,-2,0,136,15,0,319
China,05/03/2009,124,4,1,0,53,19,0,201
China,06/03/2009,46,0,0,0,27,14,0,87
China,07/03/2009,24,2,-2,0,14,19,0,57
China,08/03/2009,31,0,-1,0,20,5,0,55
China,09/03/2009,158,0,-3,0,53,20,0,228
China,10/03/2009,166,0,-7,0,44,15,0,218
China,11/03/2009,71,0,-3,0,17,8,0,93
China,12/03/2009,100,0,-7,0,87,19,0,199
China,13/03/2009,226,2,-6,0,50,21,0,293
China,14/03/2009,125,8,-2,0,4,19,0,154
China,15/03/2009,130,6,0,0,42,11,0,189
China,16/03/2009,108,4,-1,0,-1,10,0,120
China,17/03/2009,109,4,-1,0,29,3,0,144
China,18/03/2009,128,4,-7,0,32,12,0,169
China,19/03/2009,115,0,-3,0,67,8,0,187
China,20/03/2009,79,2,-8,0,42,10,0,125
China,21/03/2009,56,0,0,0,84,3,0,143
China,22/03/2009,44,0,-3,0,100,12,0,153
China,23/03/2009,94,0,-1,0,75,15,0,183
China,24/03/2009,77,12,3,0,101,15,0,208
China,25/03/2009,116,2,-14,0,48,27,0,179
China,26/03/2009,92,4,-8,0,44,7,0,139
China,27/03/2009,93,2,2,0,46,12,0,155
China,28/03/2009,110,0,-5,0,7,3,0,115
China,29/03/2009,38,4,-2,0,17,6,0,63
China,30/03/2009,99,0,2,0,66,15,0,182
China,31/03/2009,88,0,-15,0,31,18,0,122
Egypt,01/03/2009,77,0,1,0,16,1,0,95
Egypt,02/03/2009,65,6,0,0,13,3,0,87
Egypt,03/03/2009,13,0,0,0,0,0,0,13
Egypt,04/03/2009,104,2,0,0,18,5,0,129
Egypt,05/03/2009,57,0,0,0,3,7,0,67
Egypt,06/03/2009,-1,0,0,0,12,0,0,11
Egypt,07/03/2009,21,0,-1,0,4,0,0,24
Egypt,08/03/2009,27,4,0,0,3,4,0,38
Egypt,09/03/2009,59,0,0,0,25,3,0,87
Egypt,10/03/2009,34,2,-4,0,31,11,0,74
Egypt,11/03/2009,24,0,0,0,28,4,0,56
Egypt,12/03/2009,32,0,-8,0,0,0,0,24
Egypt,13/03/2009,12,0,0,0,-6,0,0,6
Egypt,14/03/2009,27,0,1,0,13,6,0,47
Egypt,15/03/2009,36,0,0,0,12,3,0,51
Egypt,16/03/2009,32,0,0,0,37,3,0,72
Egypt,17/03/2009,31,0,0,0,12,3,0,46
Egypt,18/03/2009,54,0,-3,0,7,0,0,58
Egypt,19/03/2009,22,0,0,0,9,6,0,37
Egypt,20/03/2009,6,0,0,0,21,7,0,34
Egypt,21/03/2009,15,0,0,0,5,1,0,21
Egypt,22/03/2009,15,0,1,0,1,1,0,18
Egypt,23/03/2009,25,0,2,0,23,6,0,56
Egypt,24/03/2009,19,0,0,0,13,0,0,32
Egypt,25/03/2009,28,0,-2,0,31,2,0,59
Egypt,26/03/2009,55,2,-5,0,15,4,0,71
Egypt,27/03/2009,62,2,0,0,9,1,0,74
Egypt,28/03/2009,42,0,0,0,10,2,0,54
Egypt,29/03/2009,25,0,-2,0,3,2,0,28
Egypt,30/03/2009,29,0,0,0,-10,0,0,19
Egypt,31/03/2009,80,0,0,0,7,3,0,90
Eritrea,01/03/2009,1,0,0,0,-4,0,0,-3
Eritrea,02/03/2009,27,0,0,0,0,0,0,27
Eritrea,04/03/2009,1,0,2,0,3,0,0,6
Eritrea,05/03/2009,0,0,0,0,13,0,0,13
Eritrea,06/03/2009,0,0,0,0,0,0,0,0
Eritrea,10/03/2009,4,0,0,0,5,0,0,9
Eritrea,11/03/2009,0,0,0,0,0,0,0,0
Eritrea,12/03/2009,8,0,0,0,6,0,0,14
Eritrea,13/03/2009,-1,0,0,0,0,0,0,-1
Eritrea,14/03/2009,2,0,0,0,0,0,0,2
Eritrea,15/03/2009,5,0,0,0,0,0,0,5
Eritrea,16/03/2009,-1,0,0,0,0,0,0,-1
Eritrea,17/03/2009,6,0,0,0,12,1,0,19
Eritrea,19/03/2009,0,0,1,0,3,0,0,4
Eritrea,20/03/2009,0,0,0,0,0,0,0,0
Eritrea,21/03/2009,0,0,0,0,0,0,0,0
Eritrea,23/03/2009,22,0,0,0,24,1,0,47
Eritrea,24/03/2009,4,0,0,0,18,0,0,22
Eritrea,25/03/2009,8,0,2,0,78,0,0,88
Eritrea,26/03/2009,14,0,0,0,7,2,0,23
Eritrea,27/03/2009,6,0,0,0,6,0,0,12
Eritrea,28/03/2009,3,0,0,0,0,0,0,3
Eritrea,29/03/2009,11,0,0,0,6,0,0,17
Eritrea,30/03/2009,1,0,0,0,3,0,0,4
Eritrea,31/03/2009,0,0,0,0,0,0,0,0
Georgia,01/03/2009,2,0,0,0,1,0,0,3
Georgia,02/03/2009,4,0,0,0,-3,0,0,1
Georgia,03/03/2009,2,0,0,0,1,0,0,3
Georgia,04/03/2009,22,0,1,0,10,1,0,34
Georgia,05/03/2009,-2,0,-2,0,15,7,0,18
Georgia,06/03/2009,27,0,-2,0,0,0,0,25
Georgia,07/03/2009,15,0,0,0,-2,0,0,13
Georgia,08/03/2009,14,4,0,0,6,1,0,25
Georgia,09/03/2009,19,0,0,0,5,2,0,26
Georgia,10/03/2009,35,0,-2,0,13,4,0,50
Georgia,11/03/2009,13,0,0,0,0,4,0,17
Georgia,12/03/2009,23,2,0,0,-1,2,0,26
Georgia,13/03/2009,3,0,-2,0,10,2,0,13
Georgia,14/03/2009,4,0,0,0,18,1,0,23
Georgia,15/03/2009,5,0,0,0,6,0,0,11
Georgia,16/03/2009,6,2,0,0,4,3,0,15
Georgia,17/03/2009,13,0,2,0,10,0,0,25
Georgia,18/03/2009,24,6,3,0,4,1,0,38
Georgia,19/03/2009,7,0,0,0,8,4,0,19
Georgia,20/03/2009,17,0,0,0,2,5,0,24
Georgia,21/03/2009,20,0,0,0,-2,3,0,21
Georgia,22/03/2009,16,0,0,0,4,2,0,22
Georgia,23/03/2009,18,0,0,0,16,4,0,38
Georgia,24/03/2009,18,2,0,0,4,6,0,30
Georgia,25/03/2009,4,6,0,0,6,1,0,17
Georgia,26/03/2009,8,0,-6,0,12,1,0,15
Georgia,27/03/2009,30,0,0,0,9,2,0,41
Georgia,28/03/2009,1,0,0,0,0,0,0,1
Georgia,29/03/2009,1,0,-2,0,0,2,0,1
Georgia,30/03/2009,14,0,0,0,4,1,0,19
Georgia,31/03/2009,5,0,0,0,5,2,0,12
India,01/03/2009,33,0,-2,0,21,2,0,54
India,02/03/2009,36,0,-3,0,35,8,0,76
India,03/03/2009,5,0,0,0,-1,0,0,4
India,04/03/2009,43,0,0,0,13,3,0,59
India,05/03/2009,51,0,0,0,19,0,0,70
India,06/03/2009,37,2,0,0,15,5,0,59
India,07/03/2009,21,0,0,0,5,3,0,29
India,08/03/2009,3,0,0,0,12,1,0,16
India,09/03/2009,55,0,0,0,32,10,0,97
India,10/03/2009,62,0,-2,0,-4,42,0,98
India,11/03/2009,15,2,0,0,4,7,0,28
India,12/03/2009,34,0,-2,0,21,9,0,62
India,13/03/2009,20,0,-2,0,5,1,0,24
India,14/03/2009,65,0,0,0,20,0,0,85
India,15/03/2009,38,0,0,0,20,6,0,64
India,16/03/2009,38,4,-2,0,12,1,0,53
India,17/03/2009,34,0,0,0,6,17,0,57
India,18/03/2009,55,0,0,0,18,2,0,75
India,19/03/2009,41,0,0,0,6,7,0,54
India,20/03/2009,19,0,1,0,14,3,0,37
India,21/03/2009,42,0,-2,0,20,6,0,66
India,22/03/2009,56,0,0,0,25,3,0,84
India,23/03/2009,56,4,0,0,14,5,0,79
India,24/03/2009,31,6,0,0,21,0,0,58
India,25/03/2009,36,4,-1,0,24,7,0,70
India,26/03/2009,77,0,2,0,1,2,0,82
India,27/03/2009,40,0,-1,0,6,6,0,51
India,28/03/2009,14,0,0,0,-4,2,0,12
India,29/03/2009,33,0,-2,0,1,2,0,34
India,30/03/2009,61,2,0,0,-1,4,0,66
India,31/03/2009,97,2,-1,0,40,17,0,155
Iran,01/03/2009,50,0,0,0,36,7,0,93
Iran,02/03/2009,87,0,8,0,57,5,0,157
Iran,03/03/2009,32,0,1,0,13,3,0,49
Iran,04/03/2009,58,0,-4,0,14,26,0,94
Iran,05/03/2009,60,6,0,0,21,5,0,92
Iran,06/03/2009,54,2,0,0,17,12,0,85
Iran,07/03/2009,23,2,0,0,14,3,0,42
Iran,08/03/2009,76,0,0,0,33,8,0,117
Iran,09/03/2009,100,2,2,0,70,13,0,187
Iran,10/03/2009,62,0,2,0,20,15,0,99
Iran,11/03/2009,35,0,-4,0,30,1,0,62
Iran,12/03/2009,48,4,1,0,35,9,0,97
Iran,13/03/2009,26,0,1,0,36,7,0,70
Iran,14/03/2009,27,0,0,0,-5,7,0,29
Iran,15/03/2009,29,0,2,0,7,2,0,40
Iran,16/03/2009,96,0,0,0,5,7,0,108
Iran,17/03/2009,72,0,2,0,18,16,0,108
Iran,18/03/2009,51,0,-3,0,46,8,0,102
Iran,19/03/2009,51,0,-3,0,16,4,0,68
Iran,20/03/2009,42,2,1,0,11,4,0,60
Iran,21/03/2009,9,2,1,0,21,5,0,38
Iran,22/03/2009,31,0,0,0,18,1,0,50
Iran,23/03/2009,48,0,0,0,15,2,0,65
Iran,24/03/2009,14,0,-2,0,18,0,0,30
Iran,25/03/2009,0,0,-2,0,36,1,0,35
Iran,26/03/2009,60,0,-4,0,27,9,0,92
Iran,27/03/2009,111,0,0,0,-6,4,0,109
Iran,28/03/2009,93,0,0,0,7,0,0,100
Iran,29/03/2009,46,0,-4,0,-5,1,0,38
Iran,30/03/2009,115,4,0,0,11,6,0,136
Iran,31/03/2009,50,0,0,0,100,3,0,153
Iraq,01/03/2009,108,0,2,0,31,22,0,163
Iraq,02/03/2009,44,0,-7,0,29,6,0,72
Iraq,03/03/2009,2,0,0,0,9,0,0,11
Iraq,04/03/2009,60,0,3,0,39,9,0,111
Iraq,05/03/2009,79,0,-4,0,16,6,0,97
Iraq,06/03/2009,38,0,0,0,12,7,0,57
Iraq,07/03/2009,24,2,0,0,12,4,0,42
Iraq,08/03/2009,54,0,-2,0,18,16,0,86
Iraq,09/03/2009,162,2,1,0,13,9,0,187
Iraq,10/03/2009,76,2,0,0,25,26,0,129
Iraq,11/03/2009,45,0,1,0,36,5,0,87
Iraq,12/03/2009,98,0,-3,0,77,42,0,214
Iraq,13/03/2009,104,0,0,0,31,11,0,146
Iraq,14/03/2009,68,0,0,0,21,2,0,91
Iraq,15/03/2009,125,0,-2,0,69,26,0,218
Iraq,16/03/2009,128,0,-2,0,80,13,0,219
Iraq,17/03/2009,150,0,-4,0,86,18,0,250
Iraq,18/03/2009,194,0,1,0,86,29,0,310
Iraq,19/03/2009,64,4,0,0,15,10,0,93
Iraq,20/03/2009,80,0,0,0,42,19,0,141
Iraq,21/03/2009,36,0,1,0,12,24,0,73
Iraq,22/03/2009,104,4,0,0,6,21,0,135
Iraq,23/03/2009,117,2,0,0,42,5,0,166
Iraq,24/03/2009,125,0,0,0,33,13,0,171
Iraq,25/03/2009,113,6,0,0,5,16,0,140
Iraq,26/03/2009,122,4,1,0,20,10,0,157
Iraq,27/03/2009,59,0,0,0,9,18,0,86
Iraq,28/03/2009,56,0,4,0,10,1,0,71
Iraq,29/03/2009,26,0,-2,0,9,5,0,38
Iraq,30/03/2009,93,0,2,0,40,8,0,143
Iraq,31/03/2009,84,0,2,0,15,39,0,140
Morocco,01/03/2009,0,0,0,0,6,1,0,7
Morocco,02/03/2009,3,0,0,0,0,1,0,4
Morocco,03/03/2009,0,0,0,0,6,0,0,6
Morocco,04/03/2009,1,0,1,0,12,0,0,14
Morocco,05/03/2009,11,0,0,0,6,0,0,17
Morocco,06/03/2009,6,0,0,0,0,0,0,6
Morocco,07/03/2009,1,0,0,0,0,0,0,1
Morocco,08/03/2009,-1,0,0,0,20,0,0,19
Morocco,09/03/2009,7,0,0,0,46,4,0,57
Morocco,10/03/2009,4,0,0,0,10,0,0,14
Morocco,11/03/2009,0,0,0,0,4,1,0,5
Morocco,12/03/2009,4,0,0,0,9,0,0,13
Morocco,13/03/2009,2,0,0,0,34,4,0,40
Morocco,14/03/2009,4,0,0,0,11,0,0,15
Morocco,15/03/2009,0,0,0,0,12,2,0,14
Morocco,16/03/2009,11,0,2,0,24,0,0,37
Morocco,17/03/2009,17,0,0,0,24,1,0,42
Morocco,18/03/2009,17,0,0,0,30,4,0,51
Morocco,19/03/2009,2,0,1,0,3,1,0,7
Morocco,20/03/2009,4,0,0,0,0,0,0,4
Morocco,21/03/2009,0,0,0,0,21,0,0,21
Morocco,22/03/2009,1,0,0,0,12,7,0,20
Morocco,23/03/2009,3,0,0,0,24,0,0,27
Morocco,24/03/2009,0,0,0,0,9,0,0,9
Morocco,25/03/2009,1,0,0,0,0,0,0,1
Morocco,26/03/2009,13,0,0,0,66,4,0,83
Morocco,27/03/2009,0,0,0,0,15,3,0,18
Morocco,28/03/2009,0,0,0,0,3,0,0,3
Morocco,29/03/2009,0,0,0,0,0,0,0,0
Morocco,30/03/2009,5,0,0,0,12,0,0,17
Morocco,31/03/2009,0,0,0,0,0,0,0,0
Nigeria,01/03/2009,14,0,0,0,1,1,0,16
Nigeria,02/03/2009,14,0,-2,0,12,0,0,24
Nigeria,03/03/2009,9,0,0,0,4,0,0,13
Nigeria,04/03/2009,19,2,-2,0,33,9,0,61
Nigeria,05/03/2009,23,0,1,0,26,1,0,51
Nigeria,06/03/2009,1,0,0,0,0,0,0,1
Nigeria,07/03/2009,4,0,0,0,2,0,0,6
Nigeria,08/03/2009,5,0,0,0,3,0,0,8
Nigeria,09/03/2009,12,0,-2,0,7,5,0,22
Nigeria,10/03/2009,26,0,0,0,19,6,0,51
Nigeria,11/03/2009,8,0,1,0,-2,0,0,7
Nigeria,12/03/2009,29,0,2,0,27,7,0,65
Nigeria,13/03/2009,16,0,3,0,24,0,0,43
Nigeria,14/03/2009,13,0,0,0,3,1,0,17
Nigeria,15/03/2009,47,0,1,0,12,3,0,63
Nigeria,16/03/2009,7,0,-2,0,5,0,0,10
Nigeria,17/03/2009,33,8,1,0,6,8,0,56
Nigeria,18/03/2009,7,0,0,0,21,2,0,30
Nigeria,19/03/2009,34,0,2,0,3,1,0,40
Nigeria,20/03/2009,12,0,0,0,3,0,0,15
Nigeria,21/03/2009,8,0,0,0,-2,0,0,6
Nigeria,22/03/2009,8,0,0,0,3,0,0,11
Nigeria,23/03/2009,13,0,-2,0,40,1,0,52
Nigeria,24/03/2009,36,0,-5,0,63,4,0,98
Nigeria,25/03/2009,55,0,0,0,27,3,0,85
Nigeria,26/03/2009,18,0,0,0,2,2,0,22
Nigeria,27/03/2009,14,0,-1,0,8,0,0,21
Nigeria,28/03/2009,10,0,0,0,10,1,0,21
Nigeria,29/03/2009,24,0,0,0,12,3,0,39
Nigeria,30/03/2009,27,0,0,0,23,-1,0,49
Nigeria,31/03/2009,12,0,0,0,7,0,0,19
Pakistan,01/03/2009,60,0,3,0,69,11,0,143
Pakistan,02/03/2009,71,2,-1,0,48,19,0,139
Pakistan,03/03/2009,8,0,-2,0,15,0,0,21
Pakistan,04/03/2009,37,0,0,0,13,5,0,55
Pakistan,05/03/2009,21,0,0,0,14,1,0,36
Pakistan,06/03/2009,21,0,0,0,0,0,0,21
Pakistan,07/03/2009,23,0,0,0,12,2,0,37
Pakistan,08/03/2009,40,0,1,0,50,2,0,93
Pakistan,09/03/2009,109,0,0,0,48,3,0,160
Pakistan,10/03/2009,72,2,2,0,30,7,0,113
Pakistan,11/03/2009,31,0,0,0,40,5,0,76
Pakistan,12/03/2009,92,4,-1,0,83,10,0,188
Pakistan,13/03/2009,103,0,-7,0,66,9,0,171
Pakistan,14/03/2009,83,0,-10,0,39,9,0,121
Pakistan,15/03/2009,66,0,-4,0,26,13,0,101
Pakistan,16/03/2009,97,0,-5,0,4,32,0,128
Pakistan,17/03/2009,81,0,-5,0,25,11,0,112
Pakistan,18/03/2009,81,8,2,0,165,10,0,266
Pakistan,19/03/2009,90,0,-3,0,22,1,0,110
Pakistan,20/03/2009,84,6,0,0,12,4,0,106
Pakistan,21/03/2009,84,2,-6,0,49,39,0,168
Pakistan,22/03/2009,106,0,1,0,17,3,0,127
Pakistan,23/03/2009,128,8,-2,0,61,14,0,209
Pakistan,24/03/2009,134,0,-1,0,64,4,0,201
Pakistan,25/03/2009,98,2,1,0,73,7,0,181
Pakistan,26/03/2009,156,0,3,0,27,6,0,192
Pakistan,27/03/2009,282,2,1,0,39,45,0,369
Pakistan,28/03/2009,225,2,-13,0,27,31,0,272
Pakistan,29/03/2009,79,2,-1,0,38,3,0,121
Pakistan,30/03/2009,160,0,-1,0,11,22,0,192
Pakistan,31/03/2009,145,4,-5,0,26,6,0,176
Sierra Leone,01/03/2009,0,0,0,0,0,0,0,0
Sierra Leone,02/03/2009,3,0,0,0,0,0,0,3
Sierra Leone,04/03/2009,4,0,0,0,9,0,0,13
Sierra Leone,05/03/2009,6,0,0,0,18,0,0,24
Sierra Leone,06/03/2009,3,0,-1,0,12,1,0,15
Sierra Leone,07/03/2009,0,0,0,0,0,0,0,0
Sierra Leone,08/03/2009,0,0,0,0,12,0,0,12
Sierra Leone,09/03/2009,1,0,0,0,12,0,0,13
Sierra Leone,10/03/2009,0,0,0,0,-6,0,0,-6
Sierra Leone,11/03/2009,0,0,0,0,0,4,0,4
Sierra Leone,12/03/2009,0,0,0,0,0,0,0,0
Sierra Leone,13/03/2009,0,0,0,0,6,0,0,6
Sierra Leone,14/03/2009,0,0,0,0,0,0,0,0
Sierra Leone,15/03/2009,0,0,0,0,-10,0,0,-10
Sierra Leone,16/03/2009,5,0,0,0,-5,2,0,2
Sierra Leone,17/03/2009,0,0,0,0,3,0,0,3
Sierra Leone,18/03/2009,0,0,0,0,-2,0,0,-2
Sierra Leone,19/03/2009,2,0,0,0,18,0,0,20
Sierra Leone,20/03/2009,5,0,0,0,0,1,0,6
Sierra Leone,21/03/2009,7,0,0,0,0,3,0,10
Sierra Leone,22/03/2009,3,0,0,0,0,0,0,3
Sierra Leone,23/03/2009,-2,0,0,0,0,0,0,-2
Sierra Leone,24/03/2009,-5,0,0,0,2,0,0,-3
Sierra Leone,25/03/2009,3,0,0,0,0,1,0,4
Sierra Leone,26/03/2009,0,0,0,0,0,0,0,0
Sierra Leone,27/03/2009,4,0,0,0,-2,1,0,3
Sierra Leone,28/03/2009,0,0,0,0,0,0,0,0
Sierra Leone,29/03/2009,0,0,0,0,0,0,0,0
Sierra Leone,30/03/2009,0,0,0,0,0,0,0,0
Sierra Leone,31/03/2009,0,0,0,0,0,1,0,1
Somalia,01/03/2009,6,0,0,0,3,1,0,10
Somalia,02/03/2009,9,0,0,0,2,0,0,11
Somalia,03/03/2009,17,0,0,0,6,0,0,23
Somalia,04/03/2009,38,0,0,0,-10,0,0,28
Somalia,05/03/2009,25,0,0,0,-45,0,0,-20
Somalia,06/03/2009,7,0,0,0,-6,6,0,7
Somalia,07/03/2009,2,0,0,0,18,0,0,20
Somalia,08/03/2009,12,0,0,0,0,3,0,15
Somalia,09/03/2009,36,0,1,0,9,0,0,46
Somalia,10/03/2009,59,0,2,0,40,4,0,105
Somalia,11/03/2009,16,0,0,0,7,3,0,26
Somalia,12/03/2009,100,0,0,0,30,17,0,147
Somalia,13/03/2009,68,0,0,0,25,12,0,105
Somalia,14/03/2009,14,0,0,0,12,8,0,34
Somalia,15/03/2009,51,0,-2,0,14,3,0,66
Somalia,16/03/2009,47,0,0,0,73,8,0,128
Somalia,17/03/2009,43,0,0,0,6,6,0,55
Somalia,18/03/2009,14,0,0,0,6,6,0,26
Somalia,19/03/2009,27,2,8,0,4,0,0,41
Somalia,20/03/2009,75,0,6,0,19,0,0,100
Somalia,21/03/2009,15,2,0,0,0,0,0,17
Somalia,22/03/2009,49,0,0,0,-30,2,0,21
Somalia,23/03/2009,109,0,0,0,21,0,0,130
Somalia,24/03/2009,44,0,0,0,11,5,0,60
Somalia,25/03/2009,19,0,0,0,27,2,0,48
Somalia,26/03/2009,73,0,0,0,40,8,0,121
Somalia,27/03/2009,28,0,0,0,28,1,0,57
Somalia,28/03/2009,54,0,0,0,13,3,0,70
Somalia,29/03/2009,38,0,0,0,10,0,0,48
Somalia,30/03/2009,58,0,0,0,56,2,0,116
Somalia,31/03/2009,31,0,0,0,18,0,0,49
Syria,01/03/2009,50,0,0,0,52,5,0,107
Syria,02/03/2009,4,0,0,0,31,2,0,37
Syria,03/03/2009,6,0,0,0,5,0,0,11
Syria,04/03/2009,21,0,2,0,5,0,0,28
Syria,05/03/2009,51,0,0,0,6,0,0,57
Syria,06/03/2009,23,2,0,0,7,7,0,39
Syria,07/03/2009,0,0,0,0,-2,0,0,-2
Syria,08/03/2009,9,0,0,0,0,0,0,9
Syria,09/03/2009,28,0,1,0,46,5,0,80
Syria,10/03/2009,41,0,0,0,30,1,0,72
Syria,11/03/2009,11,0,0,0,3,1,0,15
Syria,12/03/2009,7,4,0,0,30,1,0,42
Syria,13/03/2009,23,0,0,0,0,0,0,23
Syria,14/03/2009,6,0,0,0,3,0,0,9
Syria,15/03/2009,7,0,0,0,21,0,0,28
Syria,16/03/2009,32,0,0,0,20,1,0,53
Syria,17/03/2009,17,0,0,0,9,0,0,26
Syria,18/03/2009,17,0,0,0,33,2,0,52
Syria,19/03/2009,20,0,0,0,6,1,0,27
Syria,20/03/2009,8,0,0,0,0,0,0,8
Syria,21/03/2009,-2,0,0,0,9,0,0,7
Syria,22/03/2009,9,0,0,0,3,0,0,12
Syria,23/03/2009,9,0,0,0,4,13,0,26
Syria,24/03/2009,-3,0,0,0,6,18,0,21
Syria,25/03/2009,3,0,-2,0,22,1,0,24
Syria,26/03/2009,41,0,0,0,23,1,0,65
Syria,27/03/2009,17,0,0,0,-8,2,0,11
Syria,28/03/2009,40,0,0,0,3,0,0,43
Syria,29/03/2009,3,0,0,0,6,0,0,9
Syria,30/03/2009,67,0,0,0,-2,10,0,75
Syria,31/03/2009,11,0,0,0,13,0,0,24
Yemen,01/03/2009,1,0,-2,0,18,2,0,19
Yemen,02/03/2009,8,0,0,0,20,1,0,29
Yemen,03/03/2009,0,0,-8,0,1,6,0,-1
Yemen,04/03/2009,-12,0,0,0,6,1,0,-5
Yemen,05/03/2009,2,0,0,0,-2,2,0,2
Yemen,06/03/2009,3,0,0,0,-1,0,0,2
Yemen,07/03/2009,6,0,0,0,6,0,0,12
Yemen,08/03/2009,-1,0,0,0,9,0,0,8
Yemen,09/03/2009,27,0,1,0,0,5,0,33
Yemen,10/03/2009,2,0,0,0,0,0,0,2
Yemen,11/03/2009,9,0,0,0,0,0,0,9
Yemen,12/03/2009,15,0,0,0,5,1,0,21
Yemen,13/03/2009,11,0,0,0,3,0,0,14
Yemen,14/03/2009,17,0,0,0,-10,0,0,7
Yemen,15/03/2009,57,0,0,0,3,27,0,87
Yemen,16/03/2009,64,4,-2,0,15,40,0,121
Yemen,17/03/2009,15,0,0,0,4,1,0,20
Yemen,18/03/2009,18,0,0,0,3,5,0,26
Yemen,19/03/2009,36,0,1,0,-1,1,0,37
Yemen,20/03/2009,3,0,0,0,0,6,0,9
Yemen,21/03/2009,7,0,0,0,6,0,0,13
Yemen,22/03/2009,24,0,0,0,6,0,0,30
Yemen,23/03/2009,24,0,0,0,27,0,0,51
Yemen,24/03/2009,5,0,0,0,0,0,0,5
Yemen,25/03/2009,15,0,0,0,27,1,0,43
Yemen,26/03/2009,8,0,0,0,3,0,0,11
Yemen,27/03/2009,27,0,0,0,4,3,0,34
Yemen,28/03/2009,36,0,0,0,6,0,0,42
Yemen,29/03/2009,2,0,0,0,40,0,0,42
Yemen,30/03/2009,6,0,0,0,48,0,0,54
Yemen,31/03/2009,19,0,0,0,45,0,0,64
Afghanistan,01/02/2010,318,22,-4,0,70,44,0,450
Afghanistan,02/02/2010,415,12,0,0,79,39,0,545
Afghanistan,03/02/2010,487,6,-5,0,153,39,0,680
Afghanistan,04/02/2010,393,8,2,0,199,46,0,648
Afghanistan,05/02/2010,255,12,2,0,73,33,0,375
Afghanistan,06/02/2010,228,6,0,0,18,31,0,283
Afghanistan,07/02/2010,147,2,-1,0,33,22,0,203
Afghanistan,08/02/2010,192,0,0,0,42,11,0,245
Afghanistan,09/02/2010,198,10,0,0,61,51,0,320
Afghanistan,10/02/2010,395,0,5,0,49,67,0,516
Afghanistan,11/02/2010,262,0,0,0,72,45,0,379
Afghanistan,12/02/2010,243,0,-2,0,25,29,0,295
Afghanistan,13/02/2010,271,2,-1,0,23,50,0,345
Afghanistan,14/02/2010,417,2,2,0,68,22,0,511
Afghanistan,15/02/2010,475,4,-8,0,59,44,0,574
Afghanistan,16/02/2010,600,2,0,0,251,61,0,914
Afghanistan,17/02/2010,454,0,0,0,197,22,0,673
Afghanistan,18/02/2010,291,2,0,0,63,68,0,424
Afghanistan,19/02/2010,341,0,2,0,108,24,0,475
Afghanistan,20/02/2010,350,0,-3,0,54,32,0,433
Afghanistan,21/02/2010,259,8,-13,0,44,32,0,330
Afghanistan,22/02/2010,341,2,-12,0,96,51,0,478
Afghanistan,23/02/2010,457,2,-7,0,211,66,0,729
Afghanistan,24/02/2010,304,0,-2,0,120,13,0,435
Afghanistan,25/02/2010,144,0,5,0,24,29,0,202
Afghanistan,26/02/2010,68,0,0,0,6,8,0,82
Afghanistan,27/02/2010,159,0,1,0,35,29,0,224
Afghanistan,28/02/2010,56,0,0,0,17,2,0,75
Albania,01/02/2010,2,0,0,0,0,3,0,5
Albania,02/02/2010,-6,0,0,0,12,0,0,6
Albania,03/02/2010,12,0,-1,0,4,0,0,15
Albania,04/02/2010,7,0,-1,0,0,0,0,6
Albania,05/02/2010,16,0,0,0,0,0,0,16
Albania,06/02/2010,-5,0,0,0,0,0,0,-5
Albania,07/02/2010,3,0,0,0,0,0,0,3
Albania,08/02/2010,1,6,2,0,0,0,0,9
Albania,09/02/2010,0,6,0,0,0,0,0,6
Albania,10/02/2010,6,0,0,0,0,0,0,6
Albania,11/02/2010,18,0,0,0,12,1,0,31
Albania,12/02/2010,8,0,-2,0,4,0,0,10
Albania,13/02/2010,3,0,0,0,3,0,0,6
Albania,14/02/2010,12,0,0,0,9,0,0,21
Albania,15/02/2010,29,0,-5,0,13,6,0,43
Albania,16/02/2010,0,0,-1,0,3,0,0,2
Albania,17/02/2010,10,0,0,0,3,2,0,15
Albania,18/02/2010,0,0,0,0,6,0,0,6
Albania,19/02/2010,4,0,0,0,12,0,0,16
Albania,20/02/2010,3,0,0,0,9,0,0,12
Albania,21/02/2010,0,0,0,0,0,0,0,0
Albania,22/02/2010,4,0,0,0,-2,1,0,3
Albania,23/02/2010,5,0,0,0,-2,0,0,3
Albania,24/02/2010,5,0,-1,0,1,2,0,7
Albania,25/02/2010,2,0,0,0,0,0,0,2
Albania,26/02/2010,0,0,0,0,3,0,0,3
Albania,27/02/2010,0,0,0,0,0,0,0,0
Albania,28/02/2010,0,0,0,0,0,0,0,0
Algeria,01/02/2010,18,0,0,0,9,0,0,27
Algeria,02/02/2010,14,0,0,0,3,7,0,24
Algeria,03/02/2010,20,0,0,0,14,2,0,36
Algeria,04/02/2010,11,0,0,0,3,0,0,14
Algeria,05/02/2010,1,0,0,0,0,0,0,1
Algeria,06/02/2010,3,0,0,0,0,0,0,3
Algeria,07/02/2010,12,0,0,0,-2,0,0,10
Algeria,08/02/2010,5,0,0,0,4,0,0,9
Algeria,09/02/2010,10,0,0,0,6,0,0,16
Algeria,10/02/2010,3,0,0,0,0,0,0,3
Algeria,11/02/2010,2,0,0,0,3,0,0,5
Algeria,12/02/2010,1,0,0,0,6,0,0,7
Algeria,13/02/2010,4,0,0,0,0,1,0,5
Algeria,14/02/2010,5,0,0,0,6,2,0,13
Algeria,15/02/2010,3,0,0,0,0,2,0,5
Algeria,16/02/2010,6,0,0,0,5,3,0,14
Algeria,17/02/2010,8,0,0,0,0,1,0,9
Algeria,18/02/2010,9,0,0,0,0,2,0,11
Algeria,19/02/2010,13,0,0,0,9,0,0,22
Algeria,20/02/2010,23,0,0,0,0,1,0,24
Algeria,21/02/2010,3,0,0,0,-8,0,0,-5
Algeria,22/02/2010,-2,0,0,0,2,0,0,0
Algeria,23/02/2010,9,0,0,0,-44,2,0,-33
Algeria,24/02/2010,-7,0,0,0,-14,4,0,-17
Algeria,25/02/2010,23,0,0,0,-2,1,0,22
Algeria,26/02/2010,7,0,0,0,-2,0,0,5
Algeria,27/02/2010,14,0,0,0,0,0,0,14
Algeria,28/02/2010,7,0,0,0,0,0,0,7
Bangladesh,01/02/2010,3,0,0,0,-2,0,0,1
Bangladesh,02/02/2010,27,2,0,0,15,3,0,47
Bangladesh,03/02/2010,20,0,0,0,10,3,0,33
Bangladesh,04/02/2010,9,0,-4,0,-2,4,0,7
Bangladesh,05/02/2010,16,0,1,0,6,0,0,23
Bangladesh,06/02/2010,15,0,0,0,12,10,0,37
Bangladesh,07/02/2010,20,0,0,0,9,4,0,33
Bangladesh,08/02/2010,9,0,0,0,22,6,0,37
Bangladesh,09/02/2010,24,0,0,0,3,0,0,27
Bangladesh,10/02/2010,17,0,0,0,5,1,0,23
Bangladesh,11/02/2010,26,0,0,0,21,-2,0,45
Bangladesh,12/02/2010,3,0,0,0,-2,0,0,1
Bangladesh,13/02/2010,5,0,0,0,0,1,0,6
Bangladesh,14/02/2010,4,0,0,0,6,2,0,12
Bangladesh,15/02/2010,16,0,0,0,7,2,0,25
Bangladesh,16/02/2010,10,0,-2,0,8,2,0,18
Bangladesh,17/02/2010,27,0,0,0,6,1,0,34
Bangladesh,18/02/2010,50,0,0,0,24,4,0,78
Bangladesh,19/02/2010,7,0,0,0,10,2,0,19
Bangladesh,20/02/2010,2,0,0,0,12,3,0,17
Bangladesh,21/02/2010,30,0,0,0,7,1,0,38
Bangladesh,22/02/2010,18,0,1,0,12,2,0,33
Bangladesh,23/02/2010,12,0,0,0,13,14,0,39
Bangladesh,24/02/2010,3,0,1,0,4,1,0,9
Bangladesh,25/02/2010,0,0,1,0,11,0,0,12
Bangladesh,26/02/2010,1,0,0,0,0,0,0,1
Bangladesh,27/02/2010,5,0,0,0,3,1,0,9
Bangladesh,28/02/2010,8,0,-2,0,-2,2,0,6
Cameroon,01/02/2010,4,0,0,0,0,0,0,4
Cameroon,02/02/2010,3,0,0,0,21,0,0,24
Cameroon,03/02/2010,2,0,1,0,0,0,0,3
Cameroon,04/02/2010,2,0,0,0,0,0,0,2
Cameroon,05/02/2010,0,0,0,0,0,0,0,0
Cameroon,06/02/2010,0,0,0,0,0,0,0,0
Cameroon,08/02/2010,0,0,0,0,0,0,0,0
Cameroon,09/02/2010,-1,0,0,0,1,0,0,0
Cameroon,10/02/2010,1,0,0,0,0,0,0,1
Cameroon,11/02/2010,0,0,0,0,-2,0,0,-2
Cameroon,12/02/2010,7,0,0,0,-2,1,0,6
Cameroon,14/02/2010,-1,0,0,0,0,0,0,-1
Cameroon,15/02/2010,-1,0,0,0,3,0,0,2
Cameroon,16/02/2010,4,0,0,0,6,0,0,10
Cameroon,17/02/2010,0,0,0,0,-2,0,0,-2
Cameroon,18/02/2010,14,0,0,0,0,0,0,14
Cameroon,19/02/2010,1,0,0,0,0,0,0,1
Cameroon,20/02/2010,1,0,-2,0,0,0,0,-1
Cameroon,21/02/2010,0,0,0,0,0,0,0,0
Cameroon,22/02/2010,0,0,0,0,0,0,0,0
Cameroon,23/02/2010,1,0,0,0,0,0,0,1
Cameroon,24/02/2010,0,0,0,0,0,0,0,0
Cameroon,25/02/2010,1,0,0,0,0,0,0,1
Cameroon,27/02/2010,0,0,0,0,0,0,0,0
China,01/02/2010,238,0,-2,0,59,21,0,316
China,02/02/2010,190,4,-7,0,53,13,0,253
China,03/02/2010,239,0,-1,0,98,24,0,360
China,04/02/2010,250,4,-3,0,68,20,0,339
China,05/02/2010,132,0,-2,0,82,19,0,231
China,06/02/2010,131,0,-11,0,6,18,0,144
China,07/02/2010,88,0,0,0,25,9,0,122
China,08/02/2010,115,2,-1,0,131,3,0,250
China,09/02/2010,126,8,-3,0,120,10,0,261
China,10/02/2010,143,12,0,0,93,6,0,254
China,11/02/2010,130,6,3,0,135,22,0,296
China,12/02/2010,120,8,-1,0,71,14,0,212
China,13/02/2010,36,6,0,0,27,4,0,73
China,14/02/2010,43,0,1,0,27,9,0,80
China,15/02/2010,98,4,-6,0,45,11,0,152
China,16/02/2010,114,0,0,0,42,9,0,165
China,17/02/2010,212,2,1,0,62,8,0,285
China,18/02/2010,117,4,6,0,39,21,0,187
China,19/02/2010,114,4,-2,0,2,18,0,136
China,20/02/2010,71,0,-3,0,19,9,0,96
China,21/02/2010,81,0,3,0,5,6,0,95
China,22/02/2010,166,0,-3,0,49,11,0,223
China,23/02/2010,131,4,-1,0,19,19,0,172
China,24/02/2010,126,0,1,0,59,13,0,199
China,25/02/2010,53,2,0,0,52,4,0,111
China,26/02/2010,47,0,-4,0,-5,4,0,42
China,27/02/2010,189,2,0,0,35,9,0,235
China,28/02/2010,43,2,0,0,6,1,0,52
Egypt,01/02/2010,29,0,-10,0,3,2,0,24
Egypt,02/02/2010,33,0,-2,0,22,3,0,56
Egypt,03/02/2010,88,0,0,0,9,3,0,100
Egypt,04/02/2010,66,0,0,0,72,6,0,144
Egypt,05/02/2010,23,0,0,0,13,0,0,36
Egypt,06/02/2010,27,0,0,0,0,3,0,30
Egypt,07/02/2010,0,0,0,0,3,4,0,7
Egypt,08/02/2010,81,0,0,0,54,5,0,140
Egypt,09/02/2010,21,0,0,0,22,0,0,43
Egypt,10/02/2010,36,0,0,0,6,0,0,42
Egypt,11/02/2010,33,0,0,0,43,1,0,77
Egypt,12/02/2010,11,0,0,0,12,3,0,26
Egypt,13/02/2010,20,0,0,0,5,2,0,27
Egypt,14/02/2010,71,0,0,0,33,6,0,110
Egypt,15/02/2010,63,0,-3,0,18,5,0,83
Egypt,16/02/2010,44,0,0,0,8,2,0,54
Egypt,17/02/2010,26,0,0,0,1,3,0,30
Egypt,18/02/2010,65,0,0,0,29,7,0,101
Egypt,19/02/2010,28,0,-4,0,1,3,0,28
Egypt,20/02/2010,12,0,-2,0,10,0,0,20
Egypt,21/02/2010,35,0,0,0,3,4,0,42
Egypt,22/02/2010,33,0,0,0,11,0,0,44
Egypt,23/02/2010,35,0,0,0,15,16,0,66
Egypt,24/02/2010,11,0,-2,0,24,7,0,40
Egypt,25/02/2010,10,0,0,0,13,4,0,27
Egypt,26/02/2010,1,0,0,0,0,0,0,1
Egypt,27/02/2010,7,0,-2,0,9,1,0,15
Egypt,28/02/2010,5,0,0,0,12,0,0,17
Eritrea,01/02/2010,11,0,0,0,17,0,0,28
Eritrea,02/02/2010,-3,0,0,0,6,2,0,5
Eritrea,03/02/2010,4,0,0,0,0,4,0,8
Eritrea,04/02/2010,23,0,1,0,18,4,0,46
Eritrea,05/02/2010,6,0,0,0,0,4,0,10
Eritrea,06/02/2010,0,0,0,0,6,0,0,6
Eritrea,07/02/2010,0,0,0,0,0,0,0,0
Eritrea,08/02/2010,6,0,0,0,3,2,0,11
Eritrea,09/02/2010,7,0,0,0,0,0,0,7
Eritrea,10/02/2010,2,0,0,0,-4,0,0,-2
Eritrea,11/02/2010,1,0,0,0,0,1,0,2
Eritrea,12/02/2010,1,0,0,0,0,0,0,1
Eritrea,13/02/2010,0,0,0,0,15,7,0,22
Eritrea,15/02/2010,0,0,0,0,28,0,0,28
Eritrea,16/02/2010,13,0,0,0,11,0,0,24
Eritrea,17/02/2010,11,0,0,0,4,0,0,15
Eritrea,18/02/2010,17,0,0,0,15,1,0,33
Eritrea,19/02/2010,0,0,0,0,0,0,0,0
Eritrea,20/02/2010,12,0,0,0,3,9,0,24
Eritrea,21/02/2010,25,0,0,0,3,0,0,28
Eritrea,22/02/2010,26,0,0,0,3,0,0,29
Eritrea,23/02/2010,33,0,0,0,6,0,0,39
Eritrea,24/02/2010,4,0,0,0,3,2,0,9
Eritrea,27/02/2010,6,0,0,0,0,2,0,8
Eritrea,28/02/2010,1,0,0,0,0,0,0,1
Georgia,01/02/2010,33,0,2,0,27,18,0,80
Georgia,02/02/2010,31,0,-2,0,29,5,0,63
Georgia,03/02/2010,25,0,0,0,19,0,0,44
Georgia,04/02/2010,28,0,0,0,4,4,0,36
Georgia,05/02/2010,17,0,-2,0,18,7,0,40
Georgia,06/02/2010,2,0,0,0,3,1,0,6
Georgia,07/02/2010,15,0,-2,0,9,0,0,22
Georgia,08/02/2010,26,0,-1,0,23,6,0,54
Georgia,09/02/2010,19,2,0,0,15,2,0,38
Georgia,10/02/2010,28,0,0,0,10,6,0,44
Georgia,11/02/2010,37,0,0,0,2,0,0,39
Georgia,12/02/2010,64,2,0,0,26,9,0,101
Georgia,13/02/2010,47,0,0,0,27,15,0,89
Georgia,14/02/2010,17,0,0,0,-1,2,0,18
Georgia,15/02/2010,13,0,0,0,-6,1,0,8
Georgia,16/02/2010,50,2,1,0,14,3,0,70
Georgia,17/02/2010,12,0,0,0,6,0,0,18
Georgia,18/02/2010,28,0,0,0,50,0,0,78
Georgia,19/02/2010,28,2,0,0,15,4,0,49
Georgia,20/02/2010,19,0,0,0,15,0,0,34
Georgia,21/02/2010,20,0,0,0,4,2,0,26
Georgia,22/02/2010,31,0,-1,0,21,4,0,55
Georgia,23/02/2010,23,0,1,0,28,4,0,56
Georgia,24/02/2010,6,0,1,0,12,2,0,21
Georgia,25/02/2010,7,0,0,0,-3,1,0,5
Georgia,26/02/2010,-1,0,0,0,0,0,0,-1
Georgia,27/02/2010,-3,0,0,0,3,6,0,6
Georgia,28/02/2010,2,0,0,0,-2,8,0,8
India,01/02/2010,60,0,-1,0,8,4,0,71
India,02/02/2010,69,0,-1,0,21,12,0,101
India,03/02/2010,49,0,-4,0,30,14,0,89
India,04/02/2010,53,2,-2,0,-3,5,0,55
India,05/02/2010,48,4,-9,0,28,4,0,75
India,06/02/2010,66,2,-2,0,21,5,0,92
India,07/02/2010,43,2,1,0,20,10,0,76
India,08/02/2010,143,2,0,0,22,4,0,171
India,09/02/2010,87,2,0,0,12,4,0,105
India,10/02/2010,77,0,-1,0,26,2,0,104
India,11/02/2010,74,0,-8,0,16,10,0,92
India,12/02/2010,56,0,1,0,29,5,0,91
India,13/02/2010,80,0,2,0,23,4,0,109
India,14/02/2010,56,0,1,0,3,8,0,68
India,15/02/2010,151,0,-3,0,21,7,0,176
India,16/02/2010,61,4,4,0,17,8,0,94
India,17/02/2010,75,6,1,0,25,9,0,116
India,18/02/2010,61,0,-2,0,47,6,0,112
India,19/02/2010,79,0,0,0,8,16,0,103
India,20/02/2010,63,2,-2,0,12,1,0,76
India,21/02/2010,45,0,0,0,4,-2,0,47
India,22/02/2010,55,0,3,0,45,6,0,109
India,23/02/2010,42,2,-5,0,11,12,0,62
India,24/02/2010,35,4,-4,0,29,9,0,73
India,25/02/2010,13,0,0,0,0,1,0,14
India,26/02/2010,57,0,0,0,6,10,0,73
India,27/02/2010,36,0,1,0,4,10,0,51
India,28/02/2010,17,0,0,0,3,0,0,20
Iran,01/02/2010,175,6,1,0,18,18,0,218
Iran,02/02/2010,256,0,-6,0,31,20,0,301
Iran,03/02/2010,190,2,1,0,82,33,0,308
Iran,04/02/2010,108,2,1,0,55,31,0,197
Iran,05/02/2010,59,2,-2,0,25,21,0,105
Iran,06/02/2010,57,0,-2,0,15,10,0,80
Iran,07/02/2010,70,0,-1,0,19,14,0,102
Iran,08/02/2010,119,0,-1,0,71,7,0,196
Iran,09/02/2010,120,0,1,0,31,7,0,159
Iran,10/02/2010,85,0,-2,0,64,15,0,162
Iran,11/02/2010,178,0,1,0,119,48,0,346
Iran,12/02/2010,175,0,-4,0,100,17,0,288
Iran,13/02/2010,64,0,1,0,42,21,0,128
Iran,14/02/2010,122,2,1,0,13,15,0,153
Iran,15/02/2010,189,0,4,0,18,14,0,225
Iran,16/02/2010,156,2,2,0,41,11,0,212
Iran,17/02/2010,142,2,2,0,63,19,0,228
Iran,18/02/2010,110,2,0,0,43,16,0,171
Iran,19/02/2010,61,0,-10,0,42,15,0,108
Iran,20/02/2010,44,4,1,0,22,5,0,76
Iran,21/02/2010,64,2,1,0,27,19,0,113
Iran,22/02/2010,126,0,1,0,34,13,0,174
Iran,23/02/2010,139,0,3,0,101,26,0,269
Iran,24/02/2010,64,0,0,0,29,4,0,97
Iran,25/02/2010,13,0,0,0,22,1,0,36
Iran,26/02/2010,11,0,0,0,3,-1,0,13
Iran,27/02/2010,61,0,0,0,22,3,0,86
Iran,28/02/2010,25,0,-1,0,30,39,0,93
Iraq,01/02/2010,86,4,6,0,7,12,0,115
Iraq,02/02/2010,149,0,-11,0,113,26,0,277
Iraq,03/02/2010,112,2,0,0,67,-3,0,178
Iraq,04/02/2010,85,0,3,0,47,6,0,141
Iraq,05/02/2010,81,0,-4,0,24,10,0,111
Iraq,06/02/2010,50,0,0,0,22,5,0,77
Iraq,07/02/2010,49,0,1,0,25,7,0,82
Iraq,08/02/2010,118,0,-2,0,67,9,0,192
Iraq,09/02/2010,104,0,-1,0,27,18,0,148
Iraq,10/02/2010,127,0,3,0,44,15,0,189
Iraq,11/02/2010,98,0,2,0,42,6,0,148
Iraq,12/02/2010,48,0,3,0,39,21,0,111
Iraq,13/02/2010,85,2,0,0,47,10,0,144
Iraq,14/02/2010,115,0,0,0,31,11,0,157
Iraq,15/02/2010,120,0,2,0,59,17,0,198
Iraq,16/02/2010,206,0,1,0,90,38,0,335
Iraq,17/02/2010,96,0,0,0,14,12,0,122
Iraq,18/02/2010,124,0,1,0,32,56,0,213
Iraq,19/02/2010,85,4,0,0,16,32,0,137
Iraq,20/02/2010,65,2,0,0,10,16,0,93
Iraq,21/02/2010,69,6,-1,0,26,20,0,120
Iraq,22/02/2010,70,0,1,0,11,11,0,93
Iraq,23/02/2010,177,0,-3,0,13,15,0,202
Iraq,24/02/2010,104,2,0,0,15,6,0,127
Iraq,25/02/2010,21,0,0,0,7,0,0,28
Iraq,26/02/2010,15,0,0,0,9,4,0,28
Iraq,27/02/2010,43,0,1,0,0,10,0,54
Iraq,28/02/2010,39,0,-1,0,18,2,0,58
Morocco,01/02/2010,18,0,0,0,15,0,0,33
Morocco,02/02/2010,24,0,0,0,18,0,0,42
Morocco,03/02/2010,16,0,0,0,28,3,0,47
Morocco,04/02/2010,7,0,0,0,3,0,0,10
Morocco,05/02/2010,2,0,0,0,0,2,0,4
Morocco,06/02/2010,7,0,0,0,6,0,0,13
Morocco,07/02/2010,0,0,0,0,0,0,0,0
Morocco,08/02/2010,0,0,0,0,6,0,0,6
Morocco,09/02/2010,-1,0,0,0,7,0,0,6
Morocco,10/02/2010,-1,0,3,0,38,0,0,40
Morocco,11/02/2010,5,0,0,0,15,0,0,20
Morocco,12/02/2010,16,0,0,0,10,0,0,26
Morocco,13/02/2010,8,0,0,0,0,0,0,8
Morocco,14/02/2010,-1,0,0,0,0,0,0,-1
Morocco,15/02/2010,70,0,0,0,12,5,0,87
Morocco,16/02/2010,3,2,0,0,0,0,0,5
Morocco,17/02/2010,8,0,0,0,12,0,0,20
Morocco,18/02/2010,6,0,0,0,9,1,0,16
Morocco,19/02/2010,18,0,0,0,16,0,0,34
Morocco,20/02/2010,0,0,0,0,27,2,0,29
Morocco,21/02/2010,0,0,0,0,0,0,0,0
Morocco,22/02/2010,5,0,0,0,5,0,0,10
Morocco,23/02/2010,3,0,0,0,9,0,0,12
Morocco,24/02/2010,0,0,0,0,9,0,0,9
Morocco,25/02/2010,2,0,0,0,0,0,0,2
Morocco,26/02/2010,0,0,0,0,0,0,0,0
Morocco,27/02/2010,10,0,0,0,4,0,0,14
Morocco,28/02/2010,2,0,0,0,0,0,0,2
Nigeria,01/02/2010,82,0,1,0,39,11,0,133
Nigeria,02/02/2010,62,2,-2,0,26,8,0,96
Nigeria,03/02/2010,79,0,-2,0,38,13,0,128
Nigeria,04/02/2010,63,0,-8,0,34,1,0,90
Nigeria,05/02/2010,26,6,1,0,30,1,0,64
Nigeria,06/02/2010,17,0,0,0,-4,2,0,15
Nigeria,07/02/2010,48,0,-2,0,8,4,0,58
Nigeria,08/02/2010,26,0,0,0,4,4,0,34
Nigeria,09/02/2010,43,0,-10,0,6,6,0,45
Nigeria,10/02/2010,77,0,0,0,11,4,0,92
Nigeria,11/02/2010,53,4,1,0,26,11,0,95
Nigeria,12/02/2010,28,0,-6,0,3,7,0,32
Nigeria,13/02/2010,23,0,-1,0,13,4,0,39
Nigeria,14/02/2010,35,0,1,0,4,4,0,44
Nigeria,15/02/2010,34,0,2,0,16,5,0,57
Nigeria,16/02/2010,15,0,0,0,-2,4,0,17
Nigeria,17/02/2010,16,0,-4,0,35,0,0,47
Nigeria,18/02/2010,50,0,0,0,4,4,0,58
Nigeria,19/02/2010,36,0,-1,0,20,4,0,59
Nigeria,20/02/2010,40,0,0,0,16,1,0,57
Nigeria,21/02/2010,19,0,0,0,1,1,0,21
Nigeria,22/02/2010,14,2,-7,0,25,8,0,42
Nigeria,23/02/2010,13,0,0,0,15,7,0,35
Nigeria,24/02/2010,13,0,0,0,12,10,0,35
Nigeria,25/02/2010,20,0,-1,0,0,0,0,19
Nigeria,26/02/2010,5,0,0,0,3,1,0,9
Nigeria,27/02/2010,14,0,0,0,1,5,0,20
Nigeria,28/02/2010,3,0,0,0,0,0,0,3
Pakistan,01/02/2010,59,12,1,0,20,4,0,96
Pakistan,02/02/2010,93,8,0,0,28,3,0,132
Pakistan,03/02/2010,161,0,0,0,48,17,0,226
Pakistan,04/02/2010,181,0,0,0,26,19,0,226
Pakistan,05/02/2010,77,2,-5,0,46,17,0,137
Pakistan,06/02/2010,84,2,0,0,-7,20,0,99
Pakistan,07/02/2010,54,0,0,0,54,12,0,120
Pakistan,08/02/2010,77,10,0,0,48,9,0,144
Pakistan,09/02/2010,51,0,0,0,36,22,0,109
Pakistan,10/02/2010,130,0,-1,0,154,35,0,318
Pakistan,11/02/2010,304,0,0,0,90,19,0,413
Pakistan,12/02/2010,154,0,-2,0,49,26,0,227
Pakistan,13/02/2010,137,0,2,0,39,14,0,192
Pakistan,14/02/2010,211,0,0,0,38,17,0,266
Pakistan,15/02/2010,122,0,-1,0,48,15,0,184
Pakistan,16/02/2010,155,2,-2,0,134,12,0,301
Pakistan,17/02/2010,170,2,0,0,155,9,0,336
Pakistan,18/02/2010,139,0,0,0,90,19,0,248
Pakistan,19/02/2010,99,0,-2,0,90,10,0,197
Pakistan,20/02/2010,41,0,-4,0,89,9,0,135
Pakistan,21/02/2010,122,0,4,0,47,14,0,187
Pakistan,22/02/2010,137,0,-4,0,71,38,0,242
Pakistan,23/02/2010,106,0,-20,0,156,21,0,263
Pakistan,24/02/2010,75,0,-1,0,77,7,0,158
Pakistan,25/02/2010,97,0,3,0,61,10,0,171
Pakistan,26/02/2010,93,0,3,0,74,12,0,182
Pakistan,27/02/2010,131,0,3,0,38,22,0,194
Pakistan,28/02/2010,65,0,2,0,24,0,0,91
Sierra Leone,01/02/2010,0,0,0,0,0,0,0,0
Sierra Leone,02/02/2010,0,0,0,0,0,0,0,0
Sierra Leone,03/02/2010,1,0,0,0,0,0,0,1
Sierra Leone,04/02/2010,2,0,0,0,6,0,0,8
Sierra Leone,05/02/2010,6,0,0,0,15,0,0,21
Sierra Leone,06/02/2010,-1,0,0,0,24,2,0,25
Sierra Leone,07/02/2010,0,0,0,0,-1,0,0,-1
Sierra Leone,08/02/2010,3,0,0,0,12,0,0,15
Sierra Leone,09/02/2010,4,0,-2,0,-4,0,0,-2
Sierra Leone,10/02/2010,0,0,0,0,-4,0,0,-4
Sierra Leone,11/02/2010,4,0,0,0,0,0,0,4
Sierra Leone,12/02/2010,3,0,0,0,3,0,0,6
Sierra Leone,13/02/2010,4,0,0,0,0,0,0,4
Sierra Leone,14/02/2010,0,0,0,0,0,0,0,0
Sierra Leone,15/02/2010,0,0,0,0,0,0,0,0
Sierra Leone,16/02/2010,3,0,0,0,0,0,0,3
Sierra Leone,17/02/2010,3,0,0,0,0,0,0,3
Sierra Leone,18/02/2010,0,0,0,0,6,0,0,6
Sierra Leone,19/02/2010,0,0,0,0,0,0,0,0
Sierra Leone,21/02/2010,2,0,0,0,12,0,0,14
Sierra Leone,22/02/2010,-1,0,0,0,12,0,0,11
Sierra Leone,23/02/2010,2,0,-1,0,4,4,0,9
Sierra Leone,24/02/2010,7,0,0,0,0,0,0,7
Sierra Leone,25/02/2010,3,0,0,0,15,0,0,18
Sierra Leone,26/02/2010,1,0,0,0,6,4,0,11
Sierra Leone,27/02/2010,0,0,0,0,3,0,0,3
Sierra Leone,28/02/2010,0,0,0,0,0,0,0,0
Somalia,01/02/2010,72,2,-2,0,-4,10,0,78
Somalia,02/02/2010,28,2,0,0,-39,3,0,-6
Somalia,03/02/2010,15,0,0,0,51,0,0,66
Somalia,04/02/2010,13,2,4,0,-2,7,0,24
Somalia,05/02/2010,29,0,0,0,28,1,0,58
Somalia,06/02/2010,25,0,0,0,-5,1,0,21
Somalia,07/02/2010,14,0,0,0,7,2,0,23
Somalia,08/02/2010,20,8,0,0,15,0,0,43
Somalia,09/02/2010,85,6,0,0,-30,3,0,64
Somalia,10/02/2010,54,0,0,0,42,4,0,100
Somalia,11/02/2010,42,8,0,0,-12,2,0,40
Somalia,12/02/2010,2,0,0,0,-1,2,0,3
Somalia,13/02/2010,6,0,0,0,-2,2,0,6
Somalia,14/02/2010,9,0,0,0,-3,0,0,6
Somalia,15/02/2010,38,0,-2,0,20,4,0,60
Somalia,16/02/2010,45,0,0,0,6,0,0,51
Somalia,17/02/2010,46,0,0,0,18,1,0,65
Somalia,18/02/2010,34,0,0,0,10,0,0,44
Somalia,19/02/2010,7,0,0,0,7,0,0,14
Somalia,20/02/2010,10,0,0,0,13,0,0,23
Somalia,21/02/2010,19,0,0,0,0,0,0,19
Somalia,22/02/2010,14,0,0,0,13,1,0,28
Somalia,23/02/2010,39,0,0,0,21,0,0,60
Somalia,24/02/2010,9,2,0,0,4,0,0,15
Somalia,25/02/2010,2,0,0,0,0,0,0,2
Somalia,26/02/2010,0,0,0,0,-4,1,0,-3
Somalia,27/02/2010,27,0,0,0,-23,0,0,4
Somalia,28/02/2010,13,0,0,0,-25,2,0,-10
Syria,01/02/2010,14,0,0,0,27,0,0,41
Syria,02/02/2010,14,0,0,0,39,0,0,53
Syria,03/02/2010,3,0,0,0,12,4,0,19
Syria,04/02/2010,62,0,0,0,1,2,0,65
Syria,05/02/2010,61,0,-2,0,5,1,0,65
Syria,06/02/2010,7,0,-4,0,0,2,0,5
Syria,07/02/2010,6,0,0,0,3,0,0,9
Syria,08/02/2010,25,0,0,0,0,0,0,25
Syria,09/02/2010,20,0,0,0,18,0,0,38
Syria,10/02/2010,18,2,0,0,12,3,0,35
Syria,11/02/2010,15,0,0,0,1,0,0,16
Syria,12/02/2010,3,0,0,0,3,4,0,10
Syria,13/02/2010,10,0,0,0,0,2,0,12
Syria,14/02/2010,51,0,1,0,6,0,0,58
Syria,15/02/2010,24,0,2,0,18,0,0,44
Syria,16/02/2010,2,0,0,0,12,2,0,16
Syria,17/02/2010,20,0,0,0,14,7,0,41
Syria,18/02/2010,11,0,0,0,39,1,0,51
Syria,19/02/2010,11,0,0,0,21,0,0,32
Syria,20/02/2010,5,0,0,0,6,5,0,16
Syria,21/02/2010,18,0,0,0,0,0,0,18
Syria,22/02/2010,20,0,0,0,12,2,0,34
Syria,23/02/2010,30,0,0,0,19,2,0,51
Syria,24/02/2010,20,0,0,0,9,2,0,31
Syria,25/02/2010,-5,0,0,0,9,0,0,4
Syria,26/02/2010,0,0,0,0,0,0,0,0
Syria,27/02/2010,9,0,0,0,3,3,0,15
Syria,28/02/2010,22,0,0,0,0,0,0,22
Yemen,01/02/2010,65,6,0,0,6,1,0,78
Yemen,02/02/2010,60,2,0,0,-5,6,0,63
Yemen,03/02/2010,80,0,0,0,14,6,0,100
Yemen,04/02/2010,41,0,0,0,10,7,0,58
Yemen,05/02/2010,21,2,0,0,22,1,0,46
Yemen,06/02/2010,36,0,0,0,37,6,0,79
Yemen,07/02/2010,28,0,0,0,14,3,0,45
Yemen,08/02/2010,127,4,0,0,10,18,0,159
Yemen,09/02/2010,48,0,0,0,15,0,0,63
Yemen,10/02/2010,24,0,0,0,4,3,0,31
Yemen,11/02/2010,-9,0,0,0,8,2,0,1
Yemen,12/02/2010,38,0,0,0,4,2,0,44
Yemen,13/02/2010,21,0,0,0,-2,0,0,19
Yemen,14/02/2010,15,0,2,0,0,1,0,18
Yemen,15/02/2010,57,2,0,0,-10,0,0,49
Yemen,16/02/2010,50,2,0,0,15,1,0,68
Yemen,17/02/2010,33,2,0,0,16,0,0,51
Yemen,18/02/2010,11,0,0,0,-16,2,0,-3
Yemen,19/02/2010,42,0,0,0,4,3,0,49
Yemen,20/02/2010,29,0,0,0,15,6,0,50
Yemen,21/02/2010,10,0,0,0,1,0,0,11
Yemen,22/02/2010,17,0,0,0,12,0,0,29
Yemen,23/02/2010,32,0,0,0,-8,0,0,24
Yemen,24/02/2010,5,0,0,0,8,0,0,13
Yemen,25/02/2010,3,0,0,0,0,0,0,3
Yemen,26/02/2010,6,0,0,0,0,0,0,6
Yemen,27/02/2010,6,0,0,0,3,1,0,10
Yemen,28/02/2010,3,0,0,0,15,2,0,20
Afghanistan,01/02/2012,414,2,-1,0,24,26,0,465
Afghanistan,02/02/2012,205,2,-1,0,8,27,0,241
Afghanistan,03/02/2012,71,0,0,0,25,5,0,101
Afghanistan,04/02/2012,246,0,4,0,55,33,0,338
Afghanistan,05/02/2012,207,2,0,0,42,60,0,311
Afghanistan,06/02/2012,190,0,5,0,25,13,0,233
Afghanistan,07/02/2012,181,2,-16,0,9,10,0,186
Afghanistan,08/02/2012,275,0,-8,0,28,11,0,306
Afghanistan,09/02/2012,430,0,0,0,50,9,0,489
Afghanistan,10/02/2012,335,0,-6,0,78,41,0,448
Afghanistan,11/02/2012,160,0,-1,0,18,7,0,184
Afghanistan,12/02/2012,240,2,-2,0,116,7,0,363
Afghanistan,13/02/2012,127,0,2,0,42,18,0,189
Afghanistan,14/02/2012,62,6,-2,0,50,10,0,126
Afghanistan,15/02/2012,134,6,1,0,37,20,0,198
Afghanistan,16/02/2012,179,2,3,0,17,7,0,208
Afghanistan,17/02/2012,256,2,-2,0,37,49,0,342
Afghanistan,18/02/2012,172,14,0,0,24,7,0,217
Afghanistan,19/02/2012,167,4,0,0,25,24,0,220
Afghanistan,20/02/2012,227,0,-6,0,42,59,0,322
Afghanistan,21/02/2012,99,4,0,0,16,40,0,159
Afghanistan,22/02/2012,104,0,0,0,28,13,0,145
Afghanistan,23/02/2012,277,4,-4,0,33,49,0,359
Afghanistan,24/02/2012,302,0,1,0,79,65,0,447
Afghanistan,25/02/2012,273,0,0,0,29,38,0,340
Afghanistan,26/02/2012,286,2,1,0,34,34,0,357
Afghanistan,27/02/2012,244,2,0,0,18,49,0,313
Afghanistan,28/02/2012,220,0,0,0,10,8,0,238
Afghanistan,29/02/2012,165,4,0,0,44,35,0,248
Albania,01/02/2012,4,0,-1,0,-2,5,0,6
Albania,02/02/2012,5,0,0,0,0,1,0,6
Albania,03/02/2012,-1,0,0,0,0,2,0,1
Albania,04/02/2012,24,0,0,0,3,4,0,31
Albania,05/02/2012,5,0,0,0,0,2,0,7
Albania,06/02/2012,13,0,-1,0,3,2,0,17
Albania,07/02/2012,0,0,0,0,6,0,0,6
Albania,08/02/2012,4,0,0,0,0,0,0,4
Albania,09/02/2012,5,0,0,0,1,3,0,9
Albania,10/02/2012,52,0,0,0,6,6,0,64
Albania,11/02/2012,0,0,0,0,3,0,0,3
Albania,12/02/2012,6,0,0,0,0,0,0,6
Albania,13/02/2012,2,2,-1,0,0,4,0,7
Albania,14/02/2012,30,0,2,0,6,5,0,43
Albania,15/02/2012,12,0,2,0,6,1,0,21
Albania,16/02/2012,21,0,0,0,0,4,0,25
Albania,17/02/2012,7,0,0,0,0,2,0,9
Albania,18/02/2012,6,0,0,0,-1,0,0,5
Albania,19/02/2012,10,0,0,0,12,0,0,22
Albania,20/02/2012,37,0,0,0,3,4,0,44
Albania,21/02/2012,26,0,0,0,3,2,0,31
Albania,22/02/2012,4,0,1,0,0,1,0,6
Albania,23/02/2012,13,0,0,0,-4,0,0,9
Albania,24/02/2012,2,0,0,0,0,0,0,2
Albania,25/02/2012,0,0,0,0,0,0,0,0
Albania,26/02/2012,3,0,0,0,0,0,0,3
Albania,27/02/2012,7,0,-4,0,0,0,0,3
Albania,28/02/2012,2,0,-1,0,7,5,0,13
Albania,29/02/2012,8,0,0,0,0,0,0,8
Algeria,01/02/2012,15,0,0,0,3,2,0,20
Algeria,02/02/2012,20,0,0,0,40,2,0,62
Algeria,03/02/2012,5,0,0,0,0,0,0,5
Algeria,04/02/2012,8,0,0,0,7,0,0,15
Algeria,05/02/2012,9,0,0,0,-2,0,0,7
Algeria,06/02/2012,30,0,0,0,0,2,0,32
Algeria,07/02/2012,4,0,2,0,-4,0,0,2
Algeria,08/02/2012,31,0,-2,0,0,0,0,29
Algeria,09/02/2012,14,0,0,0,4,0,0,18
Algeria,10/02/2012,2,0,0,0,7,1,0,10
Algeria,11/02/2012,0,0,-6,0,3,0,0,-3
Algeria,12/02/2012,8,0,0,0,0,0,0,8
Algeria,13/02/2012,46,0,0,0,48,0,0,94
Algeria,14/02/2012,13,0,0,0,27,0,0,40
Algeria,15/02/2012,10,0,0,0,9,3,0,22
Algeria,16/02/2012,4,0,0,0,6,0,0,10
Algeria,17/02/2012,-1,0,0,0,0,0,0,-1
Algeria,18/02/2012,20,0,0,0,9,1,0,30
Algeria,19/02/2012,19,0,0,0,0,0,0,19
Algeria,20/02/2012,4,0,0,0,9,2,0,15
Algeria,21/02/2012,24,0,0,0,6,1,0,31
Algeria,22/02/2012,27,0,0,0,15,0,0,42
Algeria,23/02/2012,3,0,1,0,6,0,0,10
Algeria,24/02/2012,9,0,1,0,-5,0,0,5
Algeria,25/02/2012,-16,0,-2,0,-4,0,0,-22
Algeria,26/02/2012,2,0,-3,0,0,0,0,-1
Algeria,27/02/2012,5,0,0,0,0,0,0,5
Algeria,28/02/2012,4,0,0,0,0,0,0,4
Algeria,29/02/2012,8,0,2,0,7,0,0,17
Bangladesh,01/02/2012,-1,6,0,0,9,3,0,17
Bangladesh,02/02/2012,4,0,0,0,22,2,0,28
Bangladesh,03/02/2012,6,0,0,0,-4,0,0,2
Bangladesh,04/02/2012,10,2,0,0,4,0,0,16
Bangladesh,05/02/2012,9,0,0,0,1,7,0,17
Bangladesh,06/02/2012,12,0,0,0,-3,10,0,19
Bangladesh,07/02/2012,22,0,0,0,15,12,0,49
Bangladesh,08/02/2012,10,0,-2,0,12,11,0,31
Bangladesh,09/02/2012,38,2,0,0,-5,8,0,43
Bangladesh,10/02/2012,8,0,0,0,4,1,0,13
Bangladesh,11/02/2012,14,0,0,0,1,0,0,15
Bangladesh,12/02/2012,0,0,-2,0,3,1,0,2
Bangladesh,13/02/2012,33,0,-1,0,0,4,0,36
Bangladesh,14/02/2012,14,0,1,0,0,1,0,16
Bangladesh,15/02/2012,14,2,0,0,3,0,0,19
Bangladesh,16/02/2012,26,2,0,0,15,2,0,45
Bangladesh,17/02/2012,11,0,0,0,15,4,0,30
Bangladesh,18/02/2012,12,0,0,0,7,3,0,22
Bangladesh,19/02/2012,14,0,0,0,0,2,0,16
Bangladesh,20/02/2012,10,0,4,0,0,1,0,15
Bangladesh,21/02/2012,13,0,0,0,13,3,0,29
Bangladesh,22/02/2012,10,0,0,0,3,3,0,16
Bangladesh,23/02/2012,27,0,-2,0,23,3,0,51
Bangladesh,24/02/2012,6,0,0,0,13,4,0,23
Bangladesh,25/02/2012,26,0,-2,0,0,11,0,35
Bangladesh,26/02/2012,8,0,0,0,0,7,0,15
Bangladesh,27/02/2012,1,0,2,0,6,1,0,10
Bangladesh,28/02/2012,8,0,0,0,20,2,0,30
Bangladesh,29/02/2012,5,0,0,0,6,0,0,11
Cameroon,01/02/2012,14,0,0,0,0,0,0,14
Cameroon,02/02/2012,0,0,0,0,0,0,0,0
Cameroon,04/02/2012,2,0,1,0,3,2,0,8
Cameroon,05/02/2012,0,0,0,0,0,0,0,0
Cameroon,06/02/2012,0,0,0,0,0,0,0,0
Cameroon,07/02/2012,8,0,0,0,0,0,0,8
Cameroon,08/02/2012,3,0,0,0,0,0,0,3
Cameroon,09/02/2012,11,0,0,0,6,0,0,17
Cameroon,10/02/2012,0,0,0,0,42,0,0,42
Cameroon,11/02/2012,0,0,0,0,0,1,0,1
Cameroon,12/02/2012,0,0,0,0,0,0,0,0
Cameroon,13/02/2012,0,0,0,0,0,0,0,0
Cameroon,14/02/2012,-1,0,0,0,0,0,0,-1
Cameroon,15/02/2012,0,0,0,0,0,0,0,0
Cameroon,16/02/2012,4,0,0,0,0,0,0,4
Cameroon,17/02/2012,3,0,0,0,3,1,0,7
Cameroon,18/02/2012,17,0,0,0,0,0,0,17
Cameroon,19/02/2012,-12,0,0,0,0,0,0,-12
Cameroon,20/02/2012,2,0,0,0,3,0,0,5
Cameroon,21/02/2012,23,0,0,0,0,0,0,23
Cameroon,22/02/2012,8,0,0,0,0,0,0,8
Cameroon,23/02/2012,3,0,0,0,0,0,0,3
Cameroon,24/02/2012,16,0,0,0,0,0,0,16
Cameroon,25/02/2012,0,0,0,0,0,0,0,0
Cameroon,26/02/2012,11,0,0,0,0,0,0,11
Cameroon,27/02/2012,0,0,0,0,0,0,0,0
Cameroon,28/02/2012,12,0,0,0,2,0,0,14
Cameroon,29/02/2012,6,0,0,0,3,0,0,9
China,01/02/2012,173,0,3,0,95,36,0,307
China,02/02/2012,197,6,-2,0,71,21,0,293
China,03/02/2012,27,0,1,0,5,10,0,43
China,04/02/2012,197,4,-17,0,36,22,0,242
China,05/02/2012,219,14,-27,0,27,49,0,282
China,06/02/2012,311,0,-17,0,90,35,0,419
China,07/02/2012,302,2,-47,0,23,41,0,321
China,08/02/2012,195,4,-16,0,157,36,0,376
China,09/02/2012,169,2,-8,0,62,20,0,245
China,10/02/2012,223,8,-2,0,81,37,0,347
China,11/02/2012,109,0,3,0,8,26,0,146
China,12/02/2012,137,2,-12,0,23,22,0,172
China,13/02/2012,301,2,-8,0,45,28,0,368
China,14/02/2012,135,6,0,0,128,27,0,296
China,15/02/2012,107,8,2,0,23,27,0,167
China,16/02/2012,210,4,-17,0,69,27,0,293
China,17/02/2012,206,2,-15,0,58,23,0,274
China,18/02/2012,152,0,0,0,9,15,0,176
China,19/02/2012,243,2,-3,0,38,11,0,291
China,20/02/2012,124,0,-4,0,61,20,0,201
China,21/02/2012,225,4,1,0,53,32,0,315
China,22/02/2012,194,2,-7,0,92,38,0,319
China,23/02/2012,214,0,-7,0,47,48,0,302
China,24/02/2012,275,10,-8,0,51,32,0,360
China,25/02/2012,122,8,-3,0,39,15,0,181
China,26/02/2012,100,0,-15,0,35,21,0,141
China,27/02/2012,170,12,-24,0,50,22,0,230
China,28/02/2012,240,6,-11,0,38,41,0,314
China,29/02/2012,255,6,1,0,68,54,0,384
Egypt,01/02/2012,47,0,0,0,37,13,0,97
Egypt,02/02/2012,88,12,-7,0,98,18,0,209
Egypt,03/02/2012,23,8,0,0,12,3,0,46
Egypt,04/02/2012,26,0,0,0,62,2,0,90
Egypt,05/02/2012,76,0,0,0,55,7,0,138
Egypt,06/02/2012,109,0,-3,0,72,14,0,192
Egypt,07/02/2012,84,0,-4,0,36,12,0,128
Egypt,08/02/2012,58,0,-1,0,56,22,0,135
Egypt,09/02/2012,83,0,-1,0,63,26,0,171
Egypt,10/02/2012,52,0,-11,0,61,12,0,114
Egypt,11/02/2012,84,0,-6,0,29,9,0,116
Egypt,12/02/2012,45,0,0,0,-5,4,0,44
Egypt,13/02/2012,50,0,-8,0,3,18,0,63
Egypt,14/02/2012,62,8,0,0,4,16,0,90
Egypt,15/02/2012,53,2,-3,0,-5,2,0,49
Egypt,16/02/2012,65,0,3,0,38,13,0,119
Egypt,17/02/2012,52,2,-5,0,11,10,0,70
Egypt,18/02/2012,35,0,-2,0,25,7,0,65
Egypt,19/02/2012,50,2,-8,0,-1,2,0,45
Egypt,20/02/2012,50,2,-9,0,20,3,0,66
Egypt,21/02/2012,47,2,-4,0,36,13,0,94
Egypt,22/02/2012,137,0,0,0,84,10,0,231
Egypt,23/02/2012,42,0,-11,0,44,6,0,81
Egypt,24/02/2012,48,0,0,0,24,6,0,78
Egypt,25/02/2012,62,0,0,0,10,7,0,79
Egypt,26/02/2012,35,2,0,0,30,13,0,80
Egypt,27/02/2012,60,0,0,0,18,7,0,85
Egypt,28/02/2012,80,2,4,0,81,10,0,177
Egypt,29/02/2012,74,0,-1,0,112,15,0,200
Eritrea,01/02/2012,1,0,0,0,2,4,0,7
Eritrea,03/02/2012,3,0,0,0,0,0,0,3
Eritrea,05/02/2012,6,0,0,0,6,0,0,12
Eritrea,07/02/2012,1,0,0,0,0,0,0,1
Eritrea,08/02/2012,0,0,0,0,0,0,0,0
Eritrea,09/02/2012,0,0,0,0,0,0,0,0
Eritrea,10/02/2012,0,0,0,0,0,0,0,0
Eritrea,11/02/2012,0,0,0,0,0,0,0,0
Eritrea,12/02/2012,0,0,0,0,0,0,0,0
Eritrea,14/02/2012,2,0,0,0,6,0,0,8
Eritrea,15/02/2012,0,0,0,0,0,0,0,0
Eritrea,16/02/2012,0,8,0,0,3,0,0,11
Eritrea,17/02/2012,0,4,0,0,-1,0,0,3
Eritrea,18/02/2012,0,0,0,0,0,0,0,0
Eritrea,20/02/2012,8,0,0,0,18,0,0,26
Eritrea,21/02/2012,4,0,0,0,15,0,0,19
Eritrea,22/02/2012,4,0,0,0,3,3,0,10
Eritrea,23/02/2012,-1,0,0,0,3,1,0,3
Eritrea,24/02/2012,4,0,0,0,3,0,0,7
Eritrea,26/02/2012,3,0,0,0,0,0,0,3
Eritrea,27/02/2012,2,0,0,0,0,0,0,2
Eritrea,28/02/2012,6,0,0,0,-2,0,0,4
Eritrea,29/02/2012,0,0,0,0,0,0,0,0
Georgia,01/02/2012,33,2,0,0,33,4,0,72
Georgia,02/02/2012,54,2,-6,0,20,8,0,78
Georgia,03/02/2012,2,2,0,0,-2,2,0,4
Georgia,04/02/2012,20,0,0,0,9,3,0,32
Georgia,05/02/2012,34,2,0,0,27,3,0,66
Georgia,06/02/2012,49,2,2,0,32,3,0,88
Georgia,07/02/2012,62,0,-41,0,54,10,0,85
Georgia,08/02/2012,87,0,-8,0,43,12,0,134
Georgia,09/02/2012,24,0,-4,0,36,15,0,71
Georgia,10/02/2012,58,0,1,0,40,5,0,104
Georgia,11/02/2012,20,0,0,0,41,0,0,61
Georgia,12/02/2012,22,2,-6,0,6,0,0,24
Georgia,13/02/2012,78,0,-1,0,35,9,0,121
Georgia,14/02/2012,52,2,2,0,61,19,0,136
Georgia,15/02/2012,76,0,0,0,53,12,0,141
Georgia,16/02/2012,73,0,0,0,34,7,0,114
Georgia,17/02/2012,41,0,-3,0,37,13,0,88
Georgia,18/02/2012,45,0,0,0,32,8,0,85
Georgia,19/02/2012,32,0,0,0,27,7,0,66
Georgia,20/02/2012,30,2,-1,0,45,10,0,86
Georgia,21/02/2012,126,0,-5,0,28,8,0,157
Georgia,22/02/2012,189,8,-8,0,38,16,0,243
Georgia,23/02/2012,91,0,-3,0,11,6,0,105
Georgia,24/02/2012,54,4,-2,0,15,5,0,76
Georgia,25/02/2012,32,0,0,0,10,4,0,46
Georgia,26/02/2012,14,0,0,0,9,0,0,23
Georgia,27/02/2012,50,4,1,0,45,12,0,112
Georgia,28/02/2012,60,0,-1,0,62,10,0,131
Georgia,29/02/2012,65,4,-4,0,56,10,0,131
India,01/02/2012,70,2,-6,0,30,8,0,104
India,02/02/2012,108,14,-9,0,8,12,0,133
India,03/02/2012,17,6,0,0,0,4,0,27
India,04/02/2012,15,0,-6,0,28,6,0,43
India,05/02/2012,70,6,-6,0,37,8,0,115
India,06/02/2012,64,2,1,0,61,14,0,142
India,07/02/2012,72,0,-6,0,32,9,0,107
India,08/02/2012,82,4,-28,0,30,15,0,103
India,09/02/2012,80,2,-25,0,13,34,0,104
India,10/02/2012,119,8,-20,0,7,18,0,132
India,11/02/2012,80,2,-14,0,21,14,0,103
India,12/02/2012,76,0,4,0,42,21,0,143
India,13/02/2012,107,0,2,0,49,14,0,172
India,14/02/2012,86,2,2,0,55,30,0,175
India,15/02/2012,70,0,0,0,63,12,0,145
India,16/02/2012,98,2,-6,0,48,19,0,161
India,17/02/2012,104,0,-9,0,49,12,0,156
India,18/02/2012,67,2,-2,0,6,13,0,86
India,19/02/2012,55,2,1,0,16,9,0,83
India,20/02/2012,105,0,1,0,44,36,0,186
India,21/02/2012,105,0,3,0,32,21,0,161
India,22/02/2012,92,2,-3,0,26,21,0,138
India,23/02/2012,49,2,5,0,12,7,0,75
India,24/02/2012,80,2,-7,0,3,10,0,88
India,25/02/2012,41,2,-1,0,7,11,0,60
India,26/02/2012,68,0,-2,0,-5,10,0,71
India,27/02/2012,58,2,-6,0,24,10,0,88
India,28/02/2012,88,0,0,0,13,13,0,114
India,29/02/2012,80,2,-1,0,33,22,0,136
Iran,01/02/2012,171,0,-10,0,112,21,0,294
Iran,02/02/2012,158,0,-2,0,35,36,0,227
Iran,03/02/2012,47,0,0,0,31,17,0,95
Iran,04/02/2012,153,0,1,0,38,19,0,211
Iran,05/02/2012,234,1,-1,0,46,40,0,320
Iran,06/02/2012,241,0,3,0,88,41,0,373
Iran,07/02/2012,188,0,2,0,125,11,0,326
Iran,08/02/2012,164,0,-9,0,85,18,0,258
Iran,09/02/2012,209,4,-2,0,132,30,0,373
Iran,10/02/2012,156,0,6,0,75,20,0,257
Iran,11/02/2012,74,0,1,0,54,7,0,136
Iran,12/02/2012,86,0,1,0,32,11,0,130
Iran,13/02/2012,310,6,3,0,178,60,0,557
Iran,14/02/2012,382,0,0,0,145,85,0,612
Iran,15/02/2012,338,4,1,0,158,67,0,568
Iran,16/02/2012,285,2,2,0,77,35,0,401
Iran,17/02/2012,183,2,-2,0,60,23,0,266
Iran,18/02/2012,154,0,-2,0,51,19,0,222
Iran,19/02/2012,194,0,-1,0,39,68,0,300
Iran,20/02/2012,172,0,3,0,104,64,0,343
Iran,21/02/2012,215,0,1,0,165,32,0,413
Iran,22/02/2012,207,4,-9,0,123,37,0,362
Iran,23/02/2012,268,0,-5,0,74,46,0,383
Iran,24/02/2012,158,2,1,0,60,22,0,243
Iran,25/02/2012,138,0,-2,0,54,14,0,204
Iran,26/02/2012,155,0,4,0,64,11,0,234
Iran,27/02/2012,176,4,-4,0,98,23,0,297
Iran,28/02/2012,230,2,-1,0,101,24,0,356
Iran,29/02/2012,216,0,3,0,222,23,0,464
Iraq,01/02/2012,109,0,0,0,60,14,0,183
Iraq,02/02/2012,170,6,-2,0,67,18,0,259
Iraq,03/02/2012,56,0,0,0,19,3,0,78
Iraq,04/02/2012,88,0,2,0,28,12,0,130
Iraq,05/02/2012,97,0,0,0,6,5,0,108
Iraq,06/02/2012,75,0,-3,0,37,8,0,117
Iraq,07/02/2012,86,0,1,0,43,9,0,139
Iraq,08/02/2012,134,0,0,0,22,12,0,168
Iraq,09/02/2012,159,0,0,0,59,14,0,232
Iraq,10/02/2012,117,2,2,0,41,9,0,171
Iraq,11/02/2012,107,2,0,0,25,7,0,141
Iraq,12/02/2012,150,2,3,0,43,22,0,220
Iraq,13/02/2012,149,2,5,0,54,10,0,220
Iraq,14/02/2012,80,4,-1,0,21,43,0,147
Iraq,15/02/2012,145,0,-1,0,40,19,0,203
Iraq,16/02/2012,113,4,1,0,20,19,0,157
Iraq,17/02/2012,125,0,0,0,37,13,0,175
Iraq,18/02/2012,88,0,-2,0,16,2,0,104
Iraq,19/02/2012,55,2,0,0,3,4,0,64
Iraq,20/02/2012,100,6,-1,0,46,27,0,178
Iraq,21/02/2012,114,0,0,0,23,15,0,152
Iraq,22/02/2012,123,0,-2,0,14,27,0,162
Iraq,23/02/2012,168,0,6,0,30,21,0,225
Iraq,24/02/2012,124,2,3,0,38,21,0,188
Iraq,25/02/2012,65,2,0,0,9,9,0,85
Iraq,26/02/2012,65,0,0,0,13,29,0,107
Iraq,27/02/2012,157,2,1,0,40,14,0,214
Iraq,28/02/2012,161,12,0,0,38,9,0,220
Iraq,29/02/2012,125,0,3,0,43,9,0,180
Morocco,01/02/2012,14,0,-9,0,0,1,0,6
Morocco,02/02/2012,9,0,0,0,-7,0,0,2
Morocco,03/02/2012,11,0,0,0,16,0,0,27
Morocco,04/02/2012,18,0,0,0,-1,2,0,19
Morocco,05/02/2012,12,0,0,0,2,2,0,16
Morocco,06/02/2012,13,0,0,0,-6,0,0,7
Morocco,07/02/2012,5,0,0,0,6,0,0,11
Morocco,08/02/2012,0,0,0,0,10,0,0,10
Morocco,09/02/2012,29,0,-12,0,30,3,0,50
Morocco,10/02/2012,7,0,-24,0,0,1,0,-16
Morocco,11/02/2012,5,0,-10,0,3,1,0,-1
Morocco,12/02/2012,15,0,1,0,-2,1,0,15
Morocco,13/02/2012,7,0,0,0,3,0,0,10
Morocco,14/02/2012,7,0,0,0,12,9,0,28
Morocco,15/02/2012,28,0,0,0,25,0,0,53
Morocco,16/02/2012,27,0,0,0,3,1,0,31
Morocco,17/02/2012,51,0,0,0,96,2,0,149
Morocco,18/02/2012,52,0,0,0,100,5,0,157
Morocco,19/02/2012,4,0,0,0,7,0,0,11
Morocco,20/02/2012,7,0,0,0,9,1,0,17
Morocco,21/02/2012,4,0,-2,0,14,0,0,16
Morocco,22/02/2012,22,0,0,0,41,0,0,63
Morocco,23/02/2012,17,0,0,0,9,0,0,26
Morocco,24/02/2012,23,2,0,0,2,0,0,27
Morocco,25/02/2012,26,0,0,0,6,0,0,32
Morocco,26/02/2012,25,6,-1,0,-4,0,0,26
Morocco,27/02/2012,3,0,0,0,2,4,0,9
Morocco,28/02/2012,1,0,0,0,1,0,0,2
Morocco,29/02/2012,15,4,-4,0,3,2,0,20
Nigeria,01/02/2012,29,0,-2,0,5,1,0,33
Nigeria,02/02/2012,1,0,1,0,11,5,0,18
Nigeria,03/02/2012,2,0,0,0,0,0,0,2
Nigeria,04/02/2012,49,0,0,0,1,1,0,51
Nigeria,05/02/2012,21,0,0,0,6,2,0,29
Nigeria,06/02/2012,16,0,-2,0,6,10,0,30
Nigeria,07/02/2012,14,0,3,0,22,3,0,42
Nigeria,08/02/2012,45,4,3,0,11,0,0,63
Nigeria,09/02/2012,41,0,4,0,7,5,0,57
Nigeria,10/02/2012,27,0,1,0,26,11,0,65
Nigeria,11/02/2012,9,4,-2,0,17,4,0,32
Nigeria,12/02/2012,11,2,0,0,10,0,0,23
Nigeria,13/02/2012,50,2,0,0,-2,1,0,51
Nigeria,14/02/2012,33,0,-2,0,4,3,0,38
Nigeria,15/02/2012,23,0,0,0,13,3,0,39
Nigeria,16/02/2012,165,0,0,0,147,19,0,331
Nigeria,17/02/2012,101,0,-3,0,83,22,0,203
Nigeria,18/02/2012,26,0,0,0,21,6,0,53
Nigeria,19/02/2012,11,0,0,0,6,1,0,18
Nigeria,20/02/2012,22,2,0,0,25,1,0,50
Nigeria,21/02/2012,38,4,-3,0,15,4,0,58
Nigeria,22/02/2012,31,0,0,0,30,4,0,65
Nigeria,23/02/2012,74,0,0,0,93,5,0,172
Nigeria,24/02/2012,35,0,-6,0,78,1,0,108
Nigeria,25/02/2012,42,0,0,0,10,3,0,55
Nigeria,26/02/2012,74,0,1,0,16,8,0,99
Nigeria,27/02/2012,65,2,-4,0,72,5,0,140
Nigeria,28/02/2012,41,2,-1,0,30,2,0,74
Nigeria,29/02/2012,75,0,0,0,38,11,0,124
Pakistan,01/02/2012,129,0,1,0,10,3,0,143
Pakistan,02/02/2012,94,0,-3,0,93,12,0,196
Pakistan,03/02/2012,3,14,0,0,36,0,0,53
Pakistan,04/02/2012,52,0,2,0,63,4,0,121
Pakistan,05/02/2012,40,2,0,0,42,7,0,91
Pakistan,06/02/2012,39,0,-10,0,2,7,0,38
Pakistan,07/02/2012,74,0,-3,0,7,5,0,83
Pakistan,08/02/2012,75,0,-7,0,54,5,0,127
Pakistan,09/02/2012,95,0,-2,0,75,4,0,172
Pakistan,10/02/2012,123,14,6,0,42,18,0,203
Pakistan,11/02/2012,45,0,3,0,13,9,0,70
Pakistan,12/02/2012,111,0,1,0,116,1,0,229
Pakistan,13/02/2012,128,2,5,0,170,28,0,333
Pakistan,14/02/2012,75,0,-1,0,84,13,0,171
Pakistan,15/02/2012,110,0,-12,0,80,17,0,195
Pakistan,16/02/2012,99,4,-6,0,79,16,0,192
Pakistan,17/02/2012,112,0,-2,0,50,22,0,182
Pakistan,18/02/2012,71,2,0,0,19,11,0,103
Pakistan,19/02/2012,25,2,0,0,15,5,0,47
Pakistan,20/02/2012,108,2,-1,0,-1,18,0,126
Pakistan,21/02/2012,113,2,-4,0,42,11,0,164
Pakistan,22/02/2012,139,2,1,0,30,20,0,192
Pakistan,23/02/2012,121,0,-1,0,27,8,0,155
Pakistan,24/02/2012,46,0,0,0,31,13,0,90
Pakistan,25/02/2012,89,2,-1,0,12,19,0,121
Pakistan,26/02/2012,79,0,0,0,20,34,0,133
Pakistan,27/02/2012,99,0,-2,0,31,23,0,151
Pakistan,28/02/2012,127,0,1,0,9,12,0,149
Pakistan,29/02/2012,188,0,0,0,209,30,0,427
Sierra Leone,01/02/2012,37,0,0,0,0,1,0,38
Sierra Leone,02/02/2012,7,0,0,0,9,0,0,16
Sierra Leone,03/02/2012,1,0,0,0,3,0,0,4
Sierra Leone,04/02/2012,2,0,0,0,0,0,0,2
Sierra Leone,05/02/2012,0,0,0,0,0,0,0,0
Sierra Leone,06/02/2012,6,0,0,0,0,0,0,6
Sierra Leone,07/02/2012,8,0,0,0,0,0,0,8
Sierra Leone,08/02/2012,12,0,0,0,3,0,0,15
Sierra Leone,09/02/2012,0,0,0,0,3,2,0,5
Sierra Leone,10/02/2012,0,0,0,0,-2,0,0,-2
Sierra Leone,11/02/2012,0,0,0,0,0,0,0,0
Sierra Leone,12/02/2012,2,0,0,0,0,0,0,2
Sierra Leone,13/02/2012,9,0,0,0,7,0,0,16
Sierra Leone,14/02/2012,3,0,0,0,0,0,0,3
Sierra Leone,15/02/2012,-2,0,0,0,0,0,0,-2
Sierra Leone,16/02/2012,5,0,1,0,3,0,0,9
Sierra Leone,17/02/2012,3,0,0,0,0,0,0,3
Sierra Leone,18/02/2012,0,0,0,0,3,0,0,3
Sierra Leone,20/02/2012,0,0,0,0,-2,0,0,-2
Sierra Leone,21/02/2012,3,0,0,0,0,0,0,3
Sierra Leone,22/02/2012,4,0,0,0,0,4,0,8
Sierra Leone,23/02/2012,1,0,0,0,3,0,0,4
Sierra Leone,24/02/2012,0,0,0,0,0,0,0,0
Sierra Leone,26/02/2012,0,0,0,0,0,0,0,0
Sierra Leone,27/02/2012,4,0,0,0,0,1,0,5
Sierra Leone,28/02/2012,1,0,0,0,0,0,0,1
Sierra Leone,29/02/2012,3,0,0,0,-2,0,0,1
Somalia,01/02/2012,89,0,-2,0,58,4,0,149
Somalia,02/02/2012,79,0,0,0,87,12,0,178
Somalia,03/02/2012,18,0,-2,0,18,3,0,37
Somalia,04/02/2012,59,2,0,0,4,13,0,78
Somalia,05/02/2012,31,0,0,0,3,11,0,45
Somalia,06/02/2012,103,6,0,0,67,8,0,184
Somalia,07/02/2012,76,2,0,0,33,8,0,119
Somalia,08/02/2012,139,8,-1,0,6,4,0,156
Somalia,09/02/2012,58,4,1,0,37,1,0,101
Somalia,10/02/2012,100,2,0,0,17,14,0,133
Somalia,11/02/2012,33,0,0,0,28,7,0,68
Somalia,12/02/2012,63,0,-1,0,27,16,0,105
Somalia,13/02/2012,76,0,0,0,40,10,0,126
Somalia,14/02/2012,84,4,-1,0,12,11,0,110
Somalia,15/02/2012,94,1,1,0,48,13,0,157
Somalia,16/02/2012,136,0,-5,0,37,11,0,179
Somalia,17/02/2012,100,0,1,0,22,14,0,137
Somalia,18/02/2012,41,0,-4,0,32,10,0,79
Somalia,19/02/2012,80,2,-1,0,13,17,0,111
Somalia,20/02/2012,74,2,0,0,55,9,0,140
Somalia,21/02/2012,68,0,-1,0,27,15,0,109
Somalia,22/02/2012,125,2,0,0,57,12,0,196
Somalia,23/02/2012,136,4,-4,0,28,16,0,180
Somalia,24/02/2012,77,2,-4,0,57,10,0,142
Somalia,25/02/2012,54,0,-2,0,42,2,0,96
Somalia,26/02/2012,54,0,1,0,22,13,0,90
Somalia,27/02/2012,76,0,0,0,12,16,0,104
Somalia,28/02/2012,173,0,-1,0,50,9,0,231
Somalia,29/02/2012,82,6,0,0,31,14,0,133
Syria,01/02/2012,289,0,-29,0,54,22,0,336
Syria,02/02/2012,245,0,-30,0,5,71,0,291
Syria,03/02/2012,87,0,-10,0,22,20,0,119
Syria,04/02/2012,607,0,-58,0,206,322,0,1077
Syria,05/02/2012,463,0,-23,0,83,140,0,663
Syria,06/02/2012,464,0,-31,0,34,84,0,551
Syria,07/02/2012,331,2,-4,0,173,43,0,545
Syria,08/02/2012,470,0,-15,0,63,76,0,594
Syria,09/02/2012,356,10,-11,0,141,89,0,585
Syria,10/02/2012,354,8,-4,0,71,79,0,508
Syria,11/02/2012,288,2,-10,0,26,36,0,342
Syria,12/02/2012,424,8,-9,0,19,74,0,516
Syria,13/02/2012,514,4,-11,0,50,40,0,597
Syria,14/02/2012,343,6,-1,0,82,49,0,479
Syria,15/02/2012,366,6,-36,0,105,73,0,514
Syria,16/02/2012,488,12,-46,0,75,54,0,583
Syria,17/02/2012,446,4,-8,0,80,53,0,575
Syria,18/02/2012,183,0,-4,0,41,15,0,235
Syria,19/02/2012,148,4,0,0,41,17,0,210
Syria,20/02/2012,229,2,-8,0,44,31,0,298
Syria,21/02/2012,380,0,-9,0,38,62,0,471
Syria,22/02/2012,785,4,-17,0,49,57,0,878
Syria,23/02/2012,511,8,-16,0,48,89,0,640
Syria,24/02/2012,574,8,-21,0,26,63,0,650
Syria,25/02/2012,380,8,-8,0,22,56,0,458
Syria,26/02/2012,352,2,-4,0,47,42,0,439
Syria,27/02/2012,331,2,-15,0,135,45,0,498
Syria,28/02/2012,538,10,-8,0,74,79,0,693
Syria,29/02/2012,303,0,0,0,45,41,0,389
Yemen,01/02/2012,71,0,-5,0,-9,10,0,67
Yemen,02/02/2012,27,0,0,0,34,6,0,67
Yemen,03/02/2012,1,0,0,0,9,0,0,10
Yemen,04/02/2012,8,0,-2,0,12,0,0,18
Yemen,05/02/2012,15,0,-2,0,14,4,0,31
Yemen,06/02/2012,45,0,0,0,18,3,0,66
Yemen,07/02/2012,41,0,0,0,12,6,0,59
Yemen,08/02/2012,54,0,0,0,3,8,0,65
Yemen,09/02/2012,42,0,0,0,11,12,0,65
Yemen,10/02/2012,24,0,0,0,-2,3,0,25
Yemen,11/02/2012,29,0,1,0,-4,3,0,29
Yemen,12/02/2012,40,0,0,0,0,14,0,54
Yemen,13/02/2012,37,0,0,0,-6,6,0,37
Yemen,14/02/2012,46,0,2,0,6,9,0,63
Yemen,15/02/2012,54,0,0,0,6,3,0,63
Yemen,16/02/2012,66,0,0,0,61,1,0,128
Yemen,17/02/2012,41,0,-1,0,27,1,0,68
Yemen,18/02/2012,15,0,0,0,19,0,0,34
Yemen,19/02/2012,37,0,-3,0,12,5,0,51
Yemen,20/02/2012,41,2,-3,0,7,15,0,62
Yemen,21/02/2012,30,0,-2,0,0,14,0,42
Yemen,22/02/2012,39,0,1,0,23,7,0,70
Yemen,23/02/2012,14,0,2,0,12,6,0,34
Yemen,24/02/2012,30,0,-18,0,9,7,0,28
Yemen,25/02/2012,97,0,-4,0,6,31,0,130
Yemen,26/02/2012,21,0,-2,0,-1,19,0,37
Yemen,27/02/2012,35,0,-8,0,13,5,0,45
Yemen,28/02/2012,16,2,0,0,28,3,0,49
Yemen,29/02/2012,28,0,-4,0,14,0,0,38
Afghanistan,01/01/2009,93,0,2,0,7,7,0,109
Afghanistan,02/01/2009,302,2,-1,0,68,44,0,415
Afghanistan,03/01/2009,114,0,0,0,110,9,0,233
Afghanistan,04/01/2009,145,0,0,0,17,27,0,189
Afghanistan,05/01/2009,288,0,0,0,68,32,0,388
Afghanistan,06/01/2009,263,2,1,0,34,20,0,320
Afghanistan,07/01/2009,140,0,0,0,14,10,0,164
Afghanistan,08/01/2009,94,0,0,0,-6,3,0,91
Afghanistan,09/01/2009,209,0,1,0,1,13,0,224
Afghanistan,10/01/2009,68,2,-7,0,22,2,0,87
Afghanistan,11/01/2009,235,0,-3,0,53,13,0,298
Afghanistan,12/01/2009,131,6,0,0,29,16,0,182
Afghanistan,13/01/2009,131,0,0,0,81,4,0,216
Afghanistan,14/01/2009,67,4,0,0,21,5,0,97
Afghanistan,15/01/2009,211,0,0,0,87,30,0,328
Afghanistan,16/01/2009,136,4,0,0,77,81,0,298
Afghanistan,17/01/2009,90,0,4,0,22,63,0,179
Afghanistan,18/01/2009,212,0,0,0,44,48,0,304
Afghanistan,19/01/2009,167,2,0,0,45,14,0,228
Afghanistan,20/01/2009,420,0,0,0,47,25,0,492
Afghanistan,21/01/2009,290,2,0,0,103,16,0,411
Afghanistan,22/01/2009,225,6,2,0,158,20,0,411
Afghanistan,23/01/2009,304,10,-1,0,51,26,0,390
Afghanistan,24/01/2009,242,2,1,0,37,23,0,305
Afghanistan,25/01/2009,166,0,1,0,41,28,0,236
Afghanistan,26/01/2009,82,0,-3,0,44,17,0,140
Afghanistan,27/01/2009,251,0,2,0,37,15,0,305
Afghanistan,28/01/2009,193,0,-6,0,-12,21,0,196
Afghanistan,29/01/2009,284,8,-2,0,29,30,0,349
Afghanistan,30/01/2009,146,2,0,0,18,5,0,171
Afghanistan,31/01/2009,125,2,-2,0,21,6,0,152
Albania,01/01/2009,0,0,0,0,0,0,0,0
Albania,02/01/2009,7,0,0,0,0,0,0,7
Albania,03/01/2009,23,0,-7,0,-2,18,0,32
Albania,04/01/2009,22,0,-2,0,-4,14,0,30
Albania,05/01/2009,37,0,-2,0,-4,17,0,48
Albania,06/01/2009,22,0,0,0,-12,1,0,11
Albania,07/01/2009,7,0,-2,0,-6,0,0,-1
Albania,08/01/2009,9,0,0,0,5,4,0,18
Albania,09/01/2009,19,0,0,0,9,2,0,30
Albania,10/01/2009,3,0,0,0,4,2,0,9
Albania,11/01/2009,5,0,0,0,0,0,0,5
Albania,12/01/2009,8,0,0,0,6,0,0,14
Albania,13/01/2009,2,0,0,0,1,4,0,7
Albania,14/01/2009,10,0,-2,0,0,1,0,9
Albania,15/01/2009,0,0,-4,0,15,5,0,16
Albania,16/01/2009,7,0,0,0,0,1,0,8
Albania,17/01/2009,0,0,0,0,0,0,0,0
Albania,18/01/2009,2,0,0,0,0,0,0,2
Albania,19/01/2009,3,0,2,0,0,0,0,5
Albania,20/01/2009,0,0,0,0,0,1,0,1
Albania,21/01/2009,18,0,-6,0,12,0,0,24
Albania,22/01/2009,14,0,0,0,-8,3,0,9
Albania,23/01/2009,2,0,0,0,10,9,0,21
Albania,24/01/2009,14,0,0,0,2,4,0,20
Albania,25/01/2009,0,0,0,0,3,6,0,9
Albania,26/01/2009,22,0,0,0,-3,3,0,22
Albania,27/01/2009,18,0,0,0,10,8,0,36
Albania,28/01/2009,25,0,0,0,3,3,0,31
Albania,29/01/2009,-2,0,-2,0,19,3,0,18
Albania,30/01/2009,4,0,0,0,21,0,0,25
Albania,31/01/2009,11,0,0,0,0,0,0,11
Algeria,01/01/2009,2,0,0,0,0,0,0,2
Algeria,02/01/2009,6,0,0,0,1,1,0,8
Algeria,03/01/2009,0,0,0,0,12,0,0,12
Algeria,04/01/2009,9,0,0,0,0,4,0,13
Algeria,05/01/2009,13,0,0,0,3,4,0,20
Algeria,06/01/2009,6,0,0,0,9,2,0,17
Algeria,07/01/2009,12,0,0,0,0,2,0,14
Algeria,08/01/2009,5,0,0,0,15,0,0,20
Algeria,09/01/2009,18,0,0,0,24,0,0,42
Algeria,10/01/2009,11,0,0,0,0,16,0,27
Algeria,11/01/2009,0,0,0,0,-4,6,0,2
Algeria,12/01/2009,16,0,0,0,9,0,0,25
Algeria,13/01/2009,11,0,0,0,12,0,0,23
Algeria,14/01/2009,18,0,0,0,9,0,0,27
Algeria,15/01/2009,13,0,0,0,-4,1,0,10
Algeria,16/01/2009,7,0,0,0,-2,1,0,6
Algeria,17/01/2009,13,0,0,0,0,0,0,13
Algeria,18/01/2009,13,0,0,0,-2,1,0,12
Algeria,19/01/2009,5,0,0,0,4,1,0,10
Algeria,20/01/2009,-1,0,0,0,4,2,0,5
Algeria,21/01/2009,4,0,0,0,-3,2,0,3
Algeria,22/01/2009,3,0,0,0,16,0,0,19
Algeria,23/01/2009,8,0,0,0,7,0,0,15
Algeria,24/01/2009,-2,0,0,0,-4,0,0,-6
Algeria,25/01/2009,2,0,0,0,0,0,0,2
Algeria,26/01/2009,10,0,0,0,9,0,0,19
Algeria,27/01/2009,-2,0,0,0,12,1,0,11
Algeria,28/01/2009,-3,0,0,0,0,3,0,0
Algeria,29/01/2009,13,0,0,0,13,0,0,26
Algeria,30/01/2009,1,0,0,0,0,0,0,1
Algeria,31/01/2009,6,0,0,0,0,0,0,6
Bangladesh,01/01/2009,21,0,-6,0,5,3,0,23
Bangladesh,02/01/2009,31,24,-1,0,3,4,0,61
Bangladesh,03/01/2009,24,0,0,0,1,3,0,28
Bangladesh,04/01/2009,22,0,0,0,3,2,0,27
Bangladesh,05/01/2009,37,2,0,0,24,3,0,66
Bangladesh,06/01/2009,22,0,1,0,18,5,0,46
Bangladesh,07/01/2009,13,0,-5,0,6,1,0,15
Bangladesh,08/01/2009,4,0,0,0,-3,1,0,2
Bangladesh,09/01/2009,21,0,0,0,-10,3,0,14
Bangladesh,10/01/2009,6,0,0,0,4,0,0,10
Bangladesh,11/01/2009,14,0,0,0,6,2,0,22
Bangladesh,12/01/2009,19,0,-4,0,14,0,0,29
Bangladesh,13/01/2009,17,0,0,0,4,2,0,23
Bangladesh,14/01/2009,8,0,0,0,3,0,0,11
Bangladesh,15/01/2009,20,0,0,0,13,2,0,35
Bangladesh,16/01/2009,9,0,0,0,12,2,0,23
Bangladesh,17/01/2009,18,0,0,0,24,5,0,47
Bangladesh,18/01/2009,16,0,1,0,43,0,0,60
Bangladesh,19/01/2009,31,0,0,0,18,6,0,55
Bangladesh,20/01/2009,14,0,0,0,10,1,0,25
Bangladesh,21/01/2009,14,2,0,0,-4,0,0,12
Bangladesh,22/01/2009,18,0,1,0,15,0,0,34
Bangladesh,23/01/2009,24,0,0,0,19,4,0,47
Bangladesh,24/01/2009,3,0,0,0,5,2,0,10
Bangladesh,25/01/2009,-4,0,0,0,11,0,0,7
Bangladesh,26/01/2009,32,0,1,0,9,2,0,44
Bangladesh,27/01/2009,34,2,1,0,18,2,0,57
Bangladesh,28/01/2009,11,0,-5,0,9,2,0,17
Bangladesh,29/01/2009,23,4,0,0,36,4,0,67
Bangladesh,30/01/2009,13,0,1,0,1,0,0,15
Bangladesh,31/01/2009,20,0,0,0,9,0,0,29
Cameroon,01/01/2009,0,0,0,0,3,0,0,3
Cameroon,02/01/2009,0,0,0,0,3,0,0,3
Cameroon,03/01/2009,2,0,0,0,0,0,0,2
Cameroon,05/01/2009,3,0,0,0,-4,0,0,-1
Cameroon,06/01/2009,0,0,0,0,0,0,0,0
Cameroon,07/01/2009,3,0,0,0,-2,0,0,1
Cameroon,08/01/2009,0,0,0,0,0,0,0,0
Cameroon,09/01/2009,-1,0,0,0,3,0,0,2
Cameroon,10/01/2009,5,0,0,0,0,0,0,5
Cameroon,11/01/2009,2,0,0,0,0,0,0,2
Cameroon,12/01/2009,4,0,-6,0,0,0,0,-2
Cameroon,13/01/2009,0,0,0,0,0,0,0,0
Cameroon,14/01/2009,-1,0,1,0,0,0,0,0
Cameroon,15/01/2009,7,0,0,0,0,0,0,7
Cameroon,16/01/2009,3,0,0,0,3,0,0,6
Cameroon,17/01/2009,5,0,0,0,0,0,0,5
Cameroon,18/01/2009,-1,0,0,0,0,0,0,-1
Cameroon,19/01/2009,0,0,0,0,0,0,0,0
Cameroon,20/01/2009,-1,0,0,0,3,0,0,2
Cameroon,21/01/2009,0,0,0,0,0,0,0,0
Cameroon,22/01/2009,2,0,0,0,0,0,0,2
Cameroon,23/01/2009,2,0,0,0,0,0,0,2
Cameroon,24/01/2009,0,0,0,0,0,0,0,0
Cameroon,25/01/2009,0,0,0,0,0,0,0,0
Cameroon,26/01/2009,3,0,1,0,12,1,0,17
Cameroon,27/01/2009,-2,0,0,0,0,0,0,-2
Cameroon,28/01/2009,6,0,0,0,6,4,0,16
Cameroon,29/01/2009,6,0,0,0,13,7,0,26
Cameroon,30/01/2009,7,0,0,0,11,3,0,21
Cameroon,31/01/2009,0,0,0,0,0,0,0,0
China,01/01/2009,85,0,0,0,25,4,0,114
China,02/01/2009,49,0,0,0,-5,1,0,45
China,03/01/2009,106,0,0,0,15,13,0,134
China,04/01/2009,39,0,0,0,0,13,0,52
China,05/01/2009,91,0,0,0,21,17,0,129
China,06/01/2009,57,2,-8,0,16,12,0,79
China,07/01/2009,39,0,-9,0,12,3,0,45
China,08/01/2009,50,0,-6,0,0,7,0,51
China,09/01/2009,59,0,7,0,19,8,0,93
China,10/01/2009,40,0,0,0,21,3,0,64
China,11/01/2009,87,2,0,0,26,15,0,130
China,12/01/2009,39,2,0,0,26,18,0,85
China,13/01/2009,78,0,0,0,49,7,0,134
China,14/01/2009,43,2,0,0,8,5,0,58
China,15/01/2009,42,0,2,0,46,6,0,96
China,16/01/2009,95,0,0,0,49,8,0,152
China,17/01/2009,64,0,-2,0,30,22,0,114
China,18/01/2009,91,2,-2,0,20,6,0,117
China,19/01/2009,77,0,-2,0,17,12,0,104
China,20/01/2009,72,4,9,0,47,6,0,138
China,21/01/2009,88,8,-2,0,65,11,0,170
China,22/01/2009,56,0,0,0,103,6,0,165
China,23/01/2009,98,0,-4,0,46,14,0,154
China,24/01/2009,56,0,-4,0,22,5,0,79
China,25/01/2009,18,0,1,0,23,3,0,45
China,26/01/2009,167,0,1,0,44,12,0,224
China,27/01/2009,59,2,3,0,35,11,0,110
China,28/01/2009,52,0,-2,0,47,4,0,101
China,29/01/2009,83,2,1,0,53,12,0,151
China,30/01/2009,115,0,1,0,17,14,0,147
China,31/01/2009,136,2,1,0,20,16,0,175
Egypt,01/01/2009,207,2,2,0,19,18,0,248
Egypt,02/01/2009,147,0,0,0,42,21,0,210
Egypt,03/01/2009,136,0,4,0,10,20,0,170
Egypt,04/01/2009,172,0,3,0,4,16,0,195
Egypt,05/01/2009,145,0,0,0,16,12,0,173
Egypt,06/01/2009,254,4,3,0,47,14,0,322
Egypt,07/01/2009,269,8,0,0,17,47,0,341
Egypt,08/01/2009,193,4,1,0,18,22,0,238
Egypt,09/01/2009,178,4,0,0,10,24,0,216
Egypt,10/01/2009,85,0,4,0,-1,21,0,109
Egypt,11/01/2009,148,0,0,0,10,19,0,177
Egypt,12/01/2009,229,0,-12,0,23,27,0,267
Egypt,13/01/2009,165,0,-1,0,18,10,0,192
Egypt,14/01/2009,42,0,-3,0,7,4,0,50
Egypt,15/01/2009,267,4,4,0,73,11,0,359
Egypt,16/01/2009,118,0,7,0,34,5,0,164
Egypt,17/01/2009,175,0,0,0,1,30,0,206
Egypt,18/01/2009,181,0,-2,0,-4,20,0,195
Egypt,19/01/2009,121,0,6,0,12,12,0,151
Egypt,20/01/2009,53,0,6,0,10,2,0,71
Egypt,21/01/2009,56,0,0,0,8,4,0,68
Egypt,22/01/2009,119,0,-1,0,11,4,0,133
Egypt,23/01/2009,47,0,0,0,13,4,0,64
Egypt,24/01/2009,30,0,-1,0,15,6,0,50
Egypt,25/01/2009,94,0,-4,0,46,3,0,139
Egypt,26/01/2009,31,2,-2,0,43,6,0,80
Egypt,27/01/2009,224,0,7,0,25,9,0,265
Egypt,28/01/2009,159,0,-2,0,-6,4,0,155
Egypt,29/01/2009,91,8,0,0,18,28,0,145
Egypt,30/01/2009,33,4,-2,0,10,8,0,53
Egypt,31/01/2009,28,0,0,0,42,4,0,74
Eritrea,01/01/2009,0,0,0,0,0,0,0,0
Eritrea,02/01/2009,0,0,0,0,0,0,0,0
Eritrea,03/01/2009,0,0,0,0,0,0,0,0
Eritrea,04/01/2009,-3,0,0,0,0,0,0,-3
Eritrea,05/01/2009,3,0,0,0,0,0,0,3
Eritrea,07/01/2009,0,0,0,0,0,0,0,0
Eritrea,08/01/2009,0,0,0,0,-8,0,0,-8
Eritrea,09/01/2009,11,0,0,0,13,0,0,24
Eritrea,10/01/2009,6,0,0,0,0,0,0,6
Eritrea,11/01/2009,0,0,0,0,0,0,0,0
Eritrea,12/01/2009,0,0,0,0,0,0,0,0
Eritrea,13/01/2009,23,0,0,0,0,0,0,23
Eritrea,14/01/2009,-10,0,0,0,0,0,0,-10
Eritrea,15/01/2009,6,0,0,0,0,0,0,6
Eritrea,16/01/2009,-3,0,0,0,0,0,0,-3
Eritrea,17/01/2009,5,0,0,0,6,0,0,11
Eritrea,18/01/2009,2,0,0,0,0,0,0,2
Eritrea,20/01/2009,0,0,0,0,-2,0,0,-2
Eritrea,21/01/2009,0,0,0,0,9,0,0,9
Eritrea,22/01/2009,7,0,0,0,0,0,0,7
Eritrea,23/01/2009,16,0,0,0,12,1,0,29
Eritrea,24/01/2009,0,0,0,0,0,0,0,0
Eritrea,25/01/2009,15,0,0,0,0,0,0,15
Eritrea,26/01/2009,-2,0,0,0,6,2,0,6
Eritrea,27/01/2009,10,0,0,0,3,1,0,14
Eritrea,28/01/2009,-4,0,0,0,3,0,0,-1
Eritrea,29/01/2009,10,0,0,0,0,0,0,10
Eritrea,30/01/2009,0,0,0,0,6,0,0,6
Eritrea,31/01/2009,0,0,0,0,0,0,0,0
Georgia,01/01/2009,1,0,0,0,0,0,0,1
Georgia,02/01/2009,0,0,0,0,0,2,0,2
Georgia,03/01/2009,4,0,0,0,0,0,0,4
Georgia,04/01/2009,10,0,0,0,16,0,0,26
Georgia,05/01/2009,12,0,0,0,13,0,0,25
Georgia,06/01/2009,4,0,0,0,6,0,0,10
Georgia,07/01/2009,0,0,0,0,12,0,0,12
Georgia,08/01/2009,-4,0,0,0,-1,3,0,-2
Georgia,09/01/2009,5,0,0,0,3,1,0,9
Georgia,10/01/2009,7,0,-4,0,15,0,0,18
Georgia,11/01/2009,0,0,0,0,6,0,0,6
Georgia,12/01/2009,7,0,-4,0,9,2,0,14
Georgia,13/01/2009,13,0,0,0,1,0,0,14
Georgia,14/01/2009,6,0,0,0,0,0,0,6
Georgia,15/01/2009,5,2,1,0,3,0,0,11
Georgia,16/01/2009,22,0,-1,0,21,0,0,42
Georgia,17/01/2009,5,0,0,0,4,3,0,12
Georgia,18/01/2009,4,0,0,0,3,1,0,8
Georgia,19/01/2009,5,0,0,0,9,0,0,14
Georgia,20/01/2009,-3,0,0,0,6,1,0,4
Georgia,21/01/2009,5,0,0,0,0,1,0,6
Georgia,22/01/2009,11,2,-1,0,0,0,0,12
Georgia,23/01/2009,4,0,0,0,4,1,0,9
Georgia,24/01/2009,8,0,0,0,0,0,0,8
Georgia,25/01/2009,9,0,0,0,0,0,0,9
Georgia,26/01/2009,16,0,-1,0,-2,0,0,13
Georgia,27/01/2009,10,0,0,0,-2,2,0,10
Georgia,28/01/2009,13,0,0,0,3,2,0,18
Georgia,29/01/2009,13,0,1,0,6,1,0,21
Georgia,30/01/2009,9,0,-9,0,0,2,0,2
Georgia,31/01/2009,7,0,-2,0,3,0,0,8
India,01/01/2009,32,0,0,0,9,0,0,41
India,02/01/2009,20,0,0,0,7,0,0,27
India,03/01/2009,41,2,0,0,9,11,0,63
India,04/01/2009,38,0,-1,0,4,7,0,48
India,05/01/2009,6,0,0,0,11,4,0,21
India,06/01/2009,22,0,-4,0,4,2,0,24
India,07/01/2009,60,0,-4,0,18,2,0,76
India,08/01/2009,95,0,-2,0,15,1,0,109
India,09/01/2009,117,4,0,0,-4,16,0,133
India,10/01/2009,43,0,0,0,15,9,0,67
India,11/01/2009,29,0,-5,0,7,7,0,38
India,12/01/2009,58,2,-2,0,17,12,0,87
India,13/01/2009,52,0,0,0,26,0,0,78
India,14/01/2009,2,0,0,0,18,2,0,22
India,15/01/2009,32,2,0,0,23,3,0,60
India,16/01/2009,95,0,2,0,32,2,0,131
India,17/01/2009,36,0,0,0,7,2,0,45
India,18/01/2009,77,0,2,0,8,3,0,90
India,19/01/2009,72,0,1,0,21,3,0,97
India,20/01/2009,77,5,0,0,20,15,0,117
India,21/01/2009,51,0,1,0,25,1,0,78
India,22/01/2009,56,0,0,0,22,11,0,89
India,23/01/2009,48,0,-7,0,6,6,0,53
India,24/01/2009,35,0,0,0,10,1,0,46
India,25/01/2009,58,0,0,0,24,8,0,90
India,26/01/2009,46,0,-4,0,16,11,0,69
India,27/01/2009,85,0,0,0,30,6,0,121
India,28/01/2009,87,0,2,0,67,17,0,173
India,29/01/2009,54,0,1,0,31,8,0,94
India,30/01/2009,46,0,0,0,16,0,0,62
India,31/01/2009,49,2,0,0,-2,2,0,51
Iran,01/01/2009,71,0,1,0,8,10,0,90
Iran,02/01/2009,97,0,1,0,36,9,0,143
Iran,03/01/2009,109,0,0,0,-2,21,0,128
Iran,04/01/2009,136,0,3,0,31,155,0,325
Iran,05/01/2009,164,2,2,0,23,31,0,222
Iran,06/01/2009,102,0,0,0,20,29,0,151
Iran,07/01/2009,43,0,0,0,6,7,0,56
Iran,08/01/2009,109,2,0,0,15,15,0,141
Iran,09/01/2009,79,0,2,0,13,7,0,101
Iran,10/01/2009,19,2,2,0,-12,7,0,18
Iran,11/01/2009,463,0,2,0,4,3,0,472
Iran,12/01/2009,61,0,2,0,10,15,0,88
Iran,13/01/2009,64,0,0,0,5,14,0,83
Iran,14/01/2009,81,0,0,0,19,1,0,101
Iran,15/01/2009,139,0,-1,0,63,4,0,205
Iran,16/01/2009,83,0,2,0,55,24,0,164
Iran,17/01/2009,88,4,1,0,31,6,0,130
Iran,18/01/2009,30,0,0,0,7,8,0,45
Iran,19/01/2009,55,0,0,0,14,24,0,93
Iran,20/01/2009,70,0,0,0,0,20,0,90
Iran,21/01/2009,108,0,1,0,20,7,0,136
Iran,22/01/2009,24,0,0,0,37,4,0,65
Iran,23/01/2009,49,0,0,0,4,6,0,59
Iran,24/01/2009,19,2,0,0,9,6,0,36
Iran,25/01/2009,52,4,0,0,15,10,0,81
Iran,26/01/2009,52,2,-2,0,31,8,0,91
Iran,27/01/2009,84,0,0,0,28,13,0,125
Iran,28/01/2009,46,0,1,0,27,3,0,77
Iran,29/01/2009,60,0,0,0,28,2,0,90
Iran,30/01/2009,64,0,0,0,37,3,0,104
Iran,31/01/2009,19,0,0,0,21,6,0,46
Iraq,01/01/2009,106,0,0,0,21,7,0,134
Iraq,02/01/2009,124,0,1,0,42,14,0,181
Iraq,03/01/2009,85,0,-2,0,9,25,0,117
Iraq,04/01/2009,93,0,1,0,-12,20,0,102
Iraq,05/01/2009,119,0,-8,0,14,11,0,136
Iraq,06/01/2009,107,0,-4,0,15,14,0,132
Iraq,07/01/2009,155,0,-1,0,36,7,0,197
Iraq,08/01/2009,83,0,0,0,19,8,0,110
Iraq,09/01/2009,-24,0,0,0,23,20,0,19
Iraq,10/01/2009,46,0,0,0,25,6,0,77
Iraq,11/01/2009,103,0,0,0,0,34,0,137
Iraq,12/01/2009,105,4,-1,0,22,8,0,138
Iraq,13/01/2009,72,0,0,0,33,6,0,111
Iraq,14/01/2009,44,0,-4,0,5,17,0,62
Iraq,15/01/2009,140,2,-2,0,50,24,0,214
Iraq,16/01/2009,181,0,-7,0,6,12,0,192
Iraq,17/01/2009,62,0,0,0,4,3,0,69
Iraq,18/01/2009,110,0,3,0,20,20,0,153
Iraq,19/01/2009,58,0,1,0,55,26,0,140
Iraq,20/01/2009,90,0,1,0,24,6,0,121
Iraq,21/01/2009,58,0,-1,0,70,17,0,144
Iraq,22/01/2009,42,2,-2,0,57,20,0,119
Iraq,23/01/2009,37,0,0,0,40,13,0,90
Iraq,24/01/2009,60,0,1,0,28,8,0,97
Iraq,25/01/2009,68,2,0,0,17,4,0,91
Iraq,26/01/2009,91,4,-1,0,41,18,0,153
Iraq,27/01/2009,95,0,0,0,63,35,0,193
Iraq,28/01/2009,120,4,-2,0,30,34,0,186
Iraq,29/01/2009,111,12,-5,0,16,10,0,144
Iraq,30/01/2009,119,0,5,0,50,23,0,197
Iraq,31/01/2009,171,0,2,0,35,25,0,233
Morocco,01/01/2009,8,0,0,0,6,3,0,17
Morocco,02/01/2009,8,0,0,0,3,0,0,11
Morocco,03/01/2009,0,0,0,0,3,2,0,5
Morocco,04/01/2009,45,0,0,0,0,0,0,45
Morocco,05/01/2009,7,0,0,0,0,0,0,7
Morocco,06/01/2009,5,0,0,0,0,0,0,5
Morocco,07/01/2009,2,0,0,0,0,0,0,2
Morocco,08/01/2009,3,0,0,0,6,0,0,9
Morocco,09/01/2009,15,0,0,0,0,0,0,15
Morocco,10/01/2009,24,0,0,0,-6,0,0,18
Morocco,11/01/2009,17,0,0,0,0,0,0,17
Morocco,12/01/2009,13,0,0,0,12,3,0,28
Morocco,13/01/2009,2,0,0,0,3,0,0,5
Morocco,14/01/2009,0,0,0,0,3,0,0,3
Morocco,15/01/2009,11,0,0,0,-2,0,0,9
Morocco,16/01/2009,5,0,0,0,0,2,0,7
Morocco,17/01/2009,8,0,0,0,0,0,0,8
Morocco,18/01/2009,4,0,0,0,0,0,0,4
Morocco,19/01/2009,0,0,0,0,0,2,0,2
Morocco,20/01/2009,1,0,0,0,9,3,0,13
Morocco,21/01/2009,-3,0,0,0,0,0,0,-3
Morocco,22/01/2009,5,0,0,0,2,0,0,7
Morocco,23/01/2009,-6,0,-6,0,0,0,0,-12
Morocco,24/01/2009,4,0,0,0,3,0,0,7
Morocco,25/01/2009,7,0,0,0,0,0,0,7
Morocco,26/01/2009,-1,0,0,0,3,0,0,2
Morocco,27/01/2009,3,0,0,0,-2,0,0,1
Morocco,28/01/2009,2,0,0,0,0,0,0,2
Morocco,29/01/2009,0,0,0,0,0,0,0,0
Morocco,30/01/2009,10,0,0,0,3,0,0,13
Morocco,31/01/2009,0,0,0,0,6,0,0,6
Nigeria,01/01/2009,1,0,0,0,1,2,0,4
Nigeria,02/01/2009,0,0,0,0,9,4,0,13
Nigeria,03/01/2009,1,0,0,0,3,1,0,5
Nigeria,04/01/2009,8,0,0,0,6,3,0,17
Nigeria,05/01/2009,19,0,0,0,19,1,0,39
Nigeria,06/01/2009,14,0,1,0,0,0,0,15
Nigeria,07/01/2009,22,0,0,0,-30,0,0,-8
Nigeria,08/01/2009,14,0,0,0,-10,2,0,6
Nigeria,09/01/2009,15,0,0,0,15,1,0,31
Nigeria,10/01/2009,0,0,0,0,0,-6,0,-6
Nigeria,11/01/2009,8,0,0,0,-3,1,0,6
Nigeria,12/01/2009,23,0,0,0,16,1,0,40
Nigeria,13/01/2009,28,0,2,0,16,1,0,47
Nigeria,14/01/2009,2,0,0,0,1,1,0,4
Nigeria,15/01/2009,13,0,0,0,1,2,0,16
Nigeria,16/01/2009,25,0,0,0,-1,1,0,25
Nigeria,17/01/2009,15,0,0,0,14,4,0,33
Nigeria,18/01/2009,34,0,0,0,30,0,0,64
Nigeria,19/01/2009,39,0,0,0,-3,0,0,36
Nigeria,20/01/2009,16,0,1,0,9,0,0,26
Nigeria,21/01/2009,21,0,0,0,15,4,0,40
Nigeria,22/01/2009,37,2,0,0,15,0,0,54
Nigeria,23/01/2009,39,2,-2,0,9,2,0,50
Nigeria,24/01/2009,24,0,0,0,19,2,0,45
Nigeria,25/01/2009,7,0,0,0,12,1,0,20
Nigeria,26/01/2009,55,0,-6,0,12,7,0,68
Nigeria,27/01/2009,13,0,0,0,13,1,0,27
Nigeria,28/01/2009,20,0,0,0,4,0,0,24
Nigeria,29/01/2009,17,0,0,0,6,4,0,27
Nigeria,30/01/2009,18,0,0,0,6,0,0,24
Nigeria,31/01/2009,27,0,0,0,3,2,0,32
Pakistan,01/01/2009,82,0,0,0,28,9,0,119
Pakistan,02/01/2009,112,0,0,0,23,5,0,140
Pakistan,03/01/2009,48,0,0,0,12,11,0,71
Pakistan,04/01/2009,67,0,0,0,3,9,0,79
Pakistan,05/01/2009,84,0,-1,0,-7,11,0,87
Pakistan,06/01/2009,128,0,0,0,36,12,0,176
Pakistan,07/01/2009,108,0,-1,0,39,22,0,168
Pakistan,08/01/2009,39,0,1,0,18,6,0,64
Pakistan,09/01/2009,88,0,1,0,19,6,0,114
Pakistan,10/01/2009,76,0,-5,0,0,6,0,77
Pakistan,11/01/2009,119,2,0,0,24,7,0,152
Pakistan,12/01/2009,110,0,0,0,52,8,0,170
Pakistan,13/01/2009,90,2,0,0,22,18,0,132
Pakistan,14/01/2009,58,0,0,0,15,2,0,75
Pakistan,15/01/2009,88,0,1,0,114,3,0,206
Pakistan,16/01/2009,129,2,0,0,133,3,0,267
Pakistan,17/01/2009,63,0,0,0,15,14,0,92
Pakistan,18/01/2009,35,0,0,0,22,10,0,67
Pakistan,19/01/2009,155,0,0,0,36,20,0,211
Pakistan,20/01/2009,204,0,0,0,76,12,0,292
Pakistan,21/01/2009,134,0,2,0,77,7,0,220
Pakistan,22/01/2009,131,2,0,0,58,11,0,202
Pakistan,23/01/2009,152,4,0,0,45,4,0,205
Pakistan,24/01/2009,137,2,0,0,42,8,0,189
Pakistan,25/01/2009,232,0,0,0,34,6,0,272
Pakistan,26/01/2009,218,4,1,0,81,8,0,312
Pakistan,27/01/2009,168,0,1,0,61,25,0,255
Pakistan,28/01/2009,171,4,0,0,2,19,0,196
Pakistan,29/01/2009,103,0,0,0,14,6,0,123
Pakistan,30/01/2009,171,0,0,0,66,4,0,241
Pakistan,31/01/2009,113,2,0,0,22,10,0,147
Sierra Leone,01/01/2009,4,0,0,0,0,0,0,4
Sierra Leone,02/01/2009,16,0,0,0,0,0,0,16
Sierra Leone,03/01/2009,0,0,0,0,0,1,0,1
Sierra Leone,04/01/2009,0,0,0,0,0,0,0,0
Sierra Leone,05/01/2009,1,0,0,0,0,1,0,2
Sierra Leone,06/01/2009,0,0,0,0,0,0,0,0
Sierra Leone,07/01/2009,2,0,3,0,0,0,0,5
Sierra Leone,08/01/2009,-2,2,0,0,8,0,0,8
Sierra Leone,09/01/2009,6,0,0,0,42,0,0,48
Sierra Leone,10/01/2009,0,0,0,0,42,2,0,44
Sierra Leone,11/01/2009,0,0,0,0,9,1,0,10
Sierra Leone,12/01/2009,3,0,0,0,0,0,0,3
Sierra Leone,13/01/2009,9,0,0,0,-2,0,0,7
Sierra Leone,14/01/2009,0,0,0,0,0,0,0,0
Sierra Leone,15/01/2009,2,0,0,0,-2,3,0,3
Sierra Leone,16/01/2009,4,4,0,0,3,0,0,11
Sierra Leone,17/01/2009,0,0,0,0,0,0,0,0
Sierra Leone,18/01/2009,0,0,0,0,-2,0,0,-2
Sierra Leone,19/01/2009,2,0,0,0,9,0,0,11
Sierra Leone,20/01/2009,0,0,0,0,0,0,0,0
Sierra Leone,21/01/2009,3,0,0,0,0,0,0,3
Sierra Leone,22/01/2009,4,0,0,0,0,0,0,4
Sierra Leone,23/01/2009,2,0,0,0,0,0,0,2
Sierra Leone,24/01/2009,0,0,0,0,6,0,0,6
Sierra Leone,25/01/2009,2,0,0,0,6,2,0,10
Sierra Leone,26/01/2009,13,0,0,0,3,0,0,16
Sierra Leone,27/01/2009,12,2,0,0,3,0,0,17
Sierra Leone,28/01/2009,-1,0,0,0,0,0,0,-1
Sierra Leone,29/01/2009,1,0,0,0,-1,0,0,0
Sierra Leone,30/01/2009,0,0,-1,0,-1,0,0,-2
Sierra Leone,31/01/2009,2,0,0,0,18,0,0,20
Somalia,01/01/2009,71,0,0,0,9,1,0,81
Somalia,02/01/2009,81,0,0,0,-2,25,0,104
Somalia,03/01/2009,19,0,0,0,0,20,0,39
Somalia,04/01/2009,49,0,-4,0,-6,13,0,52
Somalia,05/01/2009,29,0,0,0,38,21,0,88
Somalia,06/01/2009,71,0,0,0,9,22,0,102
Somalia,07/01/2009,43,0,0,0,-44,2,0,1
Somalia,08/01/2009,87,0,0,0,-18,2,0,71
Somalia,09/01/2009,95,0,-2,0,-38,9,0,64
Somalia,10/01/2009,37,2,-5,0,-55,4,0,-17
Somalia,11/01/2009,66,0,0,0,-22,4,0,48
Somalia,12/01/2009,35,6,-2,0,-5,7,0,41
Somalia,13/01/2009,37,0,0,0,-77,2,0,-38
Somalia,14/01/2009,53,0,0,0,5,0,0,58
Somalia,15/01/2009,47,2,0,0,29,7,0,85
Somalia,16/01/2009,49,0,0,0,1,6,0,56
Somalia,17/01/2009,6,0,0,0,8,2,0,16
Somalia,18/01/2009,3,0,0,0,5,0,0,8
Somalia,19/01/2009,17,0,0,0,7,6,0,30
Somalia,20/01/2009,31,0,0,0,15,1,0,47
Somalia,21/01/2009,9,0,0,0,-9,5,0,5
Somalia,22/01/2009,35,0,4,0,-4,0,0,35
Somalia,23/01/2009,41,2,0,0,11,7,0,61
Somalia,24/01/2009,7,0,2,0,-32,5,0,-18
Somalia,25/01/2009,-11,0,0,0,9,0,0,-2
Somalia,26/01/2009,7,0,-2,0,2,-2,0,5
Somalia,27/01/2009,46,0,0,0,21,3,0,70
Somalia,28/01/2009,49,0,0,0,3,3,0,55
Somalia,29/01/2009,44,0,3,0,60,3,0,110
Somalia,30/01/2009,40,0,0,0,38,2,0,80
Somalia,31/01/2009,-8,0,0,0,28,1,0,21
Syria,01/01/2009,31,0,0,0,0,5,0,36
Syria,02/01/2009,45,0,0,0,11,9,0,65
Syria,03/01/2009,42,0,0,0,11,3,0,56
Syria,04/01/2009,26,0,0,0,0,8,0,34
Syria,05/01/2009,28,0,0,0,0,1,0,29
Syria,06/01/2009,54,0,0,0,9,0,0,63
Syria,07/01/2009,32,0,0,0,9,1,0,42
Syria,08/01/2009,41,0,0,0,3,0,0,44
Syria,09/01/2009,9,0,0,0,3,4,0,16
Syria,10/01/2009,17,0,1,0,0,0,0,18
Syria,11/01/2009,43,0,0,0,0,13,0,56
Syria,12/01/2009,44,0,0,0,0,9,0,53
Syria,13/01/2009,30,0,0,0,6,15,0,51
Syria,14/01/2009,24,0,0,0,0,0,0,24
Syria,15/01/2009,28,0,0,0,-2,5,0,31
Syria,16/01/2009,32,0,0,0,-3,1,0,30
Syria,17/01/2009,47,0,0,0,24,0,0,71
Syria,18/01/2009,4,0,0,0,2,2,0,8
Syria,19/01/2009,55,0,0,0,3,8,0,66
Syria,20/01/2009,23,0,0,0,19,7,0,49
Syria,21/01/2009,16,0,0,0,13,4,0,33
Syria,22/01/2009,3,0,0,0,9,0,0,12
Syria,23/01/2009,7,0,0,0,4,2,0,13
Syria,24/01/2009,34,0,1,0,6,6,0,47
Syria,25/01/2009,3,0,0,0,0,4,0,7
Syria,26/01/2009,10,0,0,0,0,0,0,10
Syria,27/01/2009,40,0,0,0,16,4,0,60
Syria,28/01/2009,15,2,0,0,-2,2,0,17
Syria,29/01/2009,20,6,0,0,7,1,0,34
Syria,30/01/2009,25,0,0,0,8,11,0,44
Syria,31/01/2009,6,0,0,0,0,12,0,18
Yemen,01/01/2009,9,0,0,0,-3,5,0,11
Yemen,02/01/2009,16,0,0,0,18,6,0,40
Yemen,03/01/2009,22,0,0,0,4,2,0,28
Yemen,04/01/2009,-2,0,0,0,6,6,0,10
Yemen,05/01/2009,1,0,0,0,0,3,0,4
Yemen,06/01/2009,3,0,0,0,6,0,0,9
Yemen,07/01/2009,2,0,0,0,6,0,0,8
Yemen,08/01/2009,9,0,0,0,0,0,0,9
Yemen,09/01/2009,12,0,0,0,5,2,0,19
Yemen,10/01/2009,7,0,0,0,6,2,0,15
Yemen,11/01/2009,10,0,0,0,14,1,0,25
Yemen,12/01/2009,2,0,0,0,21,0,0,23
Yemen,13/01/2009,17,0,0,0,0,2,0,19
Yemen,14/01/2009,3,0,0,0,-4,0,0,-1
Yemen,15/01/2009,40,0,0,0,-2,3,0,41
Yemen,16/01/2009,22,0,0,0,0,5,0,27
Yemen,17/01/2009,17,0,0,0,0,0,0,17
Yemen,18/01/2009,8,0,0,0,20,2,0,30
Yemen,19/01/2009,14,0,0,0,30,0,0,44
Yemen,20/01/2009,6,0,0,0,2,4,0,12
Yemen,21/01/2009,18,0,0,0,1,3,0,22
Yemen,22/01/2009,16,0,0,0,23,0,0,39
Yemen,23/01/2009,66,0,0,0,-1,0,0,65
Yemen,24/01/2009,49,0,-1,0,54,1,0,103
Yemen,25/01/2009,21,0,0,0,9,0,0,30
Yemen,26/01/2009,110,4,2,0,62,0,0,178
Yemen,27/01/2009,65,0,2,0,0,0,0,67
Yemen,28/01/2009,0,0,0,0,-2,0,0,-2
Yemen,29/01/2009,29,0,4,0,25,5,0,63
Yemen,30/01/2009,9,0,1,0,0,5,0,15
Yemen,31/01/2009,0,0,1,0,12,0,0,13
Afghanistan,01/03/2012,264,0,3,0,52,17,0,336
Afghanistan,02/03/2012,323,0,2,0,52,36,0,413
Afghanistan,03/03/2012,161,0,-1,0,19,6,0,185
Afghanistan,04/03/2012,139,0,0,0,24,15,0,178
Afghanistan,05/03/2012,166,0,0,0,37,20,0,223
Afghanistan,06/03/2012,222,0,0,0,109,23,0,354
Afghanistan,07/03/2012,294,2,-7,0,26,21,0,336
Afghanistan,08/03/2012,311,0,-2,0,40,11,0,360
Afghanistan,09/03/2012,161,0,0,0,29,19,0,209
Afghanistan,10/03/2012,185,4,1,0,1,9,0,200
Afghanistan,11/03/2012,551,0,2,0,65,32,0,650
Afghanistan,12/03/2012,614,2,2,0,107,56,0,781
Afghanistan,13/03/2012,777,4,-1,0,87,64,0,931
Afghanistan,14/03/2012,475,2,-2,0,86,63,0,624
Afghanistan,15/03/2012,418,4,3,0,230,54,0,709
Afghanistan,16/03/2012,407,14,-4,0,122,50,0,589
Afghanistan,17/03/2012,349,0,0,0,125,31,0,505
Afghanistan,18/03/2012,323,4,0,0,101,13,0,441
Afghanistan,19/03/2012,381,0,-1,0,102,18,0,500
Afghanistan,20/03/2012,426,0,5,0,121,29,0,581
Afghanistan,21/03/2012,589,0,-6,0,311,65,0,959
Afghanistan,22/03/2012,660,2,1,0,290,64,0,1017
Afghanistan,23/03/2012,502,2,1,0,251,27,0,783
Afghanistan,24/03/2012,256,10,0,0,43,11,0,320
Afghanistan,25/03/2012,281,2,-3,0,84,27,0,391
Afghanistan,26/03/2012,422,8,0,0,90,31,0,551
Afghanistan,27/03/2012,395,0,-2,0,62,35,0,490
Afghanistan,28/03/2012,319,6,0,0,74,38,0,437
Afghanistan,29/03/2012,293,2,1,0,68,27,0,391
Afghanistan,30/03/2012,113,0,-2,0,18,7,0,136
Afghanistan,31/03/2012,133,2,0,0,22,7,0,164
Albania,01/03/2012,15,0,4,0,-2,4,0,21
Albania,02/03/2012,8,0,0,0,3,1,0,12
Albania,03/03/2012,2,0,0,0,0,1,0,3
Albania,04/03/2012,3,0,0,0,6,0,0,9
Albania,05/03/2012,0,0,0,0,0,2,0,2
Albania,06/03/2012,11,0,0,0,9,0,0,20
Albania,07/03/2012,2,0,1,0,0,2,0,5
Albania,08/03/2012,9,0,1,0,0,0,0,10
Albania,09/03/2012,3,0,0,0,-2,0,0,1
Albania,10/03/2012,27,0,0,0,-2,4,0,29
Albania,11/03/2012,-3,0,0,0,0,0,0,-3
Albania,12/03/2012,3,0,0,0,0,3,0,6
Albania,13/03/2012,5,0,0,0,-4,1,0,2
Albania,14/03/2012,11,0,0,0,-2,0,0,9
Albania,15/03/2012,2,0,0,0,5,0,0,7
Albania,16/03/2012,8,0,0,0,-5,2,0,5
Albania,17/03/2012,15,0,0,0,-7,5,0,13
Albania,18/03/2012,0,0,0,0,0,1,0,1
Albania,19/03/2012,7,0,0,0,2,3,0,12
Albania,20/03/2012,35,0,0,0,-2,11,0,44
Albania,21/03/2012,23,0,1,0,15,4,0,43
Albania,22/03/2012,5,0,0,0,-6,2,0,1
Albania,23/03/2012,15,0,1,0,6,0,0,22
Albania,24/03/2012,40,0,1,0,13,2,0,56
Albania,25/03/2012,3,0,0,0,3,0,0,6
Albania,26/03/2012,9,0,0,0,0,2,0,11
Albania,27/03/2012,12,0,0,0,1,2,0,15
Albania,28/03/2012,14,0,-5,0,4,0,0,13
Albania,29/03/2012,3,0,0,0,0,0,0,3
Albania,30/03/2012,10,0,0,0,0,3,0,13
Albania,31/03/2012,2,0,0,0,12,0,0,14
Algeria,01/03/2012,16,0,3,0,8,2,0,29
Algeria,02/03/2012,114,0,3,0,-8,2,0,111
Algeria,03/03/2012,19,0,0,0,11,3,0,33
Algeria,04/03/2012,9,0,0,0,-1,0,0,8
Algeria,05/03/2012,9,0,0,0,4,0,0,13
Algeria,06/03/2012,18,0,0,0,5,0,0,23
Algeria,07/03/2012,31,0,1,0,12,3,0,47
Algeria,08/03/2012,16,0,0,0,0,0,0,16
Algeria,09/03/2012,4,0,0,0,0,0,0,4
Algeria,10/03/2012,-1,0,0,0,7,0,0,6
Algeria,11/03/2012,21,0,0,0,0,0,0,21
Algeria,12/03/2012,42,0,1,0,22,0,0,65
Algeria,13/03/2012,18,2,1,0,10,4,0,35
Algeria,14/03/2012,31,0,1,0,3,4,0,39
Algeria,15/03/2012,23,0,1,0,1,1,0,26
Algeria,16/03/2012,27,0,-2,0,0,1,0,26
Algeria,17/03/2012,20,0,0,0,15,1,0,36
Algeria,18/03/2012,9,0,0,0,10,0,0,19
Algeria,19/03/2012,25,0,-2,0,0,0,0,23
Algeria,20/03/2012,18,0,0,0,3,2,0,23
Algeria,21/03/2012,316,0,0,0,49,3,0,368
Algeria,22/03/2012,333,0,-2,0,28,9,0,368
Algeria,23/03/2012,145,0,0,0,6,4,0,155
Algeria,24/03/2012,80,0,0,0,42,0,0,122
Algeria,25/03/2012,29,0,2,0,4,3,0,38
Algeria,26/03/2012,47,0,0,0,8,1,0,56
Algeria,27/03/2012,86,0,0,0,27,6,0,119
Algeria,28/03/2012,48,0,0,0,31,2,0,81
Algeria,29/03/2012,127,0,0,0,63,22,0,212
Algeria,30/03/2012,72,0,-4,0,33,4,0,105
Algeria,31/03/2012,27,0,0,0,24,0,0,51
Bangladesh,01/03/2012,20,0,0,0,9,1,0,30
Bangladesh,02/03/2012,10,0,-4,0,4,3,0,13
Bangladesh,03/03/2012,16,0,-2,0,4,5,0,23
Bangladesh,04/03/2012,19,0,-2,0,-1,1,0,17
Bangladesh,05/03/2012,30,0,-1,0,-4,1,0,26
Bangladesh,06/03/2012,21,0,0,0,7,1,0,29
Bangladesh,07/03/2012,8,0,0,0,9,0,0,17
Bangladesh,08/03/2012,17,0,0,0,5,0,0,22
Bangladesh,09/03/2012,3,0,0,0,0,2,0,5
Bangladesh,10/03/2012,5,0,0,0,0,3,0,8
Bangladesh,11/03/2012,17,0,0,0,9,0,0,26
Bangladesh,12/03/2012,13,0,-2,0,10,6,0,27
Bangladesh,13/03/2012,14,0,0,0,12,3,0,29
Bangladesh,14/03/2012,6,0,0,0,33,4,0,43
Bangladesh,15/03/2012,9,0,0,0,0,0,0,9
Bangladesh,16/03/2012,43,4,0,0,3,0,0,50
Bangladesh,17/03/2012,12,0,0,0,-2,4,0,14
Bangladesh,18/03/2012,9,0,0,0,4,1,0,14
Bangladesh,19/03/2012,4,0,0,0,-1,1,0,4
Bangladesh,20/03/2012,23,0,0,0,3,9,0,35
Bangladesh,21/03/2012,25,0,0,0,9,1,0,35
Bangladesh,22/03/2012,24,0,0,0,7,7,0,38
Bangladesh,23/03/2012,35,0,0,0,12,5,0,52
Bangladesh,24/03/2012,24,0,1,0,3,4,0,32
Bangladesh,25/03/2012,35,0,0,0,3,3,0,41
Bangladesh,26/03/2012,50,0,1,0,24,4,0,79
Bangladesh,27/03/2012,23,0,0,0,3,5,0,31
Bangladesh,28/03/2012,4,2,1,0,25,2,0,34
Bangladesh,29/03/2012,15,2,0,0,9,5,0,31
Bangladesh,30/03/2012,2,0,0,0,9,0,0,11
Bangladesh,31/03/2012,5,0,0,0,6,2,0,13
Cameroon,01/03/2012,10,0,0,0,0,0,0,10
Cameroon,02/03/2012,29,0,0,0,0,0,0,29
Cameroon,03/03/2012,3,0,0,0,0,0,0,3
Cameroon,04/03/2012,0,0,0,0,0,0,0,0
Cameroon,05/03/2012,3,0,0,0,1,0,0,4
Cameroon,06/03/2012,5,0,0,0,0,0,0,5
Cameroon,07/03/2012,4,2,0,0,0,0,0,6
Cameroon,08/03/2012,0,0,0,0,3,0,0,3
Cameroon,09/03/2012,2,0,0,0,0,0,0,2
Cameroon,10/03/2012,-4,0,0,0,3,0,0,-1
Cameroon,11/03/2012,-6,0,0,0,27,0,0,21
Cameroon,12/03/2012,8,0,0,0,3,0,0,11
Cameroon,13/03/2012,13,0,0,0,3,0,0,16
Cameroon,14/03/2012,2,0,0,0,0,0,0,2
Cameroon,15/03/2012,17,0,0,0,6,2,0,25
Cameroon,16/03/2012,25,0,0,0,3,0,0,28
Cameroon,17/03/2012,9,0,0,0,1,0,0,10
Cameroon,18/03/2012,0,0,0,0,-2,0,0,-2
Cameroon,19/03/2012,0,0,0,0,-2,0,0,-2
Cameroon,20/03/2012,2,0,0,0,3,0,0,5
Cameroon,21/03/2012,0,0,0,0,-3,0,0,-3
Cameroon,22/03/2012,1,0,0,0,-2,0,0,-1
Cameroon,23/03/2012,0,0,0,0,0,0,0,0
Cameroon,24/03/2012,0,0,0,0,0,0,0,0
Cameroon,25/03/2012,2,0,0,0,0,0,0,2
Cameroon,26/03/2012,3,0,0,0,3,0,0,6
Cameroon,27/03/2012,2,0,0,0,0,0,0,2
Cameroon,28/03/2012,0,0,0,0,0,0,0,0
Cameroon,29/03/2012,0,0,0,0,0,0,0,0
Cameroon,31/03/2012,3,0,0,0,3,0,0,6
China,01/03/2012,186,6,3,0,31,25,0,251
China,02/03/2012,168,2,-12,0,48,42,0,248
China,03/03/2012,43,0,-1,0,44,17,0,103
China,04/03/2012,156,4,-3,0,56,24,0,237
China,05/03/2012,202,4,1,0,31,24,0,262
China,06/03/2012,145,6,-5,0,42,31,0,219
China,07/03/2012,126,0,-15,0,54,42,0,207
China,08/03/2012,194,10,-14,0,81,28,0,299
China,09/03/2012,169,0,-4,0,67,15,0,247
China,10/03/2012,100,2,7,0,84,18,0,211
China,11/03/2012,69,0,-6,0,46,16,0,125
China,12/03/2012,205,0,-6,0,46,34,0,279
China,13/03/2012,162,2,1,0,142,23,0,330
China,14/03/2012,121,4,0,0,83,28,0,236
China,15/03/2012,118,2,-15,0,43,15,0,163
China,16/03/2012,170,10,1,0,80,25,0,286
China,17/03/2012,88,0,0,0,65,12,0,165
China,18/03/2012,113,6,0,0,109,6,0,234
China,19/03/2012,147,6,0,0,92,29,0,274
China,20/03/2012,156,4,-5,0,72,36,0,263
China,21/03/2012,211,8,-13,0,91,22,0,319
China,22/03/2012,190,2,-16,0,50,31,0,257
China,23/03/2012,188,2,-22,0,58,29,0,255
China,24/03/2012,102,6,-10,0,55,9,0,162
China,25/03/2012,147,6,-1,0,11,19,0,182
China,26/03/2012,233,4,-5,0,58,89,0,379
China,27/03/2012,188,0,-4,0,88,27,0,299
China,28/03/2012,238,2,-3,0,87,61,0,385
China,29/03/2012,81,4,-1,0,42,14,0,140
China,30/03/2012,97,2,0,0,39,2,0,140
China,31/03/2012,50,4,2,0,30,3,0,89
Egypt,01/03/2012,57,2,-4,0,73,11,0,139
Egypt,02/03/2012,50,0,-2,0,67,26,0,141
Egypt,03/03/2012,109,0,-2,0,64,19,0,190
Egypt,04/03/2012,107,0,-4,0,49,8,0,160
Egypt,05/03/2012,56,0,0,0,16,10,0,82
Egypt,06/03/2012,73,4,-2,0,12,4,0,91
Egypt,07/03/2012,38,2,-4,0,38,14,0,88
Egypt,08/03/2012,56,0,0,0,57,17,0,130
Egypt,09/03/2012,134,0,0,0,58,7,0,199
Egypt,10/03/2012,166,0,2,0,17,15,0,200
Egypt,11/03/2012,185,0,0,0,41,14,0,240
Egypt,12/03/2012,270,0,2,0,17,20,0,309
Egypt,13/03/2012,189,2,1,0,16,14,0,222
Egypt,14/03/2012,64,0,0,0,16,10,0,90
Egypt,15/03/2012,67,2,0,0,36,3,0,108
Egypt,16/03/2012,45,2,1,0,-3,3,0,48
Egypt,17/03/2012,46,4,2,0,11,7,0,70
Egypt,18/03/2012,93,0,0,0,117,13,0,223
Egypt,19/03/2012,69,2,-5,0,123,16,0,205
Egypt,20/03/2012,41,0,-6,0,61,6,0,102
Egypt,21/03/2012,60,2,1,0,36,9,0,108
Egypt,22/03/2012,53,0,0,0,31,10,0,94
Egypt,23/03/2012,71,0,0,0,37,11,0,119
Egypt,24/03/2012,31,6,0,0,1,20,0,58
Egypt,25/03/2012,25,0,0,0,17,16,0,58
Egypt,26/03/2012,21,0,-14,0,51,21,0,79
Egypt,27/03/2012,66,0,-8,0,40,12,0,110
Egypt,28/03/2012,68,0,0,0,44,16,0,128
Egypt,29/03/2012,44,0,-4,0,66,15,0,121
Egypt,30/03/2012,12,0,-4,0,24,3,0,35
Egypt,31/03/2012,10,0,0,0,10,5,0,25
Eritrea,01/03/2012,0,0,0,0,0,0,0,0
Eritrea,02/03/2012,3,0,0,0,6,0,0,9
Eritrea,03/03/2012,9,0,0,0,3,4,0,16
Eritrea,05/03/2012,6,0,0,0,6,0,0,12
Eritrea,06/03/2012,4,0,0,0,-6,0,0,-2
Eritrea,07/03/2012,0,0,0,0,-12,1,0,-11
Eritrea,08/03/2012,11,0,0,0,-1,2,0,12
Eritrea,09/03/2012,2,0,0,0,0,0,0,2
Eritrea,10/03/2012,0,0,0,0,3,0,0,3
Eritrea,11/03/2012,0,0,0,0,3,0,0,3
Eritrea,12/03/2012,8,0,0,0,0,0,0,8
Eritrea,13/03/2012,1,0,0,0,0,0,0,1
Eritrea,14/03/2012,1,0,0,0,-4,0,0,-3
Eritrea,15/03/2012,94,0,0,0,1,2,0,97
Eritrea,16/03/2012,57,0,0,0,0,6,0,63
Eritrea,17/03/2012,19,0,0,0,0,2,0,21
Eritrea,18/03/2012,0,0,0,0,0,0,0,0
Eritrea,19/03/2012,3,0,0,0,9,0,0,12
Eritrea,20/03/2012,9,0,0,0,0,0,0,9
Eritrea,21/03/2012,22,0,0,0,1,0,0,23
Eritrea,22/03/2012,4,0,0,0,0,0,0,4
Eritrea,23/03/2012,0,0,0,0,6,0,0,6
Eritrea,24/03/2012,5,0,0,0,0,0,0,5
Eritrea,25/03/2012,3,0,0,0,0,0,0,3
Eritrea,26/03/2012,77,0,0,0,0,0,0,77
Eritrea,27/03/2012,10,0,0,0,0,2,0,12
Eritrea,28/03/2012,0,0,0,0,1,0,0,1
Eritrea,29/03/2012,1,0,0,0,6,0,0,7
Eritrea,30/03/2012,0,0,0,0,0,0,0,0
Eritrea,31/03/2012,0,0,0,0,0,0,0,0
Georgia,01/03/2012,65,2,0,0,40,9,0,116
Georgia,02/03/2012,22,0,1,0,0,5,0,28
Georgia,03/03/2012,44,4,0,0,-3,2,0,47
Georgia,04/03/2012,25,0,0,0,0,2,0,27
Georgia,05/03/2012,59,2,0,0,33,12,0,106
Georgia,06/03/2012,82,8,1,0,50,29,0,170
Georgia,07/03/2012,97,0,-1,0,21,13,0,130
Georgia,08/03/2012,39,0,-2,0,17,5,0,59
Georgia,09/03/2012,55,0,0,0,18,5,0,78
Georgia,10/03/2012,19,0,0,0,18,7,0,44
Georgia,11/03/2012,5,2,0,0,25,1,0,33
Georgia,12/03/2012,27,2,-2,0,24,5,0,56
Georgia,13/03/2012,103,0,0,0,43,12,0,158
Georgia,14/03/2012,128,4,0,0,35,14,0,181
Georgia,15/03/2012,169,2,0,0,56,13,0,240
Georgia,16/03/2012,56,0,0,0,41,9,0,106
Georgia,17/03/2012,18,0,0,0,31,3,0,52
Georgia,18/03/2012,27,0,0,0,12,1,0,40
Georgia,19/03/2012,21,0,-1,0,51,10,0,81
Georgia,20/03/2012,53,2,-1,0,57,10,0,121
Georgia,21/03/2012,47,6,1,0,21,9,0,84
Georgia,22/03/2012,50,2,-1,0,39,10,0,100
Georgia,23/03/2012,12,0,0,0,5,2,0,19
Georgia,24/03/2012,20,2,-4,0,25,5,0,48
Georgia,25/03/2012,34,0,0,0,4,2,0,40
Georgia,26/03/2012,80,0,0,0,51,3,0,134
Georgia,27/03/2012,79,0,-2,0,46,2,0,125
Georgia,28/03/2012,133,0,0,0,60,14,0,207
Georgia,29/03/2012,76,8,-9,0,20,10,0,105
Georgia,30/03/2012,10,4,-1,0,1,1,0,15
Georgia,31/03/2012,5,2,-1,0,12,2,0,20
India,01/03/2012,124,8,2,0,82,13,0,229
India,02/03/2012,106,0,0,0,21,15,0,142
India,03/03/2012,69,2,-2,0,22,12,0,103
India,04/03/2012,44,2,2,0,10,13,0,71
India,05/03/2012,146,0,0,0,30,12,0,188
India,06/03/2012,57,0,1,0,66,16,0,140
India,07/03/2012,50,0,1,0,45,14,0,110
India,08/03/2012,42,0,-1,0,21,8,0,70
India,09/03/2012,55,0,-1,0,31,19,0,104
India,10/03/2012,41,2,-2,0,16,13,0,70
India,11/03/2012,34,0,-2,0,30,6,0,68
India,12/03/2012,89,0,-6,0,33,4,0,120
India,13/03/2012,83,0,-11,0,15,12,0,99
India,14/03/2012,132,0,1,0,44,7,0,184
India,15/03/2012,100,0,-13,0,48,15,0,150
India,16/03/2012,65,2,-5,0,54,12,0,128
India,17/03/2012,47,0,-8,0,43,10,0,92
India,18/03/2012,70,0,-8,0,34,11,0,107
India,19/03/2012,71,0,-3,0,37,22,0,127
India,20/03/2012,119,0,-3,0,48,8,0,172
India,21/03/2012,122,0,-3,0,21,25,0,165
India,22/03/2012,117,2,-6,0,41,9,0,163
India,23/03/2012,84,2,-1,0,41,14,0,140
India,24/03/2012,61,0,0,0,28,13,0,102
India,25/03/2012,69,2,-5,0,36,15,0,117
India,26/03/2012,94,0,0,0,48,28,0,170
India,27/03/2012,68,8,-1,0,20,33,0,128
India,28/03/2012,103,6,-2,0,27,21,0,155
India,29/03/2012,49,0,0,0,-2,8,0,55
India,30/03/2012,23,2,1,0,-2,0,0,24
India,31/03/2012,55,0,-2,0,32,6,0,91
Iran,01/03/2012,235,2,1,0,109,22,0,369
Iran,02/03/2012,169,0,6,0,24,35,0,234
Iran,03/03/2012,89,0,2,0,55,15,0,161
Iran,04/03/2012,162,4,0,0,11,24,0,201
Iran,05/03/2012,299,2,1,0,136,27,0,465
Iran,06/03/2012,389,2,4,0,103,25,0,523
Iran,07/03/2012,263,6,-4,0,124,36,0,425
Iran,08/03/2012,179,0,9,0,59,24,0,271
Iran,09/03/2012,178,0,0,0,70,29,0,277
Iran,10/03/2012,172,4,1,0,48,23,0,248
Iran,11/03/2012,227,0,2,0,69,15,0,313
Iran,12/03/2012,296,2,1,0,108,28,0,435
Iran,13/03/2012,241,10,0,0,49,13,0,313
Iran,14/03/2012,266,0,1,0,81,16,0,364
Iran,15/03/2012,266,0,8,0,102,39,0,415
Iran,16/03/2012,146,2,0,0,43,13,0,204
Iran,17/03/2012,105,2,0,0,36,17,0,160
Iran,18/03/2012,52,6,-2,0,20,6,0,82
Iran,19/03/2012,116,0,1,0,23,5,0,145
Iran,20/03/2012,183,0,1,0,58,21,0,263
Iran,21/03/2012,166,4,7,0,78,22,0,277
Iran,22/03/2012,157,0,6,0,41,14,0,218
Iran,23/03/2012,162,0,0,0,53,27,0,242
Iran,24/03/2012,98,2,-12,0,17,12,0,117
Iran,25/03/2012,79,0,0,0,40,9,0,128
Iran,26/03/2012,130,0,1,0,43,22,0,196
Iran,27/03/2012,100,0,0,0,15,13,0,128
Iran,28/03/2012,130,0,-4,0,27,30,0,183
Iran,29/03/2012,166,0,-3,0,10,26,0,199
Iran,30/03/2012,37,0,2,0,18,13,0,70
Iran,31/03/2012,87,0,-6,0,62,5,0,148
Iraq,01/03/2012,196,0,0,0,37,20,0,253
Iraq,02/03/2012,101,0,0,0,33,17,0,151
Iraq,03/03/2012,52,0,0,0,18,1,0,71
Iraq,04/03/2012,75,0,-4,0,7,5,0,83
Iraq,05/03/2012,103,0,3,0,51,9,0,166
Iraq,06/03/2012,93,6,2,0,40,12,0,153
Iraq,07/03/2012,108,0,0,0,38,21,0,167
Iraq,08/03/2012,121,2,0,0,32,20,0,175
Iraq,09/03/2012,99,0,-4,0,18,12,0,125
Iraq,10/03/2012,84,0,0,0,3,2,0,89
Iraq,11/03/2012,81,0,0,0,25,3,0,109
Iraq,12/03/2012,231,2,0,0,26,17,0,276
Iraq,13/03/2012,240,0,0,0,55,16,0,311
Iraq,14/03/2012,151,0,3,0,47,9,0,210
Iraq,15/03/2012,179,6,4,0,94,12,0,295
Iraq,16/03/2012,350,10,-4,0,32,38,0,426
Iraq,17/03/2012,295,0,-10,0,63,56,0,404
Iraq,18/03/2012,230,2,2,0,78,23,0,335
Iraq,19/03/2012,117,0,1,0,44,14,0,176
Iraq,20/03/2012,218,6,2,0,36,10,0,272
Iraq,21/03/2012,274,0,0,0,30,25,0,329
Iraq,22/03/2012,213,4,0,0,89,25,0,331
Iraq,23/03/2012,151,4,5,0,80,18,0,258
Iraq,24/03/2012,177,6,1,0,70,13,0,267
Iraq,25/03/2012,170,4,2,0,55,14,0,245
Iraq,26/03/2012,202,2,0,0,65,14,0,283
Iraq,27/03/2012,132,2,1,0,35,28,0,198
Iraq,28/03/2012,170,0,0,0,50,18,0,238
Iraq,29/03/2012,122,6,0,0,60,7,0,195
Iraq,30/03/2012,52,4,0,0,16,0,0,72
Iraq,31/03/2012,29,0,-7,0,15,5,0,42
Morocco,01/03/2012,17,0,0,0,18,0,0,35
Morocco,02/03/2012,16,0,0,0,18,1,0,35
Morocco,03/03/2012,6,0,0,0,12,1,0,19
Morocco,04/03/2012,19,0,0,0,3,0,0,22
Morocco,05/03/2012,13,0,0,0,0,2,0,15
Morocco,06/03/2012,7,0,0,0,9,2,0,18
Morocco,07/03/2012,23,0,0,0,7,6,0,36
Morocco,08/03/2012,14,0,0,0,12,0,0,26
Morocco,09/03/2012,31,2,0,0,-4,5,0,34
Morocco,10/03/2012,21,2,0,0,5,4,0,32
Morocco,11/03/2012,11,0,0,0,0,4,0,15
Morocco,12/03/2012,13,0,0,0,0,0,0,13
Morocco,13/03/2012,13,0,0,0,2,1,0,16
Morocco,14/03/2012,37,0,0,0,1,9,0,47
Morocco,15/03/2012,21,0,0,0,24,4,0,49
Morocco,16/03/2012,6,0,0,0,21,9,0,36
Morocco,17/03/2012,3,0,0,0,23,23,0,49
Morocco,18/03/2012,7,0,0,0,9,7,0,23
Morocco,19/03/2012,8,0,0,0,19,2,0,29
Morocco,20/03/2012,34,0,0,0,4,1,0,39
Morocco,21/03/2012,73,0,0,0,12,2,0,87
Morocco,22/03/2012,24,0,0,0,3,4,0,31
Morocco,23/03/2012,6,0,0,0,4,0,0,10
Morocco,24/03/2012,4,0,0,0,0,7,0,11
Morocco,25/03/2012,8,0,0,0,1,0,0,9
Morocco,26/03/2012,19,0,0,0,0,3,0,22
Morocco,27/03/2012,19,0,0,0,0,0,0,19
Morocco,28/03/2012,0,0,0,0,3,0,0,3
Morocco,29/03/2012,4,0,0,0,3,0,0,7
Morocco,30/03/2012,3,0,0,0,0,0,0,3
Morocco,31/03/2012,0,0,0,0,0,0,0,0
Nigeria,01/03/2012,39,0,-2,0,22,6,0,65
Nigeria,02/03/2012,55,0,-1,0,14,9,0,77
Nigeria,03/03/2012,10,0,0,0,12,3,0,25
Nigeria,04/03/2012,14,0,-1,0,16,13,0,42
Nigeria,05/03/2012,35,0,0,0,58,11,0,104
Nigeria,06/03/2012,40,0,0,0,21,7,0,68
Nigeria,07/03/2012,21,0,0,0,18,7,0,46
Nigeria,08/03/2012,59,0,2,0,54,7,0,122
Nigeria,09/03/2012,118,2,0,0,39,9,0,168
Nigeria,10/03/2012,53,4,1,0,35,2,0,95
Nigeria,11/03/2012,54,0,0,0,3,23,0,80
Nigeria,12/03/2012,78,0,0,0,16,12,0,106
Nigeria,13/03/2012,37,0,-2,0,26,1,0,62
Nigeria,14/03/2012,42,0,0,0,2,7,0,51
Nigeria,15/03/2012,42,0,1,0,34,9,0,86
Nigeria,16/03/2012,21,0,-2,0,14,3,0,36
Nigeria,17/03/2012,11,0,0,0,18,3,0,32
Nigeria,18/03/2012,20,0,0,0,6,3,0,29
Nigeria,19/03/2012,43,0,-1,0,10,2,0,54
Nigeria,20/03/2012,42,0,-5,0,13,5,0,55
Nigeria,21/03/2012,58,0,-4,0,15,4,0,73
Nigeria,22/03/2012,45,0,-3,0,22,4,0,68
Nigeria,23/03/2012,56,0,-11,0,35,7,0,87
Nigeria,24/03/2012,18,0,0,0,12,0,0,30
Nigeria,25/03/2012,15,0,1,0,-7,3,0,12
Nigeria,26/03/2012,46,0,-9,0,14,-2,0,49
Nigeria,27/03/2012,22,0,-8,0,57,6,0,77
Nigeria,28/03/2012,3,0,-2,0,40,0,0,41
Nigeria,29/03/2012,16,0,1,0,18,4,0,39
Nigeria,30/03/2012,0,0,0,0,3,1,0,4
Nigeria,31/03/2012,34,0,0,0,12,0,0,46
Pakistan,01/03/2012,143,0,-2,0,63,18,0,222
Pakistan,02/03/2012,141,0,1,0,81,21,0,244
Pakistan,03/03/2012,64,0,0,0,28,11,0,103
Pakistan,04/03/2012,32,0,0,0,4,5,0,41
Pakistan,05/03/2012,66,0,0,0,44,2,0,112
Pakistan,06/03/2012,49,0,2,0,60,6,0,117
Pakistan,07/03/2012,70,2,0,0,22,19,0,113
Pakistan,08/03/2012,69,2,0,0,44,1,0,116
Pakistan,09/03/2012,63,0,0,0,57,13,0,133
Pakistan,10/03/2012,61,0,0,0,14,10,0,85
Pakistan,11/03/2012,60,0,4,0,12,6,0,82
Pakistan,12/03/2012,86,0,2,0,59,13,0,160
Pakistan,13/03/2012,92,0,1,0,195,15,0,303
Pakistan,14/03/2012,60,0,0,0,91,29,0,180
Pakistan,15/03/2012,42,0,0,0,63,21,0,126
Pakistan,16/03/2012,182,2,0,0,77,5,0,266
Pakistan,17/03/2012,148,2,0,0,80,19,0,249
Pakistan,18/03/2012,110,0,-2,0,60,7,0,175
Pakistan,19/03/2012,91,0,-6,0,57,12,0,154
Pakistan,20/03/2012,123,0,2,0,53,4,0,182
Pakistan,21/03/2012,146,2,-5,0,75,28,0,246
Pakistan,22/03/2012,191,2,0,0,64,15,0,272
Pakistan,23/03/2012,141,0,-2,0,79,19,0,237
Pakistan,24/03/2012,64,0,0,0,24,6,0,94
Pakistan,25/03/2012,123,2,0,0,5,11,0,141
Pakistan,26/03/2012,99,4,0,0,45,17,0,165
Pakistan,27/03/2012,121,2,1,0,43,32,0,199
Pakistan,28/03/2012,110,0,0,0,24,12,0,146
Pakistan,29/03/2012,112,0,1,0,28,10,0,151
Pakistan,30/03/2012,10,0,0,0,12,0,0,22
Pakistan,31/03/2012,65,0,-2,0,45,3,0,111
Sierra Leone,01/03/2012,4,0,0,0,15,1,0,20
Sierra Leone,02/03/2012,2,0,0,0,3,0,0,5
Sierra Leone,03/03/2012,9,0,0,0,3,0,0,12
Sierra Leone,04/03/2012,-3,0,0,0,0,1,0,-2
Sierra Leone,05/03/2012,6,0,0,0,0,1,0,7
Sierra Leone,06/03/2012,2,0,0,0,0,0,0,2
Sierra Leone,07/03/2012,2,0,0,0,0,0,0,2
Sierra Leone,08/03/2012,2,0,1,0,0,0,0,3
Sierra Leone,09/03/2012,10,0,0,0,15,3,0,28
Sierra Leone,10/03/2012,4,0,0,0,0,0,0,4
Sierra Leone,11/03/2012,7,0,0,0,0,0,0,7
Sierra Leone,12/03/2012,23,0,0,0,0,0,0,23
Sierra Leone,13/03/2012,20,0,0,0,9,4,0,33
Sierra Leone,14/03/2012,-2,0,0,0,3,0,0,1
Sierra Leone,15/03/2012,3,0,0,0,0,0,0,3
Sierra Leone,16/03/2012,6,0,0,0,0,2,0,8
Sierra Leone,18/03/2012,15,0,0,0,0,0,0,15
Sierra Leone,19/03/2012,8,0,0,0,0,0,0,8
Sierra Leone,20/03/2012,9,0,0,0,0,7,0,16
Sierra Leone,21/03/2012,1,0,0,0,-2,1,0,0
Sierra Leone,22/03/2012,7,0,0,0,3,2,0,12
Sierra Leone,23/03/2012,5,0,0,0,0,0,0,5
Sierra Leone,24/03/2012,0,0,0,0,0,0,0,0
Sierra Leone,25/03/2012,10,0,0,0,0,0,0,10
Sierra Leone,26/03/2012,4,0,0,0,-4,0,0,0
Sierra Leone,27/03/2012,11,0,0,0,0,0,0,11
Sierra Leone,28/03/2012,4,0,0,0,0,0,0,4
Sierra Leone,29/03/2012,0,0,0,0,0,0,0,0
Sierra Leone,30/03/2012,0,0,0,0,0,0,0,0
Sierra Leone,31/03/2012,1,0,0,0,3,0,0,4
Somalia,01/03/2012,89,0,0,0,21,31,0,141
Somalia,02/03/2012,46,0,0,0,3,12,0,61
Somalia,03/03/2012,51,0,0,0,34,16,0,101
Somalia,04/03/2012,61,0,0,0,20,8,0,89
Somalia,05/03/2012,86,4,1,0,66,5,0,162
Somalia,06/03/2012,55,2,2,0,26,8,0,93
Somalia,07/03/2012,53,2,0,0,63,11,0,129
Somalia,08/03/2012,82,0,-1,0,60,7,0,148
Somalia,09/03/2012,60,2,1,0,14,4,0,81
Somalia,10/03/2012,109,0,0,0,0,21,0,130
Somalia,11/03/2012,149,0,0,0,43,37,0,229
Somalia,12/03/2012,191,0,1,0,101,14,0,307
Somalia,13/03/2012,117,2,0,0,54,7,0,180
Somalia,14/03/2012,163,2,-4,0,26,34,0,221
Somalia,15/03/2012,102,2,0,0,35,3,0,142
Somalia,16/03/2012,63,2,-1,0,40,9,0,113
Somalia,17/03/2012,53,0,0,0,54,4,0,111
Somalia,18/03/2012,53,0,0,0,24,2,0,79
Somalia,19/03/2012,99,0,-6,0,8,3,0,104
Somalia,20/03/2012,105,0,-3,0,40,2,0,144
Somalia,21/03/2012,152,0,-1,0,16,25,0,192
Somalia,22/03/2012,109,0,-2,0,34,9,0,150
Somalia,23/03/2012,115,12,-4,0,15,13,0,151
Somalia,24/03/2012,36,0,0,0,5,7,0,48
Somalia,25/03/2012,39,0,-4,0,18,5,0,58
Somalia,26/03/2012,60,0,-4,0,39,11,0,106
Somalia,27/03/2012,90,0,-2,0,18,5,0,111
Somalia,28/03/2012,74,0,0,0,24,8,0,106
Somalia,29/03/2012,91,0,0,0,39,9,0,139
Somalia,30/03/2012,33,0,-2,0,6,1,0,38
Somalia,31/03/2012,103,0,0,0,0,15,0,118
Syria,01/03/2012,269,0,1,0,74,61,0,405
Syria,02/03/2012,308,4,1,0,68,30,0,411
Syria,03/03/2012,202,0,0,0,11,37,0,250
Syria,04/03/2012,201,6,-2,0,17,37,0,259
Syria,05/03/2012,347,4,-9,0,92,35,0,469
Syria,06/03/2012,352,10,-10,0,56,28,0,436
Syria,07/03/2012,367,10,-26,0,58,69,0,478
Syria,08/03/2012,501,0,-36,0,32,44,0,541
Syria,09/03/2012,508,4,-18,0,45,62,0,601
Syria,10/03/2012,272,0,-2,0,14,30,0,314
Syria,11/03/2012,99,0,-19,0,6,12,0,98
Syria,12/03/2012,540,0,-3,0,98,57,0,692
Syria,13/03/2012,532,2,-10,0,98,39,0,661
Syria,14/03/2012,309,2,-12,0,198,52,0,549
Syria,15/03/2012,314,4,4,0,97,55,0,474
Syria,16/03/2012,193,4,-4,0,52,30,0,275
Syria,17/03/2012,159,0,-8,0,46,20,0,217
Syria,18/03/2012,139,0,-4,0,65,10,0,210
Syria,19/03/2012,284,0,-6,0,32,28,0,338
Syria,20/03/2012,161,0,-1,0,72,21,0,253
Syria,21/03/2012,192,2,1,0,30,25,0,250
Syria,22/03/2012,249,0,-14,0,50,20,0,305
Syria,23/03/2012,254,14,-9,0,143,40,0,442
Syria,24/03/2012,154,10,-5,0,18,17,0,194
Syria,25/03/2012,150,2,1,0,29,11,0,193
Syria,26/03/2012,349,2,4,0,56,18,0,429
Syria,27/03/2012,474,12,-5,0,54,45,0,580
Syria,28/03/2012,265,0,-31,0,9,33,0,276
Syria,29/03/2012,291,2,-20,0,73,29,0,375
Syria,30/03/2012,157,0,-2,0,14,11,0,180
Syria,31/03/2012,136,0,-18,0,-6,17,0,129
Yemen,01/03/2012,23,0,1,0,9,2,0,35
Yemen,02/03/2012,17,0,0,0,3,3,0,23
Yemen,03/03/2012,8,0,0,0,8,8,0,24
Yemen,04/03/2012,49,0,0,0,-1,0,0,48
Yemen,05/03/2012,99,0,3,0,27,7,0,136
Yemen,06/03/2012,77,0,0,0,-3,3,0,77
Yemen,07/03/2012,44,0,0,0,1,11,0,56
Yemen,08/03/2012,18,2,0,0,-11,0,0,9
Yemen,09/03/2012,71,2,0,0,-7,11,0,77
Yemen,10/03/2012,86,0,0,0,20,15,0,121
Yemen,11/03/2012,22,2,0,0,7,0,0,31
Yemen,12/03/2012,41,0,0,0,1,1,0,43
Yemen,13/03/2012,55,0,0,0,3,10,0,68
Yemen,14/03/2012,57,0,0,0,16,4,0,77
Yemen,15/03/2012,33,0,-2,0,29,9,0,69
Yemen,16/03/2012,33,0,0,0,40,3,0,76
Yemen,17/03/2012,29,0,1,0,18,8,0,56
Yemen,18/03/2012,111,0,-6,0,4,12,0,121
Yemen,19/03/2012,105,0,0,0,27,10,0,142
Yemen,20/03/2012,45,0,0,0,12,2,0,59
Yemen,21/03/2012,65,0,-10,0,0,2,0,57
Yemen,22/03/2012,58,0,0,0,16,3,0,77
Yemen,23/03/2012,44,0,-2,0,6,1,0,49
Yemen,24/03/2012,15,0,-2,0,18,1,0,32
Yemen,25/03/2012,37,0,0,0,0,0,0,37
Yemen,26/03/2012,25,0,-8,0,6,2,0,25
Yemen,27/03/2012,49,0,-2,0,17,2,0,66
Yemen,28/03/2012,45,2,0,0,62,5,0,114
Yemen,29/03/2012,72,8,0,0,25,0,0,105
Yemen,30/03/2012,29,0,0,0,2,3,0,34
Yemen,31/03/2012,37,0,0,0,3,0,0,40
Afghanistan,01/01/2010,528,6,-1,0,29,64,0,626
Afghanistan,02/01/2010,362,0,0,0,73,29,0,464
Afghanistan,03/01/2010,272,0,0,0,39,27,0,338
Afghanistan,04/01/2010,411,2,0,0,64,16,0,493
Afghanistan,05/01/2010,363,2,1,0,49,40,0,455
Afghanistan,06/01/2010,414,8,-1,0,58,55,0,534
Afghanistan,07/01/2010,213,4,-1,0,69,48,0,333
Afghanistan,08/01/2010,339,0,-17,0,61,44,0,427
Afghanistan,09/01/2010,332,2,-11,0,62,68,0,453
Afghanistan,10/01/2010,298,4,-1,0,108,59,0,468
Afghanistan,11/01/2010,407,2,-2,0,114,27,0,548
Afghanistan,12/01/2010,389,4,1,0,82,41,0,517
Afghanistan,13/01/2010,372,6,2,0,116,41,0,537
Afghanistan,14/01/2010,455,6,0,0,32,35,0,528
Afghanistan,15/01/2010,308,2,0,0,38,30,0,378
Afghanistan,16/01/2010,296,4,0,0,3,52,0,355
Afghanistan,17/01/2010,263,0,1,0,10,6,0,280
Afghanistan,18/01/2010,226,2,0,0,94,24,0,346
Afghanistan,19/01/2010,319,4,2,0,65,9,0,399
Afghanistan,20/01/2010,243,6,-4,0,46,23,0,314
Afghanistan,21/01/2010,281,2,2,0,39,27,0,351
Afghanistan,22/01/2010,301,0,-4,0,77,29,0,403
Afghanistan,23/01/2010,231,0,-5,0,44,101,0,371
Afghanistan,24/01/2010,383,6,0,0,51,45,0,485
Afghanistan,25/01/2010,360,4,-5,0,33,31,0,423
Afghanistan,26/01/2010,285,18,-7,0,32,35,0,363
Afghanistan,27/01/2010,253,6,-18,0,47,54,0,342
Afghanistan,28/01/2010,288,24,-6,0,86,36,0,428
Afghanistan,29/01/2010,338,6,-10,0,110,28,0,472
Afghanistan,30/01/2010,260,2,0,0,39,31,0,332
Afghanistan,31/01/2010,213,2,-3,0,16,22,0,250
Albania,01/01/2010,63,0,0,0,3,0,0,66
Albania,02/01/2010,6,0,0,0,0,0,0,6
Albania,03/01/2010,0,0,0,0,0,0,0,0
Albania,04/01/2010,0,0,0,0,0,0,0,0
Albania,05/01/2010,6,0,0,0,-4,5,0,7
Albania,06/01/2010,38,0,-6,0,-2,6,0,36
Albania,07/01/2010,12,0,0,0,-2,8,0,18
Albania,08/01/2010,13,0,-2,0,6,3,0,20
Albania,09/01/2010,0,2,0,0,0,0,0,2
Albania,10/01/2010,-1,0,0,0,0,0,0,-1
Albania,11/01/2010,2,0,0,0,-2,0,0,0
Albania,12/01/2010,6,0,-2,0,4,0,0,8
Albania,13/01/2010,1,0,0,0,-2,0,0,-1
Albania,14/01/2010,14,0,0,0,0,1,0,15
Albania,15/01/2010,4,0,0,0,0,0,0,4
Albania,16/01/2010,0,2,0,0,0,0,0,2
Albania,17/01/2010,3,0,0,0,0,1,0,4
Albania,18/01/2010,10,2,0,0,0,0,0,12
Albania,19/01/2010,0,0,2,0,6,0,0,8
Albania,20/01/2010,6,0,0,0,0,0,0,6
Albania,21/01/2010,7,0,0,0,9,3,0,19
Albania,22/01/2010,3,0,0,0,0,5,0,8
Albania,23/01/2010,7,0,-3,0,0,0,0,4
Albania,24/01/2010,7,0,0,0,0,0,0,7
Albania,25/01/2010,2,0,0,0,-4,3,0,1
Albania,26/01/2010,6,0,0,0,15,5,0,26
Albania,27/01/2010,1,0,0,0,3,0,0,4
Albania,28/01/2010,5,0,-1,0,3,0,0,7
Albania,29/01/2010,9,0,-4,0,0,0,0,5
Algeria,01/01/2010,3,0,0,0,-4,0,0,-1
Algeria,02/01/2010,0,0,0,0,6,0,0,6
Algeria,03/01/2010,12,0,0,0,6,0,0,18
Algeria,04/01/2010,6,0,0,0,3,0,0,9
Algeria,05/01/2010,7,0,0,0,0,5,0,12
Algeria,06/01/2010,6,0,0,0,9,15,0,30
Algeria,07/01/2010,15,0,0,0,8,0,0,23
Algeria,08/01/2010,4,0,0,0,0,0,0,4
Algeria,09/01/2010,10,0,0,0,9,0,0,19
Algeria,10/01/2010,19,0,0,0,0,4,0,23
Algeria,11/01/2010,27,0,0,0,40,5,0,72
Algeria,12/01/2010,27,0,0,0,12,2,0,41
Algeria,13/01/2010,1,0,0,0,6,2,0,9
Algeria,14/01/2010,17,2,1,0,6,0,0,26
Algeria,15/01/2010,35,0,0,0,0,0,0,35
Algeria,16/01/2010,6,0,0,0,0,0,0,6
Algeria,17/01/2010,2,0,2,0,-4,0,0,0
Algeria,18/01/2010,-2,0,0,0,0,4,0,2
Algeria,19/01/2010,2,0,0,0,-4,0,0,-2
Algeria,20/01/2010,9,0,0,0,-7,0,0,2
Algeria,21/01/2010,4,0,0,0,28,0,0,32
Algeria,22/01/2010,8,0,0,0,17,2,0,27
Algeria,23/01/2010,4,0,0,0,7,5,0,16
Algeria,24/01/2010,3,0,0,0,0,1,0,4
Algeria,25/01/2010,17,0,0,0,9,0,0,26
Algeria,26/01/2010,13,0,0,0,0,0,0,13
Algeria,27/01/2010,0,0,0,0,3,0,0,3
Algeria,28/01/2010,2,0,0,0,0,0,0,2
Algeria,29/01/2010,6,0,0,0,0,0,0,6
Algeria,30/01/2010,0,0,0,0,0,0,0,0
Algeria,31/01/2010,14,0,0,0,3,2,0,19
Bangladesh,01/01/2010,7,0,0,0,9,0,0,16
Bangladesh,02/01/2010,13,0,0,0,0,0,0,13
Bangladesh,03/01/2010,4,0,0,0,-2,1,0,3
Bangladesh,04/01/2010,11,0,2,0,13,0,0,26
Bangladesh,05/01/2010,37,0,1,0,9,5,0,52
Bangladesh,06/01/2010,26,0,0,0,18,3,0,47
Bangladesh,07/01/2010,17,0,0,0,4,1,0,22
Bangladesh,08/01/2010,24,0,0,0,30,8,0,62
Bangladesh,09/01/2010,10,0,0,0,19,2,0,31
Bangladesh,10/01/2010,28,0,0,0,18,3,0,49
Bangladesh,11/01/2010,26,2,0,0,14,2,0,44
Bangladesh,12/01/2010,20,0,1,0,21,0,0,42
Bangladesh,13/01/2010,14,0,0,0,8,3,0,25
Bangladesh,14/01/2010,42,0,0,0,-1,6,0,47
Bangladesh,15/01/2010,0,0,0,0,3,0,0,3
Bangladesh,16/01/2010,8,0,0,0,15,0,0,23
Bangladesh,17/01/2010,55,0,2,0,-3,2,0,56
Bangladesh,18/01/2010,36,0,0,0,5,0,0,41
Bangladesh,19/01/2010,44,0,0,0,35,3,0,82
Bangladesh,20/01/2010,10,0,0,0,11,1,0,22
Bangladesh,21/01/2010,9,0,0,0,3,0,0,12
Bangladesh,22/01/2010,16,0,0,0,18,0,0,34
Bangladesh,23/01/2010,24,0,-2,0,13,2,0,37
Bangladesh,24/01/2010,7,0,0,0,12,2,0,21
Bangladesh,25/01/2010,7,0,0,0,20,5,0,32
Bangladesh,26/01/2010,26,0,0,0,20,0,0,46
Bangladesh,27/01/2010,18,0,1,0,10,0,0,29
Bangladesh,28/01/2010,28,0,0,0,-1,0,0,27
Bangladesh,29/01/2010,10,2,0,0,-1,3,0,14
Bangladesh,30/01/2010,15,0,1,0,7,5,0,28
Bangladesh,31/01/2010,8,0,0,0,23,3,0,34
Cameroon,01/01/2010,0,0,0,0,0,0,0,0
Cameroon,03/01/2010,0,0,0,0,3,0,0,3
Cameroon,04/01/2010,0,0,0,0,0,0,0,0
Cameroon,05/01/2010,3,0,0,0,0,0,0,3
Cameroon,06/01/2010,0,0,0,0,0,0,0,0
Cameroon,07/01/2010,3,0,0,0,0,0,0,3
Cameroon,08/01/2010,9,0,0,0,0,0,0,9
Cameroon,11/01/2010,4,0,0,0,0,0,0,4
Cameroon,12/01/2010,0,0,0,0,-2,0,0,-2
Cameroon,13/01/2010,18,0,0,0,0,3,0,21
Cameroon,14/01/2010,0,0,0,0,0,0,0,0
Cameroon,15/01/2010,3,0,0,0,0,0,0,3
Cameroon,16/01/2010,0,0,0,0,0,0,0,0
Cameroon,17/01/2010,0,0,0,0,0,0,0,0
Cameroon,18/01/2010,2,0,0,0,0,3,0,5
Cameroon,19/01/2010,0,0,0,0,3,0,0,3
Cameroon,20/01/2010,72,0,0,0,0,0,0,72
Cameroon,21/01/2010,10,0,0,0,-2,1,0,9
Cameroon,22/01/2010,2,0,0,0,0,1,0,3
Cameroon,23/01/2010,0,0,0,0,0,0,0,0
Cameroon,25/01/2010,0,0,0,0,0,0,0,0
Cameroon,26/01/2010,1,0,0,0,0,0,0,1
Cameroon,27/01/2010,2,0,0,0,0,0,0,2
Cameroon,28/01/2010,6,0,0,0,0,0,0,6
Cameroon,29/01/2010,6,0,0,0,0,0,0,6
Cameroon,30/01/2010,0,0,0,0,0,0,0,0
China,01/01/2010,42,0,1,0,35,5,0,83
China,02/01/2010,62,0,0,0,32,7,0,101
China,03/01/2010,78,0,2,0,79,7,0,166
China,04/01/2010,107,0,-4,0,80,8,0,191
China,05/01/2010,118,6,-10,0,43,5,0,162
China,06/01/2010,131,6,0,0,112,11,0,260
China,07/01/2010,131,0,0,0,31,21,0,183
China,08/01/2010,139,0,-2,0,43,30,0,210
China,09/01/2010,93,2,4,0,-4,11,0,106
China,10/01/2010,109,0,28,0,58,8,0,203
China,11/01/2010,121,0,7,0,72,15,0,215
China,12/01/2010,239,2,9,0,134,23,0,407
China,13/01/2010,418,2,0,0,195,43,0,658
China,14/01/2010,246,6,-3,0,156,43,0,448
China,15/01/2010,161,0,-2,0,78,10,0,247
China,16/01/2010,106,8,1,0,-4,12,0,123
China,17/01/2010,101,4,7,0,113,6,0,231
China,18/01/2010,140,0,-5,0,80,14,0,229
China,19/01/2010,150,2,2,0,100,21,0,275
China,20/01/2010,159,0,2,0,43,13,0,217
China,21/01/2010,214,6,-10,0,112,26,0,348
China,22/01/2010,107,0,1,0,91,8,0,207
China,23/01/2010,66,0,5,0,44,10,0,125
China,24/01/2010,78,2,-4,0,23,20,0,119
China,25/01/2010,82,0,-6,0,65,13,0,154
China,26/01/2010,136,0,-1,0,80,16,0,231
China,27/01/2010,124,8,-1,0,53,9,0,193
China,28/01/2010,186,1,1,0,81,11,0,280
China,29/01/2010,152,10,4,0,116,7,0,289
China,30/01/2010,111,6,-1,0,26,14,0,156
China,31/01/2010,113,0,0,0,37,11,0,161
Egypt,01/01/2010,5,0,0,0,6,2,0,13
Egypt,02/01/2010,59,0,0,0,26,5,0,90
Egypt,03/01/2010,22,0,-3,0,27,3,0,49
Egypt,04/01/2010,59,2,0,0,0,6,0,67
Egypt,05/01/2010,58,0,0,0,15,4,0,77
Egypt,06/01/2010,177,0,-1,0,72,41,0,289
Egypt,07/01/2010,283,2,0,0,60,36,0,381
Egypt,08/01/2010,128,0,0,0,19,10,0,157
Egypt,09/01/2010,47,0,4,0,17,11,0,79
Egypt,10/01/2010,104,0,0,0,33,13,0,150
Egypt,11/01/2010,77,0,-1,0,28,8,0,112
Egypt,12/01/2010,108,0,2,0,31,6,0,147
Egypt,13/01/2010,54,0,0,0,10,8,0,72
Egypt,14/01/2010,84,0,0,0,22,7,0,113
Egypt,15/01/2010,53,0,2,0,33,2,0,90
Egypt,16/01/2010,76,0,-4,0,30,6,0,108
Egypt,17/01/2010,34,0,0,0,30,4,0,68
Egypt,18/01/2010,38,0,1,0,13,2,0,54
Egypt,19/01/2010,18,0,3,0,3,-2,0,22
Egypt,20/01/2010,30,0,1,0,31,2,0,64
Egypt,21/01/2010,49,0,0,0,52,8,0,109
Egypt,22/01/2010,47,0,0,0,16,1,0,64
Egypt,23/01/2010,15,0,0,0,22,19,0,56
Egypt,24/01/2010,46,0,0,0,12,0,0,58
Egypt,25/01/2010,40,0,3,0,13,0,0,56
Egypt,26/01/2010,55,2,0,0,6,3,0,66
Egypt,27/01/2010,32,0,1,0,19,1,0,53
Egypt,28/01/2010,33,2,0,0,21,0,0,56
Egypt,29/01/2010,25,0,0,0,2,0,0,27
Egypt,30/01/2010,20,0,0,0,6,1,0,27
Egypt,31/01/2010,33,0,0,0,10,1,0,44
Eritrea,01/01/2010,0,0,0,0,0,0,0,0
Eritrea,02/01/2010,9,0,0,0,15,0,0,24
Eritrea,03/01/2010,23,0,0,0,36,4,0,63
Eritrea,04/01/2010,2,0,0,0,-2,0,0,0
Eritrea,05/01/2010,4,0,0,0,-1,0,0,3
Eritrea,06/01/2010,11,0,0,0,0,1,0,12
Eritrea,07/01/2010,6,0,0,0,0,1,0,7
Eritrea,08/01/2010,9,0,0,0,3,0,0,12
Eritrea,09/01/2010,6,0,0,0,0,0,0,6
Eritrea,10/01/2010,7,0,0,0,6,0,0,13
Eritrea,11/01/2010,1,0,0,0,12,2,0,15
Eritrea,12/01/2010,0,0,0,0,0,0,0,0
Eritrea,13/01/2010,12,0,0,0,0,0,0,12
Eritrea,14/01/2010,2,0,0,0,-4,0,0,-2
Eritrea,15/01/2010,1,0,0,0,0,0,0,1
Eritrea,16/01/2010,0,0,1,0,0,0,0,1
Eritrea,17/01/2010,0,0,0,0,0,0,0,0
Eritrea,18/01/2010,17,0,0,0,0,0,0,17
Eritrea,19/01/2010,2,0,0,0,1,0,0,3
Eritrea,20/01/2010,12,0,0,0,0,0,0,12
Eritrea,21/01/2010,19,0,0,0,47,0,0,66
Eritrea,22/01/2010,0,0,0,0,3,0,0,3
Eritrea,23/01/2010,0,0,0,0,12,0,0,12
Eritrea,24/01/2010,0,0,0,0,0,0,0,0
Eritrea,25/01/2010,2,0,0,0,0,0,0,2
Eritrea,26/01/2010,0,0,0,0,0,1,0,1
Eritrea,27/01/2010,3,0,0,0,0,0,0,3
Eritrea,28/01/2010,0,0,0,0,0,0,0,0
Eritrea,29/01/2010,0,0,1,0,0,0,0,1
Eritrea,30/01/2010,3,0,0,0,0,0,0,3
Eritrea,31/01/2010,0,2,0,0,0,0,0,2
Georgia,01/01/2010,7,0,0,0,2,4,0,13
Georgia,02/01/2010,22,0,0,0,24,2,0,48
Georgia,03/01/2010,7,0,0,0,10,1,0,18
Georgia,04/01/2010,35,0,-2,0,10,4,0,47
Georgia,05/01/2010,26,0,-2,0,-4,4,0,24
Georgia,06/01/2010,21,0,-1,0,14,3,0,37
Georgia,07/01/2010,33,0,6,0,18,5,0,62
Georgia,08/01/2010,20,4,0,0,9,1,0,34
Georgia,09/01/2010,16,0,-2,0,16,0,0,30
Georgia,10/01/2010,0,0,0,0,3,0,0,3
Georgia,11/01/2010,22,0,2,0,3,5,0,32
Georgia,12/01/2010,68,0,-2,0,26,7,0,99
Georgia,13/01/2010,67,0,3,0,21,3,0,94
Georgia,14/01/2010,25,0,-1,0,8,0,0,32
Georgia,15/01/2010,52,0,0,0,9,5,0,66
Georgia,16/01/2010,16,0,0,0,11,2,0,29
Georgia,17/01/2010,14,0,1,0,9,5,0,29
Georgia,18/01/2010,11,0,-1,0,6,4,0,20
Georgia,19/01/2010,39,0,1,0,26,0,0,66
Georgia,20/01/2010,26,0,0,0,17,2,0,45
Georgia,21/01/2010,25,0,1,0,0,2,0,28
Georgia,22/01/2010,34,0,-1,0,23,4,0,60
Georgia,23/01/2010,33,0,0,0,1,6,0,40
Georgia,24/01/2010,13,0,0,0,3,2,0,18
Georgia,25/01/2010,40,0,0,0,34,7,0,81
Georgia,26/01/2010,25,0,1,0,7,5,0,38
Georgia,27/01/2010,36,0,1,0,18,3,0,58
Georgia,28/01/2010,10,0,0,0,21,1,0,32
Georgia,29/01/2010,13,2,0,0,34,2,0,51
Georgia,30/01/2010,12,0,-1,0,6,2,0,19
Georgia,31/01/2010,18,0,-2,0,3,1,0,20
India,01/01/2010,39,2,0,0,-3,7,0,45
India,02/01/2010,64,0,0,0,12,6,0,82
India,03/01/2010,54,0,0,0,4,3,0,61
India,04/01/2010,76,0,-1,0,8,4,0,87
India,05/01/2010,37,0,0,0,41,3,0,81
India,06/01/2010,120,2,-5,0,5,19,0,141
India,07/01/2010,110,0,-1,0,12,10,0,131
India,08/01/2010,48,0,2,0,15,12,0,77
India,09/01/2010,45,0,2,0,6,29,0,82
India,10/01/2010,35,4,1,0,36,3,0,79
India,11/01/2010,61,2,-5,0,34,8,0,100
India,12/01/2010,68,0,-3,0,14,4,0,83
India,13/01/2010,42,2,-1,0,39,3,0,85
India,14/01/2010,55,6,1,0,30,7,0,99
India,15/01/2010,56,0,-3,0,21,21,0,95
India,16/01/2010,49,4,-2,0,2,11,0,64
India,17/01/2010,64,0,-1,0,23,8,0,94
India,18/01/2010,74,0,-1,0,2,10,0,85
India,19/01/2010,136,4,0,0,22,11,0,173
India,20/01/2010,62,0,0,0,11,10,0,83
India,21/01/2010,67,0,0,0,16,13,0,96
India,22/01/2010,65,0,-1,0,7,9,0,80
India,23/01/2010,39,4,0,0,4,0,0,47
India,24/01/2010,82,0,-1,0,33,5,0,119
India,25/01/2010,62,0,-2,0,37,3,0,100
India,26/01/2010,80,0,-4,0,28,16,0,120
India,27/01/2010,122,6,-1,0,12,12,0,151
India,28/01/2010,71,0,-1,0,23,13,0,106
India,29/01/2010,52,0,1,0,9,12,0,74
India,30/01/2010,35,2,-1,0,13,4,0,53
India,31/01/2010,58,0,-3,0,1,2,0,58
Iran,01/01/2010,148,2,-1,0,82,12,0,243
Iran,02/01/2010,93,0,0,0,12,3,0,108
Iran,03/01/2010,75,0,7,0,73,4,0,159
Iran,04/01/2010,87,0,3,0,116,7,0,213
Iran,05/01/2010,86,0,-1,0,95,16,0,196
Iran,06/01/2010,43,0,0,0,25,12,0,80
Iran,07/01/2010,32,0,0,0,37,6,0,75
Iran,08/01/2010,55,0,-2,0,45,2,0,100
Iran,09/01/2010,28,0,0,0,-6,8,0,30
Iran,10/01/2010,27,0,-2,0,0,5,0,30
Iran,11/01/2010,22,0,3,0,24,7,0,56
Iran,12/01/2010,61,0,1,0,25,1,0,88
Iran,13/01/2010,142,0,2,0,52,5,0,201
Iran,14/01/2010,30,0,4,0,83,1,0,118
Iran,15/01/2010,46,0,-2,0,50,10,0,104
Iran,16/01/2010,67,2,3,0,11,13,0,96
Iran,17/01/2010,52,0,2,0,48,3,0,105
Iran,18/01/2010,57,0,2,0,61,6,0,126
Iran,19/01/2010,49,0,0,0,47,6,0,102
Iran,20/01/2010,80,4,-2,0,26,6,0,114
Iran,21/01/2010,108,0,-1,0,49,18,0,174
Iran,22/01/2010,103,0,0,0,43,7,0,153
Iran,23/01/2010,21,0,0,0,18,4,0,43
Iran,24/01/2010,37,0,1,0,27,47,0,112
Iran,25/01/2010,94,0,0,0,33,49,0,176
Iran,26/01/2010,72,0,1,0,26,16,0,115
Iran,27/01/2010,200,0,-2,0,98,31,0,327
Iran,28/01/2010,117,0,1,0,51,19,0,188
Iran,29/01/2010,176,0,-1,0,28,23,0,226
Iran,30/01/2010,136,0,0,0,24,14,0,174
Iran,31/01/2010,55,0,-3,0,12,12,0,76
Iraq,01/01/2010,108,2,-1,0,9,5,0,123
Iraq,02/01/2010,71,0,0,0,5,5,0,81
Iraq,03/01/2010,54,0,0,0,23,4,0,81
Iraq,04/01/2010,202,2,1,0,50,21,0,276
Iraq,05/01/2010,165,0,0,0,21,16,0,202
Iraq,06/01/2010,129,2,0,0,10,12,0,153
Iraq,07/01/2010,148,2,0,0,21,18,0,189
Iraq,08/01/2010,69,0,2,0,54,18,0,143
Iraq,09/01/2010,72,2,0,0,25,14,0,113
Iraq,10/01/2010,91,4,0,0,14,4,0,113
Iraq,11/01/2010,127,4,-5,0,29,1,0,156
Iraq,12/01/2010,373,4,-1,0,33,25,0,434
Iraq,13/01/2010,195,18,7,0,47,24,0,291
Iraq,14/01/2010,90,0,0,0,62,10,0,162
Iraq,15/01/2010,93,2,2,0,44,9,0,150
Iraq,16/01/2010,87,0,3,0,28,17,0,135
Iraq,17/01/2010,127,4,1,0,46,12,0,190
Iraq,18/01/2010,179,2,0,0,59,17,0,257
Iraq,19/01/2010,210,2,-3,0,4,15,0,228
Iraq,20/01/2010,115,2,1,0,49,7,0,174
Iraq,21/01/2010,64,4,2,0,6,11,0,87
Iraq,22/01/2010,56,2,0,0,63,20,0,141
Iraq,23/01/2010,76,0,0,0,37,5,0,118
Iraq,24/01/2010,95,8,-2,0,42,18,0,161
Iraq,25/01/2010,112,0,0,0,28,11,0,151
Iraq,26/01/2010,211,4,8,0,57,37,0,317
Iraq,27/01/2010,235,0,-2,0,103,14,0,350
Iraq,28/01/2010,113,0,1,0,44,22,0,180
Iraq,29/01/2010,256,0,-6,0,84,45,0,379
Iraq,30/01/2010,112,0,4,0,36,21,0,173
Iraq,31/01/2010,90,0,1,0,5,11,0,107
Morocco,01/01/2010,0,0,0,0,0,0,0,0
Morocco,02/01/2010,0,0,0,0,0,0,0,0
Morocco,03/01/2010,-3,0,0,0,6,0,0,3
Morocco,04/01/2010,16,0,0,0,3,1,0,20
Morocco,05/01/2010,0,0,1,0,11,0,0,12
Morocco,06/01/2010,32,0,1,0,6,0,0,39
Morocco,07/01/2010,18,0,0,0,9,4,0,31
Morocco,08/01/2010,34,0,0,0,0,0,0,34
Morocco,09/01/2010,29,0,0,0,3,0,0,32
Morocco,10/01/2010,0,0,0,0,9,0,0,9
Morocco,11/01/2010,2,0,0,0,3,0,0,5
Morocco,12/01/2010,5,0,0,0,0,4,0,9
Morocco,13/01/2010,40,0,0,0,21,8,0,69
Morocco,14/01/2010,15,0,0,0,6,0,0,21
Morocco,15/01/2010,9,0,0,0,39,0,0,48
Morocco,16/01/2010,5,0,0,0,12,0,0,17
Morocco,17/01/2010,19,0,0,0,0,0,0,19
Morocco,18/01/2010,12,0,0,0,-4,0,0,8
Morocco,19/01/2010,10,0,0,0,6,1,0,17
Morocco,20/01/2010,2,0,0,0,12,5,0,19
Morocco,21/01/2010,4,0,0,0,16,0,0,20
Morocco,22/01/2010,22,0,0,0,15,0,0,37
Morocco,23/01/2010,0,0,0,0,0,0,0,0
Morocco,24/01/2010,0,0,0,0,6,0,0,6
Morocco,25/01/2010,24,0,0,0,9,0,0,33
Morocco,26/01/2010,3,0,0,0,3,0,0,6
Morocco,27/01/2010,8,0,0,0,12,0,0,20
Morocco,28/01/2010,9,2,0,0,8,2,0,21
Morocco,29/01/2010,-1,0,0,0,4,1,0,4
Morocco,30/01/2010,17,0,0,0,3,0,0,20
Morocco,31/01/2010,11,0,0,0,0,0,0,11
Nigeria,01/01/2010,78,0,1,0,17,19,0,115
Nigeria,02/01/2010,86,0,-3,0,27,9,0,119
Nigeria,03/01/2010,124,0,-5,0,56,12,0,187
Nigeria,04/01/2010,132,0,2,0,76,54,0,264
Nigeria,05/01/2010,158,2,-1,0,57,39,0,255
Nigeria,06/01/2010,215,0,0,0,136,21,0,372
Nigeria,07/01/2010,154,0,0,0,82,37,0,273
Nigeria,08/01/2010,137,0,4,0,116,22,0,279
Nigeria,09/01/2010,96,6,3,0,104,20,0,229
Nigeria,10/01/2010,64,0,0,0,20,12,0,96
Nigeria,11/01/2010,80,0,1,0,37,10,0,128
Nigeria,12/01/2010,112,2,0,0,16,19,0,149
Nigeria,13/01/2010,93,0,1,0,34,11,0,139
Nigeria,14/01/2010,137,0,-6,0,23,6,0,160
Nigeria,15/01/2010,94,0,0,0,28,7,0,129
Nigeria,16/01/2010,68,0,0,0,14,4,0,86
Nigeria,17/01/2010,130,0,1,0,8,4,0,143
Nigeria,18/01/2010,86,4,1,0,12,16,0,119
Nigeria,19/01/2010,122,0,-1,0,37,17,0,175
Nigeria,20/01/2010,160,0,-1,0,22,12,0,193
Nigeria,21/01/2010,116,0,-2,0,38,8,0,160
Nigeria,22/01/2010,75,0,-3,0,43,14,0,129
Nigeria,23/01/2010,58,0,1,0,16,2,0,77
Nigeria,24/01/2010,70,0,0,0,11,43,0,124
Nigeria,25/01/2010,76,0,-2,0,24,28,0,126
Nigeria,26/01/2010,39,0,-2,0,3,7,0,47
Nigeria,27/01/2010,62,0,0,0,36,5,0,103
Nigeria,28/01/2010,40,2,2,0,28,10,0,82
Nigeria,29/01/2010,54,2,-1,0,70,2,0,127
Nigeria,30/01/2010,40,2,-9,0,57,0,0,90
Nigeria,31/01/2010,52,0,0,0,9,2,0,63
Pakistan,01/01/2010,136,6,0,0,18,18,0,178
Pakistan,02/01/2010,202,0,2,0,27,32,0,263
Pakistan,03/01/2010,83,0,2,0,55,40,0,180
Pakistan,04/01/2010,154,0,-1,0,58,11,0,222
Pakistan,05/01/2010,120,0,1,0,21,43,0,185
Pakistan,06/01/2010,209,0,0,0,27,19,0,255
Pakistan,07/01/2010,350,2,1,0,22,91,0,466
Pakistan,08/01/2010,149,0,0,0,51,22,0,222
Pakistan,09/01/2010,240,0,0,0,73,110,0,423
Pakistan,10/01/2010,121,6,0,0,24,47,0,198
Pakistan,11/01/2010,76,2,0,0,6,2,0,86
Pakistan,12/01/2010,143,0,0,0,33,22,0,198
Pakistan,13/01/2010,141,0,0,0,36,18,0,195
Pakistan,14/01/2010,143,0,1,0,80,4,0,228
Pakistan,15/01/2010,117,0,-1,0,56,5,0,177
Pakistan,16/01/2010,75,2,1,0,9,9,0,96
Pakistan,17/01/2010,98,0,1,0,17,8,0,124
Pakistan,18/01/2010,129,0,0,0,78,24,0,231
Pakistan,19/01/2010,155,2,5,0,66,15,0,243
Pakistan,20/01/2010,92,0,1,0,10,12,0,115
Pakistan,21/01/2010,113,2,-5,0,21,7,0,138
Pakistan,22/01/2010,116,0,0,0,28,28,0,172
Pakistan,23/01/2010,98,2,0,0,30,18,0,148
Pakistan,24/01/2010,145,0,-1,0,30,10,0,184
Pakistan,25/01/2010,103,0,1,0,99,13,0,216
Pakistan,26/01/2010,115,0,4,0,38,3,0,160
Pakistan,27/01/2010,201,0,4,0,43,15,0,263
Pakistan,28/01/2010,167,0,0,0,34,6,0,207
Pakistan,29/01/2010,114,0,0,0,51,4,0,169
Pakistan,30/01/2010,70,2,1,0,40,18,0,131
Pakistan,31/01/2010,64,0,0,0,11,6,0,81
Sierra Leone,01/01/2010,2,0,0,0,3,0,0,5
Sierra Leone,02/01/2010,0,0,0,0,0,0,0,0
Sierra Leone,03/01/2010,2,0,0,0,3,0,0,5
Sierra Leone,04/01/2010,2,0,0,0,0,0,0,2
Sierra Leone,05/01/2010,0,0,0,0,3,0,0,3
Sierra Leone,06/01/2010,0,0,0,0,3,0,0,3
Sierra Leone,07/01/2010,22,0,0,0,-7,2,0,17
Sierra Leone,08/01/2010,0,0,0,0,0,0,0,0
Sierra Leone,09/01/2010,0,0,0,0,0,0,0,0
Sierra Leone,10/01/2010,0,0,0,0,0,0,0,0
Sierra Leone,11/01/2010,38,0,0,0,5,0,0,43
Sierra Leone,12/01/2010,9,0,0,0,0,0,0,9
Sierra Leone,13/01/2010,2,0,0,0,0,0,0,2
Sierra Leone,14/01/2010,6,0,0,0,0,0,0,6
Sierra Leone,15/01/2010,2,0,0,0,0,0,0,2
Sierra Leone,16/01/2010,0,0,0,0,0,0,0,0
Sierra Leone,17/01/2010,0,0,0,0,0,0,0,0
Sierra Leone,18/01/2010,4,0,0,0,0,2,0,6
Sierra Leone,19/01/2010,-4,0,0,0,0,-1,0,-5
Sierra Leone,20/01/2010,-1,0,0,0,3,1,0,3
Sierra Leone,21/01/2010,5,0,0,0,12,0,0,17
Sierra Leone,22/01/2010,0,0,0,0,0,1,0,1
Sierra Leone,23/01/2010,0,0,0,0,6,1,0,7
Sierra Leone,24/01/2010,5,0,0,0,0,0,0,5
Sierra Leone,25/01/2010,3,0,0,0,0,0,0,3
Sierra Leone,26/01/2010,2,0,0,0,3,0,0,5
Sierra Leone,27/01/2010,13,0,0,0,0,0,0,13
Sierra Leone,28/01/2010,2,0,0,0,0,0,0,2
Sierra Leone,29/01/2010,0,0,0,0,6,0,0,6
Sierra Leone,30/01/2010,6,0,0,0,6,0,0,12
Sierra Leone,31/01/2010,0,0,0,0,0,0,0,0
Somalia,01/01/2010,63,0,0,0,-2,3,0,64
Somalia,02/01/2010,271,0,1,0,79,29,0,380
Somalia,03/01/2010,215,0,0,0,63,13,0,291
Somalia,04/01/2010,185,0,1,0,43,7,0,236
Somalia,05/01/2010,118,0,0,0,22,4,0,144
Somalia,06/01/2010,95,0,0,0,6,2,0,103
Somalia,07/01/2010,77,0,0,0,4,3,0,84
Somalia,08/01/2010,62,0,0,0,28,3,0,93
Somalia,09/01/2010,21,0,0,0,21,0,0,42
Somalia,10/01/2010,83,2,0,0,13,3,0,101
Somalia,11/01/2010,151,0,0,0,23,3,0,177
Somalia,12/01/2010,146,2,-1,0,21,7,0,175
Somalia,13/01/2010,110,0,1,0,16,11,0,138
Somalia,14/01/2010,91,0,0,0,12,0,0,103
Somalia,15/01/2010,115,0,0,0,66,10,0,191
Somalia,16/01/2010,29,0,0,0,13,6,0,48
Somalia,17/01/2010,55,0,0,0,55,6,0,116
Somalia,18/01/2010,155,2,0,0,26,29,0,212
Somalia,19/01/2010,138,2,0,0,41,8,0,189
Somalia,20/01/2010,80,0,0,0,59,6,0,145
Somalia,21/01/2010,93,2,0,0,40,9,0,144
Somalia,22/01/2010,68,0,0,0,69,5,0,142
Somalia,23/01/2010,11,0,0,0,7,3,0,21
Somalia,24/01/2010,41,6,0,0,11,6,0,64
Somalia,25/01/2010,39,0,0,0,2,2,0,43
Somalia,26/01/2010,51,0,0,0,13,4,0,68
Somalia,27/01/2010,52,10,0,0,36,10,0,108
Somalia,28/01/2010,38,0,0,0,22,5,0,65
Somalia,29/01/2010,37,0,0,0,7,8,0,52
Somalia,30/01/2010,35,0,0,0,9,0,0,44
Somalia,31/01/2010,21,4,0,0,12,13,0,50
Syria,01/01/2010,2,0,0,0,9,0,0,11
Syria,02/01/2010,7,0,0,0,3,0,0,10
Syria,03/01/2010,-14,0,0,0,1,3,0,-10
Syria,04/01/2010,15,0,0,0,13,1,0,29
Syria,05/01/2010,13,0,0,0,18,1,0,32
Syria,06/01/2010,30,0,0,0,-1,5,0,34
Syria,07/01/2010,17,0,0,0,9,1,0,27
Syria,08/01/2010,32,0,1,0,16,10,0,59
Syria,09/01/2010,20,0,0,0,20,10,0,50
Syria,10/01/2010,10,0,0,0,35,3,0,48
Syria,11/01/2010,11,0,0,0,18,3,0,32
Syria,12/01/2010,12,0,0,0,9,4,0,25
Syria,13/01/2010,29,4,0,0,4,2,0,39
Syria,14/01/2010,19,0,0,0,25,4,0,48
Syria,15/01/2010,13,0,0,0,12,0,0,25
Syria,16/01/2010,4,0,-2,0,0,13,0,15
Syria,17/01/2010,22,0,0,0,3,0,0,25
Syria,18/01/2010,11,0,0,0,36,0,0,47
Syria,19/01/2010,18,0,0,0,9,0,0,27
Syria,20/01/2010,4,0,0,0,29,0,0,33
Syria,21/01/2010,11,0,-4,0,24,15,0,46
Syria,22/01/2010,20,0,0,0,25,0,0,45
Syria,23/01/2010,16,0,0,0,7,0,0,23
Syria,24/01/2010,20,0,0,0,12,25,0,57
Syria,25/01/2010,13,0,0,0,6,22,0,41
Syria,26/01/2010,55,2,0,0,45,8,0,110
Syria,27/01/2010,14,2,0,0,10,0,0,26
Syria,28/01/2010,60,0,0,0,72,0,0,132
Syria,29/01/2010,23,0,0,0,67,0,0,90
Syria,30/01/2010,12,0,0,0,24,0,0,36
Syria,31/01/2010,3,0,0,0,3,0,0,6
Yemen,01/01/2010,146,6,-3,0,-8,9,0,150
Yemen,02/01/2010,297,4,1,0,14,12,0,328
Yemen,03/01/2010,321,0,0,0,41,20,0,382
Yemen,04/01/2010,319,0,3,0,22,36,0,380
Yemen,05/01/2010,312,0,5,0,61,24,0,402
Yemen,06/01/2010,258,0,1,0,75,23,0,357
Yemen,07/01/2010,255,0,0,0,84,5,0,344
Yemen,08/01/2010,162,4,0,0,77,17,0,260
Yemen,09/01/2010,172,2,-2,0,18,17,0,207
Yemen,10/01/2010,128,0,1,0,7,12,0,148
Yemen,11/01/2010,176,0,0,0,16,16,0,208
Yemen,12/01/2010,127,0,0,0,31,11,0,169
Yemen,13/01/2010,287,0,0,0,8,17,0,312
Yemen,14/01/2010,121,4,1,0,15,18,0,159
Yemen,15/01/2010,288,0,2,0,14,15,0,319
Yemen,16/01/2010,157,2,0,0,29,3,0,191
Yemen,17/01/2010,77,0,0,0,-2,4,0,79
Yemen,18/01/2010,102,0,0,0,-15,8,0,95
Yemen,19/01/2010,42,2,0,0,39,13,0,96
Yemen,20/01/2010,107,0,2,0,27,7,0,143
Yemen,21/01/2010,169,0,0,0,20,4,0,193
Yemen,22/01/2010,115,0,0,0,25,5,0,145
Yemen,23/01/2010,94,0,0,0,5,4,0,103
Yemen,24/01/2010,121,0,0,0,19,28,0,168
Yemen,25/01/2010,71,0,-2,0,23,21,0,113
Yemen,26/01/2010,118,2,1,0,48,13,0,182
Yemen,27/01/2010,275,4,2,0,14,4,0,299
Yemen,28/01/2010,78,0,-2,0,45,4,0,125
Yemen,29/01/2010,71,0,0,0,25,10,0,106
Yemen,30/01/2010,50,0,-1,0,13,0,0,62
Yemen,31/01/2010,42,4,1,0,8,2,0,57
Afghanistan,01/07/2008,221,2,0,0,16,2,0,241
Afghanistan,02/07/2008,157,2,0,0,20,10,0,189
Afghanistan,03/07/2008,117,0,0,0,41,0,0,158
Afghanistan,04/07/2008,137,4,3,0,81,9,0,234
Afghanistan,05/07/2008,120,0,-1,0,-2,5,0,122
Afghanistan,06/07/2008,136,0,0,0,23,5,0,164
Afghanistan,07/07/2008,224,0,1,0,18,20,0,263
Afghanistan,08/07/2008,153,0,0,0,-2,21,0,172
Afghanistan,09/07/2008,155,0,0,0,23,20,0,198
Afghanistan,10/07/2008,195,6,0,0,27,6,0,234
Afghanistan,11/07/2008,146,0,0,0,38,13,0,197
Afghanistan,12/07/2008,97,0,0,0,18,17,0,132
Afghanistan,13/07/2008,194,0,-1,0,10,20,0,223
Afghanistan,14/07/2008,126,0,-3,0,23,18,0,164
Afghanistan,15/07/2008,151,0,0,0,27,11,0,189
Afghanistan,16/07/2008,303,4,1,0,71,14,0,393
Afghanistan,17/07/2008,282,4,1,0,103,11,0,401
Afghanistan,18/07/2008,206,0,2,0,77,11,0,296
Afghanistan,19/07/2008,94,0,-6,0,9,13,0,110
Afghanistan,20/07/2008,259,0,1,0,11,4,0,275
Afghanistan,21/07/2008,183,2,0,0,118,15,0,318
Afghanistan,22/07/2008,162,0,1,0,77,13,0,253
Afghanistan,23/07/2008,221,0,0,0,32,17,0,270
Afghanistan,24/07/2008,172,0,0,0,43,11,0,226
Afghanistan,25/07/2008,199,0,0,0,21,4,0,224
Afghanistan,26/07/2008,170,2,0,0,18,2,0,192
Afghanistan,27/07/2008,113,0,0,0,14,8,0,135
Afghanistan,28/07/2008,234,0,0,0,6,15,0,255
Afghanistan,29/07/2008,169,0,0,0,38,4,0,211
Afghanistan,30/07/2008,118,4,0,0,40,12,0,174
Afghanistan,31/07/2008,187,0,3,0,34,12,0,236
Albania,01/07/2008,0,0,0,0,0,0,0,0
Albania,02/07/2008,4,0,1,0,12,4,0,21
Albania,03/07/2008,4,0,0,0,12,2,0,18
Albania,04/07/2008,25,0,0,0,0,0,0,25
Albania,05/07/2008,1,0,0,0,0,0,0,1
Albania,06/07/2008,0,0,0,0,0,0,0,0
Albania,07/07/2008,11,0,0,0,9,0,0,20
Albania,08/07/2008,11,0,0,0,6,0,0,17
Albania,09/07/2008,8,0,0,0,3,0,0,11
Albania,10/07/2008,16,0,0,0,18,2,0,36
Albania,11/07/2008,15,0,0,0,17,0,0,32
Albania,12/07/2008,15,0,0,0,-4,0,0,11
Albania,13/07/2008,0,0,0,0,0,0,0,0
Albania,14/07/2008,5,0,0,0,10,0,0,15
Albania,15/07/2008,7,0,0,0,0,0,0,7
Albania,16/07/2008,0,0,0,0,0,1,0,1
Albania,17/07/2008,3,0,-2,0,0,0,0,1
Albania,18/07/2008,0,0,0,0,0,2,0,2
Albania,19/07/2008,0,0,0,0,15,0,0,15
Albania,20/07/2008,0,0,0,0,6,2,0,8
Albania,21/07/2008,0,0,0,0,0,0,0,0
Albania,22/07/2008,0,0,-2,0,6,10,0,14
Albania,23/07/2008,6,0,0,0,6,0,0,12
Albania,24/07/2008,6,0,0,0,0,0,0,6
Albania,25/07/2008,10,0,-2,0,3,0,0,11
Albania,26/07/2008,4,0,0,0,0,0,0,4
Albania,27/07/2008,11,0,0,0,0,0,0,11
Albania,28/07/2008,-3,0,0,0,6,0,0,3
Albania,29/07/2008,19,0,0,0,0,4,0,23
Albania,30/07/2008,0,0,-2,0,0,0,0,-2
Albania,31/07/2008,5,0,-3,0,3,0,0,5
Algeria,01/07/2008,16,0,0,0,3,0,0,19
Algeria,02/07/2008,11,0,0,0,18,2,0,31
Algeria,03/07/2008,8,0,0,0,4,2,0,14
Algeria,04/07/2008,11,0,0,0,10,0,0,21
Algeria,05/07/2008,-3,0,0,0,0,0,0,-3
Algeria,06/07/2008,0,0,0,0,-1,0,0,-1
Algeria,07/07/2008,5,2,0,0,3,0,0,10
Algeria,08/07/2008,-1,0,0,0,0,0,0,-1
Algeria,09/07/2008,0,0,0,0,2,0,0,2
Algeria,10/07/2008,0,0,0,0,0,0,0,0
Algeria,11/07/2008,2,0,0,0,3,0,0,5
Algeria,12/07/2008,1,0,0,0,-2,0,0,-1
Algeria,13/07/2008,8,0,0,0,0,1,0,9
Algeria,14/07/2008,4,0,0,0,0,0,0,4
Algeria,15/07/2008,3,0,0,0,-1,1,0,3
Algeria,16/07/2008,1,0,0,0,3,0,0,4
Algeria,17/07/2008,12,0,0,0,3,0,0,15
Algeria,18/07/2008,-1,0,0,0,0,3,0,2
Algeria,19/07/2008,7,0,0,0,0,3,0,10
Algeria,20/07/2008,1,0,0,0,0,0,0,1
Algeria,21/07/2008,0,0,0,0,3,0,0,3
Algeria,22/07/2008,0,0,0,0,0,0,0,0
Algeria,23/07/2008,13,0,1,0,2,0,0,16
Algeria,24/07/2008,1,0,0,0,9,0,0,10
Algeria,25/07/2008,3,0,0,0,0,0,0,3
Algeria,26/07/2008,0,0,0,0,0,0,0,0
Algeria,27/07/2008,4,0,0,0,15,0,0,19
Algeria,28/07/2008,2,0,0,0,3,0,0,5
Algeria,29/07/2008,0,0,0,0,4,0,0,4
Algeria,30/07/2008,0,0,0,0,0,0,0,0
Algeria,31/07/2008,8,0,0,0,6,0,0,14
Bangladesh,01/07/2008,19,0,0,0,1,2,0,22
Bangladesh,02/07/2008,34,0,0,0,4,3,0,41
Bangladesh,03/07/2008,5,0,0,0,0,0,0,5
Bangladesh,04/07/2008,6,0,0,0,-4,0,0,2
Bangladesh,05/07/2008,3,0,0,0,13,0,0,16
Bangladesh,06/07/2008,8,0,2,0,6,0,0,16
Bangladesh,07/07/2008,4,0,0,0,3,2,0,9
Bangladesh,08/07/2008,22,0,0,0,6,1,0,29
Bangladesh,09/07/2008,4,0,0,0,1,0,0,5
Bangladesh,10/07/2008,-1,0,0,0,0,0,0,-1
Bangladesh,11/07/2008,3,0,1,0,3,0,0,7
Bangladesh,12/07/2008,0,0,0,0,3,1,0,4
Bangladesh,13/07/2008,8,0,0,0,6,0,0,14
Bangladesh,14/07/2008,3,0,0,0,9,0,0,12
Bangladesh,15/07/2008,15,0,0,0,8,2,0,25
Bangladesh,16/07/2008,7,0,-4,0,10,5,0,18
Bangladesh,17/07/2008,23,0,0,0,8,0,0,31
Bangladesh,18/07/2008,-1,2,0,0,-2,2,0,1
Bangladesh,19/07/2008,-1,0,0,0,3,0,0,2
Bangladesh,20/07/2008,0,0,0,0,2,1,0,3
Bangladesh,21/07/2008,0,0,0,0,4,0,0,4
Bangladesh,22/07/2008,-3,0,0,0,6,0,0,3
Bangladesh,23/07/2008,18,0,0,0,3,1,0,22
Bangladesh,24/07/2008,6,0,0,0,4,2,0,12
Bangladesh,25/07/2008,12,0,0,0,1,0,0,13
Bangladesh,26/07/2008,8,0,0,0,7,7,0,22
Bangladesh,27/07/2008,7,0,0,0,-2,0,0,5
Bangladesh,28/07/2008,13,0,1,0,13,9,0,36
Bangladesh,29/07/2008,2,0,0,0,-3,0,0,-1
Bangladesh,30/07/2008,-1,0,1,0,5,2,0,7
Bangladesh,31/07/2008,12,0,0,0,-6,3,0,9
Cameroon,01/07/2008,0,0,0,0,0,0,0,0
Cameroon,02/07/2008,4,0,0,0,0,0,0,4
Cameroon,03/07/2008,1,0,0,0,0,0,0,1
Cameroon,04/07/2008,0,0,0,0,0,0,0,0
Cameroon,05/07/2008,1,0,0,0,0,0,0,1
Cameroon,07/07/2008,2,0,0,0,6,0,0,8
Cameroon,08/07/2008,0,0,0,0,0,0,0,0
Cameroon,11/07/2008,0,0,0,0,0,0,0,0
Cameroon,14/07/2008,6,0,0,0,3,2,0,11
Cameroon,15/07/2008,4,0,0,0,3,0,0,7
Cameroon,16/07/2008,0,0,0,0,3,0,0,3
Cameroon,17/07/2008,-8,0,0,0,0,0,0,-8
Cameroon,20/07/2008,0,0,0,0,0,0,0,0
Cameroon,21/07/2008,1,0,0,0,0,0,0,1
Cameroon,22/07/2008,0,0,0,0,6,0,0,6
Cameroon,24/07/2008,3,0,0,0,3,0,0,6
Cameroon,25/07/2008,4,0,0,0,0,0,0,4
Cameroon,27/07/2008,-2,0,0,0,0,0,0,-2
Cameroon,28/07/2008,2,0,0,0,3,0,0,5
Cameroon,29/07/2008,0,0,0,0,0,0,0,0
Cameroon,30/07/2008,0,0,0,0,3,0,0,3
Cameroon,31/07/2008,2,0,0,0,6,0,0,8
China,01/07/2008,80,0,-2,0,29,21,0,128
China,02/07/2008,78,0,-4,0,24,13,0,111
China,03/07/2008,111,0,0,0,47,12,0,170
China,04/07/2008,36,0,0,0,6,8,0,50
China,05/07/2008,26,0,-2,0,-6,2,0,20
China,06/07/2008,24,0,0,0,0,5,0,29
China,07/07/2008,20,0,0,0,9,1,0,30
China,08/07/2008,41,0,0,0,41,8,0,90
China,09/07/2008,85,0,0,0,57,14,0,156
China,10/07/2008,57,0,-2,0,16,11,0,82
China,11/07/2008,103,0,-7,0,73,17,0,186
China,12/07/2008,80,6,1,0,55,7,0,149
China,13/07/2008,46,4,0,0,14,6,0,70
China,14/07/2008,48,0,2,0,30,9,0,89
China,15/07/2008,70,0,-1,0,17,14,0,100
China,16/07/2008,57,2,0,0,67,12,0,138
China,17/07/2008,97,2,-3,0,21,12,0,129
China,18/07/2008,35,0,-1,0,41,13,0,88
China,19/07/2008,34,0,-1,0,21,1,0,55
China,20/07/2008,54,4,0,0,16,9,0,83
China,21/07/2008,70,0,2,0,-5,15,0,82
China,22/07/2008,66,0,0,0,9,7,0,82
China,23/07/2008,62,0,-2,0,11,5,0,76
China,24/07/2008,75,0,2,0,3,4,0,84
China,25/07/2008,56,0,0,0,38,8,0,102
China,26/07/2008,38,0,0,0,13,5,0,56
China,27/07/2008,39,0,0,0,-2,8,0,45
China,28/07/2008,53,0,0,0,48,4,0,105
China,29/07/2008,53,0,0,0,18,6,0,77
China,30/07/2008,77,0,-3,0,21,6,0,101
China,31/07/2008,46,2,3,0,49,5,0,105
Egypt,01/07/2008,44,0,-6,0,24,2,0,64
Egypt,02/07/2008,124,0,0,0,19,12,0,155
Egypt,03/07/2008,47,0,0,0,11,3,0,61
Egypt,04/07/2008,35,0,0,0,18,1,0,54
Egypt,05/07/2008,5,0,0,0,6,0,0,11
Egypt,06/07/2008,9,0,0,0,15,0,0,24
Egypt,07/07/2008,36,0,1,0,21,0,0,58
Egypt,08/07/2008,69,2,0,0,25,2,0,98
Egypt,09/07/2008,39,0,0,0,24,0,0,63
Egypt,10/07/2008,-7,0,2,0,21,2,0,18
Egypt,11/07/2008,16,0,0,0,13,2,0,31
Egypt,12/07/2008,9,0,0,0,0,0,0,9
Egypt,13/07/2008,9,0,0,0,3,0,0,12
Egypt,14/07/2008,15,0,0,0,-2,0,0,13
Egypt,15/07/2008,24,0,0,0,10,6,0,40
Egypt,16/07/2008,14,0,0,0,2,6,0,22
Egypt,17/07/2008,48,0,0,0,22,0,0,70
Egypt,18/07/2008,22,0,0,0,40,0,0,62
Egypt,19/07/2008,18,0,0,0,15,2,0,35
Egypt,20/07/2008,4,0,0,0,0,0,0,4
Egypt,21/07/2008,11,0,0,0,6,0,0,17
Egypt,22/07/2008,28,0,0,0,13,4,0,45
Egypt,23/07/2008,30,0,0,0,13,1,0,44
Egypt,24/07/2008,3,0,0,0,7,0,0,10
Egypt,25/07/2008,10,0,0,0,1,2,0,13
Egypt,26/07/2008,-3,0,1,0,9,0,0,7
Egypt,27/07/2008,9,0,-2,0,3,0,0,10
Egypt,28/07/2008,31,0,0,0,2,3,0,36
Egypt,29/07/2008,53,0,1,0,8,0,0,62
Egypt,30/07/2008,2,0,0,0,9,5,0,16
Egypt,31/07/2008,6,0,0,0,12,0,0,18
Eritrea,01/07/2008,10,0,0,0,3,0,0,13
Eritrea,02/07/2008,21,0,0,0,3,0,0,24
Eritrea,03/07/2008,6,0,0,0,0,0,0,6
Eritrea,04/07/2008,8,0,0,0,0,1,0,9
Eritrea,05/07/2008,0,0,0,0,3,0,0,3
Eritrea,06/07/2008,15,0,0,0,0,0,0,15
Eritrea,07/07/2008,5,0,0,0,21,0,0,26
Eritrea,08/07/2008,0,0,0,0,1,0,0,1
Eritrea,09/07/2008,13,0,0,0,0,2,0,15
Eritrea,10/07/2008,6,0,0,0,-2,2,0,6
Eritrea,11/07/2008,9,0,0,0,12,1,0,22
Eritrea,12/07/2008,6,0,0,0,0,0,0,6
Eritrea,13/07/2008,0,0,0,0,3,1,0,4
Eritrea,14/07/2008,15,0,0,0,-6,1,0,10
Eritrea,15/07/2008,3,0,0,0,2,6,0,11
Eritrea,16/07/2008,8,0,0,0,-9,1,0,0
Eritrea,18/07/2008,0,0,0,0,0,1,0,1
Eritrea,19/07/2008,1,0,0,0,6,0,0,7
Eritrea,20/07/2008,-1,0,0,0,0,0,0,-1
Eritrea,21/07/2008,6,0,0,0,3,0,0,9
Eritrea,22/07/2008,2,0,0,0,0,0,0,2
Eritrea,23/07/2008,2,0,0,0,0,1,0,3
Eritrea,24/07/2008,4,0,0,0,0,2,0,6
Eritrea,25/07/2008,24,0,0,0,-2,0,0,22
Eritrea,26/07/2008,3,0,0,0,0,0,0,3
Eritrea,28/07/2008,2,0,0,0,3,3,0,8
Eritrea,29/07/2008,0,0,0,0,3,0,0,3
Eritrea,30/07/2008,0,0,0,0,3,0,0,3
Eritrea,31/07/2008,0,0,0,0,0,1,0,1
Georgia,01/07/2008,18,0,0,0,17,2,0,37
Georgia,02/07/2008,9,0,-1,0,17,2,0,27
Georgia,03/07/2008,12,0,0,0,-1,0,0,11
Georgia,04/07/2008,11,0,1,0,6,0,0,18
Georgia,05/07/2008,2,0,0,0,3,0,0,5
Georgia,06/07/2008,0,0,0,0,0,0,0,0
Georgia,07/07/2008,2,0,0,0,0,0,0,2
Georgia,08/07/2008,16,0,0,0,1,0,0,17
Georgia,09/07/2008,11,0,0,0,5,0,0,16
Georgia,10/07/2008,9,0,0,0,15,2,0,26
Georgia,11/07/2008,4,0,0,0,-2,0,0,2
Georgia,12/07/2008,0,0,0,0,3,0,0,3
Georgia,13/07/2008,3,0,0,0,0,-4,0,-1
Georgia,14/07/2008,-2,0,0,0,0,0,0,-2
Georgia,15/07/2008,8,0,0,0,0,0,0,8
Georgia,16/07/2008,3,0,0,0,-1,0,0,2
Georgia,17/07/2008,6,0,1,0,-3,0,0,4
Georgia,18/07/2008,5,0,0,0,3,1,0,9
Georgia,19/07/2008,0,0,0,0,0,0,0,0
Georgia,20/07/2008,5,0,0,0,0,0,0,5
Georgia,21/07/2008,11,0,0,0,3,1,0,15
Georgia,22/07/2008,2,0,0,0,0,1,0,3
Georgia,23/07/2008,14,0,0,0,1,0,0,15
Georgia,24/07/2008,5,0,0,0,3,3,0,11
Georgia,25/07/2008,7,0,0,0,0,0,0,7
Georgia,26/07/2008,2,0,0,0,6,0,0,8
Georgia,27/07/2008,2,0,0,0,0,0,0,2
Georgia,28/07/2008,3,0,0,0,0,3,0,6
Georgia,29/07/2008,5,0,0,0,0,0,0,5
Georgia,30/07/2008,5,0,0,0,3,0,0,8
Georgia,31/07/2008,6,0,0,0,-2,0,0,4
India,01/07/2008,25,0,0,0,-7,4,0,22
India,02/07/2008,37,0,0,0,-2,3,0,38
India,03/07/2008,4,2,0,0,3,2,0,11
India,04/07/2008,27,0,0,0,13,4,0,44
India,05/07/2008,24,2,0,0,10,6,0,42
India,06/07/2008,23,0,0,0,14,7,0,44
India,07/07/2008,104,0,0,0,1,26,0,131
India,08/07/2008,88,0,-1,0,6,15,0,108
India,09/07/2008,86,0,0,0,15,4,0,105
India,10/07/2008,102,2,4,0,38,14,0,160
India,11/07/2008,21,0,0,0,4,4,0,29
India,12/07/2008,25,0,0,0,14,9,0,48
India,13/07/2008,23,0,0,0,7,1,0,31
India,14/07/2008,21,0,0,0,-2,20,0,39
India,15/07/2008,9,0,1,0,3,15,0,28
India,16/07/2008,31,0,1,0,8,7,0,47
India,17/07/2008,45,0,0,0,9,6,0,60
India,18/07/2008,34,0,0,0,3,1,0,38
India,19/07/2008,72,0,0,0,3,6,0,81
India,20/07/2008,38,0,-1,0,-6,3,0,34
India,21/07/2008,44,0,-2,0,18,5,0,65
India,22/07/2008,32,0,-5,0,7,0,0,34
India,23/07/2008,22,10,0,0,25,14,0,71
India,24/07/2008,5,0,0,0,19,5,0,29
India,25/07/2008,22,2,0,0,14,6,0,44
India,26/07/2008,54,2,0,0,28,2,0,86
India,27/07/2008,10,0,0,0,3,0,0,13
India,28/07/2008,29,2,0,0,-3,4,0,32
India,29/07/2008,29,0,0,0,-2,2,0,29
India,30/07/2008,29,0,0,0,9,4,0,42
India,31/07/2008,76,0,-1,0,14,7,0,96
Iran,01/07/2008,67,0,0,0,17,2,0,86
Iran,02/07/2008,85,0,1,0,12,1,0,99
Iran,03/07/2008,91,0,0,0,35,3,0,129
Iran,04/07/2008,44,0,-6,0,38,2,0,78
Iran,05/07/2008,43,0,0,0,35,0,0,78
Iran,06/07/2008,17,0,-2,0,22,5,0,42
Iran,07/07/2008,95,0,2,0,18,17,0,132
Iran,08/07/2008,127,0,-3,0,22,16,0,162
Iran,09/07/2008,250,2,2,0,35,10,0,299
Iran,10/07/2008,338,0,6,0,27,27,0,398
Iran,11/07/2008,206,0,-1,0,10,15,0,230
Iran,12/07/2008,67,0,1,0,30,4,0,102
Iran,13/07/2008,39,0,-2,0,11,10,0,58
Iran,14/07/2008,54,0,0,0,11,5,0,70
Iran,15/07/2008,77,0,-2,0,10,4,0,89
Iran,16/07/2008,39,0,-1,0,10,3,0,51
Iran,17/07/2008,49,0,3,0,10,4,0,66
Iran,18/07/2008,29,0,3,0,21,4,0,57
Iran,19/07/2008,22,0,1,0,1,0,0,24
Iran,20/07/2008,27,0,-4,0,53,12,0,88
Iran,21/07/2008,48,0,0,0,13,4,0,65
Iran,22/07/2008,30,0,2,0,27,2,0,61
Iran,23/07/2008,62,0,-2,0,15,7,0,82
Iran,24/07/2008,26,4,1,0,33,17,0,81
Iran,25/07/2008,16,2,0,0,20,5,0,43
Iran,26/07/2008,22,0,0,0,15,1,0,38
Iran,27/07/2008,51,0,1,0,6,2,0,60
Iran,28/07/2008,11,0,0,0,13,1,0,25
Iran,29/07/2008,-7,0,2,0,15,4,0,14
Iran,30/07/2008,-9,0,-1,0,9,0,0,-1
Iran,31/07/2008,40,2,3,0,25,2,0,72
Iraq,01/07/2008,175,2,0,0,59,11,0,247
Iraq,02/07/2008,150,2,2,0,41,8,0,203
Iraq,03/07/2008,82,0,0,0,7,20,0,109
Iraq,04/07/2008,75,0,1,0,3,10,0,89
Iraq,05/07/2008,54,0,0,0,-4,0,0,50
Iraq,06/07/2008,150,0,-2,0,1,4,0,153
Iraq,07/07/2008,86,0,1,0,-5,28,0,110
Iraq,08/07/2008,163,4,0,0,20,9,0,196
Iraq,09/07/2008,75,0,2,0,24,19,0,120
Iraq,10/07/2008,115,0,6,0,82,12,0,215
Iraq,11/07/2008,188,4,-2,0,78,3,0,271
Iraq,12/07/2008,54,0,0,0,23,20,0,97
Iraq,13/07/2008,106,2,0,0,5,24,0,137
Iraq,14/07/2008,181,0,6,0,26,22,0,235
Iraq,15/07/2008,228,2,6,0,75,12,0,323
Iraq,16/07/2008,177,0,-1,0,44,21,0,241
Iraq,17/07/2008,121,0,0,0,17,4,0,142
Iraq,18/07/2008,98,4,2,0,18,10,0,132
Iraq,19/07/2008,2,2,0,0,13,3,0,20
Iraq,20/07/2008,150,0,3,0,33,29,0,215
Iraq,21/07/2008,121,0,0,0,17,21,0,159
Iraq,22/07/2008,82,4,-3,0,39,16,0,138
Iraq,23/07/2008,134,0,3,0,14,24,0,175
Iraq,24/07/2008,172,0,1,0,-4,20,0,189
Iraq,25/07/2008,58,0,-1,0,34,30,0,121
Iraq,26/07/2008,57,0,2,0,3,2,0,64
Iraq,27/07/2008,129,0,-4,0,31,4,0,160
Iraq,28/07/2008,128,2,0,0,54,19,0,203
Iraq,29/07/2008,131,0,2,0,24,16,0,173
Iraq,30/07/2008,22,0,-2,0,3,4,0,27
Iraq,31/07/2008,104,0,2,0,-5,14,0,115
Morocco,01/07/2008,0,0,0,0,0,0,0,0
Morocco,02/07/2008,0,0,0,0,18,2,0,20
Morocco,03/07/2008,0,0,-1,0,0,0,0,-1
Morocco,04/07/2008,0,0,0,0,0,0,0,0
Morocco,05/07/2008,6,0,0,0,0,0,0,6
Morocco,06/07/2008,4,0,0,0,6,2,0,12
Morocco,07/07/2008,0,0,0,0,3,0,0,3
Morocco,08/07/2008,2,0,0,0,3,0,0,5
Morocco,09/07/2008,4,0,0,0,6,0,0,10
Morocco,10/07/2008,0,0,0,0,3,2,0,5
Morocco,11/07/2008,8,0,0,0,0,1,0,9
Morocco,12/07/2008,0,0,0,0,3,0,0,3
Morocco,13/07/2008,8,0,0,0,-4,2,0,6
Morocco,14/07/2008,0,0,0,0,0,0,0,0
Morocco,15/07/2008,0,0,0,0,0,0,0,0
Morocco,16/07/2008,4,0,0,0,-2,0,0,2
Morocco,17/07/2008,5,0,0,0,12,0,0,17
Morocco,18/07/2008,0,0,0,0,3,14,0,17
Morocco,19/07/2008,2,0,0,0,0,0,0,2
Morocco,20/07/2008,0,0,0,0,0,0,0,0
Morocco,21/07/2008,6,0,1,0,3,0,0,10
Morocco,22/07/2008,7,0,0,0,3,0,0,10
Morocco,23/07/2008,3,0,0,0,0,0,0,3
Morocco,24/07/2008,1,0,0,0,-3,0,0,-2
Morocco,25/07/2008,0,0,0,0,-7,0,0,-7
Morocco,26/07/2008,3,0,0,0,-4,0,0,-1
Morocco,27/07/2008,2,0,0,0,8,0,0,10
Morocco,28/07/2008,2,0,1,0,3,0,0,6
Morocco,29/07/2008,0,0,0,0,-4,0,0,-4
Morocco,30/07/2008,1,0,1,0,3,4,0,9
Morocco,31/07/2008,0,2,0,0,-4,2,0,0
Nigeria,01/07/2008,16,0,0,0,2,0,0,18
Nigeria,02/07/2008,5,0,0,0,9,0,0,14
Nigeria,03/07/2008,3,0,0,0,0,0,0,3
Nigeria,04/07/2008,5,0,0,0,0,0,0,5
Nigeria,05/07/2008,8,0,0,0,0,0,0,8
Nigeria,06/07/2008,0,0,0,0,9,0,0,9
Nigeria,07/07/2008,16,0,-3,0,18,1,0,32
Nigeria,08/07/2008,-3,0,0,0,18,1,0,16
Nigeria,09/07/2008,33,0,0,0,3,4,0,40
Nigeria,10/07/2008,12,0,0,0,0,0,0,12
Nigeria,11/07/2008,15,0,0,0,-1,4,0,18
Nigeria,12/07/2008,4,0,0,0,3,2,0,9
Nigeria,13/07/2008,3,0,0,0,0,0,0,3
Nigeria,14/07/2008,0,0,0,0,2,2,0,4
Nigeria,15/07/2008,7,0,0,0,0,0,0,7
Nigeria,16/07/2008,41,0,0,0,6,0,0,47
Nigeria,17/07/2008,71,0,-2,0,15,0,0,84
Nigeria,18/07/2008,14,0,0,0,12,0,0,26
Nigeria,19/07/2008,8,0,0,0,9,4,0,21
Nigeria,20/07/2008,7,0,0,0,6,2,0,15
Nigeria,21/07/2008,3,0,0,0,1,3,0,7
Nigeria,22/07/2008,59,0,-2,0,25,5,0,87
Nigeria,23/07/2008,26,0,-2,0,21,7,0,52
Nigeria,24/07/2008,15,0,-2,0,-2,1,0,12
Nigeria,25/07/2008,4,0,0,0,12,2,0,18
Nigeria,26/07/2008,10,0,0,0,7,0,0,17
Nigeria,27/07/2008,6,0,0,0,0,0,0,6
Nigeria,28/07/2008,22,0,0,0,15,1,0,38
Nigeria,29/07/2008,0,0,0,0,0,2,0,2
Nigeria,30/07/2008,9,0,0,0,6,0,0,15
Nigeria,31/07/2008,4,0,0,0,6,0,0,10
Pakistan,01/07/2008,102,0,0,0,3,9,0,114
Pakistan,02/07/2008,119,0,0,0,10,11,0,140
Pakistan,03/07/2008,27,0,0,0,11,3,0,41
Pakistan,04/07/2008,70,0,0,0,3,10,0,83
Pakistan,05/07/2008,47,0,0,0,3,3,0,53
Pakistan,06/07/2008,31,0,0,0,8,2,0,41
Pakistan,07/07/2008,89,0,-1,0,6,3,0,97
Pakistan,08/07/2008,118,0,0,0,20,3,0,141
Pakistan,09/07/2008,88,0,0,0,16,7,0,111
Pakistan,10/07/2008,98,0,-10,0,6,1,0,95
Pakistan,11/07/2008,45,0,-6,0,-2,4,0,41
Pakistan,12/07/2008,79,0,-6,0,2,26,0,101
Pakistan,13/07/2008,140,0,1,0,21,7,0,169
Pakistan,14/07/2008,155,0,2,0,11,24,0,192
Pakistan,15/07/2008,112,0,0,0,17,7,0,136
Pakistan,16/07/2008,133,0,-1,0,13,6,0,151
Pakistan,17/07/2008,101,0,1,0,0,12,0,114
Pakistan,18/07/2008,69,0,0,0,6,3,0,78
Pakistan,19/07/2008,40,0,0,0,12,29,0,81
Pakistan,20/07/2008,119,0,-2,0,21,3,0,141
Pakistan,21/07/2008,56,0,0,0,18,1,0,75
Pakistan,22/07/2008,37,0,0,0,-2,5,0,40
Pakistan,23/07/2008,36,0,0,0,14,1,0,51
Pakistan,24/07/2008,121,0,0,0,22,18,0,161
Pakistan,25/07/2008,41,0,1,0,32,8,0,82
Pakistan,26/07/2008,61,4,0,0,6,1,0,72
Pakistan,27/07/2008,140,0,0,0,19,14,0,173
Pakistan,28/07/2008,78,0,3,0,14,18,0,113
Pakistan,29/07/2008,62,0,0,0,18,8,0,88
Pakistan,30/07/2008,45,0,2,0,6,6,0,59
Pakistan,31/07/2008,115,0,-2,0,48,15,0,176
Sierra Leone,01/07/2008,7,0,0,0,8,1,0,16
Sierra Leone,02/07/2008,18,0,0,0,0,0,0,18
Sierra Leone,03/07/2008,0,0,0,0,0,0,0,0
Sierra Leone,04/07/2008,0,0,0,0,0,0,0,0
Sierra Leone,05/07/2008,0,0,0,0,0,0,0,0
Sierra Leone,07/07/2008,0,0,0,0,3,0,0,3
Sierra Leone,08/07/2008,0,0,0,0,0,0,0,0
Sierra Leone,09/07/2008,0,0,0,0,3,0,0,3
Sierra Leone,10/07/2008,0,0,0,0,0,0,0,0
Sierra Leone,11/07/2008,1,0,0,0,15,0,0,16
Sierra Leone,12/07/2008,0,0,0,0,6,0,0,6
Sierra Leone,13/07/2008,7,0,0,0,6,2,0,15
Sierra Leone,14/07/2008,6,0,0,0,21,4,0,31
Sierra Leone,15/07/2008,2,0,0,0,3,2,0,7
Sierra Leone,16/07/2008,2,0,0,0,0,0,0,2
Sierra Leone,17/07/2008,0,0,0,0,3,0,0,3
Sierra Leone,18/07/2008,2,0,0,0,3,0,0,5
Sierra Leone,20/07/2008,2,0,0,0,3,0,0,5
Sierra Leone,21/07/2008,0,0,0,0,3,0,0,3
Sierra Leone,22/07/2008,4,0,0,0,3,2,0,9
Sierra Leone,23/07/2008,2,0,0,0,5,0,0,7
Sierra Leone,24/07/2008,3,0,0,0,0,0,0,3
Sierra Leone,26/07/2008,0,0,0,0,2,0,0,2
Sierra Leone,27/07/2008,0,0,0,0,0,0,0,0
Sierra Leone,29/07/2008,0,0,0,0,-6,0,0,-6
Sierra Leone,30/07/2008,7,0,0,0,3,0,0,10
Sierra Leone,31/07/2008,2,0,0,0,0,0,0,2
Somalia,01/07/2008,35,0,0,0,4,3,0,42
Somalia,02/07/2008,-1,0,0,0,0,1,0,0
Somalia,03/07/2008,12,0,3,0,15,6,0,36
Somalia,04/07/2008,8,0,0,0,0,2,0,10
Somalia,05/07/2008,3,0,0,0,9,0,0,12
Somalia,06/07/2008,0,0,0,0,-6,-2,0,-8
Somalia,07/07/2008,42,0,3,0,6,0,0,51
Somalia,08/07/2008,0,0,0,0,0,6,0,6
Somalia,09/07/2008,18,0,1,0,-5,4,0,18
Somalia,10/07/2008,4,0,0,0,0,0,0,4
Somalia,11/07/2008,29,0,0,0,0,3,0,32
Somalia,12/07/2008,0,0,0,0,0,0,0,0
Somalia,13/07/2008,0,0,0,0,0,0,0,0
Somalia,14/07/2008,3,0,0,0,0,0,0,3
Somalia,15/07/2008,2,0,0,0,0,5,0,7
Somalia,16/07/2008,2,0,0,0,6,0,0,8
Somalia,17/07/2008,5,0,0,0,6,0,0,11
Somalia,18/07/2008,9,0,0,0,3,0,0,12
Somalia,19/07/2008,22,0,0,0,0,0,0,22
Somalia,20/07/2008,6,0,0,0,8,0,0,14
Somalia,21/07/2008,36,0,0,0,9,2,0,47
Somalia,22/07/2008,16,0,0,0,6,0,0,22
Somalia,23/07/2008,47,4,0,0,1,1,0,53
Somalia,24/07/2008,50,2,0,0,9,0,0,61
Somalia,25/07/2008,57,2,0,0,2,2,0,63
Somalia,26/07/2008,36,6,0,0,6,0,0,48
Somalia,27/07/2008,7,0,0,0,3,0,0,10
Somalia,28/07/2008,29,0,0,0,7,5,0,41
Somalia,29/07/2008,2,0,0,0,3,0,0,5
Somalia,30/07/2008,10,0,-12,0,0,1,0,-1
Somalia,31/07/2008,21,0,-2,0,1,0,0,20
Syria,01/07/2008,23,0,0,0,11,0,0,34
Syria,02/07/2008,16,0,0,0,0,0,0,16
Syria,03/07/2008,14,0,0,0,6,0,0,20
Syria,04/07/2008,6,0,0,0,-1,0,0,5
Syria,05/07/2008,15,0,0,0,9,0,0,24
Syria,06/07/2008,0,0,1,0,13,0,0,14
Syria,07/07/2008,-1,2,0,0,7,0,0,8
Syria,08/07/2008,17,2,0,0,9,0,0,28
Syria,09/07/2008,25,0,0,0,1,1,0,27
Syria,10/07/2008,3,0,0,0,-8,0,0,-5
Syria,11/07/2008,5,0,-11,0,6,4,0,4
Syria,12/07/2008,12,0,1,0,0,0,0,13
Syria,13/07/2008,26,4,0,0,-9,4,0,25
Syria,14/07/2008,26,0,0,0,6,3,0,35
Syria,15/07/2008,8,0,0,0,6,7,0,21
Syria,16/07/2008,14,0,0,0,-1,9,0,22
Syria,17/07/2008,23,0,1,0,-3,4,0,25
Syria,18/07/2008,30,0,0,0,20,0,0,50
Syria,19/07/2008,-2,0,0,0,4,1,0,3
Syria,20/07/2008,1,0,0,0,36,0,0,37
Syria,21/07/2008,19,0,0,0,9,2,0,30
Syria,22/07/2008,10,0,0,0,1,0,0,11
Syria,23/07/2008,-2,0,0,0,25,9,0,32
Syria,24/07/2008,11,0,0,0,13,0,0,24
Syria,25/07/2008,31,0,0,0,-3,0,0,28
Syria,26/07/2008,19,0,0,0,0,0,0,19
Syria,27/07/2008,24,0,0,0,9,0,0,33
Syria,28/07/2008,11,0,0,0,-2,0,0,9
Syria,29/07/2008,15,0,0,0,0,0,0,15
Syria,30/07/2008,-3,0,-3,0,18,0,0,12
Syria,31/07/2008,21,0,-4,0,0,1,0,18
Yemen,01/07/2008,24,0,0,0,15,1,0,40
Yemen,02/07/2008,8,0,0,0,3,0,0,11
Yemen,03/07/2008,5,0,0,0,14,1,0,20
Yemen,04/07/2008,4,0,0,0,15,0,0,19
Yemen,05/07/2008,0,0,0,0,-2,1,0,-1
Yemen,06/07/2008,2,0,0,0,0,0,0,2
Yemen,07/07/2008,8,0,0,0,15,3,0,26
Yemen,08/07/2008,3,0,0,0,20,0,0,23
Yemen,09/07/2008,3,0,0,0,13,0,0,16
Yemen,10/07/2008,0,0,0,0,3,0,0,3
Yemen,11/07/2008,0,0,0,0,0,0,0,0
Yemen,12/07/2008,0,0,0,0,0,0,0,0
Yemen,13/07/2008,0,0,0,0,-2,1,0,-1
Yemen,14/07/2008,12,0,0,0,-2,1,0,11
Yemen,15/07/2008,6,0,0,0,18,0,0,24
Yemen,16/07/2008,4,0,0,0,15,0,0,19
Yemen,17/07/2008,6,0,1,0,30,0,0,37
Yemen,18/07/2008,3,0,1,0,19,0,0,23
Yemen,19/07/2008,5,0,1,0,9,0,0,15
Yemen,20/07/2008,0,0,0,0,2,0,0,2
Yemen,21/07/2008,26,0,0,0,27,0,0,53
Yemen,22/07/2008,15,0,0,0,26,0,0,41
Yemen,23/07/2008,39,0,0,0,23,0,0,62
Yemen,24/07/2008,8,0,0,0,9,3,0,20
Yemen,25/07/2008,10,0,0,0,-1,9,0,18
Yemen,26/07/2008,3,0,0,0,0,0,0,3
Yemen,27/07/2008,14,0,0,0,6,2,0,22
Yemen,28/07/2008,10,0,0,0,0,2,0,12
Yemen,29/07/2008,1,0,0,0,2,0,0,3
Yemen,30/07/2008,5,0,0,0,9,0,0,14
Yemen,31/07/2008,17,0,0,0,36,1,0,54
Afghanistan,01/08/2006,40,2,0,0,-1,9,0,50
Afghanistan,02/08/2006,65,0,0,0,2,7,0,74
Afghanistan,03/08/2006,100,0,0,0,18,21,0,139
Afghanistan,04/08/2006,30,0,4,0,3,5,0,42
Afghanistan,05/08/2006,21,0,0,0,6,9,0,36
Afghanistan,06/08/2006,45,0,0,0,4,4,0,53
Afghanistan,07/08/2006,13,0,0,0,6,2,0,21
Afghanistan,08/08/2006,47,0,-1,0,3,6,0,55
Afghanistan,09/08/2006,19,0,0,0,12,2,0,33
Afghanistan,10/08/2006,28,0,0,0,6,1,0,35
Afghanistan,11/08/2006,28,0,0,0,23,8,0,59
Afghanistan,12/08/2006,44,0,0,0,20,3,0,67
Afghanistan,13/08/2006,38,0,0,0,9,8,0,55
Afghanistan,14/08/2006,33,0,0,0,12,6,0,51
Afghanistan,15/08/2006,18,2,0,0,9,4,0,33
Afghanistan,16/08/2006,30,0,0,0,15,2,0,47
Afghanistan,17/08/2006,67,0,0,0,34,19,0,120
Afghanistan,18/08/2006,22,2,0,0,6,9,0,39
Afghanistan,19/08/2006,6,0,1,0,18,7,0,32
Afghanistan,20/08/2006,129,0,0,0,3,6,0,138
Afghanistan,21/08/2006,38,0,0,0,25,0,0,63
Afghanistan,22/08/2006,25,0,-2,0,5,7,0,35
Afghanistan,23/08/2006,55,0,0,0,14,13,0,82
Afghanistan,24/08/2006,48,0,0,0,39,3,0,90
Afghanistan,25/08/2006,28,0,0,0,1,0,0,29
Afghanistan,26/08/2006,27,0,0,0,10,6,0,43
Afghanistan,27/08/2006,66,0,0,0,0,2,0,68
Afghanistan,28/08/2006,35,0,0,0,18,1,0,54
Afghanistan,29/08/2006,33,0,1,0,12,2,0,48
Afghanistan,30/08/2006,59,0,0,0,43,3,0,105
Afghanistan,31/08/2006,2,0,0,0,3,1,0,6
Albania,01/08/2006,0,0,0,0,0,2,0,2
Albania,02/08/2006,15,0,0,0,0,1,0,16
Albania,03/08/2006,12,0,0,0,3,1,0,16
Albania,04/08/2006,9,0,0,0,0,2,0,11
Albania,05/08/2006,3,0,0,0,-2,0,0,1
Albania,06/08/2006,0,0,0,0,0,0,0,0
Albania,07/08/2006,16,0,0,0,0,2,0,18
Albania,08/08/2006,4,0,-2,0,6,2,0,10
Albania,09/08/2006,13,0,1,0,-2,1,0,13
Albania,10/08/2006,1,0,0,0,6,1,0,8
Albania,11/08/2006,0,0,0,0,12,0,0,12
Albania,12/08/2006,22,0,0,0,0,0,0,22
Albania,13/08/2006,12,0,0,0,0,0,0,12
Albania,14/08/2006,23,0,0,0,0,1,0,24
Albania,15/08/2006,16,0,-2,0,0,0,0,14
Albania,16/08/2006,4,0,0,0,-4,0,0,0
Albania,17/08/2006,0,0,0,0,0,-4,0,-4
Albania,18/08/2006,3,0,0,0,15,0,0,18
Albania,19/08/2006,6,0,0,0,0,0,0,6
Albania,20/08/2006,2,0,0,0,0,0,0,2
Albania,21/08/2006,3,0,0,0,3,0,0,6
Albania,22/08/2006,0,0,0,0,0,0,0,0
Albania,23/08/2006,2,0,0,0,0,1,0,3
Albania,24/08/2006,6,0,0,0,3,1,0,10
Albania,25/08/2006,9,0,0,0,0,3,0,12
Albania,26/08/2006,7,0,0,0,0,3,0,10
Albania,27/08/2006,18,0,-2,0,0,2,0,18
Albania,28/08/2006,4,0,-1,0,7,3,0,13
Albania,29/08/2006,0,0,0,0,3,0,0,3
Albania,30/08/2006,2,0,0,0,0,3,0,5
Albania,31/08/2006,5,0,0,0,-2,0,0,3
Algeria,02/08/2006,-1,0,0,0,0,0,0,-1
Algeria,03/08/2006,0,0,0,0,0,0,0,0
Algeria,04/08/2006,-1,0,0,0,3,0,0,2
Algeria,05/08/2006,3,0,0,0,0,0,0,3
Algeria,06/08/2006,0,0,0,0,0,0,0,0
Algeria,07/08/2006,2,0,0,0,0,0,0,2
Algeria,08/08/2006,0,0,0,0,0,0,0,0
Algeria,09/08/2006,-1,0,0,0,0,1,0,0
Algeria,10/08/2006,4,0,0,0,3,0,0,7
Algeria,11/08/2006,0,0,0,0,3,0,0,3
Algeria,12/08/2006,-2,0,0,0,3,0,0,1
Algeria,13/08/2006,0,0,0,0,3,0,0,3
Algeria,14/08/2006,3,0,0,0,3,2,0,8
Algeria,15/08/2006,2,0,0,0,0,0,0,2
Algeria,16/08/2006,0,0,0,0,0,0,0,0
Algeria,17/08/2006,4,0,0,0,1,0,0,5
Algeria,18/08/2006,2,0,0,0,7,0,0,9
Algeria,19/08/2006,-1,0,0,0,12,0,0,11
Algeria,20/08/2006,0,0,0,0,0,0,0,0
Algeria,21/08/2006,0,0,0,0,0,0,0,0
Algeria,22/08/2006,0,0,0,0,0,0,0,0
Algeria,23/08/2006,0,0,0,0,-2,0,0,-2
Algeria,24/08/2006,8,0,0,0,24,0,0,32
Algeria,25/08/2006,2,0,0,0,0,0,0,2
Algeria,27/08/2006,-1,0,0,0,-2,0,0,-3
Algeria,28/08/2006,-2,0,0,0,0,1,0,-1
Algeria,29/08/2006,0,0,0,0,0,0,0,0
Algeria,30/08/2006,7,0,0,0,0,2,0,9
Algeria,31/08/2006,0,0,0,0,0,0,0,0
Bangladesh,01/08/2006,-9,0,0,0,0,1,0,-8
Bangladesh,02/08/2006,3,0,-2,0,0,0,0,1
Bangladesh,03/08/2006,16,0,0,0,3,1,0,20
Bangladesh,04/08/2006,6,0,0,0,6,1,0,13
Bangladesh,05/08/2006,0,0,0,0,0,0,0,0
Bangladesh,06/08/2006,0,0,0,0,0,0,0,0
Bangladesh,07/08/2006,13,0,0,0,3,0,0,16
Bangladesh,08/08/2006,15,0,0,0,0,3,0,18
Bangladesh,09/08/2006,-4,0,0,0,6,0,0,2
Bangladesh,10/08/2006,0,0,0,0,0,0,0,0
Bangladesh,11/08/2006,0,0,0,0,0,0,0,0
Bangladesh,12/08/2006,8,0,0,0,15,0,0,23
Bangladesh,13/08/2006,12,0,0,0,3,0,0,15
Bangladesh,14/08/2006,10,0,0,0,0,0,0,10
Bangladesh,15/08/2006,11,0,0,0,4,0,0,15
Bangladesh,16/08/2006,4,0,0,0,2,0,0,6
Bangladesh,17/08/2006,3,0,0,0,-4,0,0,-1
Bangladesh,18/08/2006,19,0,0,0,9,1,0,29
Bangladesh,19/08/2006,16,0,0,0,3,0,0,19
Bangladesh,20/08/2006,0,0,0,0,-2,0,0,-2
Bangladesh,21/08/2006,1,0,0,0,0,0,0,1
Bangladesh,22/08/2006,10,0,0,0,1,2,0,13
Bangladesh,23/08/2006,7,0,0,0,4,0,0,11
Bangladesh,24/08/2006,3,0,0,0,10,0,0,13
Bangladesh,25/08/2006,5,0,0,0,-1,0,0,4
Bangladesh,26/08/2006,3,0,0,0,-2,0,0,1
Bangladesh,27/08/2006,9,0,0,0,0,0,0,9
Bangladesh,28/08/2006,7,0,0,0,0,0,0,7
Bangladesh,29/08/2006,3,0,0,0,3,0,0,6
Bangladesh,30/08/2006,1,0,0,0,0,0,0,1
Bangladesh,31/08/2006,5,0,1,0,0,0,0,6
Cameroon,01/08/2006,0,0,0,0,0,0,0,0
Cameroon,02/08/2006,4,0,0,0,3,2,0,9
Cameroon,03/08/2006,0,0,0,0,0,0,0,0
Cameroon,04/08/2006,2,0,0,0,0,2,0,4
Cameroon,05/08/2006,2,0,0,0,0,0,0,2
Cameroon,06/08/2006,0,0,0,0,0,0,0,0
Cameroon,07/08/2006,3,0,0,0,0,0,0,3
Cameroon,08/08/2006,3,0,0,0,0,1,0,4
Cameroon,09/08/2006,-2,0,0,0,-4,0,0,-6
Cameroon,10/08/2006,-3,0,0,0,0,0,0,-3
Cameroon,11/08/2006,2,0,0,0,0,0,0,2
Cameroon,15/08/2006,-3,0,0,0,0,0,0,-3
Cameroon,16/08/2006,0,0,0,0,0,0,0,0
Cameroon,17/08/2006,0,0,0,0,-2,0,0,-2
Cameroon,18/08/2006,1,0,-1,0,4,0,0,4
Cameroon,21/08/2006,3,0,0,0,0,0,0,3
Cameroon,22/08/2006,9,0,0,0,6,0,0,15
Cameroon,23/08/2006,7,0,0,0,0,0,0,7
Cameroon,24/08/2006,0,0,0,0,-2,0,0,-2
Cameroon,25/08/2006,0,0,0,0,0,0,0,0
Cameroon,27/08/2006,0,0,0,0,0,0,0,0
Cameroon,29/08/2006,6,0,0,0,0,0,0,6
Cameroon,30/08/2006,0,0,0,0,0,0,0,0
Cameroon,31/08/2006,2,0,0,0,0,0,0,2
China,01/08/2006,15,0,0,0,3,12,0,30
China,02/08/2006,37,0,0,0,10,4,0,51
China,03/08/2006,45,0,-2,0,25,1,0,69
China,04/08/2006,20,0,0,0,6,2,0,28
China,05/08/2006,5,0,1,0,15,1,0,22
China,06/08/2006,42,0,0,0,0,4,0,46
China,07/08/2006,40,0,0,0,16,12,0,68
China,08/08/2006,23,0,-4,0,18,3,0,40
China,09/08/2006,45,0,0,0,60,6,0,111
China,10/08/2006,12,0,-1,0,15,0,0,26
China,11/08/2006,45,0,0,0,2,0,0,47
China,12/08/2006,7,0,0,0,2,1,0,10
China,13/08/2006,21,0,0,0,3,8,0,32
China,14/08/2006,13,0,1,0,18,4,0,36
China,15/08/2006,25,0,0,0,7,6,0,38
China,16/08/2006,11,0,-2,0,19,6,0,34
China,17/08/2006,9,2,-1,0,12,3,0,25
China,18/08/2006,23,0,2,0,9,1,0,35
China,19/08/2006,51,0,0,0,27,2,0,80
China,20/08/2006,19,2,0,0,10,1,0,32
China,21/08/2006,63,0,2,0,35,2,0,102
China,22/08/2006,49,0,0,0,26,12,0,87
China,23/08/2006,21,0,0,0,10,4,0,35
China,24/08/2006,29,0,-1,0,23,13,0,64
China,25/08/2006,35,0,-2,0,11,3,0,47
China,26/08/2006,43,0,0,0,17,1,0,61
China,27/08/2006,20,0,0,0,4,0,0,24
China,28/08/2006,44,0,0,0,7,4,0,55
China,29/08/2006,28,0,0,0,27,5,0,60
China,30/08/2006,10,0,1,0,12,4,0,27
China,31/08/2006,19,0,2,0,33,7,0,61
Egypt,01/08/2006,19,0,0,0,2,0,0,21
Egypt,02/08/2006,-1,0,0,0,6,0,0,5
Egypt,03/08/2006,24,0,0,0,9,0,0,33
Egypt,04/08/2006,22,0,0,0,0,1,0,23
Egypt,05/08/2006,14,2,0,0,0,0,0,16
Egypt,06/08/2006,31,0,0,0,19,10,0,60
Egypt,07/08/2006,16,0,0,0,6,1,0,23
Egypt,08/08/2006,11,0,0,0,0,0,0,11
Egypt,09/08/2006,9,0,0,0,0,2,0,11
Egypt,10/08/2006,28,0,0,0,10,0,0,38
Egypt,11/08/2006,11,0,0,0,6,0,0,17
Egypt,12/08/2006,8,0,0,0,14,0,0,22
Egypt,13/08/2006,29,0,0,0,-7,0,0,22
Egypt,14/08/2006,36,0,0,0,3,0,0,39
Egypt,15/08/2006,-3,0,0,0,0,0,0,-3
Egypt,16/08/2006,5,0,0,0,-2,1,0,4
Egypt,17/08/2006,6,0,0,0,6,1,0,13
Egypt,18/08/2006,8,0,0,0,21,6,0,35
Egypt,19/08/2006,12,0,0,0,6,0,0,18
Egypt,20/08/2006,12,0,0,0,9,0,0,21
Egypt,21/08/2006,13,0,1,0,5,2,0,21
Egypt,22/08/2006,9,0,0,0,0,0,0,9
Egypt,23/08/2006,35,0,0,0,14,0,0,49
Egypt,24/08/2006,6,0,0,0,10,0,0,16
Egypt,25/08/2006,3,0,0,0,3,0,0,6
Egypt,26/08/2006,-1,0,0,0,0,0,0,-1
Egypt,27/08/2006,0,0,0,0,3,2,0,5
Egypt,28/08/2006,1,0,0,0,-5,0,0,-4
Egypt,29/08/2006,8,0,0,0,0,0,0,8
Egypt,30/08/2006,10,0,0,0,1,2,0,13
Egypt,31/08/2006,-6,0,0,0,0,0,0,-6
Eritrea,01/08/2006,6,0,-4,0,-6,0,0,-4
Eritrea,02/08/2006,4,0,0,0,0,0,0,4
Eritrea,03/08/2006,2,0,0,0,0,0,0,2
Eritrea,04/08/2006,13,0,0,0,0,0,0,13
Eritrea,05/08/2006,6,0,0,0,0,0,0,6
Eritrea,06/08/2006,0,0,0,0,0,0,0,0
Eritrea,07/08/2006,-1,0,0,0,1,0,0,0
Eritrea,08/08/2006,4,0,0,0,0,0,0,4
Eritrea,09/08/2006,8,0,0,0,0,0,0,8
Eritrea,10/08/2006,1,0,0,0,3,0,0,4
Eritrea,11/08/2006,0,0,0,0,1,0,0,1
Eritrea,12/08/2006,9,0,0,0,0,0,0,9
Eritrea,16/08/2006,0,0,0,0,0,0,0,0
Eritrea,18/08/2006,11,0,0,0,0,0,0,11
Eritrea,19/08/2006,0,0,0,0,0,0,0,0
Eritrea,20/08/2006,2,0,0,0,0,0,0,2
Eritrea,21/08/2006,3,0,0,0,0,0,0,3
Eritrea,22/08/2006,4,0,0,0,0,3,0,7
Eritrea,24/08/2006,0,0,0,0,0,0,0,0
Eritrea,26/08/2006,0,0,0,0,0,0,0,0
Eritrea,27/08/2006,0,0,0,0,0,0,0,0
Eritrea,28/08/2006,0,0,0,0,6,2,0,8
Eritrea,29/08/2006,0,0,0,0,9,0,0,9
Eritrea,30/08/2006,0,0,0,0,0,0,0,0
Eritrea,31/08/2006,3,0,0,0,5,1,0,9
Georgia,01/08/2006,0,0,0,0,3,0,0,3
Georgia,02/08/2006,-1,0,0,0,3,0,0,2
Georgia,03/08/2006,7,0,-2,0,-2,0,0,3
Georgia,04/08/2006,0,0,0,0,3,0,0,3
Georgia,05/08/2006,4,0,0,0,9,0,0,13
Georgia,06/08/2006,2,0,0,0,-2,0,0,0
Georgia,07/08/2006,3,0,0,0,0,0,0,3
Georgia,08/08/2006,0,0,0,0,0,0,0,0
Georgia,09/08/2006,0,0,0,0,3,0,0,3
Georgia,10/08/2006,6,0,0,0,0,0,0,6
Georgia,11/08/2006,2,0,0,0,9,0,0,11
Georgia,14/08/2006,0,0,0,0,0,0,0,0
Georgia,15/08/2006,4,0,0,0,0,1,0,5
Georgia,16/08/2006,2,0,0,0,0,4,0,6
Georgia,17/08/2006,9,0,0,0,6,0,0,15
Georgia,18/08/2006,1,0,-4,0,6,0,0,3
Georgia,19/08/2006,10,0,0,0,0,0,0,10
Georgia,21/08/2006,3,0,0,0,0,0,0,3
Georgia,22/08/2006,10,0,0,0,0,1,0,11
Georgia,23/08/2006,0,0,1,0,0,2,0,3
Georgia,24/08/2006,3,0,0,0,9,0,0,12
Georgia,25/08/2006,3,0,0,0,3,0,0,6
Georgia,26/08/2006,-1,0,0,0,6,0,0,5
Georgia,27/08/2006,0,0,0,0,0,0,0,0
Georgia,28/08/2006,14,0,0,0,3,0,0,17
Georgia,29/08/2006,0,0,0,0,0,0,0,0
Georgia,30/08/2006,-1,0,0,0,0,0,0,-1
India,01/08/2006,7,0,0,0,-6,0,0,1
India,02/08/2006,25,0,0,0,0,0,0,25
India,03/08/2006,11,0,0,0,0,2,0,13
India,04/08/2006,17,0,-2,0,6,0,0,21
India,05/08/2006,6,2,0,0,3,3,0,14
India,06/08/2006,5,0,0,0,6,2,0,13
India,07/08/2006,3,0,1,0,-4,2,0,2
India,08/08/2006,1,0,0,0,6,2,0,9
India,09/08/2006,0,0,0,0,0,0,0,0
India,10/08/2006,9,0,1,0,15,0,0,25
India,11/08/2006,10,0,-1,0,3,3,0,15
India,12/08/2006,12,0,0,0,6,3,0,21
India,13/08/2006,9,0,0,0,6,1,0,16
India,14/08/2006,25,0,0,0,9,0,0,34
India,15/08/2006,2,0,0,0,3,3,0,8
India,16/08/2006,3,0,0,0,0,0,0,3
India,17/08/2006,19,0,0,0,-1,1,0,19
India,18/08/2006,13,0,-4,0,-3,2,0,8
India,19/08/2006,6,0,-1,0,24,0,0,29
India,20/08/2006,5,0,-2,0,0,0,0,3
India,21/08/2006,5,0,-2,0,-2,0,0,1
India,22/08/2006,20,0,-2,0,6,1,0,25
India,23/08/2006,5,0,0,0,0,0,0,5
India,24/08/2006,20,0,0,0,6,2,0,28
India,25/08/2006,22,2,0,0,3,6,0,33
India,26/08/2006,10,0,0,0,1,0,0,11
India,27/08/2006,13,0,0,0,-12,0,0,1
India,28/08/2006,3,0,-1,0,-5,1,0,-2
India,29/08/2006,8,0,0,0,15,1,0,24
India,30/08/2006,4,0,0,0,-2,6,0,8
India,31/08/2006,8,0,0,0,1,1,0,10
Iran,01/08/2006,131,0,0,0,6,1,0,138
Iran,02/08/2006,54,0,0,0,1,0,0,55
Iran,03/08/2006,23,0,0,0,4,4,0,31
Iran,04/08/2006,32,0,0,0,12,5,0,49
Iran,05/08/2006,33,0,0,0,3,2,0,38
Iran,06/08/2006,37,0,3,0,12,1,0,53
Iran,07/08/2006,21,0,0,0,0,10,0,31
Iran,08/08/2006,56,0,1,0,0,2,0,59
Iran,09/08/2006,27,0,1,0,7,3,0,38
Iran,10/08/2006,50,0,-2,0,22,9,0,79
Iran,11/08/2006,31,0,0,0,18,9,0,58
Iran,12/08/2006,11,0,0,0,6,0,0,17
Iran,13/08/2006,28,0,0,0,6,0,0,34
Iran,14/08/2006,27,0,-1,0,16,6,0,48
Iran,15/08/2006,39,0,0,0,9,8,0,56
Iran,16/08/2006,34,0,0,0,-5,0,0,29
Iran,17/08/2006,34,0,0,0,-1,6,0,39
Iran,18/08/2006,50,0,1,0,12,1,0,64
Iran,19/08/2006,47,0,0,0,0,1,0,48
Iran,20/08/2006,27,0,0,0,7,7,0,41
Iran,21/08/2006,47,0,3,0,4,5,0,59
Iran,22/08/2006,83,0,1,0,11,3,0,98
Iran,23/08/2006,41,0,1,0,4,7,0,53
Iran,24/08/2006,22,0,0,0,12,10,0,44
Iran,25/08/2006,24,0,0,0,12,4,0,40
Iran,26/08/2006,37,0,0,0,-2,2,0,37
Iran,27/08/2006,54,0,0,0,4,3,0,61
Iran,28/08/2006,33,0,0,0,33,1,0,67
Iran,29/08/2006,56,2,1,0,-1,3,0,61
Iran,30/08/2006,33,0,-2,0,4,2,0,37
Iran,31/08/2006,19,0,5,0,23,5,0,52
Iraq,01/08/2006,95,0,-1,0,22,12,0,128
Iraq,02/08/2006,46,2,1,0,2,11,0,62
Iraq,03/08/2006,59,2,1,0,27,2,0,91
Iraq,04/08/2006,37,0,1,0,41,21,0,100
Iraq,05/08/2006,33,2,0,0,22,11,0,68
Iraq,06/08/2006,59,0,-4,0,31,14,0,100
Iraq,07/08/2006,26,2,-2,0,9,19,0,54
Iraq,08/08/2006,55,4,1,0,-6,2,0,56
Iraq,09/08/2006,108,0,1,0,9,5,0,123
Iraq,10/08/2006,50,0,1,0,23,3,0,77
Iraq,11/08/2006,53,0,1,0,-2,5,0,57
Iraq,12/08/2006,46,0,-2,0,3,8,0,55
Iraq,13/08/2006,35,0,0,0,18,4,0,57
Iraq,14/08/2006,55,0,0,0,12,2,0,69
Iraq,15/08/2006,53,0,4,0,18,12,0,87
Iraq,16/08/2006,37,0,0,0,6,2,0,45
Iraq,17/08/2006,58,0,2,0,59,7,0,126
Iraq,18/08/2006,45,0,0,0,16,1,0,62
Iraq,19/08/2006,16,0,0,0,7,2,0,25
Iraq,20/08/2006,22,0,0,0,18,6,0,46
Iraq,21/08/2006,83,0,0,0,36,6,0,125
Iraq,22/08/2006,37,0,1,0,10,4,0,52
Iraq,23/08/2006,72,0,2,0,26,7,0,107
Iraq,24/08/2006,81,0,1,0,36,4,0,122
Iraq,25/08/2006,73,0,0,0,33,1,0,107
Iraq,26/08/2006,43,0,0,0,21,1,0,65
Iraq,27/08/2006,76,0,2,0,6,12,0,96
Iraq,28/08/2006,78,0,0,0,12,8,0,98
Iraq,29/08/2006,91,0,1,0,15,3,0,110
Iraq,30/08/2006,77,0,0,0,22,4,0,103
Iraq,31/08/2006,58,0,-1,0,9,10,0,76
Morocco,01/08/2006,0,0,0,0,3,0,0,3
Morocco,02/08/2006,0,0,0,0,0,0,0,0
Morocco,03/08/2006,0,0,0,0,0,0,0,0
Morocco,04/08/2006,0,0,0,0,0,0,0,0
Morocco,05/08/2006,0,0,0,0,0,0,0,0
Morocco,06/08/2006,0,0,0,0,3,1,0,4
Morocco,07/08/2006,0,0,0,0,0,0,0,0
Morocco,08/08/2006,-1,0,0,0,-5,0,0,-6
Morocco,09/08/2006,-1,0,0,0,0,0,0,-1
Morocco,10/08/2006,0,0,0,0,6,0,0,6
Morocco,11/08/2006,24,0,0,0,12,0,0,36
Morocco,12/08/2006,-1,0,0,0,6,0,0,5
Morocco,13/08/2006,8,0,0,0,0,0,0,8
Morocco,14/08/2006,-13,0,0,0,12,0,0,-1
Morocco,15/08/2006,8,0,0,0,4,0,0,12
Morocco,16/08/2006,-5,0,0,0,0,1,0,-4
Morocco,17/08/2006,0,0,0,0,3,0,0,3
Morocco,18/08/2006,0,0,0,0,6,0,0,6
Morocco,19/08/2006,0,0,0,0,3,0,0,3
Morocco,20/08/2006,0,0,0,0,2,0,0,2
Morocco,21/08/2006,3,0,0,0,0,0,0,3
Morocco,22/08/2006,0,0,0,0,0,0,0,0
Morocco,23/08/2006,1,0,0,0,6,0,0,7
Morocco,24/08/2006,0,0,0,0,3,0,0,3
Morocco,25/08/2006,0,0,0,0,0,0,0,0
Morocco,27/08/2006,3,0,0,0,0,0,0,3
Morocco,28/08/2006,6,0,0,0,0,0,0,6
Morocco,29/08/2006,0,0,0,0,9,0,0,9
Morocco,30/08/2006,0,0,0,0,9,0,0,9
Morocco,31/08/2006,1,0,0,0,1,0,0,2
Nigeria,01/08/2006,25,0,0,0,-4,5,0,26
Nigeria,02/08/2006,16,4,-2,0,2,1,0,21
Nigeria,03/08/2006,34,0,-12,0,3,0,0,25
Nigeria,04/08/2006,35,0,-6,0,0,0,0,29
Nigeria,05/08/2006,1,0,0,0,0,0,0,1
Nigeria,06/08/2006,4,0,-2,0,0,0,0,2
Nigeria,07/08/2006,30,0,-1,0,2,2,0,33
Nigeria,08/08/2006,11,0,-1,0,1,1,0,12
Nigeria,09/08/2006,9,0,1,0,28,3,0,41
Nigeria,10/08/2006,14,0,-2,0,21,1,0,34
Nigeria,11/08/2006,24,0,0,0,-1,0,0,23
Nigeria,12/08/2006,1,0,0,0,-1,0,0,0
Nigeria,13/08/2006,8,0,0,0,1,0,0,9
Nigeria,14/08/2006,3,0,0,0,2,0,0,5
Nigeria,15/08/2006,26,0,0,0,17,5,0,48
Nigeria,16/08/2006,30,0,0,0,6,3,0,39
Nigeria,17/08/2006,13,0,1,0,12,0,0,26
Nigeria,18/08/2006,15,0,0,0,2,2,0,19
Nigeria,19/08/2006,8,0,0,0,-3,0,0,5
Nigeria,20/08/2006,5,0,0,0,0,7,0,12
Nigeria,21/08/2006,18,0,2,0,9,0,0,29
Nigeria,22/08/2006,11,0,0,0,-8,0,0,3
Nigeria,23/08/2006,0,0,0,0,1,1,0,2
Nigeria,24/08/2006,10,0,0,0,14,1,0,25
Nigeria,25/08/2006,3,0,0,0,3,1,0,7
Nigeria,26/08/2006,0,0,0,0,3,0,0,3
Nigeria,27/08/2006,9,0,0,0,6,3,0,18
Nigeria,28/08/2006,12,0,0,0,4,-2,0,14
Nigeria,29/08/2006,12,0,-2,0,1,1,0,12
Nigeria,30/08/2006,-5,0,-2,0,2,2,0,-3
Nigeria,31/08/2006,12,0,-1,0,2,6,0,19
Pakistan,01/08/2006,30,0,0,0,6,1,0,37
Pakistan,02/08/2006,9,0,0,0,3,3,0,15
Pakistan,03/08/2006,32,0,0,0,1,5,0,38
Pakistan,04/08/2006,11,0,0,0,21,0,0,32
Pakistan,05/08/2006,7,0,0,0,9,3,0,19
Pakistan,06/08/2006,7,0,0,0,17,0,0,24
Pakistan,07/08/2006,7,0,0,0,3,1,0,11
Pakistan,08/08/2006,32,0,0,0,2,0,0,34
Pakistan,09/08/2006,28,0,0,0,14,0,0,42
Pakistan,10/08/2006,37,0,0,0,21,0,0,58
Pakistan,11/08/2006,42,0,-1,0,70,0,0,111
Pakistan,12/08/2006,38,0,2,0,39,3,0,82
Pakistan,13/08/2006,58,2,0,0,61,0,0,121
Pakistan,14/08/2006,67,0,0,0,1,9,0,77
Pakistan,15/08/2006,33,2,0,0,48,4,0,87
Pakistan,16/08/2006,23,0,0,0,45,4,0,72
Pakistan,17/08/2006,21,0,0,0,22,6,0,49
Pakistan,18/08/2006,14,0,0,0,45,2,0,61
Pakistan,19/08/2006,9,0,0,0,21,5,0,35
Pakistan,20/08/2006,11,0,0,0,9,0,0,20
Pakistan,21/08/2006,38,0,0,0,8,1,0,47
Pakistan,22/08/2006,61,0,0,0,34,8,0,103
Pakistan,23/08/2006,35,0,0,0,42,3,0,80
Pakistan,24/08/2006,43,2,0,0,28,3,0,76
Pakistan,25/08/2006,16,0,0,0,24,2,0,42
Pakistan,26/08/2006,10,0,0,0,7,0,0,17
Pakistan,27/08/2006,16,0,0,0,2,0,0,18
Pakistan,28/08/2006,18,0,0,0,13,2,0,33
Pakistan,29/08/2006,6,0,0,0,11,0,0,17
Pakistan,30/08/2006,23,0,0,0,28,2,0,53
Pakistan,31/08/2006,7,0,2,0,21,4,0,34
Sierra Leone,01/08/2006,0,0,0,0,3,0,0,3
Sierra Leone,02/08/2006,2,0,0,0,3,0,0,5
Sierra Leone,03/08/2006,-1,0,0,0,0,0,0,-1
Sierra Leone,04/08/2006,19,0,0,0,15,1,0,35
Sierra Leone,07/08/2006,9,0,0,0,0,1,0,10
Sierra Leone,08/08/2006,0,0,0,0,0,0,0,0
Sierra Leone,09/08/2006,0,0,0,0,0,0,0,0
Sierra Leone,10/08/2006,2,0,0,0,0,0,0,2
Sierra Leone,11/08/2006,0,0,0,0,0,0,0,0
Sierra Leone,14/08/2006,0,0,0,0,0,0,0,0
Sierra Leone,15/08/2006,2,0,0,0,0,0,0,2
Sierra Leone,16/08/2006,2,0,0,0,0,0,0,2
Sierra Leone,17/08/2006,2,0,0,0,3,0,0,5
Sierra Leone,18/08/2006,0,0,0,0,0,0,0,0
Sierra Leone,20/08/2006,3,0,0,0,0,0,0,3
Sierra Leone,24/08/2006,0,0,0,0,0,0,0,0
Sierra Leone,25/08/2006,0,0,0,0,0,0,0,0
Sierra Leone,26/08/2006,0,0,0,0,0,0,0,0
Sierra Leone,27/08/2006,0,0,0,0,0,0,0,0
Sierra Leone,28/08/2006,0,0,0,0,0,0,0,0
Sierra Leone,29/08/2006,1,0,0,0,0,0,0,1
Sierra Leone,31/08/2006,0,0,0,0,0,0,0,0
Somalia,01/08/2006,3,0,-6,0,6,0,0,3
Somalia,02/08/2006,10,0,0,0,0,0,0,10
Somalia,03/08/2006,1,0,-4,0,9,0,0,6
Somalia,04/08/2006,4,0,-2,0,0,0,0,2
Somalia,05/08/2006,-2,0,0,0,8,0,0,6
Somalia,06/08/2006,2,0,0,0,-1,0,0,1
Somalia,07/08/2006,1,0,0,0,0,0,0,1
Somalia,08/08/2006,0,0,0,0,0,0,0,0
Somalia,09/08/2006,2,2,0,0,-3,0,0,1
Somalia,10/08/2006,16,0,0,0,0,0,0,16
Somalia,11/08/2006,3,0,0,0,0,0,0,3
Somalia,12/08/2006,1,0,0,0,0,0,0,1
Somalia,13/08/2006,0,0,0,0,0,0,0,0
Somalia,14/08/2006,7,0,0,0,0,0,0,7
Somalia,15/08/2006,2,0,0,0,0,0,0,2
Somalia,16/08/2006,1,0,0,0,-2,0,0,-1
Somalia,17/08/2006,1,0,0,0,6,2,0,9
Somalia,18/08/2006,24,0,0,0,0,0,0,24
Somalia,19/08/2006,2,0,0,0,0,0,0,2
Somalia,20/08/2006,7,0,0,0,-2,0,0,5
Somalia,21/08/2006,4,0,0,0,0,0,0,4
Somalia,22/08/2006,6,0,0,0,0,0,0,6
Somalia,23/08/2006,2,0,0,0,0,0,0,2
Somalia,24/08/2006,2,0,0,0,0,0,0,2
Somalia,25/08/2006,0,0,0,0,3,0,0,3
Somalia,26/08/2006,2,0,0,0,12,0,0,14
Somalia,27/08/2006,14,0,0,0,0,0,0,14
Somalia,28/08/2006,10,0,0,0,9,2,0,21
Somalia,29/08/2006,9,2,0,0,0,0,0,11
Somalia,30/08/2006,5,0,0,0,0,0,0,5
Somalia,31/08/2006,13,0,0,0,0,1,0,14
Syria,01/08/2006,46,0,0,0,8,3,0,57
Syria,02/08/2006,84,0,0,0,9,2,0,95
Syria,03/08/2006,43,0,0,0,0,1,0,44
Syria,04/08/2006,58,0,0,0,3,10,0,71
Syria,05/08/2006,60,0,0,0,0,2,0,62
Syria,06/08/2006,95,0,5,0,2,2,0,104
Syria,07/08/2006,58,0,3,0,3,7,0,71
Syria,08/08/2006,23,0,1,0,0,0,0,24
Syria,09/08/2006,16,0,0,0,7,3,0,26
Syria,10/08/2006,27,0,0,0,4,1,0,32
Syria,11/08/2006,65,0,0,0,4,0,0,69
Syria,12/08/2006,14,0,0,0,6,0,0,20
Syria,13/08/2006,13,0,0,0,39,1,0,53
Syria,14/08/2006,45,8,1,0,0,2,0,56
Syria,15/08/2006,12,0,0,0,3,2,0,17
Syria,16/08/2006,14,0,3,0,3,3,0,23
Syria,17/08/2006,12,0,0,0,14,0,0,26
Syria,18/08/2006,20,0,0,0,-2,0,0,18
Syria,19/08/2006,54,0,0,0,0,0,0,54
Syria,20/08/2006,62,0,1,0,0,0,0,63
Syria,21/08/2006,33,0,0,0,3,2,0,38
Syria,22/08/2006,24,0,0,0,9,9,0,42
Syria,23/08/2006,40,0,0,0,25,6,0,71
Syria,24/08/2006,43,0,0,0,34,8,0,85
Syria,25/08/2006,32,0,0,0,13,5,0,50
Syria,26/08/2006,13,0,0,0,6,1,0,20
Syria,27/08/2006,15,0,0,0,6,2,0,23
Syria,28/08/2006,5,0,0,0,6,5,0,16
Syria,29/08/2006,9,0,0,0,17,3,0,29
Syria,30/08/2006,-4,0,0,0,-5,4,0,-5
Syria,31/08/2006,24,0,0,0,18,3,0,45
Yemen,01/08/2006,0,0,0,0,0,0,0,0
Yemen,02/08/2006,5,0,0,0,0,0,0,5
Yemen,03/08/2006,5,0,0,0,0,0,0,5
Yemen,04/08/2006,8,0,0,0,0,0,0,8
Yemen,05/08/2006,4,0,0,0,0,0,0,4
Yemen,06/08/2006,0,0,0,0,0,0,0,0
Yemen,07/08/2006,7,0,0,0,0,0,0,7
Yemen,08/08/2006,0,0,0,0,0,0,0,0
Yemen,10/08/2006,2,0,0,0,0,0,0,2
Yemen,11/08/2006,0,0,0,0,0,0,0,0
Yemen,12/08/2006,-1,0,0,0,0,0,0,-1
Yemen,13/08/2006,0,0,0,0,0,0,0,0
Yemen,14/08/2006,0,0,0,0,0,0,0,0
Yemen,15/08/2006,0,0,0,0,0,0,0,0
Yemen,17/08/2006,3,0,0,0,3,0,0,6
Yemen,18/08/2006,0,0,0,0,0,0,0,0
Yemen,19/08/2006,-3,0,0,0,0,0,0,-3
Yemen,20/08/2006,0,0,0,0,3,0,0,3
Yemen,21/08/2006,24,0,0,0,0,0,0,24
Yemen,22/08/2006,0,0,0,0,0,0,0,0
Yemen,23/08/2006,0,0,0,0,0,0,0,0
Yemen,24/08/2006,0,0,0,0,0,0,0,0
Yemen,25/08/2006,0,0,0,0,0,0,0,0
Yemen,26/08/2006,0,0,0,0,0,0,0,0
Yemen,28/08/2006,0,0,0,0,0,0,0,0
Yemen,29/08/2006,0,0,0,0,0,0,0,0
Yemen,30/08/2006,0,0,0,0,3,0,0,3
Yemen,31/08/2006,0,0,0,0,0,0,0,0
Afghanistan,01/12/2011,181,8,0,0,31,20,0,240
Afghanistan,02/12/2011,254,0,-2,0,-10,18,0,260
Afghanistan,03/12/2011,160,4,0,0,35,39,0,238
Afghanistan,04/12/2011,253,4,0,0,15,19,0,291
Afghanistan,05/12/2011,223,12,-1,0,11,13,0,258
Afghanistan,06/12/2011,174,2,-1,0,44,21,0,240
Afghanistan,07/12/2011,141,12,-2,0,8,11,0,170
Afghanistan,08/12/2011,166,0,1,0,25,15,0,207
Afghanistan,09/12/2011,134,0,1,0,45,22,0,202
Afghanistan,10/12/2011,78,0,0,0,46,12,0,136
Afghanistan,11/12/2011,101,4,0,0,2,3,0,110
Afghanistan,12/12/2011,136,0,-3,0,49,3,0,185
Afghanistan,13/12/2011,115,2,0,0,49,12,0,178
Afghanistan,14/12/2011,99,2,-1,0,25,18,0,143
Afghanistan,15/12/2011,119,0,0,0,4,12,0,135
Afghanistan,16/12/2011,131,4,14,0,58,23,0,230
Afghanistan,17/12/2011,127,0,3,0,16,2,0,148
Afghanistan,18/12/2011,174,4,0,0,20,6,0,204
Afghanistan,19/12/2011,88,16,4,0,-2,12,0,118
Afghanistan,20/12/2011,60,10,0,0,13,8,0,91
Afghanistan,21/12/2011,206,0,-2,0,49,24,0,277
Afghanistan,22/12/2011,116,0,-8,0,8,10,0,126
Afghanistan,23/12/2011,156,0,0,0,26,5,0,187
Afghanistan,24/12/2011,80,0,0,0,8,6,0,94
Afghanistan,25/12/2011,115,0,2,0,10,11,0,138
Afghanistan,26/12/2011,136,4,2,0,25,7,0,174
Afghanistan,27/12/2011,170,0,0,0,27,11,0,208
Afghanistan,28/12/2011,197,2,0,0,5,22,0,226
Afghanistan,29/12/2011,129,0,-2,0,1,10,0,138
Afghanistan,30/12/2011,201,0,0,0,24,31,0,256
Afghanistan,31/12/2011,91,4,-1,0,33,5,0,132
Albania,01/12/2011,10,0,0,0,6,2,0,18
Albania,02/12/2011,0,0,0,0,5,6,0,11
Albania,03/12/2011,3,0,0,0,0,0,0,3
Albania,05/12/2011,6,0,0,0,6,1,0,13
Albania,06/12/2011,5,0,-1,0,9,0,0,13
Albania,07/12/2011,24,0,0,0,9,0,0,33
Albania,08/12/2011,23,0,0,0,3,0,0,26
Albania,09/12/2011,-1,0,0,0,0,0,0,-1
Albania,10/12/2011,0,0,0,0,0,0,0,0
Albania,11/12/2011,0,0,0,0,0,3,0,3
Albania,12/12/2011,1,0,1,0,0,0,0,2
Albania,13/12/2011,22,0,-2,0,0,1,0,21
Albania,14/12/2011,30,0,-1,0,3,0,0,32
Albania,15/12/2011,8,0,2,0,21,0,0,31
Albania,16/12/2011,2,0,-1,0,0,2,0,3
Albania,17/12/2011,8,0,0,0,0,0,0,8
Albania,18/12/2011,0,0,0,0,0,0,0,0
Albania,19/12/2011,26,0,-2,0,3,0,0,27
Albania,20/12/2011,8,0,0,0,2,0,0,10
Albania,21/12/2011,14,0,0,0,3,0,0,17
Albania,22/12/2011,-1,0,0,0,0,0,0,-1
Albania,23/12/2011,2,0,0,0,0,0,0,2
Albania,24/12/2011,0,0,0,0,0,0,0,0
Albania,25/12/2011,7,0,0,0,0,0,0,7
Albania,26/12/2011,2,0,0,0,6,0,0,8
Albania,27/12/2011,-1,0,0,0,-2,0,0,-3
Albania,28/12/2011,7,0,0,0,3,0,0,10
Albania,29/12/2011,3,0,-3,0,0,1,0,1
Albania,30/12/2011,4,0,0,0,0,0,0,4
Algeria,01/12/2011,10,0,0,0,16,0,0,26
Algeria,02/12/2011,5,0,0,0,6,3,0,14
Algeria,03/12/2011,5,0,0,0,0,0,0,5
Algeria,04/12/2011,4,0,0,0,-2,0,0,2
Algeria,05/12/2011,4,0,0,0,16,0,0,20
Algeria,06/12/2011,8,0,0,0,6,6,0,20
Algeria,07/12/2011,8,0,0,0,12,0,0,20
Algeria,08/12/2011,12,0,0,0,0,4,0,16
Algeria,09/12/2011,7,0,0,0,3,2,0,12
Algeria,10/12/2011,10,0,0,0,0,2,0,12
Algeria,11/12/2011,4,0,0,0,3,0,0,7
Algeria,12/12/2011,0,0,0,0,10,0,0,10
Algeria,13/12/2011,14,0,-1,0,4,3,0,20
Algeria,14/12/2011,13,0,0,0,23,2,0,38
Algeria,15/12/2011,7,0,0,0,27,10,0,44
Algeria,16/12/2011,29,0,1,0,3,0,0,33
Algeria,17/12/2011,44,0,1,0,7,4,0,56
Algeria,18/12/2011,30,0,1,0,-4,0,0,27
Algeria,19/12/2011,-1,0,0,0,0,0,0,-1
Algeria,20/12/2011,8,0,1,0,0,1,0,10
Algeria,21/12/2011,50,0,0,0,7,0,0,57
Algeria,22/12/2011,46,0,0,0,3,3,0,52
Algeria,23/12/2011,61,0,0,0,15,8,0,84
Algeria,24/12/2011,16,0,0,0,0,0,0,16
Algeria,25/12/2011,17,0,0,0,0,0,0,17
Algeria,26/12/2011,16,0,0,0,-3,0,0,13
Algeria,27/12/2011,1,0,0,0,-3,0,0,-2
Algeria,28/12/2011,8,0,0,0,0,4,0,12
Algeria,29/12/2011,10,0,0,0,0,0,0,10
Algeria,30/12/2011,6,0,0,0,9,3,0,18
Algeria,31/12/2011,10,0,-2,0,0,4,0,12
Bangladesh,01/12/2011,4,0,0,0,6,0,0,10
Bangladesh,02/12/2011,13,0,0,0,1,1,0,15
Bangladesh,03/12/2011,14,0,0,0,-4,0,0,10
Bangladesh,04/12/2011,15,0,0,0,13,1,0,29
Bangladesh,05/12/2011,1,0,0,0,0,0,0,1
Bangladesh,06/12/2011,14,0,-2,0,1,14,0,27
Bangladesh,07/12/2011,7,0,0,0,4,5,0,16
Bangladesh,08/12/2011,13,0,-1,0,4,0,0,16
Bangladesh,09/12/2011,7,0,0,0,-3,2,0,6
Bangladesh,10/12/2011,17,0,-2,0,-6,2,0,11
Bangladesh,11/12/2011,11,0,-2,0,4,0,0,13
Bangladesh,12/12/2011,3,0,-2,0,0,0,0,1
Bangladesh,13/12/2011,10,0,0,0,6,0,0,16
Bangladesh,14/12/2011,5,0,0,0,3,4,0,12
Bangladesh,15/12/2011,23,0,0,0,5,1,0,29
Bangladesh,16/12/2011,24,0,2,0,15,3,0,44
Bangladesh,17/12/2011,19,0,-2,0,3,0,0,20
Bangladesh,18/12/2011,10,0,1,0,12,0,0,23
Bangladesh,19/12/2011,6,2,0,0,0,1,0,9
Bangladesh,20/12/2011,5,0,0,0,5,3,0,13
Bangladesh,21/12/2011,6,0,0,0,4,-2,0,8
Bangladesh,22/12/2011,6,0,0,0,-2,1,0,5
Bangladesh,23/12/2011,7,0,0,0,3,0,0,10
Bangladesh,24/12/2011,21,0,0,0,-1,0,0,20
Bangladesh,25/12/2011,2,0,0,0,4,1,0,7
Bangladesh,26/12/2011,8,2,0,0,0,0,0,10
Bangladesh,27/12/2011,22,0,1,0,16,1,0,40
Bangladesh,28/12/2011,20,0,0,0,9,1,0,30
Bangladesh,29/12/2011,18,0,-4,0,6,0,0,20
Bangladesh,30/12/2011,2,0,0,0,0,0,0,2
Bangladesh,31/12/2011,13,0,0,0,3,2,0,18
Cameroon,01/12/2011,0,0,0,0,0,2,0,2
Cameroon,02/12/2011,0,0,-6,0,0,0,0,-6
Cameroon,03/12/2011,0,0,0,0,0,0,0,0
Cameroon,04/12/2011,0,2,0,0,0,0,0,2
Cameroon,05/12/2011,0,0,-2,0,0,0,0,-2
Cameroon,06/12/2011,2,0,0,0,0,0,0,2
Cameroon,07/12/2011,0,0,0,0,0,4,0,4
Cameroon,08/12/2011,2,0,0,0,3,0,0,5
Cameroon,09/12/2011,1,0,0,0,0,0,0,1
Cameroon,10/12/2011,0,0,0,0,0,0,0,0
Cameroon,12/12/2011,1,0,0,0,0,0,0,1
Cameroon,13/12/2011,0,0,0,0,0,0,0,0
Cameroon,14/12/2011,0,0,0,0,3,0,0,3
Cameroon,15/12/2011,0,0,0,0,0,0,0,0
Cameroon,16/12/2011,3,2,0,0,0,0,0,5
Cameroon,17/12/2011,0,0,0,0,0,0,0,0
Cameroon,18/12/2011,3,0,0,0,0,0,0,3
Cameroon,19/12/2011,15,0,0,0,0,0,0,15
Cameroon,20/12/2011,-3,0,0,0,0,2,0,-1
Cameroon,21/12/2011,0,0,0,0,1,0,0,1
Cameroon,22/12/2011,0,0,0,0,-2,0,0,-2
Cameroon,23/12/2011,0,0,0,0,0,0,0,0
Cameroon,24/12/2011,0,0,0,0,0,0,0,0
Cameroon,25/12/2011,0,0,0,0,0,0,0,0
Cameroon,27/12/2011,-1,0,0,0,0,0,0,-1
Cameroon,28/12/2011,0,0,0,0,-2,0,0,-2
Cameroon,29/12/2011,0,0,0,0,0,0,0,0
Cameroon,30/12/2011,0,0,0,0,0,0,0,0
China,01/12/2011,155,3,2,0,54,17,0,231
China,02/12/2011,139,0,4,0,63,16,0,222
China,03/12/2011,125,0,2,0,35,20,0,182
China,04/12/2011,68,6,5,0,39,11,0,129
China,05/12/2011,68,4,-9,0,37,4,0,104
China,06/12/2011,150,0,-3,0,79,17,0,243
China,07/12/2011,118,10,1,0,88,11,0,228
China,08/12/2011,144,0,0,0,160,8,0,312
China,09/12/2011,102,0,1,0,88,28,0,219
China,10/12/2011,84,2,1,0,57,13,0,157
China,11/12/2011,61,0,-2,0,50,4,0,113
China,12/12/2011,146,2,1,0,100,26,0,275
China,13/12/2011,186,2,-4,0,72,10,0,266
China,14/12/2011,115,0,1,0,38,20,0,174
China,15/12/2011,91,0,0,0,116,13,0,220
China,16/12/2011,147,0,-1,0,82,13,0,241
China,17/12/2011,57,0,2,0,37,7,0,103
China,18/12/2011,67,0,2,0,22,1,0,92
China,19/12/2011,84,2,0,0,30,18,0,134
China,20/12/2011,100,4,-2,0,82,12,0,196
China,21/12/2011,172,0,2,0,88,16,0,278
China,22/12/2011,66,4,1,0,29,12,0,112
China,23/12/2011,78,0,2,0,54,16,0,150
China,24/12/2011,46,2,1,0,26,5,0,80
China,25/12/2011,97,2,-1,0,44,1,0,143
China,26/12/2011,43,0,-1,0,27,13,0,82
China,27/12/2011,82,0,-4,0,99,21,0,198
China,28/12/2011,80,2,1,0,41,23,0,147
China,29/12/2011,114,2,2,0,57,19,0,194
China,30/12/2011,44,0,3,0,117,21,0,185
China,31/12/2011,57,2,2,0,15,18,0,94
Egypt,01/12/2011,75,0,-5,0,19,8,0,97
Egypt,02/12/2011,44,0,-2,0,2,26,0,70
Egypt,03/12/2011,90,0,1,0,12,22,0,125
Egypt,04/12/2011,93,0,-12,0,5,11,0,97
Egypt,05/12/2011,26,2,0,0,4,7,0,39
Egypt,06/12/2011,95,0,-14,0,-14,12,0,79
Egypt,07/12/2011,122,0,-12,0,20,27,0,157
Egypt,08/12/2011,177,0,-1,0,20,18,0,214
Egypt,09/12/2011,110,0,-2,0,21,11,0,140
Egypt,10/12/2011,51,0,0,0,-12,7,0,46
Egypt,11/12/2011,53,2,-4,0,-2,5,0,54
Egypt,12/12/2011,55,0,0,0,4,12,0,71
Egypt,13/12/2011,26,0,0,0,23,23,0,72
Egypt,14/12/2011,40,0,0,0,37,10,0,87
Egypt,15/12/2011,28,4,-7,0,71,18,0,114
Egypt,16/12/2011,85,2,-2,0,64,41,0,190
Egypt,17/12/2011,115,2,-9,0,32,54,0,194
Egypt,18/12/2011,89,0,-8,0,-5,14,0,90
Egypt,19/12/2011,107,0,-2,0,-3,25,0,127
Egypt,20/12/2011,113,0,-6,0,30,28,0,165
Egypt,21/12/2011,47,0,-12,0,26,14,0,75
Egypt,22/12/2011,50,4,-2,0,9,11,0,72
Egypt,23/12/2011,53,2,-2,0,21,15,0,89
Egypt,24/12/2011,19,0,-2,0,0,13,0,30
Egypt,25/12/2011,85,0,2,0,-9,17,0,95
Egypt,26/12/2011,69,0,7,0,12,33,0,121
Egypt,27/12/2011,92,2,3,0,44,28,0,169
Egypt,28/12/2011,86,0,6,0,43,28,0,163
Egypt,29/12/2011,209,0,0,0,10,8,0,227
Egypt,30/12/2011,198,0,-2,0,30,14,0,240
Egypt,31/12/2011,302,2,-8,0,61,41,0,398
Eritrea,01/12/2011,35,0,0,0,0,0,0,35
Eritrea,02/12/2011,11,0,0,0,3,0,0,14
Eritrea,03/12/2011,-2,0,0,0,12,0,0,10
Eritrea,04/12/2011,0,0,0,0,0,1,0,1
Eritrea,05/12/2011,1,0,0,0,0,0,0,1
Eritrea,06/12/2011,13,0,0,0,6,0,0,19
Eritrea,07/12/2011,1,0,0,0,15,0,0,16
Eritrea,08/12/2011,2,0,0,0,31,0,0,33
Eritrea,09/12/2011,0,0,0,0,7,0,0,7
Eritrea,10/12/2011,6,0,0,0,3,0,0,9
Eritrea,11/12/2011,21,0,0,0,0,0,0,21
Eritrea,12/12/2011,8,0,0,0,0,0,0,8
Eritrea,13/12/2011,0,0,0,0,16,0,0,16
Eritrea,14/12/2011,0,0,0,0,0,0,0,0
Eritrea,16/12/2011,4,0,0,0,0,0,0,4
Eritrea,17/12/2011,0,0,0,0,0,0,0,0
Eritrea,18/12/2011,0,0,0,0,9,0,0,9
Eritrea,19/12/2011,2,0,0,0,0,0,0,2
Eritrea,20/12/2011,3,0,0,0,0,0,0,3
Eritrea,21/12/2011,0,0,0,0,0,0,0,0
Eritrea,22/12/2011,9,0,0,0,-2,0,0,7
Eritrea,23/12/2011,9,0,0,0,3,0,0,12
Eritrea,24/12/2011,3,0,0,0,-6,1,0,-2
Eritrea,25/12/2011,0,0,0,0,0,0,0,0
Eritrea,26/12/2011,9,0,0,0,0,0,0,9
Eritrea,27/12/2011,2,0,0,0,0,0,0,2
Eritrea,28/12/2011,0,0,0,0,0,0,0,0
Eritrea,29/12/2011,0,0,0,0,0,0,0,0
Georgia,01/12/2011,17,0,-4,0,9,1,0,23
Georgia,02/12/2011,17,0,0,0,25,5,0,47
Georgia,03/12/2011,7,0,0,0,21,3,0,31
Georgia,04/12/2011,4,0,0,0,9,1,0,14
Georgia,05/12/2011,7,0,2,0,18,4,0,31
Georgia,06/12/2011,34,0,8,0,8,14,0,64
Georgia,07/12/2011,27,0,-2,0,37,6,0,68
Georgia,08/12/2011,20,2,-1,0,54,2,0,77
Georgia,09/12/2011,26,0,0,0,5,3,0,34
Georgia,10/12/2011,8,0,0,0,36,1,0,45
Georgia,11/12/2011,0,0,0,0,0,0,0,0
Georgia,12/12/2011,14,4,0,0,17,10,0,45
Georgia,13/12/2011,25,0,0,0,14,7,0,46
Georgia,14/12/2011,7,0,0,0,7,6,0,20
Georgia,15/12/2011,6,0,0,0,0,0,0,6
Georgia,16/12/2011,13,0,0,0,6,0,0,19
Georgia,17/12/2011,16,0,0,0,1,0,0,17
Georgia,18/12/2011,16,0,0,0,3,1,0,20
Georgia,19/12/2011,15,0,5,0,0,1,0,21
Georgia,20/12/2011,32,0,3,0,9,3,0,47
Georgia,21/12/2011,3,0,-2,0,3,4,0,8
Georgia,22/12/2011,7,0,0,0,2,0,0,9
Georgia,23/12/2011,19,0,0,0,11,4,0,34
Georgia,24/12/2011,6,0,0,0,3,0,0,9
Georgia,25/12/2011,9,0,0,0,0,0,0,9
Georgia,26/12/2011,42,0,0,0,0,2,0,44
Georgia,27/12/2011,16,0,-1,0,-8,0,0,7
Georgia,28/12/2011,38,4,0,0,6,4,0,52
Georgia,29/12/2011,6,0,0,0,6,4,0,16
Georgia,30/12/2011,23,0,0,0,9,0,0,32
Georgia,31/12/2011,7,0,0,0,3,1,0,11
India,01/12/2011,47,0,-1,0,19,8,0,73
India,02/12/2011,40,0,0,0,18,13,0,71
India,03/12/2011,30,0,-2,0,0,3,0,31
India,04/12/2011,67,4,-4,0,29,4,0,100
India,05/12/2011,52,0,-6,0,15,2,0,63
India,06/12/2011,55,0,0,0,13,3,0,71
India,07/12/2011,72,0,1,0,22,6,0,101
India,08/12/2011,30,0,0,0,7,1,0,38
India,09/12/2011,57,0,0,0,16,15,0,88
India,10/12/2011,44,0,1,0,3,8,0,56
India,11/12/2011,30,0,0,0,6,8,0,44
India,12/12/2011,29,0,-2,0,-4,2,0,25
India,13/12/2011,24,2,0,0,-3,3,0,26
India,14/12/2011,25,0,-2,0,-1,1,0,23
India,15/12/2011,41,2,0,0,7,7,0,57
India,16/12/2011,35,0,0,0,9,1,0,45
India,17/12/2011,18,0,-1,0,18,2,0,37
India,18/12/2011,43,0,1,0,0,1,0,45
India,19/12/2011,26,0,0,0,24,6,0,56
India,20/12/2011,15,0,0,0,42,9,0,66
India,21/12/2011,29,2,0,0,12,7,0,50
India,22/12/2011,48,0,-2,0,17,3,0,66
India,23/12/2011,25,0,0,0,4,7,0,36
India,24/12/2011,38,0,1,0,4,7,0,50
India,25/12/2011,41,0,-20,0,17,15,0,53
India,26/12/2011,41,0,-6,0,2,0,0,37
India,27/12/2011,36,0,1,0,40,2,0,79
India,28/12/2011,63,0,1,0,23,7,0,94
India,29/12/2011,33,0,0,0,13,12,0,58
India,30/12/2011,39,0,-6,0,7,6,0,46
India,31/12/2011,47,0,0,0,30,1,0,78
Iran,01/12/2011,75,0,-4,0,25,4,0,100
Iran,02/12/2011,108,0,-6,0,18,6,0,126
Iran,03/12/2011,55,0,-4,0,16,10,0,77
Iran,04/12/2011,140,2,-2,0,13,-2,0,151
Iran,05/12/2011,114,0,0,0,29,5,0,148
Iran,06/12/2011,96,0,0,0,27,3,0,126
Iran,07/12/2011,72,0,3,0,37,9,0,121
Iran,08/12/2011,99,0,-2,0,56,11,0,164
Iran,09/12/2011,95,4,0,0,20,9,0,128
Iran,10/12/2011,76,4,0,0,26,5,0,111
Iran,11/12/2011,46,0,0,0,11,2,0,59
Iran,12/12/2011,68,0,-2,0,22,6,0,94
Iran,13/12/2011,97,0,-7,0,28,18,0,136
Iran,14/12/2011,92,8,-1,0,22,5,0,126
Iran,15/12/2011,78,2,1,0,51,4,0,136
Iran,16/12/2011,114,0,4,0,38,10,0,166
Iran,17/12/2011,82,6,0,0,54,5,0,147
Iran,18/12/2011,73,0,-2,0,32,1,0,104
Iran,19/12/2011,50,2,2,0,20,10,0,84
Iran,20/12/2011,73,0,-2,0,2,9,0,82
Iran,21/12/2011,99,2,7,0,29,11,0,148
Iran,22/12/2011,95,4,0,0,-13,6,0,92
Iran,23/12/2011,71,0,1,0,19,3,0,94
Iran,24/12/2011,69,0,4,0,38,5,0,116
Iran,25/12/2011,91,0,2,0,37,10,0,140
Iran,26/12/2011,415,2,9,0,180,88,0,694
Iran,27/12/2011,169,2,3,0,94,29,0,297
Iran,28/12/2011,102,0,4,0,53,11,0,170
Iran,29/12/2011,142,2,0,0,72,7,0,223
Iran,30/12/2011,77,0,-6,0,14,23,0,108
Iran,31/12/2011,102,0,3,0,3,6,0,114
Iraq,01/12/2011,75,12,0,0,6,10,0,103
Iraq,02/12/2011,22,2,0,0,4,2,0,30
Iraq,03/12/2011,44,0,-3,0,1,3,0,45
Iraq,04/12/2011,60,0,0,0,-1,3,0,62
Iraq,05/12/2011,93,0,1,0,20,10,0,124
Iraq,06/12/2011,100,0,0,0,21,12,0,133
Iraq,07/12/2011,56,0,0,0,30,15,0,101
Iraq,08/12/2011,58,0,-2,0,0,2,0,58
Iraq,09/12/2011,75,0,0,0,59,5,0,139
Iraq,10/12/2011,63,0,0,0,36,7,0,106
Iraq,11/12/2011,36,2,0,0,0,2,0,40
Iraq,12/12/2011,79,0,-12,0,37,5,0,109
Iraq,13/12/2011,64,4,-7,0,28,9,0,98
Iraq,14/12/2011,92,2,0,0,8,6,0,108
Iraq,15/12/2011,84,2,2,0,15,5,0,108
Iraq,16/12/2011,654,8,-11,0,434,129,0,1214
Iraq,17/12/2011,154,4,-3,0,69,16,0,240
Iraq,18/12/2011,152,4,0,0,53,9,0,218
Iraq,19/12/2011,164,6,4,0,112,37,0,323
Iraq,20/12/2011,112,0,2,0,102,9,0,225
Iraq,21/12/2011,98,0,5,0,39,14,0,156
Iraq,22/12/2011,73,0,-2,0,43,11,0,125
Iraq,23/12/2011,58,0,3,0,24,9,0,94
Iraq,24/12/2011,93,2,-1,0,15,6,0,115
Iraq,25/12/2011,88,4,-1,0,3,17,0,111
Iraq,26/12/2011,99,2,1,0,5,33,0,140
Iraq,27/12/2011,116,0,7,0,9,16,0,148
Iraq,28/12/2011,86,6,6,0,21,6,0,125
Iraq,29/12/2011,278,0,-8,0,0,31,0,301
Iraq,30/12/2011,178,0,1,0,101,17,0,297
Iraq,31/12/2011,84,0,0,0,19,19,0,122
Morocco,01/12/2011,8,0,0,0,3,0,0,11
Morocco,02/12/2011,3,0,0,0,6,0,0,9
Morocco,03/12/2011,11,0,0,0,3,0,0,14
Morocco,04/12/2011,9,0,0,0,0,0,0,9
Morocco,05/12/2011,12,0,-2,0,9,1,0,20
Morocco,06/12/2011,13,0,0,0,2,3,0,18
Morocco,07/12/2011,11,0,0,0,-1,0,0,10
Morocco,08/12/2011,-7,0,0,0,6,0,0,-1
Morocco,09/12/2011,7,0,0,0,14,0,0,21
Morocco,10/12/2011,3,0,-1,0,3,0,0,5
Morocco,11/12/2011,5,0,0,0,0,0,0,5
Morocco,12/12/2011,2,0,0,0,0,0,0,2
Morocco,13/12/2011,5,0,0,0,0,0,0,5
Morocco,14/12/2011,8,0,-2,0,15,9,0,30
Morocco,15/12/2011,5,0,0,0,21,3,0,29
Morocco,16/12/2011,1,0,0,0,18,0,0,19
Morocco,17/12/2011,0,0,0,0,0,0,0,0
Morocco,18/12/2011,6,0,0,0,6,1,0,13
Morocco,19/12/2011,3,0,0,0,12,4,0,19
Morocco,20/12/2011,9,0,0,0,3,3,0,15
Morocco,21/12/2011,2,0,0,0,16,0,0,18
Morocco,22/12/2011,0,0,0,0,0,0,0,0
Morocco,23/12/2011,0,0,0,0,6,0,0,6
Morocco,24/12/2011,4,0,0,0,3,0,0,7
Morocco,25/12/2011,4,0,0,0,9,0,0,13
Morocco,26/12/2011,-6,0,0,0,3,0,0,-3
Morocco,27/12/2011,15,0,0,0,9,0,0,24
Morocco,28/12/2011,1,0,0,0,-2,0,0,-1
Morocco,29/12/2011,24,0,1,0,5,0,0,30
Morocco,30/12/2011,1,0,0,0,2,0,0,3
Morocco,31/12/2011,24,0,0,0,3,0,0,27
Nigeria,01/12/2011,25,0,-4,0,4,0,0,25
Nigeria,02/12/2011,31,2,0,0,3,1,0,37
Nigeria,03/12/2011,12,0,0,0,0,0,0,12
Nigeria,04/12/2011,31,0,0,0,0,2,0,33
Nigeria,05/12/2011,14,0,0,0,0,1,0,15
Nigeria,06/12/2011,31,0,1,0,11,3,0,46
Nigeria,07/12/2011,20,0,2,0,30,1,0,53
Nigeria,08/12/2011,9,0,2,0,15,1,0,27
Nigeria,09/12/2011,10,0,1,0,28,0,0,39
Nigeria,10/12/2011,5,0,0,0,0,4,0,9
Nigeria,11/12/2011,6,0,0,0,0,2,0,8
Nigeria,12/12/2011,16,0,0,0,12,0,0,28
Nigeria,13/12/2011,48,0,0,0,17,1,0,66
Nigeria,14/12/2011,9,0,0,0,22,1,0,32
Nigeria,15/12/2011,11,2,0,0,0,4,0,17
Nigeria,16/12/2011,19,0,-2,0,6,1,0,24
Nigeria,17/12/2011,16,0,0,0,6,3,0,25
Nigeria,18/12/2011,11,0,-1,0,-1,0,0,9
Nigeria,19/12/2011,40,0,1,0,1,4,0,46
Nigeria,20/12/2011,23,0,0,0,9,7,0,39
Nigeria,21/12/2011,16,0,0,0,-2,2,0,16
Nigeria,22/12/2011,21,0,0,0,7,4,0,32
Nigeria,23/12/2011,18,0,0,0,6,4,0,28
Nigeria,24/12/2011,17,0,0,0,-1,2,0,18
Nigeria,25/12/2011,92,0,0,0,8,13,0,113
Nigeria,26/12/2011,47,0,2,0,30,4,0,83
Nigeria,27/12/2011,27,0,1,0,18,2,0,48
Nigeria,28/12/2011,46,0,1,0,9,18,0,74
Nigeria,29/12/2011,22,0,-2,0,7,1,0,28
Nigeria,30/12/2011,8,0,0,0,14,2,0,24
Nigeria,31/12/2011,49,0,0,0,12,2,0,63
Pakistan,01/12/2011,83,0,-1,0,87,5,0,174
Pakistan,02/12/2011,164,0,0,0,104,36,0,304
Pakistan,03/12/2011,153,0,-2,0,50,11,0,212
Pakistan,04/12/2011,119,0,0,0,33,4,0,156
Pakistan,05/12/2011,142,0,0,0,-7,9,0,144
Pakistan,06/12/2011,175,2,0,0,25,18,0,220
Pakistan,07/12/2011,177,4,-10,0,40,17,0,228
Pakistan,08/12/2011,157,4,-2,0,39,21,0,219
Pakistan,09/12/2011,101,0,-2,0,63,12,0,174
Pakistan,10/12/2011,97,0,-3,0,26,11,0,131
Pakistan,11/12/2011,75,0,1,0,9,9,0,94
Pakistan,12/12/2011,86,0,1,0,37,1,0,125
Pakistan,13/12/2011,108,0,2,0,35,4,0,149
Pakistan,14/12/2011,101,0,-4,0,36,0,0,133
Pakistan,15/12/2011,37,0,1,0,-6,10,0,42
Pakistan,16/12/2011,46,4,1,0,9,7,0,67
Pakistan,17/12/2011,43,4,1,0,17,9,0,74
Pakistan,18/12/2011,68,0,1,0,21,4,0,94
Pakistan,19/12/2011,69,8,-1,0,36,3,0,115
Pakistan,20/12/2011,78,4,-1,0,44,7,0,132
Pakistan,21/12/2011,67,0,0,0,21,3,0,91
Pakistan,22/12/2011,92,0,-1,0,9,8,0,108
Pakistan,23/12/2011,144,0,-7,0,12,8,0,157
Pakistan,24/12/2011,93,0,-6,0,8,10,0,105
Pakistan,25/12/2011,56,0,-2,0,25,20,0,99
Pakistan,26/12/2011,92,0,-4,0,19,4,0,111
Pakistan,27/12/2011,87,0,-2,0,11,1,0,97
Pakistan,28/12/2011,97,0,1,0,11,8,0,117
Pakistan,29/12/2011,52,0,-3,0,10,8,0,67
Pakistan,30/12/2011,93,0,-2,0,12,24,0,127
Pakistan,31/12/2011,66,0,2,0,26,14,0,108
Sierra Leone,01/12/2011,0,0,0,0,6,0,0,6
Sierra Leone,02/12/2011,11,0,0,0,0,1,0,12
Sierra Leone,03/12/2011,0,0,0,0,0,1,0,1
Sierra Leone,04/12/2011,0,0,0,0,0,0,0,0
Sierra Leone,05/12/2011,-4,0,0,0,0,1,0,-3
Sierra Leone,06/12/2011,7,0,-6,0,3,1,0,5
Sierra Leone,07/12/2011,0,0,0,0,0,0,0,0
Sierra Leone,08/12/2011,1,0,0,0,3,0,0,4
Sierra Leone,09/12/2011,8,0,0,0,3,0,0,11
Sierra Leone,10/12/2011,2,0,0,0,0,0,0,2
Sierra Leone,11/12/2011,0,0,0,0,0,0,0,0
Sierra Leone,12/12/2011,2,0,0,0,0,0,0,2
Sierra Leone,13/12/2011,-2,0,0,0,9,0,0,7
Sierra Leone,14/12/2011,8,0,0,0,0,2,0,10
Sierra Leone,15/12/2011,2,2,0,0,0,0,0,4
Sierra Leone,16/12/2011,1,0,0,0,6,0,0,7
Sierra Leone,17/12/2011,0,0,0,0,0,0,0,0
Sierra Leone,18/12/2011,0,0,0,0,3,0,0,3
Sierra Leone,19/12/2011,2,0,0,0,0,0,0,2
Sierra Leone,20/12/2011,7,0,0,0,0,3,0,10
Sierra Leone,21/12/2011,0,0,0,0,0,0,0,0
Sierra Leone,22/12/2011,7,0,0,0,3,0,0,10
Sierra Leone,23/12/2011,-1,0,0,0,0,0,0,-1
Sierra Leone,24/12/2011,0,0,0,0,6,0,0,6
Sierra Leone,25/12/2011,4,0,0,0,0,0,0,4
Sierra Leone,26/12/2011,0,0,0,0,0,0,0,0
Sierra Leone,27/12/2011,2,0,0,0,0,0,0,2
Sierra Leone,28/12/2011,0,0,0,0,3,2,0,5
Sierra Leone,30/12/2011,3,0,0,0,0,0,0,3
Somalia,01/12/2011,46,0,0,0,77,0,0,123
Somalia,02/12/2011,27,0,0,0,31,0,0,58
Somalia,03/12/2011,16,0,0,0,21,0,0,37
Somalia,04/12/2011,11,0,0,0,6,1,0,18
Somalia,05/12/2011,37,0,2,0,0,0,0,39
Somalia,06/12/2011,60,2,-3,0,30,9,0,98
Somalia,07/12/2011,29,0,0,0,22,0,0,51
Somalia,08/12/2011,15,0,0,0,-7,1,0,9
Somalia,09/12/2011,17,0,0,0,6,0,0,23
Somalia,10/12/2011,4,0,-4,0,18,0,0,18
Somalia,11/12/2011,23,0,0,0,13,0,0,36
Somalia,12/12/2011,25,0,0,0,15,3,0,43
Somalia,13/12/2011,25,0,0,0,15,0,0,40
Somalia,14/12/2011,48,0,0,0,15,0,0,63
Somalia,15/12/2011,18,0,0,0,39,0,0,57
Somalia,16/12/2011,38,0,0,0,17,7,0,62
Somalia,17/12/2011,-2,0,0,0,9,3,0,10
Somalia,18/12/2011,32,2,0,0,6,10,0,50
Somalia,19/12/2011,41,0,0,0,21,5,0,67
Somalia,20/12/2011,15,0,0,0,4,0,0,19
Somalia,21/12/2011,74,0,0,0,18,5,0,97
Somalia,22/12/2011,68,2,0,0,13,1,0,84
Somalia,23/12/2011,37,0,2,0,27,4,0,70
Somalia,24/12/2011,85,0,0,0,9,8,0,102
Somalia,25/12/2011,106,0,0,0,16,1,0,123
Somalia,26/12/2011,36,0,0,0,-4,0,0,32
Somalia,27/12/2011,52,0,0,0,106,7,0,165
Somalia,28/12/2011,38,0,0,0,49,14,0,101
Somalia,29/12/2011,42,0,0,0,6,4,0,52
Somalia,30/12/2011,51,0,0,0,16,7,0,74
Somalia,31/12/2011,67,10,0,0,4,15,0,96
Syria,01/12/2011,142,0,1,0,52,14,0,209
Syria,02/12/2011,213,2,6,0,90,38,0,349
Syria,03/12/2011,105,0,0,0,37,11,0,153
Syria,04/12/2011,107,0,0,0,29,20,0,156
Syria,05/12/2011,83,0,0,0,63,11,0,157
Syria,06/12/2011,166,4,0,0,48,10,0,228
Syria,07/12/2011,203,0,-4,0,26,20,0,245
Syria,08/12/2011,203,2,2,0,49,33,0,289
Syria,09/12/2011,148,0,2,0,49,24,0,223
Syria,10/12/2011,127,0,2,0,-1,20,0,148
Syria,11/12/2011,159,0,0,0,6,19,0,184
Syria,12/12/2011,247,0,-20,0,13,29,0,269
Syria,13/12/2011,162,0,-21,0,31,14,0,186
Syria,14/12/2011,168,0,0,0,15,23,0,206
Syria,15/12/2011,247,0,3,0,37,14,0,301
Syria,16/12/2011,225,0,-6,0,59,23,0,301
Syria,17/12/2011,84,6,-2,0,6,18,0,112
Syria,18/12/2011,108,0,-2,0,10,14,0,130
Syria,19/12/2011,85,0,-2,0,-13,10,0,80
Syria,20/12/2011,98,0,-1,0,30,2,0,129
Syria,21/12/2011,144,6,0,0,29,14,0,193
Syria,22/12/2011,94,0,-8,0,30,22,0,138
Syria,23/12/2011,200,0,-3,0,26,15,0,238
Syria,24/12/2011,81,0,-6,0,10,17,0,102
Syria,25/12/2011,80,0,-2,0,15,9,0,102
Syria,26/12/2011,204,0,2,0,11,13,0,230
Syria,27/12/2011,132,0,1,0,68,24,0,225
Syria,28/12/2011,138,0,0,0,-1,30,0,167
Syria,29/12/2011,154,0,-4,0,20,13,0,183
Syria,30/12/2011,633,16,-15,0,189,355,0,1178
Syria,31/12/2011,329,2,-11,0,68,185,0,573
Yemen,01/12/2011,14,0,0,0,17,-3,0,28
Yemen,02/12/2011,18,0,-2,0,8,5,0,29
Yemen,03/12/2011,7,0,-2,0,6,2,0,13
Yemen,04/12/2011,24,0,0,0,3,0,0,27
Yemen,05/12/2011,0,0,0,0,5,0,0,5
Yemen,06/12/2011,9,0,0,0,-4,3,0,8
Yemen,07/12/2011,19,0,0,0,12,5,0,36
Yemen,08/12/2011,17,0,-6,0,10,7,0,28
Yemen,09/12/2011,38,0,0,0,-1,5,0,42
Yemen,10/12/2011,41,0,0,0,-15,3,0,29
Yemen,11/12/2011,11,0,0,0,0,1,0,12
Yemen,12/12/2011,23,0,0,0,21,8,0,52
Yemen,13/12/2011,8,0,-2,0,1,4,0,11
Yemen,14/12/2011,5,0,0,0,3,0,0,8
Yemen,15/12/2011,10,0,0,0,3,9,0,22
Yemen,16/12/2011,28,0,0,0,-4,4,0,28
Yemen,17/12/2011,8,0,0,0,0,3,0,11
Yemen,18/12/2011,14,10,0,0,10,1,0,35
Yemen,19/12/2011,18,4,0,0,-2,4,0,24
Yemen,20/12/2011,4,0,0,0,11,4,0,19
Yemen,21/12/2011,2,0,0,0,14,3,0,19
Yemen,22/12/2011,18,0,0,0,0,1,0,19
Yemen,23/12/2011,27,0,-6,0,1,0,0,22
Yemen,24/12/2011,41,0,1,0,9,8,0,59
Yemen,25/12/2011,27,0,-4,0,6,5,0,34
Yemen,26/12/2011,53,0,-2,0,19,26,0,96
Yemen,27/12/2011,49,0,0,0,29,15,0,93
Yemen,28/12/2011,16,0,0,0,-4,14,0,26
Yemen,29/12/2011,5,0,-2,0,-2,2,0,3
Yemen,30/12/2011,19,0,0,0,7,6,0,32
Yemen,31/12/2011,19,0,-10,0,-2,2,0,9
Afghanistan,01/06/2011,107,10,1,0,7,13,0,138
Afghanistan,02/06/2011,324,0,-2,0,35,23,0,380
Afghanistan,03/06/2011,435,4,0,0,29,14,0,482
Afghanistan,04/06/2011,298,0,-2,0,28,40,0,364
Afghanistan,05/06/2011,329,2,3,0,15,22,0,371
Afghanistan,06/06/2011,367,2,-2,0,-6,23,0,384
Afghanistan,07/06/2011,163,0,-8,0,49,22,0,226
Afghanistan,08/06/2011,200,2,-4,0,18,16,0,232
Afghanistan,09/06/2011,224,4,0,0,6,26,0,260
Afghanistan,10/06/2011,230,18,0,0,31,29,0,308
Afghanistan,11/06/2011,170,28,-2,0,15,12,0,223
Afghanistan,12/06/2011,79,4,0,0,-3,15,0,95
Afghanistan,13/06/2011,41,2,0,0,1,12,0,56
Afghanistan,14/06/2011,179,0,3,0,44,22,0,248
Afghanistan,15/06/2011,238,0,-5,0,-4,40,0,269
Afghanistan,16/06/2011,149,0,0,0,17,3,0,169
Afghanistan,17/06/2011,342,6,1,0,21,13,0,383
Afghanistan,18/06/2011,148,2,-2,0,25,4,0,177
Afghanistan,19/06/2011,176,0,0,0,2,35,0,213
Afghanistan,20/06/2011,254,2,-3,0,61,32,0,346
Afghanistan,21/06/2011,91,6,1,0,19,21,0,138
Afghanistan,22/06/2011,186,8,4,0,67,38,0,303
Afghanistan,23/06/2011,82,0,8,0,145,50,0,285
Afghanistan,24/06/2011,80,0,5,0,55,19,0,159
Afghanistan,25/06/2011,156,0,-2,0,28,41,0,223
Afghanistan,26/06/2011,162,6,4,0,40,19,0,231
Afghanistan,27/06/2011,627,12,-20,0,249,69,0,937
Afghanistan,28/06/2011,220,2,-9,0,33,24,0,270
Afghanistan,29/06/2011,233,0,-4,0,14,24,0,267
Afghanistan,30/06/2011,206,8,-3,0,29,11,0,251
Albania,01/06/2011,3,0,0,0,6,0,0,9
Albania,02/06/2011,18,0,0,0,6,1,0,25
Albania,03/06/2011,0,0,-2,0,0,1,0,-1
Albania,04/06/2011,1,0,0,0,0,3,0,4
Albania,05/06/2011,4,0,2,0,3,7,0,16
Albania,06/06/2011,14,0,-1,0,6,3,0,22
Albania,07/06/2011,3,0,0,0,0,0,0,3
Albania,08/06/2011,5,0,1,0,8,6,0,20
Albania,09/06/2011,0,0,2,0,6,0,0,8
Albania,10/06/2011,10,0,0,0,0,0,0,10
Albania,11/06/2011,8,0,0,0,3,0,0,11
Albania,12/06/2011,3,0,0,0,0,8,0,11
Albania,13/06/2011,2,0,-1,0,9,1,0,11
Albania,14/06/2011,13,0,-2,0,12,-1,0,22
Albania,15/06/2011,8,0,-1,0,4,4,0,15
Albania,16/06/2011,0,0,0,0,0,0,0,0
Albania,17/06/2011,2,0,0,0,0,0,0,2
Albania,18/06/2011,31,0,0,0,21,0,0,52
Albania,19/06/2011,2,0,0,0,0,0,0,2
Albania,20/06/2011,9,0,-1,0,0,0,0,8
Albania,21/06/2011,9,0,-1,0,6,0,0,14
Albania,22/06/2011,7,0,-4,0,0,14,0,17
Albania,23/06/2011,1,0,0,0,3,1,0,5
Albania,24/06/2011,9,0,0,0,-6,0,0,3
Albania,25/06/2011,0,0,0,0,0,0,0,0
Albania,26/06/2011,0,0,0,0,0,0,0,0
Albania,27/06/2011,4,0,-2,0,13,2,0,17
Albania,28/06/2011,17,0,0,0,13,8,0,38
Albania,29/06/2011,2,0,0,0,-1,2,0,3
Albania,30/06/2011,6,0,-1,0,9,1,0,15
Algeria,01/06/2011,-6,0,0,0,0,0,0,-6
Algeria,02/06/2011,2,0,0,0,0,0,0,2
Algeria,03/06/2011,9,0,0,0,10,0,0,19
Algeria,04/06/2011,2,0,0,0,0,0,0,2
Algeria,05/06/2011,10,0,0,0,0,0,0,10
Algeria,06/06/2011,11,0,0,0,3,6,0,20
Algeria,07/06/2011,3,0,0,0,-4,0,0,-1
Algeria,08/06/2011,-6,0,0,0,0,0,0,-6
Algeria,09/06/2011,18,0,0,0,2,0,0,20
Algeria,10/06/2011,2,0,0,0,-2,1,0,1
Algeria,11/06/2011,22,0,0,0,0,0,0,22
Algeria,12/06/2011,7,0,0,0,-7,2,0,2
Algeria,13/06/2011,24,0,2,0,-8,0,0,18
Algeria,14/06/2011,2,0,0,0,4,1,0,7
Algeria,15/06/2011,2,0,0,0,20,8,0,30
Algeria,16/06/2011,0,0,0,0,0,0,0,0
Algeria,17/06/2011,6,0,1,0,0,4,0,11
Algeria,18/06/2011,15,0,0,0,-4,0,0,11
Algeria,19/06/2011,0,0,0,0,9,0,0,9
Algeria,20/06/2011,12,0,0,0,15,0,0,27
Algeria,21/06/2011,5,0,0,0,11,2,0,18
Algeria,22/06/2011,-1,0,0,0,15,0,0,14
Algeria,23/06/2011,6,0,0,0,0,0,0,6
Algeria,24/06/2011,9,0,0,0,0,0,0,9
Algeria,25/06/2011,21,0,0,0,-2,0,0,19
Algeria,26/06/2011,15,0,0,0,12,0,0,27
Algeria,27/06/2011,6,0,0,0,18,2,0,26
Algeria,28/06/2011,0,0,0,0,6,1,0,7
Algeria,29/06/2011,1,0,0,0,0,0,0,1
Algeria,30/06/2011,26,0,0,0,3,0,0,29
Bangladesh,01/06/2011,12,0,0,0,12,0,0,24
Bangladesh,02/06/2011,20,0,0,0,10,4,0,34
Bangladesh,03/06/2011,11,0,0,0,6,9,0,26
Bangladesh,04/06/2011,35,0,0,0,3,-4,0,34
Bangladesh,05/06/2011,11,0,0,0,18,1,0,30
Bangladesh,06/06/2011,27,0,0,0,1,5,0,33
Bangladesh,07/06/2011,10,0,0,0,1,4,0,15
Bangladesh,08/06/2011,46,0,0,0,6,6,0,58
Bangladesh,09/06/2011,1,0,0,0,28,5,0,34
Bangladesh,10/06/2011,32,0,0,0,-3,4,0,33
Bangladesh,11/06/2011,24,0,-2,0,2,9,0,33
Bangladesh,12/06/2011,16,2,0,0,-2,2,0,18
Bangladesh,13/06/2011,29,0,0,0,0,1,0,30
Bangladesh,14/06/2011,18,0,0,0,21,2,0,41
Bangladesh,15/06/2011,20,0,0,0,18,0,0,38
Bangladesh,16/06/2011,2,0,-2,0,0,1,0,1
Bangladesh,17/06/2011,12,2,0,0,2,2,0,18
Bangladesh,18/06/2011,11,0,0,0,-2,0,0,9
Bangladesh,19/06/2011,8,0,0,0,3,3,0,14
Bangladesh,20/06/2011,11,0,0,0,10,3,0,24
Bangladesh,21/06/2011,13,0,0,0,24,1,0,38
Bangladesh,22/06/2011,50,0,0,0,-9,4,0,45
Bangladesh,23/06/2011,21,0,0,0,19,1,0,41
Bangladesh,24/06/2011,45,0,-6,0,14,4,0,57
Bangladesh,25/06/2011,20,0,0,0,0,2,0,22
Bangladesh,26/06/2011,4,0,1,0,15,1,0,21
Bangladesh,27/06/2011,10,0,0,0,18,0,0,28
Bangladesh,28/06/2011,32,0,-2,0,30,6,0,66
Bangladesh,29/06/2011,37,0,1,0,21,4,0,63
Bangladesh,30/06/2011,42,0,-5,0,37,9,0,83
Cameroon,01/06/2011,1,0,0,0,1,0,0,2
Cameroon,03/06/2011,0,0,0,0,0,0,0,0
Cameroon,04/06/2011,7,0,0,0,0,1,0,8
Cameroon,05/06/2011,2,0,0,0,0,1,0,3
Cameroon,06/06/2011,2,0,0,0,-6,0,0,-4
Cameroon,07/06/2011,0,0,-1,0,0,0,0,-1
Cameroon,08/06/2011,0,0,0,0,0,0,0,0
Cameroon,09/06/2011,2,0,0,0,3,0,0,5
Cameroon,10/06/2011,0,0,0,0,12,2,0,14
Cameroon,11/06/2011,0,0,0,0,12,0,0,12
Cameroon,12/06/2011,0,0,0,0,0,0,0,0
Cameroon,13/06/2011,0,0,0,0,0,0,0,0
Cameroon,14/06/2011,3,0,0,0,0,0,0,3
Cameroon,15/06/2011,9,0,0,0,0,0,0,9
Cameroon,16/06/2011,3,0,0,0,0,0,0,3
Cameroon,17/06/2011,0,0,1,0,5,0,0,6
Cameroon,18/06/2011,0,0,0,0,0,0,0,0
Cameroon,19/06/2011,4,0,0,0,0,0,0,4
Cameroon,20/06/2011,3,0,0,0,0,0,0,3
Cameroon,22/06/2011,10,0,0,0,0,0,0,10
Cameroon,23/06/2011,0,0,0,0,0,0,0,0
Cameroon,24/06/2011,1,0,0,0,0,0,0,1
Cameroon,25/06/2011,0,0,0,0,0,1,0,1
Cameroon,27/06/2011,18,0,0,0,0,0,0,18
Cameroon,28/06/2011,1,0,0,0,1,0,0,2
Cameroon,29/06/2011,1,0,-1,0,-2,2,0,0
Cameroon,30/06/2011,4,0,0,0,0,0,0,4
China,01/06/2011,69,0,-6,0,18,12,0,93
China,02/06/2011,91,2,4,0,53,25,0,175
China,03/06/2011,271,0,-3,0,60,24,0,352
China,04/06/2011,192,0,-4,0,21,27,0,236
China,05/06/2011,168,0,0,0,14,27,0,209
China,06/06/2011,137,2,-4,0,49,29,0,213
China,07/06/2011,137,6,3,0,46,17,0,209
China,08/06/2011,117,2,-5,0,58,24,0,196
China,09/06/2011,164,0,-4,0,103,12,0,275
China,10/06/2011,173,4,-2,0,151,23,0,349
China,11/06/2011,80,16,-3,0,47,6,0,146
China,12/06/2011,109,0,-4,0,20,19,0,144
China,13/06/2011,169,0,-9,0,70,17,0,247
China,14/06/2011,212,10,-3,0,58,20,0,297
China,15/06/2011,175,2,4,0,66,15,0,262
China,16/06/2011,63,0,-4,0,19,3,0,81
China,17/06/2011,154,2,1,0,22,24,0,203
China,18/06/2011,127,0,0,0,1,11,0,139
China,19/06/2011,114,0,-4,0,42,9,0,161
China,20/06/2011,129,0,-2,0,-6,17,0,138
China,21/06/2011,187,8,-13,0,64,22,0,268
China,22/06/2011,151,2,-4,0,70,21,0,240
China,23/06/2011,158,6,-8,0,45,14,0,215
China,24/06/2011,165,0,-7,0,23,10,0,191
China,25/06/2011,101,2,-3,0,31,25,0,156
China,26/06/2011,94,0,-4,0,-12,16,0,94
China,27/06/2011,232,4,1,0,86,30,0,353
China,28/06/2011,128,0,-5,0,31,15,0,169
China,29/06/2011,118,8,1,0,81,22,0,230
China,30/06/2011,200,0,0,0,93,13,0,306
Egypt,01/06/2011,48,0,-1,0,68,29,0,144
Egypt,02/06/2011,63,0,1,0,28,12,0,104
Egypt,03/06/2011,89,0,1,0,37,16,0,143
Egypt,04/06/2011,67,0,-8,0,37,9,0,105
Egypt,05/06/2011,70,0,-4,0,46,19,0,131
Egypt,06/06/2011,127,0,2,0,29,34,0,192
Egypt,07/06/2011,99,0,-2,0,48,19,0,164
Egypt,08/06/2011,46,0,0,0,22,13,0,81
Egypt,09/06/2011,110,0,1,0,27,24,0,162
Egypt,10/06/2011,81,0,-1,0,40,8,0,128
Egypt,11/06/2011,21,0,0,0,30,37,0,88
Egypt,12/06/2011,69,0,0,0,8,24,0,101
Egypt,13/06/2011,81,2,-6,0,79,28,0,184
Egypt,14/06/2011,79,0,-7,0,67,10,0,149
Egypt,15/06/2011,60,0,-5,0,81,6,0,142
Egypt,16/06/2011,44,0,-2,0,52,1,0,95
Egypt,17/06/2011,110,0,5,0,81,9,0,205
Egypt,18/06/2011,38,0,0,0,95,12,0,145
Egypt,19/06/2011,46,2,-5,0,101,22,0,166
Egypt,20/06/2011,66,0,-16,0,63,15,0,128
Egypt,21/06/2011,68,0,1,0,43,7,0,119
Egypt,22/06/2011,85,0,-8,0,32,4,0,113
Egypt,23/06/2011,65,0,-4,0,85,8,0,154
Egypt,24/06/2011,47,0,0,0,67,34,0,148
Egypt,25/06/2011,51,10,0,0,53,13,0,127
Egypt,26/06/2011,58,12,-2,0,25,3,0,96
Egypt,27/06/2011,27,0,-10,0,54,16,0,87
Egypt,28/06/2011,101,0,-4,0,74,28,0,199
Egypt,29/06/2011,71,0,-5,0,36,18,0,120
Egypt,30/06/2011,76,0,0,0,90,25,0,191
Eritrea,02/06/2011,0,0,0,0,0,24,0,24
Eritrea,03/06/2011,0,0,0,0,9,0,0,9
Eritrea,04/06/2011,0,0,0,0,0,2,0,2
Eritrea,06/06/2011,0,0,0,0,0,0,0,0
Eritrea,07/06/2011,3,0,0,0,3,0,0,6
Eritrea,08/06/2011,-1,0,0,0,0,0,0,-1
Eritrea,09/06/2011,3,0,0,0,9,0,0,12
Eritrea,10/06/2011,0,0,0,0,0,0,0,0
Eritrea,11/06/2011,5,0,0,0,0,4,0,9
Eritrea,12/06/2011,1,0,0,0,93,0,0,94
Eritrea,13/06/2011,0,0,0,0,7,0,0,7
Eritrea,14/06/2011,9,0,0,0,6,0,0,15
Eritrea,15/06/2011,4,0,0,0,0,0,0,4
Eritrea,16/06/2011,3,0,0,0,0,0,0,3
Eritrea,17/06/2011,0,0,0,0,0,0,0,0
Eritrea,18/06/2011,0,0,0,0,0,0,0,0
Eritrea,19/06/2011,0,0,0,0,0,0,0,0
Eritrea,20/06/2011,0,0,0,0,0,0,0,0
Eritrea,21/06/2011,2,0,0,0,0,0,0,2
Eritrea,22/06/2011,7,0,0,0,6,0,0,13
Eritrea,23/06/2011,27,2,0,0,-2,1,0,28
Eritrea,24/06/2011,2,0,0,0,3,1,0,6
Eritrea,25/06/2011,1,0,0,0,3,0,0,4
Eritrea,26/06/2011,0,0,0,0,3,0,0,3
Eritrea,27/06/2011,-1,0,0,0,3,1,0,3
Eritrea,28/06/2011,0,0,-1,0,0,0,0,-1
Eritrea,29/06/2011,3,0,0,0,9,1,0,13
Eritrea,30/06/2011,-1,0,-2,0,6,0,0,3
Georgia,01/06/2011,8,0,0,0,9,1,0,18
Georgia,02/06/2011,22,2,0,0,10,7,0,41
Georgia,03/06/2011,34,2,0,0,11,5,0,52
Georgia,04/06/2011,34,4,0,0,28,3,0,69
Georgia,05/06/2011,8,0,0,0,6,0,0,14
Georgia,06/06/2011,54,0,3,0,27,2,0,86
Georgia,07/06/2011,25,0,1,0,27,2,0,55
Georgia,08/06/2011,18,0,0,0,1,2,0,21
Georgia,09/06/2011,40,0,0,0,40,7,0,87
Georgia,10/06/2011,43,0,0,0,9,5,0,57
Georgia,11/06/2011,18,0,0,0,3,1,0,22
Georgia,12/06/2011,18,0,0,0,9,1,0,28
Georgia,13/06/2011,57,0,3,0,19,9,0,88
Georgia,14/06/2011,45,0,0,0,10,4,0,59
Georgia,15/06/2011,38,0,0,0,7,9,0,54
Georgia,16/06/2011,6,0,0,0,3,7,0,16
Georgia,17/06/2011,37,0,0,0,24,5,0,66
Georgia,18/06/2011,17,0,0,0,11,0,0,28
Georgia,19/06/2011,18,0,0,0,3,2,0,23
Georgia,20/06/2011,36,0,0,0,15,2,0,53
Georgia,21/06/2011,35,0,-1,0,39,3,0,76
Georgia,22/06/2011,47,0,3,0,6,3,0,59
Georgia,23/06/2011,48,2,1,0,35,6,0,92
Georgia,24/06/2011,34,0,2,0,12,5,0,53
Georgia,25/06/2011,53,6,0,0,25,0,0,84
Georgia,26/06/2011,24,0,0,0,7,8,0,39
Georgia,27/06/2011,45,4,0,0,16,0,0,65
Georgia,28/06/2011,55,4,1,0,26,10,0,96
Georgia,29/06/2011,42,0,-1,0,9,8,0,58
Georgia,30/06/2011,26,4,1,0,32,4,0,67
India,01/06/2011,34,0,0,0,10,9,0,53
India,02/06/2011,37,0,1,0,12,1,0,51
India,03/06/2011,39,0,-2,0,20,6,0,63
India,04/06/2011,93,0,0,0,19,11,0,123
India,05/06/2011,40,0,1,0,0,17,0,58
India,06/06/2011,87,2,-2,0,0,6,0,93
India,07/06/2011,91,6,-1,0,17,3,0,116
India,08/06/2011,30,0,0,0,4,4,0,38
India,09/06/2011,80,2,0,0,33,9,0,124
India,10/06/2011,102,2,3,0,40,6,0,153
India,11/06/2011,38,0,2,0,0,8,0,48
India,12/06/2011,32,0,0,0,-6,1,0,27
India,13/06/2011,64,4,-9,0,1,11,0,71
India,14/06/2011,63,0,-6,0,6,15,0,78
India,15/06/2011,45,2,2,0,16,6,0,71
India,16/06/2011,24,0,-2,0,5,2,0,29
India,17/06/2011,51,0,0,0,23,12,0,86
India,18/06/2011,46,0,0,0,29,6,0,81
India,19/06/2011,66,0,1,0,6,6,0,79
India,20/06/2011,44,2,0,0,13,8,0,67
India,21/06/2011,85,2,-3,0,14,11,0,109
India,22/06/2011,45,0,3,0,21,6,0,75
India,23/06/2011,77,2,1,0,-3,7,0,84
India,24/06/2011,44,0,1,0,48,18,0,111
India,25/06/2011,60,2,0,0,18,14,0,94
India,26/06/2011,40,4,-2,0,6,13,0,61
India,27/06/2011,42,0,0,0,0,9,0,51
India,28/06/2011,83,0,0,0,20,12,0,115
India,29/06/2011,60,0,-1,0,31,11,0,101
India,30/06/2011,76,2,1,0,34,12,0,125
Iran,01/06/2011,66,0,0,0,18,2,0,86
Iran,02/06/2011,342,4,-6,0,211,39,0,590
Iran,03/06/2011,118,2,-1,0,84,21,0,224
Iran,04/06/2011,53,0,-1,0,36,20,0,108
Iran,05/06/2011,85,0,1,0,33,10,0,129
Iran,06/06/2011,50,0,-2,0,33,5,0,86
Iran,07/06/2011,64,2,0,0,18,5,0,89
Iran,08/06/2011,78,0,0,0,30,15,0,123
Iran,09/06/2011,54,0,3,0,65,27,0,149
Iran,10/06/2011,83,0,-1,0,73,5,0,160
Iran,11/06/2011,70,0,1,0,52,4,0,127
Iran,12/06/2011,31,0,0,0,51,6,0,88
Iran,13/06/2011,39,0,-1,0,12,24,0,74
Iran,14/06/2011,111,0,-6,0,18,25,0,148
Iran,15/06/2011,127,0,2,0,50,35,0,214
Iran,16/06/2011,11,0,-1,0,3,2,0,15
Iran,17/06/2011,53,0,0,0,48,5,0,106
Iran,18/06/2011,70,0,0,0,32,6,0,108
Iran,19/06/2011,52,0,0,0,31,4,0,87
Iran,20/06/2011,51,2,-1,0,29,10,0,91
Iran,21/06/2011,99,0,-11,0,74,6,0,168
Iran,22/06/2011,84,0,1,0,37,8,0,130
Iran,23/06/2011,90,0,1,0,89,13,0,193
Iran,24/06/2011,22,0,-2,0,23,1,0,44
Iran,25/06/2011,55,0,-1,0,23,14,0,91
Iran,26/06/2011,62,0,1,0,5,18,0,86
Iran,27/06/2011,70,0,1,0,37,1,0,109
Iran,28/06/2011,59,0,0,0,13,2,0,74
Iran,29/06/2011,115,0,-2,0,32,11,0,156
Iran,30/06/2011,52,0,0,0,58,4,0,114
Iraq,01/06/2011,53,0,-4,0,46,4,0,99
Iraq,02/06/2011,52,0,-2,0,13,6,0,69
Iraq,03/06/2011,90,2,-2,0,9,37,0,136
Iraq,04/06/2011,67,0,0,0,33,22,0,122
Iraq,05/06/2011,65,0,-16,0,11,10,0,70
Iraq,06/06/2011,76,6,0,0,53,37,0,172
Iraq,07/06/2011,102,6,0,0,18,2,0,128
Iraq,08/06/2011,120,0,1,0,14,7,0,142
Iraq,09/06/2011,220,0,2,0,14,14,0,250
Iraq,10/06/2011,138,0,0,0,16,18,0,172
Iraq,11/06/2011,37,0,0,0,3,10,0,50
Iraq,12/06/2011,61,2,0,0,12,8,0,83
Iraq,13/06/2011,107,0,2,0,40,36,0,185
Iraq,14/06/2011,148,0,0,0,26,25,0,199
Iraq,15/06/2011,140,2,0,0,0,12,0,154
Iraq,16/06/2011,16,0,0,0,9,2,0,27
Iraq,17/06/2011,93,0,0,0,23,8,0,124
Iraq,18/06/2011,57,0,0,0,6,12,0,75
Iraq,19/06/2011,106,4,-4,0,5,19,0,130
Iraq,20/06/2011,90,6,0,0,15,11,0,122
Iraq,21/06/2011,109,4,1,0,43,31,0,188
Iraq,22/06/2011,86,10,0,0,32,8,0,136
Iraq,23/06/2011,61,2,-2,0,4,28,0,93
Iraq,24/06/2011,60,0,2,0,17,19,0,98
Iraq,25/06/2011,54,2,1,0,24,6,0,87
Iraq,26/06/2011,68,6,0,0,12,18,0,104
Iraq,27/06/2011,113,2,-1,0,35,15,0,164
Iraq,28/06/2011,67,0,-2,0,19,9,0,93
Iraq,29/06/2011,101,2,0,0,13,14,0,130
Iraq,30/06/2011,83,0,-4,0,24,6,0,109
Morocco,01/06/2011,2,0,0,0,3,1,0,6
Morocco,02/06/2011,5,0,0,0,3,0,0,8
Morocco,03/06/2011,3,0,-4,0,4,2,0,5
Morocco,04/06/2011,6,0,0,0,0,2,0,8
Morocco,05/06/2011,3,0,0,0,13,7,0,23
Morocco,06/06/2011,13,0,0,0,12,3,0,28
Morocco,07/06/2011,-1,0,0,0,9,0,0,8
Morocco,08/06/2011,-2,0,0,0,0,2,0,0
Morocco,09/06/2011,23,0,0,0,36,3,0,62
Morocco,10/06/2011,5,0,1,0,18,10,0,34
Morocco,11/06/2011,5,0,0,0,0,0,0,5
Morocco,12/06/2011,0,0,0,0,0,1,0,1
Morocco,13/06/2011,5,0,0,0,0,0,0,5
Morocco,14/06/2011,-3,0,0,0,0,0,0,-3
Morocco,15/06/2011,4,0,0,0,19,0,0,23
Morocco,16/06/2011,2,0,0,0,9,0,0,11
Morocco,17/06/2011,4,0,-6,0,3,12,0,13
Morocco,18/06/2011,17,0,-6,0,-16,12,0,7
Morocco,19/06/2011,2,0,-2,0,-4,0,0,-4
Morocco,20/06/2011,9,0,3,0,3,7,0,22
Morocco,21/06/2011,5,0,0,0,-4,5,0,6
Morocco,22/06/2011,5,0,-4,0,1,4,0,6
Morocco,23/06/2011,21,0,-3,0,2,2,0,22
Morocco,24/06/2011,4,0,-4,0,0,2,0,2
Morocco,25/06/2011,6,0,0,0,-2,2,0,6
Morocco,26/06/2011,0,0,1,0,0,2,0,3
Morocco,27/06/2011,7,0,0,0,1,4,0,12
Morocco,28/06/2011,12,0,0,0,0,-2,0,10
Morocco,29/06/2011,3,0,0,0,6,1,0,10
Morocco,30/06/2011,1,0,0,0,4,7,0,12
Nigeria,01/06/2011,22,0,-2,0,7,0,0,27
Nigeria,02/06/2011,5,0,0,0,6,1,0,12
Nigeria,03/06/2011,20,0,1,0,3,0,0,24
Nigeria,04/06/2011,15,0,0,0,0,0,0,15
Nigeria,05/06/2011,15,0,-3,0,6,3,0,21
Nigeria,06/06/2011,27,0,0,0,15,3,0,45
Nigeria,07/06/2011,8,0,-6,0,18,1,0,21
Nigeria,08/06/2011,15,2,1,0,13,1,0,32
Nigeria,09/06/2011,14,0,0,0,24,0,0,38
Nigeria,10/06/2011,7,2,1,0,12,0,0,22
Nigeria,11/06/2011,5,0,0,0,13,4,0,22
Nigeria,12/06/2011,4,2,0,0,16,0,0,22
Nigeria,13/06/2011,33,0,-2,0,25,4,0,60
Nigeria,14/06/2011,43,0,0,0,0,12,0,55
Nigeria,15/06/2011,15,0,3,0,7,0,0,25
Nigeria,16/06/2011,0,0,0,0,3,0,0,3
Nigeria,17/06/2011,30,0,1,0,10,4,0,45
Nigeria,18/06/2011,1,0,-1,0,-2,0,0,-2
Nigeria,19/06/2011,14,0,0,0,12,5,0,31
Nigeria,20/06/2011,29,0,0,0,-8,4,0,25
Nigeria,21/06/2011,19,2,-2,0,10,6,0,35
Nigeria,22/06/2011,7,0,1,0,1,4,0,13
Nigeria,23/06/2011,20,0,0,0,-2,3,0,21
Nigeria,24/06/2011,29,2,0,0,4,3,0,38
Nigeria,25/06/2011,9,0,0,0,0,0,0,9
Nigeria,26/06/2011,9,0,-4,0,0,2,0,7
Nigeria,27/06/2011,25,0,0,0,17,7,0,49
Nigeria,28/06/2011,25,4,-1,0,16,1,0,45
Nigeria,29/06/2011,3,0,0,0,27,4,0,34
Nigeria,30/06/2011,16,0,1,0,16,0,0,33
Pakistan,01/06/2011,113,2,1,0,11,1,0,128
Pakistan,02/06/2011,146,0,0,0,23,8,0,177
Pakistan,03/06/2011,157,0,2,0,26,13,0,198
Pakistan,04/06/2011,206,2,2,0,20,18,0,248
Pakistan,05/06/2011,117,0,0,0,38,19,0,174
Pakistan,06/06/2011,223,0,-3,0,-1,15,0,234
Pakistan,07/06/2011,124,0,0,0,24,11,0,159
Pakistan,08/06/2011,116,0,-4,0,21,14,0,147
Pakistan,09/06/2011,180,0,0,0,102,12,0,294
Pakistan,10/06/2011,232,4,-10,0,122,16,0,364
Pakistan,11/06/2011,131,0,3,0,4,29,0,167
Pakistan,12/06/2011,156,0,0,0,12,20,0,188
Pakistan,13/06/2011,147,2,0,0,18,15,0,182
Pakistan,14/06/2011,149,2,-4,0,28,7,0,182
Pakistan,15/06/2011,240,2,0,0,68,37,0,347
Pakistan,16/06/2011,155,0,0,0,31,3,0,189
Pakistan,17/06/2011,318,0,0,0,30,4,0,352
Pakistan,18/06/2011,140,0,-2,0,58,16,0,212
Pakistan,19/06/2011,111,0,0,0,10,11,0,132
Pakistan,20/06/2011,135,0,-4,0,29,18,0,178
Pakistan,21/06/2011,135,2,1,0,16,19,0,173
Pakistan,22/06/2011,148,0,-2,0,8,8,0,162
Pakistan,23/06/2011,74,0,3,0,34,9,0,120
Pakistan,24/06/2011,123,0,-12,0,4,10,0,125
Pakistan,25/06/2011,156,0,-6,0,20,27,0,197
Pakistan,26/06/2011,133,0,-4,0,-15,17,0,131
Pakistan,27/06/2011,135,0,2,0,17,3,0,157
Pakistan,28/06/2011,187,2,0,0,87,10,0,286
Pakistan,29/06/2011,154,0,0,0,28,12,0,194
Pakistan,30/06/2011,152,0,-5,0,31,12,0,190
Sierra Leone,01/06/2011,0,0,0,0,3,0,0,3
Sierra Leone,02/06/2011,4,0,0,0,0,1,0,5
Sierra Leone,03/06/2011,8,0,0,0,0,0,0,8
Sierra Leone,04/06/2011,3,0,0,0,0,0,0,3
Sierra Leone,05/06/2011,-1,0,0,0,3,0,0,2
Sierra Leone,06/06/2011,4,0,0,0,3,0,0,7
Sierra Leone,07/06/2011,9,0,0,0,0,0,0,9
Sierra Leone,08/06/2011,9,0,0,0,9,0,0,18
Sierra Leone,09/06/2011,-1,0,0,0,9,0,0,8
Sierra Leone,10/06/2011,0,0,0,0,0,0,0,0
Sierra Leone,11/06/2011,0,0,0,0,3,0,0,3
Sierra Leone,12/06/2011,0,0,0,0,0,0,0,0
Sierra Leone,13/06/2011,3,0,1,0,9,2,0,15
Sierra Leone,14/06/2011,8,0,0,0,6,0,0,14
Sierra Leone,15/06/2011,14,0,-10,0,9,1,0,14
Sierra Leone,16/06/2011,9,0,0,0,3,1,0,13
Sierra Leone,17/06/2011,11,0,0,0,0,2,0,13
Sierra Leone,18/06/2011,4,0,0,0,0,0,0,4
Sierra Leone,19/06/2011,0,0,0,0,0,0,0,0
Sierra Leone,20/06/2011,2,0,0,0,6,0,0,8
Sierra Leone,21/06/2011,-2,0,0,0,0,0,0,-2
Sierra Leone,22/06/2011,1,0,0,0,0,0,0,1
Sierra Leone,23/06/2011,0,0,0,0,5,0,0,5
Sierra Leone,24/06/2011,9,0,0,0,6,0,0,15
Sierra Leone,25/06/2011,8,0,-2,0,3,0,0,9
Sierra Leone,26/06/2011,0,0,0,0,3,0,0,3
Sierra Leone,27/06/2011,2,0,0,0,6,0,0,8
Sierra Leone,28/06/2011,4,0,0,0,0,0,0,4
Sierra Leone,29/06/2011,3,0,0,0,9,1,0,13
Sierra Leone,30/06/2011,4,0,0,0,0,2,0,6
Somalia,01/06/2011,24,0,0,0,18,0,0,42
Somalia,02/06/2011,37,0,0,0,10,6,0,53
Somalia,03/06/2011,48,0,1,0,-2,9,0,56
Somalia,04/06/2011,15,0,0,0,0,2,0,17
Somalia,05/06/2011,35,0,0,0,12,0,0,47
Somalia,06/06/2011,29,0,0,0,4,4,0,37
Somalia,07/06/2011,26,0,2,0,15,1,0,44
Somalia,08/06/2011,53,0,1,0,10,3,0,67
Somalia,09/06/2011,52,0,-13,0,32,6,0,77
Somalia,10/06/2011,58,0,-8,0,14,31,0,95
Somalia,11/06/2011,106,0,0,0,2,5,0,113
Somalia,12/06/2011,132,0,0,0,-14,3,0,121
Somalia,13/06/2011,103,0,0,0,42,2,0,147
Somalia,14/06/2011,187,0,-4,0,43,39,0,265
Somalia,15/06/2011,695,10,-12,0,198,116,0,1007
Somalia,16/06/2011,23,0,-4,0,-14,2,0,7
Somalia,17/06/2011,36,0,0,0,-21,9,0,24
Somalia,18/06/2011,22,0,0,0,-56,29,0,-5
Somalia,19/06/2011,9,6,-12,0,-10,1,0,-6
Somalia,20/06/2011,12,0,1,0,1,12,0,26
Somalia,21/06/2011,21,2,0,0,7,20,0,50
Somalia,22/06/2011,37,0,0,0,23,19,0,79
Somalia,23/06/2011,9,0,0,0,9,0,0,18
Somalia,24/06/2011,47,0,0,0,23,4,0,74
Somalia,25/06/2011,17,0,0,0,2,0,0,19
Somalia,26/06/2011,13,0,0,0,15,0,0,28
Somalia,27/06/2011,15,0,-3,0,19,2,0,33
Somalia,28/06/2011,13,8,-7,0,13,0,0,27
Somalia,29/06/2011,56,4,0,0,16,6,0,82
Somalia,30/06/2011,16,0,3,0,18,0,0,37
Syria,01/06/2011,96,0,-1,0,40,17,0,152
Syria,02/06/2011,108,0,-1,0,11,9,0,127
Syria,03/06/2011,94,0,-14,0,9,15,0,104
Syria,04/06/2011,170,0,-2,0,43,35,0,246
Syria,05/06/2011,153,0,0,0,34,37,0,224
Syria,06/06/2011,182,0,4,0,22,43,0,251
Syria,07/06/2011,181,0,-3,0,42,35,0,255
Syria,08/06/2011,237,2,1,0,70,27,0,337
Syria,09/06/2011,373,0,-5,0,64,61,0,493
Syria,10/06/2011,381,0,-16,0,49,58,0,472
Syria,11/06/2011,280,0,0,0,53,68,0,401
Syria,12/06/2011,319,0,1,0,37,32,0,389
Syria,13/06/2011,345,0,1,0,85,13,0,444
Syria,14/06/2011,171,0,4,0,54,68,0,297
Syria,15/06/2011,313,0,-7,0,13,27,0,346
Syria,16/06/2011,145,0,-6,0,33,8,0,180
Syria,17/06/2011,296,0,-2,0,40,22,0,356
Syria,18/06/2011,223,0,-5,0,43,18,0,279
Syria,19/06/2011,148,0,-6,0,19,13,0,174
Syria,20/06/2011,224,0,-25,0,25,28,0,252
Syria,21/06/2011,178,2,1,0,39,35,0,255
Syria,22/06/2011,133,0,1,0,44,35,0,213
Syria,23/06/2011,265,0,2,0,110,28,0,405
Syria,24/06/2011,211,2,0,0,50,16,0,279
Syria,25/06/2011,99,0,0,0,32,4,0,135
Syria,26/06/2011,24,0,0,0,-4,4,0,24
Syria,27/06/2011,80,4,-4,0,5,5,0,90
Syria,28/06/2011,103,4,9,0,44,13,0,173
Syria,29/06/2011,102,2,4,0,3,26,0,137
Syria,30/06/2011,125,0,-12,0,38,14,0,165
Yemen,01/06/2011,30,0,-14,0,-2,2,0,16
Yemen,02/06/2011,77,0,-7,0,3,11,0,84
Yemen,03/06/2011,166,0,-2,0,5,5,0,174
Yemen,04/06/2011,146,0,-8,0,9,8,0,155
Yemen,05/06/2011,84,0,-2,0,-6,11,0,87
Yemen,06/06/2011,117,0,-1,0,10,4,0,130
Yemen,07/06/2011,113,0,-4,0,1,0,0,110
Yemen,08/06/2011,99,0,0,0,-1,10,0,108
Yemen,09/06/2011,120,0,-12,0,4,10,0,122
Yemen,10/06/2011,62,0,0,0,4,17,0,83
Yemen,11/06/2011,57,2,-7,0,13,9,0,74
Yemen,12/06/2011,70,0,0,0,7,0,0,77
Yemen,13/06/2011,71,0,-4,0,19,5,0,91
Yemen,14/06/2011,132,0,0,0,5,9,0,146
Yemen,15/06/2011,122,0,1,0,5,7,0,135
Yemen,16/06/2011,26,0,0,0,18,7,0,51
Yemen,17/06/2011,57,0,-1,0,19,4,0,79
Yemen,18/06/2011,39,0,0,0,4,7,0,50
Yemen,19/06/2011,32,0,-2,0,1,1,0,32
Yemen,20/06/2011,21,0,0,0,10,0,0,31
Yemen,21/06/2011,20,0,0,0,1,4,0,25
Yemen,22/06/2011,42,0,0,0,38,4,0,84
Yemen,23/06/2011,44,0,-3,0,4,5,0,50
Yemen,24/06/2011,165,2,-4,0,49,10,0,222
Yemen,25/06/2011,86,0,0,0,41,26,0,153
Yemen,26/06/2011,83,0,-2,0,38,24,0,143
Yemen,27/06/2011,38,0,-2,0,36,9,0,81
Yemen,28/06/2011,29,0,0,0,15,1,0,45
Yemen,29/06/2011,23,0,0,0,-40,0,0,-17
Yemen,30/06/2011,55,0,1,0,11,8,0,75
Afghanistan,01/07/2011,137,0,-19,0,7,0,0,125
Afghanistan,02/07/2011,115,2,0,0,-8,8,0,117
Afghanistan,03/07/2011,79,0,1,0,20,3,0,103
Afghanistan,04/07/2011,272,6,-5,0,1,20,0,294
Afghanistan,05/07/2011,263,0,-2,0,44,9,0,314
Afghanistan,06/07/2011,321,0,-4,0,48,24,0,389
Afghanistan,07/07/2011,496,0,-8,0,57,24,0,569
Afghanistan,08/07/2011,303,2,-7,0,33,16,0,347
Afghanistan,09/07/2011,272,6,0,0,12,16,0,306
Afghanistan,10/07/2011,191,10,-12,0,19,13,0,221
Afghanistan,11/07/2011,255,2,-2,0,37,29,0,321
Afghanistan,12/07/2011,611,0,0,0,39,33,0,683
Afghanistan,13/07/2011,455,4,0,0,20,34,0,513
Afghanistan,14/07/2011,460,0,4,0,70,87,0,621
Afghanistan,15/07/2011,253,2,0,0,22,34,0,311
Afghanistan,16/07/2011,177,0,-2,0,14,24,0,213
Afghanistan,17/07/2011,767,4,-1,0,84,39,0,893
Afghanistan,18/07/2011,778,4,-3,0,103,37,0,919
Afghanistan,19/07/2011,323,2,-12,0,37,29,0,379
Afghanistan,20/07/2011,302,2,-7,0,36,27,0,360
Afghanistan,21/07/2011,208,10,3,0,161,12,0,394
Afghanistan,22/07/2011,346,0,0,0,113,35,0,494
Afghanistan,23/07/2011,184,0,0,0,12,7,0,203
Afghanistan,24/07/2011,124,0,0,0,24,14,0,162
Afghanistan,25/07/2011,149,0,1,0,25,10,0,185
Afghanistan,26/07/2011,153,22,1,0,62,13,0,251
Afghanistan,27/07/2011,400,4,-2,0,141,94,0,637
Afghanistan,28/07/2011,355,0,0,0,164,45,0,564
Afghanistan,29/07/2011,200,0,-15,0,68,11,0,264
Afghanistan,30/07/2011,136,2,-8,0,50,29,0,209
Afghanistan,31/07/2011,131,0,-2,0,17,13,0,159
Albania,01/07/2011,2,0,0,0,9,3,0,14
Albania,02/07/2011,0,0,0,0,0,0,0,0
Albania,03/07/2011,6,0,0,0,0,1,0,7
Albania,04/07/2011,0,0,-1,0,0,0,0,-1
Albania,05/07/2011,3,0,0,0,8,0,0,11
Albania,06/07/2011,-4,0,0,0,0,0,0,-4
Albania,07/07/2011,7,0,-1,0,3,0,0,9
Albania,08/07/2011,13,0,1,0,9,0,0,23
Albania,09/07/2011,0,0,0,0,0,0,0,0
Albania,10/07/2011,0,0,0,0,13,0,0,13
Albania,11/07/2011,8,0,0,0,9,0,0,17
Albania,12/07/2011,10,0,-1,0,0,0,0,9
Albania,13/07/2011,1,0,0,0,3,0,0,4
Albania,14/07/2011,2,0,0,0,0,2,0,4
Albania,15/07/2011,21,0,-2,0,2,0,0,21
Albania,16/07/2011,4,0,0,0,-9,0,0,-5
Albania,17/07/2011,0,0,0,0,0,0,0,0
Albania,18/07/2011,0,0,0,0,3,0,0,3
Albania,19/07/2011,0,0,0,0,0,3,0,3
Albania,20/07/2011,4,0,-2,0,3,4,0,9
Albania,21/07/2011,6,0,-1,0,0,0,0,5
Albania,22/07/2011,4,0,0,0,16,0,0,20
Albania,23/07/2011,0,0,0,0,0,0,0,0
Albania,24/07/2011,16,0,0,0,3,0,0,19
Albania,25/07/2011,4,0,-2,0,3,6,0,11
Albania,26/07/2011,9,0,-2,0,6,18,0,31
Albania,27/07/2011,24,0,-3,0,7,16,0,44
Albania,28/07/2011,28,0,-4,0,8,0,0,32
Albania,29/07/2011,38,0,-4,0,15,1,0,50
Albania,30/07/2011,1,0,-12,0,0,0,0,-11
Albania,31/07/2011,3,0,-5,0,-2,0,0,-4
Algeria,01/07/2011,13,0,0,0,10,2,0,25
Algeria,02/07/2011,1,0,0,0,18,0,0,19
Algeria,03/07/2011,2,0,0,0,0,0,0,2
Algeria,04/07/2011,14,0,0,0,0,0,0,14
Algeria,05/07/2011,13,0,0,0,12,1,0,26
Algeria,06/07/2011,8,0,0,0,13,0,0,21
Algeria,07/07/2011,12,0,0,0,12,2,0,26
Algeria,08/07/2011,6,0,0,0,0,0,0,6
Algeria,09/07/2011,3,0,0,0,0,0,0,3
Algeria,10/07/2011,8,0,0,0,0,0,0,8
Algeria,11/07/2011,25,0,-5,0,3,3,0,26
Algeria,12/07/2011,21,0,-4,0,3,3,0,23
Algeria,13/07/2011,4,0,0,0,1,0,0,5
Algeria,14/07/2011,3,0,0,0,9,0,0,12
Algeria,15/07/2011,0,0,0,0,0,0,0,0
Algeria,16/07/2011,9,0,0,0,3,0,0,12
Algeria,17/07/2011,13,0,0,0,0,1,0,14
Algeria,18/07/2011,3,0,0,0,3,1,0,7
Algeria,19/07/2011,9,0,0,0,18,1,0,28
Algeria,20/07/2011,30,0,0,0,6,0,0,36
Algeria,21/07/2011,3,0,1,0,-4,0,0,0
Algeria,22/07/2011,33,0,0,0,2,0,0,35
Algeria,23/07/2011,18,0,0,0,3,0,0,21
Algeria,24/07/2011,5,0,0,0,1,0,0,6
Algeria,25/07/2011,17,0,0,0,0,6,0,23
Algeria,26/07/2011,11,0,0,0,0,0,0,11
Algeria,27/07/2011,6,0,0,0,6,0,0,12
Algeria,28/07/2011,11,0,0,0,0,0,0,11
Algeria,29/07/2011,13,0,0,0,0,0,0,13
Algeria,30/07/2011,14,0,1,0,9,0,0,24
Algeria,31/07/2011,6,0,0,0,0,0,0,6
Bangladesh,01/07/2011,18,0,-6,0,-6,9,0,15
Bangladesh,02/07/2011,12,0,-4,0,3,3,0,14
Bangladesh,03/07/2011,33,0,-2,0,15,12,0,58
Bangladesh,04/07/2011,16,0,0,0,18,4,0,38
Bangladesh,05/07/2011,9,0,0,0,12,6,0,27
Bangladesh,06/07/2011,22,0,0,0,13,2,0,37
Bangladesh,07/07/2011,27,0,-3,0,-2,5,0,27
Bangladesh,08/07/2011,41,0,0,0,9,0,0,50
Bangladesh,09/07/2011,9,0,0,0,7,6,0,22
Bangladesh,10/07/2011,22,0,-6,0,9,5,0,30
Bangladesh,11/07/2011,33,0,-7,0,3,2,0,31
Bangladesh,12/07/2011,11,0,0,0,11,8,0,30
Bangladesh,13/07/2011,22,0,-2,0,24,13,0,57
Bangladesh,14/07/2011,37,0,0,0,8,10,0,55
Bangladesh,15/07/2011,11,0,-4,0,0,2,0,9
Bangladesh,16/07/2011,26,0,-2,0,3,1,0,28
Bangladesh,17/07/2011,4,2,0,0,6,4,0,16
Bangladesh,18/07/2011,19,0,0,0,26,4,0,49
Bangladesh,19/07/2011,28,0,0,0,-1,6,0,33
Bangladesh,20/07/2011,16,0,0,0,19,1,0,36
Bangladesh,21/07/2011,36,0,1,0,10,2,0,49
Bangladesh,22/07/2011,16,0,0,0,-2,4,0,18
Bangladesh,23/07/2011,9,0,0,0,1,0,0,10
Bangladesh,24/07/2011,12,0,0,0,1,0,0,13
Bangladesh,25/07/2011,10,0,0,0,-6,0,0,4
Bangladesh,26/07/2011,12,0,0,0,33,0,0,45
Bangladesh,27/07/2011,13,2,0,0,16,0,0,31
Bangladesh,28/07/2011,3,0,0,0,-3,0,0,0
Bangladesh,29/07/2011,3,0,0,0,-10,0,0,-7
Bangladesh,30/07/2011,5,0,0,0,3,0,0,8
Bangladesh,31/07/2011,8,0,0,0,5,0,0,13
Cameroon,01/07/2011,13,0,0,0,3,2,0,18
Cameroon,02/07/2011,0,0,0,0,0,0,0,0
Cameroon,03/07/2011,4,0,0,0,0,2,0,6
Cameroon,04/07/2011,0,0,0,0,3,0,0,3
Cameroon,05/07/2011,7,0,0,0,0,0,0,7
Cameroon,06/07/2011,3,0,0,0,0,0,0,3
Cameroon,07/07/2011,0,0,0,0,0,0,0,0
Cameroon,08/07/2011,6,0,0,0,0,0,0,6
Cameroon,09/07/2011,2,0,0,0,0,0,0,2
Cameroon,11/07/2011,0,0,0,0,0,0,0,0
Cameroon,12/07/2011,2,0,0,0,3,0,0,5
Cameroon,13/07/2011,10,0,0,0,0,2,0,12
Cameroon,14/07/2011,0,0,0,0,0,0,0,0
Cameroon,15/07/2011,0,0,0,0,0,0,0,0
Cameroon,16/07/2011,1,0,0,0,0,0,0,1
Cameroon,17/07/2011,0,0,-2,0,0,0,0,-2
Cameroon,18/07/2011,0,0,0,0,0,0,0,0
Cameroon,19/07/2011,1,0,0,0,0,0,0,1
Cameroon,20/07/2011,3,0,0,0,0,0,0,3
Cameroon,21/07/2011,-3,0,0,0,0,0,0,-3
Cameroon,22/07/2011,1,0,0,0,6,0,0,7
Cameroon,23/07/2011,-2,0,0,0,3,0,0,1
Cameroon,24/07/2011,-2,0,0,0,0,0,0,-2
Cameroon,25/07/2011,-1,0,0,0,0,0,0,-1
Cameroon,26/07/2011,0,0,0,0,12,0,0,12
Cameroon,27/07/2011,2,0,0,0,3,0,0,5
Cameroon,28/07/2011,0,0,0,0,0,1,0,1
Cameroon,29/07/2011,1,0,0,0,0,0,0,1
Cameroon,30/07/2011,0,0,0,0,0,0,0,0
China,01/07/2011,187,0,2,0,4,23,0,216
China,02/07/2011,50,0,-16,0,51,6,0,91
China,03/07/2011,72,0,-2,0,17,4,0,91
China,04/07/2011,106,2,0,0,40,8,0,156
China,05/07/2011,127,2,5,0,109,34,0,277
China,06/07/2011,181,0,-3,0,124,37,0,339
China,07/07/2011,148,2,1,0,100,14,0,265
China,08/07/2011,138,2,0,0,77,7,0,224
China,09/07/2011,49,2,-3,0,38,15,0,101
China,10/07/2011,96,0,-13,0,59,8,0,150
China,11/07/2011,131,0,-13,0,62,27,0,207
China,12/07/2011,127,2,-3,0,35,15,0,176
China,13/07/2011,117,0,-3,0,12,11,0,137
China,14/07/2011,147,0,4,0,37,13,0,201
China,15/07/2011,166,6,3,0,52,17,0,244
China,16/07/2011,44,0,2,0,6,3,0,55
China,17/07/2011,78,2,-6,0,32,12,0,118
China,18/07/2011,137,0,-2,0,26,4,0,165
China,19/07/2011,198,0,-3,0,43,26,0,264
China,20/07/2011,213,2,-1,0,63,24,0,301
China,21/07/2011,121,4,-4,0,66,19,0,206
China,22/07/2011,179,2,-6,0,83,12,0,270
China,23/07/2011,157,0,3,0,9,12,0,181
China,24/07/2011,130,0,-1,0,31,6,0,166
China,25/07/2011,154,2,-3,0,110,5,0,268
China,26/07/2011,143,2,-4,0,46,18,0,205
China,27/07/2011,109,4,2,0,39,26,0,180
China,28/07/2011,128,6,-1,0,24,8,0,165
China,29/07/2011,171,2,-4,0,34,15,0,218
China,30/07/2011,83,0,-6,0,37,15,0,129
China,31/07/2011,133,0,-10,0,17,16,0,156
Egypt,01/07/2011,81,2,-9,0,58,21,0,153
Egypt,02/07/2011,87,0,2,0,42,19,0,150
Egypt,03/07/2011,52,2,-1,0,50,10,0,113
Egypt,04/07/2011,76,4,0,0,22,17,0,119
Egypt,05/07/2011,50,4,1,0,93,9,0,157
Egypt,06/07/2011,63,2,1,0,55,11,0,132
Egypt,07/07/2011,96,0,1,0,35,21,0,153
Egypt,08/07/2011,67,0,-2,0,13,12,0,90
Egypt,09/07/2011,38,0,0,0,40,13,0,91
Egypt,10/07/2011,35,0,-11,0,20,20,0,64
Egypt,11/07/2011,39,0,-7,0,46,16,0,94
Egypt,12/07/2011,56,0,-19,0,77,15,0,129
Egypt,13/07/2011,50,0,-11,0,1,15,0,55
Egypt,14/07/2011,33,0,-1,0,38,8,0,78
Egypt,15/07/2011,13,0,0,0,14,17,0,44
Egypt,16/07/2011,21,2,-1,0,16,13,0,51
Egypt,17/07/2011,77,0,-39,0,34,24,0,96
Egypt,18/07/2011,36,0,-12,0,39,28,0,91
Egypt,19/07/2011,38,0,-7,0,39,4,0,74
Egypt,20/07/2011,66,0,-4,0,22,8,0,92
Egypt,21/07/2011,50,0,-10,0,32,10,0,82
Egypt,22/07/2011,49,0,-1,0,23,8,0,79
Egypt,23/07/2011,30,0,-1,0,15,11,0,55
Egypt,24/07/2011,75,0,-1,0,20,19,0,113
Egypt,25/07/2011,75,0,-3,0,55,7,0,134
Egypt,26/07/2011,47,0,4,0,24,11,0,86
Egypt,27/07/2011,55,2,-4,0,20,13,0,86
Egypt,28/07/2011,28,0,1,0,22,9,0,60
Egypt,29/07/2011,54,0,-3,0,18,11,0,80
Egypt,30/07/2011,78,0,2,0,6,5,0,91
Egypt,31/07/2011,49,0,-3,0,18,6,0,70
Eritrea,01/07/2011,1,0,0,0,3,0,0,4
Eritrea,02/07/2011,0,0,0,0,0,0,0,0
Eritrea,03/07/2011,6,0,0,0,0,1,0,7
Eritrea,04/07/2011,13,0,0,0,11,0,0,24
Eritrea,05/07/2011,10,0,0,0,3,0,0,13
Eritrea,06/07/2011,2,0,0,0,3,0,0,5
Eritrea,07/07/2011,1,0,0,0,0,2,0,3
Eritrea,08/07/2011,1,0,0,0,-2,0,0,-1
Eritrea,09/07/2011,1,0,0,0,0,0,0,1
Eritrea,10/07/2011,0,0,0,0,0,0,0,0
Eritrea,11/07/2011,4,0,0,0,0,0,0,4
Eritrea,12/07/2011,-1,0,0,0,3,0,0,2
Eritrea,13/07/2011,0,0,0,0,6,0,0,6
Eritrea,14/07/2011,0,0,0,0,0,0,0,0
Eritrea,15/07/2011,4,0,0,0,-2,0,0,2
Eritrea,16/07/2011,2,0,0,0,-1,0,0,1
Eritrea,17/07/2011,2,0,0,0,-1,0,0,1
Eritrea,18/07/2011,0,0,0,0,0,0,0,0
Eritrea,20/07/2011,14,0,0,0,3,0,0,17
Eritrea,21/07/2011,1,0,0,0,0,0,0,1
Eritrea,22/07/2011,1,0,0,0,15,0,0,16
Eritrea,23/07/2011,0,0,0,0,0,0,0,0
Eritrea,24/07/2011,0,0,0,0,-2,0,0,-2
Eritrea,25/07/2011,0,0,0,0,0,0,0,0
Eritrea,26/07/2011,11,0,0,0,7,0,0,18
Eritrea,27/07/2011,5,4,0,0,6,2,0,17
Eritrea,28/07/2011,12,0,0,0,4,0,0,16
Eritrea,29/07/2011,13,0,0,0,-2,0,0,11
Eritrea,30/07/2011,2,0,0,0,16,0,0,18
Eritrea,31/07/2011,2,0,0,0,0,0,0,2
Georgia,01/07/2011,8,2,0,0,12,2,0,24
Georgia,02/07/2011,14,2,0,0,12,4,0,32
Georgia,03/07/2011,28,2,0,0,8,4,0,42
Georgia,04/07/2011,8,0,0,0,12,4,0,24
Georgia,05/07/2011,30,0,1,0,7,0,0,38
Georgia,06/07/2011,27,2,0,0,8,9,0,46
Georgia,07/07/2011,63,2,1,0,39,11,0,116
Georgia,08/07/2011,57,0,0,0,65,4,0,126
Georgia,09/07/2011,4,0,0,0,11,5,0,20
Georgia,10/07/2011,12,0,1,0,9,3,0,25
Georgia,11/07/2011,34,2,-2,0,21,14,0,69
Georgia,12/07/2011,41,0,3,0,-3,6,0,47
Georgia,13/07/2011,45,0,0,0,9,13,0,67
Georgia,14/07/2011,24,4,1,0,10,13,0,52
Georgia,15/07/2011,58,2,-2,0,29,5,0,92
Georgia,16/07/2011,16,0,0,0,27,8,0,51
Georgia,17/07/2011,15,0,0,0,13,1,0,29
Georgia,18/07/2011,15,0,0,0,9,12,0,36
Georgia,19/07/2011,32,0,0,0,19,2,0,53
Georgia,20/07/2011,63,2,1,0,20,1,0,87
Georgia,21/07/2011,89,0,-3,0,42,10,0,138
Georgia,22/07/2011,47,0,0,0,55,4,0,106
Georgia,23/07/2011,18,0,0,0,9,2,0,29
Georgia,24/07/2011,8,2,0,0,3,2,0,15
Georgia,25/07/2011,10,0,-4,0,24,0,0,30
Georgia,26/07/2011,52,4,-3,0,26,8,0,87
Georgia,27/07/2011,16,0,0,0,23,7,0,46
Georgia,28/07/2011,57,0,-4,0,17,4,0,74
Georgia,29/07/2011,33,0,0,0,9,5,0,47
Georgia,30/07/2011,20,0,0,0,21,8,0,49
Georgia,31/07/2011,40,0,0,0,2,3,0,45
India,01/07/2011,42,2,0,0,33,5,0,82
India,02/07/2011,38,2,1,0,19,2,0,62
India,03/07/2011,29,2,0,0,10,4,0,45
India,04/07/2011,24,0,-2,0,19,5,0,46
India,05/07/2011,42,2,-2,0,18,8,0,68
India,06/07/2011,38,4,-5,0,28,5,0,70
India,07/07/2011,62,0,-7,0,23,2,0,80
India,08/07/2011,56,2,-1,0,42,4,0,103
India,09/07/2011,51,0,-2,0,-12,6,0,43
India,10/07/2011,71,0,-6,0,6,2,0,73
India,11/07/2011,57,0,-8,0,12,14,0,75
India,12/07/2011,60,2,-2,0,16,4,0,80
India,13/07/2011,46,2,-1,0,19,14,0,80
India,14/07/2011,107,0,-6,0,16,19,0,136
India,15/07/2011,26,0,-4,0,-6,11,0,27
India,16/07/2011,54,0,0,0,1,6,0,61
India,17/07/2011,36,4,-1,0,29,4,0,72
India,18/07/2011,45,0,-1,0,15,9,0,68
India,19/07/2011,72,0,-1,0,27,3,0,101
India,20/07/2011,61,0,0,0,32,5,0,98
India,21/07/2011,78,10,-6,0,51,10,0,143
India,22/07/2011,58,0,1,0,26,14,0,99
India,23/07/2011,38,4,-3,0,37,9,0,85
India,24/07/2011,75,0,-3,0,11,11,0,94
India,25/07/2011,26,0,0,0,24,4,0,54
India,26/07/2011,42,2,-2,0,13,4,0,59
India,27/07/2011,51,0,-1,0,23,13,0,86
India,28/07/2011,61,0,-6,0,11,5,0,71
India,29/07/2011,85,0,-2,0,9,11,0,103
India,30/07/2011,81,0,1,0,16,3,0,101
India,31/07/2011,73,2,-16,0,21,18,0,98
Iran,01/07/2011,88,4,-2,0,119,8,0,217
Iran,02/07/2011,65,0,0,0,93,3,0,161
Iran,03/07/2011,51,0,-6,0,53,13,0,111
Iran,04/07/2011,118,0,-3,0,41,3,0,159
Iran,05/07/2011,123,0,0,0,36,7,0,166
Iran,06/07/2011,107,0,0,0,57,11,0,175
Iran,07/07/2011,92,0,-8,0,53,5,0,142
Iran,08/07/2011,56,0,0,0,114,1,0,171
Iran,09/07/2011,30,0,0,0,64,0,0,94
Iran,10/07/2011,54,0,-7,0,40,8,0,95
Iran,11/07/2011,176,0,-18,0,52,17,0,227
Iran,12/07/2011,79,0,-6,0,8,10,0,91
Iran,13/07/2011,42,2,-2,0,14,15,0,71
Iran,14/07/2011,67,0,0,0,16,13,0,96
Iran,15/07/2011,54,0,-4,0,18,8,0,76
Iran,16/07/2011,35,2,-1,0,13,9,0,58
Iran,17/07/2011,32,2,-4,0,4,12,0,46
Iran,18/07/2011,110,0,-10,0,30,8,0,138
Iran,19/07/2011,108,0,-19,0,16,8,0,113
Iran,20/07/2011,66,4,-14,0,11,5,0,72
Iran,21/07/2011,71,0,-7,0,36,10,0,110
Iran,22/07/2011,98,0,-9,0,36,6,0,131
Iran,23/07/2011,114,0,0,0,12,2,0,128
Iran,24/07/2011,44,0,0,0,28,1,0,73
Iran,25/07/2011,56,0,0,0,63,1,0,120
Iran,26/07/2011,81,0,0,0,9,8,0,98
Iran,27/07/2011,47,0,-8,0,28,9,0,76
Iran,28/07/2011,77,0,-14,0,21,9,0,93
Iran,29/07/2011,125,0,-4,0,74,6,0,201
Iran,30/07/2011,217,0,-5,0,16,8,0,236
Iran,31/07/2011,68,0,-6,0,62,8,0,132
Iraq,01/07/2011,127,0,-9,0,19,11,0,148
Iraq,02/07/2011,65,0,-4,0,28,20,0,109
Iraq,03/07/2011,119,2,-2,0,36,17,0,172
Iraq,04/07/2011,55,0,-2,0,5,16,0,74
Iraq,05/07/2011,71,0,0,0,42,7,0,120
Iraq,06/07/2011,155,0,0,0,4,15,0,174
Iraq,07/07/2011,125,4,4,0,37,12,0,182
Iraq,08/07/2011,124,0,0,0,52,31,0,207
Iraq,09/07/2011,71,0,-3,0,10,6,0,84
Iraq,10/07/2011,63,2,-1,0,14,7,0,85
Iraq,11/07/2011,119,0,-13,0,27,4,0,137
Iraq,12/07/2011,134,0,-3,0,57,5,0,193
Iraq,13/07/2011,183,4,3,0,20,8,0,218
Iraq,14/07/2011,229,4,0,0,29,18,0,280
Iraq,15/07/2011,189,2,0,0,28,11,0,230
Iraq,16/07/2011,67,4,1,0,10,5,0,87
Iraq,17/07/2011,111,0,-2,0,42,5,0,156
Iraq,18/07/2011,212,0,-10,0,14,11,0,227
Iraq,19/07/2011,157,0,1,0,33,8,0,199
Iraq,20/07/2011,115,0,0,0,29,4,0,148
Iraq,21/07/2011,37,0,-1,0,21,10,0,67
Iraq,22/07/2011,149,2,0,0,16,18,0,185
Iraq,23/07/2011,96,0,-1,0,8,11,0,114
Iraq,24/07/2011,416,10,-4,0,150,65,0,637
Iraq,25/07/2011,202,6,1,0,30,29,0,268
Iraq,26/07/2011,98,10,-5,0,55,18,0,176
Iraq,27/07/2011,139,4,1,0,43,8,0,195
Iraq,28/07/2011,162,0,0,0,50,19,0,231
Iraq,29/07/2011,472,16,7,0,216,88,0,799
Iraq,30/07/2011,316,10,0,0,143,48,0,517
Iraq,31/07/2011,113,2,0,0,30,7,0,152
Morocco,01/07/2011,15,0,-2,0,-3,9,0,19
Morocco,02/07/2011,4,0,0,0,-1,6,0,9
Morocco,03/07/2011,9,0,0,0,-2,3,0,10
Morocco,04/07/2011,4,0,0,0,1,5,0,10
Morocco,05/07/2011,9,0,0,0,0,1,0,10
Morocco,06/07/2011,11,0,0,0,0,1,0,12
Morocco,07/07/2011,11,0,0,0,-5,0,0,6
Morocco,08/07/2011,3,0,1,0,0,1,0,5
Morocco,09/07/2011,13,0,0,0,3,4,0,20
Morocco,10/07/2011,4,0,1,0,0,1,0,6
Morocco,11/07/2011,2,0,0,0,3,1,0,6
Morocco,12/07/2011,6,0,-6,0,0,0,0,0
Morocco,13/07/2011,10,0,-2,0,10,0,0,18
Morocco,14/07/2011,6,0,0,0,-2,0,0,4
Morocco,15/07/2011,9,0,0,0,0,5,0,14
Morocco,16/07/2011,4,0,0,0,0,1,0,5
Morocco,17/07/2011,2,0,0,0,6,0,0,8
Morocco,18/07/2011,7,0,0,0,1,2,0,10
Morocco,19/07/2011,32,0,0,0,13,7,0,52
Morocco,20/07/2011,15,0,0,0,1,0,0,16
Morocco,21/07/2011,10,0,0,0,0,0,0,10
Morocco,22/07/2011,3,0,0,0,6,0,0,9
Morocco,23/07/2011,0,0,0,0,3,0,0,3
Morocco,24/07/2011,0,0,0,0,0,0,0,0
Morocco,25/07/2011,2,0,0,0,0,0,0,2
Morocco,26/07/2011,23,0,0,0,6,0,0,29
Morocco,27/07/2011,15,0,0,0,0,0,0,15
Morocco,28/07/2011,18,0,0,0,9,0,0,27
Morocco,29/07/2011,1,0,0,0,-3,2,0,0
Morocco,30/07/2011,8,0,4,0,17,11,0,40
Morocco,31/07/2011,3,0,2,0,0,2,0,7
Nigeria,01/07/2011,16,0,1,0,15,4,0,36
Nigeria,02/07/2011,12,0,-2,0,9,3,0,22
Nigeria,03/07/2011,2,0,0,0,9,0,0,11
Nigeria,04/07/2011,14,0,-2,0,5,7,0,24
Nigeria,05/07/2011,7,4,0,0,22,2,0,35
Nigeria,06/07/2011,19,0,0,0,13,9,0,41
Nigeria,07/07/2011,18,0,0,0,37,8,0,63
Nigeria,08/07/2011,13,2,0,0,13,4,0,32
Nigeria,09/07/2011,11,0,0,0,0,0,0,11
Nigeria,10/07/2011,5,0,0,0,3,8,0,16
Nigeria,11/07/2011,20,0,1,0,-2,5,0,24
Nigeria,12/07/2011,4,0,0,0,15,5,0,24
Nigeria,13/07/2011,12,0,0,0,15,10,0,37
Nigeria,14/07/2011,35,0,0,0,12,1,0,48
Nigeria,15/07/2011,23,0,0,0,10,0,0,33
Nigeria,16/07/2011,9,0,0,0,9,2,0,20
Nigeria,17/07/2011,12,0,0,0,1,0,0,13
Nigeria,18/07/2011,28,0,-2,0,31,0,0,57
Nigeria,19/07/2011,45,0,0,0,23,3,0,71
Nigeria,20/07/2011,36,0,0,0,7,12,0,55
Nigeria,21/07/2011,16,0,-3,0,19,0,0,32
Nigeria,22/07/2011,3,0,0,0,14,1,0,18
Nigeria,23/07/2011,11,0,0,0,16,2,0,29
Nigeria,24/07/2011,3,0,0,0,9,2,0,14
Nigeria,25/07/2011,20,4,0,0,15,10,0,49
Nigeria,26/07/2011,31,0,1,0,15,4,0,51
Nigeria,27/07/2011,32,0,0,0,8,3,0,43
Nigeria,28/07/2011,28,0,0,0,5,4,0,37
Nigeria,29/07/2011,22,0,-4,0,18,15,0,51
Nigeria,30/07/2011,14,0,0,0,-2,1,0,13
Nigeria,31/07/2011,36,0,0,0,12,0,0,48
Pakistan,01/07/2011,56,0,0,0,24,12,0,92
Pakistan,02/07/2011,271,0,-4,0,32,28,0,327
Pakistan,03/07/2011,150,0,0,0,30,15,0,195
Pakistan,04/07/2011,139,0,-1,0,45,19,0,202
Pakistan,05/07/2011,136,2,2,0,34,23,0,197
Pakistan,06/07/2011,158,0,0,0,50,15,0,223
Pakistan,07/07/2011,146,0,-4,0,11,17,0,170
Pakistan,08/07/2011,174,0,-4,0,76,17,0,263
Pakistan,09/07/2011,95,0,-2,0,63,12,0,168
Pakistan,10/07/2011,127,4,-7,0,16,9,0,149
Pakistan,11/07/2011,80,0,-7,0,10,19,0,102
Pakistan,12/07/2011,122,0,1,0,31,7,0,161
Pakistan,13/07/2011,258,4,0,0,53,52,0,367
Pakistan,14/07/2011,248,0,0,0,24,45,0,317
Pakistan,15/07/2011,131,4,-2,0,32,8,0,173
Pakistan,16/07/2011,72,0,0,0,6,11,0,89
Pakistan,17/07/2011,92,0,-6,0,45,10,0,141
Pakistan,18/07/2011,147,0,-2,0,21,6,0,172
Pakistan,19/07/2011,266,2,0,0,66,11,0,345
Pakistan,20/07/2011,252,2,3,0,55,5,0,317
Pakistan,21/07/2011,179,2,-2,0,80,12,0,271
Pakistan,22/07/2011,130,0,0,0,18,6,0,154
Pakistan,23/07/2011,100,0,-2,0,34,8,0,140
Pakistan,24/07/2011,112,0,-2,0,22,8,0,140
Pakistan,25/07/2011,62,0,0,0,18,5,0,85
Pakistan,26/07/2011,93,6,0,0,39,9,0,147
Pakistan,27/07/2011,155,0,4,0,34,33,0,226
Pakistan,28/07/2011,95,6,0,0,37,12,0,150
Pakistan,29/07/2011,190,4,-9,0,51,7,0,243
Pakistan,30/07/2011,201,2,2,0,18,22,0,245
Pakistan,31/07/2011,75,0,-2,0,37,9,0,119
Sierra Leone,01/07/2011,4,0,0,0,18,10,0,32
Sierra Leone,02/07/2011,23,0,0,0,0,0,0,23
Sierra Leone,03/07/2011,0,0,0,0,0,0,0,0
Sierra Leone,04/07/2011,0,0,0,0,0,0,0,0
Sierra Leone,05/07/2011,3,0,0,0,0,0,0,3
Sierra Leone,06/07/2011,0,0,0,0,0,0,0,0
Sierra Leone,07/07/2011,2,0,0,0,0,0,0,2
Sierra Leone,08/07/2011,0,0,0,0,3,0,0,3
Sierra Leone,09/07/2011,0,0,0,0,0,0,0,0
Sierra Leone,10/07/2011,2,0,0,0,0,0,0,2
Sierra Leone,11/07/2011,-1,0,0,0,0,0,0,-1
Sierra Leone,12/07/2011,-1,0,0,0,0,0,0,-1
Sierra Leone,13/07/2011,2,0,0,0,0,0,0,2
Sierra Leone,14/07/2011,0,0,0,0,0,0,0,0
Sierra Leone,15/07/2011,2,0,0,0,3,1,0,6
Sierra Leone,16/07/2011,0,0,0,0,9,0,0,9
Sierra Leone,18/07/2011,6,0,0,0,6,0,0,12
Sierra Leone,19/07/2011,-2,0,0,0,0,1,0,-1
Sierra Leone,20/07/2011,-3,0,0,0,0,0,0,-3
Sierra Leone,21/07/2011,2,0,0,0,0,0,0,2
Sierra Leone,22/07/2011,1,0,0,0,0,0,0,1
Sierra Leone,24/07/2011,-1,0,0,0,0,0,0,-1
Sierra Leone,25/07/2011,-1,0,0,0,-4,0,0,-5
Sierra Leone,26/07/2011,4,0,0,0,6,3,0,13
Sierra Leone,27/07/2011,8,0,0,0,0,2,0,10
Sierra Leone,28/07/2011,0,0,0,0,0,0,0,0
Sierra Leone,29/07/2011,11,0,0,0,0,1,0,12
Sierra Leone,31/07/2011,5,0,0,0,0,1,0,6
Somalia,01/07/2011,48,0,0,0,29,4,0,81
Somalia,02/07/2011,25,0,0,0,39,0,0,64
Somalia,03/07/2011,-3,0,0,0,12,2,0,11
Somalia,04/07/2011,39,4,1,0,38,4,0,86
Somalia,05/07/2011,101,0,-2,0,72,3,0,174
Somalia,06/07/2011,89,14,0,0,162,2,0,267
Somalia,07/07/2011,113,10,0,0,66,1,0,190
Somalia,08/07/2011,181,4,0,0,46,2,0,233
Somalia,09/07/2011,29,4,0,0,9,0,0,42
Somalia,10/07/2011,49,4,-4,0,6,0,0,55
Somalia,11/07/2011,44,6,-4,0,11,3,0,60
Somalia,12/07/2011,64,4,0,0,-10,2,0,60
Somalia,13/07/2011,42,2,0,0,34,3,0,81
Somalia,14/07/2011,48,0,0,0,-9,1,0,40
Somalia,15/07/2011,70,0,0,0,-27,3,0,46
Somalia,16/07/2011,36,0,0,0,12,0,0,48
Somalia,17/07/2011,44,6,-4,0,15,3,0,64
Somalia,18/07/2011,74,0,0,0,6,0,0,80
Somalia,19/07/2011,77,10,-1,0,29,2,0,117
Somalia,20/07/2011,135,16,-2,0,9,3,0,161
Somalia,21/07/2011,70,6,0,0,29,3,0,108
Somalia,22/07/2011,147,2,1,0,47,4,0,201
Somalia,23/07/2011,43,0,0,0,10,0,0,53
Somalia,24/07/2011,33,2,0,0,12,2,0,49
Somalia,25/07/2011,54,2,0,0,31,2,0,89
Somalia,26/07/2011,47,0,-3,0,42,2,0,88
Somalia,27/07/2011,83,2,2,0,56,6,0,149
Somalia,28/07/2011,91,6,0,0,16,3,0,116
Somalia,29/07/2011,96,10,0,0,24,8,0,138
Somalia,30/07/2011,24,0,0,0,24,5,0,53
Somalia,31/07/2011,52,0,0,0,13,6,0,71
Syria,01/07/2011,57,0,0,0,29,8,0,94
Syria,02/07/2011,33,0,-5,0,19,11,0,58
Syria,03/07/2011,12,0,1,0,11,16,0,40
Syria,04/07/2011,51,0,0,0,12,23,0,86
Syria,05/07/2011,133,0,-1,0,54,15,0,201
Syria,06/07/2011,138,0,2,0,36,25,0,201
Syria,07/07/2011,110,0,0,0,34,4,0,148
Syria,08/07/2011,80,0,2,0,26,18,0,126
Syria,09/07/2011,76,2,0,0,18,4,0,100
Syria,10/07/2011,44,0,-10,0,6,6,0,46
Syria,11/07/2011,110,0,-22,0,11,31,0,130
Syria,12/07/2011,112,0,-2,0,29,44,0,183
Syria,13/07/2011,60,0,-1,0,30,28,0,117
Syria,14/07/2011,80,1,1,0,32,12,0,126
Syria,15/07/2011,25,0,-1,0,1,17,0,42
Syria,16/07/2011,59,0,1,0,5,8,0,73
Syria,17/07/2011,65,0,1,0,16,4,0,86
Syria,18/07/2011,78,0,-6,0,0,10,0,82
Syria,19/07/2011,105,0,-8,0,22,4,0,123
Syria,20/07/2011,124,0,-4,0,31,8,0,159
Syria,21/07/2011,16,0,0,0,14,0,0,30
Syria,22/07/2011,84,0,5,0,13,12,0,114
Syria,23/07/2011,58,0,1,0,15,14,0,88
Syria,24/07/2011,39,0,0,0,-2,1,0,38
Syria,25/07/2011,0,0,3,0,21,25,0,49
Syria,26/07/2011,24,0,2,0,34,9,0,69
Syria,27/07/2011,75,0,-1,0,37,14,0,125
Syria,28/07/2011,148,0,-4,0,43,5,0,192
Syria,29/07/2011,79,0,0,0,7,18,0,104
Syria,30/07/2011,82,0,1,0,-8,6,0,81
Syria,31/07/2011,400,0,-2,0,36,128,0,562
Yemen,01/07/2011,410,10,-16,0,332,89,0,825
Yemen,02/07/2011,195,2,-1,0,102,8,0,306
Yemen,03/07/2011,26,2,-1,0,6,1,0,34
Yemen,04/07/2011,12,0,1,0,6,1,0,20
Yemen,05/07/2011,32,0,0,0,47,2,0,81
Yemen,06/07/2011,208,8,-3,0,189,40,0,442
Yemen,07/07/2011,335,10,-5,0,210,46,0,596
Yemen,08/07/2011,53,0,1,0,7,14,0,75
Yemen,09/07/2011,99,0,-3,0,-4,9,0,101
Yemen,10/07/2011,32,0,-4,0,1,3,0,32
Yemen,11/07/2011,19,0,-22,0,9,4,0,10
Yemen,12/07/2011,11,0,0,0,14,4,0,29
Yemen,13/07/2011,29,0,0,0,39,1,0,69
Yemen,14/07/2011,40,0,0,0,12,9,0,61
Yemen,15/07/2011,30,0,0,0,11,9,0,50
Yemen,16/07/2011,21,0,0,0,3,2,0,26
Yemen,17/07/2011,27,0,0,0,10,8,0,45
Yemen,18/07/2011,21,0,0,0,11,5,0,37
Yemen,19/07/2011,47,0,-6,0,14,4,0,59
Yemen,20/07/2011,120,0,1,0,18,9,0,148
Yemen,21/07/2011,35,0,0,0,29,10,0,74
Yemen,22/07/2011,34,0,0,0,0,4,0,38
Yemen,23/07/2011,13,0,0,0,-2,0,0,11
Yemen,24/07/2011,17,0,0,0,-1,8,0,24
Yemen,25/07/2011,67,0,0,0,28,3,0,98
Yemen,26/07/2011,560,24,-5,0,338,57,0,974
Yemen,27/07/2011,28,0,2,0,27,2,0,59
Yemen,28/07/2011,30,0,-2,0,6,5,0,39
Yemen,29/07/2011,10,0,0,0,-4,2,0,8
Yemen,30/07/2011,24,0,0,0,6,6,0,36
Yemen,31/07/2011,14,0,-2,0,-4,1,0,9
Afghanistan,01/09/2006,19,0,0,0,6,1,0,26
Afghanistan,02/09/2006,71,0,0,0,3,1,0,75
Afghanistan,03/09/2006,156,0,0,0,5,2,0,163
Afghanistan,04/09/2006,120,0,0,0,21,2,0,143
Afghanistan,05/09/2006,83,0,0,0,17,4,0,104
Afghanistan,06/09/2006,118,0,0,0,30,7,0,155
Afghanistan,07/09/2006,73,0,-2,0,30,3,0,104
Afghanistan,08/09/2006,125,0,0,0,38,8,0,171
Afghanistan,09/09/2006,94,0,-2,0,9,3,0,104
Afghanistan,10/09/2006,134,0,-5,0,9,11,0,149
Afghanistan,11/09/2006,146,0,0,0,26,11,0,183
Afghanistan,12/09/2006,136,0,0,0,-4,11,0,143
Afghanistan,13/09/2006,119,4,0,0,45,12,0,180
Afghanistan,14/09/2006,28,0,0,0,6,6,0,40
Afghanistan,15/09/2006,129,0,0,0,16,15,0,160
Afghanistan,16/09/2006,62,0,0,0,16,10,0,88
Afghanistan,17/09/2006,41,2,0,0,9,19,0,71
Afghanistan,18/09/2006,67,0,0,0,9,29,0,105
Afghanistan,19/09/2006,108,0,0,0,24,18,0,150
Afghanistan,20/09/2006,86,4,0,0,2,11,0,103
Afghanistan,21/09/2006,131,0,1,0,3,6,0,141
Afghanistan,22/09/2006,177,0,0,0,30,11,0,218
Afghanistan,23/09/2006,102,0,0,0,9,14,0,125
Afghanistan,24/09/2006,73,0,0,0,-1,9,0,81
Afghanistan,25/09/2006,78,0,0,0,-2,4,0,80
Afghanistan,26/09/2006,107,0,0,0,30,24,0,161
Afghanistan,27/09/2006,56,2,1,0,12,4,0,75
Afghanistan,28/09/2006,96,0,0,0,14,3,0,113
Afghanistan,29/09/2006,125,0,1,0,19,6,0,151
Afghanistan,30/09/2006,47,0,0,0,-12,17,0,52
Albania,01/09/2006,5,0,0,0,4,0,0,9
Albania,02/09/2006,0,0,0,0,0,0,0,0
Albania,03/09/2006,2,0,0,0,0,0,0,2
Albania,04/09/2006,0,0,0,0,0,0,0,0
Albania,05/09/2006,4,0,0,0,3,3,0,10
Albania,06/09/2006,0,0,0,0,0,0,0,0
Albania,07/09/2006,0,0,0,0,12,0,0,12
Albania,08/09/2006,5,0,0,0,3,0,0,8
Albania,09/09/2006,0,0,0,0,6,0,0,6
Albania,10/09/2006,1,2,0,0,15,1,0,19
Albania,11/09/2006,1,0,0,0,18,0,0,19
Albania,12/09/2006,-4,0,0,0,0,0,0,-4
Albania,13/09/2006,30,0,1,0,12,6,0,49
Albania,14/09/2006,4,0,0,0,3,0,0,7
Albania,15/09/2006,17,0,0,0,-2,1,0,16
Albania,16/09/2006,16,0,0,0,0,0,0,16
Albania,17/09/2006,1,0,0,0,0,0,0,1
Albania,18/09/2006,7,0,0,0,33,1,0,41
Albania,19/09/2006,4,0,1,0,12,5,0,22
Albania,20/09/2006,3,0,0,0,-4,2,0,1
Albania,21/09/2006,10,0,0,0,3,0,0,13
Albania,22/09/2006,5,0,0,0,3,0,0,8
Albania,23/09/2006,0,0,0,0,0,0,0,0
Albania,24/09/2006,10,0,0,0,3,0,0,13
Albania,25/09/2006,16,0,-4,0,0,0,0,12
Albania,26/09/2006,10,0,0,0,0,0,0,10
Albania,27/09/2006,8,0,0,0,3,0,0,11
Albania,28/09/2006,7,0,0,0,0,0,0,7
Albania,29/09/2006,2,0,-2,0,-6,0,0,-6
Albania,30/09/2006,3,0,1,0,6,5,0,15
Algeria,01/09/2006,0,0,0,0,3,0,0,3
Algeria,02/09/2006,6,0,0,0,3,0,0,9
Algeria,03/09/2006,0,0,0,0,0,0,0,0
Algeria,04/09/2006,7,0,0,0,0,0,0,7
Algeria,05/09/2006,5,0,0,0,0,0,0,5
Algeria,06/09/2006,0,0,0,0,0,0,0,0
Algeria,07/09/2006,0,0,0,0,0,0,0,0
Algeria,08/09/2006,0,0,0,0,6,0,0,6
Algeria,10/09/2006,0,0,0,0,0,0,0,0
Algeria,11/09/2006,2,0,0,0,3,0,0,5
Algeria,12/09/2006,0,0,0,0,0,0,0,0
Algeria,13/09/2006,2,0,0,0,0,0,0,2
Algeria,14/09/2006,11,0,0,0,0,0,0,11
Algeria,15/09/2006,4,0,0,0,0,0,0,4
Algeria,16/09/2006,4,0,0,0,0,0,0,4
Algeria,17/09/2006,0,0,0,0,3,0,0,3
Algeria,18/09/2006,0,0,0,0,-10,0,0,-10
Algeria,19/09/2006,0,0,-1,0,3,0,0,2
Algeria,20/09/2006,0,0,0,0,3,0,0,3
Algeria,21/09/2006,1,0,0,0,10,0,0,11
Algeria,22/09/2006,4,0,0,0,6,0,0,10
Algeria,23/09/2006,1,0,0,0,-2,0,0,-1
Algeria,24/09/2006,6,0,0,0,0,0,0,6
Algeria,25/09/2006,0,0,0,0,0,0,0,0
Algeria,26/09/2006,1,0,0,0,6,0,0,7
Algeria,27/09/2006,6,0,0,0,0,3,0,9
Algeria,28/09/2006,0,0,0,0,7,0,0,7
Algeria,29/09/2006,3,0,0,0,0,0,0,3
Algeria,30/09/2006,0,0,0,0,0,0,0,0
Bangladesh,01/09/2006,14,0,0,0,0,4,0,18
Bangladesh,02/09/2006,5,0,0,0,3,0,0,8
Bangladesh,03/09/2006,0,0,0,0,-1,1,0,0
Bangladesh,04/09/2006,13,0,0,0,0,0,0,13
Bangladesh,05/09/2006,8,0,0,0,9,0,0,17
Bangladesh,06/09/2006,2,0,0,0,0,0,0,2
Bangladesh,07/09/2006,11,0,0,0,3,2,0,16
Bangladesh,08/09/2006,0,0,0,0,0,0,0,0
Bangladesh,09/09/2006,4,0,0,0,0,0,0,4
Bangladesh,10/09/2006,6,0,0,0,-2,2,0,6
Bangladesh,11/09/2006,8,0,2,0,0,2,0,12
Bangladesh,12/09/2006,1,0,0,0,0,0,0,1
Bangladesh,13/09/2006,4,0,0,0,0,0,0,4
Bangladesh,14/09/2006,-2,0,0,0,6,1,0,5
Bangladesh,15/09/2006,2,0,0,0,3,1,0,6
Bangladesh,16/09/2006,4,0,0,0,11,0,0,15
Bangladesh,17/09/2006,2,0,0,0,0,0,0,2
Bangladesh,18/09/2006,5,0,0,0,6,3,0,14
Bangladesh,19/09/2006,5,0,0,0,0,0,0,5
Bangladesh,20/09/2006,0,0,0,0,0,1,0,1
Bangladesh,21/09/2006,4,2,0,0,3,0,0,9
Bangladesh,22/09/2006,4,0,0,0,0,0,0,4
Bangladesh,23/09/2006,5,0,0,0,0,1,0,6
Bangladesh,24/09/2006,8,0,0,0,0,1,0,9
Bangladesh,25/09/2006,7,0,0,0,3,0,0,10
Bangladesh,26/09/2006,2,0,0,0,3,0,0,5
Bangladesh,27/09/2006,14,0,0,0,0,3,0,17
Bangladesh,28/09/2006,-1,0,-2,0,6,0,0,3
Bangladesh,29/09/2006,2,0,-4,0,9,0,0,7
Bangladesh,30/09/2006,9,0,-2,0,0,0,0,7
Cameroon,01/09/2006,0,0,0,0,3,0,0,3
Cameroon,02/09/2006,3,0,0,0,3,0,0,6
Cameroon,04/09/2006,0,0,0,0,0,0,0,0
Cameroon,05/09/2006,2,0,0,0,0,0,0,2
Cameroon,06/09/2006,5,0,0,0,-2,0,0,3
Cameroon,07/09/2006,0,0,0,0,0,0,0,0
Cameroon,08/09/2006,4,0,0,0,6,0,0,10
Cameroon,09/09/2006,0,0,0,0,3,0,0,3
Cameroon,11/09/2006,4,0,0,0,3,0,0,7
Cameroon,12/09/2006,2,0,0,0,0,2,0,4
Cameroon,14/09/2006,2,0,0,0,3,0,0,5
Cameroon,15/09/2006,0,0,0,0,0,0,0,0
Cameroon,17/09/2006,0,0,0,0,-6,0,0,-6
Cameroon,18/09/2006,0,0,0,0,0,0,0,0
Cameroon,19/09/2006,0,0,0,0,0,0,0,0
Cameroon,20/09/2006,15,0,0,0,0,0,0,15
Cameroon,22/09/2006,3,0,0,0,3,0,0,6
Cameroon,25/09/2006,1,0,0,0,0,0,0,1
Cameroon,26/09/2006,0,0,0,0,0,0,0,0
Cameroon,27/09/2006,0,0,0,0,0,0,0,0
Cameroon,28/09/2006,5,0,0,0,0,2,0,7
Cameroon,29/09/2006,0,0,0,0,0,0,0,0
Cameroon,30/09/2006,0,0,0,0,0,0,0,0
China,01/09/2006,38,0,0,0,10,6,0,54
China,02/09/2006,45,0,0,0,14,4,0,63
China,03/09/2006,29,0,0,0,2,1,0,32
China,04/09/2006,45,0,-3,0,7,4,0,53
China,05/09/2006,45,0,0,0,9,6,0,60
China,06/09/2006,49,2,2,0,4,2,0,59
China,07/09/2006,53,2,0,0,3,2,0,60
China,08/09/2006,22,0,-1,0,0,0,0,21
China,09/09/2006,10,0,-3,0,9,0,0,16
China,10/09/2006,13,0,-8,0,4,1,0,10
China,11/09/2006,39,0,0,0,8,2,0,49
China,12/09/2006,38,0,-6,0,15,25,0,72
China,13/09/2006,46,2,-6,0,6,15,0,63
China,14/09/2006,9,0,-1,0,3,1,0,12
China,15/09/2006,41,0,0,0,14,4,0,59
China,16/09/2006,40,0,-2,0,4,0,0,42
China,17/09/2006,21,0,-4,0,-2,1,0,16
China,18/09/2006,35,0,0,0,-3,6,0,38
China,19/09/2006,30,0,0,0,11,1,0,42
China,20/09/2006,23,0,-1,0,6,3,0,31
China,21/09/2006,20,0,0,0,9,1,0,30
China,22/09/2006,22,0,3,0,20,3,0,48
China,23/09/2006,43,0,0,0,3,0,0,46
China,24/09/2006,9,0,2,0,0,0,0,11
China,25/09/2006,3,0,0,0,19,1,0,23
China,26/09/2006,11,0,-1,0,6,1,0,17
China,27/09/2006,12,4,0,0,6,1,0,23
China,28/09/2006,38,0,-1,0,6,1,0,44
China,29/09/2006,13,0,1,0,19,4,0,37
China,30/09/2006,-2,0,0,0,2,4,0,4
Egypt,01/09/2006,5,0,0,0,-8,0,0,-3
Egypt,02/09/2006,8,0,0,0,-2,1,0,7
Egypt,03/09/2006,31,0,0,0,5,0,0,36
Egypt,04/09/2006,7,0,0,0,-8,0,0,-1
Egypt,05/09/2006,23,0,0,0,-6,0,0,17
Egypt,06/09/2006,30,0,0,0,10,2,0,42
Egypt,07/09/2006,3,0,3,0,12,0,0,18
Egypt,08/09/2006,3,0,-3,0,8,0,0,8
Egypt,09/09/2006,2,0,0,0,7,2,0,11
Egypt,10/09/2006,8,0,0,0,6,0,0,14
Egypt,11/09/2006,6,0,0,0,4,0,0,10
Egypt,12/09/2006,8,0,0,0,1,0,0,9
Egypt,13/09/2006,8,0,0,0,0,0,0,8
Egypt,14/09/2006,3,0,0,0,0,0,0,3
Egypt,15/09/2006,23,0,0,0,9,0,0,32
Egypt,16/09/2006,36,0,0,0,13,0,0,49
Egypt,17/09/2006,13,0,0,0,3,0,0,16
Egypt,18/09/2006,17,0,0,0,11,2,0,30
Egypt,19/09/2006,14,0,0,0,11,1,0,26
Egypt,20/09/2006,16,0,0,0,4,3,0,23
Egypt,21/09/2006,20,0,0,0,10,0,0,30
Egypt,22/09/2006,42,0,1,0,4,14,0,61
Egypt,23/09/2006,10,0,1,0,0,0,0,11
Egypt,24/09/2006,11,0,0,0,21,0,0,32
Egypt,25/09/2006,9,0,1,0,24,0,0,34
Egypt,26/09/2006,11,0,1,0,0,1,0,13
Egypt,27/09/2006,22,0,0,0,-27,4,0,-1
Egypt,28/09/2006,18,0,0,0,13,2,0,33
Egypt,29/09/2006,40,0,0,0,20,6,0,66
Egypt,30/09/2006,11,0,0,0,0,2,0,13
Eritrea,01/09/2006,0,0,0,0,-4,0,0,-4
Eritrea,02/09/2006,1,0,0,0,0,0,0,1
Eritrea,03/09/2006,1,0,0,0,0,0,0,1
Eritrea,04/09/2006,0,0,0,0,0,0,0,0
Eritrea,05/09/2006,9,0,0,0,6,0,0,15
Eritrea,06/09/2006,-5,0,0,0,18,0,0,13
Eritrea,07/09/2006,0,0,0,0,0,0,0,0
Eritrea,09/09/2006,0,0,0,0,0,0,0,0
Eritrea,10/09/2006,0,0,0,0,0,0,0,0
Eritrea,13/09/2006,0,0,0,0,6,0,0,6
Eritrea,14/09/2006,2,0,0,0,0,0,0,2
Eritrea,15/09/2006,9,0,0,0,0,0,0,9
Eritrea,16/09/2006,16,0,0,0,0,0,0,16
Eritrea,17/09/2006,-1,0,0,0,0,0,0,-1
Eritrea,18/09/2006,3,0,0,0,0,0,0,3
Eritrea,19/09/2006,6,0,0,0,0,0,0,6
Eritrea,20/09/2006,3,0,0,0,0,0,0,3
Eritrea,21/09/2006,3,0,0,0,0,0,0,3
Eritrea,23/09/2006,0,0,0,0,3,6,0,9
Eritrea,25/09/2006,0,0,0,0,0,0,0,0
Eritrea,26/09/2006,2,0,1,0,12,0,0,15
Eritrea,27/09/2006,2,0,0,0,0,0,0,2
Eritrea,28/09/2006,0,0,0,0,0,0,0,0
Eritrea,29/09/2006,0,0,0,0,0,0,0,0
Eritrea,30/09/2006,0,0,0,0,0,0,0,0
Georgia,01/09/2006,0,0,0,0,0,0,0,0
Georgia,02/09/2006,0,0,0,0,0,0,0,0
Georgia,04/09/2006,0,0,0,0,0,0,0,0
Georgia,05/09/2006,0,0,1,0,0,0,0,1
Georgia,06/09/2006,3,0,0,0,6,3,0,12
Georgia,07/09/2006,3,0,0,0,4,0,0,7
Georgia,08/09/2006,0,0,0,0,0,0,0,0
Georgia,09/09/2006,0,0,0,0,0,0,0,0
Georgia,10/09/2006,0,2,0,0,-2,0,0,0
Georgia,11/09/2006,0,0,0,0,0,0,0,0
Georgia,12/09/2006,3,0,0,0,0,0,0,3
Georgia,13/09/2006,2,0,0,0,0,0,0,2
Georgia,14/09/2006,0,0,0,0,0,0,0,0
Georgia,15/09/2006,6,0,0,0,9,2,0,17
Georgia,16/09/2006,5,0,0,0,0,0,0,5
Georgia,18/09/2006,-3,0,0,0,6,0,0,3
Georgia,19/09/2006,3,0,0,0,6,0,0,9
Georgia,20/09/2006,6,0,0,0,0,0,0,6
Georgia,21/09/2006,3,0,0,0,0,0,0,3
Georgia,22/09/2006,10,0,0,0,0,0,0,10
Georgia,23/09/2006,1,0,0,0,0,0,0,1
Georgia,24/09/2006,0,0,0,0,0,0,0,0
Georgia,25/09/2006,1,0,0,0,0,0,0,1
Georgia,26/09/2006,0,0,0,0,0,1,0,1
Georgia,27/09/2006,0,0,0,0,-2,0,0,-2
Georgia,28/09/2006,0,0,0,0,3,8,0,11
Georgia,29/09/2006,8,0,2,0,12,0,0,22
Georgia,30/09/2006,-2,0,0,0,0,0,0,-2
India,01/09/2006,6,0,0,0,6,0,0,12
India,02/09/2006,13,0,0,0,3,4,0,20
India,03/09/2006,1,0,0,0,6,2,0,9
India,04/09/2006,4,0,0,0,0,0,0,4
India,05/09/2006,25,0,0,0,19,4,0,48
India,06/09/2006,2,0,0,0,-2,0,0,0
India,07/09/2006,8,0,-2,0,-3,0,0,3
India,08/09/2006,13,0,0,0,6,5,0,24
India,09/09/2006,-2,0,-1,0,0,1,0,-2
India,10/09/2006,11,0,0,0,0,2,0,13
India,11/09/2006,14,0,0,0,-5,2,0,11
India,12/09/2006,1,0,0,0,-2,1,0,0
India,13/09/2006,9,0,0,0,4,2,0,15
India,14/09/2006,3,0,0,0,0,6,0,9
India,15/09/2006,31,2,1,0,1,2,0,37
India,16/09/2006,2,0,0,0,6,2,0,10
India,17/09/2006,7,0,0,0,3,1,0,11
India,18/09/2006,36,0,0,0,-2,0,0,34
India,19/09/2006,25,0,0,0,6,8,0,39
India,20/09/2006,37,0,0,0,0,3,0,40
India,21/09/2006,21,0,0,0,0,0,0,21
India,22/09/2006,9,0,0,0,0,2,0,11
India,23/09/2006,18,0,0,0,4,3,0,25
India,24/09/2006,0,0,0,0,0,0,0,0
India,25/09/2006,56,0,-2,0,0,3,0,57
India,26/09/2006,29,0,0,0,3,0,0,32
India,27/09/2006,14,0,0,0,5,2,0,21
India,28/09/2006,3,0,-6,0,6,0,0,3
India,29/09/2006,6,0,0,0,0,3,0,9
India,30/09/2006,0,0,-4,0,3,0,0,-1
Iran,01/09/2006,37,0,6,0,32,4,0,79
Iran,02/09/2006,27,0,0,0,3,2,0,32
Iran,03/09/2006,32,2,0,0,-2,0,0,32
Iran,04/09/2006,25,0,0,0,6,3,0,34
Iran,05/09/2006,42,6,2,0,17,16,0,83
Iran,06/09/2006,80,0,0,0,9,0,0,89
Iran,07/09/2006,38,0,0,0,2,5,0,45
Iran,08/09/2006,42,0,0,0,6,4,0,52
Iran,09/09/2006,76,0,0,0,19,7,0,102
Iran,10/09/2006,30,0,0,0,3,5,0,38
Iran,11/09/2006,67,0,1,0,5,10,0,83
Iran,12/09/2006,26,0,0,0,20,2,0,48
Iran,13/09/2006,28,0,-9,0,30,10,0,59
Iran,14/09/2006,10,0,0,0,9,0,0,19
Iran,15/09/2006,109,0,0,0,26,3,0,138
Iran,16/09/2006,48,0,0,0,1,0,0,49
Iran,17/09/2006,27,0,0,0,1,5,0,33
Iran,18/09/2006,80,0,1,0,16,11,0,108
Iran,19/09/2006,120,0,-5,0,16,23,0,154
Iran,20/09/2006,58,0,-2,0,19,4,0,79
Iran,21/09/2006,49,0,1,0,38,18,0,106
Iran,22/09/2006,49,2,1,0,6,5,0,63
Iran,23/09/2006,22,0,1,0,13,5,0,41
Iran,24/09/2006,7,0,2,0,0,0,0,9
Iran,25/09/2006,16,0,0,0,35,1,0,52
Iran,26/09/2006,26,0,0,0,8,2,0,36
Iran,27/09/2006,35,0,0,0,4,0,0,39
Iran,28/09/2006,29,0,0,0,22,7,0,58
Iran,29/09/2006,4,0,0,0,3,5,0,12
Iran,30/09/2006,15,0,0,0,0,1,0,16
Iraq,01/09/2006,60,0,1,0,-3,7,0,65
Iraq,02/09/2006,48,0,1,0,27,0,0,76
Iraq,03/09/2006,81,0,-2,0,27,6,0,112
Iraq,04/09/2006,116,0,0,0,19,21,0,156
Iraq,05/09/2006,120,0,-6,0,32,25,0,171
Iraq,06/09/2006,111,0,-13,0,5,14,0,117
Iraq,07/09/2006,133,0,-6,0,70,17,0,214
Iraq,08/09/2006,72,0,-3,0,11,8,0,88
Iraq,09/09/2006,54,0,0,0,0,7,0,61
Iraq,10/09/2006,73,0,-10,0,11,14,0,88
Iraq,11/09/2006,119,0,0,0,24,28,0,171
Iraq,12/09/2006,122,0,0,0,30,29,0,181
Iraq,13/09/2006,142,2,-14,0,31,14,0,175
Iraq,14/09/2006,41,0,0,0,5,0,0,46
Iraq,15/09/2006,65,0,-1,0,9,3,0,76
Iraq,16/09/2006,85,0,3,0,15,5,0,108
Iraq,17/09/2006,71,2,0,0,3,4,0,80
Iraq,18/09/2006,85,0,0,0,57,34,0,176
Iraq,19/09/2006,108,0,0,0,49,32,0,189
Iraq,20/09/2006,86,0,-1,0,53,14,0,152
Iraq,21/09/2006,97,2,0,0,58,18,0,175
Iraq,22/09/2006,71,2,4,0,42,6,0,125
Iraq,23/09/2006,100,0,2,0,16,11,0,129
Iraq,24/09/2006,118,0,0,0,10,1,0,129
Iraq,25/09/2006,95,0,1,0,22,11,0,129
Iraq,26/09/2006,186,0,3,0,46,7,0,242
Iraq,27/09/2006,103,0,0,0,21,4,0,128
Iraq,28/09/2006,130,0,-1,0,63,14,0,206
Iraq,29/09/2006,78,0,-1,0,2,16,0,95
Iraq,30/09/2006,88,0,0,0,33,14,0,135
Morocco,01/09/2006,3,0,0,0,9,0,0,12
Morocco,03/09/2006,0,0,0,0,0,0,0,0
Morocco,04/09/2006,2,0,0,0,3,0,0,5
Morocco,05/09/2006,2,0,0,0,3,1,0,6
Morocco,06/09/2006,0,6,0,0,0,0,0,6
Morocco,07/09/2006,0,0,0,0,6,0,0,6
Morocco,08/09/2006,3,0,0,0,18,0,0,21
Morocco,09/09/2006,0,0,0,0,0,0,0,0
Morocco,10/09/2006,3,0,0,0,0,0,0,3
Morocco,11/09/2006,3,0,0,0,0,0,0,3
Morocco,13/09/2006,0,0,0,0,0,1,0,1
Morocco,14/09/2006,1,0,0,0,6,0,0,7
Morocco,15/09/2006,10,0,0,0,0,0,0,10
Morocco,16/09/2006,14,0,0,0,0,1,0,15
Morocco,17/09/2006,11,0,0,0,0,4,0,15
Morocco,18/09/2006,7,0,0,0,0,0,0,7
Morocco,19/09/2006,4,0,0,0,11,0,0,15
Morocco,20/09/2006,0,0,0,0,3,0,0,3
Morocco,21/09/2006,0,0,0,0,9,0,0,9
Morocco,22/09/2006,0,0,0,0,0,0,0,0
Morocco,23/09/2006,0,0,0,0,0,0,0,0
Morocco,24/09/2006,0,0,0,0,0,0,0,0
Morocco,25/09/2006,3,0,0,0,-2,0,0,1
Morocco,26/09/2006,8,0,0,0,-2,0,0,6
Morocco,27/09/2006,3,0,0,0,0,0,0,3
Morocco,28/09/2006,2,0,0,0,-8,1,0,-5
Morocco,29/09/2006,9,0,0,0,0,0,0,9
Morocco,30/09/2006,7,0,0,0,0,2,0,9
Nigeria,01/09/2006,2,0,-1,0,3,3,0,7
Nigeria,02/09/2006,1,0,0,0,9,0,0,10
Nigeria,03/09/2006,10,2,0,0,0,0,0,12
Nigeria,04/09/2006,8,0,-2,0,6,0,0,12
Nigeria,05/09/2006,-5,2,1,0,-2,1,0,-3
Nigeria,06/09/2006,4,0,0,0,4,0,0,8
Nigeria,07/09/2006,11,0,-2,0,4,4,0,17
Nigeria,08/09/2006,26,0,2,0,2,0,0,30
Nigeria,09/09/2006,6,0,1,0,0,1,0,8
Nigeria,10/09/2006,6,0,0,0,6,0,0,12
Nigeria,11/09/2006,30,0,0,0,9,2,0,41
Nigeria,12/09/2006,19,0,0,0,9,2,0,30
Nigeria,13/09/2006,11,0,0,0,9,2,0,22
Nigeria,14/09/2006,8,0,0,0,4,2,0,14
Nigeria,15/09/2006,4,0,0,0,0,0,0,4
Nigeria,16/09/2006,2,0,0,0,0,1,0,3
Nigeria,17/09/2006,0,0,0,0,0,0,0,0
Nigeria,18/09/2006,16,0,0,0,3,0,0,19
Nigeria,19/09/2006,18,0,0,0,3,2,0,23
Nigeria,20/09/2006,25,0,-1,0,2,7,0,33
Nigeria,21/09/2006,18,0,-4,0,10,1,0,25
Nigeria,22/09/2006,1,0,5,0,4,1,0,11
Nigeria,23/09/2006,6,0,0,0,0,1,0,7
Nigeria,24/09/2006,4,0,1,0,3,0,0,8
Nigeria,25/09/2006,8,0,0,0,9,0,0,17
Nigeria,26/09/2006,15,0,1,0,10,0,0,26
Nigeria,27/09/2006,8,0,1,0,9,1,0,19
Nigeria,28/09/2006,10,0,0,0,21,1,0,32
Nigeria,29/09/2006,12,0,0,0,12,1,0,25
Nigeria,30/09/2006,4,0,0,0,0,0,0,4
Pakistan,01/09/2006,10,0,0,0,3,0,0,13
Pakistan,02/09/2006,83,0,0,0,4,27,0,114
Pakistan,03/09/2006,46,0,0,0,9,8,0,63
Pakistan,04/09/2006,30,0,0,0,13,4,0,47
Pakistan,05/09/2006,36,0,0,0,11,0,0,47
Pakistan,06/09/2006,39,0,0,0,18,8,0,65
Pakistan,07/09/2006,30,0,0,0,48,1,0,79
Pakistan,08/09/2006,29,0,0,0,27,0,0,56
Pakistan,09/09/2006,24,0,0,0,28,4,0,56
Pakistan,10/09/2006,28,0,0,0,10,0,0,38
Pakistan,11/09/2006,13,0,0,0,24,4,0,41
Pakistan,12/09/2006,28,0,0,0,12,7,0,47
Pakistan,13/09/2006,37,0,0,0,6,0,0,43
Pakistan,14/09/2006,11,0,0,0,15,7,0,33
Pakistan,15/09/2006,33,0,0,0,60,12,0,105
Pakistan,16/09/2006,49,0,0,0,39,3,0,91
Pakistan,17/09/2006,38,0,0,0,-2,4,0,40
Pakistan,18/09/2006,39,0,0,0,22,3,0,64
Pakistan,19/09/2006,54,0,0,0,9,3,0,66
Pakistan,20/09/2006,42,0,0,0,9,2,0,53
Pakistan,21/09/2006,40,0,-1,0,30,5,0,74
Pakistan,22/09/2006,141,0,0,0,39,4,0,184
Pakistan,23/09/2006,60,0,0,0,18,15,0,93
Pakistan,24/09/2006,38,0,0,0,-3,2,0,37
Pakistan,25/09/2006,56,0,0,0,-6,3,0,53
Pakistan,26/09/2006,36,0,0,0,13,4,0,53
Pakistan,27/09/2006,52,0,-2,0,5,1,0,56
Pakistan,28/09/2006,35,0,0,0,-1,6,0,40
Pakistan,29/09/2006,21,0,-1,0,6,7,0,33
Pakistan,30/09/2006,17,0,0,0,0,0,0,17
Sierra Leone,01/09/2006,0,0,0,0,0,0,0,0
Sierra Leone,03/09/2006,2,0,0,0,0,0,0,2
Sierra Leone,04/09/2006,0,0,0,0,0,0,0,0
Sierra Leone,05/09/2006,1,0,0,0,0,0,0,1
Sierra Leone,07/09/2006,2,0,0,0,0,0,0,2
Sierra Leone,08/09/2006,0,0,0,0,0,0,0,0
Sierra Leone,09/09/2006,0,0,0,0,0,0,0,0
Sierra Leone,11/09/2006,0,0,0,0,0,0,0,0
Sierra Leone,12/09/2006,2,0,0,0,0,0,0,2
Sierra Leone,13/09/2006,0,0,0,0,6,1,0,7
Sierra Leone,14/09/2006,3,0,0,0,6,0,0,9
Sierra Leone,15/09/2006,2,0,0,0,6,0,0,8
Sierra Leone,17/09/2006,0,0,0,0,0,0,0,0
Sierra Leone,18/09/2006,1,0,0,0,3,0,0,4
Sierra Leone,19/09/2006,0,0,0,0,0,0,0,0
Sierra Leone,20/09/2006,-1,0,0,0,0,0,0,-1
Sierra Leone,21/09/2006,2,0,0,0,1,0,0,3
Sierra Leone,22/09/2006,1,0,0,0,0,6,0,7
Sierra Leone,23/09/2006,1,0,0,0,0,6,0,7
Sierra Leone,25/09/2006,0,0,0,0,3,0,0,3
Sierra Leone,26/09/2006,6,0,0,0,0,0,0,6
Sierra Leone,27/09/2006,10,0,0,0,0,5,0,15
Sierra Leone,28/09/2006,10,0,0,0,-2,5,0,13
Sierra Leone,29/09/2006,2,0,0,0,-6,0,0,-4
Sierra Leone,30/09/2006,0,0,0,0,0,0,0,0
Somalia,01/09/2006,-2,0,0,0,0,0,0,-2
Somalia,02/09/2006,5,0,0,0,0,0,0,5
Somalia,03/09/2006,5,0,0,0,0,0,0,5
Somalia,04/09/2006,12,2,0,0,5,0,0,19
Somalia,05/09/2006,9,2,0,0,9,1,0,21
Somalia,06/09/2006,5,6,0,0,0,0,0,11
Somalia,07/09/2006,8,0,0,0,0,0,0,8
Somalia,08/09/2006,2,0,0,0,0,2,0,4
Somalia,09/09/2006,10,0,0,0,3,1,0,14
Somalia,10/09/2006,8,0,0,0,3,0,0,11
Somalia,11/09/2006,0,0,0,0,0,0,0,0
Somalia,12/09/2006,11,0,0,0,3,0,0,14
Somalia,13/09/2006,0,0,0,0,0,0,0,0
Somalia,14/09/2006,6,0,0,0,0,0,0,6
Somalia,15/09/2006,7,0,0,0,18,8,0,33
Somalia,16/09/2006,12,0,0,0,3,0,0,15
Somalia,17/09/2006,18,0,0,0,0,0,0,18
Somalia,18/09/2006,43,0,0,0,3,0,0,46
Somalia,19/09/2006,46,0,0,0,0,6,0,52
Somalia,20/09/2006,46,2,0,0,15,2,0,65
Somalia,21/09/2006,10,0,0,0,6,0,0,16
Somalia,22/09/2006,18,0,0,0,13,0,0,31
Somalia,23/09/2006,4,0,0,0,10,0,0,14
Somalia,24/09/2006,4,0,0,0,-3,0,0,1
Somalia,25/09/2006,13,0,0,0,3,0,0,16
Somalia,26/09/2006,5,0,2,0,3,0,0,10
Somalia,27/09/2006,6,0,0,0,6,0,0,12
Somalia,28/09/2006,3,0,0,0,9,0,0,12
Somalia,29/09/2006,3,0,0,0,0,1,0,4
Somalia,30/09/2006,20,0,0,0,0,0,0,20
Syria,01/09/2006,-3,0,0,0,9,0,0,6
Syria,02/09/2006,11,0,0,0,12,0,0,23
Syria,03/09/2006,6,0,0,0,3,1,0,10
Syria,04/09/2006,19,0,-2,0,-2,2,0,17
Syria,05/09/2006,53,0,0,0,0,6,0,59
Syria,06/09/2006,36,0,0,0,3,0,0,39
Syria,07/09/2006,6,0,0,0,12,0,0,18
Syria,08/09/2006,26,0,0,0,3,2,0,31
Syria,09/09/2006,20,0,0,0,0,0,0,20
Syria,10/09/2006,33,0,0,0,24,14,0,71
Syria,11/09/2006,12,0,0,0,7,6,0,25
Syria,12/09/2006,8,0,0,0,1,5,0,14
Syria,13/09/2006,20,0,0,0,0,2,0,22
Syria,14/09/2006,0,0,0,0,0,2,0,2
Syria,15/09/2006,31,0,1,0,12,3,0,47
Syria,16/09/2006,2,0,0,0,1,0,0,3
Syria,17/09/2006,3,4,0,0,4,3,0,14
Syria,18/09/2006,9,0,0,0,-1,0,0,8
Syria,19/09/2006,23,0,0,0,53,0,0,76
Syria,20/09/2006,7,0,0,0,24,3,0,34
Syria,21/09/2006,16,0,0,0,12,2,0,30
Syria,22/09/2006,15,0,0,0,0,0,0,15
Syria,23/09/2006,-5,0,0,0,6,4,0,5
Syria,24/09/2006,7,0,0,0,4,13,0,24
Syria,25/09/2006,22,0,1,0,1,7,0,31
Syria,26/09/2006,-2,0,1,0,-12,1,0,-12
Syria,27/09/2006,21,0,2,0,7,2,0,32
Syria,28/09/2006,12,0,0,0,10,0,0,22
Syria,29/09/2006,3,0,0,0,6,0,0,9
Syria,30/09/2006,4,0,0,0,6,7,0,17
Yemen,01/09/2006,0,0,0,0,0,0,0,0
Yemen,02/09/2006,0,0,0,0,0,0,0,0
Yemen,03/09/2006,0,0,0,0,0,0,0,0
Yemen,04/09/2006,0,0,0,0,0,0,0,0
Yemen,05/09/2006,2,0,0,0,3,3,0,8
Yemen,06/09/2006,12,0,0,0,12,2,0,26
Yemen,07/09/2006,0,0,0,0,12,4,0,16
Yemen,08/09/2006,5,0,0,0,9,0,0,14
Yemen,09/09/2006,6,0,0,0,9,0,0,15
Yemen,10/09/2006,0,0,0,0,6,5,0,11
Yemen,11/09/2006,24,0,0,0,18,0,0,42
Yemen,12/09/2006,4,0,0,0,0,3,0,7
Yemen,13/09/2006,0,0,0,0,15,1,0,16
Yemen,14/09/2006,1,0,0,0,0,2,0,3
Yemen,15/09/2006,10,0,0,0,6,0,0,16
Yemen,16/09/2006,24,0,0,0,9,6,0,39
Yemen,17/09/2006,28,0,0,0,6,0,0,34
Yemen,18/09/2006,4,0,0,0,0,0,0,4
Yemen,19/09/2006,-2,0,0,0,3,0,0,1
Yemen,20/09/2006,0,0,0,0,5,1,0,6
Yemen,21/09/2006,0,0,0,0,0,0,0,0
Yemen,22/09/2006,2,0,0,0,-2,0,0,0
Yemen,23/09/2006,0,0,0,0,0,2,0,2
Yemen,24/09/2006,10,0,0,0,0,3,0,13
Yemen,25/09/2006,1,0,0,0,0,0,0,1
Yemen,26/09/2006,0,0,-2,0,0,0,0,-2
Yemen,27/09/2006,-3,0,0,0,-3,0,0,-6
Yemen,28/09/2006,1,0,0,0,0,0,0,1
Yemen,29/09/2006,0,0,0,0,0,0,0,0
Yemen,30/09/2006,2,0,0,0,0,0,0,2
Afghanistan,01/12/2008,210,0,-2,0,66,23,0,297
Afghanistan,02/12/2008,50,0,-16,0,-1,7,0,40
Afghanistan,03/12/2008,133,0,0,0,20,5,0,158
Afghanistan,04/12/2008,162,0,-16,0,16,11,0,173
Afghanistan,05/12/2008,217,0,0,0,27,35,0,279
Afghanistan,06/12/2008,175,2,0,0,18,0,0,195
Afghanistan,07/12/2008,197,4,-1,0,35,11,0,246
Afghanistan,08/12/2008,340,0,2,0,45,16,0,403
Afghanistan,09/12/2008,86,2,0,0,23,16,0,127
Afghanistan,10/12/2008,73,2,1,0,15,7,0,98
Afghanistan,11/12/2008,251,0,1,0,51,14,0,317
Afghanistan,12/12/2008,239,2,3,0,40,33,0,317
Afghanistan,13/12/2008,215,0,-4,0,5,17,0,233
Afghanistan,14/12/2008,115,4,0,0,21,18,0,158
Afghanistan,15/12/2008,148,0,0,0,37,19,0,204
Afghanistan,16/12/2008,316,2,5,0,56,13,0,392
Afghanistan,17/12/2008,150,0,3,0,21,8,0,182
Afghanistan,18/12/2008,170,0,2,0,22,12,0,206
Afghanistan,19/12/2008,150,0,0,0,17,9,0,176
Afghanistan,20/12/2008,107,0,1,0,17,7,0,132
Afghanistan,21/12/2008,111,0,-2,0,22,1,0,132
Afghanistan,22/12/2008,154,0,-1,0,61,3,0,217
Afghanistan,23/12/2008,152,0,1,0,38,14,0,205
Afghanistan,24/12/2008,115,0,0,0,28,16,0,159
Afghanistan,25/12/2008,107,0,0,0,9,11,0,127
Afghanistan,26/12/2008,140,0,0,0,29,3,0,172
Afghanistan,27/12/2008,154,0,1,0,14,16,0,185
Afghanistan,28/12/2008,112,2,0,0,19,29,0,162
Afghanistan,29/12/2008,220,0,1,0,13,5,0,239
Afghanistan,30/12/2008,214,2,1,0,37,14,0,268
Afghanistan,31/12/2008,171,8,0,0,21,10,0,210
Albania,01/12/2008,4,0,0,0,0,0,0,4
Albania,02/12/2008,5,0,0,0,6,4,0,15
Albania,03/12/2008,3,0,0,0,-6,2,0,-1
Albania,04/12/2008,5,0,0,0,0,0,0,5
Albania,05/12/2008,3,0,0,0,0,0,0,3
Albania,06/12/2008,2,0,0,0,0,0,0,2
Albania,08/12/2008,0,0,0,0,0,0,0,0
Albania,09/12/2008,11,0,0,0,3,3,0,17
Albania,10/12/2008,2,0,-1,0,0,3,0,4
Albania,11/12/2008,9,0,0,0,-1,0,0,8
Albania,12/12/2008,0,0,0,0,4,0,0,4
Albania,13/12/2008,6,0,0,0,0,0,0,6
Albania,14/12/2008,0,0,0,0,3,0,0,3
Albania,15/12/2008,0,0,0,0,9,0,0,9
Albania,16/12/2008,3,0,1,0,6,0,0,10
Albania,17/12/2008,0,0,0,0,9,0,0,9
Albania,18/12/2008,-14,0,0,0,9,0,0,-5
Albania,19/12/2008,-9,0,0,0,0,1,0,-8
Albania,20/12/2008,0,0,0,0,0,0,0,0
Albania,21/12/2008,1,0,0,0,6,0,0,7
Albania,22/12/2008,14,0,0,0,15,4,0,33
Albania,23/12/2008,23,0,1,0,12,1,0,37
Albania,24/12/2008,6,0,0,0,1,1,0,8
Albania,25/12/2008,7,0,0,0,0,0,0,7
Albania,26/12/2008,33,0,0,0,28,6,0,67
Albania,27/12/2008,8,0,0,0,16,0,0,24
Albania,28/12/2008,21,0,0,0,7,13,0,41
Albania,29/12/2008,12,0,0,0,5,10,0,27
Albania,30/12/2008,45,0,0,0,23,11,0,79
Albania,31/12/2008,8,0,0,0,-3,8,0,13
Algeria,01/12/2008,9,0,0,0,-2,0,0,7
Algeria,02/12/2008,2,0,0,0,0,0,0,2
Algeria,03/12/2008,11,0,0,0,18,0,0,29
Algeria,04/12/2008,6,0,0,0,5,0,0,11
Algeria,05/12/2008,2,0,0,0,6,0,0,8
Algeria,06/12/2008,0,0,0,0,3,0,0,3
Algeria,07/12/2008,1,0,0,0,0,0,0,1
Algeria,08/12/2008,7,0,0,0,0,0,0,7
Algeria,09/12/2008,4,0,1,0,3,0,0,8
Algeria,10/12/2008,1,4,0,0,0,0,0,5
Algeria,11/12/2008,10,0,0,0,13,0,0,23
Algeria,12/12/2008,11,0,0,0,3,1,0,15
Algeria,13/12/2008,1,0,0,0,0,0,0,1
Algeria,14/12/2008,0,0,0,0,0,0,0,0
Algeria,15/12/2008,3,0,0,0,0,0,0,3
Algeria,16/12/2008,20,0,0,0,3,0,0,23
Algeria,17/12/2008,16,0,0,0,-7,1,0,10
Algeria,18/12/2008,22,2,0,0,1,0,0,25
Algeria,19/12/2008,21,0,0,0,-2,0,0,19
Algeria,20/12/2008,16,0,0,0,6,4,0,26
Algeria,21/12/2008,6,0,0,0,-4,4,0,6
Algeria,22/12/2008,-5,0,0,0,0,2,0,-3
Algeria,23/12/2008,-1,0,0,0,0,0,0,-1
Algeria,24/12/2008,1,0,0,0,0,0,0,1
Algeria,25/12/2008,2,0,0,0,0,0,0,2
Algeria,26/12/2008,0,0,0,0,6,0,0,6
Algeria,27/12/2008,4,0,0,0,0,0,0,4
Algeria,28/12/2008,10,0,0,0,10,0,0,20
Algeria,29/12/2008,0,0,0,0,0,0,0,0
Algeria,30/12/2008,4,0,0,0,3,6,0,13
Algeria,31/12/2008,9,0,0,0,4,0,0,13
Bangladesh,01/12/2008,18,0,0,0,14,1,0,33
Bangladesh,02/12/2008,3,0,0,0,20,5,0,28
Bangladesh,03/12/2008,8,0,0,0,6,2,0,16
Bangladesh,04/12/2008,20,0,0,0,18,0,0,38
Bangladesh,05/12/2008,40,0,1,0,19,1,0,61
Bangladesh,06/12/2008,15,0,-2,0,-1,0,0,12
Bangladesh,07/12/2008,6,0,0,0,0,0,0,6
Bangladesh,08/12/2008,18,0,0,0,4,0,0,22
Bangladesh,09/12/2008,0,0,0,0,0,1,0,1
Bangladesh,10/12/2008,-1,0,1,0,0,0,0,0
Bangladesh,11/12/2008,5,0,1,0,0,0,0,6
Bangladesh,12/12/2008,7,0,1,0,3,0,0,11
Bangladesh,13/12/2008,0,0,0,0,0,0,0,0
Bangladesh,14/12/2008,0,0,0,0,6,0,0,6
Bangladesh,15/12/2008,4,0,0,0,2,0,0,6
Bangladesh,16/12/2008,7,0,0,0,1,2,0,10
Bangladesh,17/12/2008,-1,0,0,0,2,1,0,2
Bangladesh,18/12/2008,6,0,0,0,5,0,0,11
Bangladesh,19/12/2008,10,0,3,0,4,1,0,18
Bangladesh,20/12/2008,24,0,0,0,8,6,0,38
Bangladesh,21/12/2008,12,0,0,0,0,0,0,12
Bangladesh,22/12/2008,4,0,-4,0,0,1,0,1
Bangladesh,23/12/2008,7,0,-1,0,17,0,0,23
Bangladesh,24/12/2008,12,0,0,0,6,7,0,25
Bangladesh,25/12/2008,1,0,-2,0,19,1,0,19
Bangladesh,26/12/2008,9,0,0,0,3,1,0,13
Bangladesh,27/12/2008,18,0,1,0,7,5,0,31
Bangladesh,28/12/2008,21,0,-4,0,22,6,0,45
Bangladesh,29/12/2008,57,0,-2,0,28,12,0,95
Bangladesh,30/12/2008,28,0,-2,0,-3,6,0,29
Bangladesh,31/12/2008,38,2,-4,0,2,2,0,40
Cameroon,01/12/2008,13,0,0,0,0,0,0,13
Cameroon,03/12/2008,0,0,0,0,3,0,0,3
Cameroon,04/12/2008,1,0,0,0,3,0,0,4
Cameroon,05/12/2008,0,0,0,0,6,0,0,6
Cameroon,06/12/2008,0,0,0,0,3,0,0,3
Cameroon,07/12/2008,0,0,0,0,3,0,0,3
Cameroon,08/12/2008,3,0,0,0,3,0,0,6
Cameroon,09/12/2008,3,0,0,0,0,0,0,3
Cameroon,10/12/2008,3,0,0,0,0,0,0,3
Cameroon,11/12/2008,0,0,0,0,3,0,0,3
Cameroon,13/12/2008,0,0,0,0,0,0,0,0
Cameroon,14/12/2008,0,0,0,0,0,0,0,0
Cameroon,16/12/2008,0,0,0,0,0,0,0,0
Cameroon,17/12/2008,0,0,0,0,1,0,0,1
Cameroon,18/12/2008,5,0,0,0,24,0,0,29
Cameroon,19/12/2008,16,0,0,0,6,0,0,22
Cameroon,20/12/2008,0,0,0,0,0,0,0,0
Cameroon,21/12/2008,0,0,0,0,0,0,0,0
Cameroon,23/12/2008,2,0,0,0,0,0,0,2
Cameroon,28/12/2008,0,0,0,0,6,1,0,7
Cameroon,29/12/2008,0,0,0,0,9,0,0,9
Cameroon,31/12/2008,2,0,0,0,0,0,0,2
China,01/12/2008,52,0,-2,0,10,13,0,73
China,02/12/2008,46,0,0,0,7,2,0,55
China,03/12/2008,63,0,1,0,46,6,0,116
China,04/12/2008,74,2,2,0,37,6,0,121
China,05/12/2008,34,0,1,0,21,3,0,59
China,06/12/2008,52,0,2,0,19,7,0,80
China,07/12/2008,68,0,0,0,29,15,0,112
China,08/12/2008,120,0,-3,0,21,22,0,160
China,09/12/2008,128,2,5,0,55,9,0,199
China,10/12/2008,129,0,1,0,38,17,0,185
China,11/12/2008,85,2,-1,0,43,5,0,134
China,12/12/2008,89,2,-3,0,67,11,0,166
China,13/12/2008,47,0,-11,0,50,3,0,89
China,14/12/2008,88,2,0,0,11,11,0,112
China,15/12/2008,61,0,0,0,15,7,0,83
China,16/12/2008,48,2,-1,0,74,9,0,132
China,17/12/2008,112,0,-2,0,72,17,0,199
China,18/12/2008,122,0,-2,0,56,10,0,186
China,19/12/2008,50,4,1,0,19,14,0,88
China,20/12/2008,59,2,1,0,19,5,0,86
China,21/12/2008,44,0,0,0,12,2,0,58
China,22/12/2008,90,2,1,0,36,8,0,137
China,23/12/2008,115,0,1,0,67,11,0,194
China,24/12/2008,99,0,0,0,85,18,0,202
China,25/12/2008,109,0,-4,0,64,1,0,170
China,26/12/2008,70,0,0,0,36,7,0,113
China,27/12/2008,40,0,-2,0,-6,5,0,37
China,28/12/2008,118,0,0,0,6,8,0,132
China,29/12/2008,169,4,-2,0,3,10,0,184
China,30/12/2008,74,10,0,0,38,19,0,141
China,31/12/2008,134,6,-3,0,117,6,0,260
Egypt,01/12/2008,12,0,0,0,5,1,0,18
Egypt,02/12/2008,6,0,0,0,21,0,0,27
Egypt,03/12/2008,12,0,2,0,40,2,0,56
Egypt,04/12/2008,21,4,0,0,26,4,0,55
Egypt,05/12/2008,12,4,0,0,3,0,0,19
Egypt,06/12/2008,41,0,-1,0,9,4,0,53
Egypt,07/12/2008,23,0,0,0,0,0,0,23
Egypt,08/12/2008,20,0,0,0,-5,3,0,18
Egypt,09/12/2008,11,0,0,0,-2,0,0,9
Egypt,10/12/2008,38,0,0,0,27,6,0,71
Egypt,11/12/2008,21,4,0,0,4,1,0,30
Egypt,12/12/2008,36,4,0,0,0,2,0,42
Egypt,13/12/2008,52,4,0,0,15,0,0,71
Egypt,14/12/2008,46,0,0,0,-7,2,0,41
Egypt,15/12/2008,22,0,0,0,-4,0,0,18
Egypt,16/12/2008,25,0,-4,0,1,4,0,26
Egypt,17/12/2008,16,0,0,0,-1,0,0,15
Egypt,18/12/2008,44,2,0,0,18,0,0,64
Egypt,19/12/2008,36,0,1,0,10,4,0,51
Egypt,20/12/2008,130,0,0,0,8,1,0,139
Egypt,21/12/2008,43,0,0,0,21,2,0,66
Egypt,22/12/2008,154,0,0,0,-1,13,0,166
Egypt,23/12/2008,64,0,1,0,18,4,0,87
Egypt,24/12/2008,43,0,0,0,7,3,0,53
Egypt,25/12/2008,54,0,0,0,12,0,0,66
Egypt,26/12/2008,29,0,0,0,9,2,0,40
Egypt,27/12/2008,56,0,0,0,8,6,0,70
Egypt,28/12/2008,488,0,13,0,86,40,0,627
Egypt,29/12/2008,467,0,8,0,31,70,0,576
Egypt,30/12/2008,268,4,4,0,49,56,0,381
Egypt,31/12/2008,217,4,-1,0,30,23,0,273
Eritrea,01/12/2008,4,0,0,0,0,0,0,4
Eritrea,02/12/2008,6,0,0,0,0,2,0,8
Eritrea,04/12/2008,3,0,0,0,9,0,0,12
Eritrea,05/12/2008,-3,0,0,0,15,1,0,13
Eritrea,06/12/2008,0,0,0,0,9,0,0,9
Eritrea,08/12/2008,2,0,0,0,12,0,0,14
Eritrea,09/12/2008,0,0,0,0,3,0,0,3
Eritrea,10/12/2008,0,0,0,0,0,0,0,0
Eritrea,11/12/2008,2,0,0,0,0,0,0,2
Eritrea,12/12/2008,1,0,0,0,0,0,0,1
Eritrea,13/12/2008,8,0,0,0,6,0,0,14
Eritrea,14/12/2008,-2,0,0,0,0,0,0,-2
Eritrea,15/12/2008,5,0,0,0,0,0,0,5
Eritrea,16/12/2008,1,0,0,0,0,1,0,2
Eritrea,17/12/2008,0,0,0,0,0,0,0,0
Eritrea,18/12/2008,0,0,0,0,0,0,0,0
Eritrea,19/12/2008,8,0,0,0,4,0,0,12
Eritrea,20/12/2008,8,0,0,0,-2,0,0,6
Eritrea,22/12/2008,3,0,0,0,5,0,0,8
Eritrea,23/12/2008,2,0,0,0,0,0,0,2
Eritrea,24/12/2008,3,0,0,0,0,0,0,3
Eritrea,25/12/2008,12,0,0,0,0,0,0,12
Eritrea,28/12/2008,6,0,0,0,3,0,0,9
Eritrea,29/12/2008,5,0,0,0,2,0,0,7
Eritrea,30/12/2008,6,0,0,0,0,0,0,6
Eritrea,31/12/2008,-1,0,0,0,0,0,0,-1
Georgia,01/12/2008,10,0,0,0,-2,0,0,8
Georgia,02/12/2008,23,0,0,0,0,2,0,25
Georgia,03/12/2008,20,0,0,0,0,1,0,21
Georgia,04/12/2008,14,0,0,0,0,4,0,18
Georgia,05/12/2008,3,0,-4,0,0,4,0,3
Georgia,06/12/2008,13,0,0,0,12,0,0,25
Georgia,07/12/2008,2,0,0,0,0,0,0,2
Georgia,08/12/2008,7,0,-4,0,-4,0,0,-1
Georgia,09/12/2008,2,0,0,0,10,0,0,12
Georgia,10/12/2008,8,2,-2,0,9,0,0,17
Georgia,11/12/2008,15,0,0,0,3,1,0,19
Georgia,12/12/2008,2,0,0,0,15,5,0,22
Georgia,13/12/2008,3,0,0,0,0,0,0,3
Georgia,14/12/2008,5,0,0,0,1,1,0,7
Georgia,15/12/2008,6,0,0,0,9,1,0,16
Georgia,16/12/2008,13,0,0,0,6,1,0,20
Georgia,17/12/2008,0,0,0,0,6,0,0,6
Georgia,18/12/2008,12,0,0,0,21,0,0,33
Georgia,19/12/2008,12,0,0,0,6,0,0,18
Georgia,20/12/2008,2,0,0,0,3,0,0,5
Georgia,21/12/2008,0,0,0,0,0,0,0,0
Georgia,22/12/2008,0,0,0,0,3,0,0,3
Georgia,23/12/2008,7,0,0,0,1,0,0,8
Georgia,24/12/2008,6,0,0,0,3,0,0,9
Georgia,25/12/2008,0,0,0,0,6,0,0,6
Georgia,26/12/2008,2,0,0,0,3,0,0,5
Georgia,27/12/2008,0,0,0,0,0,0,0,0
Georgia,28/12/2008,4,0,0,0,-2,0,0,2
Georgia,29/12/2008,3,0,0,0,-6,2,0,-1
Georgia,30/12/2008,-1,0,-2,0,-4,1,0,-6
Georgia,31/12/2008,29,0,0,0,-2,0,0,27
India,01/12/2008,20,4,-2,0,-6,4,0,20
India,02/12/2008,12,0,0,0,2,2,0,16
India,03/12/2008,36,0,-2,0,-1,6,0,39
India,04/12/2008,17,0,-3,0,11,0,0,25
India,05/12/2008,9,2,0,0,-4,0,0,7
India,06/12/2008,21,0,-4,0,-1,4,0,20
India,07/12/2008,26,0,-1,0,5,6,0,36
India,08/12/2008,13,2,1,0,2,5,0,23
India,09/12/2008,23,0,0,0,1,5,0,29
India,10/12/2008,13,0,0,0,3,0,0,16
India,11/12/2008,15,0,1,0,16,-2,0,30
India,12/12/2008,11,0,0,0,11,3,0,25
India,13/12/2008,14,0,0,0,14,0,0,28
India,14/12/2008,16,0,0,0,3,1,0,20
India,15/12/2008,28,2,0,0,2,0,0,32
India,16/12/2008,26,0,-2,0,13,0,0,37
India,17/12/2008,13,0,0,0,7,1,0,21
India,18/12/2008,29,0,0,0,5,4,0,38
India,19/12/2008,23,8,-2,0,3,0,0,32
India,20/12/2008,21,0,0,0,4,3,0,28
India,21/12/2008,17,0,0,0,12,2,0,31
India,22/12/2008,14,0,1,0,1,0,0,16
India,23/12/2008,33,0,1,0,24,1,0,59
India,24/12/2008,23,0,0,0,25,3,0,51
India,25/12/2008,29,0,-1,0,19,2,0,49
India,26/12/2008,24,0,0,0,4,4,0,32
India,27/12/2008,21,0,0,0,-3,2,0,20
India,28/12/2008,42,0,-4,0,13,7,0,58
India,29/12/2008,71,0,-2,0,2,13,0,84
India,30/12/2008,69,4,-1,0,6,3,0,81
India,31/12/2008,48,0,-2,0,27,1,0,74
Iran,01/12/2008,51,0,0,0,12,2,0,65
Iran,02/12/2008,11,0,0,0,15,0,0,26
Iran,03/12/2008,31,0,0,0,-1,1,0,31
Iran,04/12/2008,51,2,0,0,44,5,0,102
Iran,05/12/2008,21,2,0,0,3,2,0,28
Iran,06/12/2008,46,0,0,0,9,0,0,55
Iran,07/12/2008,32,0,2,0,32,26,0,92
Iran,08/12/2008,73,0,0,0,21,8,0,102
Iran,09/12/2008,30,0,0,0,10,0,0,40
Iran,10/12/2008,6,2,1,0,34,0,0,43
Iran,11/12/2008,17,0,0,0,21,2,0,40
Iran,12/12/2008,19,0,-2,0,1,0,0,18
Iran,13/12/2008,10,0,-6,0,7,4,0,15
Iran,14/12/2008,33,0,0,0,6,8,0,47
Iran,15/12/2008,25,0,0,0,-1,6,0,30
Iran,16/12/2008,47,0,0,0,26,6,0,79
Iran,17/12/2008,48,0,0,0,15,2,0,65
Iran,18/12/2008,23,0,0,0,52,0,0,75
Iran,19/12/2008,24,0,-2,0,19,8,0,49
Iran,20/12/2008,23,2,1,0,26,2,0,54
Iran,21/12/2008,15,0,0,0,4,4,0,23
Iran,22/12/2008,17,0,0,0,11,2,0,30
Iran,23/12/2008,7,0,1,0,12,2,0,22
Iran,24/12/2008,13,8,0,0,50,1,0,72
Iran,25/12/2008,15,6,0,0,12,2,0,35
Iran,26/12/2008,41,0,0,0,15,6,0,62
Iran,27/12/2008,92,0,-4,0,3,2,0,93
Iran,28/12/2008,122,0,2,0,22,14,0,160
Iran,29/12/2008,129,0,0,0,17,16,0,162
Iran,30/12/2008,149,0,-2,0,23,14,0,184
Iran,31/12/2008,116,0,0,0,1,18,0,135
Iraq,01/12/2008,82,0,1,0,7,24,0,114
Iraq,02/12/2008,79,0,-2,0,34,7,0,118
Iraq,03/12/2008,55,0,0,0,48,8,0,111
Iraq,04/12/2008,93,0,2,0,49,17,0,161
Iraq,05/12/2008,70,0,1,0,32,17,0,120
Iraq,06/12/2008,45,2,1,0,22,9,0,79
Iraq,07/12/2008,40,0,5,0,9,4,0,58
Iraq,08/12/2008,121,0,4,0,6,13,0,144
Iraq,09/12/2008,66,0,0,0,23,5,0,94
Iraq,10/12/2008,63,0,4,0,47,11,0,125
Iraq,11/12/2008,114,8,-2,0,46,17,0,183
Iraq,12/12/2008,100,6,-1,0,2,4,0,111
Iraq,13/12/2008,49,0,0,0,15,1,0,65
Iraq,14/12/2008,62,0,2,0,30,15,0,109
Iraq,15/12/2008,136,0,-6,0,67,39,0,236
Iraq,16/12/2008,216,0,0,0,45,22,0,283
Iraq,17/12/2008,205,0,-1,0,76,40,0,320
Iraq,18/12/2008,90,0,0,0,136,25,0,251
Iraq,19/12/2008,113,4,0,0,36,14,0,167
Iraq,20/12/2008,72,0,0,0,18,25,0,115
Iraq,21/12/2008,88,0,-1,0,8,19,0,114
Iraq,22/12/2008,121,4,-2,0,77,15,0,215
Iraq,23/12/2008,56,2,-7,0,32,10,0,93
Iraq,24/12/2008,48,2,-2,0,6,15,0,69
Iraq,25/12/2008,62,0,-1,0,-6,9,0,64
Iraq,26/12/2008,58,0,0,0,16,3,0,77
Iraq,27/12/2008,76,0,0,0,26,3,0,105
Iraq,28/12/2008,103,2,0,0,59,58,0,222
Iraq,29/12/2008,123,2,-1,0,55,39,0,218
Iraq,30/12/2008,132,2,2,0,73,36,0,245
Iraq,31/12/2008,155,0,1,0,33,23,0,212
Morocco,01/12/2008,18,0,0,0,0,0,0,18
Morocco,02/12/2008,9,0,0,0,3,1,0,13
Morocco,03/12/2008,14,0,0,0,12,0,0,26
Morocco,04/12/2008,10,0,0,0,21,6,0,37
Morocco,05/12/2008,1,0,0,0,10,0,0,11
Morocco,06/12/2008,0,0,0,0,0,0,0,0
Morocco,07/12/2008,4,0,0,0,0,0,0,4
Morocco,08/12/2008,3,0,0,0,3,0,0,6
Morocco,09/12/2008,3,0,0,0,19,2,0,24
Morocco,10/12/2008,0,0,0,0,6,0,0,6
Morocco,11/12/2008,14,0,0,0,12,0,0,26
Morocco,12/12/2008,12,0,0,0,0,3,0,15
Morocco,13/12/2008,0,0,0,0,0,0,0,0
Morocco,14/12/2008,1,0,0,0,0,0,0,1
Morocco,15/12/2008,4,0,0,0,0,0,0,4
Morocco,16/12/2008,5,0,0,0,0,0,0,5
Morocco,17/12/2008,0,0,0,0,0,1,0,1
Morocco,18/12/2008,0,0,0,0,9,0,0,9
Morocco,19/12/2008,8,0,0,0,15,0,0,23
Morocco,20/12/2008,0,0,0,0,0,0,0,0
Morocco,21/12/2008,0,0,0,0,0,0,0,0
Morocco,22/12/2008,-6,0,0,0,0,0,0,-6
Morocco,23/12/2008,0,0,0,0,9,0,0,9
Morocco,24/12/2008,0,0,0,0,3,0,0,3
Morocco,25/12/2008,-2,0,0,0,0,0,0,-2
Morocco,26/12/2008,0,0,0,0,0,0,0,0
Morocco,27/12/2008,1,0,0,0,0,0,0,1
Morocco,28/12/2008,0,0,0,0,0,2,0,2
Morocco,29/12/2008,9,0,0,0,7,0,0,16
Morocco,30/12/2008,3,0,0,0,3,0,0,6
Morocco,31/12/2008,1,0,0,0,0,2,0,3
Nigeria,01/12/2008,21,0,0,0,3,0,0,24
Nigeria,02/12/2008,11,0,0,0,2,0,0,13
Nigeria,03/12/2008,1,0,0,0,4,0,0,5
Nigeria,04/12/2008,15,0,0,0,1,3,0,19
Nigeria,05/12/2008,12,0,0,0,0,0,0,12
Nigeria,06/12/2008,10,0,0,0,9,0,0,19
Nigeria,07/12/2008,7,0,0,0,8,0,0,15
Nigeria,08/12/2008,14,0,-2,0,2,2,0,16
Nigeria,09/12/2008,14,4,0,0,9,5,0,32
Nigeria,10/12/2008,15,2,0,0,13,5,0,35
Nigeria,11/12/2008,12,0,3,0,6,2,0,23
Nigeria,12/12/2008,11,2,-3,0,0,0,0,10
Nigeria,13/12/2008,0,0,0,0,0,0,0,0
Nigeria,14/12/2008,-4,0,0,0,15,0,0,11
Nigeria,15/12/2008,6,0,0,0,-7,0,0,-1
Nigeria,16/12/2008,11,0,0,0,9,0,0,20
Nigeria,17/12/2008,14,0,0,0,0,0,0,14
Nigeria,18/12/2008,6,0,0,0,0,0,0,6
Nigeria,19/12/2008,4,0,0,0,0,0,0,4
Nigeria,20/12/2008,18,2,0,0,3,0,0,23
Nigeria,21/12/2008,15,0,0,0,3,1,0,19
Nigeria,22/12/2008,13,0,0,0,3,2,0,18
Nigeria,23/12/2008,-1,0,0,0,3,0,0,2
Nigeria,24/12/2008,3,0,0,0,6,0,0,9
Nigeria,25/12/2008,0,0,0,0,21,0,0,21
Nigeria,26/12/2008,11,0,0,0,9,0,0,20
Nigeria,27/12/2008,6,0,0,0,3,0,0,9
Nigeria,28/12/2008,14,0,0,0,6,0,0,20
Nigeria,29/12/2008,14,0,-2,0,3,1,0,16
Nigeria,30/12/2008,16,0,0,0,-4,2,0,14
Nigeria,31/12/2008,14,0,1,0,6,2,0,23
Pakistan,01/12/2008,143,0,1,0,55,27,0,226
Pakistan,02/12/2008,88,0,-1,0,48,5,0,140
Pakistan,03/12/2008,177,0,-5,0,70,13,0,255
Pakistan,04/12/2008,97,0,0,0,53,8,0,158
Pakistan,05/12/2008,96,0,-2,0,60,9,0,163
Pakistan,06/12/2008,101,0,-4,0,52,9,0,158
Pakistan,07/12/2008,91,0,1,0,28,10,0,130
Pakistan,08/12/2008,121,0,1,0,51,6,0,179
Pakistan,09/12/2008,96,4,3,0,35,5,0,143
Pakistan,10/12/2008,117,0,2,0,165,11,0,295
Pakistan,11/12/2008,69,0,-4,0,83,1,0,149
Pakistan,12/12/2008,43,6,1,0,51,9,0,110
Pakistan,13/12/2008,61,12,0,0,17,5,0,95
Pakistan,14/12/2008,89,2,3,0,36,3,0,133
Pakistan,15/12/2008,71,4,1,0,24,12,0,112
Pakistan,16/12/2008,75,2,-2,0,33,4,0,112
Pakistan,17/12/2008,47,0,0,0,49,14,0,110
Pakistan,18/12/2008,76,0,0,0,123,4,0,203
Pakistan,19/12/2008,85,4,-8,0,59,13,0,153
Pakistan,20/12/2008,45,0,-6,0,2,12,0,53
Pakistan,21/12/2008,35,0,-4,0,28,1,0,60
Pakistan,22/12/2008,127,6,-2,0,7,4,0,142
Pakistan,23/12/2008,126,0,-2,0,40,16,0,180
Pakistan,24/12/2008,77,0,0,0,30,3,0,110
Pakistan,25/12/2008,16,2,1,0,6,0,0,25
Pakistan,26/12/2008,107,0,3,0,11,5,0,126
Pakistan,27/12/2008,67,0,0,0,11,5,0,83
Pakistan,28/12/2008,99,4,0,0,34,6,0,143
Pakistan,29/12/2008,205,0,0,0,42,25,0,272
Pakistan,30/12/2008,143,0,2,0,17,13,0,175
Pakistan,31/12/2008,166,2,0,0,48,6,0,222
Sierra Leone,01/12/2008,0,0,0,0,0,0,0,0
Sierra Leone,02/12/2008,4,0,0,0,3,0,0,7
Sierra Leone,03/12/2008,0,0,0,0,0,1,0,1
Sierra Leone,04/12/2008,-3,0,0,0,3,0,0,0
Sierra Leone,05/12/2008,0,0,0,0,0,0,0,0
Sierra Leone,08/12/2008,2,0,0,0,3,0,0,5
Sierra Leone,09/12/2008,3,0,0,0,3,1,0,7
Sierra Leone,10/12/2008,0,0,0,0,0,0,0,0
Sierra Leone,11/12/2008,2,0,0,0,1,0,0,3
Sierra Leone,12/12/2008,1,0,0,0,0,0,0,1
Sierra Leone,13/12/2008,0,0,0,0,6,0,0,6
Sierra Leone,14/12/2008,0,0,0,0,0,0,0,0
Sierra Leone,15/12/2008,0,0,0,0,0,0,0,0
Sierra Leone,16/12/2008,0,0,0,0,0,0,0,0
Sierra Leone,17/12/2008,-2,0,0,0,0,0,0,-2
Sierra Leone,18/12/2008,0,0,0,0,0,0,0,0
Sierra Leone,19/12/2008,0,0,0,0,-2,0,0,-2
Sierra Leone,20/12/2008,0,0,0,0,0,0,0,0
Sierra Leone,21/12/2008,0,0,0,0,0,0,0,0
Sierra Leone,22/12/2008,2,0,0,0,-2,0,0,0
Sierra Leone,23/12/2008,1,0,0,0,1,0,0,2
Sierra Leone,24/12/2008,4,0,0,0,9,1,0,14
Sierra Leone,25/12/2008,0,0,0,0,0,1,0,1
Sierra Leone,26/12/2008,0,0,0,0,0,0,0,0
Sierra Leone,27/12/2008,0,0,0,0,0,0,0,0
Sierra Leone,28/12/2008,7,0,0,0,6,0,0,13
Sierra Leone,29/12/2008,0,0,1,0,3,0,0,4
Sierra Leone,30/12/2008,1,0,-1,0,1,0,0,1
Sierra Leone,31/12/2008,0,0,0,0,0,0,0,0
Somalia,01/12/2008,36,2,-1,0,-16,2,0,23
Somalia,02/12/2008,56,2,0,0,13,0,0,71
Somalia,03/12/2008,55,0,0,0,-11,4,0,48
Somalia,04/12/2008,108,0,0,0,19,2,0,129
Somalia,05/12/2008,57,2,-2,0,20,6,0,83
Somalia,06/12/2008,37,0,0,0,16,3,0,56
Somalia,07/12/2008,21,0,0,0,36,8,0,65
Somalia,08/12/2008,45,0,0,0,20,8,0,73
Somalia,09/12/2008,54,0,0,0,12,50,0,116
Somalia,10/12/2008,36,0,0,0,-30,12,0,18
Somalia,11/12/2008,55,0,2,0,8,5,0,70
Somalia,12/12/2008,82,0,0,0,9,9,0,100
Somalia,13/12/2008,104,0,0,0,28,13,0,145
Somalia,14/12/2008,53,0,0,0,1,0,0,54
Somalia,15/12/2008,17,0,0,0,18,4,0,39
Somalia,16/12/2008,117,0,1,0,39,10,0,167
Somalia,17/12/2008,168,0,-4,0,27,26,0,217
Somalia,18/12/2008,189,0,0,0,61,19,0,269
Somalia,19/12/2008,49,0,-2,0,24,0,0,71
Somalia,20/12/2008,48,2,0,0,19,1,0,70
Somalia,21/12/2008,61,0,-1,0,7,8,0,75
Somalia,22/12/2008,19,0,-2,0,6,1,0,24
Somalia,23/12/2008,54,0,-1,0,25,10,0,88
Somalia,24/12/2008,47,0,-12,0,8,4,0,47
Somalia,25/12/2008,68,0,-4,0,15,12,0,91
Somalia,26/12/2008,29,0,-8,0,24,6,0,51
Somalia,27/12/2008,17,0,-2,0,-4,2,0,13
Somalia,28/12/2008,58,0,-10,0,10,3,0,61
Somalia,29/12/2008,88,0,-23,0,47,12,0,124
Somalia,30/12/2008,73,0,-13,0,24,11,0,95
Somalia,31/12/2008,22,0,-4,0,3,0,0,21
Syria,01/12/2008,2,0,0,0,0,0,0,2
Syria,02/12/2008,11,0,0,0,3,0,0,14
Syria,03/12/2008,5,0,0,0,0,0,0,5
Syria,04/12/2008,12,0,0,0,-4,2,0,10
Syria,05/12/2008,-13,0,0,0,0,0,0,-13
Syria,06/12/2008,1,0,0,0,0,0,0,1
Syria,07/12/2008,16,0,-1,0,0,2,0,17
Syria,08/12/2008,13,0,0,0,4,4,0,21
Syria,09/12/2008,17,0,0,0,0,5,0,22
Syria,10/12/2008,18,0,0,0,15,1,0,34
Syria,11/12/2008,22,0,0,0,-4,0,0,18
Syria,12/12/2008,0,0,0,0,0,4,0,4
Syria,13/12/2008,14,0,0,0,7,1,0,22
Syria,14/12/2008,15,2,1,0,8,1,0,27
Syria,15/12/2008,16,0,0,0,0,7,0,23
Syria,16/12/2008,26,0,0,0,20,10,0,56
Syria,17/12/2008,66,2,-3,0,51,6,0,122
Syria,18/12/2008,7,0,0,0,3,0,0,10
Syria,19/12/2008,7,0,0,0,9,0,0,16
Syria,20/12/2008,3,0,0,0,3,1,0,7
Syria,21/12/2008,0,0,0,0,0,0,0,0
Syria,22/12/2008,4,0,2,0,0,0,0,6
Syria,23/12/2008,10,0,-2,0,12,3,0,23
Syria,24/12/2008,11,0,0,0,-2,1,0,10
Syria,25/12/2008,5,0,0,0,3,2,0,10
Syria,26/12/2008,3,0,0,0,0,0,0,3
Syria,27/12/2008,44,0,0,0,3,2,0,49
Syria,28/12/2008,48,0,0,0,13,32,0,93
Syria,29/12/2008,73,0,0,0,21,28,0,122
Syria,30/12/2008,33,0,0,0,6,7,0,46
Syria,31/12/2008,11,0,-1,0,-1,1,0,10
Yemen,01/12/2008,12,0,0,0,-12,0,0,0
Yemen,02/12/2008,1,0,0,0,2,0,0,3
Yemen,03/12/2008,22,0,0,0,-11,6,0,17
Yemen,04/12/2008,6,0,0,0,-5,2,0,3
Yemen,05/12/2008,4,0,0,0,10,4,0,18
Yemen,06/12/2008,0,0,0,0,0,0,0,0
Yemen,07/12/2008,10,0,0,0,0,0,0,10
Yemen,08/12/2008,10,0,0,0,0,6,0,16
Yemen,09/12/2008,7,0,0,0,0,0,0,7
Yemen,10/12/2008,21,0,0,0,6,3,0,30
Yemen,11/12/2008,22,0,0,0,9,2,0,33
Yemen,12/12/2008,26,0,0,0,4,0,0,30
Yemen,13/12/2008,13,0,0,0,47,0,0,60
Yemen,14/12/2008,18,0,0,0,9,1,0,28
Yemen,15/12/2008,2,0,0,0,52,2,0,56
Yemen,16/12/2008,0,0,0,0,9,0,0,9
Yemen,17/12/2008,3,0,0,0,9,2,0,14
Yemen,18/12/2008,10,0,0,0,17,0,0,27
Yemen,19/12/2008,-1,0,0,0,2,3,0,4
Yemen,20/12/2008,12,0,0,0,10,0,0,22
Yemen,21/12/2008,5,0,0,0,6,0,0,11
Yemen,22/12/2008,-4,0,0,0,0,0,0,-4
Yemen,23/12/2008,1,0,0,0,-7,0,0,-6
Yemen,24/12/2008,14,0,0,0,0,1,0,15
Yemen,25/12/2008,3,0,0,0,6,0,0,9
Yemen,26/12/2008,2,0,0,0,6,1,0,9
Yemen,27/12/2008,13,0,0,0,-6,0,0,7
Yemen,28/12/2008,42,0,2,0,32,37,0,113
Yemen,29/12/2008,13,0,0,0,0,14,0,27
Yemen,30/12/2008,5,0,0,0,12,21,0,38
Yemen,31/12/2008,4,0,0,0,2,4,0,10
Afghanistan,01/06/2008,65,0,0,0,19,0,0,84
Afghanistan,02/06/2008,136,0,0,0,41,26,0,203
Afghanistan,03/06/2008,177,0,-2,0,36,7,0,218
Afghanistan,04/06/2008,112,2,-1,0,8,7,0,128
Afghanistan,05/06/2008,111,2,0,0,26,29,0,168
Afghanistan,06/06/2008,90,0,-3,0,15,8,0,110
Afghanistan,07/06/2008,73,2,0,0,12,4,0,91
Afghanistan,08/06/2008,72,0,-2,0,3,5,0,78
Afghanistan,09/06/2008,178,0,0,0,5,26,0,209
Afghanistan,10/06/2008,101,10,3,0,-5,6,0,115
Afghanistan,11/06/2008,441,0,-1,0,74,9,0,523
Afghanistan,12/06/2008,238,20,0,0,20,6,0,284
Afghanistan,13/06/2008,127,0,1,0,-17,18,0,129
Afghanistan,14/06/2008,183,0,0,0,28,45,0,256
Afghanistan,15/06/2008,137,0,1,0,36,10,0,184
Afghanistan,16/06/2008,200,0,0,0,43,21,0,264
Afghanistan,17/06/2008,160,2,3,0,1,6,0,172
Afghanistan,18/06/2008,260,0,-2,0,21,14,0,293
Afghanistan,19/06/2008,165,0,2,0,29,10,0,206
Afghanistan,20/06/2008,6,0,0,0,12,9,0,27
Afghanistan,21/06/2008,136,2,2,0,34,13,0,187
Afghanistan,22/06/2008,79,0,-2,0,12,2,0,91
Afghanistan,23/06/2008,105,4,0,0,18,6,0,133
Afghanistan,24/06/2008,134,6,-7,0,35,9,0,177
Afghanistan,25/06/2008,230,0,0,0,16,6,0,252
Afghanistan,26/06/2008,93,4,0,0,13,9,0,119
Afghanistan,27/06/2008,56,0,0,0,2,6,0,64
Afghanistan,28/06/2008,258,0,1,0,17,5,0,281
Afghanistan,29/06/2008,97,2,0,0,13,13,0,125
Afghanistan,30/06/2008,150,0,-2,0,29,6,0,183
Albania,01/06/2008,172,4,3,0,20,12,0,211
Albania,02/06/2008,95,0,4,0,25,13,0,137
Albania,03/06/2008,52,0,3,0,21,0,0,76
Albania,04/06/2008,6,2,0,0,14,1,0,23
Albania,05/06/2008,30,0,-1,0,3,8,0,40
Albania,06/06/2008,38,0,0,0,0,6,0,44
Albania,07/06/2008,17,0,-8,0,21,3,0,33
Albania,08/06/2008,15,0,-2,0,1,2,0,16
Albania,09/06/2008,19,0,-2,0,-4,2,0,15
Albania,10/06/2008,7,0,0,0,9,0,0,16
Albania,11/06/2008,17,0,0,0,-4,0,0,13
Albania,12/06/2008,9,0,-2,0,9,0,0,16
Albania,13/06/2008,6,0,-2,0,-6,0,0,-2
Albania,14/06/2008,40,0,-1,0,3,3,0,45
Albania,15/06/2008,62,0,-21,0,10,11,0,62
Albania,16/06/2008,14,0,-1,0,-8,2,0,7
Albania,17/06/2008,5,0,-11,0,3,0,0,-3
Albania,18/06/2008,15,0,-7,0,-2,2,0,8
Albania,19/06/2008,9,0,0,0,0,0,0,9
Albania,20/06/2008,9,0,-4,0,0,1,0,6
Albania,21/06/2008,4,0,0,0,6,1,0,11
Albania,22/06/2008,3,0,-1,0,0,0,0,2
Albania,23/06/2008,25,0,0,0,8,3,0,36
Albania,24/06/2008,18,0,0,0,-8,3,0,13
Albania,25/06/2008,2,0,-1,0,0,1,0,2
Albania,26/06/2008,8,0,0,0,6,0,0,14
Albania,27/06/2008,4,0,1,0,-2,0,0,3
Albania,28/06/2008,59,0,-3,0,6,0,0,62
Albania,29/06/2008,9,0,-1,0,3,0,0,11
Albania,30/06/2008,-3,0,1,0,0,0,0,-2
Algeria,01/06/2008,0,0,0,0,3,0,0,3
Algeria,02/06/2008,14,0,0,0,17,4,0,35
Algeria,03/06/2008,5,0,0,0,0,0,0,5
Algeria,04/06/2008,2,0,0,0,0,0,0,2
Algeria,05/06/2008,2,0,0,0,3,0,0,5
Algeria,06/06/2008,0,0,0,0,18,0,0,18
Algeria,07/06/2008,0,0,0,0,0,4,0,4
Algeria,08/06/2008,1,0,0,0,3,5,0,9
Algeria,09/06/2008,12,0,0,0,3,2,0,17
Algeria,10/06/2008,8,0,0,0,30,0,0,38
Algeria,11/06/2008,4,0,0,0,-1,0,0,3
Algeria,12/06/2008,1,0,0,0,24,0,0,25
Algeria,13/06/2008,4,0,0,0,3,0,0,7
Algeria,14/06/2008,0,0,0,0,24,0,0,24
Algeria,15/06/2008,10,0,0,0,4,0,0,14
Algeria,16/06/2008,1,0,0,0,0,0,0,1
Algeria,17/06/2008,0,0,0,0,0,0,0,0
Algeria,18/06/2008,0,0,0,0,3,0,0,3
Algeria,19/06/2008,-1,0,0,0,9,0,0,8
Algeria,20/06/2008,0,0,0,0,0,0,0,0
Algeria,21/06/2008,3,0,0,0,-2,0,0,1
Algeria,22/06/2008,3,0,0,0,-2,2,0,3
Algeria,23/06/2008,1,0,0,0,0,1,0,2
Algeria,24/06/2008,3,0,0,0,0,0,0,3
Algeria,25/06/2008,2,0,0,0,0,0,0,2
Algeria,26/06/2008,1,0,1,0,30,0,0,32
Algeria,27/06/2008,0,0,0,0,0,0,0,0
Algeria,28/06/2008,3,0,0,0,6,0,0,9
Algeria,29/06/2008,5,0,0,0,-1,0,0,4
Algeria,30/06/2008,2,0,0,0,9,0,0,11
Bangladesh,01/06/2008,11,0,0,0,1,2,0,14
Bangladesh,02/06/2008,11,0,0,0,12,2,0,25
Bangladesh,03/06/2008,30,0,0,0,27,2,0,59
Bangladesh,04/06/2008,4,0,0,0,22,2,0,28
Bangladesh,05/06/2008,17,2,0,0,15,0,0,34
Bangladesh,06/06/2008,11,0,1,0,5,0,0,17
Bangladesh,07/06/2008,6,0,0,0,-4,0,0,2
Bangladesh,08/06/2008,12,2,0,0,-13,0,0,1
Bangladesh,09/06/2008,3,0,0,0,8,0,0,11
Bangladesh,10/06/2008,4,0,0,0,3,0,0,7
Bangladesh,11/06/2008,6,0,0,0,-13,0,0,-7
Bangladesh,12/06/2008,4,0,0,0,-5,3,0,2
Bangladesh,13/06/2008,0,0,0,0,5,-2,0,3
Bangladesh,14/06/2008,17,0,0,0,2,0,0,19
Bangladesh,15/06/2008,7,0,0,0,-4,0,0,3
Bangladesh,16/06/2008,3,0,0,0,-7,0,0,-4
Bangladesh,17/06/2008,20,0,-2,0,7,0,0,25
Bangladesh,18/06/2008,12,0,-2,0,-1,4,0,13
Bangladesh,19/06/2008,23,0,0,0,6,0,0,29
Bangladesh,20/06/2008,-1,0,0,0,0,0,0,-1
Bangladesh,21/06/2008,19,0,0,0,27,2,0,48
Bangladesh,22/06/2008,3,0,0,0,9,0,0,12
Bangladesh,23/06/2008,0,0,0,0,3,0,0,3
Bangladesh,24/06/2008,26,0,-3,0,-2,0,0,21
Bangladesh,25/06/2008,9,0,0,0,4,0,0,13
Bangladesh,26/06/2008,5,0,0,0,3,0,0,8
Bangladesh,27/06/2008,16,0,0,0,0,0,0,16
Bangladesh,28/06/2008,8,0,-2,0,-2,0,0,4
Bangladesh,29/06/2008,3,0,0,0,1,0,0,4
Bangladesh,30/06/2008,31,0,-2,0,9,2,0,40
Cameroon,02/06/2008,-1,0,0,0,0,0,0,-1
Cameroon,04/06/2008,0,0,0,0,3,0,0,3
Cameroon,05/06/2008,2,0,0,0,3,0,0,5
Cameroon,06/06/2008,0,0,0,0,0,0,0,0
Cameroon,09/06/2008,2,0,0,0,3,0,0,5
Cameroon,10/06/2008,0,0,0,0,0,0,0,0
Cameroon,11/06/2008,12,0,0,0,0,0,0,12
Cameroon,12/06/2008,1,0,0,0,6,0,0,7
Cameroon,13/06/2008,9,0,0,0,0,0,0,9
Cameroon,14/06/2008,6,0,0,0,0,2,0,8
Cameroon,15/06/2008,0,0,0,0,3,0,0,3
Cameroon,16/06/2008,66,0,0,0,0,0,0,66
Cameroon,17/06/2008,6,0,0,0,12,1,0,19
Cameroon,23/06/2008,0,0,0,0,0,0,0,0
Cameroon,24/06/2008,0,0,0,0,0,0,0,0
Cameroon,25/06/2008,3,0,0,0,0,0,0,3
Cameroon,26/06/2008,1,0,0,0,0,0,0,1
Cameroon,27/06/2008,0,0,0,0,0,0,0,0
Cameroon,28/06/2008,0,0,-4,0,0,0,0,-4
Cameroon,30/06/2008,2,0,0,0,0,0,0,2
China,01/06/2008,44,2,0,0,6,1,0,53
China,02/06/2008,49,0,0,0,9,8,0,66
China,03/06/2008,85,0,-3,0,17,5,0,104
China,04/06/2008,22,0,-1,0,59,4,0,84
China,05/06/2008,31,4,0,0,36,2,0,73
China,06/06/2008,49,0,0,0,16,9,0,74
China,07/06/2008,25,0,0,0,26,4,0,55
China,08/06/2008,45,0,2,0,57,13,0,117
China,09/06/2008,32,4,-4,0,17,9,0,58
China,10/06/2008,51,0,-6,0,35,13,0,93
China,11/06/2008,83,2,2,0,33,22,0,142
China,12/06/2008,36,0,0,0,43,4,0,83
China,13/06/2008,46,0,2,0,9,2,0,59
China,14/06/2008,58,0,-1,0,5,6,0,68
China,15/06/2008,62,0,4,0,14,4,0,84
China,16/06/2008,18,4,1,0,22,2,0,47
China,17/06/2008,24,4,-2,0,20,5,0,51
China,18/06/2008,176,0,3,0,28,20,0,227
China,19/06/2008,38,0,0,0,75,21,0,134
China,20/06/2008,2,0,0,0,7,0,0,9
China,21/06/2008,54,0,0,0,58,17,0,129
China,22/06/2008,53,4,0,0,13,6,0,76
China,23/06/2008,38,2,0,0,18,2,0,60
China,24/06/2008,103,0,-2,0,76,11,0,188
China,25/06/2008,60,2,-1,0,62,6,0,129
China,26/06/2008,45,0,-13,0,7,7,0,46
China,27/06/2008,32,0,-3,0,20,6,0,55
China,28/06/2008,25,0,0,0,12,4,0,41
China,29/06/2008,60,0,-2,0,46,23,0,127
China,30/06/2008,66,0,-6,0,30,9,0,99
Egypt,01/06/2008,8,0,0,0,0,0,0,8
Egypt,02/06/2008,10,0,0,0,15,1,0,26
Egypt,03/06/2008,11,0,1,0,-5,1,0,8
Egypt,04/06/2008,19,0,1,0,-1,0,0,19
Egypt,05/06/2008,101,0,2,0,-18,6,0,91
Egypt,06/06/2008,52,0,0,0,12,2,0,66
Egypt,07/06/2008,10,0,0,0,6,9,0,25
Egypt,08/06/2008,13,0,0,0,18,3,0,34
Egypt,09/06/2008,35,0,0,0,16,2,0,53
Egypt,10/06/2008,67,0,0,0,1,1,0,69
Egypt,11/06/2008,53,0,0,0,4,7,0,64
Egypt,12/06/2008,45,0,0,0,-12,4,0,37
Egypt,13/06/2008,4,0,0,0,9,4,0,17
Egypt,14/06/2008,13,0,0,0,7,3,0,23
Egypt,15/06/2008,25,0,0,0,8,1,0,34
Egypt,16/06/2008,45,0,0,0,21,6,0,72
Egypt,17/06/2008,107,2,-1,0,2,5,0,115
Egypt,18/06/2008,65,2,0,0,41,2,0,110
Egypt,19/06/2008,84,0,0,0,17,2,0,103
Egypt,20/06/2008,10,0,0,0,0,1,0,11
Egypt,21/06/2008,60,0,0,0,10,0,0,70
Egypt,22/06/2008,8,0,0,0,4,3,0,15
Egypt,23/06/2008,24,0,0,0,3,0,0,27
Egypt,24/06/2008,49,0,0,0,-6,0,0,43
Egypt,25/06/2008,48,0,-1,0,5,0,0,52
Egypt,26/06/2008,32,0,0,0,8,1,0,41
Egypt,27/06/2008,8,0,0,0,5,0,0,13
Egypt,28/06/2008,43,0,2,0,0,0,0,45
Egypt,29/06/2008,35,0,0,0,1,8,0,44
Egypt,30/06/2008,62,2,-5,0,20,2,0,81
Eritrea,01/06/2008,2,0,0,0,13,3,0,18
Eritrea,02/06/2008,8,0,0,0,6,3,0,17
Eritrea,03/06/2008,14,0,0,0,1,0,0,15
Eritrea,04/06/2008,31,0,0,0,2,2,0,35
Eritrea,05/06/2008,19,0,-2,0,8,4,0,29
Eritrea,06/06/2008,9,0,0,0,9,6,0,24
Eritrea,07/06/2008,12,0,0,0,1,0,0,13
Eritrea,08/06/2008,10,0,0,0,6,2,0,18
Eritrea,09/06/2008,4,0,0,0,0,3,0,7
Eritrea,10/06/2008,24,0,0,0,6,2,0,32
Eritrea,11/06/2008,49,0,0,0,0,2,0,51
Eritrea,12/06/2008,47,0,0,0,6,0,0,53
Eritrea,13/06/2008,25,0,0,0,0,0,0,25
Eritrea,14/06/2008,42,0,0,0,3,0,0,45
Eritrea,15/06/2008,23,0,1,0,3,2,0,29
Eritrea,16/06/2008,15,0,0,0,-2,5,0,18
Eritrea,17/06/2008,7,0,0,0,0,0,0,7
Eritrea,18/06/2008,15,0,0,0,9,2,0,26
Eritrea,19/06/2008,3,0,0,0,3,0,0,6
Eritrea,20/06/2008,7,0,0,0,0,0,0,7
Eritrea,21/06/2008,4,0,0,0,0,1,0,5
Eritrea,22/06/2008,9,0,0,0,1,4,0,14
Eritrea,23/06/2008,0,0,0,0,3,0,0,3
Eritrea,24/06/2008,7,0,0,0,0,0,0,7
Eritrea,25/06/2008,13,0,0,0,1,2,0,16
Eritrea,26/06/2008,18,0,0,0,0,0,0,18
Eritrea,27/06/2008,21,0,0,0,0,0,0,21
Eritrea,28/06/2008,0,0,0,0,3,0,0,3
Eritrea,29/06/2008,15,0,0,0,5,0,0,20
Eritrea,30/06/2008,27,0,0,0,-3,0,0,24
Georgia,01/06/2008,0,0,0,0,0,0,0,0
Georgia,02/06/2008,0,0,0,0,1,0,0,1
Georgia,03/06/2008,8,0,-4,0,-1,0,0,3
Georgia,04/06/2008,-3,0,0,0,0,0,0,-3
Georgia,05/06/2008,22,2,1,0,2,2,0,29
Georgia,06/06/2008,5,0,0,0,3,0,0,8
Georgia,07/06/2008,-1,0,0,0,0,0,0,-1
Georgia,08/06/2008,3,0,0,0,0,1,0,4
Georgia,09/06/2008,5,0,1,0,1,0,0,7
Georgia,10/06/2008,10,0,0,0,4,0,0,14
Georgia,11/06/2008,5,0,0,0,-2,0,0,3
Georgia,12/06/2008,1,0,0,0,0,0,0,1
Georgia,13/06/2008,2,0,0,0,0,0,0,2
Georgia,14/06/2008,0,0,0,0,0,0,0,0
Georgia,15/06/2008,0,0,0,0,9,0,0,9
Georgia,16/06/2008,9,0,0,0,17,2,0,28
Georgia,17/06/2008,1,0,0,0,3,2,0,6
Georgia,18/06/2008,0,0,0,0,6,0,0,6
Georgia,19/06/2008,0,0,0,0,15,0,0,15
Georgia,20/06/2008,0,0,0,0,0,0,0,0
Georgia,21/06/2008,12,0,0,0,6,1,0,19
Georgia,22/06/2008,9,0,0,0,3,2,0,14
Georgia,23/06/2008,5,0,0,0,0,0,0,5
Georgia,24/06/2008,10,0,0,0,3,0,0,13
Georgia,25/06/2008,22,0,0,0,21,1,0,44
Georgia,26/06/2008,10,0,0,0,6,0,0,16
Georgia,27/06/2008,11,0,0,0,9,0,0,20
Georgia,28/06/2008,24,0,0,0,-1,2,0,25
Georgia,29/06/2008,6,0,0,0,0,2,0,8
Georgia,30/06/2008,10,0,0,0,9,3,0,22
India,01/06/2008,36,0,0,0,-4,0,0,32
India,02/06/2008,60,0,0,0,2,6,0,68
India,03/06/2008,58,0,-2,0,13,0,0,69
India,04/06/2008,43,0,0,0,11,5,0,59
India,05/06/2008,51,0,0,0,26,19,0,96
India,06/06/2008,42,0,-2,0,36,6,0,82
India,07/06/2008,22,0,1,0,9,1,0,33
India,08/06/2008,17,0,2,0,21,4,0,44
India,09/06/2008,36,0,1,0,-2,2,0,37
India,10/06/2008,21,0,-2,0,-2,10,0,27
India,11/06/2008,43,0,0,0,25,9,0,77
India,12/06/2008,19,0,0,0,0,2,0,21
India,13/06/2008,15,2,0,0,3,0,0,20
India,14/06/2008,9,0,1,0,-2,3,0,11
India,15/06/2008,26,0,0,0,10,1,0,37
India,16/06/2008,9,2,0,0,7,3,0,21
India,17/06/2008,24,0,0,0,5,4,0,33
India,18/06/2008,22,0,0,0,5,6,0,33
India,19/06/2008,16,2,0,0,0,8,0,26
India,20/06/2008,1,0,0,0,0,0,0,1
India,21/06/2008,12,0,-2,0,22,0,0,32
India,22/06/2008,36,0,0,0,6,3,0,45
India,23/06/2008,27,0,-2,0,7,1,0,33
India,24/06/2008,44,0,0,0,4,0,0,48
India,25/06/2008,18,4,0,0,3,3,0,28
India,26/06/2008,36,0,-7,0,10,4,0,43
India,27/06/2008,38,0,-5,0,13,6,0,52
India,28/06/2008,26,0,0,0,6,6,0,38
India,29/06/2008,29,0,0,0,12,4,0,45
India,30/06/2008,23,0,-1,0,30,16,0,68
Iran,01/06/2008,49,0,0,0,6,74,0,129
Iran,02/06/2008,68,0,1,0,23,25,0,117
Iran,03/06/2008,57,0,1,0,39,13,0,110
Iran,04/06/2008,133,0,2,0,11,16,0,162
Iran,05/06/2008,96,2,2,0,4,7,0,111
Iran,06/06/2008,43,0,2,0,3,6,0,54
Iran,07/06/2008,36,2,2,0,21,8,0,69
Iran,08/06/2008,62,0,-4,0,9,5,0,72
Iran,09/06/2008,38,0,0,0,9,5,0,52
Iran,10/06/2008,82,0,-3,0,29,8,0,116
Iran,11/06/2008,103,0,1,0,16,16,0,136
Iran,12/06/2008,21,0,0,0,4,1,0,26
Iran,13/06/2008,7,0,0,0,0,0,0,7
Iran,14/06/2008,40,0,-2,0,5,2,0,45
Iran,15/06/2008,32,0,-10,0,23,5,0,50
Iran,16/06/2008,23,0,-3,0,19,4,0,43
Iran,17/06/2008,79,0,0,0,40,7,0,126
Iran,18/06/2008,62,0,-2,0,25,2,0,87
Iran,19/06/2008,27,4,0,0,12,2,0,45
Iran,20/06/2008,17,0,0,0,20,0,0,37
Iran,21/06/2008,88,0,2,0,21,5,0,116
Iran,22/06/2008,60,0,0,0,7,5,0,72
Iran,23/06/2008,30,0,-2,0,39,2,0,69
Iran,24/06/2008,53,0,-3,0,48,5,0,103
Iran,25/06/2008,61,0,-2,0,4,0,0,63
Iran,26/06/2008,40,0,-2,0,26,4,0,68
Iran,27/06/2008,10,0,0,0,6,1,0,17
Iran,28/06/2008,24,0,-6,0,10,7,0,35
Iran,29/06/2008,47,0,0,0,-6,10,0,51
Iran,30/06/2008,42,4,0,0,67,6,0,119
Iraq,01/06/2008,66,2,0,0,13,8,0,89
Iraq,02/06/2008,112,0,1,0,54,34,0,201
Iraq,03/06/2008,87,0,0,0,20,9,0,116
Iraq,04/06/2008,197,0,0,0,108,13,0,318
Iraq,05/06/2008,314,2,0,0,78,14,0,408
Iraq,06/06/2008,101,2,3,0,17,4,0,127
Iraq,07/06/2008,43,2,0,0,7,5,0,57
Iraq,08/06/2008,102,2,-6,0,13,14,0,125
Iraq,09/06/2008,177,0,-2,0,27,25,0,227
Iraq,10/06/2008,158,2,-8,0,50,12,0,214
Iraq,11/06/2008,165,4,7,0,53,37,0,266
Iraq,12/06/2008,111,0,11,0,23,18,0,163
Iraq,13/06/2008,69,0,2,0,13,0,0,84
Iraq,14/06/2008,52,0,1,0,17,10,0,80
Iraq,15/06/2008,35,0,1,0,13,44,0,93
Iraq,16/06/2008,91,0,-5,0,33,29,0,148
Iraq,17/06/2008,231,2,3,0,79,4,0,319
Iraq,18/06/2008,139,10,1,0,36,13,0,199
Iraq,19/06/2008,39,6,0,0,47,2,0,94
Iraq,20/06/2008,-1,0,0,0,21,0,0,20
Iraq,21/06/2008,109,8,0,0,48,10,0,175
Iraq,22/06/2008,41,2,0,0,1,15,0,59
Iraq,23/06/2008,71,2,10,0,-7,14,0,90
Iraq,24/06/2008,59,2,5,0,20,7,0,93
Iraq,25/06/2008,148,0,5,0,7,8,0,168
Iraq,26/06/2008,133,0,-1,0,-5,16,0,143
Iraq,27/06/2008,72,0,-1,0,7,20,0,98
Iraq,28/06/2008,85,2,0,0,7,5,0,99
Iraq,29/06/2008,57,0,-5,0,-2,8,0,58
Iraq,30/06/2008,97,2,0,0,27,21,0,147
Morocco,01/06/2008,6,0,0,0,0,0,0,6
Morocco,02/06/2008,4,0,0,0,12,0,0,16
Morocco,03/06/2008,2,0,0,0,0,0,0,2
Morocco,04/06/2008,0,0,0,0,2,0,0,2
Morocco,05/06/2008,0,0,0,0,3,2,0,5
Morocco,06/06/2008,-2,0,0,0,3,0,0,1
Morocco,07/06/2008,0,0,0,0,-2,0,0,-2
Morocco,08/06/2008,0,0,0,0,0,0,0,0
Morocco,09/06/2008,0,0,0,0,0,0,0,0
Morocco,10/06/2008,5,0,0,0,0,0,0,5
Morocco,11/06/2008,4,0,0,0,15,0,0,19
Morocco,12/06/2008,-2,0,0,0,0,1,0,-1
Morocco,13/06/2008,3,0,0,0,0,0,0,3
Morocco,14/06/2008,0,0,0,0,9,0,0,9
Morocco,15/06/2008,0,0,0,0,3,0,0,3
Morocco,16/06/2008,6,0,0,0,0,0,0,6
Morocco,17/06/2008,4,0,0,0,-2,0,0,2
Morocco,18/06/2008,0,0,0,0,6,0,0,6
Morocco,19/06/2008,4,0,0,0,6,0,0,10
Morocco,20/06/2008,-1,0,0,0,0,0,0,-1
Morocco,21/06/2008,0,0,0,0,0,2,0,2
Morocco,22/06/2008,2,2,0,0,0,0,0,4
Morocco,23/06/2008,3,0,0,0,6,0,0,9
Morocco,24/06/2008,0,0,0,0,0,0,0,0
Morocco,25/06/2008,1,0,-2,0,0,0,0,-1
Morocco,26/06/2008,3,0,1,0,6,0,0,10
Morocco,27/06/2008,0,0,0,0,0,0,0,0
Morocco,28/06/2008,-1,0,0,0,0,0,0,-1
Morocco,29/06/2008,3,0,0,0,0,0,0,3
Morocco,30/06/2008,17,0,0,0,12,2,0,31
Nigeria,01/06/2008,4,0,0,0,0,0,0,4
Nigeria,02/06/2008,47,0,0,0,0,4,0,51
Nigeria,03/06/2008,14,0,0,0,6,5,0,25
Nigeria,04/06/2008,6,2,0,0,5,3,0,16
Nigeria,05/06/2008,8,0,0,0,9,0,0,17
Nigeria,06/06/2008,4,2,0,0,6,0,0,12
Nigeria,07/06/2008,-2,4,0,0,0,0,0,2
Nigeria,08/06/2008,3,0,0,0,0,0,0,3
Nigeria,09/06/2008,14,4,0,0,3,0,0,21
Nigeria,10/06/2008,18,0,0,0,22,8,0,48
Nigeria,11/06/2008,12,0,0,0,3,0,0,15
Nigeria,12/06/2008,7,0,0,0,4,0,0,11
Nigeria,13/06/2008,2,0,0,0,0,1,0,3
Nigeria,14/06/2008,3,0,0,0,3,0,0,6
Nigeria,15/06/2008,3,0,0,0,-6,0,0,-3
Nigeria,16/06/2008,2,0,0,0,0,0,0,2
Nigeria,17/06/2008,4,0,0,0,1,0,0,5
Nigeria,18/06/2008,3,0,0,0,15,0,0,18
Nigeria,19/06/2008,11,0,0,0,-1,0,0,10
Nigeria,20/06/2008,2,0,0,0,0,0,0,2
Nigeria,21/06/2008,16,0,0,0,0,3,0,19
Nigeria,22/06/2008,13,0,0,0,6,0,0,19
Nigeria,23/06/2008,28,2,0,0,9,2,0,41
Nigeria,24/06/2008,-16,0,0,0,0,0,0,-16
Nigeria,25/06/2008,-7,0,-1,0,4,0,0,-4
Nigeria,26/06/2008,44,0,0,0,30,0,0,74
Nigeria,27/06/2008,12,0,2,0,24,0,0,38
Nigeria,28/06/2008,13,0,0,0,0,1,0,14
Nigeria,29/06/2008,17,0,0,0,6,0,0,23
Nigeria,30/06/2008,35,0,0,0,3,0,0,38
Pakistan,01/06/2008,42,2,1,0,35,0,0,80
Pakistan,02/06/2008,77,2,1,0,31,8,0,119
Pakistan,03/06/2008,42,0,2,0,24,6,0,74
Pakistan,04/06/2008,58,0,-1,0,33,13,0,103
Pakistan,05/06/2008,50,0,0,0,96,6,0,152
Pakistan,06/06/2008,47,2,0,0,57,6,0,112
Pakistan,07/06/2008,45,2,0,0,17,8,0,72
Pakistan,08/06/2008,40,0,-5,0,1,10,0,46
Pakistan,09/06/2008,79,0,0,0,10,7,0,96
Pakistan,10/06/2008,50,0,0,0,8,5,0,63
Pakistan,11/06/2008,164,0,1,0,10,9,0,184
Pakistan,12/06/2008,82,2,0,0,4,1,0,89
Pakistan,13/06/2008,48,0,0,0,27,0,0,75
Pakistan,14/06/2008,38,0,0,0,6,12,0,56
Pakistan,15/06/2008,129,0,-5,0,37,16,0,177
Pakistan,16/06/2008,121,2,-4,0,67,7,0,193
Pakistan,17/06/2008,92,0,0,0,16,4,0,112
Pakistan,18/06/2008,55,0,2,0,8,1,0,66
Pakistan,19/06/2008,42,6,-10,0,12,4,0,54
Pakistan,20/06/2008,3,0,0,0,-4,0,0,-1
Pakistan,21/06/2008,41,0,-3,0,15,2,0,55
Pakistan,22/06/2008,95,0,-2,0,8,3,0,104
Pakistan,23/06/2008,116,0,3,0,25,12,0,156
Pakistan,24/06/2008,179,0,0,0,7,15,0,201
Pakistan,25/06/2008,72,4,0,0,8,12,0,96
Pakistan,26/06/2008,84,0,0,0,37,9,0,130
Pakistan,27/06/2008,63,0,-2,0,8,3,0,72
Pakistan,28/06/2008,49,0,-4,0,24,9,0,78
Pakistan,29/06/2008,27,0,0,0,9,3,0,39
Pakistan,30/06/2008,89,0,0,0,25,8,0,122
Sierra Leone,01/06/2008,0,0,0,0,3,0,0,3
Sierra Leone,02/06/2008,0,0,0,0,3,0,0,3
Sierra Leone,03/06/2008,0,0,0,0,0,0,0,0
Sierra Leone,04/06/2008,0,0,0,0,0,0,0,0
Sierra Leone,06/06/2008,2,0,0,0,0,0,0,2
Sierra Leone,07/06/2008,0,0,0,0,0,0,0,0
Sierra Leone,08/06/2008,0,0,0,0,0,0,0,0
Sierra Leone,09/06/2008,2,0,0,0,0,2,0,4
Sierra Leone,10/06/2008,0,0,0,0,6,0,0,6
Sierra Leone,11/06/2008,0,0,0,0,0,0,0,0
Sierra Leone,12/06/2008,-1,0,0,0,9,0,0,8
Sierra Leone,13/06/2008,0,0,0,0,-1,0,0,-1
Sierra Leone,15/06/2008,0,0,0,0,0,0,0,0
Sierra Leone,16/06/2008,13,0,0,0,6,0,0,19
Sierra Leone,17/06/2008,20,0,0,0,8,0,0,28
Sierra Leone,18/06/2008,3,0,0,0,3,0,0,6
Sierra Leone,19/06/2008,0,0,0,0,0,0,0,0
Sierra Leone,20/06/2008,0,0,0,0,0,0,0,0
Sierra Leone,21/06/2008,0,0,0,0,0,0,0,0
Sierra Leone,23/06/2008,0,0,0,0,6,0,0,6
Sierra Leone,24/06/2008,4,0,0,0,9,0,0,13
Sierra Leone,25/06/2008,2,0,0,0,0,0,0,2
Sierra Leone,26/06/2008,-1,0,0,0,-4,0,0,-5
Sierra Leone,28/06/2008,0,0,0,0,0,0,0,0
Sierra Leone,29/06/2008,2,0,0,0,0,1,0,3
Sierra Leone,30/06/2008,1,0,0,0,0,1,0,2
Somalia,01/06/2008,12,0,0,0,-14,0,0,-2
Somalia,02/06/2008,113,0,-1,0,21,25,0,158
Somalia,03/06/2008,97,10,-1,0,9,10,0,125
Somalia,04/06/2008,53,0,0,0,2,4,0,59
Somalia,05/06/2008,14,0,0,0,0,8,0,22
Somalia,06/06/2008,-2,0,0,0,9,0,0,7
Somalia,07/06/2008,48,0,0,0,6,19,0,73
Somalia,08/06/2008,72,0,0,0,15,16,0,103
Somalia,09/06/2008,19,0,0,0,5,4,0,28
Somalia,10/06/2008,67,2,0,0,3,6,0,78
Somalia,11/06/2008,16,0,0,0,8,0,0,24
Somalia,12/06/2008,42,0,0,0,0,1,0,43
Somalia,13/06/2008,15,0,0,0,0,0,0,15
Somalia,14/06/2008,9,0,0,0,0,0,0,9
Somalia,15/06/2008,9,0,0,0,0,0,0,9
Somalia,16/06/2008,8,0,0,0,0,2,0,10
Somalia,17/06/2008,25,6,0,0,0,0,0,31
Somalia,18/06/2008,-19,0,0,0,0,4,0,-15
Somalia,19/06/2008,2,0,0,0,-2,0,0,0
Somalia,20/06/2008,1,0,0,0,3,0,0,4
Somalia,21/06/2008,5,0,0,0,0,0,0,5
Somalia,22/06/2008,6,0,0,0,21,2,0,29
Somalia,23/06/2008,21,0,0,0,4,1,0,26
Somalia,24/06/2008,2,0,0,0,3,1,0,6
Somalia,25/06/2008,15,0,0,0,-7,2,0,10
Somalia,26/06/2008,1,0,0,0,-1,0,0,0
Somalia,27/06/2008,7,0,0,0,-2,1,0,6
Somalia,28/06/2008,12,4,0,0,23,0,0,39
Somalia,29/06/2008,13,0,0,0,3,6,0,22
Somalia,30/06/2008,21,0,0,0,-6,1,0,16
Syria,01/06/2008,21,0,0,0,1,2,0,24
Syria,02/06/2008,23,0,-2,0,7,1,0,29
Syria,03/06/2008,35,0,0,0,-2,0,0,33
Syria,04/06/2008,49,0,-6,0,25,7,0,75
Syria,05/06/2008,11,0,1,0,15,0,0,27
Syria,06/06/2008,10,0,1,0,19,0,0,30
Syria,07/06/2008,3,0,0,0,-1,0,0,2
Syria,08/06/2008,5,0,0,0,0,0,0,5
Syria,09/06/2008,32,0,0,0,-2,1,0,31
Syria,10/06/2008,10,0,0,0,15,2,0,27
Syria,11/06/2008,9,0,0,0,0,0,0,9
Syria,12/06/2008,8,0,0,0,12,3,0,23
Syria,13/06/2008,-3,0,0,0,3,-2,0,-2
Syria,14/06/2008,8,0,0,0,6,6,0,20
Syria,15/06/2008,-5,0,0,0,12,2,0,9
Syria,16/06/2008,-3,0,-4,0,-6,0,0,-13
Syria,17/06/2008,13,0,0,0,3,0,0,16
Syria,18/06/2008,29,0,0,0,1,6,0,36
Syria,19/06/2008,18,0,0,0,5,0,0,23
Syria,20/06/2008,0,0,0,0,0,3,0,3
Syria,21/06/2008,18,0,0,0,-1,0,0,17
Syria,22/06/2008,28,0,0,0,7,0,0,35
Syria,23/06/2008,19,0,0,0,-8,0,0,11
Syria,24/06/2008,23,0,0,0,1,0,0,24
Syria,25/06/2008,18,0,-2,0,0,0,0,16
Syria,26/06/2008,14,0,0,0,-4,0,0,10
Syria,27/06/2008,-1,0,0,0,0,2,0,1
Syria,28/06/2008,24,0,0,0,0,1,0,25
Syria,29/06/2008,7,0,0,0,0,0,0,7
Syria,30/06/2008,24,0,0,0,26,1,0,51
Yemen,01/06/2008,24,0,0,0,0,0,0,24
Yemen,02/06/2008,2,0,0,0,-2,0,0,0
Yemen,03/06/2008,5,0,0,0,8,0,0,13
Yemen,04/06/2008,12,0,0,0,0,3,0,15
Yemen,05/06/2008,37,0,0,0,6,0,0,43
Yemen,06/06/2008,6,0,0,0,3,0,0,9
Yemen,07/06/2008,1,0,-2,0,0,0,0,-1
Yemen,08/06/2008,-2,0,0,0,0,0,0,-2
Yemen,09/06/2008,42,0,0,0,55,4,0,101
Yemen,10/06/2008,8,0,0,0,2,0,0,10
Yemen,11/06/2008,12,0,0,0,6,0,0,18
Yemen,12/06/2008,3,0,0,0,7,0,0,10
Yemen,13/06/2008,0,0,0,0,-2,0,0,-2
Yemen,14/06/2008,0,0,0,0,0,0,0,0
Yemen,15/06/2008,-1,0,0,0,-2,4,0,1
Yemen,16/06/2008,2,0,0,0,6,0,0,8
Yemen,17/06/2008,0,0,-3,0,3,0,0,0
Yemen,18/06/2008,0,0,0,0,3,0,0,3
Yemen,19/06/2008,1,0,0,0,-4,0,0,-3
Yemen,20/06/2008,6,0,0,0,0,0,0,6
Yemen,21/06/2008,32,0,0,0,18,0,0,50
Yemen,22/06/2008,0,0,0,0,9,0,0,9
Yemen,23/06/2008,3,0,0,0,0,0,0,3
Yemen,24/06/2008,13,0,-2,0,9,0,0,20
Yemen,25/06/2008,10,0,0,0,12,0,0,22
Yemen,26/06/2008,0,0,0,0,0,0,0,0
Yemen,27/06/2008,2,0,0,0,34,2,0,38
Yemen,28/06/2008,0,0,0,0,12,0,0,12
Yemen,29/06/2008,0,0,0,0,1,1,0,2
Yemen,30/06/2008,66,0,0,0,21,1,0,88
Afghanistan,01/10/2008,219,0,1,0,10,8,0,238
Afghanistan,02/10/2008,166,0,0,0,9,23,0,198
Afghanistan,03/10/2008,176,2,0,0,53,15,0,246
Afghanistan,04/10/2008,91,0,0,0,9,9,0,109
Afghanistan,05/10/2008,193,0,0,0,29,9,0,231
Afghanistan,06/10/2008,267,0,-2,0,47,12,0,324
Afghanistan,07/10/2008,92,0,-2,0,3,11,0,104
Afghanistan,08/10/2008,191,2,0,0,7,11,0,211
Afghanistan,09/10/2008,258,2,-2,0,26,5,0,289
Afghanistan,10/10/2008,157,0,-4,0,24,23,0,200
Afghanistan,11/10/2008,110,0,-5,0,11,11,0,127
Afghanistan,12/10/2008,240,0,2,0,3,19,0,264
Afghanistan,13/10/2008,270,0,0,0,49,18,0,337
Afghanistan,14/10/2008,241,0,0,0,102,2,0,345
Afghanistan,15/10/2008,179,2,-1,0,27,21,0,228
Afghanistan,16/10/2008,150,0,0,0,42,9,0,201
Afghanistan,17/10/2008,136,0,1,0,6,7,0,150
Afghanistan,18/10/2008,86,0,0,0,8,8,0,102
Afghanistan,19/10/2008,120,0,0,0,12,5,0,137
Afghanistan,20/10/2008,129,0,0,0,13,22,0,164
Afghanistan,21/10/2008,83,0,0,0,21,25,0,129
Afghanistan,22/10/2008,136,2,-2,0,59,10,0,205
Afghanistan,23/10/2008,255,0,0,0,48,14,0,317
Afghanistan,24/10/2008,113,0,-2,0,29,13,0,153
Afghanistan,25/10/2008,161,0,0,0,84,8,0,253
Afghanistan,26/10/2008,237,0,2,0,58,7,0,304
Afghanistan,27/10/2008,219,0,0,0,23,7,0,249
Afghanistan,28/10/2008,133,8,0,0,23,5,0,169
Afghanistan,29/10/2008,237,0,0,0,46,7,0,290
Afghanistan,30/10/2008,74,0,1,0,30,12,0,117
Afghanistan,31/10/2008,190,0,-3,0,45,51,0,283
Albania,01/10/2008,2,0,0,0,-2,0,0,0
Albania,02/10/2008,6,0,0,0,0,1,0,7
Albania,03/10/2008,18,0,-4,0,0,0,0,14
Albania,04/10/2008,0,0,0,0,0,0,0,0
Albania,05/10/2008,0,0,0,0,0,0,0,0
Albania,06/10/2008,0,0,0,0,0,0,0,0
Albania,07/10/2008,4,0,-1,0,-1,0,0,2
Albania,08/10/2008,6,4,-3,0,-7,2,0,2
Albania,09/10/2008,26,0,0,0,7,1,0,34
Albania,10/10/2008,19,0,-5,0,3,2,0,19
Albania,11/10/2008,0,0,0,0,0,0,0,0
Albania,12/10/2008,0,0,0,0,0,0,0,0
Albania,13/10/2008,7,0,0,0,3,0,0,10
Albania,14/10/2008,5,0,0,0,0,0,0,5
Albania,15/10/2008,0,0,-3,0,6,0,0,3
Albania,16/10/2008,0,0,-2,0,3,0,0,1
Albania,17/10/2008,4,0,0,0,6,-2,0,8
Albania,18/10/2008,6,0,0,0,-2,0,0,4
Albania,19/10/2008,3,0,0,0,0,0,0,3
Albania,20/10/2008,9,0,0,0,0,1,0,10
Albania,21/10/2008,2,0,0,0,9,0,0,11
Albania,22/10/2008,9,0,0,0,0,0,0,9
Albania,23/10/2008,-2,0,0,0,3,1,0,2
Albania,24/10/2008,1,0,0,0,0,1,0,2
Albania,25/10/2008,4,0,0,0,-4,0,0,0
Albania,26/10/2008,0,0,0,0,3,0,0,3
Albania,27/10/2008,9,0,0,0,3,0,0,12
Albania,28/10/2008,2,0,0,0,0,0,0,2
Albania,29/10/2008,9,0,0,0,0,0,0,9
Albania,30/10/2008,12,0,0,0,6,5,0,23
Albania,31/10/2008,8,0,-2,0,3,0,0,9
Algeria,01/10/2008,6,0,0,0,0,0,0,6
Algeria,02/10/2008,2,0,0,0,6,0,0,8
Algeria,03/10/2008,1,0,0,0,0,0,0,1
Algeria,04/10/2008,0,0,0,0,0,0,0,0
Algeria,05/10/2008,0,0,0,0,0,0,0,0
Algeria,06/10/2008,-2,0,0,0,-2,0,0,-4
Algeria,07/10/2008,-1,0,0,0,12,0,0,11
Algeria,08/10/2008,0,0,-2,0,-5,0,0,-7
Algeria,09/10/2008,2,0,0,0,0,0,0,2
Algeria,10/10/2008,0,0,0,0,0,1,0,1
Algeria,11/10/2008,0,0,0,0,0,0,0,0
Algeria,12/10/2008,0,0,0,0,6,0,0,6
Algeria,13/10/2008,0,0,0,0,0,0,0,0
Algeria,14/10/2008,0,0,0,0,0,0,0,0
Algeria,15/10/2008,-2,0,0,0,3,5,0,6
Algeria,16/10/2008,1,0,0,0,20,0,0,21
Algeria,17/10/2008,0,0,0,0,0,0,0,0
Algeria,18/10/2008,0,0,0,0,3,0,0,3
Algeria,19/10/2008,3,0,0,0,0,0,0,3
Algeria,20/10/2008,2,0,0,0,12,0,0,14
Algeria,21/10/2008,15,0,0,0,12,0,0,27
Algeria,22/10/2008,14,0,0,0,9,0,0,23
Algeria,23/10/2008,8,0,0,0,4,1,0,13
Algeria,24/10/2008,5,0,0,0,0,0,0,5
Algeria,25/10/2008,1,0,0,0,0,0,0,1
Algeria,26/10/2008,2,0,0,0,0,0,0,2
Algeria,27/10/2008,0,0,0,0,0,0,0,0
Algeria,28/10/2008,0,0,0,0,0,0,0,0
Algeria,29/10/2008,-1,0,0,0,0,0,0,-1
Algeria,30/10/2008,1,0,0,0,0,0,0,1
Algeria,31/10/2008,4,0,0,0,33,0,0,37
Bangladesh,01/10/2008,10,0,0,0,0,0,0,10
Bangladesh,02/10/2008,7,0,0,0,3,1,0,11
Bangladesh,03/10/2008,2,0,0,0,10,2,0,14
Bangladesh,04/10/2008,0,0,0,0,2,0,0,2
Bangladesh,05/10/2008,30,0,0,0,0,4,0,34
Bangladesh,06/10/2008,100,2,0,0,0,0,0,102
Bangladesh,07/10/2008,35,0,0,0,9,10,0,54
Bangladesh,08/10/2008,21,0,0,0,0,1,0,22
Bangladesh,09/10/2008,5,0,0,0,0,0,0,5
Bangladesh,10/10/2008,13,0,0,0,16,2,0,31
Bangladesh,11/10/2008,13,0,0,0,6,0,0,19
Bangladesh,12/10/2008,21,0,0,0,9,1,0,31
Bangladesh,13/10/2008,5,0,1,0,-2,0,0,4
Bangladesh,14/10/2008,28,0,0,0,9,2,0,39
Bangladesh,15/10/2008,9,0,-2,0,0,6,0,13
Bangladesh,16/10/2008,2,0,0,0,-4,0,0,-2
Bangladesh,17/10/2008,48,0,0,0,43,0,0,91
Bangladesh,18/10/2008,0,0,-2,0,1,0,0,-1
Bangladesh,19/10/2008,1,0,0,0,3,1,0,5
Bangladesh,20/10/2008,4,0,0,0,14,0,0,18
Bangladesh,21/10/2008,4,0,0,0,3,1,0,8
Bangladesh,22/10/2008,4,0,0,0,3,0,0,7
Bangladesh,23/10/2008,1,0,0,0,9,0,0,10
Bangladesh,24/10/2008,-4,0,0,0,11,0,0,7
Bangladesh,25/10/2008,37,0,0,0,9,0,0,46
Bangladesh,26/10/2008,29,0,0,0,-2,0,0,27
Bangladesh,27/10/2008,7,0,0,0,0,0,0,7
Bangladesh,28/10/2008,4,0,0,0,6,0,0,10
Bangladesh,29/10/2008,15,0,0,0,9,1,0,25
Bangladesh,30/10/2008,91,0,0,0,12,12,0,115
Bangladesh,31/10/2008,68,0,-4,0,23,7,0,94
Cameroon,01/10/2008,0,0,0,0,0,0,0,0
Cameroon,02/10/2008,0,0,0,0,0,0,0,0
Cameroon,04/10/2008,0,0,0,0,3,0,0,3
Cameroon,06/10/2008,1,0,0,0,3,0,0,4
Cameroon,07/10/2008,3,0,0,0,0,0,0,3
Cameroon,09/10/2008,0,0,0,0,3,0,0,3
Cameroon,10/10/2008,5,0,0,0,0,0,0,5
Cameroon,11/10/2008,13,0,0,0,0,0,0,13
Cameroon,14/10/2008,-1,0,0,0,0,0,0,-1
Cameroon,15/10/2008,0,0,0,0,0,0,0,0
Cameroon,16/10/2008,0,0,0,0,0,0,0,0
Cameroon,17/10/2008,0,0,0,0,0,0,0,0
Cameroon,19/10/2008,0,0,0,0,3,0,0,3
Cameroon,20/10/2008,0,0,0,0,3,0,0,3
Cameroon,21/10/2008,3,0,0,0,0,0,0,3
Cameroon,22/10/2008,0,0,0,0,0,0,0,0
Cameroon,23/10/2008,0,0,0,0,0,0,0,0
Cameroon,24/10/2008,6,0,0,0,-2,0,0,4
Cameroon,26/10/2008,4,0,0,0,0,0,0,4
Cameroon,27/10/2008,4,0,0,0,0,0,0,4
Cameroon,28/10/2008,0,0,0,0,0,0,0,0
Cameroon,29/10/2008,0,0,0,0,0,0,0,0
Cameroon,31/10/2008,11,0,4,0,-1,0,0,14
China,01/10/2008,77,2,-1,0,33,13,0,124
China,02/10/2008,64,0,3,0,66,17,0,150
China,03/10/2008,74,0,1,0,95,12,0,182
China,04/10/2008,47,0,0,0,34,4,0,85
China,05/10/2008,34,0,0,0,45,7,0,86
China,06/10/2008,121,4,0,0,49,19,0,193
China,07/10/2008,85,4,1,0,33,14,0,137
China,08/10/2008,65,4,-15,0,32,9,0,95
China,09/10/2008,91,0,-3,0,56,10,0,154
China,10/10/2008,78,4,1,0,37,7,0,127
China,11/10/2008,56,0,-7,0,3,11,0,63
China,12/10/2008,34,2,1,0,22,0,0,59
China,13/10/2008,49,0,-4,0,37,7,0,89
China,14/10/2008,68,2,1,0,11,7,0,89
China,15/10/2008,60,2,-5,0,40,21,0,118
China,16/10/2008,46,0,-4,0,38,6,0,86
China,17/10/2008,70,0,-8,0,34,15,0,111
China,18/10/2008,55,2,3,0,39,4,0,103
China,19/10/2008,29,2,-2,0,22,7,0,58
China,20/10/2008,58,2,-2,0,26,10,0,94
China,21/10/2008,55,0,-4,0,13,7,0,71
China,22/10/2008,57,8,0,0,23,5,0,93
China,23/10/2008,70,4,1,0,24,22,0,121
China,24/10/2008,57,0,-1,0,-9,32,0,79
China,25/10/2008,27,0,1,0,18,7,0,53
China,26/10/2008,58,0,0,0,21,23,0,102
China,27/10/2008,107,4,-4,0,98,12,0,217
China,28/10/2008,135,2,0,0,98,22,0,257
China,29/10/2008,129,4,1,0,77,23,0,234
China,30/10/2008,101,0,0,0,52,20,0,173
China,31/10/2008,144,0,0,0,89,20,0,253
Egypt,01/10/2008,30,0,0,0,3,2,0,35
Egypt,02/10/2008,2,0,-2,0,15,6,0,21
Egypt,03/10/2008,20,0,1,0,-3,0,0,18
Egypt,04/10/2008,2,0,0,0,0,0,0,2
Egypt,05/10/2008,18,0,0,0,-2,6,0,22
Egypt,06/10/2008,24,0,0,0,21,1,0,46
Egypt,07/10/2008,17,0,2,0,15,0,0,34
Egypt,08/10/2008,42,0,0,0,17,11,0,70
Egypt,09/10/2008,25,0,0,0,30,2,0,57
Egypt,10/10/2008,18,0,0,0,4,0,0,22
Egypt,11/10/2008,20,0,0,0,7,0,0,27
Egypt,12/10/2008,60,0,-1,0,3,0,0,62
Egypt,13/10/2008,24,0,0,0,0,2,0,26
Egypt,14/10/2008,27,0,0,0,7,0,0,34
Egypt,15/10/2008,22,0,-1,0,9,0,0,30
Egypt,16/10/2008,17,0,0,0,4,8,0,29
Egypt,17/10/2008,15,0,0,0,15,6,0,36
Egypt,18/10/2008,19,0,0,0,9,10,0,38
Egypt,19/10/2008,13,0,-2,0,6,0,0,17
Egypt,20/10/2008,24,0,-1,0,0,2,0,25
Egypt,21/10/2008,36,0,0,0,2,0,0,38
Egypt,22/10/2008,74,0,0,0,-5,3,0,72
Egypt,23/10/2008,35,0,1,0,13,4,0,53
Egypt,24/10/2008,27,0,0,0,20,0,0,47
Egypt,25/10/2008,46,0,-1,0,0,0,0,45
Egypt,26/10/2008,36,0,3,0,9,4,0,52
Egypt,27/10/2008,27,0,2,0,0,0,0,29
Egypt,28/10/2008,51,0,0,0,32,0,0,83
Egypt,29/10/2008,37,0,0,0,16,5,0,58
Egypt,30/10/2008,49,0,-2,0,-16,5,0,36
Egypt,31/10/2008,24,0,-2,0,0,7,0,29
Eritrea,01/10/2008,3,0,0,0,0,0,0,3
Eritrea,02/10/2008,0,0,0,0,0,0,0,0
Eritrea,03/10/2008,0,0,0,0,0,0,0,0
Eritrea,05/10/2008,0,0,0,0,0,0,0,0
Eritrea,06/10/2008,3,0,0,0,0,0,0,3
Eritrea,07/10/2008,0,0,0,0,0,0,0,0
Eritrea,08/10/2008,2,0,0,0,9,0,0,11
Eritrea,09/10/2008,2,0,0,0,0,0,0,2
Eritrea,10/10/2008,2,0,0,0,0,0,0,2
Eritrea,12/10/2008,0,0,0,0,12,0,0,12
Eritrea,13/10/2008,2,0,0,0,3,0,0,5
Eritrea,14/10/2008,9,0,0,0,0,0,0,9
Eritrea,15/10/2008,-1,0,0,0,0,0,0,-1
Eritrea,16/10/2008,1,0,0,0,-2,1,0,0
Eritrea,18/10/2008,0,0,0,0,0,0,0,0
Eritrea,19/10/2008,3,0,0,0,0,0,0,3
Eritrea,20/10/2008,2,0,0,0,0,0,0,2
Eritrea,21/10/2008,0,0,0,0,9,0,0,9
Eritrea,22/10/2008,3,0,0,0,0,0,0,3
Eritrea,23/10/2008,14,0,0,0,0,0,0,14
Eritrea,24/10/2008,15,0,0,0,0,0,0,15
Eritrea,25/10/2008,4,0,0,0,0,0,0,4
Eritrea,26/10/2008,0,0,0,0,0,0,0,0
Eritrea,27/10/2008,2,0,0,0,-1,0,0,1
Eritrea,28/10/2008,2,0,0,0,0,0,0,2
Eritrea,29/10/2008,3,0,0,0,0,0,0,3
Eritrea,30/10/2008,0,0,0,0,0,0,0,0
Eritrea,31/10/2008,0,0,0,0,0,0,0,0
Georgia,01/10/2008,10,2,-1,0,6,1,0,18
Georgia,02/10/2008,-2,4,0,0,0,0,0,2
Georgia,03/10/2008,5,0,0,0,6,0,0,11
Georgia,04/10/2008,7,0,0,0,3,0,0,10
Georgia,05/10/2008,0,0,0,0,0,2,0,2
Georgia,06/10/2008,15,0,0,0,-8,1,0,8
Georgia,07/10/2008,8,0,0,0,-2,0,0,6
Georgia,08/10/2008,3,2,0,0,0,0,0,5
Georgia,09/10/2008,14,0,0,0,0,2,0,16
Georgia,10/10/2008,8,0,0,0,-6,0,0,2
Georgia,11/10/2008,11,0,0,0,0,10,0,21
Georgia,12/10/2008,5,0,0,0,0,0,0,5
Georgia,13/10/2008,1,0,0,0,0,1,0,2
Georgia,14/10/2008,1,0,-1,0,0,0,0,0
Georgia,15/10/2008,11,0,1,0,21,1,0,34
Georgia,16/10/2008,6,0,0,0,-3,1,0,4
Georgia,17/10/2008,4,0,0,0,0,3,0,7
Georgia,18/10/2008,3,0,0,0,0,0,0,3
Georgia,19/10/2008,0,0,0,0,0,1,0,1
Georgia,20/10/2008,1,0,0,0,8,0,0,9
Georgia,21/10/2008,1,0,0,0,0,0,0,1
Georgia,22/10/2008,10,0,0,0,9,1,0,20
Georgia,23/10/2008,9,0,0,0,-10,1,0,0
Georgia,24/10/2008,21,2,1,0,5,3,0,32
Georgia,25/10/2008,8,0,0,0,3,1,0,12
Georgia,26/10/2008,0,0,0,0,9,0,0,9
Georgia,27/10/2008,19,0,0,0,0,1,0,20
Georgia,28/10/2008,6,0,0,0,3,1,0,10
Georgia,29/10/2008,0,0,0,0,0,1,0,1
Georgia,30/10/2008,18,0,0,0,9,5,0,32
Georgia,31/10/2008,9,0,1,0,3,0,0,13
India,01/10/2008,33,2,-6,0,10,2,0,41
India,02/10/2008,33,2,-3,0,15,0,0,47
India,03/10/2008,46,0,-2,0,13,10,0,67
India,04/10/2008,19,2,-1,0,3,10,0,33
India,05/10/2008,57,0,-2,0,19,3,0,77
India,06/10/2008,35,0,-1,0,8,1,0,43
India,07/10/2008,10,0,-2,0,11,12,0,31
India,08/10/2008,35,2,0,0,31,4,0,72
India,09/10/2008,5,0,0,0,18,3,0,26
India,10/10/2008,36,0,1,0,0,2,0,39
India,11/10/2008,17,2,-2,0,8,0,0,25
India,12/10/2008,58,0,0,0,12,9,0,79
India,13/10/2008,44,2,2,0,17,0,0,65
India,14/10/2008,29,0,-4,0,16,1,0,42
India,15/10/2008,47,0,0,0,17,3,0,67
India,16/10/2008,19,0,0,0,0,1,0,20
India,17/10/2008,10,0,0,0,1,6,0,17
India,18/10/2008,16,0,0,0,9,3,0,28
India,19/10/2008,0,0,0,0,0,2,0,2
India,20/10/2008,11,0,0,0,15,2,0,28
India,21/10/2008,18,0,1,0,6,2,0,27
India,22/10/2008,48,0,0,0,16,4,0,68
India,23/10/2008,31,0,1,0,21,5,0,58
India,24/10/2008,26,0,0,0,7,10,0,43
India,25/10/2008,19,0,0,0,13,5,0,37
India,26/10/2008,28,0,0,0,17,2,0,47
India,27/10/2008,19,2,0,0,22,19,0,62
India,28/10/2008,33,0,0,0,12,4,0,49
India,29/10/2008,102,0,-4,0,-3,4,0,99
India,30/10/2008,50,0,0,0,19,24,0,93
India,31/10/2008,68,0,0,0,20,4,0,92
Iran,01/10/2008,34,0,0,0,-2,12,0,44
Iran,02/10/2008,24,0,0,0,0,10,0,34
Iran,03/10/2008,16,0,0,0,-2,5,0,19
Iran,04/10/2008,43,0,0,0,6,0,0,49
Iran,05/10/2008,33,0,0,0,1,5,0,39
Iran,06/10/2008,30,0,0,0,7,1,0,38
Iran,07/10/2008,40,2,0,0,5,1,0,48
Iran,08/10/2008,20,0,0,0,0,0,0,20
Iran,09/10/2008,45,2,1,0,14,13,0,75
Iran,10/10/2008,10,0,-4,0,2,9,0,17
Iran,11/10/2008,33,0,0,0,-11,5,0,27
Iran,12/10/2008,16,0,0,0,6,1,0,23
Iran,13/10/2008,13,0,0,0,19,0,0,32
Iran,14/10/2008,20,0,0,0,8,3,0,31
Iran,15/10/2008,23,0,0,0,0,9,0,32
Iran,16/10/2008,13,0,1,0,24,5,0,43
Iran,17/10/2008,32,0,0,0,1,3,0,36
Iran,18/10/2008,35,0,0,0,14,4,0,53
Iran,19/10/2008,4,0,0,0,12,5,0,21
Iran,20/10/2008,10,0,0,0,12,3,0,25
Iran,21/10/2008,33,0,0,0,12,4,0,49
Iran,22/10/2008,61,0,0,0,10,1,0,72
Iran,23/10/2008,29,0,-1,0,6,5,0,39
Iran,24/10/2008,38,0,0,0,12,1,0,51
Iran,25/10/2008,19,0,0,0,5,11,0,35
Iran,26/10/2008,11,0,2,0,6,0,0,19
Iran,27/10/2008,26,0,0,0,24,20,0,70
Iran,28/10/2008,36,0,2,0,15,4,0,57
Iran,29/10/2008,34,0,-3,0,3,2,0,36
Iran,30/10/2008,42,0,0,0,4,3,0,49
Iran,31/10/2008,41,0,1,0,18,2,0,62
Iraq,01/10/2008,147,0,-1,0,24,7,0,177
Iraq,02/10/2008,68,0,1,0,6,2,0,77
Iraq,03/10/2008,177,0,-1,0,28,3,0,207
Iraq,04/10/2008,298,0,0,0,49,10,0,357
Iraq,05/10/2008,409,2,1,0,42,15,0,469
Iraq,06/10/2008,357,0,1,0,22,27,0,407
Iraq,07/10/2008,197,0,0,0,11,8,0,216
Iraq,08/10/2008,256,0,0,0,27,16,0,299
Iraq,09/10/2008,165,0,0,0,36,7,0,208
Iraq,10/10/2008,157,0,-2,0,19,23,0,197
Iraq,11/10/2008,148,2,-2,0,7,10,0,165
Iraq,12/10/2008,239,0,-1,0,39,4,0,281
Iraq,13/10/2008,212,2,0,0,29,22,0,265
Iraq,14/10/2008,107,0,0,0,23,12,0,142
Iraq,15/10/2008,183,0,0,0,27,5,0,215
Iraq,16/10/2008,145,2,-1,0,73,2,0,221
Iraq,17/10/2008,154,0,-3,0,49,12,0,212
Iraq,18/10/2008,48,0,-2,0,11,2,0,59
Iraq,19/10/2008,38,0,0,0,9,11,0,58
Iraq,20/10/2008,72,0,-6,0,45,4,0,115
Iraq,21/10/2008,78,4,0,0,23,6,0,111
Iraq,22/10/2008,94,0,-1,0,7,8,0,108
Iraq,23/10/2008,168,6,-1,0,17,15,0,205
Iraq,24/10/2008,121,0,0,0,4,6,0,131
Iraq,25/10/2008,100,0,0,0,10,19,0,129
Iraq,26/10/2008,193,0,3,0,20,6,0,222
Iraq,27/10/2008,423,0,2,0,19,24,0,468
Iraq,28/10/2008,372,0,-6,0,50,23,0,439
Iraq,29/10/2008,262,0,-1,0,57,22,0,340
Iraq,30/10/2008,225,0,-1,0,62,35,0,321
Iraq,31/10/2008,216,0,0,0,33,24,0,273
Morocco,01/10/2008,4,0,0,0,-6,0,0,-2
Morocco,02/10/2008,0,0,0,0,0,0,0,0
Morocco,03/10/2008,6,0,0,0,9,0,0,15
Morocco,04/10/2008,1,0,0,0,0,0,0,1
Morocco,05/10/2008,2,0,0,0,3,0,0,5
Morocco,06/10/2008,4,0,0,0,3,3,0,10
Morocco,07/10/2008,18,0,0,0,4,0,0,22
Morocco,08/10/2008,2,0,0,0,0,0,0,2
Morocco,09/10/2008,19,0,0,0,-2,0,0,17
Morocco,10/10/2008,3,0,0,0,0,0,0,3
Morocco,11/10/2008,2,0,0,0,0,0,0,2
Morocco,12/10/2008,1,0,0,0,0,0,0,1
Morocco,13/10/2008,2,0,0,0,0,1,0,3
Morocco,14/10/2008,2,0,0,0,8,0,0,10
Morocco,15/10/2008,75,0,0,0,4,0,0,79
Morocco,16/10/2008,54,0,0,0,15,2,0,71
Morocco,17/10/2008,3,0,0,0,9,0,0,12
Morocco,18/10/2008,3,0,0,0,0,0,0,3
Morocco,19/10/2008,0,0,0,0,0,4,0,4
Morocco,20/10/2008,0,0,0,0,0,0,0,0
Morocco,21/10/2008,10,0,0,0,24,1,0,35
Morocco,22/10/2008,0,0,0,0,12,0,0,12
Morocco,23/10/2008,0,0,0,0,0,0,0,0
Morocco,24/10/2008,3,0,0,0,6,0,0,9
Morocco,25/10/2008,6,0,0,0,6,0,0,12
Morocco,26/10/2008,0,0,0,0,0,0,0,0
Morocco,27/10/2008,5,0,0,0,12,0,0,17
Morocco,28/10/2008,0,0,0,0,0,0,0,0
Morocco,29/10/2008,3,0,0,0,3,0,0,6
Morocco,30/10/2008,0,0,0,0,12,0,0,12
Morocco,31/10/2008,15,0,0,0,56,1,0,72
Nigeria,01/10/2008,5,0,0,0,0,0,0,5
Nigeria,02/10/2008,-3,0,0,0,0,1,0,-2
Nigeria,03/10/2008,-1,0,0,0,0,0,0,-1
Nigeria,04/10/2008,0,0,0,0,0,0,0,0
Nigeria,05/10/2008,6,0,0,0,0,0,0,6
Nigeria,06/10/2008,1,0,0,0,-8,0,0,-7
Nigeria,07/10/2008,6,0,0,0,9,4,0,19
Nigeria,08/10/2008,17,0,0,0,9,0,0,26
Nigeria,09/10/2008,12,0,1,0,-3,3,0,13
Nigeria,10/10/2008,13,2,0,0,3,0,0,18
Nigeria,11/10/2008,3,0,0,0,6,0,0,9
Nigeria,12/10/2008,3,0,0,0,-2,1,0,2
Nigeria,13/10/2008,0,0,0,0,-2,0,0,-2
Nigeria,14/10/2008,1,0,0,0,-1,2,0,2
Nigeria,15/10/2008,8,0,0,0,-4,0,0,4
Nigeria,16/10/2008,15,2,0,0,-2,6,0,21
Nigeria,17/10/2008,0,0,0,0,0,0,0,0
Nigeria,18/10/2008,11,0,0,0,6,0,0,17
Nigeria,19/10/2008,0,2,0,0,0,0,0,2
Nigeria,20/10/2008,1,0,0,0,9,7,0,17
Nigeria,21/10/2008,7,0,0,0,0,0,0,7
Nigeria,22/10/2008,4,0,2,0,6,0,0,12
Nigeria,23/10/2008,2,0,0,0,21,2,0,25
Nigeria,24/10/2008,7,0,0,0,17,0,0,24
Nigeria,25/10/2008,-4,0,0,0,3,0,0,-1
Nigeria,27/10/2008,25,4,0,0,3,0,0,32
Nigeria,28/10/2008,24,0,2,0,4,1,0,31
Nigeria,29/10/2008,0,0,0,0,9,0,0,9
Nigeria,30/10/2008,21,0,0,0,3,18,0,42
Nigeria,31/10/2008,14,0,0,0,1,2,0,17
Pakistan,01/10/2008,82,4,1,0,7,5,0,99
Pakistan,02/10/2008,55,0,0,0,-2,3,0,56
Pakistan,03/10/2008,42,0,1,0,23,0,0,66
Pakistan,04/10/2008,55,0,2,0,15,1,0,73
Pakistan,05/10/2008,31,4,0,0,22,0,0,57
Pakistan,06/10/2008,92,4,-2,0,23,17,0,134
Pakistan,07/10/2008,22,0,-3,0,-8,0,0,11
Pakistan,08/10/2008,70,0,-6,0,-6,0,0,58
Pakistan,09/10/2008,24,0,-1,0,-24,10,0,9
Pakistan,10/10/2008,78,2,0,0,14,1,0,95
Pakistan,11/10/2008,37,2,0,0,1,8,0,48
Pakistan,12/10/2008,54,0,0,0,10,3,0,67
Pakistan,13/10/2008,72,0,0,0,6,0,0,78
Pakistan,14/10/2008,62,0,2,0,36,2,0,102
Pakistan,15/10/2008,47,6,0,0,42,4,0,99
Pakistan,16/10/2008,46,2,0,0,23,0,0,71
Pakistan,17/10/2008,14,0,0,0,0,13,0,27
Pakistan,18/10/2008,5,0,0,0,-9,0,0,-4
Pakistan,19/10/2008,29,0,0,0,0,4,0,33
Pakistan,20/10/2008,16,0,0,0,12,0,0,28
Pakistan,21/10/2008,18,0,0,0,30,0,0,48
Pakistan,22/10/2008,64,0,0,0,31,1,0,96
Pakistan,23/10/2008,106,0,0,0,100,12,0,218
Pakistan,24/10/2008,75,0,0,0,21,3,0,99
Pakistan,25/10/2008,95,2,0,0,10,3,0,110
Pakistan,26/10/2008,31,0,0,0,-2,3,0,32
Pakistan,27/10/2008,40,0,0,0,12,21,0,73
Pakistan,28/10/2008,82,0,-3,0,3,3,0,85
Pakistan,29/10/2008,82,4,0,0,70,9,0,165
Pakistan,30/10/2008,69,6,1,0,24,16,0,116
Pakistan,31/10/2008,97,6,0,0,41,31,0,175
Sierra Leone,01/10/2008,7,0,0,0,27,0,0,34
Sierra Leone,02/10/2008,2,0,0,0,12,0,0,14
Sierra Leone,03/10/2008,0,0,0,0,9,0,0,9
Sierra Leone,04/10/2008,0,0,0,0,18,0,0,18
Sierra Leone,05/10/2008,0,0,0,0,9,0,0,9
Sierra Leone,06/10/2008,1,0,0,0,3,0,0,4
Sierra Leone,07/10/2008,0,0,0,0,0,0,0,0
Sierra Leone,08/10/2008,0,0,0,0,0,0,0,0
Sierra Leone,09/10/2008,0,0,0,0,0,0,0,0
Sierra Leone,10/10/2008,4,0,0,0,21,0,0,25
Sierra Leone,12/10/2008,15,0,0,0,0,0,0,15
Sierra Leone,13/10/2008,10,0,0,0,-4,0,0,6
Sierra Leone,14/10/2008,8,0,0,0,0,0,0,8
Sierra Leone,15/10/2008,4,0,0,0,0,0,0,4
Sierra Leone,16/10/2008,2,0,0,0,0,0,0,2
Sierra Leone,17/10/2008,0,0,0,0,0,2,0,2
Sierra Leone,18/10/2008,0,0,0,0,0,1,0,1
Sierra Leone,20/10/2008,0,0,1,0,0,0,0,1
Sierra Leone,22/10/2008,0,0,0,0,0,0,0,0
Sierra Leone,27/10/2008,0,0,0,0,0,0,0,0
Sierra Leone,28/10/2008,0,0,0,0,0,0,0,0
Sierra Leone,29/10/2008,0,0,0,0,6,0,0,6
Sierra Leone,30/10/2008,0,0,0,0,3,0,0,3
Sierra Leone,31/10/2008,1,0,0,0,3,0,0,4
Somalia,01/10/2008,92,2,0,0,38,4,0,136
Somalia,02/10/2008,57,2,1,0,15,3,0,78
Somalia,03/10/2008,28,0,0,0,17,0,0,45
Somalia,04/10/2008,13,0,0,0,4,2,0,19
Somalia,05/10/2008,9,0,0,0,18,1,0,28
Somalia,06/10/2008,52,0,0,0,43,6,0,101
Somalia,07/10/2008,59,0,1,0,3,8,0,71
Somalia,08/10/2008,25,0,0,0,7,3,0,35
Somalia,09/10/2008,57,0,0,0,-48,4,0,13
Somalia,10/10/2008,68,0,0,0,-9,5,0,64
Somalia,11/10/2008,19,0,0,0,-2,2,0,19
Somalia,12/10/2008,8,0,0,0,0,2,0,10
Somalia,13/10/2008,44,2,0,0,7,4,0,57
Somalia,14/10/2008,43,0,0,0,6,3,0,52
Somalia,15/10/2008,41,0,0,0,-6,0,0,35
Somalia,16/10/2008,10,0,0,0,-1,4,0,13
Somalia,17/10/2008,26,2,0,0,16,4,0,48
Somalia,18/10/2008,4,0,0,0,9,2,0,15
Somalia,19/10/2008,10,0,5,0,-4,0,0,11
Somalia,20/10/2008,19,0,0,0,0,8,0,27
Somalia,21/10/2008,35,0,0,0,0,1,0,36
Somalia,22/10/2008,29,2,0,0,5,2,0,38
Somalia,23/10/2008,21,2,0,0,-1,0,0,22
Somalia,24/10/2008,21,0,0,0,12,3,0,36
Somalia,25/10/2008,9,0,0,0,12,0,0,21
Somalia,26/10/2008,10,0,0,0,6,0,0,16
Somalia,27/10/2008,5,0,0,0,9,1,0,15
Somalia,28/10/2008,18,0,0,0,4,2,0,24
Somalia,29/10/2008,79,0,0,0,-12,28,0,95
Somalia,30/10/2008,43,0,0,0,15,4,0,62
Somalia,31/10/2008,3,0,0,0,5,2,0,10
Syria,01/10/2008,8,2,0,0,0,1,0,11
Syria,02/10/2008,7,0,0,0,12,5,0,24
Syria,03/10/2008,3,8,0,0,21,0,0,32
Syria,04/10/2008,10,2,0,0,0,0,0,12
Syria,05/10/2008,34,0,1,0,0,0,0,35
Syria,06/10/2008,22,2,0,0,0,0,0,24
Syria,07/10/2008,7,0,2,0,6,1,0,16
Syria,08/10/2008,19,0,0,0,0,1,0,20
Syria,09/10/2008,24,0,0,0,16,0,0,40
Syria,10/10/2008,29,2,0,0,7,2,0,40
Syria,11/10/2008,12,0,0,0,-2,1,0,11
Syria,12/10/2008,24,0,0,0,13,2,0,39
Syria,13/10/2008,23,0,0,0,6,4,0,33
Syria,14/10/2008,15,0,0,0,2,2,0,19
Syria,15/10/2008,22,0,0,0,1,0,0,23
Syria,16/10/2008,-2,0,0,0,0,0,0,-2
Syria,17/10/2008,-5,0,0,0,15,1,0,11
Syria,18/10/2008,7,2,0,0,0,0,0,9
Syria,19/10/2008,4,0,0,0,9,2,0,15
Syria,20/10/2008,12,0,0,0,18,2,0,32
Syria,21/10/2008,31,0,0,0,9,0,0,40
Syria,22/10/2008,6,0,1,0,27,2,0,36
Syria,23/10/2008,16,0,0,0,30,6,0,52
Syria,24/10/2008,16,0,0,0,24,1,0,41
Syria,25/10/2008,5,0,0,0,24,2,0,31
Syria,26/10/2008,81,0,2,0,6,0,0,89
Syria,27/10/2008,464,0,3,0,28,36,0,531
Syria,28/10/2008,285,0,-1,0,7,12,0,303
Syria,29/10/2008,112,0,1,0,0,8,0,121
Syria,30/10/2008,66,0,-1,0,2,10,0,77
Syria,31/10/2008,49,0,0,0,3,0,0,52
Yemen,01/10/2008,1,0,0,0,7,3,0,11
Yemen,02/10/2008,0,0,0,0,3,0,0,3
Yemen,03/10/2008,10,0,0,0,45,0,0,55
Yemen,04/10/2008,7,0,0,0,16,0,0,23
Yemen,05/10/2008,15,0,0,0,5,0,0,20
Yemen,06/10/2008,4,0,0,0,3,0,0,7
Yemen,07/10/2008,1,0,0,0,3,0,0,4
Yemen,09/10/2008,0,0,0,0,0,0,0,0
Yemen,10/10/2008,15,0,0,0,0,0,0,15
Yemen,11/10/2008,0,0,0,0,0,0,0,0
Yemen,12/10/2008,0,0,0,0,-2,0,0,-2
Yemen,13/10/2008,2,0,0,0,6,0,0,8
Yemen,14/10/2008,0,0,0,0,0,0,0,0
Yemen,15/10/2008,0,0,0,0,0,0,0,0
Yemen,16/10/2008,0,0,0,0,10,0,0,10
Yemen,17/10/2008,0,0,0,0,0,0,0,0
Yemen,18/10/2008,10,0,0,0,3,0,0,13
Yemen,19/10/2008,0,0,0,0,0,0,0,0
Yemen,20/10/2008,0,0,0,0,0,0,0,0
Yemen,21/10/2008,2,0,0,0,3,0,0,5
Yemen,22/10/2008,1,0,0,0,21,0,0,22
Yemen,23/10/2008,0,0,0,0,6,0,0,6
Yemen,24/10/2008,6,0,0,0,63,16,0,85
Yemen,25/10/2008,25,0,0,0,12,9,0,46
Yemen,26/10/2008,1,0,0,0,0,0,0,1
Yemen,27/10/2008,33,0,0,0,34,0,0,67
Yemen,28/10/2008,50,0,0,0,6,3,0,59
Yemen,29/10/2008,16,0,0,0,9,0,0,25
Yemen,30/10/2008,28,0,0,0,39,0,0,67
Yemen,31/10/2008,16,0,0,0,33,7,0,56
Afghanistan,01/04/2008,100,0,0,0,21,9,0,130
Afghanistan,02/04/2008,39,0,0,0,3,1,0,43
Afghanistan,03/04/2008,32,0,-1,0,1,23,0,55
Afghanistan,04/04/2008,17,0,-3,0,7,4,0,25
Afghanistan,05/04/2008,219,2,0,0,49,12,0,282
Afghanistan,06/04/2008,39,0,0,0,12,0,0,51
Afghanistan,07/04/2008,104,0,0,0,62,0,0,166
Afghanistan,08/04/2008,145,0,-3,0,58,9,0,209
Afghanistan,09/04/2008,96,0,0,0,23,23,0,142
Afghanistan,10/04/2008,139,0,-2,0,39,82,0,258
Afghanistan,11/04/2008,70,0,-4,0,54,4,0,124
Afghanistan,12/04/2008,62,0,1,0,21,7,0,91
Afghanistan,13/04/2008,67,0,0,0,16,6,0,89
Afghanistan,14/04/2008,176,2,-6,0,28,6,0,206
Afghanistan,15/04/2008,98,0,0,0,17,29,0,144
Afghanistan,16/04/2008,151,2,-7,0,-1,13,0,158
Afghanistan,17/04/2008,168,4,0,0,64,16,0,252
Afghanistan,18/04/2008,166,2,0,0,46,20,0,234
Afghanistan,19/04/2008,63,2,0,0,42,6,0,113
Afghanistan,20/04/2008,103,0,2,0,17,6,0,128
Afghanistan,21/04/2008,143,2,0,0,55,11,0,211
Afghanistan,22/04/2008,142,10,1,0,18,30,0,201
Afghanistan,23/04/2008,137,8,1,0,29,25,0,200
Afghanistan,24/04/2008,132,2,-4,0,43,5,0,178
Afghanistan,25/04/2008,121,0,-2,0,22,34,0,175
Afghanistan,26/04/2008,69,0,0,0,11,3,0,83
Afghanistan,27/04/2008,42,2,0,0,27,4,0,75
Afghanistan,28/04/2008,135,0,-10,0,-5,6,0,126
Afghanistan,29/04/2008,52,0,1,0,18,3,0,74
Afghanistan,30/04/2008,170,8,0,0,29,14,0,221
Albania,01/04/2008,11,0,-2,0,3,0,0,12
Albania,02/04/2008,11,0,0,0,20,0,0,31
Albania,03/04/2008,0,0,-5,0,30,17,0,42
Albania,04/04/2008,21,0,-1,0,15,1,0,36
Albania,05/04/2008,27,0,-3,0,27,2,0,53
Albania,06/04/2008,0,0,-2,0,0,0,0,-2
Albania,07/04/2008,8,0,-2,0,6,1,0,13
Albania,08/04/2008,8,0,0,0,4,1,0,13
Albania,09/04/2008,24,0,-7,0,2,0,0,19
Albania,10/04/2008,17,0,-1,0,-2,2,0,16
Albania,11/04/2008,-4,0,0,0,-2,0,0,-6
Albania,12/04/2008,17,0,0,0,16,3,0,36
Albania,13/04/2008,8,0,0,0,0,0,0,8
Albania,14/04/2008,7,0,-2,0,3,0,0,8
Albania,15/04/2008,8,0,0,0,6,0,0,14
Albania,16/04/2008,13,0,0,0,18,0,0,31
Albania,17/04/2008,19,0,0,0,6,0,0,25
Albania,18/04/2008,29,0,0,0,3,0,0,32
Albania,19/04/2008,0,0,0,0,0,-4,0,-4
Albania,20/04/2008,2,0,0,0,0,0,0,2
Albania,21/04/2008,3,0,0,0,0,0,0,3
Albania,22/04/2008,7,0,-2,0,9,2,0,16
Albania,23/04/2008,5,0,0,0,6,0,0,11
Albania,24/04/2008,0,0,0,0,0,0,0,0
Albania,25/04/2008,0,0,0,0,0,0,0,0
Albania,26/04/2008,0,0,0,0,0,0,0,0
Albania,27/04/2008,4,0,0,0,0,0,0,4
Albania,28/04/2008,6,0,0,0,2,0,0,8
Albania,29/04/2008,0,0,0,0,0,1,0,1
Albania,30/04/2008,12,0,0,0,-2,0,0,10
Algeria,01/04/2008,7,0,0,0,3,0,0,10
Algeria,02/04/2008,5,0,0,0,7,0,0,12
Algeria,03/04/2008,0,0,0,0,0,0,0,0
Algeria,04/04/2008,2,0,0,0,0,0,0,2
Algeria,05/04/2008,8,0,0,0,0,3,0,11
Algeria,06/04/2008,2,0,0,0,3,3,0,8
Algeria,07/04/2008,13,0,0,0,2,8,0,23
Algeria,08/04/2008,21,0,0,0,23,0,0,44
Algeria,09/04/2008,16,0,0,0,3,0,0,19
Algeria,10/04/2008,9,0,0,0,6,0,0,15
Algeria,11/04/2008,4,0,0,0,0,0,0,4
Algeria,13/04/2008,0,0,0,0,0,0,0,0
Algeria,14/04/2008,2,0,0,0,-1,0,0,1
Algeria,15/04/2008,2,0,0,0,0,1,0,3
Algeria,16/04/2008,2,0,0,0,0,0,0,2
Algeria,17/04/2008,8,0,0,0,6,0,0,14
Algeria,18/04/2008,0,0,0,0,0,1,0,1
Algeria,19/04/2008,0,0,0,0,-2,0,0,-2
Algeria,20/04/2008,2,0,0,0,0,0,0,2
Algeria,21/04/2008,15,0,0,0,0,1,0,16
Algeria,22/04/2008,0,0,0,0,0,0,0,0
Algeria,23/04/2008,1,0,0,0,-4,0,0,-3
Algeria,24/04/2008,2,0,0,0,-4,2,0,0
Algeria,25/04/2008,0,0,0,0,6,0,0,6
Algeria,26/04/2008,6,0,0,0,0,0,0,6
Algeria,27/04/2008,2,0,0,0,0,2,0,4
Algeria,28/04/2008,4,0,1,0,0,0,0,5
Algeria,29/04/2008,2,0,0,0,0,0,0,2
Algeria,30/04/2008,26,0,0,0,0,1,0,27
Bangladesh,01/04/2008,3,0,0,0,6,0,0,9
Bangladesh,02/04/2008,3,0,0,0,6,0,0,9
Bangladesh,03/04/2008,0,0,0,0,9,0,0,9
Bangladesh,04/04/2008,0,0,0,0,0,0,0,0
Bangladesh,05/04/2008,9,0,0,0,0,0,0,9
Bangladesh,06/04/2008,0,0,0,0,3,0,0,3
Bangladesh,07/04/2008,-1,0,0,0,6,0,0,5
Bangladesh,08/04/2008,24,0,-4,0,2,0,0,22
Bangladesh,09/04/2008,8,0,0,0,9,0,0,17
Bangladesh,10/04/2008,3,0,0,0,9,0,0,12
Bangladesh,11/04/2008,-1,0,0,0,10,1,0,10
Bangladesh,12/04/2008,2,0,0,0,0,0,0,2
Bangladesh,13/04/2008,0,0,-2,0,3,0,0,1
Bangladesh,14/04/2008,11,0,0,0,6,0,0,17
Bangladesh,15/04/2008,4,0,0,0,0,1,0,5
Bangladesh,16/04/2008,9,0,1,0,4,2,0,16
Bangladesh,17/04/2008,15,4,0,0,-6,3,0,16
Bangladesh,18/04/2008,0,0,0,0,0,0,0,0
Bangladesh,19/04/2008,0,2,0,0,3,0,0,5
Bangladesh,20/04/2008,4,2,0,0,3,0,0,9
Bangladesh,21/04/2008,14,0,0,0,9,1,0,24
Bangladesh,22/04/2008,49,0,0,0,3,8,0,60
Bangladesh,23/04/2008,14,2,1,0,9,1,0,27
Bangladesh,24/04/2008,7,2,0,0,0,0,0,9
Bangladesh,25/04/2008,6,0,0,0,3,1,0,10
Bangladesh,26/04/2008,9,0,0,0,3,0,0,12
Bangladesh,27/04/2008,8,0,-2,0,3,0,0,9
Bangladesh,28/04/2008,8,0,0,0,3,2,0,13
Bangladesh,29/04/2008,-1,0,0,0,2,0,0,1
Bangladesh,30/04/2008,10,0,0,0,0,11,0,21
Cameroon,01/04/2008,4,0,0,0,0,0,0,4
Cameroon,02/04/2008,3,0,0,0,3,0,0,6
Cameroon,03/04/2008,1,0,0,0,0,0,0,1
Cameroon,05/04/2008,4,0,0,0,-4,2,0,2
Cameroon,06/04/2008,0,0,0,0,0,0,0,0
Cameroon,07/04/2008,0,0,0,0,3,0,0,3
Cameroon,08/04/2008,0,0,-3,0,0,5,0,2
Cameroon,09/04/2008,3,0,0,0,-2,1,0,2
Cameroon,10/04/2008,2,0,0,0,0,0,0,2
Cameroon,11/04/2008,9,0,0,0,-2,2,0,9
Cameroon,12/04/2008,0,0,0,0,-8,0,0,-8
Cameroon,13/04/2008,0,0,0,0,0,0,0,0
Cameroon,14/04/2008,2,0,0,0,27,4,0,33
Cameroon,15/04/2008,0,0,0,0,0,0,0,0
Cameroon,16/04/2008,3,0,0,0,3,1,0,7
Cameroon,17/04/2008,0,0,0,0,0,0,0,0
Cameroon,18/04/2008,0,0,0,0,0,0,0,0
Cameroon,21/04/2008,0,0,0,0,-2,0,0,-2
Cameroon,22/04/2008,0,0,0,0,0,0,0,0
Cameroon,23/04/2008,2,0,0,0,3,0,0,5
Cameroon,24/04/2008,8,2,0,0,3,0,0,13
Cameroon,25/04/2008,2,0,0,0,0,0,0,2
Cameroon,26/04/2008,0,0,0,0,0,1,0,1
Cameroon,28/04/2008,1,0,0,0,0,0,0,1
Cameroon,29/04/2008,0,0,0,0,0,0,0,0
Cameroon,30/04/2008,0,0,0,0,0,0,0,0
China,01/04/2008,64,2,-1,0,50,18,0,133
China,02/04/2008,11,0,0,0,4,0,0,15
China,03/04/2008,8,0,0,0,3,6,0,17
China,04/04/2008,12,0,0,0,9,3,0,24
China,05/04/2008,56,0,1,0,47,19,0,123
China,06/04/2008,2,0,0,0,11,4,0,17
China,07/04/2008,62,8,-4,0,36,9,0,111
China,08/04/2008,114,2,-2,0,36,22,0,172
China,09/04/2008,150,0,2,0,23,10,0,185
China,10/04/2008,75,0,-2,0,12,18,0,103
China,11/04/2008,81,2,1,0,58,20,0,162
China,12/04/2008,48,0,0,0,14,9,0,71
China,13/04/2008,34,0,0,0,28,5,0,67
China,14/04/2008,53,0,1,0,19,18,0,91
China,15/04/2008,127,6,1,0,70,30,0,234
China,16/04/2008,87,0,-2,0,45,35,0,165
China,17/04/2008,98,2,4,0,45,25,0,174
China,18/04/2008,83,0,2,0,17,14,0,116
China,19/04/2008,43,4,0,0,32,10,0,89
China,20/04/2008,42,0,3,0,0,10,0,55
China,21/04/2008,56,0,2,0,58,22,0,138
China,22/04/2008,106,0,4,0,72,33,0,215
China,23/04/2008,64,0,2,0,36,4,0,106
China,24/04/2008,42,0,0,0,28,12,0,82
China,25/04/2008,103,0,-2,0,82,27,0,210
China,26/04/2008,102,0,-2,0,6,6,0,112
China,27/04/2008,38,2,0,0,12,11,0,63
China,28/04/2008,70,4,-2,0,58,7,0,137
China,29/04/2008,36,0,2,0,28,0,0,66
China,30/04/2008,42,0,0,0,19,2,0,63
Egypt,01/04/2008,55,0,1,0,16,2,0,74
Egypt,02/04/2008,-1,0,0,0,9,0,0,8
Egypt,03/04/2008,9,0,0,0,0,1,0,10
Egypt,04/04/2008,7,0,0,0,15,1,0,23
Egypt,05/04/2008,8,0,0,0,9,2,0,19
Egypt,06/04/2008,12,0,0,0,1,0,0,13
Egypt,07/04/2008,44,0,1,0,24,3,0,72
Egypt,08/04/2008,99,0,13,0,13,15,0,140
Egypt,09/04/2008,73,0,13,0,10,4,0,100
Egypt,10/04/2008,50,0,9,0,4,6,0,69
Egypt,11/04/2008,28,0,-1,0,18,4,0,49
Egypt,12/04/2008,11,0,2,0,1,1,0,15
Egypt,13/04/2008,32,0,0,0,7,0,0,39
Egypt,14/04/2008,42,0,-2,0,24,3,0,67
Egypt,15/04/2008,42,0,1,0,39,7,0,89
Egypt,16/04/2008,61,4,0,0,40,15,0,120
Egypt,17/04/2008,80,4,0,0,49,3,0,136
Egypt,18/04/2008,53,0,0,0,15,5,0,73
Egypt,19/04/2008,38,0,1,0,4,4,0,47
Egypt,20/04/2008,50,4,3,0,3,8,0,68
Egypt,21/04/2008,79,0,0,0,11,13,0,103
Egypt,22/04/2008,122,4,0,0,7,3,0,136
Egypt,23/04/2008,132,0,3,0,10,3,0,148
Egypt,24/04/2008,62,0,0,0,3,1,0,66
Egypt,25/04/2008,43,0,1,0,3,5,0,52
Egypt,26/04/2008,19,0,0,0,5,1,0,25
Egypt,27/04/2008,30,0,0,0,4,0,0,34
Egypt,28/04/2008,69,0,0,0,12,8,0,89
Egypt,29/04/2008,7,0,0,0,12,0,0,19
Egypt,30/04/2008,13,0,0,0,0,2,0,15
Eritrea,04/04/2008,0,0,0,0,0,0,0,0
Eritrea,05/04/2008,0,0,0,0,2,0,0,2
Eritrea,07/04/2008,1,0,0,0,6,0,0,7
Eritrea,08/04/2008,-1,0,0,0,0,0,0,-1
Eritrea,09/04/2008,9,0,0,0,3,2,0,14
Eritrea,10/04/2008,-12,0,0,0,3,2,0,-7
Eritrea,11/04/2008,0,0,1,0,6,0,0,7
Eritrea,14/04/2008,19,0,0,0,0,0,0,19
Eritrea,15/04/2008,26,0,0,0,0,0,0,26
Eritrea,16/04/2008,0,0,0,0,15,0,0,15
Eritrea,17/04/2008,0,0,0,0,0,0,0,0
Eritrea,18/04/2008,0,0,1,0,0,0,0,1
Eritrea,19/04/2008,4,0,0,0,0,0,0,4
Eritrea,20/04/2008,6,0,0,0,0,0,0,6
Eritrea,21/04/2008,3,0,0,0,0,0,0,3
Eritrea,22/04/2008,20,0,0,0,27,0,0,47
Eritrea,23/04/2008,7,0,0,0,15,0,0,22
Eritrea,24/04/2008,16,0,0,0,0,0,0,16
Eritrea,25/04/2008,0,0,0,0,-6,0,0,-6
Eritrea,26/04/2008,0,0,0,0,0,0,0,0
Eritrea,27/04/2008,0,0,0,0,0,0,0,0
Eritrea,28/04/2008,0,0,0,0,0,0,0,0
Eritrea,30/04/2008,12,0,0,0,3,0,0,15
Georgia,01/04/2008,0,0,0,0,7,1,0,8
Georgia,02/04/2008,7,0,1,0,0,0,0,8
Georgia,03/04/2008,2,0,0,0,3,0,0,5
Georgia,04/04/2008,-1,0,0,0,0,0,0,-1
Georgia,05/04/2008,24,0,0,0,1,2,0,27
Georgia,06/04/2008,0,0,0,0,0,0,0,0
Georgia,07/04/2008,0,0,0,0,-2,0,0,-2
Georgia,08/04/2008,3,0,0,0,-4,2,0,1
Georgia,09/04/2008,14,0,0,0,0,1,0,15
Georgia,10/04/2008,4,0,0,0,3,1,0,8
Georgia,11/04/2008,12,0,0,0,9,2,0,23
Georgia,12/04/2008,6,0,1,0,6,0,0,13
Georgia,13/04/2008,0,0,0,0,9,2,0,11
Georgia,14/04/2008,9,0,0,0,-4,0,0,5
Georgia,15/04/2008,9,0,0,0,0,3,0,12
Georgia,16/04/2008,5,0,0,0,3,0,0,8
Georgia,17/04/2008,15,0,0,0,0,0,0,15
Georgia,18/04/2008,1,0,-2,0,3,1,0,3
Georgia,19/04/2008,2,0,0,0,3,2,0,7
Georgia,20/04/2008,6,0,0,0,0,0,0,6
Georgia,21/04/2008,9,0,0,0,14,1,0,24
Georgia,22/04/2008,15,2,0,0,3,0,0,20
Georgia,23/04/2008,17,0,0,0,7,3,0,27
Georgia,24/04/2008,24,0,0,0,-2,0,0,22
Georgia,25/04/2008,6,0,0,0,1,0,0,7
Georgia,26/04/2008,4,0,0,0,0,0,0,4
Georgia,27/04/2008,4,0,0,0,0,0,0,4
Georgia,28/04/2008,6,0,0,0,0,0,0,6
Georgia,29/04/2008,6,0,0,0,0,0,0,6
Georgia,30/04/2008,13,0,0,0,-7,3,0,9
India,01/04/2008,10,2,1,0,27,5,0,45
India,02/04/2008,0,0,0,0,0,0,0,0
India,03/04/2008,5,0,0,0,12,0,0,17
India,04/04/2008,10,0,0,0,3,0,0,13
India,05/04/2008,36,0,-2,0,15,5,0,54
India,06/04/2008,3,0,0,0,0,0,0,3
India,07/04/2008,20,4,0,0,4,4,0,32
India,08/04/2008,57,0,-2,0,11,5,0,71
India,09/04/2008,19,0,-2,0,14,9,0,40
India,10/04/2008,56,0,-1,0,21,19,0,95
India,11/04/2008,43,0,2,0,26,10,0,81
India,12/04/2008,27,0,0,0,14,9,0,50
India,13/04/2008,5,0,-1,0,0,2,0,6
India,14/04/2008,33,2,-4,0,6,5,0,42
India,15/04/2008,23,0,-1,0,8,4,0,34
India,16/04/2008,42,0,0,0,23,9,0,74
India,17/04/2008,42,0,0,0,14,14,0,70
India,18/04/2008,65,0,0,0,37,7,0,109
India,19/04/2008,52,2,-1,0,12,5,0,70
India,20/04/2008,24,0,-4,0,19,3,0,42
India,21/04/2008,14,0,-4,0,15,6,0,31
India,22/04/2008,29,0,0,0,14,5,0,48
India,23/04/2008,41,0,0,0,2,4,0,47
India,24/04/2008,14,0,0,0,22,1,0,37
India,25/04/2008,33,0,1,0,22,7,0,63
India,26/04/2008,24,0,0,0,0,0,0,24
India,27/04/2008,7,0,0,0,1,1,0,9
India,28/04/2008,45,0,-4,0,21,5,0,67
India,29/04/2008,12,0,0,0,10,0,0,22
India,30/04/2008,48,0,-2,0,16,2,0,64
Iran,01/04/2008,29,0,3,0,6,2,0,40
Iran,02/04/2008,8,0,0,0,0,2,0,10
Iran,03/04/2008,11,0,-1,0,8,0,0,18
Iran,04/04/2008,5,0,0,0,0,1,0,6
Iran,05/04/2008,74,0,-3,0,21,10,0,102
Iran,06/04/2008,35,0,0,0,0,1,0,36
Iran,07/04/2008,80,0,-2,0,23,5,0,106
Iran,08/04/2008,119,0,0,0,49,-3,0,165
Iran,09/04/2008,98,0,-4,0,28,1,0,123
Iran,10/04/2008,118,0,3,0,20,4,0,145
Iran,11/04/2008,93,0,-2,0,21,5,0,117
Iran,12/04/2008,85,0,0,0,12,9,0,106
Iran,13/04/2008,40,0,0,0,17,19,0,76
Iran,14/04/2008,90,0,0,0,15,22,0,127
Iran,15/04/2008,70,0,2,0,24,6,0,102
Iran,16/04/2008,29,0,1,0,9,4,0,43
Iran,17/04/2008,96,0,3,0,9,22,0,130
Iran,18/04/2008,46,0,0,0,8,4,0,58
Iran,19/04/2008,74,4,0,0,7,1,0,86
Iran,20/04/2008,165,0,0,0,7,0,0,172
Iran,21/04/2008,71,0,6,0,9,5,0,91
Iran,22/04/2008,114,0,-4,0,11,10,0,131
Iran,23/04/2008,70,0,-5,0,19,13,0,97
Iran,24/04/2008,63,0,1,0,12,4,0,80
Iran,25/04/2008,124,2,-1,0,22,6,0,153
Iran,26/04/2008,58,0,0,0,11,2,0,71
Iran,27/04/2008,92,0,4,0,0,0,0,96
Iran,28/04/2008,78,2,-2,0,17,2,0,97
Iran,29/04/2008,14,0,-1,0,6,0,0,19
Iran,30/04/2008,57,4,-1,0,28,0,0,88
Iraq,01/04/2008,68,0,0,0,12,0,0,80
Iraq,02/04/2008,46,0,0,0,12,3,0,61
Iraq,03/04/2008,30,0,1,0,24,5,0,60
Iraq,04/04/2008,78,2,0,0,10,10,0,100
Iraq,05/04/2008,118,0,3,0,15,18,0,154
Iraq,06/04/2008,28,0,0,0,11,4,0,43
Iraq,07/04/2008,119,2,3,0,42,18,0,184
Iraq,08/04/2008,147,4,1,0,23,26,0,201
Iraq,09/04/2008,106,2,0,0,14,39,0,161
Iraq,10/04/2008,142,0,1,0,58,28,0,229
Iraq,11/04/2008,187,0,-2,0,72,14,0,271
Iraq,12/04/2008,79,18,0,0,12,12,0,121
Iraq,13/04/2008,88,8,1,0,37,10,0,144
Iraq,14/04/2008,152,6,-2,0,-14,18,0,160
Iraq,15/04/2008,125,4,2,0,32,19,0,182
Iraq,16/04/2008,186,6,0,0,7,11,0,210
Iraq,17/04/2008,166,0,5,0,36,31,0,238
Iraq,18/04/2008,93,4,5,0,60,9,0,171
Iraq,19/04/2008,127,8,1,0,42,9,0,187
Iraq,20/04/2008,118,8,1,0,9,10,0,146
Iraq,21/04/2008,112,6,1,0,31,9,0,159
Iraq,22/04/2008,113,8,1,0,16,17,0,155
Iraq,23/04/2008,136,2,-8,0,73,13,0,216
Iraq,24/04/2008,92,0,1,0,29,20,0,142
Iraq,25/04/2008,139,2,0,0,31,1,0,173
Iraq,26/04/2008,129,0,0,0,20,33,0,182
Iraq,27/04/2008,51,0,0,0,-13,13,0,51
Iraq,28/04/2008,162,0,0,0,39,21,0,222
Iraq,29/04/2008,51,4,0,0,5,5,0,65
Iraq,30/04/2008,211,4,0,0,20,14,0,249
Morocco,01/04/2008,0,0,0,0,0,0,0,0
Morocco,03/04/2008,6,0,0,0,9,6,0,21
Morocco,05/04/2008,0,0,0,0,3,2,0,5
Morocco,06/04/2008,0,0,0,0,0,3,0,3
Morocco,07/04/2008,0,0,0,0,0,1,0,1
Morocco,08/04/2008,6,0,1,0,0,0,0,7
Morocco,09/04/2008,21,0,0,0,0,10,0,31
Morocco,10/04/2008,0,0,0,0,0,2,0,2
Morocco,11/04/2008,0,0,0,0,0,0,0,0
Morocco,12/04/2008,0,0,0,0,6,0,0,6
Morocco,13/04/2008,0,0,0,0,0,0,0,0
Morocco,14/04/2008,0,0,0,0,0,0,0,0
Morocco,15/04/2008,4,0,0,0,0,0,0,4
Morocco,16/04/2008,-2,0,0,0,0,0,0,-2
Morocco,17/04/2008,3,0,0,0,0,0,0,3
Morocco,18/04/2008,0,0,0,0,0,0,0,0
Morocco,19/04/2008,5,0,0,0,9,0,0,14
Morocco,20/04/2008,1,0,0,0,3,0,0,4
Morocco,21/04/2008,0,0,0,0,0,0,0,0
Morocco,22/04/2008,7,0,0,0,0,1,0,8
Morocco,23/04/2008,1,0,0,0,0,0,0,1
Morocco,24/04/2008,2,0,0,0,0,0,0,2
Morocco,25/04/2008,26,0,0,0,0,0,0,26
Morocco,26/04/2008,2,0,0,0,0,0,0,2
Morocco,27/04/2008,6,0,0,0,0,0,0,6
Morocco,28/04/2008,0,0,0,0,3,0,0,3
Morocco,29/04/2008,3,0,1,0,0,2,0,6
Morocco,30/04/2008,0,0,0,0,0,0,0,0
Nigeria,01/04/2008,-1,0,0,0,6,0,0,5
Nigeria,02/04/2008,0,0,0,0,0,0,0,0
Nigeria,03/04/2008,6,0,0,0,3,0,0,9
Nigeria,04/04/2008,3,0,0,0,0,0,0,3
Nigeria,05/04/2008,2,0,0,0,3,4,0,9
Nigeria,06/04/2008,0,0,0,0,0,2,0,2
Nigeria,07/04/2008,15,0,0,0,33,0,0,48
Nigeria,08/04/2008,19,0,-1,0,9,0,0,27
Nigeria,09/04/2008,5,0,0,0,-1,0,0,4
Nigeria,10/04/2008,10,0,0,0,6,1,0,17
Nigeria,11/04/2008,2,0,0,0,3,0,0,5
Nigeria,12/04/2008,11,0,0,0,3,0,0,14
Nigeria,13/04/2008,17,0,0,0,33,2,0,52
Nigeria,14/04/2008,21,0,2,0,9,1,0,33
Nigeria,15/04/2008,9,2,-2,0,15,1,0,25
Nigeria,16/04/2008,-1,0,-2,0,0,0,0,-3
Nigeria,17/04/2008,1,0,0,0,0,7,0,8
Nigeria,18/04/2008,5,0,0,0,6,2,0,13
Nigeria,19/04/2008,4,0,0,0,0,0,0,4
Nigeria,20/04/2008,7,0,0,0,-12,0,0,-5
Nigeria,21/04/2008,34,0,0,0,10,2,0,46
Nigeria,22/04/2008,45,2,1,0,9,2,0,59
Nigeria,23/04/2008,38,0,1,0,6,2,0,47
Nigeria,24/04/2008,4,0,0,0,24,2,0,30
Nigeria,25/04/2008,5,0,-12,0,0,0,0,-7
Nigeria,26/04/2008,6,0,-12,0,0,2,0,-4
Nigeria,27/04/2008,15,0,0,0,3,2,0,20
Nigeria,28/04/2008,6,0,0,0,3,0,0,9
Nigeria,29/04/2008,9,0,0,0,0,0,0,9
Nigeria,30/04/2008,0,0,0,0,0,1,0,1
Pakistan,01/04/2008,31,0,0,0,12,4,0,47
Pakistan,02/04/2008,17,0,0,0,9,2,0,28
Pakistan,03/04/2008,14,0,0,0,16,0,0,30
Pakistan,04/04/2008,0,0,0,0,6,4,0,10
Pakistan,05/04/2008,41,0,2,0,22,8,0,73
Pakistan,06/04/2008,32,0,0,0,36,2,0,70
Pakistan,07/04/2008,31,0,0,0,39,11,0,81
Pakistan,08/04/2008,44,0,-4,0,35,6,0,81
Pakistan,09/04/2008,69,0,-2,0,31,17,0,115
Pakistan,10/04/2008,65,2,0,0,25,6,0,98
Pakistan,11/04/2008,-1,0,0,0,43,6,0,48
Pakistan,12/04/2008,18,0,0,0,0,15,0,33
Pakistan,13/04/2008,26,0,0,0,0,3,0,29
Pakistan,14/04/2008,45,2,0,0,11,6,0,64
Pakistan,15/04/2008,39,0,0,0,11,10,0,60
Pakistan,16/04/2008,28,2,1,0,13,7,0,51
Pakistan,17/04/2008,51,0,2,0,23,5,0,81
Pakistan,18/04/2008,35,0,0,0,-10,5,0,30
Pakistan,19/04/2008,73,0,0,0,69,3,0,145
Pakistan,20/04/2008,24,0,0,0,15,1,0,40
Pakistan,21/04/2008,52,0,0,0,66,4,0,122
Pakistan,22/04/2008,46,2,0,0,13,9,0,70
Pakistan,23/04/2008,96,0,0,0,16,12,0,124
Pakistan,24/04/2008,26,0,0,0,9,0,0,35
Pakistan,25/04/2008,51,0,1,0,20,22,0,94
Pakistan,26/04/2008,27,0,0,0,19,5,0,51
Pakistan,27/04/2008,42,0,-4,0,8,5,0,51
Pakistan,28/04/2008,64,0,-1,0,24,9,0,96
Pakistan,29/04/2008,38,0,0,0,9,4,0,51
Pakistan,30/04/2008,100,0,0,0,15,11,0,126
Sierra Leone,01/04/2008,4,0,0,0,0,0,0,4
Sierra Leone,02/04/2008,0,0,0,0,0,0,0,0
Sierra Leone,03/04/2008,0,0,0,0,0,0,0,0
Sierra Leone,04/04/2008,0,0,0,0,0,0,0,0
Sierra Leone,05/04/2008,2,0,0,0,0,0,0,2
Sierra Leone,07/04/2008,8,0,0,0,0,0,0,8
Sierra Leone,08/04/2008,0,0,0,0,0,0,0,0
Sierra Leone,09/04/2008,0,0,0,0,0,0,0,0
Sierra Leone,10/04/2008,1,0,0,0,0,0,0,1
Sierra Leone,11/04/2008,0,0,0,0,0,0,0,0
Sierra Leone,12/04/2008,0,0,0,0,0,0,0,0
Sierra Leone,14/04/2008,0,0,0,0,0,0,0,0
Sierra Leone,15/04/2008,0,0,0,0,0,0,0,0
Sierra Leone,16/04/2008,0,0,0,0,0,0,0,0
Sierra Leone,17/04/2008,-1,0,-2,0,0,2,0,-1
Sierra Leone,18/04/2008,0,0,0,0,0,0,0,0
Sierra Leone,19/04/2008,0,0,0,0,0,0,0,0
Sierra Leone,20/04/2008,0,0,0,0,0,0,0,0
Sierra Leone,21/04/2008,0,0,0,0,0,0,0,0
Sierra Leone,22/04/2008,-3,0,0,0,0,0,0,-3
Sierra Leone,23/04/2008,6,0,0,0,0,0,0,6
Sierra Leone,24/04/2008,0,0,0,0,6,0,0,6
Sierra Leone,25/04/2008,-1,0,-2,0,0,0,0,-3
Sierra Leone,27/04/2008,0,0,0,0,0,0,0,0
Sierra Leone,28/04/2008,1,0,0,0,0,0,0,1
Sierra Leone,29/04/2008,1,0,0,0,0,0,0,1
Sierra Leone,30/04/2008,12,0,0,0,0,0,0,12
Somalia,01/04/2008,9,0,0,0,5,0,0,14
Somalia,02/04/2008,0,0,0,0,0,0,0,0
Somalia,03/04/2008,3,0,0,0,21,0,0,24
Somalia,04/04/2008,13,0,0,0,12,0,0,25
Somalia,05/04/2008,54,0,-1,0,45,1,0,99
Somalia,06/04/2008,3,0,0,0,0,0,0,3
Somalia,07/04/2008,14,2,0,0,12,2,0,30
Somalia,08/04/2008,16,2,0,0,7,0,0,25
Somalia,09/04/2008,9,0,0,0,3,4,0,16
Somalia,10/04/2008,3,0,0,0,2,0,0,5
Somalia,11/04/2008,24,0,0,0,4,0,0,28
Somalia,12/04/2008,45,6,0,0,5,1,0,57
Somalia,13/04/2008,25,0,0,0,9,4,0,38
Somalia,14/04/2008,19,0,0,0,16,0,0,35
Somalia,15/04/2008,11,0,1,0,9,1,0,22
Somalia,16/04/2008,38,0,1,0,21,0,0,60
Somalia,17/04/2008,33,0,1,0,7,0,0,41
Somalia,18/04/2008,5,0,1,0,-1,4,0,9
Somalia,19/04/2008,9,0,0,0,1,0,0,10
Somalia,20/04/2008,28,0,0,0,26,0,0,54
Somalia,21/04/2008,81,0,0,0,18,0,0,99
Somalia,22/04/2008,56,0,0,0,14,4,0,74
Somalia,23/04/2008,37,0,0,0,25,0,0,62
Somalia,24/04/2008,2,0,-6,0,6,0,0,2
Somalia,25/04/2008,10,0,0,0,18,0,0,28
Somalia,26/04/2008,25,0,0,0,-15,0,0,10
Somalia,27/04/2008,16,0,1,0,2,0,0,19
Somalia,28/04/2008,42,4,1,0,-6,0,0,41
Somalia,29/04/2008,9,0,1,0,5,1,0,16
Somalia,30/04/2008,20,0,0,0,0,2,0,22
Syria,01/04/2008,14,0,0,0,1,3,0,18
Syria,02/04/2008,3,0,0,0,0,1,0,4
Syria,03/04/2008,0,0,0,0,0,0,0,0
Syria,04/04/2008,2,0,0,0,0,0,0,2
Syria,05/04/2008,23,0,0,0,42,3,0,68
Syria,06/04/2008,5,0,0,0,0,0,0,5
Syria,07/04/2008,14,8,0,0,18,0,0,40
Syria,08/04/2008,40,0,0,0,14,0,0,54
Syria,09/04/2008,2,0,0,0,-1,2,0,3
Syria,10/04/2008,28,0,0,0,21,0,0,49
Syria,11/04/2008,9,2,0,0,0,0,0,11
Syria,12/04/2008,6,0,0,0,3,0,0,9
Syria,13/04/2008,17,0,0,0,3,5,0,25
Syria,14/04/2008,7,0,1,0,3,7,0,18
Syria,15/04/2008,42,0,0,0,6,0,0,48
Syria,16/04/2008,31,4,0,0,0,0,0,35
Syria,17/04/2008,2,0,0,0,6,12,0,20
Syria,18/04/2008,14,0,0,0,5,4,0,23
Syria,19/04/2008,-3,0,0,0,15,0,0,12
Syria,20/04/2008,30,0,0,0,9,0,0,39
Syria,21/04/2008,46,0,0,0,21,1,0,68
Syria,22/04/2008,43,0,-2,0,0,2,0,43
Syria,23/04/2008,37,0,0,0,2,2,0,41
Syria,24/04/2008,59,0,1,0,-1,2,0,61
Syria,25/04/2008,137,0,3,0,24,28,0,192
Syria,26/04/2008,42,0,2,0,15,3,0,62
Syria,27/04/2008,15,0,-1,0,-4,0,0,10
Syria,28/04/2008,27,0,2,0,41,1,0,71
Syria,29/04/2008,4,0,0,0,3,0,0,7
Syria,30/04/2008,24,0,0,0,3,2,0,29
Yemen,01/04/2008,9,0,0,0,0,4,0,13
Yemen,02/04/2008,0,0,0,0,0,0,0,0
Yemen,04/04/2008,0,0,0,0,6,0,0,6
Yemen,05/04/2008,3,0,0,0,-1,0,0,2
Yemen,06/04/2008,14,0,0,0,0,0,0,14
Yemen,07/04/2008,6,0,0,0,3,0,0,9
Yemen,08/04/2008,3,0,0,0,0,13,0,16
Yemen,09/04/2008,10,0,3,0,3,0,0,16
Yemen,10/04/2008,6,0,1,0,0,1,0,8
Yemen,11/04/2008,0,0,0,0,-2,0,0,-2
Yemen,12/04/2008,12,0,0,0,3,1,0,16
Yemen,13/04/2008,5,0,0,0,0,3,0,8
Yemen,14/04/2008,2,0,0,0,0,0,0,2
Yemen,15/04/2008,1,0,0,0,3,0,0,4
Yemen,16/04/2008,7,0,0,0,0,3,0,10
Yemen,17/04/2008,14,0,0,0,6,2,0,22
Yemen,18/04/2008,31,0,0,0,3,2,0,36
Yemen,19/04/2008,0,0,0,0,0,0,0,0
Yemen,20/04/2008,8,0,0,0,0,0,0,8
Yemen,21/04/2008,25,4,0,0,8,0,0,37
Yemen,22/04/2008,27,0,0,0,3,0,0,30
Yemen,23/04/2008,13,0,0,0,0,0,0,13
Yemen,25/04/2008,13,0,0,0,3,0,0,16
Yemen,26/04/2008,0,0,0,0,9,0,0,9
Yemen,27/04/2008,6,0,0,0,0,0,0,6
Yemen,28/04/2008,17,0,0,0,24,0,0,41
Yemen,29/04/2008,9,0,0,0,12,0,0,21
Yemen,30/04/2008,22,2,0,0,12,7,0,43
Afghanistan,01/05/2011,195,2,-1,0,40,26,0,262
Afghanistan,02/05/2011,1051,6,-4,0,181,84,0,1318
Afghanistan,03/05/2011,989,2,0,0,124,31,0,1146
Afghanistan,04/05/2011,572,8,4,0,29,37,0,650
Afghanistan,05/05/2011,626,4,1,0,41,40,0,712
Afghanistan,06/05/2011,607,2,-5,0,53,49,0,706
Afghanistan,07/05/2011,704,2,5,0,29,95,0,835
Afghanistan,08/05/2011,530,0,2,0,79,93,0,704
Afghanistan,09/05/2011,329,0,1,0,46,57,0,433
Afghanistan,10/05/2011,141,10,-3,0,33,22,0,203
Afghanistan,11/05/2011,234,6,-1,0,11,17,0,267
Afghanistan,12/05/2011,177,2,9,0,-2,7,0,193
Afghanistan,13/05/2011,115,0,-2,0,11,0,0,124
Afghanistan,14/05/2011,149,4,0,0,18,5,0,176
Afghanistan,15/05/2011,115,0,0,0,15,0,0,130
Afghanistan,16/05/2011,54,0,1,0,18,4,0,77
Afghanistan,17/05/2011,245,0,-10,0,78,16,0,329
Afghanistan,18/05/2011,374,2,-6,0,46,31,0,447
Afghanistan,19/05/2011,408,8,1,0,63,29,0,509
Afghanistan,20/05/2011,296,6,1,0,20,18,0,341
Afghanistan,21/05/2011,152,2,-2,0,2,10,0,164
Afghanistan,22/05/2011,93,6,1,0,13,18,0,131
Afghanistan,23/05/2011,349,0,2,0,43,24,0,418
Afghanistan,24/05/2011,353,0,-1,0,7,8,0,367
Afghanistan,25/05/2011,122,0,-3,0,23,9,0,151
Afghanistan,26/05/2011,270,6,-8,0,70,25,0,363
Afghanistan,27/05/2011,310,0,2,0,35,36,0,383
Afghanistan,28/05/2011,520,0,3,0,23,108,0,654
Afghanistan,29/05/2011,447,0,2,0,21,47,0,517
Afghanistan,30/05/2011,636,4,-15,0,43,74,0,742
Afghanistan,31/05/2011,286,0,1,0,36,15,0,338
Albania,01/05/2011,-1,0,0,0,0,0,0,-1
Albania,02/05/2011,-1,0,0,0,1,1,0,1
Albania,03/05/2011,6,0,0,0,3,0,0,9
Albania,04/05/2011,4,0,0,0,0,0,0,4
Albania,05/05/2011,6,0,0,0,-4,2,0,4
Albania,06/05/2011,4,0,0,0,3,1,0,8
Albania,07/05/2011,0,0,0,0,0,0,0,0
Albania,08/05/2011,4,0,0,0,0,1,0,5
Albania,09/05/2011,11,0,0,0,0,0,0,11
Albania,10/05/2011,-2,0,0,0,4,0,0,2
Albania,11/05/2011,7,0,0,0,0,0,0,7
Albania,12/05/2011,21,0,-1,0,15,3,0,38
Albania,13/05/2011,11,0,0,0,2,0,0,13
Albania,14/05/2011,8,0,0,0,0,0,0,8
Albania,15/05/2011,0,0,-4,0,0,0,0,-4
Albania,16/05/2011,2,0,0,0,0,0,0,2
Albania,17/05/2011,1,0,0,0,0,0,0,1
Albania,18/05/2011,2,0,-1,0,0,0,0,1
Albania,19/05/2011,2,0,0,0,3,3,0,8
Albania,20/05/2011,-4,0,0,0,-4,0,0,-8
Albania,21/05/2011,4,0,0,0,3,0,0,7
Albania,22/05/2011,0,0,0,0,0,0,0,0
Albania,23/05/2011,11,0,0,0,3,1,0,15
Albania,24/05/2011,4,0,-1,0,4,2,0,9
Albania,25/05/2011,4,0,-1,0,3,3,0,9
Albania,26/05/2011,10,0,0,0,-2,0,0,8
Albania,27/05/2011,2,0,-1,0,4,0,0,5
Albania,28/05/2011,0,0,0,0,0,0,0,0
Albania,29/05/2011,1,0,0,0,0,0,0,1
Albania,30/05/2011,0,0,0,0,6,0,0,6
Albania,31/05/2011,3,0,-1,0,0,0,0,2
Algeria,01/05/2011,8,0,0,0,0,0,0,8
Algeria,02/05/2011,15,0,0,0,18,2,0,35
Algeria,03/05/2011,8,0,0,0,-2,2,0,8
Algeria,04/05/2011,-3,0,0,0,21,0,0,18
Algeria,05/05/2011,10,0,0,0,12,0,0,22
Algeria,06/05/2011,8,0,0,0,12,0,0,20
Algeria,07/05/2011,6,0,0,0,-4,0,0,2
Algeria,08/05/2011,0,0,1,0,6,0,0,7
Algeria,09/05/2011,6,0,0,0,9,0,0,15
Algeria,10/05/2011,11,0,0,0,10,0,0,21
Algeria,11/05/2011,9,0,0,0,8,4,0,21
Algeria,12/05/2011,7,0,-2,0,-2,1,0,4
Algeria,13/05/2011,5,0,0,0,18,0,0,23
Algeria,14/05/2011,1,0,0,0,9,2,0,12
Algeria,15/05/2011,0,0,0,0,-5,0,0,-5
Algeria,16/05/2011,0,0,0,0,3,0,0,3
Algeria,17/05/2011,0,0,0,0,-1,0,0,-1
Algeria,18/05/2011,70,0,0,0,12,0,0,82
Algeria,19/05/2011,38,0,0,0,19,1,0,58
Algeria,20/05/2011,7,0,0,0,3,4,0,14
Algeria,21/05/2011,22,0,0,0,0,0,0,22
Algeria,22/05/2011,10,0,0,0,3,-1,0,12
Algeria,23/05/2011,0,0,1,0,-2,1,0,0
Algeria,24/05/2011,4,0,0,0,9,2,0,15
Algeria,25/05/2011,4,0,1,0,-7,0,0,-2
Algeria,26/05/2011,63,0,1,0,25,0,0,89
Algeria,27/05/2011,8,0,0,0,4,0,0,12
Algeria,28/05/2011,4,0,0,0,0,0,0,4
Algeria,29/05/2011,11,0,0,0,-8,2,0,5
Algeria,30/05/2011,13,0,0,0,-1,2,0,14
Algeria,31/05/2011,0,0,0,0,1,0,0,1
Bangladesh,01/05/2011,8,4,0,0,4,0,0,16
Bangladesh,02/05/2011,5,0,0,0,0,0,0,5
Bangladesh,03/05/2011,16,0,-3,0,15,4,0,32
Bangladesh,04/05/2011,7,0,-6,0,15,1,0,17
Bangladesh,05/05/2011,54,0,1,0,8,3,0,66
Bangladesh,06/05/2011,7,0,0,0,27,6,0,40
Bangladesh,07/05/2011,14,0,-7,0,4,0,0,11
Bangladesh,08/05/2011,1,0,-2,0,5,1,0,5
Bangladesh,09/05/2011,9,0,0,0,0,3,0,12
Bangladesh,10/05/2011,27,0,0,0,28,3,0,58
Bangladesh,11/05/2011,24,0,2,0,30,1,0,57
Bangladesh,12/05/2011,27,0,-2,0,15,1,0,41
Bangladesh,13/05/2011,26,0,-10,0,3,0,0,19
Bangladesh,14/05/2011,5,0,-2,0,0,0,0,3
Bangladesh,15/05/2011,3,0,0,0,3,0,0,6
Bangladesh,16/05/2011,-3,0,2,0,1,2,0,2
Bangladesh,17/05/2011,16,0,0,0,27,3,0,46
Bangladesh,18/05/2011,56,0,-12,0,15,14,0,73
Bangladesh,19/05/2011,17,0,-4,0,6,2,0,21
Bangladesh,20/05/2011,22,2,0,0,0,2,0,26
Bangladesh,21/05/2011,12,0,1,0,0,0,0,13
Bangladesh,22/05/2011,16,0,0,0,28,0,0,44
Bangladesh,23/05/2011,22,0,0,0,7,0,0,29
Bangladesh,24/05/2011,6,0,0,0,-4,0,0,2
Bangladesh,25/05/2011,6,0,0,0,-2,4,0,8
Bangladesh,26/05/2011,13,0,0,0,1,1,0,15
Bangladesh,27/05/2011,10,0,0,0,11,1,0,22
Bangladesh,28/05/2011,23,0,0,0,14,2,0,39
Bangladesh,29/05/2011,2,0,0,0,3,0,0,5
Bangladesh,30/05/2011,4,0,0,0,15,2,0,21
Bangladesh,31/05/2011,2,2,0,0,9,6,0,19
Cameroon,01/05/2011,0,0,0,0,0,0,0,0
Cameroon,02/05/2011,0,0,-2,0,0,0,0,-2
Cameroon,03/05/2011,0,0,0,0,0,0,0,0
Cameroon,04/05/2011,4,0,0,0,0,0,0,4
Cameroon,05/05/2011,3,0,0,0,0,0,0,3
Cameroon,06/05/2011,0,0,0,0,0,0,0,0
Cameroon,07/05/2011,-1,0,0,0,0,0,0,-1
Cameroon,09/05/2011,-2,0,0,0,0,0,0,-2
Cameroon,10/05/2011,3,0,0,0,0,0,0,3
Cameroon,11/05/2011,0,0,0,0,0,0,0,0
Cameroon,13/05/2011,0,0,0,0,3,2,0,5
Cameroon,16/05/2011,0,0,0,0,0,0,0,0
Cameroon,17/05/2011,9,0,0,0,18,0,0,27
Cameroon,18/05/2011,0,0,0,0,0,0,0,0
Cameroon,19/05/2011,1,0,0,0,6,0,0,7
Cameroon,20/05/2011,7,0,0,0,15,0,0,22
Cameroon,21/05/2011,8,0,0,0,3,0,0,11
Cameroon,23/05/2011,0,0,-2,0,2,0,0,0
Cameroon,24/05/2011,3,0,0,0,6,0,0,9
Cameroon,25/05/2011,1,0,0,0,0,0,0,1
Cameroon,26/05/2011,0,0,0,0,0,0,0,0
Cameroon,27/05/2011,0,0,0,0,-2,0,0,-2
Cameroon,28/05/2011,0,0,0,0,0,0,0,0
Cameroon,29/05/2011,0,0,0,0,0,0,0,0
Cameroon,30/05/2011,0,0,0,0,0,0,0,0
Cameroon,31/05/2011,0,0,0,0,3,1,0,4
China,01/05/2011,106,2,2,0,21,24,0,155
China,02/05/2011,105,2,0,0,78,11,0,196
China,03/05/2011,157,2,-4,0,56,15,0,226
China,04/05/2011,174,6,0,0,45,17,0,242
China,05/05/2011,160,2,-1,0,91,12,0,264
China,06/05/2011,177,0,2,0,51,7,0,237
China,07/05/2011,105,0,-6,0,33,16,0,148
China,08/05/2011,88,8,-1,0,27,10,0,132
China,09/05/2011,147,0,0,0,66,5,0,218
China,10/05/2011,150,10,-6,0,72,8,0,234
China,11/05/2011,132,2,-1,0,62,13,0,208
China,12/05/2011,60,0,2,0,15,1,0,78
China,13/05/2011,46,0,0,0,29,12,0,87
China,14/05/2011,37,0,0,0,15,3,0,55
China,15/05/2011,15,0,-2,0,24,2,0,39
China,16/05/2011,15,0,0,0,17,5,0,37
China,17/05/2011,105,2,0,0,19,6,0,132
China,18/05/2011,142,0,-6,0,38,30,0,204
China,19/05/2011,175,0,-15,0,160,29,0,349
China,20/05/2011,106,0,-11,0,132,18,0,245
China,21/05/2011,102,4,-10,0,43,15,0,154
China,22/05/2011,65,0,0,0,34,3,0,102
China,23/05/2011,126,4,1,0,57,7,0,195
China,24/05/2011,194,2,1,0,62,21,0,280
China,25/05/2011,48,0,1,0,15,15,0,79
China,26/05/2011,96,0,-4,0,24,16,0,132
China,27/05/2011,106,0,0,0,100,14,0,220
China,28/05/2011,119,6,-2,0,33,8,0,164
China,29/05/2011,151,4,-6,0,40,6,0,195
China,30/05/2011,93,0,2,0,116,4,0,215
China,31/05/2011,100,0,0,0,53,13,0,166
Egypt,01/05/2011,185,0,-1,0,24,24,0,232
Egypt,02/05/2011,290,0,-4,0,-7,30,0,309
Egypt,03/05/2011,164,0,-1,0,48,18,0,229
Egypt,04/05/2011,86,0,0,0,75,18,0,179
Egypt,05/05/2011,465,10,-9,0,334,95,0,895
Egypt,06/05/2011,171,0,2,0,55,39,0,267
Egypt,07/05/2011,71,0,1,0,-6,14,0,80
Egypt,08/05/2011,111,0,0,0,19,23,0,153
Egypt,09/05/2011,133,6,-2,0,71,23,0,231
Egypt,10/05/2011,747,10,-13,0,384,117,0,1245
Egypt,11/05/2011,93,0,-4,0,65,16,0,170
Egypt,12/05/2011,85,0,-6,0,34,24,0,137
Egypt,13/05/2011,52,0,0,0,52,28,0,132
Egypt,14/05/2011,35,0,0,0,7,3,0,45
Egypt,15/05/2011,65,0,-4,0,29,7,0,97
Egypt,16/05/2011,38,0,-10,0,12,7,0,47
Egypt,17/05/2011,82,0,-13,0,25,6,0,100
Egypt,18/05/2011,135,0,-10,0,48,30,0,203
Egypt,19/05/2011,204,12,7,0,84,37,0,344
Egypt,20/05/2011,111,0,2,0,18,19,0,150
Egypt,21/05/2011,74,8,-11,0,35,11,0,117
Egypt,22/05/2011,36,0,-4,0,11,2,0,45
Egypt,23/05/2011,122,0,0,0,4,9,0,135
Egypt,24/05/2011,112,2,-3,0,111,5,0,227
Egypt,25/05/2011,91,2,-5,0,51,7,0,146
Egypt,26/05/2011,132,0,-3,0,132,17,0,278
Egypt,27/05/2011,111,4,-5,0,64,19,0,193
Egypt,28/05/2011,93,2,-3,0,68,19,0,179
Egypt,29/05/2011,88,0,-2,0,48,15,0,149
Egypt,30/05/2011,79,0,-4,0,42,8,0,125
Egypt,31/05/2011,63,0,-2,0,37,29,0,127
Eritrea,01/05/2011,0,0,0,0,-2,0,0,-2
Eritrea,02/05/2011,3,0,0,0,3,0,0,6
Eritrea,03/05/2011,0,0,0,0,3,0,0,3
Eritrea,04/05/2011,0,0,0,0,0,0,0,0
Eritrea,05/05/2011,1,0,0,0,0,0,0,1
Eritrea,06/05/2011,0,0,0,0,0,1,0,1
Eritrea,07/05/2011,5,0,0,0,0,0,0,5
Eritrea,08/05/2011,0,0,0,0,0,0,0,0
Eritrea,09/05/2011,2,0,0,0,-1,1,0,2
Eritrea,10/05/2011,1,0,0,0,-1,0,0,0
Eritrea,11/05/2011,24,0,0,0,3,0,0,27
Eritrea,13/05/2011,0,0,0,0,6,0,0,6
Eritrea,16/05/2011,4,0,0,0,0,0,0,4
Eritrea,17/05/2011,0,0,0,0,0,0,0,0
Eritrea,18/05/2011,0,0,0,0,0,0,0,0
Eritrea,19/05/2011,0,0,0,0,3,0,0,3
Eritrea,20/05/2011,2,0,0,0,0,0,0,2
Eritrea,21/05/2011,0,0,0,0,0,0,0,0
Eritrea,23/05/2011,0,0,0,0,0,0,0,0
Eritrea,24/05/2011,32,0,0,0,6,11,0,49
Eritrea,25/05/2011,46,0,0,0,-2,11,0,55
Eritrea,26/05/2011,0,0,0,0,6,0,0,6
Eritrea,27/05/2011,36,2,0,0,0,4,0,42
Eritrea,28/05/2011,3,0,0,0,12,0,0,15
Eritrea,30/05/2011,11,0,1,0,0,0,0,12
Eritrea,31/05/2011,0,0,0,0,0,0,0,0
Georgia,01/05/2011,9,0,2,0,6,2,0,19
Georgia,02/05/2011,26,2,1,0,18,9,0,56
Georgia,03/05/2011,48,4,2,0,23,5,0,82
Georgia,04/05/2011,12,2,1,0,33,8,0,56
Georgia,05/05/2011,54,8,0,0,19,2,0,83
Georgia,06/05/2011,21,0,-6,0,36,7,0,58
Georgia,07/05/2011,15,0,-4,0,15,0,0,26
Georgia,08/05/2011,20,0,0,0,19,1,0,40
Georgia,09/05/2011,80,2,0,0,20,6,0,108
Georgia,10/05/2011,42,0,0,0,7,6,0,55
Georgia,11/05/2011,7,0,0,0,-6,5,0,6
Georgia,12/05/2011,6,0,0,0,3,1,0,10
Georgia,13/05/2011,7,0,0,0,0,0,0,7
Georgia,14/05/2011,4,2,0,0,0,0,0,6
Georgia,15/05/2011,4,0,0,0,0,0,0,4
Georgia,16/05/2011,-1,0,0,0,0,2,0,1
Georgia,17/05/2011,8,0,0,0,6,2,0,16
Georgia,18/05/2011,54,0,-4,0,20,2,0,72
Georgia,19/05/2011,17,2,0,0,26,11,0,56
Georgia,20/05/2011,27,0,-4,0,12,9,0,44
Georgia,21/05/2011,8,2,-2,0,18,1,0,27
Georgia,22/05/2011,14,4,0,0,11,2,0,31
Georgia,23/05/2011,10,0,0,0,6,0,0,16
Georgia,24/05/2011,23,4,0,0,21,5,0,53
Georgia,25/05/2011,6,0,0,0,13,5,0,24
Georgia,26/05/2011,20,0,0,0,15,14,0,49
Georgia,27/05/2011,52,2,1,0,27,12,0,94
Georgia,28/05/2011,19,0,0,0,10,2,0,31
Georgia,29/05/2011,30,0,0,0,-11,0,0,19
Georgia,30/05/2011,23,0,0,0,7,0,0,30
Georgia,31/05/2011,50,0,-4,0,6,1,0,53
India,01/05/2011,46,2,-1,0,2,10,0,59
India,02/05/2011,122,4,-1,0,29,19,0,173
India,03/05/2011,72,0,-2,0,29,6,0,105
India,04/05/2011,84,0,-1,0,17,6,0,106
India,05/05/2011,20,0,2,0,23,6,0,51
India,06/05/2011,57,2,-1,0,20,6,0,84
India,07/05/2011,51,2,2,0,17,9,0,81
India,08/05/2011,52,0,-7,0,20,7,0,72
India,09/05/2011,42,0,-5,0,19,8,0,64
India,10/05/2011,72,0,3,0,15,7,0,97
India,11/05/2011,94,0,-1,0,32,8,0,133
India,12/05/2011,58,10,1,0,9,2,0,80
India,13/05/2011,24,0,0,0,1,3,0,28
India,14/05/2011,20,0,1,0,8,2,0,31
India,15/05/2011,19,0,0,0,9,8,0,36
India,16/05/2011,9,0,0,0,3,0,0,12
India,17/05/2011,32,0,-2,0,30,2,0,62
India,18/05/2011,63,0,-6,0,9,7,0,73
India,19/05/2011,79,0,-5,0,13,4,0,91
India,20/05/2011,49,2,-2,0,5,7,0,61
India,21/05/2011,49,2,1,0,33,9,0,94
India,22/05/2011,14,0,-1,0,3,0,0,16
India,23/05/2011,43,0,0,0,2,6,0,51
India,24/05/2011,88,2,-1,0,14,11,0,114
India,25/05/2011,48,4,0,0,17,5,0,74
India,26/05/2011,55,0,1,0,9,8,0,73
India,27/05/2011,65,2,-3,0,60,11,0,135
India,28/05/2011,92,0,0,0,16,15,0,123
India,29/05/2011,70,2,-2,0,16,9,0,95
India,30/05/2011,56,0,-6,0,-1,4,0,53
India,31/05/2011,32,0,-2,0,7,3,0,40
Iran,01/05/2011,96,0,-2,0,25,23,0,142
Iran,02/05/2011,144,0,0,0,10,8,0,162
Iran,03/05/2011,123,0,-1,0,78,5,0,205
Iran,04/05/2011,93,0,2,0,77,4,0,176
Iran,05/05/2011,112,0,0,0,51,3,0,166
Iran,06/05/2011,74,0,-4,0,30,7,0,107
Iran,07/05/2011,68,0,-3,0,34,3,0,102
Iran,08/05/2011,118,0,0,0,60,23,0,201
Iran,09/05/2011,69,0,-1,0,57,3,0,128
Iran,10/05/2011,51,0,-2,0,40,7,0,96
Iran,11/05/2011,52,0,-2,0,52,4,0,106
Iran,12/05/2011,73,0,-2,0,24,4,0,99
Iran,13/05/2011,28,0,2,0,9,4,0,43
Iran,14/05/2011,12,0,0,0,18,1,0,31
Iran,15/05/2011,25,0,2,0,22,2,0,51
Iran,16/05/2011,58,0,0,0,1,9,0,68
Iran,17/05/2011,41,0,-2,0,27,8,0,74
Iran,18/05/2011,111,0,-6,0,52,22,0,179
Iran,19/05/2011,148,0,-2,0,57,29,0,232
Iran,20/05/2011,80,0,1,0,24,6,0,111
Iran,21/05/2011,44,0,-5,0,34,7,0,80
Iran,22/05/2011,23,0,0,0,63,4,0,90
Iran,23/05/2011,35,0,0,0,32,8,0,75
Iran,24/05/2011,99,0,-7,0,95,12,0,199
Iran,25/05/2011,28,0,1,0,46,9,0,84
Iran,26/05/2011,46,0,0,0,52,10,0,108
Iran,27/05/2011,58,0,0,0,49,8,0,115
Iran,28/05/2011,20,0,1,0,31,13,0,65
Iran,29/05/2011,39,2,3,0,0,12,0,56
Iran,30/05/2011,124,2,7,0,43,6,0,182
Iran,31/05/2011,48,0,-2,0,52,9,0,107
Iraq,01/05/2011,165,4,-6,0,1,10,0,174
Iraq,02/05/2011,617,4,-1,0,40,49,0,709
Iraq,03/05/2011,457,0,-1,0,24,22,0,502
Iraq,04/05/2011,243,2,0,0,45,17,0,307
Iraq,05/05/2011,245,2,-3,0,69,22,0,335
Iraq,06/05/2011,98,0,1,0,66,20,0,185
Iraq,07/05/2011,104,0,0,0,22,10,0,136
Iraq,08/05/2011,166,4,1,0,14,13,0,198
Iraq,09/05/2011,122,2,-1,0,63,12,0,198
Iraq,10/05/2011,125,4,0,0,21,16,0,166
Iraq,11/05/2011,133,0,-1,0,57,4,0,193
Iraq,12/05/2011,61,0,2,0,23,5,0,91
Iraq,13/05/2011,58,0,2,0,32,9,0,101
Iraq,14/05/2011,196,0,-5,0,96,32,0,319
Iraq,15/05/2011,75,2,0,0,28,13,0,118
Iraq,16/05/2011,36,0,0,0,1,1,0,38
Iraq,17/05/2011,78,2,0,0,16,7,0,103
Iraq,18/05/2011,134,0,0,0,44,11,0,189
Iraq,19/05/2011,136,0,1,0,41,31,0,209
Iraq,20/05/2011,61,2,2,0,76,22,0,163
Iraq,21/05/2011,48,2,-1,0,3,9,0,61
Iraq,22/05/2011,39,0,1,0,24,18,0,82
Iraq,23/05/2011,63,4,0,0,-7,8,0,68
Iraq,24/05/2011,83,0,3,0,34,4,0,124
Iraq,25/05/2011,48,0,0,0,21,18,0,87
Iraq,26/05/2011,111,0,-10,0,5,17,0,123
Iraq,27/05/2011,108,0,1,0,24,13,0,146
Iraq,28/05/2011,128,0,-2,0,19,7,0,152
Iraq,29/05/2011,196,0,0,0,33,5,0,234
Iraq,30/05/2011,321,0,-22,0,35,15,0,349
Iraq,31/05/2011,129,0,-6,0,23,12,0,158
Morocco,01/05/2011,20,0,0,0,3,6,0,29
Morocco,02/05/2011,39,0,-2,0,11,0,0,48
Morocco,03/05/2011,27,0,0,0,4,4,0,35
Morocco,04/05/2011,10,0,0,0,6,3,0,19
Morocco,05/05/2011,5,0,-1,0,6,3,0,13
Morocco,06/05/2011,19,0,0,0,14,1,0,34
Morocco,07/05/2011,21,0,0,0,3,10,0,34
Morocco,08/05/2011,15,0,-2,0,1,13,0,27
Morocco,09/05/2011,8,0,0,0,5,0,0,13
Morocco,10/05/2011,60,0,0,0,33,10,0,103
Morocco,11/05/2011,3,0,0,0,18,8,0,29
Morocco,12/05/2011,2,0,-3,0,6,0,0,5
Morocco,13/05/2011,17,0,0,0,3,0,0,20
Morocco,14/05/2011,9,0,0,0,0,0,0,9
Morocco,15/05/2011,0,0,-6,0,-2,4,0,-4
Morocco,16/05/2011,0,0,-2,0,3,0,0,1
Morocco,17/05/2011,18,0,-2,0,9,0,0,25
Morocco,18/05/2011,0,0,-2,0,3,0,0,1
Morocco,19/05/2011,3,0,-1,0,2,0,0,4
Morocco,20/05/2011,3,4,-1,0,12,1,0,19
Morocco,21/05/2011,2,0,0,0,-2,1,0,1
Morocco,22/05/2011,0,0,0,0,3,0,0,3
Morocco,23/05/2011,31,0,0,0,0,10,0,41
Morocco,24/05/2011,16,0,-1,0,5,0,0,20
Morocco,25/05/2011,-1,0,0,0,-2,0,0,-3
Morocco,26/05/2011,3,0,0,0,0,0,0,3
Morocco,27/05/2011,4,0,0,0,-4,0,0,0
Morocco,28/05/2011,1,0,0,0,9,3,0,13
Morocco,29/05/2011,4,0,-4,0,2,8,0,10
Morocco,30/05/2011,4,0,0,0,0,3,0,7
Morocco,31/05/2011,3,0,0,0,6,1,0,10
Nigeria,01/05/2011,16,0,0,0,18,3,0,37
Nigeria,02/05/2011,36,0,0,0,9,3,0,48
Nigeria,03/05/2011,38,0,1,0,37,8,0,84
Nigeria,04/05/2011,20,0,4,0,37,1,0,62
Nigeria,05/05/2011,40,0,1,0,69,0,0,110
Nigeria,06/05/2011,48,0,2,0,56,2,0,108
Nigeria,07/05/2011,20,0,-6,0,4,7,0,25
Nigeria,08/05/2011,19,0,0,0,14,2,0,35
Nigeria,09/05/2011,10,0,0,0,24,10,0,44
Nigeria,10/05/2011,35,0,-3,0,14,1,0,47
Nigeria,11/05/2011,11,0,1,0,24,1,0,37
Nigeria,12/05/2011,42,0,0,0,0,15,0,57
Nigeria,13/05/2011,38,6,0,0,6,0,0,50
Nigeria,14/05/2011,9,0,0,0,1,0,0,10
Nigeria,15/05/2011,10,0,0,0,0,0,0,10
Nigeria,16/05/2011,12,0,0,0,0,8,0,20
Nigeria,17/05/2011,20,0,0,0,12,23,0,55
Nigeria,18/05/2011,41,0,0,0,4,4,0,49
Nigeria,19/05/2011,32,0,0,0,30,5,0,67
Nigeria,20/05/2011,35,0,1,0,16,13,0,65
Nigeria,21/05/2011,11,0,0,0,3,10,0,24
Nigeria,22/05/2011,4,0,0,0,0,0,0,4
Nigeria,23/05/2011,3,0,0,0,3,2,0,8
Nigeria,24/05/2011,45,0,-1,0,21,2,0,67
Nigeria,25/05/2011,7,0,0,0,7,0,0,14
Nigeria,26/05/2011,7,0,-4,0,0,1,0,4
Nigeria,27/05/2011,20,0,0,0,27,12,0,59
Nigeria,28/05/2011,17,0,0,0,1,4,0,22
Nigeria,29/05/2011,5,0,0,0,0,2,0,7
Nigeria,30/05/2011,33,0,-4,0,12,8,0,49
Nigeria,31/05/2011,12,0,0,0,3,6,0,21
Pakistan,01/05/2011,319,0,0,0,6,46,0,371
Pakistan,02/05/2011,1851,0,8,0,136,68,0,2063
Pakistan,03/05/2011,1526,8,10,0,102,104,0,1750
Pakistan,04/05/2011,925,4,1,0,69,70,0,1069
Pakistan,05/05/2011,935,4,-2,0,94,89,0,1120
Pakistan,06/05/2011,1046,22,2,0,104,93,0,1267
Pakistan,07/05/2011,699,8,-9,0,70,76,0,844
Pakistan,08/05/2011,831,10,-4,0,232,96,0,1165
Pakistan,09/05/2011,424,0,4,0,98,21,0,547
Pakistan,10/05/2011,508,8,3,0,101,46,0,666
Pakistan,11/05/2011,424,6,-4,0,37,26,0,489
Pakistan,12/05/2011,97,6,-6,0,60,12,0,169
Pakistan,13/05/2011,180,2,0,0,34,29,0,245
Pakistan,14/05/2011,80,0,1,0,24,4,0,109
Pakistan,15/05/2011,40,0,-6,0,9,12,0,55
Pakistan,16/05/2011,92,2,0,0,16,3,0,113
Pakistan,17/05/2011,129,0,-1,0,8,8,0,144
Pakistan,18/05/2011,338,2,1,0,31,43,0,415
Pakistan,19/05/2011,310,4,1,0,47,39,0,401
Pakistan,20/05/2011,240,0,0,0,28,17,0,285
Pakistan,21/05/2011,165,0,-2,0,19,14,0,196
Pakistan,22/05/2011,196,0,2,0,34,3,0,235
Pakistan,23/05/2011,196,0,-1,0,49,7,0,251
Pakistan,24/05/2011,315,0,0,0,59,20,0,394
Pakistan,25/05/2011,116,2,-1,0,17,12,0,146
Pakistan,26/05/2011,148,2,-4,0,31,20,0,197
Pakistan,27/05/2011,130,0,-2,0,47,6,0,181
Pakistan,28/05/2011,217,0,1,0,16,42,0,276
Pakistan,29/05/2011,195,0,0,0,9,10,0,214
Pakistan,30/05/2011,190,0,0,0,12,6,0,208
Pakistan,31/05/2011,91,0,-2,0,51,4,0,144
Sierra Leone,01/05/2011,0,0,0,0,0,0,0,0
Sierra Leone,02/05/2011,4,0,0,0,3,0,0,7
Sierra Leone,03/05/2011,0,0,0,0,0,1,0,1
Sierra Leone,04/05/2011,0,0,0,0,0,1,0,1
Sierra Leone,05/05/2011,4,0,0,0,3,0,0,7
Sierra Leone,06/05/2011,0,2,0,0,0,0,0,2
Sierra Leone,07/05/2011,0,0,0,0,0,0,0,0
Sierra Leone,08/05/2011,0,0,0,0,-2,0,0,-2
Sierra Leone,09/05/2011,10,0,0,0,0,1,0,11
Sierra Leone,10/05/2011,4,0,0,0,0,0,0,4
Sierra Leone,11/05/2011,2,0,0,0,0,0,0,2
Sierra Leone,12/05/2011,-1,0,0,0,3,0,0,2
Sierra Leone,13/05/2011,2,0,0,0,3,0,0,5
Sierra Leone,14/05/2011,0,0,0,0,3,0,0,3
Sierra Leone,15/05/2011,6,0,0,0,-2,0,0,4
Sierra Leone,16/05/2011,4,0,0,0,-2,1,0,3
Sierra Leone,17/05/2011,0,0,0,0,0,0,0,0
Sierra Leone,18/05/2011,2,0,0,0,0,0,0,2
Sierra Leone,19/05/2011,0,0,0,0,0,0,0,0
Sierra Leone,20/05/2011,-1,0,0,0,12,0,0,11
Sierra Leone,21/05/2011,4,0,0,0,0,1,0,5
Sierra Leone,22/05/2011,3,0,0,0,0,1,0,4
Sierra Leone,23/05/2011,0,0,0,0,0,0,0,0
Sierra Leone,24/05/2011,6,0,0,0,0,0,0,6
Sierra Leone,25/05/2011,0,0,0,0,9,0,0,9
Sierra Leone,26/05/2011,6,0,0,0,0,0,0,6
Sierra Leone,27/05/2011,0,0,0,0,0,0,0,0
Sierra Leone,28/05/2011,3,0,0,0,0,0,0,3
Sierra Leone,29/05/2011,0,0,0,0,0,3,0,3
Sierra Leone,30/05/2011,0,0,0,0,0,0,0,0
Sierra Leone,31/05/2011,0,0,0,0,0,0,0,0
Somalia,01/05/2011,19,0,0,0,-2,1,0,18
Somalia,02/05/2011,145,0,0,0,3,5,0,153
Somalia,03/05/2011,78,0,0,0,128,3,0,209
Somalia,04/05/2011,39,0,0,0,68,2,0,109
Somalia,05/05/2011,56,0,0,0,8,8,0,72
Somalia,06/05/2011,45,0,0,0,49,4,0,98
Somalia,07/05/2011,30,0,0,0,15,2,0,47
Somalia,08/05/2011,30,0,0,0,15,0,0,45
Somalia,09/05/2011,28,0,0,0,27,2,0,57
Somalia,10/05/2011,34,0,2,0,27,3,0,66
Somalia,11/05/2011,51,0,2,0,26,3,0,82
Somalia,12/05/2011,60,0,2,0,6,6,0,74
Somalia,13/05/2011,16,0,0,0,21,0,0,37
Somalia,14/05/2011,12,0,0,0,2,4,0,18
Somalia,15/05/2011,19,0,0,0,22,6,0,47
Somalia,16/05/2011,11,0,0,0,9,4,0,24
Somalia,17/05/2011,51,0,-1,0,12,0,0,62
Somalia,18/05/2011,35,0,0,0,-5,1,0,31
Somalia,19/05/2011,92,0,-2,0,3,3,0,96
Somalia,20/05/2011,84,0,0,0,4,2,0,90
Somalia,21/05/2011,58,2,0,0,27,1,0,88
Somalia,22/05/2011,6,0,0,0,33,0,0,39
Somalia,23/05/2011,18,0,0,0,22,3,0,43
Somalia,24/05/2011,49,0,1,0,14,4,0,68
Somalia,25/05/2011,45,0,0,0,0,5,0,50
Somalia,26/05/2011,81,0,-2,0,16,7,0,102
Somalia,27/05/2011,107,0,0,0,80,18,0,205
Somalia,28/05/2011,60,0,0,0,23,11,0,94
Somalia,29/05/2011,79,2,0,0,6,0,0,87
Somalia,30/05/2011,55,0,0,0,27,1,0,83
Somalia,31/05/2011,52,0,0,0,23,2,0,77
Syria,01/05/2011,159,0,2,0,32,18,0,211
Syria,02/05/2011,144,0,-15,0,37,32,0,198
Syria,03/05/2011,137,0,-7,0,61,14,0,205
Syria,04/05/2011,78,2,-1,0,27,21,0,127
Syria,05/05/2011,17,4,-2,0,37,15,0,71
Syria,06/05/2011,132,12,4,0,30,36,0,214
Syria,07/05/2011,210,0,0,0,47,35,0,292
Syria,08/05/2011,66,0,-1,0,27,9,0,101
Syria,09/05/2011,95,0,-4,0,36,6,0,133
Syria,10/05/2011,136,0,0,0,54,25,0,215
Syria,11/05/2011,195,0,-6,0,45,50,0,284
Syria,12/05/2011,61,8,-2,0,-2,16,0,81
Syria,13/05/2011,80,0,-3,0,30,25,0,132
Syria,14/05/2011,24,0,0,0,19,4,0,47
Syria,15/05/2011,56,0,-10,0,-5,7,0,48
Syria,16/05/2011,84,0,2,0,12,9,0,107
Syria,17/05/2011,117,0,-1,0,17,20,0,153
Syria,18/05/2011,172,4,-3,0,61,18,0,252
Syria,19/05/2011,326,4,-6,0,28,36,0,388
Syria,20/05/2011,258,2,-5,0,36,28,0,319
Syria,21/05/2011,73,0,-1,0,15,7,0,94
Syria,22/05/2011,40,0,1,0,21,5,0,67
Syria,23/05/2011,71,0,-8,0,34,12,0,109
Syria,24/05/2011,135,0,-2,0,30,21,0,184
Syria,25/05/2011,69,0,3,0,12,10,0,94
Syria,26/05/2011,103,0,1,0,28,17,0,149
Syria,27/05/2011,173,2,2,0,44,24,0,245
Syria,28/05/2011,53,0,7,0,47,9,0,116
Syria,29/05/2011,22,0,-2,0,32,10,0,62
Syria,30/05/2011,35,0,0,0,8,9,0,52
Syria,31/05/2011,37,0,-1,0,32,4,0,72
Yemen,01/05/2011,99,0,-8,0,3,14,0,108
Yemen,02/05/2011,275,0,-7,0,21,48,0,337
Yemen,03/05/2011,126,0,-8,0,20,31,0,169
Yemen,04/05/2011,101,0,-18,0,-5,7,0,85
Yemen,05/05/2011,136,0,-2,0,14,22,0,170
Yemen,06/05/2011,150,0,0,0,12,4,0,166
Yemen,07/05/2011,201,0,-6,0,18,11,0,224
Yemen,08/05/2011,69,0,-6,0,1,10,0,74
Yemen,09/05/2011,39,0,0,0,7,9,0,55
Yemen,10/05/2011,155,12,-11,0,26,11,0,193
Yemen,11/05/2011,169,8,-2,0,9,17,0,201
Yemen,12/05/2011,76,4,0,0,-4,9,0,85
Yemen,13/05/2011,51,0,-4,0,5,3,0,55
Yemen,14/05/2011,25,0,0,0,3,2,0,30
Yemen,15/05/2011,29,0,0,0,6,3,0,38
Yemen,16/05/2011,19,0,0,0,0,1,0,20
Yemen,17/05/2011,42,0,0,0,29,6,0,77
Yemen,18/05/2011,69,0,-12,0,23,8,0,88
Yemen,19/05/2011,51,0,-5,0,9,3,0,58
Yemen,20/05/2011,57,2,-2,0,13,1,0,71
Yemen,21/05/2011,42,0,-13,0,-2,4,0,31
Yemen,22/05/2011,23,2,-19,0,9,1,0,16
Yemen,23/05/2011,61,0,-3,0,6,5,0,69
Yemen,24/05/2011,105,2,-4,0,28,7,0,138
Yemen,25/05/2011,25,0,0,0,3,0,0,28
Yemen,26/05/2011,79,0,1,0,9,1,0,90
Yemen,27/05/2011,31,0,-4,0,13,0,0,40
Yemen,28/05/2011,26,0,-2,0,33,7,0,64
Yemen,29/05/2011,42,0,-2,0,24,2,0,66
Yemen,30/05/2011,36,0,-4,0,9,5,0,46
Yemen,31/05/2011,59,0,0,0,10,11,0,80
Afghanistan,01/11/2011,192,0,6,0,38,14,0,250
Afghanistan,02/11/2011,205,2,-4,0,50,11,0,264
Afghanistan,03/11/2011,299,0,0,0,76,42,0,417
Afghanistan,04/11/2011,139,0,0,0,67,25,0,231
Afghanistan,05/11/2011,184,0,0,0,54,9,0,247
Afghanistan,06/11/2011,133,0,0,0,9,4,0,146
Afghanistan,07/11/2011,166,0,0,0,44,14,0,224
Afghanistan,08/11/2011,186,0,-4,0,65,6,0,253
Afghanistan,09/11/2011,217,0,0,0,27,14,0,258
Afghanistan,10/11/2011,295,0,0,0,126,2,0,423
Afghanistan,11/11/2011,379,8,0,0,232,40,0,659
Afghanistan,12/11/2011,357,0,0,0,133,19,0,509
Afghanistan,13/11/2011,92,0,0,0,24,1,0,117
Afghanistan,14/11/2011,231,1,-5,0,124,11,0,362
Afghanistan,15/11/2011,301,0,-5,0,72,7,0,375
Afghanistan,16/11/2011,332,0,0,0,27,3,0,362
Afghanistan,17/11/2011,165,0,2,0,88,14,0,269
Afghanistan,18/11/2011,141,0,0,0,41,12,0,194
Afghanistan,19/11/2011,125,0,0,0,71,2,0,198
Afghanistan,20/11/2011,128,4,0,0,42,13,0,187
Afghanistan,21/11/2011,83,2,-3,0,46,28,0,156
Afghanistan,22/11/2011,105,0,-2,0,48,12,0,163
Afghanistan,23/11/2011,138,0,4,0,39,8,0,189
Afghanistan,24/11/2011,105,0,0,0,13,9,0,127
Afghanistan,25/11/2011,110,6,0,0,38,22,0,176
Afghanistan,26/11/2011,284,0,0,0,32,15,0,331
Afghanistan,27/11/2011,273,0,1,0,36,25,0,335
Afghanistan,28/11/2011,288,2,-2,0,60,35,0,383
Afghanistan,29/11/2011,301,0,2,0,26,87,0,416
Afghanistan,30/11/2011,200,2,1,0,1,22,0,226
Albania,01/11/2011,14,0,1,0,9,2,0,26
Albania,02/11/2011,8,0,0,0,0,1,0,9
Albania,03/11/2011,3,0,0,0,6,0,0,9
Albania,04/11/2011,4,0,0,0,6,0,0,10
Albania,06/11/2011,3,0,0,0,0,0,0,3
Albania,07/11/2011,14,0,0,0,9,3,0,26
Albania,08/11/2011,2,0,0,0,9,8,0,19
Albania,09/11/2011,11,0,0,0,6,2,0,19
Albania,10/11/2011,25,0,0,0,9,4,0,38
Albania,11/11/2011,34,0,0,0,27,10,0,71
Albania,12/11/2011,0,0,0,0,0,0,0,0
Albania,13/11/2011,0,0,0,0,0,0,0,0
Albania,14/11/2011,-2,0,0,0,3,2,0,3
Albania,15/11/2011,2,0,0,0,0,0,0,2
Albania,16/11/2011,11,0,0,0,0,0,0,11
Albania,17/11/2011,6,0,0,0,0,0,0,6
Albania,18/11/2011,9,0,0,0,0,0,0,9
Albania,19/11/2011,0,0,-1,0,0,0,0,-1
Albania,20/11/2011,4,0,0,0,0,0,0,4
Albania,21/11/2011,12,0,0,0,25,0,0,37
Albania,22/11/2011,6,0,0,0,12,0,0,18
Albania,23/11/2011,28,0,0,0,12,0,0,40
Albania,24/11/2011,37,0,-2,0,-2,0,0,33
Albania,25/11/2011,7,0,0,0,0,0,0,7
Albania,26/11/2011,1,0,0,0,-2,0,0,-1
Albania,27/11/2011,9,0,0,0,-2,0,0,7
Albania,28/11/2011,24,0,0,0,-2,1,0,23
Albania,29/11/2011,15,0,0,0,0,1,0,16
Albania,30/11/2011,6,0,0,0,0,0,0,6
Algeria,01/11/2011,1,0,0,0,9,2,0,12
Algeria,02/11/2011,4,0,-2,0,15,0,0,17
Algeria,03/11/2011,16,0,0,0,0,0,0,16
Algeria,04/11/2011,10,0,0,0,9,0,0,19
Algeria,05/11/2011,6,0,0,0,0,1,0,7
Algeria,06/11/2011,0,0,0,0,6,0,0,6
Algeria,07/11/2011,9,0,0,0,0,0,0,9
Algeria,08/11/2011,13,0,0,0,10,1,0,24
Algeria,09/11/2011,18,0,0,0,-2,0,0,16
Algeria,10/11/2011,3,0,0,0,0,1,0,4
Algeria,11/11/2011,1,0,0,0,2,3,0,6
Algeria,12/11/2011,3,0,0,0,15,2,0,20
Algeria,13/11/2011,16,0,0,0,0,1,0,17
Algeria,14/11/2011,19,0,0,0,9,0,0,28
Algeria,15/11/2011,12,0,0,0,6,3,0,21
Algeria,16/11/2011,0,0,0,0,6,0,0,6
Algeria,17/11/2011,27,0,1,0,2,1,0,31
Algeria,18/11/2011,22,0,0,0,14,0,0,36
Algeria,19/11/2011,34,0,0,0,19,1,0,54
Algeria,20/11/2011,31,0,0,0,13,3,0,47
Algeria,21/11/2011,1,0,0,0,-6,0,0,-5
Algeria,22/11/2011,8,0,0,0,-4,0,0,4
Algeria,23/11/2011,1,0,0,0,15,0,0,16
Algeria,24/11/2011,8,0,-2,0,18,4,0,28
Algeria,25/11/2011,12,0,0,0,25,0,0,37
Algeria,26/11/2011,5,0,0,0,6,0,0,11
Algeria,27/11/2011,9,0,-2,0,24,4,0,35
Algeria,28/11/2011,9,0,0,0,11,0,0,20
Algeria,29/11/2011,17,0,1,0,9,0,0,27
Algeria,30/11/2011,14,0,6,0,13,0,0,33
Bangladesh,01/11/2011,20,2,0,0,7,3,0,32
Bangladesh,02/11/2011,18,0,0,0,1,4,0,23
Bangladesh,03/11/2011,18,0,0,0,6,0,0,24
Bangladesh,04/11/2011,9,0,0,0,12,0,0,21
Bangladesh,05/11/2011,4,0,0,0,0,0,0,4
Bangladesh,06/11/2011,4,2,0,0,12,6,0,24
Bangladesh,07/11/2011,1,0,0,0,3,0,0,4
Bangladesh,08/11/2011,8,0,-1,0,3,0,0,10
Bangladesh,09/11/2011,44,0,0,0,11,4,0,59
Bangladesh,10/11/2011,10,0,0,0,0,0,0,10
Bangladesh,11/11/2011,15,0,5,0,6,1,0,27
Bangladesh,12/11/2011,5,0,0,0,3,0,0,8
Bangladesh,13/11/2011,10,0,-2,0,7,0,0,15
Bangladesh,14/11/2011,15,0,2,0,7,2,0,26
Bangladesh,15/11/2011,28,0,0,0,7,2,0,37
Bangladesh,16/11/2011,30,0,6,0,26,0,0,62
Bangladesh,17/11/2011,3,0,0,0,3,2,0,8
Bangladesh,18/11/2011,23,0,0,0,0,0,0,23
Bangladesh,19/11/2011,24,0,1,0,0,1,0,26
Bangladesh,20/11/2011,10,0,0,0,7,6,0,23
Bangladesh,21/11/2011,11,0,2,0,6,4,0,23
Bangladesh,22/11/2011,12,0,0,0,4,5,0,21
Bangladesh,23/11/2011,15,0,0,0,3,2,0,20
Bangladesh,24/11/2011,7,0,0,0,12,2,0,21
Bangladesh,25/11/2011,20,0,0,0,5,3,0,28
Bangladesh,26/11/2011,26,0,0,0,3,0,0,29
Bangladesh,27/11/2011,-1,0,1,0,0,4,0,4
Bangladesh,28/11/2011,11,0,-4,0,0,2,0,9
Bangladesh,29/11/2011,32,0,0,0,15,5,0,52
Bangladesh,30/11/2011,7,0,0,0,-1,1,0,7
Cameroon,01/11/2011,1,0,0,0,0,0,0,1
Cameroon,02/11/2011,7,0,0,0,-2,1,0,6
Cameroon,03/11/2011,3,0,0,0,6,0,0,9
Cameroon,04/11/2011,5,0,0,0,-2,1,0,4
Cameroon,05/11/2011,2,0,0,0,5,0,0,7
Cameroon,06/11/2011,0,2,0,0,0,0,0,2
Cameroon,08/11/2011,6,0,0,0,0,3,0,9
Cameroon,09/11/2011,0,0,0,0,0,0,0,0
Cameroon,10/11/2011,0,0,0,0,6,0,0,6
Cameroon,11/11/2011,0,0,0,0,0,0,0,0
Cameroon,12/11/2011,3,0,0,0,0,0,0,3
Cameroon,14/11/2011,0,0,0,0,0,0,0,0
Cameroon,15/11/2011,6,0,0,0,6,5,0,17
Cameroon,16/11/2011,1,0,0,0,0,1,0,2
Cameroon,17/11/2011,0,0,0,0,3,0,0,3
Cameroon,18/11/2011,0,0,0,0,3,0,0,3
Cameroon,19/11/2011,5,0,0,0,0,0,0,5
Cameroon,20/11/2011,0,0,0,0,0,0,0,0
Cameroon,21/11/2011,-6,0,0,0,0,0,0,-6
Cameroon,22/11/2011,6,0,0,0,0,0,0,6
Cameroon,23/11/2011,4,0,0,0,3,0,0,7
Cameroon,24/11/2011,4,0,0,0,0,0,0,4
Cameroon,25/11/2011,0,0,-2,0,0,0,0,-2
Cameroon,27/11/2011,0,0,0,0,0,0,0,0
Cameroon,28/11/2011,0,0,0,0,3,1,0,4
Cameroon,29/11/2011,2,0,0,0,0,0,0,2
Cameroon,30/11/2011,4,0,0,0,0,1,0,5
China,01/11/2011,141,2,3,0,45,22,0,213
China,02/11/2011,121,0,-3,0,58,24,0,200
China,03/11/2011,142,0,3,0,23,47,0,215
China,04/11/2011,145,8,0,0,38,25,0,216
China,05/11/2011,151,2,-3,0,18,6,0,174
China,06/11/2011,71,0,1,0,24,21,0,117
China,07/11/2011,144,4,-8,0,55,20,0,215
China,08/11/2011,158,4,-12,0,86,13,0,249
China,09/11/2011,154,4,-16,0,22,10,0,174
China,10/11/2011,110,4,2,0,40,57,0,213
China,11/11/2011,186,2,-1,0,70,30,0,287
China,12/11/2011,110,0,-6,0,48,14,0,166
China,13/11/2011,93,2,0,0,49,19,0,163
China,14/11/2011,217,0,-6,0,53,11,0,275
China,15/11/2011,189,8,-8,0,87,17,0,293
China,16/11/2011,138,0,-7,0,28,19,0,178
China,17/11/2011,203,16,-5,0,22,15,0,251
China,18/11/2011,458,6,-10,0,313,82,0,849
China,19/11/2011,516,6,-19,0,218,50,0,771
China,20/11/2011,86,0,3,0,39,5,0,133
China,21/11/2011,109,2,0,0,31,13,0,155
China,22/11/2011,121,0,-4,0,15,14,0,146
China,23/11/2011,146,0,-8,0,22,7,0,167
China,24/11/2011,114,2,-1,0,32,9,0,156
China,25/11/2011,151,0,-6,0,76,4,0,225
China,26/11/2011,62,0,0,0,31,4,0,97
China,27/11/2011,40,0,-1,0,34,15,0,88
China,28/11/2011,255,10,-6,0,74,25,0,358
China,29/11/2011,155,0,0,0,32,13,0,200
China,30/11/2011,142,4,-10,0,68,14,0,218
Egypt,01/11/2011,61,0,0,0,45,9,0,115
Egypt,02/11/2011,64,0,-12,0,23,24,0,99
Egypt,03/11/2011,47,0,-3,0,12,9,0,65
Egypt,04/11/2011,71,0,-6,0,27,17,0,109
Egypt,05/11/2011,93,0,4,0,-2,6,0,101
Egypt,06/11/2011,32,0,0,0,20,18,0,70
Egypt,07/11/2011,20,0,-2,0,34,20,0,72
Egypt,08/11/2011,141,0,1,0,15,6,0,163
Egypt,09/11/2011,31,0,0,0,18,3,0,52
Egypt,10/11/2011,36,0,-2,0,1,23,0,58
Egypt,11/11/2011,74,6,-2,0,1,20,0,99
Egypt,12/11/2011,27,0,-10,0,1,0,0,18
Egypt,13/11/2011,78,0,-5,0,58,8,0,139
Egypt,14/11/2011,67,0,1,0,46,16,0,130
Egypt,15/11/2011,62,0,0,0,40,16,0,118
Egypt,16/11/2011,44,0,-8,0,4,9,0,49
Egypt,17/11/2011,61,0,-12,0,8,17,0,74
Egypt,18/11/2011,42,0,-3,0,27,48,0,114
Egypt,19/11/2011,125,0,-7,0,110,66,0,294
Egypt,20/11/2011,122,0,-12,0,37,44,0,191
Egypt,21/11/2011,187,0,-30,0,37,39,0,233
Egypt,22/11/2011,412,4,-34,0,226,83,0,691
Egypt,23/11/2011,574,6,-55,0,240,104,0,869
Egypt,24/11/2011,269,6,-44,0,86,77,0,394
Egypt,25/11/2011,199,0,-38,0,-7,68,0,222
Egypt,26/11/2011,140,0,-22,0,52,22,0,192
Egypt,27/11/2011,59,0,-13,0,5,22,0,73
Egypt,28/11/2011,117,0,-18,0,28,33,0,160
Egypt,29/11/2011,85,0,-6,0,9,18,0,106
Egypt,30/11/2011,91,0,-3,0,57,25,0,170
Eritrea,01/11/2011,25,0,1,0,3,0,0,29
Eritrea,02/11/2011,57,0,0,0,-2,6,0,61
Eritrea,03/11/2011,10,0,0,0,18,0,0,28
Eritrea,04/11/2011,28,0,0,0,21,1,0,50
Eritrea,05/11/2011,8,0,0,0,1,0,0,9
Eritrea,06/11/2011,18,0,0,0,0,0,0,18
Eritrea,07/11/2011,6,0,0,0,0,0,0,6
Eritrea,08/11/2011,6,0,0,0,9,2,0,17
Eritrea,09/11/2011,0,0,0,0,-4,0,0,-4
Eritrea,10/11/2011,0,0,0,0,6,0,0,6
Eritrea,11/11/2011,6,0,0,0,0,0,0,6
Eritrea,12/11/2011,17,0,0,0,6,1,0,24
Eritrea,13/11/2011,24,0,0,0,10,0,0,34
Eritrea,14/11/2011,2,0,0,0,0,0,0,2
Eritrea,15/11/2011,12,0,1,0,0,0,0,13
Eritrea,16/11/2011,2,0,0,0,6,0,0,8
Eritrea,17/11/2011,2,0,0,0,-1,0,0,1
Eritrea,18/11/2011,3,0,0,0,-3,0,0,0
Eritrea,19/11/2011,4,0,0,0,0,1,0,5
Eritrea,20/11/2011,1,0,0,0,-2,0,0,-1
Eritrea,21/11/2011,-2,0,0,0,18,2,0,18
Eritrea,22/11/2011,2,0,0,0,0,0,0,2
Eritrea,23/11/2011,0,0,0,0,0,0,0,0
Eritrea,25/11/2011,8,0,0,0,0,0,0,8
Eritrea,26/11/2011,18,0,0,0,1,0,0,19
Eritrea,27/11/2011,3,0,0,0,-2,0,0,1
Eritrea,28/11/2011,2,0,0,0,0,0,0,2
Eritrea,29/11/2011,0,0,0,0,6,1,0,7
Eritrea,30/11/2011,2,0,0,0,1,0,0,3
Georgia,01/11/2011,32,2,2,0,18,1,0,55
Georgia,02/11/2011,47,0,1,0,12,11,0,71
Georgia,03/11/2011,17,0,0,0,15,6,0,38
Georgia,04/11/2011,53,0,0,0,35,12,0,100
Georgia,05/11/2011,3,0,0,0,11,4,0,18
Georgia,06/11/2011,10,0,0,0,0,0,0,10
Georgia,07/11/2011,16,0,-2,0,14,11,0,39
Georgia,08/11/2011,29,0,-1,0,16,9,0,53
Georgia,09/11/2011,22,6,0,0,16,5,0,49
Georgia,10/11/2011,16,0,1,0,15,3,0,35
Georgia,11/11/2011,3,0,0,0,0,0,0,3
Georgia,12/11/2011,18,0,1,0,4,1,0,24
Georgia,13/11/2011,9,0,0,0,3,0,0,12
Georgia,14/11/2011,12,0,-1,0,6,4,0,21
Georgia,15/11/2011,23,0,1,0,7,1,0,32
Georgia,16/11/2011,39,0,0,0,-9,2,0,32
Georgia,17/11/2011,34,0,0,0,10,0,0,44
Georgia,18/11/2011,15,0,0,0,2,0,0,17
Georgia,19/11/2011,35,0,0,0,18,10,0,63
Georgia,20/11/2011,4,0,-1,0,9,2,0,14
Georgia,21/11/2011,16,0,0,0,10,8,0,34
Georgia,22/11/2011,38,8,0,0,1,9,0,56
Georgia,23/11/2011,50,4,0,0,33,2,0,89
Georgia,24/11/2011,8,4,0,0,1,1,0,14
Georgia,25/11/2011,22,0,0,0,1,2,0,25
Georgia,26/11/2011,16,0,0,0,12,3,0,31
Georgia,27/11/2011,5,0,0,0,6,4,0,15
Georgia,28/11/2011,42,0,-1,0,-1,7,0,47
Georgia,29/11/2011,36,0,1,0,15,6,0,58
Georgia,30/11/2011,39,0,0,0,27,5,0,71
India,01/11/2011,31,0,1,0,13,9,0,54
India,02/11/2011,36,0,2,0,-1,0,0,37
India,03/11/2011,52,0,1,0,9,9,0,71
India,04/11/2011,21,0,-5,0,-8,11,0,19
India,05/11/2011,51,0,0,0,16,4,0,71
India,06/11/2011,16,2,0,0,-8,18,0,28
India,07/11/2011,35,8,0,0,16,5,0,64
India,08/11/2011,67,0,-6,0,11,7,0,79
India,09/11/2011,51,2,-1,0,36,7,0,95
India,10/11/2011,35,0,0,0,16,7,0,58
India,11/11/2011,35,0,-2,0,10,10,0,53
India,12/11/2011,46,2,0,0,7,6,0,61
India,13/11/2011,35,0,0,0,0,4,0,39
India,14/11/2011,55,0,2,0,53,11,0,121
India,15/11/2011,66,0,-7,0,34,8,0,101
India,16/11/2011,64,2,2,0,23,5,0,96
India,17/11/2011,75,0,0,0,6,5,0,86
India,18/11/2011,54,2,0,0,7,8,0,71
India,19/11/2011,52,0,-1,0,27,10,0,88
India,20/11/2011,41,4,0,0,30,5,0,80
India,21/11/2011,43,0,0,0,6,5,0,54
India,22/11/2011,27,4,-7,0,20,7,0,51
India,23/11/2011,89,4,-10,0,13,7,0,103
India,24/11/2011,62,2,0,0,0,8,0,72
India,25/11/2011,96,4,-3,0,12,12,0,121
India,26/11/2011,67,4,-2,0,5,3,0,77
India,27/11/2011,29,2,0,0,8,8,0,47
India,28/11/2011,58,2,1,0,-3,9,0,67
India,29/11/2011,55,0,0,0,32,7,0,94
India,30/11/2011,35,0,2,0,5,9,0,51
Iran,01/11/2011,104,0,0,0,26,8,0,138
Iran,02/11/2011,184,0,1,0,20,8,0,213
Iran,03/11/2011,139,0,7,0,31,13,0,190
Iran,04/11/2011,152,0,-4,0,33,16,0,197
Iran,05/11/2011,82,2,-2,0,18,11,0,111
Iran,06/11/2011,404,2,-5,0,159,55,0,615
Iran,07/11/2011,463,16,-17,0,180,71,0,713
Iran,08/11/2011,189,2,-3,0,92,25,0,305
Iran,09/11/2011,386,13,-38,0,129,53,0,543
Iran,10/11/2011,488,10,-21,0,240,64,0,781
Iran,11/11/2011,111,0,-2,0,18,20,0,147
Iran,12/11/2011,119,0,1,0,21,7,0,148
Iran,13/11/2011,147,0,0,0,38,14,0,199
Iran,14/11/2011,175,2,0,0,58,20,0,255
Iran,15/11/2011,134,2,-8,0,32,2,0,162
Iran,16/11/2011,84,0,1,0,28,28,0,141
Iran,17/11/2011,103,0,1,0,38,5,0,147
Iran,18/11/2011,75,0,2,0,3,9,0,89
Iran,19/11/2011,79,0,-2,0,34,9,0,120
Iran,20/11/2011,129,0,-4,0,67,4,0,196
Iran,21/11/2011,146,2,0,0,63,6,0,217
Iran,22/11/2011,157,4,0,0,36,6,0,203
Iran,23/11/2011,143,2,-1,0,40,22,0,206
Iran,24/11/2011,96,0,0,0,59,24,0,179
Iran,25/11/2011,117,0,-2,0,55,20,0,190
Iran,26/11/2011,65,0,3,0,26,4,0,98
Iran,27/11/2011,83,0,0,0,13,2,0,98
Iran,28/11/2011,92,0,0,0,53,2,0,147
Iran,29/11/2011,298,6,-2,0,116,27,0,445
Iran,30/11/2011,95,0,2,0,107,9,0,213
Iraq,01/11/2011,100,0,1,0,47,16,0,164
Iraq,02/11/2011,97,0,3,0,33,31,0,164
Iraq,03/11/2011,167,2,0,0,61,30,0,260
Iraq,04/11/2011,126,6,0,0,26,36,0,194
Iraq,05/11/2011,80,0,1,0,13,21,0,115
Iraq,06/11/2011,65,0,0,0,-3,2,0,64
Iraq,07/11/2011,172,0,0,0,16,14,0,202
Iraq,08/11/2011,161,2,-2,0,37,19,0,217
Iraq,09/11/2011,106,0,-8,0,9,9,0,116
Iraq,10/11/2011,135,2,-4,0,102,22,0,257
Iraq,11/11/2011,473,6,-17,0,215,64,0,741
Iraq,12/11/2011,408,0,-11,0,167,44,0,608
Iraq,13/11/2011,68,0,0,0,9,6,0,83
Iraq,14/11/2011,183,0,0,0,36,18,0,237
Iraq,15/11/2011,100,2,-2,0,56,14,0,170
Iraq,16/11/2011,94,0,0,0,15,6,0,115
Iraq,17/11/2011,101,0,0,0,4,8,0,113
Iraq,18/11/2011,82,0,-6,0,20,7,0,103
Iraq,19/11/2011,64,0,0,0,56,11,0,131
Iraq,20/11/2011,60,0,2,0,25,7,0,94
Iraq,21/11/2011,66,0,8,0,87,41,0,202
Iraq,22/11/2011,108,0,5,0,174,17,0,304
Iraq,23/11/2011,87,8,-6,0,97,14,0,200
Iraq,24/11/2011,96,0,1,0,13,21,0,131
Iraq,25/11/2011,105,0,0,0,18,20,0,143
Iraq,26/11/2011,74,0,1,0,5,18,0,98
Iraq,27/11/2011,66,0,-2,0,8,10,0,82
Iraq,28/11/2011,101,0,0,0,33,14,0,148
Iraq,29/11/2011,69,0,0,0,25,7,0,101
Iraq,30/11/2011,83,2,-4,0,3,7,0,91
Morocco,01/11/2011,3,0,0,0,6,0,0,9
Morocco,02/11/2011,1,0,0,0,15,4,0,20
Morocco,03/11/2011,5,0,0,0,-1,2,0,6
Morocco,04/11/2011,2,0,0,0,1,0,0,3
Morocco,05/11/2011,12,0,0,0,-2,1,0,11
Morocco,06/11/2011,0,0,0,0,-2,0,0,-2
Morocco,07/11/2011,3,0,0,0,-2,1,0,2
Morocco,08/11/2011,2,0,0,0,9,2,0,13
Morocco,09/11/2011,14,0,-2,0,9,7,0,28
Morocco,10/11/2011,1,0,0,0,24,0,0,25
Morocco,11/11/2011,-1,0,0,0,12,0,0,11
Morocco,12/11/2011,3,0,0,0,3,0,0,6
Morocco,13/11/2011,3,0,2,0,0,1,0,6
Morocco,14/11/2011,7,0,-2,0,6,5,0,16
Morocco,15/11/2011,26,0,-4,0,2,1,0,25
Morocco,16/11/2011,32,0,-2,0,6,2,0,38
Morocco,17/11/2011,31,0,1,0,-2,7,0,37
Morocco,18/11/2011,8,0,2,0,0,1,0,11
Morocco,19/11/2011,3,6,0,0,0,0,0,9
Morocco,20/11/2011,7,0,0,0,-2,0,0,5
Morocco,21/11/2011,-1,0,0,0,6,2,0,7
Morocco,22/11/2011,10,0,0,0,-6,0,0,4
Morocco,23/11/2011,14,0,0,0,2,2,0,18
Morocco,24/11/2011,7,2,1,0,0,2,0,12
Morocco,25/11/2011,8,2,-3,0,37,17,0,61
Morocco,26/11/2011,26,0,-4,0,1,6,0,29
Morocco,27/11/2011,28,0,-4,0,-6,3,0,21
Morocco,28/11/2011,15,0,0,0,-5,5,0,15
Morocco,29/11/2011,6,0,0,0,9,1,0,16
Morocco,30/11/2011,8,0,0,0,-6,6,0,8
Nigeria,01/11/2011,35,0,2,0,-1,4,0,40
Nigeria,02/11/2011,24,0,2,0,17,3,0,46
Nigeria,03/11/2011,19,0,0,0,25,5,0,49
Nigeria,04/11/2011,11,0,-2,0,24,4,0,37
Nigeria,05/11/2011,10,0,-2,0,16,4,0,28
Nigeria,06/11/2011,14,0,-3,0,15,0,0,26
Nigeria,07/11/2011,33,0,0,0,37,1,0,71
Nigeria,08/11/2011,27,0,-2,0,29,0,0,54
Nigeria,09/11/2011,39,2,-2,0,14,4,0,57
Nigeria,10/11/2011,28,0,0,0,18,4,0,50
Nigeria,11/11/2011,10,0,0,0,1,0,0,11
Nigeria,12/11/2011,7,0,0,0,3,1,0,11
Nigeria,13/11/2011,45,0,0,0,3,0,0,48
Nigeria,14/11/2011,42,0,2,0,17,0,0,61
Nigeria,15/11/2011,25,0,0,0,3,2,0,30
Nigeria,16/11/2011,38,0,0,0,43,1,0,82
Nigeria,17/11/2011,46,0,1,0,67,4,0,118
Nigeria,18/11/2011,60,2,2,0,40,12,0,116
Nigeria,19/11/2011,11,0,0,0,0,1,0,12
Nigeria,20/11/2011,20,0,0,0,5,3,0,28
Nigeria,21/11/2011,37,0,0,0,15,1,0,53
Nigeria,22/11/2011,38,0,0,0,21,0,0,59
Nigeria,23/11/2011,41,2,1,0,3,4,0,51
Nigeria,24/11/2011,82,0,0,0,38,9,0,129
Nigeria,25/11/2011,43,2,-2,0,39,4,0,86
Nigeria,26/11/2011,21,0,0,0,16,0,0,37
Nigeria,27/11/2011,23,0,-1,0,3,3,0,28
Nigeria,28/11/2011,31,0,0,0,17,0,0,48
Nigeria,29/11/2011,21,0,0,0,32,1,0,54
Nigeria,30/11/2011,37,0,1,0,21,2,0,61
Pakistan,01/11/2011,55,2,2,0,20,9,0,88
Pakistan,02/11/2011,109,0,0,0,19,10,0,138
Pakistan,03/11/2011,121,4,0,0,49,4,0,178
Pakistan,04/11/2011,88,2,0,0,41,13,0,144
Pakistan,05/11/2011,57,0,-1,0,10,11,0,77
Pakistan,06/11/2011,83,0,0,0,29,10,0,122
Pakistan,07/11/2011,88,2,0,0,25,25,0,140
Pakistan,08/11/2011,75,0,-2,0,30,1,0,104
Pakistan,09/11/2011,90,4,-4,0,12,4,0,106
Pakistan,10/11/2011,55,4,1,0,7,0,0,67
Pakistan,11/11/2011,53,0,0,0,18,3,0,74
Pakistan,12/11/2011,30,0,0,0,9,8,0,47
Pakistan,13/11/2011,60,0,0,0,13,5,0,78
Pakistan,14/11/2011,62,0,-4,0,67,7,0,132
Pakistan,15/11/2011,75,0,-4,0,23,7,0,101
Pakistan,16/11/2011,93,0,4,0,7,4,0,108
Pakistan,17/11/2011,93,0,2,0,20,3,0,118
Pakistan,18/11/2011,45,0,0,0,53,3,0,101
Pakistan,19/11/2011,53,0,0,0,34,2,0,89
Pakistan,20/11/2011,111,6,0,0,85,4,0,206
Pakistan,21/11/2011,57,0,2,0,51,10,0,120
Pakistan,22/11/2011,65,6,-11,0,32,5,0,97
Pakistan,23/11/2011,168,0,-16,0,30,16,0,198
Pakistan,24/11/2011,72,0,-7,0,17,14,0,96
Pakistan,25/11/2011,44,2,0,0,30,22,0,98
Pakistan,26/11/2011,226,0,0,0,64,30,0,320
Pakistan,27/11/2011,181,0,1,0,12,21,0,215
Pakistan,28/11/2011,181,0,0,0,43,27,0,251
Pakistan,29/11/2011,182,0,0,0,60,32,0,274
Pakistan,30/11/2011,131,0,3,0,22,23,0,179
Sierra Leone,01/11/2011,-1,0,0,0,0,0,0,-1
Sierra Leone,02/11/2011,0,0,0,0,3,0,0,3
Sierra Leone,03/11/2011,8,0,0,0,0,2,0,10
Sierra Leone,04/11/2011,0,0,0,0,1,0,0,1
Sierra Leone,05/11/2011,0,0,0,0,0,0,0,0
Sierra Leone,06/11/2011,0,0,0,0,0,0,0,0
Sierra Leone,07/11/2011,9,0,0,0,10,0,0,19
Sierra Leone,08/11/2011,6,0,0,0,3,0,0,9
Sierra Leone,09/11/2011,3,0,0,0,0,0,0,3
Sierra Leone,10/11/2011,2,0,0,0,11,1,0,14
Sierra Leone,11/11/2011,36,0,0,0,4,4,0,44
Sierra Leone,12/11/2011,9,0,1,0,27,0,0,37
Sierra Leone,13/11/2011,2,0,0,0,0,1,0,3
Sierra Leone,14/11/2011,6,2,0,0,3,0,0,11
Sierra Leone,15/11/2011,13,0,0,0,12,0,0,25
Sierra Leone,16/11/2011,3,0,0,0,0,0,0,3
Sierra Leone,17/11/2011,2,0,0,0,0,1,0,3
Sierra Leone,19/11/2011,5,2,0,0,0,0,0,7
Sierra Leone,21/11/2011,5,0,0,0,0,0,0,5
Sierra Leone,22/11/2011,2,0,0,0,12,0,0,14
Sierra Leone,23/11/2011,6,0,0,0,9,0,0,15
Sierra Leone,24/11/2011,3,0,1,0,-1,0,0,3
Sierra Leone,25/11/2011,0,0,1,0,-2,0,0,-1
Sierra Leone,26/11/2011,0,0,0,0,0,0,0,0
Sierra Leone,27/11/2011,0,0,1,0,0,0,0,1
Sierra Leone,28/11/2011,6,0,0,0,0,0,0,6
Sierra Leone,29/11/2011,2,0,0,0,0,0,0,2
Sierra Leone,30/11/2011,4,0,0,0,6,0,0,10
Somalia,01/11/2011,41,0,4,0,36,4,0,85
Somalia,02/11/2011,49,2,1,0,30,5,0,87
Somalia,03/11/2011,34,0,1,0,61,9,0,105
Somalia,04/11/2011,67,2,0,0,72,28,0,169
Somalia,05/11/2011,89,0,1,0,52,41,0,183
Somalia,06/11/2011,131,0,-2,0,-1,26,0,154
Somalia,07/11/2011,83,0,0,0,59,13,0,155
Somalia,08/11/2011,75,0,0,0,38,8,0,121
Somalia,09/11/2011,43,0,-2,0,36,5,0,82
Somalia,10/11/2011,20,0,0,0,4,11,0,35
Somalia,11/11/2011,66,0,0,0,28,4,0,98
Somalia,12/11/2011,38,2,0,0,26,2,0,68
Somalia,13/11/2011,73,0,0,0,57,6,0,136
Somalia,14/11/2011,61,0,0,0,55,2,0,118
Somalia,15/11/2011,76,0,1,0,40,3,0,120
Somalia,16/11/2011,102,6,1,0,29,10,0,148
Somalia,17/11/2011,31,0,0,0,9,13,0,53
Somalia,18/11/2011,30,0,0,0,12,0,0,42
Somalia,19/11/2011,36,0,0,0,9,22,0,67
Somalia,20/11/2011,47,0,0,0,3,10,0,60
Somalia,21/11/2011,47,0,0,0,11,0,0,58
Somalia,22/11/2011,37,0,0,0,32,4,0,73
Somalia,23/11/2011,41,0,1,0,11,2,0,55
Somalia,24/11/2011,108,0,1,0,42,6,0,157
Somalia,25/11/2011,84,0,0,0,24,5,0,113
Somalia,26/11/2011,101,0,0,0,5,7,0,113
Somalia,27/11/2011,17,0,1,0,14,4,0,36
Somalia,28/11/2011,23,4,0,0,7,0,0,34
Somalia,29/11/2011,17,2,0,0,30,3,0,52
Somalia,30/11/2011,9,0,0,0,33,2,0,44
Syria,01/11/2011,72,0,-4,0,28,9,0,105
Syria,02/11/2011,71,0,-8,0,30,23,0,116
Syria,03/11/2011,155,2,-6,0,69,21,0,241
Syria,04/11/2011,95,0,-6,0,26,18,0,133
Syria,05/11/2011,90,0,-2,0,19,14,0,121
Syria,06/11/2011,36,2,1,0,1,4,0,44
Syria,07/11/2011,149,2,4,0,36,18,0,209
Syria,08/11/2011,112,4,1,0,85,27,0,229
Syria,09/11/2011,117,0,-3,0,86,5,0,205
Syria,10/11/2011,53,0,1,0,44,5,0,103
Syria,11/11/2011,79,0,1,0,35,8,0,123
Syria,12/11/2011,125,0,-2,0,3,22,0,148
Syria,13/11/2011,74,0,0,0,11,10,0,95
Syria,14/11/2011,229,0,-46,0,36,6,0,225
Syria,15/11/2011,245,0,-13,0,55,24,0,311
Syria,16/11/2011,341,2,-16,0,121,32,0,480
Syria,17/11/2011,589,8,-18,0,290,97,0,966
Syria,18/11/2011,323,2,-10,0,76,38,0,429
Syria,19/11/2011,295,4,-3,0,95,26,0,417
Syria,20/11/2011,548,14,-22,0,212,102,0,854
Syria,21/11/2011,197,0,-10,0,11,14,0,212
Syria,22/11/2011,162,0,-60,0,29,17,0,148
Syria,23/11/2011,180,2,-20,0,26,10,0,198
Syria,24/11/2011,161,8,-2,0,7,21,0,195
Syria,25/11/2011,124,2,0,0,24,19,0,169
Syria,26/11/2011,240,2,-4,0,81,24,0,343
Syria,27/11/2011,186,4,0,0,28,17,0,235
Syria,28/11/2011,170,4,-5,0,30,49,0,248
Syria,29/11/2011,218,1,-1,0,55,22,0,295
Syria,30/11/2011,288,0,-2,0,107,19,0,412
Yemen,01/11/2011,73,2,-3,0,-24,6,0,54
Yemen,02/11/2011,101,4,1,0,-84,16,0,38
Yemen,03/11/2011,11,0,0,0,26,0,0,37
Yemen,04/11/2011,14,0,0,0,4,2,0,20
Yemen,05/11/2011,20,0,-2,0,7,4,0,29
Yemen,06/11/2011,10,0,-2,0,-2,4,0,10
Yemen,07/11/2011,25,6,0,0,12,1,0,44
Yemen,08/11/2011,37,0,0,0,4,0,0,41
Yemen,09/11/2011,40,0,0,0,33,5,0,78
Yemen,10/11/2011,17,0,0,0,29,0,0,46
Yemen,11/11/2011,31,2,0,0,-5,1,0,29
Yemen,12/11/2011,10,0,-2,0,15,2,0,25
Yemen,13/11/2011,17,0,0,0,13,3,0,33
Yemen,14/11/2011,27,0,-2,0,12,7,0,44
Yemen,15/11/2011,10,0,-16,0,-1,4,0,-3
Yemen,16/11/2011,37,0,0,0,9,5,0,51
Yemen,17/11/2011,34,0,0,0,3,8,0,45
Yemen,18/11/2011,21,0,0,0,2,9,0,32
Yemen,19/11/2011,42,0,-3,0,2,0,0,41
Yemen,20/11/2011,35,0,0,0,9,3,0,47
Yemen,21/11/2011,16,0,0,0,6,2,0,24
Yemen,22/11/2011,6,0,-2,0,3,0,0,7
Yemen,23/11/2011,42,0,-62,0,-3,5,0,-18
Yemen,24/11/2011,49,0,-20,0,-3,3,0,29
Yemen,25/11/2011,56,0,0,0,9,9,0,74
Yemen,26/11/2011,40,0,-4,0,19,11,0,66
Yemen,27/11/2011,44,0,-1,0,-1,1,0,43
Yemen,28/11/2011,49,0,-4,0,4,1,0,50
Yemen,29/11/2011,24,0,2,0,6,0,0,32
Yemen,30/11/2011,3,0,0,0,6,1,0,10
Afghanistan,01/10/2011,22,0,0,0,-1,1,0,22
Afghanistan,02/10/2011,182,4,-9,0,46,21,0,244
Afghanistan,03/10/2011,217,0,1,0,7,18,0,243
Afghanistan,04/10/2011,252,0,0,0,24,22,0,298
Afghanistan,05/10/2011,85,0,0,0,17,32,0,134
Afghanistan,06/10/2011,19,0,0,0,0,6,0,25
Afghanistan,07/10/2011,276,6,0,0,50,35,0,367
Afghanistan,08/10/2011,358,6,-13,0,100,73,0,524
Afghanistan,09/10/2011,343,4,-7,0,109,62,0,511
Afghanistan,10/10/2011,184,0,0,0,22,25,0,231
Afghanistan,11/10/2011,213,4,-3,0,53,18,0,285
Afghanistan,12/10/2011,139,0,1,0,42,23,0,205
Afghanistan,13/10/2011,1053,24,-19,0,534,119,0,1711
Afghanistan,14/10/2011,483,0,-41,0,196,30,0,668
Afghanistan,15/10/2011,212,0,-13,0,36,27,0,262
Afghanistan,16/10/2011,175,0,-1,0,45,13,0,232
Afghanistan,17/10/2011,170,0,-10,0,58,14,0,232
Afghanistan,18/10/2011,147,0,0,0,17,17,0,181
Afghanistan,19/10/2011,146,6,-2,0,23,18,0,191
Afghanistan,20/10/2011,208,0,-2,0,16,18,0,240
Afghanistan,21/10/2011,274,0,-6,0,37,8,0,313
Afghanistan,22/10/2011,110,0,0,0,56,11,0,177
Afghanistan,23/10/2011,122,0,0,0,16,15,0,153
Afghanistan,24/10/2011,144,0,0,0,21,12,0,177
Afghanistan,25/10/2011,158,2,0,0,73,3,0,236
Afghanistan,26/10/2011,148,0,0,0,16,11,0,175
Afghanistan,27/10/2011,193,0,1,0,35,15,0,244
Afghanistan,28/10/2011,196,6,2,0,34,8,0,246
Afghanistan,29/10/2011,191,12,-6,0,-4,11,0,204
Afghanistan,30/10/2011,183,4,0,0,37,21,0,245
Afghanistan,31/10/2011,298,0,-8,0,41,49,0,380
Albania,01/10/2011,0,0,0,0,0,0,0,0
Albania,02/10/2011,2,0,0,0,0,4,0,6
Albania,03/10/2011,1,0,1,0,-2,0,0,0
Albania,04/10/2011,20,0,0,0,3,-2,0,21
Albania,05/10/2011,2,0,0,0,0,1,0,3
Albania,06/10/2011,0,0,0,0,-1,0,0,-1
Albania,07/10/2011,12,0,-4,0,6,2,0,16
Albania,08/10/2011,0,0,0,0,0,1,0,1
Albania,09/10/2011,0,0,0,0,0,0,0,0
Albania,10/10/2011,-2,0,0,0,0,0,0,-2
Albania,11/10/2011,4,0,-1,0,6,2,0,11
Albania,12/10/2011,-1,0,-1,0,6,2,0,6
Albania,13/10/2011,15,0,0,0,6,6,0,27
Albania,14/10/2011,3,0,-4,0,6,6,0,11
Albania,15/10/2011,0,0,0,0,0,13,0,13
Albania,16/10/2011,1,0,0,0,0,12,0,13
Albania,17/10/2011,9,0,0,0,-4,14,0,19
Albania,18/10/2011,13,0,0,0,33,0,0,46
Albania,19/10/2011,57,0,-6,0,36,11,0,98
Albania,20/10/2011,17,0,0,0,3,4,0,24
Albania,21/10/2011,17,0,0,0,9,2,0,28
Albania,22/10/2011,35,0,0,0,5,0,0,40
Albania,23/10/2011,12,0,0,0,0,0,0,12
Albania,24/10/2011,14,0,-3,0,4,1,0,16
Albania,25/10/2011,19,0,0,0,0,1,0,20
Albania,26/10/2011,6,0,0,0,0,0,0,6
Albania,27/10/2011,13,0,-1,0,6,0,0,18
Albania,28/10/2011,0,0,0,0,0,0,0,0
Albania,29/10/2011,0,0,0,0,0,0,0,0
Albania,30/10/2011,30,0,0,0,0,4,0,34
Albania,31/10/2011,13,0,0,0,0,4,0,17
Algeria,01/10/2011,4,0,0,0,10,0,0,14
Algeria,02/10/2011,7,0,0,0,6,1,0,14
Algeria,03/10/2011,4,0,0,0,7,1,0,12
Algeria,04/10/2011,0,0,0,0,3,1,0,4
Algeria,05/10/2011,0,0,0,0,3,0,0,3
Algeria,06/10/2011,0,0,0,0,6,0,0,6
Algeria,07/10/2011,7,0,-2,0,18,0,0,23
Algeria,08/10/2011,13,0,0,0,9,4,0,26
Algeria,09/10/2011,0,0,0,0,0,3,0,3
Algeria,10/10/2011,2,0,0,0,-4,0,0,-2
Algeria,11/10/2011,97,0,0,0,3,2,0,102
Algeria,12/10/2011,7,0,0,0,-4,6,0,9
Algeria,13/10/2011,27,0,0,0,1,0,0,28
Algeria,14/10/2011,12,2,-1,0,9,0,0,22
Algeria,15/10/2011,9,0,0,0,11,2,0,22
Algeria,16/10/2011,14,0,0,0,0,0,0,14
Algeria,17/10/2011,29,0,0,0,-1,4,0,32
Algeria,18/10/2011,23,0,0,0,3,3,0,29
Algeria,19/10/2011,0,0,0,0,0,2,0,2
Algeria,20/10/2011,64,0,0,0,70,4,0,138
Algeria,21/10/2011,46,0,0,0,19,1,0,66
Algeria,22/10/2011,76,0,0,0,33,10,0,119
Algeria,23/10/2011,20,0,0,0,38,8,0,66
Algeria,24/10/2011,13,0,0,0,4,1,0,18
Algeria,25/10/2011,20,2,0,0,15,4,0,41
Algeria,26/10/2011,4,2,0,0,-2,1,0,5
Algeria,27/10/2011,19,0,0,0,50,4,0,73
Algeria,28/10/2011,12,0,0,0,27,2,0,41
Algeria,29/10/2011,9,2,0,0,11,3,0,25
Algeria,30/10/2011,6,0,0,0,10,3,0,19
Algeria,31/10/2011,7,0,0,0,4,0,0,11
Bangladesh,01/10/2011,0,0,0,0,6,0,0,6
Bangladesh,02/10/2011,8,0,-2,0,9,3,0,18
Bangladesh,03/10/2011,53,2,0,0,15,3,0,73
Bangladesh,04/10/2011,18,0,2,0,0,1,0,21
Bangladesh,05/10/2011,-4,0,0,0,3,0,0,-1
Bangladesh,06/10/2011,0,0,0,0,0,0,0,0
Bangladesh,07/10/2011,13,0,0,0,3,0,0,16
Bangladesh,08/10/2011,8,0,0,0,22,0,0,30
Bangladesh,09/10/2011,2,0,0,0,19,6,0,27
Bangladesh,10/10/2011,10,0,0,0,0,-2,0,8
Bangladesh,11/10/2011,23,0,1,0,10,0,0,34
Bangladesh,12/10/2011,27,0,0,0,8,4,0,39
Bangladesh,13/10/2011,34,0,0,0,4,0,0,38
Bangladesh,14/10/2011,19,0,-2,0,4,0,0,21
Bangladesh,15/10/2011,27,4,0,0,0,0,0,31
Bangladesh,16/10/2011,22,0,0,0,7,3,0,32
Bangladesh,17/10/2011,11,0,0,0,0,2,0,13
Bangladesh,18/10/2011,7,0,1,0,0,3,0,11
Bangladesh,19/10/2011,21,0,0,0,12,14,0,47
Bangladesh,20/10/2011,4,0,2,0,-8,1,0,-1
Bangladesh,21/10/2011,9,0,0,0,9,0,0,18
Bangladesh,22/10/2011,8,0,0,0,9,1,0,18
Bangladesh,23/10/2011,55,0,0,0,11,2,0,68
Bangladesh,24/10/2011,17,0,0,0,4,2,0,23
Bangladesh,25/10/2011,21,0,0,0,12,3,0,36
Bangladesh,26/10/2011,4,0,2,0,-2,0,0,4
Bangladesh,27/10/2011,9,0,0,0,12,0,0,21
Bangladesh,28/10/2011,9,0,-1,0,6,0,0,14
Bangladesh,29/10/2011,8,0,0,0,0,0,0,8
Bangladesh,30/10/2011,2,0,0,0,22,5,0,29
Bangladesh,31/10/2011,11,0,3,0,39,5,0,58
Cameroon,02/10/2011,1,0,0,0,3,0,0,4
Cameroon,03/10/2011,0,0,0,0,0,0,0,0
Cameroon,04/10/2011,3,0,-2,0,3,0,0,4
Cameroon,05/10/2011,0,0,0,0,3,0,0,3
Cameroon,06/10/2011,0,0,0,0,0,0,0,0
Cameroon,07/10/2011,8,0,0,0,6,0,0,14
Cameroon,08/10/2011,1,0,0,0,0,0,0,1
Cameroon,09/10/2011,-1,0,0,0,0,2,0,1
Cameroon,10/10/2011,0,0,0,0,0,2,0,2
Cameroon,11/10/2011,2,0,0,0,0,0,0,2
Cameroon,12/10/2011,1,0,0,0,0,0,0,1
Cameroon,13/10/2011,1,0,0,0,0,0,0,1
Cameroon,14/10/2011,2,0,0,0,0,0,0,2
Cameroon,15/10/2011,3,0,0,0,0,1,0,4
Cameroon,16/10/2011,0,0,0,0,0,0,0,0
Cameroon,17/10/2011,3,0,0,0,0,1,0,4
Cameroon,18/10/2011,0,0,0,0,-2,5,0,3
Cameroon,19/10/2011,0,0,0,0,3,0,0,3
Cameroon,20/10/2011,16,0,0,0,0,0,0,16
Cameroon,21/10/2011,4,0,0,0,3,0,0,7
Cameroon,22/10/2011,4,0,0,0,9,0,0,13
Cameroon,23/10/2011,1,0,0,0,0,0,0,1
Cameroon,24/10/2011,0,0,0,0,0,0,0,0
Cameroon,25/10/2011,2,0,0,0,3,0,0,5
Cameroon,26/10/2011,-3,0,0,0,9,6,0,12
Cameroon,27/10/2011,2,0,-4,0,0,2,0,0
Cameroon,28/10/2011,0,0,0,0,3,0,0,3
Cameroon,30/10/2011,5,0,0,0,0,0,0,5
Cameroon,31/10/2011,6,0,2,0,0,0,0,8
China,01/10/2011,0,0,0,0,0,0,0,0
China,02/10/2011,118,0,-7,0,11,15,0,137
China,03/10/2011,123,0,-3,0,37,7,0,164
China,04/10/2011,171,2,-2,0,46,38,0,255
China,05/10/2011,155,2,0,0,6,28,0,191
China,06/10/2011,49,0,-1,0,27,1,0,76
China,07/10/2011,155,2,-4,0,12,49,0,214
China,08/10/2011,93,0,-5,0,28,8,0,124
China,09/10/2011,68,0,-6,0,32,14,0,108
China,10/10/2011,107,0,-6,0,17,11,0,129
China,11/10/2011,121,0,-2,0,27,8,0,154
China,12/10/2011,134,0,0,0,11,9,0,154
China,13/10/2011,207,6,3,0,24,26,0,266
China,14/10/2011,159,2,1,0,37,32,0,231
China,15/10/2011,134,0,0,0,6,15,0,155
China,16/10/2011,62,2,1,0,24,28,0,117
China,17/10/2011,152,0,-2,0,68,38,0,256
China,18/10/2011,165,0,2,0,50,38,0,255
China,19/10/2011,127,4,0,0,86,26,0,243
China,20/10/2011,144,2,3,0,44,12,0,205
China,21/10/2011,138,6,2,0,41,12,0,199
China,22/10/2011,66,0,-2,0,33,12,0,109
China,23/10/2011,85,0,0,0,27,15,0,127
China,24/10/2011,70,2,-1,0,39,7,0,117
China,25/10/2011,126,0,-2,0,31,29,0,184
China,26/10/2011,147,0,-8,0,77,19,0,235
China,27/10/2011,159,0,-2,0,38,26,0,221
China,28/10/2011,105,6,-5,0,33,23,0,162
China,29/10/2011,70,2,1,0,11,8,0,92
China,30/10/2011,72,0,1,0,40,2,0,115
China,31/10/2011,149,4,7,0,35,23,0,218
Egypt,01/10/2011,7,0,0,0,3,0,0,10
Egypt,02/10/2011,55,0,1,0,32,11,0,99
Egypt,03/10/2011,55,0,-4,0,44,15,0,110
Egypt,04/10/2011,97,0,2,0,43,28,0,170
Egypt,05/10/2011,56,0,-2,0,7,14,0,75
Egypt,06/10/2011,0,0,0,0,4,3,0,7
Egypt,07/10/2011,90,0,-5,0,4,15,0,104
Egypt,08/10/2011,50,0,-6,0,28,2,0,74
Egypt,09/10/2011,112,0,-3,0,54,25,0,188
Egypt,10/10/2011,165,0,3,0,45,9,0,222
Egypt,11/10/2011,240,2,-38,0,60,55,0,319
Egypt,12/10/2011,195,6,-6,0,10,27,0,232
Egypt,13/10/2011,166,0,0,0,65,28,0,259
Egypt,14/10/2011,183,0,-3,0,-9,14,0,185
Egypt,15/10/2011,157,0,0,0,-3,14,0,168
Egypt,16/10/2011,51,0,-2,0,-7,11,0,53
Egypt,17/10/2011,75,0,3,0,-21,11,0,68
Egypt,18/10/2011,196,0,-6,0,-191,6,0,5
Egypt,19/10/2011,63,0,2,0,-5,14,0,74
Egypt,20/10/2011,81,0,-2,0,-1,31,0,109
Egypt,21/10/2011,88,0,-4,0,21,18,0,123
Egypt,22/10/2011,75,0,-12,0,7,6,0,76
Egypt,23/10/2011,35,0,0,0,42,17,0,94
Egypt,24/10/2011,74,2,0,0,-16,17,0,77
Egypt,25/10/2011,106,0,-3,0,26,23,0,152
Egypt,26/10/2011,38,0,-1,0,23,14,0,74
Egypt,27/10/2011,61,0,-4,0,-12,20,0,65
Egypt,28/10/2011,63,0,-2,0,41,6,0,108
Egypt,29/10/2011,69,0,0,0,23,10,0,102
Egypt,30/10/2011,127,0,0,0,26,10,0,163
Egypt,31/10/2011,96,2,0,0,69,24,0,191
Eritrea,02/10/2011,0,0,0,0,3,0,0,3
Eritrea,03/10/2011,3,0,0,0,0,0,0,3
Eritrea,04/10/2011,0,0,0,0,0,0,0,0
Eritrea,05/10/2011,0,0,0,0,0,0,0,0
Eritrea,06/10/2011,0,0,0,0,3,0,0,3
Eritrea,07/10/2011,0,0,0,0,0,1,0,1
Eritrea,09/10/2011,0,0,0,0,0,0,0,0
Eritrea,10/10/2011,0,0,0,0,0,0,0,0
Eritrea,11/10/2011,0,0,0,0,0,0,0,0
Eritrea,12/10/2011,0,0,0,0,6,0,0,6
Eritrea,13/10/2011,0,0,0,0,-2,0,0,-2
Eritrea,14/10/2011,0,0,0,0,0,0,0,0
Eritrea,15/10/2011,0,0,0,0,0,0,0,0
Eritrea,16/10/2011,6,0,0,0,-4,0,0,2
Eritrea,17/10/2011,0,0,0,0,6,1,0,7
Eritrea,18/10/2011,2,0,0,0,7,1,0,10
Eritrea,19/10/2011,0,0,0,0,3,0,0,3
Eritrea,20/10/2011,2,0,0,0,0,0,0,2
Eritrea,21/10/2011,4,0,0,0,3,0,0,7
Eritrea,22/10/2011,0,0,0,0,0,0,0,0
Eritrea,23/10/2011,3,0,0,0,0,0,0,3
Eritrea,24/10/2011,0,0,0,0,0,0,0,0
Eritrea,25/10/2011,0,0,0,0,6,0,0,6
Eritrea,26/10/2011,0,0,0,0,15,2,0,17
Eritrea,27/10/2011,2,0,0,0,10,0,0,12
Eritrea,28/10/2011,11,0,0,0,24,0,0,35
Eritrea,29/10/2011,0,0,0,0,0,0,0,0
Eritrea,30/10/2011,2,0,0,0,0,0,0,2
Eritrea,31/10/2011,5,0,0,0,0,0,0,5
Georgia,02/10/2011,15,2,-1,0,16,4,0,36
Georgia,03/10/2011,46,2,0,0,15,0,0,63
Georgia,04/10/2011,90,4,-13,0,12,9,0,102
Georgia,05/10/2011,11,0,0,0,2,6,0,19
Georgia,06/10/2011,1,0,0,0,0,1,0,2
Georgia,07/10/2011,21,0,-2,0,14,1,0,34
Georgia,08/10/2011,5,0,0,0,0,1,0,6
Georgia,09/10/2011,16,0,0,0,-4,0,0,12
Georgia,10/10/2011,10,0,0,0,6,0,0,16
Georgia,11/10/2011,21,0,-2,0,7,1,0,27
Georgia,12/10/2011,3,0,-2,0,8,1,0,10
Georgia,13/10/2011,14,0,1,0,4,3,0,22
Georgia,14/10/2011,10,0,-2,0,13,9,0,30
Georgia,15/10/2011,12,0,0,0,1,0,0,13
Georgia,16/10/2011,17,0,1,0,11,1,0,30
Georgia,17/10/2011,36,4,1,0,22,0,0,63
Georgia,18/10/2011,29,2,0,0,4,1,0,36
Georgia,19/10/2011,9,0,-2,0,18,7,0,32
Georgia,20/10/2011,20,0,0,0,17,4,0,41
Georgia,21/10/2011,26,4,4,0,33,4,0,71
Georgia,22/10/2011,11,0,0,0,10,0,0,21
Georgia,23/10/2011,17,0,2,0,1,5,0,25
Georgia,24/10/2011,12,0,1,0,5,4,0,22
Georgia,25/10/2011,19,0,1,0,18,10,0,48
Georgia,26/10/2011,29,2,1,0,35,7,0,74
Georgia,27/10/2011,31,0,0,0,15,1,0,47
Georgia,28/10/2011,-1,0,1,0,30,2,0,32
Georgia,29/10/2011,14,0,1,0,32,7,0,54
Georgia,30/10/2011,6,0,0,0,1,0,0,7
Georgia,31/10/2011,29,0,2,0,3,9,0,43
India,01/10/2011,0,0,0,0,0,0,0,0
India,02/10/2011,13,2,-1,0,7,3,0,24
India,03/10/2011,24,0,0,0,25,13,0,62
India,04/10/2011,41,2,-1,0,31,14,0,87
India,05/10/2011,22,0,-4,0,9,6,0,33
India,06/10/2011,8,0,0,0,6,0,0,14
India,07/10/2011,61,0,-2,0,19,6,0,84
India,08/10/2011,28,0,0,0,0,4,0,32
India,09/10/2011,17,0,0,0,16,1,0,34
India,10/10/2011,46,0,-2,0,10,6,0,60
India,11/10/2011,51,0,-2,0,10,2,0,61
India,12/10/2011,44,4,-1,0,11,7,0,65
India,13/10/2011,37,0,0,0,23,11,0,71
India,14/10/2011,51,2,0,0,13,10,0,76
India,15/10/2011,41,0,0,0,15,1,0,57
India,16/10/2011,30,2,-3,0,8,8,0,45
India,17/10/2011,40,0,0,0,5,9,0,54
India,18/10/2011,72,0,0,0,-1,1,0,72
India,19/10/2011,64,6,0,0,10,10,0,90
India,20/10/2011,37,0,1,0,7,5,0,50
India,21/10/2011,69,0,1,0,7,13,0,90
India,22/10/2011,36,0,0,0,6,2,0,44
India,23/10/2011,26,2,0,0,4,1,0,33
India,24/10/2011,26,2,0,0,16,4,0,48
India,25/10/2011,16,6,0,0,0,5,0,27
India,26/10/2011,33,0,0,0,4,1,0,38
India,27/10/2011,42,0,0,0,8,3,0,53
India,28/10/2011,72,0,-1,0,1,4,0,76
India,29/10/2011,17,0,1,0,3,5,0,26
India,30/10/2011,23,2,0,0,20,1,0,46
India,31/10/2011,41,0,-3,0,17,7,0,62
Iran,01/10/2011,4,0,0,0,6,1,0,11
Iran,02/10/2011,39,0,1,0,13,3,0,56
Iran,03/10/2011,87,0,-2,0,79,9,0,173
Iran,04/10/2011,149,0,-10,0,37,8,0,184
Iran,05/10/2011,72,0,-1,0,11,7,0,89
Iran,06/10/2011,15,0,1,0,0,0,0,16
Iran,07/10/2011,64,0,0,0,64,4,0,132
Iran,08/10/2011,63,0,0,0,25,1,0,89
Iran,09/10/2011,46,2,0,0,30,2,0,80
Iran,10/10/2011,28,0,3,0,13,4,0,48
Iran,11/10/2011,304,2,3,0,209,17,0,535
Iran,12/10/2011,219,8,-1,0,117,8,0,351
Iran,13/10/2011,337,4,0,0,98,20,0,459
Iran,14/10/2011,158,0,1,0,63,37,0,259
Iran,15/10/2011,71,0,0,0,31,11,0,113
Iran,16/10/2011,90,0,3,0,-16,5,0,82
Iran,17/10/2011,147,0,1,0,64,3,0,215
Iran,18/10/2011,101,4,9,0,26,17,0,157
Iran,19/10/2011,102,0,0,0,69,10,0,181
Iran,20/10/2011,112,0,3,0,83,21,0,219
Iran,21/10/2011,111,2,3,0,47,19,0,182
Iran,22/10/2011,10,0,0,0,24,3,0,37
Iran,23/10/2011,388,2,-18,0,178,73,0,623
Iran,24/10/2011,442,6,-8,0,206,99,0,745
Iran,25/10/2011,164,0,1,0,154,43,0,362
Iran,26/10/2011,66,0,1,0,77,6,0,150
Iran,27/10/2011,60,0,0,0,38,8,0,106
Iran,28/10/2011,37,0,0,0,18,2,0,57
Iran,29/10/2011,18,0,0,0,15,1,0,34
Iran,30/10/2011,38,0,2,0,14,3,0,57
Iran,31/10/2011,57,0,-3,0,17,6,0,77
Iraq,01/10/2011,22,0,0,0,0,0,0,22
Iraq,02/10/2011,77,0,-1,0,37,7,0,120
Iraq,03/10/2011,64,0,0,0,16,1,0,81
Iraq,04/10/2011,72,4,1,0,9,0,0,86
Iraq,05/10/2011,77,0,-2,0,5,3,0,83
Iraq,06/10/2011,0,0,4,0,0,0,0,4
Iraq,07/10/2011,143,0,1,0,22,12,0,178
Iraq,08/10/2011,7,0,-2,0,5,16,0,26
Iraq,09/10/2011,13,0,1,0,0,0,0,14
Iraq,10/10/2011,30,0,-6,0,12,4,0,40
Iraq,11/10/2011,91,2,0,0,16,10,0,119
Iraq,12/10/2011,51,0,0,0,11,6,0,68
Iraq,13/10/2011,139,2,2,0,21,19,0,183
Iraq,14/10/2011,76,0,0,0,33,13,0,122
Iraq,15/10/2011,53,0,-1,0,21,14,0,87
Iraq,16/10/2011,49,0,-1,0,33,9,0,90
Iraq,17/10/2011,53,0,2,0,21,13,0,89
Iraq,18/10/2011,110,4,0,0,7,15,0,136
Iraq,19/10/2011,325,4,0,0,32,19,0,380
Iraq,20/10/2011,247,0,0,0,22,32,0,301
Iraq,21/10/2011,67,0,-1,0,31,38,0,135
Iraq,22/10/2011,152,0,2,0,28,36,0,218
Iraq,23/10/2011,29,0,1,0,20,2,0,52
Iraq,24/10/2011,22,0,1,0,28,8,0,59
Iraq,25/10/2011,83,0,2,0,36,10,0,131
Iraq,26/10/2011,109,4,0,0,47,25,0,185
Iraq,27/10/2011,114,2,-1,0,63,27,0,205
Iraq,28/10/2011,92,0,1,0,52,55,0,200
Iraq,29/10/2011,-108,10,0,0,104,42,0,48
Iraq,30/10/2011,36,0,1,0,120,47,0,204
Iraq,31/10/2011,152,2,8,0,97,51,0,310
Morocco,01/10/2011,0,0,0,0,0,0,0,0
Morocco,02/10/2011,0,0,0,0,0,0,0,0
Morocco,03/10/2011,27,0,0,0,9,2,0,38
Morocco,04/10/2011,27,0,0,0,9,0,0,36
Morocco,05/10/2011,5,0,0,0,10,5,0,20
Morocco,06/10/2011,4,0,0,0,3,2,0,9
Morocco,07/10/2011,37,0,1,0,1,4,0,43
Morocco,08/10/2011,6,0,0,0,3,0,0,9
Morocco,09/10/2011,6,0,0,0,0,0,0,6
Morocco,10/10/2011,2,0,0,0,0,3,0,5
Morocco,11/10/2011,7,0,1,0,6,1,0,15
Morocco,12/10/2011,15,0,0,0,0,1,0,16
Morocco,13/10/2011,-3,0,0,0,18,2,0,17
Morocco,14/10/2011,4,0,0,0,-6,0,0,-2
Morocco,15/10/2011,10,0,2,0,4,1,0,17
Morocco,16/10/2011,8,0,0,0,4,3,0,15
Morocco,17/10/2011,2,0,0,0,0,5,0,7
Morocco,18/10/2011,10,0,0,0,-2,1,0,9
Morocco,19/10/2011,5,0,0,0,15,4,0,24
Morocco,20/10/2011,-4,0,0,0,3,4,0,3
Morocco,21/10/2011,3,0,-1,0,3,2,0,7
Morocco,22/10/2011,13,0,0,0,12,1,0,26
Morocco,23/10/2011,19,0,-1,0,51,2,0,71
Morocco,24/10/2011,5,0,0,0,3,2,0,10
Morocco,25/10/2011,4,0,0,0,-2,8,0,10
Morocco,26/10/2011,5,0,-2,0,7,4,0,14
Morocco,27/10/2011,5,0,-2,0,1,0,0,4
Morocco,28/10/2011,5,0,0,0,21,0,0,26
Morocco,29/10/2011,5,0,-2,0,6,0,0,9
Morocco,30/10/2011,18,0,0,0,15,0,0,33
Morocco,31/10/2011,12,0,-2,0,39,7,0,56
Nigeria,01/10/2011,2,0,1,0,6,1,0,10
Nigeria,02/10/2011,70,0,0,0,3,4,0,77
Nigeria,03/10/2011,48,0,0,0,21,12,0,81
Nigeria,04/10/2011,56,0,0,0,67,18,0,141
Nigeria,05/10/2011,21,0,0,0,27,2,0,50
Nigeria,06/10/2011,23,0,0,0,1,5,0,29
Nigeria,07/10/2011,253,4,-11,0,202,37,0,485
Nigeria,08/10/2011,25,0,2,0,31,11,0,69
Nigeria,09/10/2011,8,0,0,0,3,0,0,11
Nigeria,10/10/2011,16,0,0,0,9,0,0,25
Nigeria,11/10/2011,58,0,2,0,33,13,0,106
Nigeria,12/10/2011,161,4,0,0,37,11,0,213
Nigeria,13/10/2011,42,0,0,0,42,10,0,94
Nigeria,14/10/2011,54,2,0,0,35,9,0,100
Nigeria,15/10/2011,13,0,0,0,-10,0,0,3
Nigeria,16/10/2011,42,0,0,0,-2,1,0,41
Nigeria,17/10/2011,20,0,1,0,9,8,0,38
Nigeria,18/10/2011,23,0,-1,0,54,3,0,79
Nigeria,19/10/2011,11,0,0,0,21,6,0,38
Nigeria,20/10/2011,36,0,0,0,6,5,0,47
Nigeria,21/10/2011,9,0,0,0,2,4,0,15
Nigeria,22/10/2011,23,0,1,0,12,0,0,36
Nigeria,23/10/2011,13,0,-2,0,1,1,0,13
Nigeria,24/10/2011,19,0,0,0,1,3,0,23
Nigeria,25/10/2011,27,2,0,0,3,4,0,36
Nigeria,26/10/2011,13,0,0,0,1,1,0,15
Nigeria,27/10/2011,44,0,0,0,7,1,0,52
Nigeria,28/10/2011,25,0,0,0,12,3,0,40
Nigeria,29/10/2011,11,2,0,0,4,0,0,17
Nigeria,30/10/2011,11,0,1,0,7,1,0,20
Nigeria,31/10/2011,37,0,4,0,12,3,0,56
Pakistan,01/10/2011,29,0,0,0,-2,2,0,29
Pakistan,02/10/2011,169,0,-1,0,59,18,0,245
Pakistan,03/10/2011,185,2,-6,0,105,22,0,308
Pakistan,04/10/2011,214,2,-6,0,56,47,0,313
Pakistan,05/10/2011,130,0,-2,0,41,15,0,184
Pakistan,06/10/2011,25,0,0,0,3,0,0,28
Pakistan,07/10/2011,156,0,0,0,7,8,0,171
Pakistan,08/10/2011,196,10,-6,0,37,18,0,255
Pakistan,09/10/2011,151,4,3,0,40,8,0,206
Pakistan,10/10/2011,74,0,0,0,21,0,0,95
Pakistan,11/10/2011,104,0,-1,0,38,10,0,151
Pakistan,12/10/2011,81,2,0,0,31,7,0,121
Pakistan,13/10/2011,224,2,-1,0,43,19,0,287
Pakistan,14/10/2011,80,0,1,0,29,22,0,132
Pakistan,15/10/2011,95,0,1,0,33,12,0,141
Pakistan,16/10/2011,145,0,1,0,7,10,0,163
Pakistan,17/10/2011,164,2,1,0,42,20,0,229
Pakistan,18/10/2011,105,0,0,0,44,0,0,149
Pakistan,19/10/2011,71,0,0,0,25,11,0,107
Pakistan,20/10/2011,139,0,2,0,64,4,0,209
Pakistan,21/10/2011,125,2,0,0,56,5,0,188
Pakistan,22/10/2011,92,0,1,0,34,5,0,132
Pakistan,23/10/2011,76,0,-6,0,10,9,0,89
Pakistan,24/10/2011,47,2,0,0,22,5,0,76
Pakistan,25/10/2011,132,2,4,0,33,0,0,171
Pakistan,26/10/2011,95,0,0,0,28,2,0,125
Pakistan,27/10/2011,70,0,1,0,8,11,0,90
Pakistan,28/10/2011,148,0,1,0,-3,1,0,147
Pakistan,29/10/2011,128,12,0,0,-7,21,0,154
Pakistan,30/10/2011,82,2,0,0,12,9,0,105
Pakistan,31/10/2011,96,6,2,0,23,15,0,142
Sierra Leone,02/10/2011,7,0,1,0,0,0,0,8
Sierra Leone,03/10/2011,6,0,0,0,0,0,0,6
Sierra Leone,04/10/2011,11,0,0,0,3,1,0,15
Sierra Leone,05/10/2011,-1,0,0,0,0,0,0,-1
Sierra Leone,07/10/2011,10,0,0,0,5,0,0,15
Sierra Leone,08/10/2011,0,0,0,0,0,0,0,0
Sierra Leone,09/10/2011,0,0,0,0,0,0,0,0
Sierra Leone,10/10/2011,2,0,0,0,3,2,0,7
Sierra Leone,11/10/2011,9,0,0,0,3,0,0,12
Sierra Leone,12/10/2011,0,0,0,0,0,-1,0,-1
Sierra Leone,13/10/2011,12,0,0,0,3,0,0,15
Sierra Leone,14/10/2011,0,0,0,0,3,0,0,3
Sierra Leone,15/10/2011,0,0,0,0,24,0,0,24
Sierra Leone,16/10/2011,5,0,1,0,19,0,0,25
Sierra Leone,17/10/2011,0,0,0,0,-2,0,0,-2
Sierra Leone,18/10/2011,6,0,0,0,3,0,0,9
Sierra Leone,19/10/2011,16,0,0,0,3,1,0,20
Sierra Leone,20/10/2011,0,0,0,0,0,0,0,0
Sierra Leone,21/10/2011,4,0,0,0,1,1,0,6
Sierra Leone,22/10/2011,8,0,-4,0,3,0,0,7
Sierra Leone,23/10/2011,4,0,2,0,-1,2,0,7
Sierra Leone,24/10/2011,0,0,0,0,0,2,0,2
Sierra Leone,25/10/2011,9,0,0,0,0,3,0,12
Sierra Leone,26/10/2011,1,0,0,0,0,0,0,1
Sierra Leone,27/10/2011,0,0,0,0,0,0,0,0
Sierra Leone,28/10/2011,-3,0,0,0,0,2,0,-1
Sierra Leone,29/10/2011,-5,0,0,0,0,0,0,-5
Sierra Leone,30/10/2011,-3,0,0,0,0,0,0,-3
Sierra Leone,31/10/2011,4,0,0,0,3,3,0,10
Somalia,01/10/2011,11,0,0,0,18,7,0,36
Somalia,02/10/2011,82,0,0,0,61,10,0,153
Somalia,03/10/2011,110,16,0,0,105,3,0,234
Somalia,04/10/2011,135,6,0,0,131,4,0,276
Somalia,05/10/2011,55,4,0,0,29,10,0,98
Somalia,06/10/2011,4,0,0,0,-1,0,0,3
Somalia,07/10/2011,48,6,0,0,33,4,0,91
Somalia,08/10/2011,12,0,0,0,8,2,0,22
Somalia,09/10/2011,13,0,0,0,10,2,0,25
Somalia,10/10/2011,50,2,0,0,10,1,0,63
Somalia,11/10/2011,79,0,0,0,-1,6,0,84
Somalia,12/10/2011,41,0,0,0,25,2,0,68
Somalia,13/10/2011,114,0,0,0,249,10,0,373
Somalia,14/10/2011,124,0,0,0,176,2,0,302
Somalia,15/10/2011,84,0,0,0,85,4,0,173
Somalia,16/10/2011,87,2,0,0,60,3,0,152
Somalia,17/10/2011,112,0,0,0,62,6,0,180
Somalia,18/10/2011,102,0,0,0,78,13,0,193
Somalia,19/10/2011,114,0,0,0,183,18,0,315
Somalia,20/10/2011,112,0,0,0,220,14,0,346
Somalia,21/10/2011,89,4,0,0,92,7,0,192
Somalia,22/10/2011,44,0,1,0,31,0,0,76
Somalia,23/10/2011,61,0,0,0,9,3,0,73
Somalia,24/10/2011,94,0,0,0,-8,3,0,89
Somalia,25/10/2011,122,0,0,0,115,8,0,245
Somalia,26/10/2011,76,2,0,0,93,21,0,192
Somalia,27/10/2011,143,2,0,0,60,15,0,220
Somalia,28/10/2011,203,2,0,0,97,10,0,312
Somalia,29/10/2011,117,0,-1,0,12,9,0,137
Somalia,30/10/2011,121,2,-1,0,4,4,0,130
Somalia,31/10/2011,65,4,5,0,20,3,0,97
Syria,01/10/2011,30,0,0,0,6,2,0,38
Syria,02/10/2011,73,0,-2,0,4,11,0,86
Syria,03/10/2011,104,4,0,0,24,31,0,163
Syria,04/10/2011,235,2,-5,0,88,40,0,360
Syria,05/10/2011,254,2,-3,0,30,40,0,323
Syria,06/10/2011,35,0,-1,0,3,2,0,39
Syria,07/10/2011,410,0,-24,0,39,54,0,479
Syria,08/10/2011,254,0,-13,0,43,68,0,352
Syria,09/10/2011,185,0,-6,0,29,74,0,282
Syria,10/10/2011,157,0,-2,0,29,18,0,202
Syria,11/10/2011,235,0,1,0,50,21,0,307
Syria,12/10/2011,124,0,-2,0,98,18,0,238
Syria,13/10/2011,168,0,-6,0,22,33,0,217
Syria,14/10/2011,205,0,0,0,39,28,0,272
Syria,15/10/2011,123,0,-4,0,16,26,0,161
Syria,16/10/2011,83,0,0,0,2,10,0,95
Syria,17/10/2011,164,0,1,0,12,26,0,203
Syria,18/10/2011,477,6,-23,0,186,72,0,718
Syria,19/10/2011,569,22,-16,0,246,122,0,943
Syria,20/10/2011,167,0,-4,0,21,10,0,194
Syria,21/10/2011,278,0,-6,0,15,14,0,301
Syria,22/10/2011,141,0,-2,0,20,21,0,180
Syria,23/10/2011,156,0,-10,0,6,22,0,174
Syria,24/10/2011,160,0,0,0,11,17,0,188
Syria,25/10/2011,65,0,0,0,3,11,0,79
Syria,26/10/2011,57,0,-4,0,1,14,0,68
Syria,27/10/2011,95,0,2,0,-7,24,0,114
Syria,28/10/2011,100,0,4,0,25,16,0,145
Syria,29/10/2011,145,0,-4,0,51,12,0,204
Syria,30/10/2011,82,0,0,0,17,13,0,112
Syria,31/10/2011,145,0,3,0,10,12,0,170
Yemen,01/10/2011,45,0,0,0,0,2,0,47
Yemen,02/10/2011,212,0,-8,0,36,7,0,247
Yemen,03/10/2011,114,6,-4,0,24,14,0,154
Yemen,04/10/2011,165,0,0,0,40,4,0,209
Yemen,05/10/2011,29,0,0,0,5,0,0,34
Yemen,06/10/2011,20,0,0,0,0,0,0,20
Yemen,07/10/2011,147,0,5,0,13,17,0,182
Yemen,08/10/2011,71,0,-14,0,3,9,0,69
Yemen,09/10/2011,73,0,-13,0,22,8,0,90
Yemen,10/10/2011,22,0,-4,0,13,5,0,36
Yemen,11/10/2011,67,4,-2,0,15,14,0,98
Yemen,12/10/2011,140,2,-2,0,38,17,0,195
Yemen,13/10/2011,86,0,-8,0,37,9,0,124
Yemen,14/10/2011,18,0,-2,0,3,7,0,26
Yemen,15/10/2011,87,0,0,0,0,3,0,90
Yemen,16/10/2011,116,0,-6,0,17,9,0,136
Yemen,17/10/2011,44,0,0,0,0,6,0,50
Yemen,18/10/2011,62,0,-6,0,-1,2,0,57
Yemen,19/10/2011,58,0,-7,0,7,9,0,67
Yemen,20/10/2011,33,0,-16,0,10,13,0,40
Yemen,21/10/2011,102,0,-12,0,15,8,0,113
Yemen,22/10/2011,123,0,-16,0,-3,8,0,112
Yemen,23/10/2011,28,2,0,0,0,7,0,37
Yemen,24/10/2011,42,0,0,0,27,6,0,75
Yemen,25/10/2011,13,0,-5,0,9,3,0,20
Yemen,26/10/2011,15,0,-6,0,14,7,0,30
Yemen,27/10/2011,24,0,0,0,28,10,0,62
Yemen,28/10/2011,8,0,2,0,6,25,0,41
Yemen,29/10/2011,22,0,0,0,27,13,0,62
Yemen,30/10/2011,57,0,0,0,24,7,0,88
Yemen,31/10/2011,18,0,0,0,-2,0,0,16
Afghanistan,01/04/2011,318,0,-2,0,47,31,0,394
Afghanistan,02/04/2011,217,0,2,0,20,47,0,286
Afghanistan,03/04/2011,221,0,0,0,91,57,0,369
Afghanistan,04/04/2011,252,0,-2,0,78,42,0,370
Afghanistan,05/04/2011,216,0,-13,0,26,24,0,253
Afghanistan,06/04/2011,188,0,-3,0,31,28,0,244
Afghanistan,07/04/2011,275,4,-2,0,23,50,0,350
Afghanistan,08/04/2011,310,6,-4,0,-11,27,0,328
Afghanistan,09/04/2011,189,6,-2,0,30,17,0,240
Afghanistan,10/04/2011,138,2,-2,0,33,10,0,181
Afghanistan,11/04/2011,181,4,0,0,10,6,0,201
Afghanistan,12/04/2011,198,6,0,0,39,14,0,257
Afghanistan,13/04/2011,221,2,0,0,24,45,0,292
Afghanistan,14/04/2011,171,0,0,0,16,24,0,211
Afghanistan,15/04/2011,178,0,1,0,21,39,0,239
Afghanistan,16/04/2011,246,4,-1,0,-3,43,0,289
Afghanistan,17/04/2011,156,2,0,0,14,24,0,196
Afghanistan,18/04/2011,234,2,4,0,42,37,0,319
Afghanistan,19/04/2011,229,2,1,0,93,37,0,362
Afghanistan,20/04/2011,460,2,-4,0,60,33,0,551
Afghanistan,21/04/2011,342,6,-1,0,43,31,0,421
Afghanistan,22/04/2011,390,0,0,0,45,45,0,480
Afghanistan,23/04/2011,302,0,5,0,57,40,0,404
Afghanistan,24/04/2011,159,0,-1,0,51,28,0,237
Afghanistan,25/04/2011,264,8,2,0,110,24,0,408
Afghanistan,26/04/2011,343,2,4,0,110,20,0,479
Afghanistan,27/04/2011,290,0,-11,0,94,15,0,388
Afghanistan,28/04/2011,671,4,-22,0,299,85,0,1037
Afghanistan,29/04/2011,341,6,1,0,99,40,0,487
Afghanistan,30/04/2011,253,0,3,0,52,17,0,325
Albania,01/04/2011,20,0,-2,0,0,0,0,18
Albania,02/04/2011,1,0,0,0,0,0,0,1
Albania,03/04/2011,5,0,0,0,3,0,0,8
Albania,04/04/2011,2,0,3,0,0,0,0,5
Albania,05/04/2011,1,0,0,0,7,2,0,10
Albania,06/04/2011,15,0,0,0,-2,0,0,13
Albania,07/04/2011,-3,0,2,0,30,0,0,29
Albania,08/04/2011,1,0,3,0,1,0,0,5
Albania,09/04/2011,-1,0,0,0,3,0,0,2
Albania,10/04/2011,3,0,0,0,0,0,0,3
Albania,11/04/2011,7,0,0,0,0,0,0,7
Albania,12/04/2011,12,0,0,0,0,0,0,12
Albania,13/04/2011,7,0,0,0,-2,0,0,5
Albania,14/04/2011,9,0,0,0,1,2,0,12
Albania,15/04/2011,8,0,0,0,-1,4,0,11
Albania,17/04/2011,3,0,-4,0,6,0,0,5
Albania,18/04/2011,12,0,0,0,6,0,0,18
Albania,19/04/2011,7,0,0,0,3,0,0,10
Albania,20/04/2011,3,0,0,0,29,3,0,35
Albania,21/04/2011,5,0,0,0,3,0,0,8
Albania,22/04/2011,9,0,0,0,0,0,0,9
Albania,23/04/2011,0,0,-1,0,0,0,0,-1
Albania,24/04/2011,5,0,0,0,3,0,0,8
Albania,25/04/2011,5,0,0,0,9,0,0,14
Albania,26/04/2011,9,0,-3,0,6,0,0,12
Albania,27/04/2011,24,0,0,0,0,4,0,28
Albania,28/04/2011,10,0,0,0,0,0,0,10
Albania,29/04/2011,3,0,1,0,6,1,0,11
Albania,30/04/2011,0,0,0,0,0,0,0,0
Algeria,01/04/2011,15,0,0,0,3,2,0,20
Algeria,02/04/2011,0,0,0,0,0,0,0,0
Algeria,03/04/2011,3,0,0,0,9,1,0,13
Algeria,04/04/2011,36,0,2,0,6,5,0,49
Algeria,05/04/2011,10,0,1,0,3,5,0,19
Algeria,06/04/2011,23,0,0,0,-6,0,0,17
Algeria,07/04/2011,6,2,0,0,0,0,0,8
Algeria,08/04/2011,2,0,0,0,7,2,0,11
Algeria,09/04/2011,4,0,0,0,-6,6,0,4
Algeria,10/04/2011,21,0,0,0,6,0,0,27
Algeria,11/04/2011,38,0,-20,0,-2,0,0,16
Algeria,12/04/2011,28,0,-4,0,0,2,0,26
Algeria,13/04/2011,26,0,0,0,3,5,0,34
Algeria,14/04/2011,30,0,0,0,2,-1,0,31
Algeria,15/04/2011,23,0,-7,0,6,5,0,27
Algeria,16/04/2011,20,0,-13,0,3,0,0,10
Algeria,17/04/2011,30,0,-3,0,6,3,0,36
Algeria,18/04/2011,15,0,-2,0,-6,5,0,12
Algeria,19/04/2011,7,0,0,0,1,0,0,8
Algeria,20/04/2011,5,0,0,0,3,0,0,8
Algeria,21/04/2011,19,0,0,0,12,0,0,31
Algeria,22/04/2011,12,0,0,0,3,0,0,15
Algeria,23/04/2011,12,0,0,0,0,2,0,14
Algeria,24/04/2011,-1,0,0,0,0,0,0,-1
Algeria,25/04/2011,11,0,0,0,3,0,0,14
Algeria,26/04/2011,18,0,-1,0,9,0,0,26
Algeria,27/04/2011,10,2,0,0,7,0,0,19
Algeria,28/04/2011,6,0,0,0,21,2,0,29
Algeria,29/04/2011,39,0,0,0,11,0,0,50
Algeria,30/04/2011,15,0,-2,0,0,0,0,13
Bangladesh,01/04/2011,9,0,1,0,8,7,0,25
Bangladesh,02/04/2011,22,0,0,0,6,6,0,34
Bangladesh,03/04/2011,64,0,0,0,12,15,0,91
Bangladesh,04/04/2011,17,0,0,0,6,7,0,30
Bangladesh,05/04/2011,72,0,15,0,-1,4,0,90
Bangladesh,06/04/2011,18,0,0,0,3,4,0,25
Bangladesh,07/04/2011,17,0,0,0,0,3,0,20
Bangladesh,08/04/2011,16,0,0,0,15,5,0,36
Bangladesh,09/04/2011,16,0,0,0,0,0,0,16
Bangladesh,10/04/2011,8,0,0,0,7,1,0,16
Bangladesh,11/04/2011,11,0,0,0,10,3,0,24
Bangladesh,12/04/2011,37,0,0,0,18,5,0,60
Bangladesh,13/04/2011,16,0,0,0,0,3,0,19
Bangladesh,14/04/2011,15,0,0,0,3,7,0,25
Bangladesh,15/04/2011,60,0,0,0,10,3,0,73
Bangladesh,16/04/2011,50,2,0,0,15,11,0,78
Bangladesh,17/04/2011,53,4,0,0,9,2,0,68
Bangladesh,18/04/2011,22,0,0,0,-2,3,0,23
Bangladesh,19/04/2011,14,0,0,0,-1,6,0,19
Bangladesh,20/04/2011,15,0,1,0,2,6,0,24
Bangladesh,21/04/2011,24,0,0,0,4,0,0,28
Bangladesh,22/04/2011,28,0,0,0,7,2,0,37
Bangladesh,23/04/2011,36,0,0,0,6,1,0,43
Bangladesh,24/04/2011,6,0,0,0,15,0,0,21
Bangladesh,25/04/2011,19,0,1,0,-7,2,0,15
Bangladesh,26/04/2011,24,2,1,0,4,2,0,33
Bangladesh,27/04/2011,14,0,0,0,6,2,0,22
Bangladesh,28/04/2011,28,2,0,0,20,0,0,50
Bangladesh,29/04/2011,14,0,0,0,6,1,0,21
Bangladesh,30/04/2011,11,0,-2,0,-4,0,0,5
Cameroon,01/04/2011,0,2,0,0,-4,0,0,-2
Cameroon,02/04/2011,2,0,0,0,0,0,0,2
Cameroon,04/04/2011,0,0,0,0,0,0,0,0
Cameroon,05/04/2011,1,0,0,0,7,0,0,8
Cameroon,06/04/2011,12,0,0,0,-1,0,0,11
Cameroon,07/04/2011,12,0,0,0,-2,0,0,10
Cameroon,08/04/2011,0,0,0,0,-2,0,0,-2
Cameroon,10/04/2011,5,0,0,0,-2,0,0,3
Cameroon,11/04/2011,5,0,0,0,-2,0,0,3
Cameroon,12/04/2011,5,0,0,0,-2,0,0,3
Cameroon,13/04/2011,0,0,0,0,-2,0,0,-2
Cameroon,14/04/2011,5,0,0,0,-2,0,0,3
Cameroon,15/04/2011,0,0,0,0,3,0,0,3
Cameroon,16/04/2011,0,0,0,0,3,0,0,3
Cameroon,17/04/2011,0,0,0,0,0,1,0,1
Cameroon,18/04/2011,0,0,0,0,0,0,0,0
Cameroon,19/04/2011,1,0,0,0,0,1,0,2
Cameroon,20/04/2011,3,0,0,0,-1,0,0,2
Cameroon,21/04/2011,0,0,0,0,0,0,0,0
Cameroon,22/04/2011,-1,0,0,0,0,0,0,-1
Cameroon,23/04/2011,0,0,0,0,0,0,0,0
Cameroon,25/04/2011,0,6,0,0,7,0,0,13
Cameroon,26/04/2011,0,0,0,0,0,0,0,0
Cameroon,27/04/2011,0,0,0,0,0,0,0,0
Cameroon,28/04/2011,0,0,0,0,0,0,0,0
Cameroon,29/04/2011,0,0,0,0,0,0,0,0
Cameroon,30/04/2011,6,0,0,0,0,0,0,6
China,01/04/2011,141,6,-5,0,94,13,0,249
China,02/04/2011,110,0,-1,0,57,10,0,176
China,03/04/2011,86,4,-4,0,35,8,0,129
China,04/04/2011,215,8,-1,0,58,34,0,314
China,05/04/2011,121,2,-5,0,82,26,0,226
China,06/04/2011,132,2,1,0,131,19,0,285
China,07/04/2011,167,2,3,0,48,17,0,237
China,08/04/2011,145,0,-2,0,18,10,0,171
China,09/04/2011,81,2,0,0,48,30,0,161
China,10/04/2011,99,6,0,0,-10,12,0,107
China,11/04/2011,153,0,-4,0,12,16,0,177
China,12/04/2011,115,4,-5,0,91,25,0,230
China,13/04/2011,147,2,-4,0,115,20,0,280
China,14/04/2011,142,0,-4,0,79,18,0,235
China,15/04/2011,147,2,2,0,55,6,0,212
China,16/04/2011,75,4,-4,0,34,15,0,124
China,17/04/2011,81,2,-4,0,40,6,0,125
China,18/04/2011,149,8,2,0,90,8,0,257
China,19/04/2011,192,4,-6,0,83,21,0,294
China,20/04/2011,123,0,5,0,43,9,0,180
China,21/04/2011,125,0,0,0,26,9,0,160
China,22/04/2011,105,8,-4,0,48,20,0,177
China,23/04/2011,77,0,-4,0,22,4,0,99
China,24/04/2011,57,0,-2,0,35,11,0,101
China,25/04/2011,89,2,-2,0,41,14,0,144
China,26/04/2011,138,1,1,0,76,16,0,232
China,27/04/2011,140,0,4,0,52,19,0,215
China,28/04/2011,94,0,0,0,93,16,0,203
China,29/04/2011,187,11,-7,0,66,23,0,280
China,30/04/2011,120,2,-6,0,10,24,0,150
Egypt,01/04/2011,89,0,-3,0,84,8,0,178
Egypt,02/04/2011,54,0,-5,0,21,8,0,78
Egypt,03/04/2011,71,0,-2,0,17,14,0,100
Egypt,04/04/2011,58,2,-10,0,20,21,0,91
Egypt,05/04/2011,106,10,-6,0,39,29,0,178
Egypt,06/04/2011,151,2,-5,0,63,48,0,259
Egypt,07/04/2011,120,0,-19,0,68,25,0,194
Egypt,08/04/2011,143,2,-3,0,61,37,0,240
Egypt,09/04/2011,182,2,-6,0,52,36,0,266
Egypt,10/04/2011,149,0,-10,0,91,54,0,284
Egypt,11/04/2011,108,0,0,0,130,37,0,275
Egypt,12/04/2011,79,2,-16,0,179,10,0,254
Egypt,13/04/2011,107,0,-18,0,103,23,0,215
Egypt,14/04/2011,146,2,-18,0,103,22,0,255
Egypt,15/04/2011,104,6,-5,0,88,45,0,238
Egypt,16/04/2011,79,4,4,0,77,17,0,181
Egypt,17/04/2011,91,0,-5,0,74,19,0,179
Egypt,18/04/2011,120,2,-9,0,43,33,0,189
Egypt,19/04/2011,126,2,-19,0,50,32,0,191
Egypt,20/04/2011,100,2,-16,0,55,19,0,160
Egypt,21/04/2011,73,0,-10,0,56,33,0,152
Egypt,22/04/2011,66,0,2,0,71,13,0,152
Egypt,23/04/2011,56,4,-10,0,36,3,0,89
Egypt,24/04/2011,76,0,-13,0,63,12,0,138
Egypt,25/04/2011,119,0,-5,0,80,20,0,214
Egypt,26/04/2011,118,2,-3,0,83,19,0,219
Egypt,27/04/2011,74,4,-12,0,22,11,0,99
Egypt,28/04/2011,58,2,-6,0,-7,22,0,69
Egypt,29/04/2011,59,0,-6,0,21,14,0,88
Egypt,30/04/2011,90,2,-2,0,44,17,0,151
Eritrea,01/04/2011,0,0,0,0,3,0,0,3
Eritrea,03/04/2011,6,0,0,0,0,0,0,6
Eritrea,04/04/2011,6,0,0,0,6,0,0,12
Eritrea,05/04/2011,5,0,0,0,0,0,0,5
Eritrea,06/04/2011,1,0,-1,0,0,0,0,0
Eritrea,07/04/2011,5,0,0,0,0,0,0,5
Eritrea,08/04/2011,0,0,0,0,-2,0,0,-2
Eritrea,09/04/2011,0,0,0,0,0,0,0,0
Eritrea,10/04/2011,3,0,0,0,0,0,0,3
Eritrea,11/04/2011,6,0,1,0,1,2,0,10
Eritrea,12/04/2011,8,0,0,0,6,14,0,28
Eritrea,13/04/2011,10,0,0,0,9,0,0,19
Eritrea,14/04/2011,3,0,0,0,0,0,0,3
Eritrea,15/04/2011,0,0,0,0,0,0,0,0
Eritrea,16/04/2011,0,0,0,0,0,0,0,0
Eritrea,17/04/2011,0,0,0,0,0,0,0,0
Eritrea,18/04/2011,0,0,0,0,0,0,0,0
Eritrea,19/04/2011,0,0,0,0,0,0,0,0
Eritrea,20/04/2011,8,0,0,0,6,10,0,24
Eritrea,21/04/2011,5,0,0,0,9,0,0,14
Eritrea,22/04/2011,3,0,0,0,3,0,0,6
Eritrea,23/04/2011,0,0,0,0,-4,2,0,-2
Eritrea,24/04/2011,1,0,0,0,0,0,0,1
Eritrea,26/04/2011,0,0,0,0,0,0,0,0
Eritrea,27/04/2011,0,0,0,0,-2,0,0,-2
Eritrea,28/04/2011,0,0,0,0,0,0,0,0
Eritrea,29/04/2011,3,0,0,0,0,0,0,3
Eritrea,30/04/2011,-1,0,0,0,9,0,0,8
Georgia,01/04/2011,56,2,-2,0,-8,5,0,53
Georgia,02/04/2011,14,2,0,0,6,0,0,22
Georgia,03/04/2011,5,0,0,0,15,1,0,21
Georgia,04/04/2011,40,4,0,0,30,5,0,79
Georgia,05/04/2011,51,4,0,0,71,13,0,139
Georgia,06/04/2011,22,0,2,0,27,6,0,57
Georgia,07/04/2011,58,4,0,0,18,2,0,82
Georgia,08/04/2011,62,0,0,0,24,3,0,89
Georgia,09/04/2011,7,0,0,0,6,4,0,17
Georgia,10/04/2011,20,2,-2,0,21,3,0,44
Georgia,11/04/2011,43,10,0,0,18,14,0,85
Georgia,12/04/2011,26,2,-7,0,6,7,0,34
Georgia,13/04/2011,26,0,-4,0,28,7,0,57
Georgia,14/04/2011,48,4,1,0,5,4,0,62
Georgia,15/04/2011,35,2,-4,0,33,1,0,67
Georgia,16/04/2011,24,0,-4,0,1,3,0,24
Georgia,17/04/2011,29,0,0,0,11,1,0,41
Georgia,18/04/2011,60,4,0,0,31,7,0,102
Georgia,19/04/2011,36,0,1,0,6,7,0,50
Georgia,20/04/2011,39,0,0,0,36,6,0,81
Georgia,21/04/2011,7,0,0,0,11,7,0,25
Georgia,22/04/2011,47,4,1,0,28,1,0,81
Georgia,23/04/2011,18,0,0,0,3,2,0,23
Georgia,24/04/2011,5,4,0,0,-4,2,0,7
Georgia,25/04/2011,11,2,0,0,14,5,0,32
Georgia,26/04/2011,26,2,-6,0,17,9,0,48
Georgia,27/04/2011,65,2,-6,0,29,4,0,94
Georgia,28/04/2011,47,4,1,0,26,7,0,85
Georgia,29/04/2011,47,2,1,0,51,10,0,111
Georgia,30/04/2011,22,0,0,0,18,1,0,41
India,01/04/2011,71,2,-10,0,7,4,0,74
India,02/04/2011,23,2,-2,0,15,5,0,43
India,03/04/2011,47,2,-2,0,17,4,0,68
India,04/04/2011,42,4,-4,0,20,12,0,74
India,05/04/2011,95,0,3,0,24,9,0,131
India,06/04/2011,76,6,-1,0,20,10,0,111
India,07/04/2011,58,10,-7,0,-5,24,0,80
India,08/04/2011,77,0,-2,0,9,11,0,95
India,09/04/2011,74,2,0,0,13,9,0,98
India,10/04/2011,25,4,0,0,25,5,0,59
India,11/04/2011,50,2,-7,0,13,15,0,73
India,12/04/2011,50,4,-3,0,8,4,0,63
India,13/04/2011,59,4,-1,0,12,16,0,90
India,14/04/2011,62,0,-2,0,7,4,0,71
India,15/04/2011,77,2,-2,0,22,7,0,106
India,16/04/2011,56,0,0,0,3,8,0,67
India,17/04/2011,54,0,0,0,31,2,0,87
India,18/04/2011,61,2,-4,0,16,9,0,84
India,19/04/2011,77,0,-14,0,30,10,0,103
India,20/04/2011,67,2,-7,0,10,8,0,80
India,21/04/2011,51,2,-4,0,11,9,0,69
India,22/04/2011,75,0,-3,0,27,28,0,127
India,23/04/2011,41,0,1,0,15,3,0,60
India,24/04/2011,35,2,0,0,17,1,0,55
India,25/04/2011,33,0,-1,0,15,6,0,53
India,26/04/2011,70,0,-2,0,23,9,0,100
India,27/04/2011,78,0,-4,0,10,15,0,99
India,28/04/2011,33,0,0,0,-1,5,0,37
India,29/04/2011,98,0,-8,0,27,5,0,122
India,30/04/2011,63,0,-2,0,23,4,0,88
Iran,01/04/2011,74,0,0,0,68,13,0,155
Iran,02/04/2011,101,0,-8,0,4,2,0,99
Iran,03/04/2011,55,0,-3,0,31,26,0,109
Iran,04/04/2011,65,0,-1,0,44,9,0,117
Iran,05/04/2011,28,0,0,0,30,9,0,67
Iran,06/04/2011,69,4,0,0,17,12,0,102
Iran,07/04/2011,106,0,-8,0,32,25,0,155
Iran,08/04/2011,199,0,3,0,28,17,0,247
Iran,09/04/2011,78,0,0,0,21,2,0,101
Iran,10/04/2011,115,0,2,0,18,15,0,150
Iran,11/04/2011,138,0,0,0,44,13,0,195
Iran,12/04/2011,81,0,-1,0,70,17,0,167
Iran,13/04/2011,64,0,0,0,44,8,0,116
Iran,14/04/2011,117,0,1,0,47,7,0,172
Iran,15/04/2011,212,2,1,0,57,9,0,281
Iran,16/04/2011,41,0,0,0,25,8,0,74
Iran,17/04/2011,33,0,-37,0,-3,0,0,-7
Iran,18/04/2011,141,0,-10,0,83,10,0,224
Iran,19/04/2011,91,4,2,0,40,5,0,142
Iran,20/04/2011,80,2,-4,0,66,22,0,166
Iran,21/04/2011,68,0,-3,0,49,9,0,123
Iran,22/04/2011,101,2,-6,0,50,23,0,170
Iran,23/04/2011,66,4,-4,0,9,10,0,85
Iran,24/04/2011,89,0,-8,0,15,11,0,107
Iran,25/04/2011,90,10,-1,0,16,15,0,130
Iran,26/04/2011,131,8,-3,0,19,17,0,172
Iran,27/04/2011,99,0,-20,0,35,3,0,117
Iran,28/04/2011,65,0,-2,0,11,21,0,95
Iran,29/04/2011,78,0,1,0,28,12,0,119
Iran,30/04/2011,64,0,-2,0,34,14,0,110
Iraq,01/04/2011,126,0,1,0,11,8,0,146
Iraq,02/04/2011,109,0,-7,0,14,10,0,126
Iraq,03/04/2011,143,0,0,0,4,13,0,160
Iraq,04/04/2011,236,0,1,0,32,8,0,277
Iraq,05/04/2011,120,0,-3,0,33,14,0,164
Iraq,06/04/2011,119,2,-2,0,29,16,0,164
Iraq,07/04/2011,94,6,-3,0,13,20,0,130
Iraq,08/04/2011,203,2,1,0,55,24,0,285
Iraq,09/04/2011,124,0,-1,0,13,17,0,153
Iraq,10/04/2011,68,0,1,0,42,11,0,122
Iraq,11/04/2011,169,0,0,0,74,21,0,264
Iraq,12/04/2011,148,0,1,0,31,14,0,194
Iraq,13/04/2011,88,2,-1,0,34,22,0,145
Iraq,14/04/2011,172,0,0,0,46,14,0,232
Iraq,15/04/2011,148,2,-2,0,115,32,0,295
Iraq,16/04/2011,92,6,-8,0,68,9,0,167
Iraq,17/04/2011,66,2,-1,0,26,21,0,114
Iraq,18/04/2011,101,4,-9,0,42,32,0,170
Iraq,19/04/2011,169,0,2,0,28,24,0,223
Iraq,20/04/2011,146,0,4,0,28,24,0,202
Iraq,21/04/2011,114,6,0,0,40,17,0,177
Iraq,22/04/2011,123,0,0,0,25,30,0,178
Iraq,23/04/2011,111,0,5,0,30,21,0,167
Iraq,24/04/2011,105,0,0,0,20,14,0,139
Iraq,25/04/2011,141,0,2,0,15,17,0,175
Iraq,26/04/2011,123,0,3,0,40,10,0,176
Iraq,27/04/2011,158,0,-3,0,20,9,0,184
Iraq,28/04/2011,77,2,-6,0,33,16,0,122
Iraq,29/04/2011,107,2,1,0,55,17,0,182
Iraq,30/04/2011,119,0,1,0,-4,19,0,135
Morocco,01/04/2011,12,0,0,0,3,0,0,15
Morocco,02/04/2011,7,0,0,0,3,1,0,11
Morocco,03/04/2011,5,0,0,0,-2,6,0,9
Morocco,04/04/2011,15,0,0,0,-2,2,0,15
Morocco,05/04/2011,3,0,1,0,0,2,0,6
Morocco,06/04/2011,4,0,0,0,6,1,0,11
Morocco,07/04/2011,6,0,0,0,-3,1,0,4
Morocco,08/04/2011,17,0,-8,0,-8,3,0,4
Morocco,09/04/2011,5,0,0,0,9,2,0,16
Morocco,10/04/2011,4,0,0,0,4,5,0,13
Morocco,11/04/2011,15,0,-1,0,19,1,0,34
Morocco,12/04/2011,9,0,0,0,3,1,0,13
Morocco,13/04/2011,5,2,0,0,3,0,0,10
Morocco,14/04/2011,10,0,0,0,-1,2,0,11
Morocco,15/04/2011,0,0,-2,0,4,0,0,2
Morocco,16/04/2011,1,0,-4,0,1,0,0,-2
Morocco,17/04/2011,6,0,-4,0,-2,1,0,1
Morocco,18/04/2011,1,0,0,0,6,1,0,8
Morocco,19/04/2011,6,0,-1,0,1,1,0,7
Morocco,20/04/2011,14,0,0,0,0,3,0,17
Morocco,21/04/2011,12,0,0,0,0,0,0,12
Morocco,22/04/2011,11,0,0,0,0,0,0,11
Morocco,23/04/2011,3,0,-2,0,-4,1,0,-2
Morocco,24/04/2011,10,0,0,0,3,8,0,21
Morocco,25/04/2011,22,0,1,0,0,3,0,26
Morocco,26/04/2011,4,0,-4,0,4,4,0,8
Morocco,27/04/2011,5,0,-2,0,1,2,0,6
Morocco,28/04/2011,191,0,0,0,-2,3,0,192
Morocco,29/04/2011,202,0,0,0,38,24,0,264
Morocco,30/04/2011,36,0,0,0,47,16,0,99
Nigeria,01/04/2011,36,2,-3,0,2,5,0,42
Nigeria,02/04/2011,41,6,-14,0,15,2,0,50
Nigeria,03/04/2011,30,2,-2,0,6,6,0,42
Nigeria,04/04/2011,16,0,-1,0,-7,7,0,15
Nigeria,05/04/2011,39,2,-6,0,24,3,0,62
Nigeria,06/04/2011,36,0,1,0,7,2,0,46
Nigeria,07/04/2011,52,0,-5,0,15,3,0,65
Nigeria,08/04/2011,42,0,1,0,4,4,0,51
Nigeria,09/04/2011,17,0,0,0,3,8,0,28
Nigeria,10/04/2011,33,0,0,0,18,1,0,52
Nigeria,11/04/2011,15,0,0,0,1,1,0,17
Nigeria,12/04/2011,24,0,0,0,3,3,0,30
Nigeria,13/04/2011,8,0,0,0,6,4,0,18
Nigeria,14/04/2011,34,0,-5,0,18,1,0,48
Nigeria,15/04/2011,22,0,0,0,31,1,0,54
Nigeria,16/04/2011,29,0,1,0,16,0,0,46
Nigeria,17/04/2011,9,0,1,0,10,4,0,24
Nigeria,18/04/2011,31,0,6,0,15,9,0,61
Nigeria,19/04/2011,28,0,4,0,0,2,0,34
Nigeria,20/04/2011,62,0,0,0,31,2,0,95
Nigeria,21/04/2011,67,0,1,0,22,6,0,96
Nigeria,22/04/2011,20,0,0,0,12,2,0,34
Nigeria,23/04/2011,22,0,0,0,21,6,0,49
Nigeria,24/04/2011,21,4,0,0,9,3,0,37
Nigeria,25/04/2011,28,0,0,0,3,4,0,35
Nigeria,26/04/2011,14,2,0,0,17,16,0,49
Nigeria,27/04/2011,15,0,0,0,3,13,0,31
Nigeria,28/04/2011,10,0,0,0,7,3,0,20
Nigeria,29/04/2011,20,2,0,0,13,9,0,44
Nigeria,30/04/2011,11,0,0,0,0,1,0,12
Pakistan,01/04/2011,90,0,-2,0,35,20,0,143
Pakistan,02/04/2011,39,4,0,0,31,10,0,84
Pakistan,03/04/2011,33,0,0,0,25,13,0,71
Pakistan,04/04/2011,48,0,0,0,77,3,0,128
Pakistan,05/04/2011,77,0,0,0,48,5,0,130
Pakistan,06/04/2011,80,0,0,0,35,10,0,125
Pakistan,07/04/2011,146,6,0,0,42,52,0,246
Pakistan,08/04/2011,91,0,-4,0,25,18,0,130
Pakistan,09/04/2011,49,0,2,0,15,9,0,75
Pakistan,10/04/2011,57,2,1,0,9,9,0,78
Pakistan,11/04/2011,71,0,0,0,4,4,0,79
Pakistan,12/04/2011,172,0,-4,0,49,15,0,232
Pakistan,13/04/2011,143,0,-2,0,61,13,0,215
Pakistan,14/04/2011,137,0,-6,0,22,38,0,191
Pakistan,15/04/2011,105,0,-2,0,35,14,0,152
Pakistan,16/04/2011,85,0,0,0,11,21,0,117
Pakistan,17/04/2011,111,0,0,0,-3,5,0,113
Pakistan,18/04/2011,85,0,1,0,44,7,0,137
Pakistan,19/04/2011,82,6,0,0,27,11,0,126
Pakistan,20/04/2011,42,2,-6,0,7,0,0,45
Pakistan,21/04/2011,104,0,1,0,19,30,0,154
Pakistan,22/04/2011,142,6,1,0,50,14,0,213
Pakistan,23/04/2011,102,4,2,0,31,22,0,161
Pakistan,24/04/2011,46,2,3,0,17,11,0,79
Pakistan,25/04/2011,121,2,1,0,89,10,0,223
Pakistan,26/04/2011,95,0,0,0,91,16,0,202
Pakistan,27/04/2011,77,0,0,0,33,7,0,117
Pakistan,28/04/2011,90,0,-8,0,-6,6,0,82
Pakistan,29/04/2011,61,0,1,0,30,8,0,100
Pakistan,30/04/2011,39,0,1,0,8,2,0,50
Sierra Leone,01/04/2011,6,0,0,0,0,3,0,9
Sierra Leone,02/04/2011,0,0,0,0,0,0,0,0
Sierra Leone,03/04/2011,2,0,0,0,0,0,0,2
Sierra Leone,04/04/2011,6,0,0,0,0,0,0,6
Sierra Leone,05/04/2011,17,0,0,0,3,0,0,20
Sierra Leone,06/04/2011,4,0,0,0,0,0,0,4
Sierra Leone,07/04/2011,0,0,0,0,3,0,0,3
Sierra Leone,08/04/2011,18,0,0,0,0,0,0,18
Sierra Leone,09/04/2011,11,0,0,0,0,0,0,11
Sierra Leone,10/04/2011,0,0,0,0,0,0,0,0
Sierra Leone,11/04/2011,0,0,0,0,0,0,0,0
Sierra Leone,12/04/2011,0,0,0,0,0,0,0,0
Sierra Leone,13/04/2011,3,0,0,0,3,0,0,6
Sierra Leone,14/04/2011,-2,0,0,0,0,0,0,-2
Sierra Leone,15/04/2011,5,0,0,0,6,2,0,13
Sierra Leone,16/04/2011,1,0,0,0,-2,0,0,-1
Sierra Leone,17/04/2011,0,0,0,0,0,0,0,0
Sierra Leone,18/04/2011,1,0,0,0,3,0,0,4
Sierra Leone,19/04/2011,4,0,0,0,9,0,0,13
Sierra Leone,20/04/2011,3,0,0,0,3,1,0,7
Sierra Leone,21/04/2011,0,0,0,0,0,1,0,1
Sierra Leone,22/04/2011,0,0,0,0,0,0,0,0
Sierra Leone,23/04/2011,1,0,0,0,0,0,0,1
Sierra Leone,24/04/2011,0,0,0,0,0,0,0,0
Sierra Leone,25/04/2011,0,0,0,0,0,0,0,0
Sierra Leone,26/04/2011,1,0,0,0,0,1,0,2
Sierra Leone,27/04/2011,8,0,0,0,6,0,0,14
Sierra Leone,28/04/2011,0,0,0,0,0,0,0,0
Sierra Leone,29/04/2011,3,0,0,0,3,1,0,7
Sierra Leone,30/04/2011,3,0,0,0,3,0,0,6
Somalia,01/04/2011,64,0,0,0,5,2,0,71
Somalia,02/04/2011,47,0,0,0,27,2,0,76
Somalia,03/04/2011,31,0,0,0,2,5,0,38
Somalia,04/04/2011,50,0,1,0,4,1,0,56
Somalia,05/04/2011,64,0,1,0,30,1,0,96
Somalia,06/04/2011,42,6,0,0,23,1,0,72
Somalia,07/04/2011,39,0,0,0,40,0,0,79
Somalia,08/04/2011,13,2,0,0,-7,7,0,15
Somalia,09/04/2011,1,0,0,0,-7,0,0,-6
Somalia,10/04/2011,15,0,1,0,10,1,0,27
Somalia,11/04/2011,89,8,0,0,73,18,0,188
Somalia,12/04/2011,61,4,-2,0,12,13,0,88
Somalia,13/04/2011,91,0,-4,0,111,28,0,226
Somalia,14/04/2011,46,0,-2,0,62,9,0,115
Somalia,15/04/2011,46,0,0,0,31,0,0,77
Somalia,16/04/2011,31,0,0,0,-4,1,0,28
Somalia,17/04/2011,40,0,0,0,-32,1,0,9
Somalia,18/04/2011,23,0,0,0,-1,2,0,24
Somalia,19/04/2011,30,2,0,0,-14,0,0,18
Somalia,20/04/2011,18,0,0,0,10,7,0,35
Somalia,21/04/2011,149,0,1,0,89,15,0,254
Somalia,22/04/2011,45,0,0,0,49,0,0,94
Somalia,23/04/2011,52,0,0,0,19,2,0,73
Somalia,24/04/2011,58,0,0,0,-25,0,0,33
Somalia,25/04/2011,12,0,0,0,-3,1,0,10
Somalia,26/04/2011,12,0,0,0,-3,7,0,16
Somalia,27/04/2011,17,0,-1,0,13,7,0,36
Somalia,28/04/2011,33,0,0,0,26,0,0,59
Somalia,29/04/2011,39,0,0,0,2,2,0,43
Somalia,30/04/2011,16,0,0,0,-1,0,0,15
Syria,01/04/2011,106,0,-6,0,37,40,0,177
Syria,02/04/2011,47,0,0,0,20,8,0,75
Syria,03/04/2011,56,0,-4,0,25,8,0,85
Syria,04/04/2011,73,0,-8,0,76,8,0,149
Syria,05/04/2011,31,0,0,0,53,8,0,92
Syria,06/04/2011,37,0,1,0,38,5,0,81
Syria,07/04/2011,54,0,-8,0,23,16,0,85
Syria,08/04/2011,175,2,-7,0,49,31,0,250
Syria,09/04/2011,218,0,0,0,9,37,0,264
Syria,10/04/2011,40,0,-8,0,15,9,0,56
Syria,11/04/2011,126,0,-4,0,31,17,0,170
Syria,12/04/2011,96,0,-4,0,28,12,0,132
Syria,13/04/2011,50,0,0,0,27,24,0,101
Syria,14/04/2011,112,0,-10,0,45,15,0,162
Syria,15/04/2011,80,0,-2,0,83,29,0,190
Syria,16/04/2011,72,0,-1,0,21,28,0,120
Syria,17/04/2011,44,0,-1,0,17,13,0,73
Syria,18/04/2011,137,0,-2,0,15,31,0,181
Syria,19/04/2011,236,0,-13,0,20,25,0,268
Syria,20/04/2011,96,0,-4,0,18,15,0,125
Syria,21/04/2011,498,4,-38,0,232,82,0,778
Syria,22/04/2011,450,10,-40,0,141,93,0,654
Syria,23/04/2011,205,14,-19,0,68,29,0,297
Syria,24/04/2011,246,0,-20,0,54,36,0,316
Syria,25/04/2011,382,4,-4,0,50,35,0,467
Syria,26/04/2011,397,6,-17,0,96,44,0,526
Syria,27/04/2011,521,12,-10,0,191,75,0,789
Syria,28/04/2011,499,0,-2,0,62,38,0,597
Syria,29/04/2011,368,2,-5,0,70,80,0,515
Syria,30/04/2011,291,0,5,0,27,18,0,341
Yemen,01/04/2011,31,0,-1,0,8,11,0,49
Yemen,02/04/2011,16,0,-2,0,6,26,0,46
Yemen,03/04/2011,34,0,-2,0,-3,23,0,52
Yemen,04/04/2011,94,0,-11,0,30,30,0,143
Yemen,05/04/2011,159,2,-11,0,-7,21,0,164
Yemen,06/04/2011,347,8,1,0,97,56,0,509
Yemen,07/04/2011,37,0,-16,0,-1,8,0,28
Yemen,08/04/2011,83,0,-6,0,17,12,0,106
Yemen,09/04/2011,70,0,-2,0,0,14,0,82
Yemen,10/04/2011,76,0,-12,0,4,18,0,86
Yemen,11/04/2011,104,0,-6,0,27,6,0,131
Yemen,12/04/2011,92,0,-8,0,2,6,0,92
Yemen,13/04/2011,121,0,-8,0,48,18,0,179
Yemen,14/04/2011,66,0,-3,0,36,9,0,108
Yemen,15/04/2011,30,0,-9,0,31,7,0,59
Yemen,16/04/2011,48,0,-3,0,3,12,0,60
Yemen,17/04/2011,53,0,-5,0,5,10,0,63
Yemen,18/04/2011,43,0,-10,0,9,7,0,49
Yemen,19/04/2011,62,0,-19,0,7,21,0,71
Yemen,20/04/2011,101,0,-3,0,24,18,0,140
Yemen,21/04/2011,23,0,-18,0,12,5,0,22
Yemen,22/04/2011,16,0,-8,0,12,3,0,23
Yemen,23/04/2011,101,0,-62,0,2,22,0,63
Yemen,24/04/2011,116,0,-67,0,16,11,0,76
Yemen,25/04/2011,81,0,-32,0,22,18,0,89
Yemen,26/04/2011,71,0,-15,0,10,5,0,71
Yemen,27/04/2011,103,0,-24,0,7,11,0,97
Yemen,28/04/2011,43,0,-14,0,9,12,0,50
Yemen,29/04/2011,40,0,-1,0,5,8,0,52
Yemen,30/04/2011,122,0,-12,0,14,2,0,126
Afghanistan,01/05/2008,155,2,-4,0,59,3,0,215
Afghanistan,02/05/2008,107,0,0,0,34,10,0,151
Afghanistan,03/05/2008,88,0,0,0,4,4,0,96
Afghanistan,04/05/2008,33,0,0,0,-2,5,0,36
Afghanistan,05/05/2008,134,2,-2,0,8,6,0,148
Afghanistan,06/05/2008,111,0,0,0,24,48,0,183
Afghanistan,07/05/2008,165,0,0,0,24,9,0,198
Afghanistan,08/05/2008,105,0,1,0,41,9,0,156
Afghanistan,09/05/2008,47,0,2,0,0,0,0,49
Afghanistan,10/05/2008,1,0,0,0,-5,1,0,-3
Afghanistan,11/05/2008,87,0,-2,0,51,17,0,153
Afghanistan,12/05/2008,53,0,0,0,15,5,0,73
Afghanistan,13/05/2008,59,0,-6,0,39,2,0,94
Afghanistan,14/05/2008,132,4,0,0,6,3,0,145
Afghanistan,15/05/2008,152,0,0,0,47,25,0,224
Afghanistan,16/05/2008,149,0,-1,0,22,22,0,192
Afghanistan,17/05/2008,118,0,1,0,-23,13,0,109
Afghanistan,18/05/2008,65,0,1,0,37,4,0,107
Afghanistan,19/05/2008,85,0,2,0,37,3,0,127
Afghanistan,20/05/2008,63,0,0,0,65,19,0,147
Afghanistan,21/05/2008,115,2,-6,0,21,0,0,132
Afghanistan,22/05/2008,137,0,0,0,18,6,0,161
Afghanistan,23/05/2008,119,0,2,0,64,12,0,197
Afghanistan,24/05/2008,77,0,2,0,37,31,0,147
Afghanistan,25/05/2008,104,0,-2,0,24,32,0,158
Afghanistan,26/05/2008,92,0,1,0,23,5,0,121
Afghanistan,27/05/2008,127,2,-4,0,2,7,0,134
Afghanistan,28/05/2008,102,0,-6,0,18,14,0,128
Afghanistan,29/05/2008,67,0,-2,0,30,11,0,106
Afghanistan,30/05/2008,109,0,0,0,25,14,0,148
Afghanistan,31/05/2008,71,0,0,0,10,3,0,84
Albania,01/05/2008,9,0,-4,0,4,0,0,9
Albania,02/05/2008,11,0,0,0,-9,0,0,2
Albania,03/05/2008,0,0,0,0,12,1,0,13
Albania,04/05/2008,2,0,0,0,0,0,0,2
Albania,05/05/2008,6,0,0,0,0,0,0,6
Albania,06/05/2008,5,0,0,0,-2,0,0,3
Albania,07/05/2008,6,0,0,0,0,0,0,6
Albania,08/05/2008,3,0,0,0,-1,0,0,2
Albania,09/05/2008,0,0,0,0,-2,1,0,-1
Albania,10/05/2008,3,0,1,0,0,1,0,5
Albania,11/05/2008,9,0,-2,0,0,5,0,12
Albania,12/05/2008,0,0,-1,0,3,0,0,2
Albania,13/05/2008,41,0,2,0,13,4,0,60
Albania,14/05/2008,3,0,0,0,3,1,0,7
Albania,15/05/2008,-1,0,-2,0,0,0,0,-3
Albania,16/05/2008,5,0,0,0,0,0,0,5
Albania,17/05/2008,0,0,0,0,0,0,0,0
Albania,18/05/2008,6,0,0,0,0,0,0,6
Albania,19/05/2008,6,0,0,0,6,3,0,15
Albania,20/05/2008,9,0,0,0,0,0,0,9
Albania,21/05/2008,7,0,0,0,9,0,0,16
Albania,22/05/2008,7,0,0,0,3,5,0,15
Albania,23/05/2008,2,0,-1,0,0,0,0,1
Albania,24/05/2008,-2,0,0,0,0,0,0,-2
Albania,25/05/2008,0,0,0,0,9,0,0,9
Albania,26/05/2008,16,0,0,0,0,2,0,18
Albania,27/05/2008,1,0,0,0,21,0,0,22
Albania,28/05/2008,12,0,-4,0,1,0,0,9
Albania,29/05/2008,7,0,-6,0,5,1,0,7
Albania,30/05/2008,5,0,0,0,16,2,0,23
Albania,31/05/2008,8,0,-2,0,-2,2,0,6
Algeria,01/05/2008,6,0,0,0,0,0,0,6
Algeria,02/05/2008,10,0,0,0,0,0,0,10
Algeria,03/05/2008,2,0,0,0,0,0,0,2
Algeria,04/05/2008,0,0,0,0,0,0,0,0
Algeria,05/05/2008,2,0,0,0,0,0,0,2
Algeria,06/05/2008,0,0,0,0,0,0,0,0
Algeria,07/05/2008,0,0,0,0,3,0,0,3
Algeria,08/05/2008,15,0,0,0,17,0,0,32
Algeria,09/05/2008,0,0,0,0,0,0,0,0
Algeria,10/05/2008,2,0,0,0,0,13,0,15
Algeria,11/05/2008,0,0,0,0,3,4,0,7
Algeria,12/05/2008,0,0,0,0,0,0,0,0
Algeria,13/05/2008,0,0,0,0,0,4,0,4
Algeria,14/05/2008,0,0,0,0,57,4,0,61
Algeria,15/05/2008,1,0,0,0,25,0,0,26
Algeria,16/05/2008,0,0,-2,0,6,0,0,4
Algeria,17/05/2008,1,0,-1,0,6,0,0,6
Algeria,18/05/2008,12,0,0,0,0,1,0,13
Algeria,19/05/2008,16,0,0,0,30,1,0,47
Algeria,20/05/2008,2,0,-2,0,0,1,0,1
Algeria,21/05/2008,5,0,0,0,5,2,0,12
Algeria,22/05/2008,6,0,0,0,0,0,0,6
Algeria,23/05/2008,5,0,0,0,0,0,0,5
Algeria,24/05/2008,7,0,0,0,0,0,0,7
Algeria,25/05/2008,18,0,0,0,9,4,0,31
Algeria,26/05/2008,0,0,0,0,0,0,0,0
Algeria,27/05/2008,11,0,0,0,0,0,0,11
Algeria,28/05/2008,4,0,0,0,1,0,0,5
Algeria,29/05/2008,2,0,0,0,9,0,0,11
Algeria,30/05/2008,4,0,0,0,29,0,0,33
Algeria,31/05/2008,6,0,0,0,3,0,0,9
Bangladesh,01/05/2008,-1,0,-2,0,3,0,0,0
Bangladesh,02/05/2008,24,0,0,0,0,9,0,33
Bangladesh,03/05/2008,1,0,0,0,0,0,0,1
Bangladesh,04/05/2008,1,0,0,0,0,0,0,1
Bangladesh,05/05/2008,15,0,0,0,4,1,0,20
Bangladesh,06/05/2008,7,0,0,0,4,0,0,11
Bangladesh,07/05/2008,7,0,0,0,15,1,0,23
Bangladesh,08/05/2008,10,0,0,0,-2,0,0,8
Bangladesh,09/05/2008,6,0,0,0,0,0,0,6
Bangladesh,10/05/2008,6,0,0,0,0,0,0,6
Bangladesh,11/05/2008,7,0,0,0,-4,0,0,3
Bangladesh,12/05/2008,5,0,0,0,5,0,0,10
Bangladesh,13/05/2008,2,0,0,0,6,2,0,10
Bangladesh,14/05/2008,15,0,0,0,6,1,0,22
Bangladesh,15/05/2008,4,0,0,0,8,4,0,16
Bangladesh,16/05/2008,18,2,0,0,13,11,0,44
Bangladesh,17/05/2008,24,0,0,0,14,0,0,38
Bangladesh,18/05/2008,5,2,0,0,18,0,0,25
Bangladesh,19/05/2008,14,0,0,0,33,0,0,47
Bangladesh,20/05/2008,15,0,-1,0,27,5,0,46
Bangladesh,21/05/2008,7,0,0,0,21,4,0,32
Bangladesh,22/05/2008,6,0,0,0,0,0,0,6
Bangladesh,23/05/2008,6,0,0,0,2,5,0,13
Bangladesh,24/05/2008,6,0,0,0,10,2,0,18
Bangladesh,25/05/2008,5,0,0,0,3,2,0,10
Bangladesh,26/05/2008,8,0,0,0,3,0,0,11
Bangladesh,27/05/2008,21,0,0,0,18,0,0,39
Bangladesh,28/05/2008,6,0,1,0,12,6,0,25
Bangladesh,29/05/2008,3,0,0,0,1,0,0,4
Bangladesh,30/05/2008,-2,0,0,0,-2,0,0,-4
Bangladesh,31/05/2008,5,0,0,0,13,0,0,18
Cameroon,01/05/2008,2,0,0,0,0,0,0,2
Cameroon,02/05/2008,0,0,0,0,0,2,0,2
Cameroon,05/05/2008,-1,0,0,0,3,1,0,3
Cameroon,07/05/2008,3,0,0,0,0,0,0,3
Cameroon,08/05/2008,0,0,0,0,0,0,0,0
Cameroon,11/05/2008,0,0,0,0,0,0,0,0
Cameroon,12/05/2008,0,0,0,0,0,1,0,1
Cameroon,13/05/2008,0,0,0,0,0,1,0,1
Cameroon,14/05/2008,0,0,0,0,0,0,0,0
Cameroon,15/05/2008,0,0,0,0,-2,0,0,-2
Cameroon,16/05/2008,4,0,0,0,0,0,0,4
Cameroon,17/05/2008,0,0,0,0,0,0,0,0
Cameroon,19/05/2008,8,0,0,0,0,0,0,8
Cameroon,20/05/2008,1,0,0,0,0,0,0,1
Cameroon,21/05/2008,0,0,0,0,0,0,0,0
Cameroon,22/05/2008,2,0,0,0,0,0,0,2
Cameroon,23/05/2008,3,0,0,0,0,1,0,4
Cameroon,24/05/2008,3,0,0,0,0,1,0,4
Cameroon,26/05/2008,0,0,0,0,0,0,0,0
Cameroon,27/05/2008,6,0,0,0,0,0,0,6
Cameroon,28/05/2008,2,0,0,0,0,0,0,2
Cameroon,30/05/2008,0,0,0,0,0,0,0,0
China,01/05/2008,34,0,-2,0,17,10,0,59
China,02/05/2008,33,0,1,0,38,6,0,78
China,03/05/2008,11,0,0,0,9,4,0,24
China,04/05/2008,6,0,0,0,0,1,0,7
China,05/05/2008,94,0,-1,0,38,16,0,147
China,06/05/2008,52,0,-5,0,42,8,0,97
China,07/05/2008,44,0,-7,0,18,7,0,62
China,08/05/2008,75,4,-3,0,31,19,0,126
China,09/05/2008,3,2,0,0,7,1,0,13
China,10/05/2008,19,2,0,0,2,0,0,23
China,11/05/2008,83,0,0,0,58,26,0,167
China,12/05/2008,168,0,-6,0,89,22,0,273
China,13/05/2008,75,6,-2,0,28,10,0,117
China,14/05/2008,63,6,0,0,30,10,0,109
China,15/05/2008,113,12,-12,0,76,17,0,206
China,16/05/2008,139,2,-11,0,83,25,0,238
China,17/05/2008,41,0,0,0,33,8,0,82
China,18/05/2008,52,2,0,0,6,4,0,64
China,19/05/2008,94,4,0,0,21,6,0,125
China,20/05/2008,136,0,2,0,80,13,0,231
China,21/05/2008,92,0,-11,0,70,11,0,162
China,22/05/2008,57,8,-11,0,59,10,0,123
China,23/05/2008,85,8,-2,0,14,9,0,114
China,24/05/2008,35,0,-11,0,18,4,0,46
China,25/05/2008,25,0,0,0,5,2,0,32
China,26/05/2008,71,4,2,0,16,10,0,103
China,27/05/2008,66,0,0,0,9,4,0,79
China,28/05/2008,103,2,-4,0,75,20,0,196
China,29/05/2008,88,0,2,0,79,10,0,179
China,30/05/2008,49,4,0,0,19,9,0,81
China,31/05/2008,36,4,1,0,2,6,0,49
Egypt,01/05/2008,56,0,0,0,9,0,0,65
Egypt,02/05/2008,26,0,0,0,16,3,0,45
Egypt,03/05/2008,5,0,0,0,0,0,0,5
Egypt,04/05/2008,4,0,0,0,0,0,0,4
Egypt,05/05/2008,17,0,0,0,19,5,0,41
Egypt,06/05/2008,40,0,1,0,3,1,0,45
Egypt,07/05/2008,51,0,0,0,6,0,0,57
Egypt,08/05/2008,35,0,0,0,22,1,0,58
Egypt,09/05/2008,44,0,0,0,15,2,0,61
Egypt,10/05/2008,3,0,0,0,3,0,0,6
Egypt,11/05/2008,31,0,0,0,9,2,0,42
Egypt,12/05/2008,58,0,-2,0,-6,4,0,54
Egypt,13/05/2008,62,0,0,0,3,7,0,72
Egypt,14/05/2008,48,0,0,0,12,0,0,60
Egypt,15/05/2008,23,0,-2,0,22,0,0,43
Egypt,16/05/2008,12,0,0,0,6,6,0,24
Egypt,17/05/2008,18,0,0,0,18,2,0,38
Egypt,18/05/2008,6,2,0,0,3,7,0,18
Egypt,19/05/2008,52,2,0,0,6,2,0,62
Egypt,20/05/2008,56,8,-4,0,6,0,0,66
Egypt,21/05/2008,36,0,0,0,0,2,0,38
Egypt,22/05/2008,73,0,0,0,-1,7,0,79
Egypt,23/05/2008,23,0,1,0,7,2,0,33
Egypt,24/05/2008,17,0,0,0,15,0,0,32
Egypt,25/05/2008,24,0,1,0,3,2,0,30
Egypt,26/05/2008,46,4,3,0,5,0,0,58
Egypt,27/05/2008,19,0,1,0,9,0,0,29
Egypt,28/05/2008,29,0,0,0,6,0,0,35
Egypt,29/05/2008,8,0,0,0,7,0,0,15
Egypt,30/05/2008,39,0,0,0,-1,4,0,42
Egypt,31/05/2008,8,0,0,0,-2,0,0,6
Eritrea,01/05/2008,0,0,0,0,0,0,0,0
Eritrea,02/05/2008,0,0,0,0,-4,0,0,-4
Eritrea,03/05/2008,4,0,0,0,0,0,0,4
Eritrea,05/05/2008,0,0,0,0,0,0,0,0
Eritrea,06/05/2008,2,0,0,0,-2,0,0,0
Eritrea,07/05/2008,12,0,0,0,0,0,0,12
Eritrea,08/05/2008,9,0,0,0,0,0,0,9
Eritrea,09/05/2008,2,0,0,0,0,2,0,4
Eritrea,10/05/2008,0,0,0,0,6,0,0,6
Eritrea,11/05/2008,1,0,0,0,0,0,0,1
Eritrea,12/05/2008,5,0,0,0,0,0,0,5
Eritrea,13/05/2008,9,0,0,0,0,0,0,9
Eritrea,14/05/2008,2,0,0,0,0,0,0,2
Eritrea,16/05/2008,0,0,0,0,-2,0,0,-2
Eritrea,18/05/2008,0,0,0,0,3,0,0,3
Eritrea,19/05/2008,-8,0,0,0,0,0,0,-8
Eritrea,20/05/2008,-3,0,0,0,-6,0,0,-9
Eritrea,21/05/2008,4,0,0,0,22,0,0,26
Eritrea,22/05/2008,-2,0,0,0,6,0,0,4
Eritrea,23/05/2008,18,0,1,0,0,0,0,19
Eritrea,24/05/2008,3,0,0,0,0,0,0,3
Eritrea,25/05/2008,0,0,0,0,0,0,0,0
Eritrea,26/05/2008,0,0,0,0,0,0,0,0
Eritrea,27/05/2008,11,0,0,0,0,0,0,11
Eritrea,28/05/2008,9,0,0,0,9,9,0,27
Eritrea,29/05/2008,13,0,0,0,0,5,0,18
Eritrea,30/05/2008,11,0,0,0,6,0,0,17
Eritrea,31/05/2008,8,0,0,0,-2,0,0,6
Georgia,01/05/2008,3,0,0,0,-3,4,0,4
Georgia,02/05/2008,16,0,0,0,18,0,0,34
Georgia,03/05/2008,12,0,0,0,0,0,0,12
Georgia,04/05/2008,13,0,0,0,0,0,0,13
Georgia,05/05/2008,28,0,0,0,-2,4,0,30
Georgia,06/05/2008,1,0,1,0,6,0,0,8
Georgia,07/05/2008,34,0,0,0,14,3,0,51
Georgia,08/05/2008,7,0,0,0,-2,0,0,5
Georgia,09/05/2008,9,0,0,0,0,0,0,9
Georgia,10/05/2008,0,0,0,0,0,0,0,0
Georgia,11/05/2008,27,0,0,0,3,1,0,31
Georgia,12/05/2008,36,0,0,0,-2,0,0,34
Georgia,13/05/2008,1,0,0,0,0,0,0,1
Georgia,14/05/2008,3,0,0,0,15,0,0,18
Georgia,15/05/2008,8,0,2,0,6,0,0,16
Georgia,16/05/2008,9,0,0,0,-2,0,0,7
Georgia,17/05/2008,0,0,0,0,0,0,0,0
Georgia,18/05/2008,8,0,0,0,3,0,0,11
Georgia,19/05/2008,3,0,0,0,6,0,0,9
Georgia,20/05/2008,14,2,0,0,3,2,0,21
Georgia,21/05/2008,15,0,0,0,-1,4,0,18
Georgia,22/05/2008,9,0,-1,0,-1,0,0,7
Georgia,23/05/2008,11,0,2,0,10,1,0,24
Georgia,24/05/2008,3,0,1,0,0,0,0,4
Georgia,25/05/2008,0,0,0,0,-2,0,0,-2
Georgia,26/05/2008,16,0,-1,0,0,0,0,15
Georgia,27/05/2008,5,0,0,0,9,4,0,18
Georgia,28/05/2008,10,0,0,0,14,4,0,28
Georgia,29/05/2008,5,0,-1,0,6,0,0,10
Georgia,30/05/2008,9,0,0,0,0,0,0,9
Georgia,31/05/2008,4,0,0,0,0,0,0,4
India,01/05/2008,33,0,0,0,10,5,0,48
India,02/05/2008,23,0,-3,0,-4,0,0,16
India,03/05/2008,3,0,0,0,-2,0,0,1
India,04/05/2008,3,0,0,0,3,0,0,6
India,05/05/2008,52,0,0,0,14,18,0,84
India,06/05/2008,18,0,0,0,28,9,0,55
India,07/05/2008,26,0,0,0,1,0,0,27
India,08/05/2008,55,0,-2,0,20,7,0,80
India,09/05/2008,5,0,0,0,6,0,0,11
India,10/05/2008,0,0,0,0,3,0,0,3
India,11/05/2008,78,0,-1,0,5,1,0,83
India,12/05/2008,58,4,-1,0,1,7,0,69
India,13/05/2008,26,0,3,0,16,7,0,52
India,14/05/2008,32,4,0,0,2,13,0,51
India,15/05/2008,52,0,3,0,-5,3,0,53
India,16/05/2008,7,0,0,0,3,4,0,14
India,17/05/2008,29,0,0,0,-2,10,0,37
India,18/05/2008,3,2,0,0,1,1,0,7
India,19/05/2008,37,2,0,0,2,7,0,48
India,20/05/2008,29,2,0,0,-6,2,0,27
India,21/05/2008,18,0,1,0,9,15,0,43
India,22/05/2008,23,0,0,0,0,2,0,25
India,23/05/2008,11,2,-1,0,-15,1,0,-2
India,24/05/2008,17,0,-2,0,4,9,0,28
India,25/05/2008,9,0,-2,0,4,1,0,12
India,26/05/2008,21,0,2,0,0,7,0,30
India,27/05/2008,37,0,-13,0,9,3,0,36
India,28/05/2008,52,0,-4,0,8,9,0,65
India,29/05/2008,35,0,0,0,-3,2,0,34
India,30/05/2008,12,0,0,0,0,0,0,12
India,31/05/2008,27,2,0,0,7,2,0,38
Iran,01/05/2008,88,0,1,0,31,6,0,126
Iran,02/05/2008,56,0,-3,0,4,7,0,64
Iran,03/05/2008,17,0,0,0,1,5,0,23
Iran,04/05/2008,18,0,-2,0,3,0,0,19
Iran,05/05/2008,46,0,1,0,20,4,0,71
Iran,06/05/2008,55,0,0,0,3,8,0,66
Iran,07/05/2008,46,0,0,0,36,13,0,95
Iran,08/05/2008,44,0,1,0,6,1,0,52
Iran,09/05/2008,3,0,0,0,10,1,0,14
Iran,10/05/2008,18,0,-2,0,0,0,0,16
Iran,11/05/2008,70,4,2,0,-10,5,0,71
Iran,12/05/2008,48,0,-2,0,21,4,0,71
Iran,13/05/2008,43,0,0,0,11,10,0,64
Iran,14/05/2008,99,2,0,0,15,2,0,118
Iran,15/05/2008,230,0,0,0,20,9,0,259
Iran,16/05/2008,171,0,0,0,11,19,0,201
Iran,17/05/2008,87,0,0,0,19,3,0,109
Iran,18/05/2008,44,0,0,0,1,0,0,45
Iran,19/05/2008,101,4,0,0,26,10,0,141
Iran,20/05/2008,82,0,-7,0,24,2,0,101
Iran,21/05/2008,65,0,1,0,72,2,0,140
Iran,22/05/2008,59,0,0,0,38,9,0,106
Iran,23/05/2008,65,0,0,0,36,5,0,106
Iran,24/05/2008,22,0,-12,0,3,0,0,13
Iran,25/05/2008,39,0,-3,0,15,1,0,52
Iran,26/05/2008,20,0,2,0,14,2,0,38
Iran,27/05/2008,52,0,1,0,13,6,0,72
Iran,28/05/2008,31,0,-4,0,17,4,0,48
Iran,29/05/2008,67,0,-1,0,11,12,0,89
Iran,30/05/2008,43,0,0,0,-5,0,0,38
Iran,31/05/2008,38,0,0,0,10,0,0,48
Iraq,01/05/2008,172,0,0,0,24,39,0,235
Iraq,02/05/2008,238,2,0,0,16,31,0,287
Iraq,03/05/2008,67,0,-2,0,6,12,0,83
Iraq,04/05/2008,69,0,1,0,9,7,0,86
Iraq,05/05/2008,193,0,-1,0,62,30,0,284
Iraq,06/05/2008,89,0,-1,0,20,12,0,120
Iraq,07/05/2008,154,2,0,0,39,21,0,216
Iraq,08/05/2008,148,2,1,0,79,21,0,251
Iraq,09/05/2008,33,8,-4,0,23,2,0,62
Iraq,10/05/2008,39,2,0,0,0,0,0,41
Iraq,11/05/2008,212,0,-8,0,15,24,0,243
Iraq,12/05/2008,103,0,-7,0,9,1,0,106
Iraq,13/05/2008,79,0,-2,0,10,16,0,103
Iraq,14/05/2008,93,0,1,0,42,9,0,145
Iraq,15/05/2008,156,0,3,0,50,9,0,218
Iraq,16/05/2008,93,0,-3,0,15,23,0,128
Iraq,17/05/2008,79,0,-2,0,48,7,0,132
Iraq,18/05/2008,44,2,0,0,-1,3,0,48
Iraq,19/05/2008,105,0,0,0,30,10,0,145
Iraq,20/05/2008,97,0,0,0,52,11,0,160
Iraq,21/05/2008,130,2,-1,0,23,7,0,161
Iraq,22/05/2008,300,8,0,0,36,24,0,368
Iraq,23/05/2008,130,0,0,0,41,11,0,182
Iraq,24/05/2008,74,0,0,0,14,12,0,100
Iraq,25/05/2008,68,0,0,0,11,3,0,82
Iraq,26/05/2008,119,0,0,0,9,5,0,133
Iraq,27/05/2008,177,8,0,0,28,12,0,225
Iraq,28/05/2008,174,10,-1,0,36,11,0,230
Iraq,29/05/2008,236,4,-2,0,18,42,0,298
Iraq,30/05/2008,127,0,1,0,20,16,0,164
Iraq,31/05/2008,56,0,0,0,17,5,0,78
Morocco,01/05/2008,6,0,0,0,-2,0,0,4
Morocco,02/05/2008,4,0,0,0,-5,1,0,0
Morocco,04/05/2008,0,0,0,0,0,0,0,0
Morocco,05/05/2008,9,0,0,0,6,0,0,15
Morocco,06/05/2008,5,0,0,0,22,0,0,27
Morocco,07/05/2008,3,0,0,0,21,0,0,24
Morocco,08/05/2008,10,0,0,0,38,1,0,49
Morocco,09/05/2008,0,0,0,0,0,0,0,0
Morocco,11/05/2008,0,0,0,0,3,1,0,4
Morocco,12/05/2008,0,0,0,0,0,1,0,1
Morocco,13/05/2008,-1,0,0,0,3,0,0,2
Morocco,14/05/2008,1,0,0,0,4,0,0,5
Morocco,15/05/2008,0,0,0,0,3,0,0,3
Morocco,16/05/2008,17,0,0,0,6,4,0,27
Morocco,17/05/2008,16,0,0,0,9,4,0,29
Morocco,18/05/2008,-3,0,1,0,0,0,0,-2
Morocco,19/05/2008,0,0,0,0,3,1,0,4
Morocco,20/05/2008,4,0,0,0,0,0,0,4
Morocco,21/05/2008,9,0,0,0,0,0,0,9
Morocco,22/05/2008,21,0,0,0,-4,0,0,17
Morocco,23/05/2008,8,0,0,0,3,0,0,11
Morocco,24/05/2008,3,0,0,0,12,0,0,15
Morocco,25/05/2008,0,0,0,0,0,0,0,0
Morocco,26/05/2008,9,0,0,0,0,0,0,9
Morocco,27/05/2008,0,0,0,0,-2,0,0,-2
Morocco,28/05/2008,8,0,0,0,0,0,0,8
Morocco,29/05/2008,5,0,0,0,6,1,0,12
Morocco,30/05/2008,0,0,0,0,11,0,0,11
Morocco,31/05/2008,0,0,0,0,0,0,0,0
Nigeria,01/05/2008,6,0,0,0,-2,0,0,4
Nigeria,02/05/2008,5,0,0,0,6,0,0,11
Nigeria,03/05/2008,0,0,0,0,0,0,0,0
Nigeria,04/05/2008,6,0,0,0,9,0,0,15
Nigeria,05/05/2008,18,0,0,0,3,0,0,21
Nigeria,06/05/2008,18,0,0,0,12,3,0,33
Nigeria,07/05/2008,30,0,0,0,25,1,0,56
Nigeria,08/05/2008,13,0,0,0,3,0,0,16
Nigeria,09/05/2008,3,0,1,0,0,0,0,4
Nigeria,10/05/2008,6,0,0,0,0,0,0,6
Nigeria,11/05/2008,2,0,0,0,3,4,0,9
Nigeria,12/05/2008,13,0,0,0,3,2,0,18
Nigeria,13/05/2008,17,0,0,0,0,0,0,17
Nigeria,14/05/2008,-1,0,0,0,9,0,0,8
Nigeria,15/05/2008,7,0,0,0,6,0,0,13
Nigeria,16/05/2008,10,0,0,0,24,0,0,34
Nigeria,17/05/2008,0,0,0,0,12,0,0,12
Nigeria,18/05/2008,0,0,0,0,0,0,0,0
Nigeria,19/05/2008,27,0,0,0,0,0,0,27
Nigeria,20/05/2008,24,0,0,0,15,3,0,42
Nigeria,21/05/2008,29,0,0,0,3,9,0,41
Nigeria,22/05/2008,18,0,0,0,15,19,0,52
Nigeria,23/05/2008,19,0,0,0,5,14,0,38
Nigeria,24/05/2008,4,0,0,0,24,8,0,36
Nigeria,25/05/2008,0,0,0,0,0,0,0,0
Nigeria,26/05/2008,5,0,1,0,3,0,0,9
Nigeria,27/05/2008,3,0,0,0,9,0,0,12
Nigeria,28/05/2008,3,0,0,0,10,2,0,15
Nigeria,29/05/2008,37,0,-1,0,-3,6,0,39
Nigeria,30/05/2008,8,0,0,0,8,0,0,16
Nigeria,31/05/2008,6,0,0,0,6,0,0,12
Pakistan,01/05/2008,42,2,-1,0,64,4,0,111
Pakistan,02/05/2008,58,0,3,0,23,0,0,84
Pakistan,03/05/2008,8,0,0,0,0,1,0,9
Pakistan,04/05/2008,-3,0,0,0,9,2,0,8
Pakistan,05/05/2008,22,2,0,0,8,2,0,34
Pakistan,06/05/2008,46,0,0,0,22,7,0,75
Pakistan,07/05/2008,55,0,1,0,10,4,0,70
Pakistan,08/05/2008,44,0,0,0,16,4,0,64
Pakistan,09/05/2008,5,0,0,0,9,1,0,15
Pakistan,10/05/2008,10,0,0,0,3,0,0,13
Pakistan,11/05/2008,65,2,-6,0,6,9,0,76
Pakistan,12/05/2008,44,0,-6,0,49,17,0,104
Pakistan,13/05/2008,124,0,-15,0,50,10,0,169
Pakistan,14/05/2008,61,2,-5,0,28,18,0,104
Pakistan,15/05/2008,128,0,-2,0,18,16,0,160
Pakistan,16/05/2008,52,0,0,0,17,1,0,70
Pakistan,17/05/2008,43,0,-2,0,12,2,0,55
Pakistan,18/05/2008,35,0,-2,0,5,1,0,39
Pakistan,19/05/2008,95,0,-3,0,27,9,0,128
Pakistan,20/05/2008,34,0,0,0,13,2,0,49
Pakistan,21/05/2008,28,0,0,0,11,2,0,41
Pakistan,22/05/2008,61,0,-2,0,13,8,0,80
Pakistan,23/05/2008,67,0,-2,0,49,17,0,131
Pakistan,24/05/2008,49,0,0,0,10,2,0,61
Pakistan,25/05/2008,38,0,-4,0,6,6,0,46
Pakistan,26/05/2008,28,0,-2,0,7,6,0,39
Pakistan,27/05/2008,13,0,-6,0,7,4,0,18
Pakistan,28/05/2008,72,0,-2,0,2,4,0,76
Pakistan,29/05/2008,95,0,2,0,27,12,0,136
Pakistan,30/05/2008,52,0,0,0,22,7,0,81
Pakistan,31/05/2008,49,0,0,0,29,5,0,83
Sierra Leone,01/05/2008,6,0,0,0,0,0,0,6
Sierra Leone,05/05/2008,0,0,0,0,0,0,0,0
Sierra Leone,06/05/2008,1,0,0,0,0,0,0,1
Sierra Leone,07/05/2008,4,0,0,0,0,0,0,4
Sierra Leone,08/05/2008,3,0,0,0,3,4,0,10
Sierra Leone,09/05/2008,0,0,0,0,0,0,0,0
Sierra Leone,10/05/2008,0,0,0,0,0,0,0,0
Sierra Leone,11/05/2008,0,0,0,0,3,0,0,3
Sierra Leone,12/05/2008,0,0,0,0,9,1,0,10
Sierra Leone,13/05/2008,4,0,0,0,3,0,0,7
Sierra Leone,14/05/2008,10,0,-4,0,24,2,0,32
Sierra Leone,15/05/2008,1,0,0,0,7,12,0,20
Sierra Leone,16/05/2008,8,0,-4,0,3,2,0,9
Sierra Leone,18/05/2008,6,0,0,0,9,1,0,16
Sierra Leone,19/05/2008,8,0,0,0,15,1,0,24
Sierra Leone,20/05/2008,0,0,0,0,0,0,0,0
Sierra Leone,21/05/2008,3,0,0,0,6,0,0,9
Sierra Leone,22/05/2008,0,0,0,0,0,0,0,0
Sierra Leone,23/05/2008,0,0,0,0,0,0,0,0
Sierra Leone,26/05/2008,0,0,0,0,3,0,0,3
Sierra Leone,27/05/2008,0,0,0,0,0,0,0,0
Sierra Leone,28/05/2008,6,0,0,0,3,0,0,9
Sierra Leone,29/05/2008,8,0,0,0,15,0,0,23
Sierra Leone,30/05/2008,3,0,0,0,3,0,0,6
Somalia,01/05/2008,105,0,0,0,1,2,0,108
Somalia,02/05/2008,41,0,0,0,6,0,0,47
Somalia,03/05/2008,0,0,0,0,0,0,0,0
Somalia,04/05/2008,0,0,0,0,9,0,0,9
Somalia,05/05/2008,47,2,0,0,4,0,0,53
Somalia,06/05/2008,25,0,0,0,5,0,0,30
Somalia,07/05/2008,8,0,0,0,0,0,0,8
Somalia,08/05/2008,20,0,0,0,3,2,0,25
Somalia,09/05/2008,11,0,0,0,0,0,0,11
Somalia,10/05/2008,6,0,0,0,-2,0,0,4
Somalia,11/05/2008,15,0,0,0,1,0,0,16
Somalia,12/05/2008,10,0,0,0,0,2,0,12
Somalia,13/05/2008,24,0,0,0,9,7,0,40
Somalia,14/05/2008,32,0,0,0,-2,5,0,35
Somalia,15/05/2008,9,0,0,0,-2,1,0,8
Somalia,16/05/2008,22,0,-1,0,10,2,0,33
Somalia,17/05/2008,18,0,0,0,0,1,0,19
Somalia,18/05/2008,3,0,0,0,9,0,0,12
Somalia,19/05/2008,19,0,0,0,3,2,0,24
Somalia,20/05/2008,31,2,0,0,3,2,0,38
Somalia,21/05/2008,26,0,0,0,6,6,0,38
Somalia,22/05/2008,17,0,0,0,10,8,0,35
Somalia,23/05/2008,42,0,0,0,15,40,0,97
Somalia,24/05/2008,35,0,0,0,8,6,0,49
Somalia,25/05/2008,8,0,0,0,0,0,0,8
Somalia,26/05/2008,5,0,0,0,-1,13,0,17
Somalia,27/05/2008,32,0,0,0,-4,4,0,32
Somalia,28/05/2008,20,4,0,0,3,9,0,36
Somalia,29/05/2008,55,10,1,0,5,7,0,78
Somalia,30/05/2008,42,0,0,0,35,9,0,86
Somalia,31/05/2008,15,0,0,0,1,3,0,19
Syria,01/05/2008,13,0,0,0,0,0,0,13
Syria,02/05/2008,8,4,-1,0,0,0,0,11
Syria,03/05/2008,0,4,0,0,0,0,0,4
Syria,04/05/2008,0,0,0,0,0,0,0,0
Syria,05/05/2008,19,0,0,0,5,0,0,24
Syria,06/05/2008,0,0,0,0,-6,4,0,-2
Syria,07/05/2008,23,0,-4,0,0,4,0,23
Syria,08/05/2008,84,0,-8,0,7,15,0,98
Syria,09/05/2008,83,0,-14,0,0,2,0,71
Syria,10/05/2008,43,0,0,0,0,16,0,59
Syria,11/05/2008,93,0,-2,0,11,15,0,117
Syria,12/05/2008,69,4,2,0,6,3,0,84
Syria,13/05/2008,16,0,0,0,1,9,0,26
Syria,14/05/2008,27,0,0,0,50,0,0,77
Syria,15/05/2008,48,0,0,0,16,0,0,64
Syria,16/05/2008,24,0,0,0,-3,0,0,21
Syria,17/05/2008,27,0,-7,0,12,0,0,32
Syria,18/05/2008,18,0,-2,0,9,1,0,26
Syria,19/05/2008,24,0,2,0,0,0,0,26
Syria,20/05/2008,16,0,2,0,9,0,0,27
Syria,21/05/2008,20,0,0,0,24,3,0,47
Syria,22/05/2008,47,0,0,0,2,1,0,50
Syria,23/05/2008,17,0,0,0,0,1,0,18
Syria,24/05/2008,5,0,-4,0,0,0,0,1
Syria,25/05/2008,24,0,-12,0,-2,1,0,11
Syria,26/05/2008,21,0,0,0,0,2,0,23
Syria,27/05/2008,12,0,0,0,8,0,0,20
Syria,28/05/2008,15,2,-13,0,10,3,0,17
Syria,29/05/2008,37,0,-6,0,6,22,0,59
Syria,30/05/2008,8,0,0,0,1,0,0,9
Syria,31/05/2008,27,0,-3,0,4,2,0,30
Yemen,01/05/2008,5,0,0,0,0,3,0,8
Yemen,02/05/2008,70,0,0,0,6,18,0,94
Yemen,03/05/2008,42,0,0,0,3,1,0,46
Yemen,04/05/2008,26,0,0,0,0,0,0,26
Yemen,05/05/2008,50,0,0,0,13,1,0,64
Yemen,06/05/2008,35,0,0,0,6,0,0,41
Yemen,07/05/2008,27,0,0,0,15,0,0,42
Yemen,08/05/2008,8,2,0,0,8,0,0,18
Yemen,09/05/2008,18,2,0,0,0,0,0,20
Yemen,10/05/2008,3,0,0,0,3,0,0,6
Yemen,11/05/2008,2,2,0,0,0,0,0,4
Yemen,12/05/2008,19,0,1,0,18,0,0,38
Yemen,13/05/2008,1,0,0,0,15,0,0,16
Yemen,14/05/2008,0,0,0,0,15,4,0,19
Yemen,16/05/2008,22,0,0,0,-4,0,0,18
Yemen,17/05/2008,2,0,0,0,33,0,0,35
Yemen,18/05/2008,0,0,0,0,-2,0,0,-2
Yemen,19/05/2008,9,0,0,0,21,0,0,30
Yemen,20/05/2008,8,0,0,0,27,0,0,35
Yemen,21/05/2008,4,0,-2,0,0,0,0,2
Yemen,22/05/2008,0,0,0,0,0,0,0,0
Yemen,23/05/2008,0,0,0,0,0,0,0,0
Yemen,24/05/2008,0,0,0,0,0,0,0,0
Yemen,25/05/2008,8,0,0,0,3,0,0,11
Yemen,26/05/2008,3,0,0,0,0,0,0,3
Yemen,27/05/2008,5,0,0,0,-2,0,0,3
Yemen,28/05/2008,3,0,0,0,6,0,0,9
Yemen,29/05/2008,1,0,0,0,0,0,0,1
Yemen,30/05/2008,14,0,0,0,6,0,0,20
Yemen,31/05/2008,25,0,0,0,15,11,0,51
Afghanistan,01/11/2008,129,0,-5,0,67,26,0,217
Afghanistan,02/11/2008,93,0,0,0,66,26,0,185
Afghanistan,03/11/2008,131,0,-4,0,68,7,0,202
Afghanistan,04/11/2008,180,0,0,0,38,14,0,232
Afghanistan,05/11/2008,140,6,1,0,50,6,0,203
Afghanistan,06/11/2008,101,0,0,0,15,18,0,134
Afghanistan,07/11/2008,126,0,0,0,13,24,0,163
Afghanistan,08/11/2008,52,0,0,0,11,4,0,67
Afghanistan,09/11/2008,162,0,0,0,22,3,0,187
Afghanistan,10/11/2008,196,0,-2,0,-9,26,0,211
Afghanistan,11/11/2008,222,0,-1,0,15,14,0,250
Afghanistan,12/11/2008,318,6,0,0,49,80,0,453
Afghanistan,13/11/2008,355,2,1,0,134,46,0,538
Afghanistan,14/11/2008,301,0,0,0,60,16,0,377
Afghanistan,15/11/2008,38,0,0,0,20,8,0,66
Afghanistan,16/11/2008,103,0,3,0,21,3,0,130
Afghanistan,17/11/2008,210,0,4,0,18,29,0,261
Afghanistan,18/11/2008,126,2,0,0,18,3,0,149
Afghanistan,19/11/2008,159,0,0,0,53,21,0,233
Afghanistan,20/11/2008,137,6,0,0,50,13,0,206
Afghanistan,21/11/2008,57,0,0,0,16,24,0,97
Afghanistan,22/11/2008,35,0,0,0,18,0,0,53
Afghanistan,23/11/2008,139,2,2,0,43,26,0,212
Afghanistan,24/11/2008,181,0,2,0,36,14,0,233
Afghanistan,25/11/2008,173,0,4,0,119,1,0,297
Afghanistan,26/11/2008,185,0,0,0,68,10,0,263
Afghanistan,27/11/2008,143,0,-4,0,22,11,0,172
Afghanistan,28/11/2008,142,0,-1,0,44,16,0,201
Afghanistan,29/11/2008,82,2,0,0,2,10,0,96
Afghanistan,30/11/2008,165,4,0,0,12,8,0,189
Albania,01/11/2008,16,0,-4,0,6,2,0,20
Albania,03/11/2008,-15,0,0,0,0,0,0,-15
Albania,04/11/2008,4,0,0,0,9,0,0,13
Albania,05/11/2008,0,0,-1,0,9,0,0,8
Albania,06/11/2008,2,0,0,0,0,0,0,2
Albania,07/11/2008,3,0,0,0,0,0,0,3
Albania,09/11/2008,11,0,0,0,0,0,0,11
Albania,10/11/2008,19,0,-4,0,0,6,0,21
Albania,11/11/2008,2,0,0,0,-1,6,0,7
Albania,12/11/2008,2,0,0,0,0,0,0,2
Albania,13/11/2008,6,0,-1,0,2,7,0,14
Albania,14/11/2008,14,0,-5,0,3,0,0,12
Albania,15/11/2008,9,0,0,0,2,2,0,13
Albania,16/11/2008,0,0,0,0,2,0,0,2
Albania,17/11/2008,4,0,-1,0,0,0,0,3
Albania,18/11/2008,5,0,0,0,-2,4,0,7
Albania,19/11/2008,3,0,0,0,4,3,0,10
Albania,20/11/2008,10,0,-2,0,6,2,0,16
Albania,21/11/2008,-1,0,0,0,0,0,0,-1
Albania,22/11/2008,4,0,0,0,6,0,0,10
Albania,23/11/2008,5,0,0,0,2,1,0,8
Albania,24/11/2008,15,0,0,0,3,0,0,18
Albania,25/11/2008,16,0,-1,0,0,0,0,15
Albania,26/11/2008,3,0,0,0,9,0,0,12
Albania,27/11/2008,15,0,0,0,-5,3,0,13
Albania,28/11/2008,11,0,0,0,14,1,0,26
Albania,29/11/2008,4,0,-2,0,-7,0,0,-5
Albania,30/11/2008,4,0,0,0,-4,0,0,0
Algeria,01/11/2008,0,0,0,0,26,0,0,26
Algeria,02/11/2008,4,0,0,0,3,0,0,7
Algeria,03/11/2008,1,0,-2,0,3,0,0,2
Algeria,04/11/2008,6,0,0,0,-3,0,0,3
Algeria,05/11/2008,1,0,0,0,6,0,0,7
Algeria,06/11/2008,3,0,0,0,4,0,0,7
Algeria,07/11/2008,4,0,0,0,1,0,0,5
Algeria,08/11/2008,2,0,0,0,3,0,0,5
Algeria,09/11/2008,2,0,0,0,2,0,0,4
Algeria,10/11/2008,4,0,0,0,-3,0,0,1
Algeria,11/11/2008,6,0,-2,0,-4,2,0,2
Algeria,12/11/2008,15,0,-4,0,0,0,0,11
Algeria,13/11/2008,5,0,0,0,3,0,0,8
Algeria,14/11/2008,12,0,0,0,0,0,0,12
Algeria,15/11/2008,3,0,-2,0,0,0,0,1
Algeria,16/11/2008,4,0,0,0,0,0,0,4
Algeria,17/11/2008,11,0,0,0,1,0,0,12
Algeria,18/11/2008,5,0,0,0,0,0,0,5
Algeria,19/11/2008,-3,0,0,0,9,1,0,7
Algeria,20/11/2008,0,0,0,0,9,0,0,9
Algeria,21/11/2008,0,0,0,0,0,0,0,0
Algeria,23/11/2008,11,0,-2,0,-7,0,0,2
Algeria,24/11/2008,2,0,0,0,4,0,0,6
Algeria,25/11/2008,9,0,0,0,-8,1,0,2
Algeria,26/11/2008,-1,0,0,0,3,0,0,2
Algeria,27/11/2008,6,0,0,0,6,0,0,12
Algeria,28/11/2008,4,0,0,0,0,0,0,4
Algeria,29/11/2008,9,0,0,0,0,0,0,9
Algeria,30/11/2008,0,0,0,0,-2,1,0,-1
Bangladesh,01/11/2008,23,0,0,0,11,11,0,45
Bangladesh,02/11/2008,19,0,0,0,12,2,0,33
Bangladesh,03/11/2008,29,0,-4,0,9,7,0,41
Bangladesh,04/11/2008,24,0,0,0,6,8,0,38
Bangladesh,05/11/2008,4,0,0,0,0,0,0,4
Bangladesh,06/11/2008,6,0,0,0,14,10,0,30
Bangladesh,07/11/2008,14,0,0,0,0,0,0,14
Bangladesh,08/11/2008,15,0,0,0,6,0,0,21
Bangladesh,09/11/2008,18,0,-3,0,9,0,0,24
Bangladesh,10/11/2008,6,0,0,0,3,0,0,9
Bangladesh,11/11/2008,7,0,0,0,6,3,0,16
Bangladesh,12/11/2008,-1,0,2,0,0,5,0,6
Bangladesh,13/11/2008,6,0,1,0,24,7,0,38
Bangladesh,14/11/2008,19,0,1,0,11,6,0,37
Bangladesh,15/11/2008,19,0,0,0,0,1,0,20
Bangladesh,16/11/2008,3,0,0,0,6,0,0,9
Bangladesh,17/11/2008,15,0,0,0,-8,0,0,7
Bangladesh,18/11/2008,29,0,0,0,0,0,0,29
Bangladesh,19/11/2008,15,0,0,0,9,0,0,24
Bangladesh,20/11/2008,4,0,0,0,0,0,0,4
Bangladesh,21/11/2008,1,0,0,0,6,1,0,8
Bangladesh,22/11/2008,4,0,0,0,0,0,0,4
Bangladesh,23/11/2008,22,0,0,0,6,0,0,28
Bangladesh,24/11/2008,8,0,0,0,3,0,0,11
Bangladesh,25/11/2008,6,0,-2,0,0,3,0,7
Bangladesh,26/11/2008,14,0,0,0,19,4,0,37
Bangladesh,27/11/2008,25,0,0,0,-1,5,0,29
Bangladesh,28/11/2008,10,0,0,0,6,0,0,16
Bangladesh,29/11/2008,7,0,0,0,9,0,0,16
Bangladesh,30/11/2008,21,0,0,0,27,9,0,57
Cameroon,01/11/2008,25,0,0,0,3,0,0,28
Cameroon,03/11/2008,2,0,0,0,12,0,0,14
Cameroon,04/11/2008,0,0,0,0,0,0,0,0
Cameroon,05/11/2008,2,0,0,0,0,1,0,3
Cameroon,06/11/2008,3,0,0,0,0,0,0,3
Cameroon,07/11/2008,0,0,0,0,-4,1,0,-3
Cameroon,09/11/2008,3,0,0,0,0,1,0,4
Cameroon,10/11/2008,1,0,0,0,0,0,0,1
Cameroon,11/11/2008,5,0,0,0,1,0,0,6
Cameroon,12/11/2008,12,0,0,0,-6,0,0,6
Cameroon,13/11/2008,8,0,0,0,0,0,0,8
Cameroon,14/11/2008,0,0,0,0,0,0,0,0
Cameroon,17/11/2008,6,0,0,0,0,0,0,6
Cameroon,18/11/2008,0,0,0,0,0,0,0,0
Cameroon,19/11/2008,3,0,0,0,0,0,0,3
Cameroon,23/11/2008,2,0,0,0,0,0,0,2
Cameroon,24/11/2008,3,0,0,0,0,0,0,3
Cameroon,25/11/2008,0,0,0,0,0,1,0,1
Cameroon,26/11/2008,0,0,0,0,3,0,0,3
Cameroon,27/11/2008,0,0,0,0,0,0,0,0
China,01/11/2008,74,2,0,0,30,20,0,126
China,02/11/2008,67,0,0,0,34,4,0,105
China,03/11/2008,90,0,-2,0,2,7,0,97
China,04/11/2008,78,0,1,0,59,9,0,147
China,05/11/2008,63,0,-1,0,22,7,0,91
China,06/11/2008,62,0,-1,0,47,22,0,130
China,07/11/2008,78,2,0,0,14,18,0,112
China,08/11/2008,25,0,0,0,29,9,0,63
China,09/11/2008,48,0,0,0,26,9,0,83
China,10/11/2008,98,2,-6,0,27,14,0,135
China,11/11/2008,74,0,2,0,29,9,0,114
China,12/11/2008,71,0,0,0,19,8,0,98
China,13/11/2008,114,4,2,0,24,13,0,157
China,14/11/2008,68,2,0,0,30,6,0,106
China,15/11/2008,52,2,0,0,12,4,0,70
China,16/11/2008,69,2,0,0,15,3,0,89
China,17/11/2008,92,6,-7,0,26,15,0,132
China,18/11/2008,61,2,0,0,34,14,0,111
China,19/11/2008,35,0,1,0,39,14,0,89
China,20/11/2008,46,0,0,0,-1,18,0,63
China,21/11/2008,6,0,0,0,0,0,0,6
China,22/11/2008,3,0,0,0,9,1,0,13
China,23/11/2008,108,0,2,0,40,13,0,163
China,24/11/2008,119,2,-1,0,13,4,0,137
China,25/11/2008,63,2,-4,0,17,1,0,79
China,26/11/2008,103,2,3,0,21,11,0,140
China,27/11/2008,73,0,-6,0,24,4,0,95
China,28/11/2008,52,4,-1,0,27,6,0,88
China,29/11/2008,49,2,-2,0,18,13,0,80
China,30/11/2008,66,2,-6,0,-3,16,0,75
Egypt,01/11/2008,25,0,0,0,7,1,0,33
Egypt,02/11/2008,55,0,0,0,23,2,0,80
Egypt,03/11/2008,72,0,0,0,42,0,0,114
Egypt,04/11/2008,25,0,-1,0,6,5,0,35
Egypt,05/11/2008,102,2,2,0,27,0,0,133
Egypt,06/11/2008,22,2,1,0,-5,3,0,23
Egypt,07/11/2008,19,0,0,0,18,0,0,37
Egypt,08/11/2008,26,0,0,0,1,3,0,30
Egypt,09/11/2008,17,0,0,0,-1,1,0,17
Egypt,10/11/2008,42,0,1,0,1,2,0,46
Egypt,11/11/2008,73,0,-1,0,28,6,0,106
Egypt,12/11/2008,79,2,-2,0,9,5,0,93
Egypt,13/11/2008,80,0,2,0,10,0,0,92
Egypt,14/11/2008,52,0,0,0,6,6,0,64
Egypt,15/11/2008,9,0,0,0,0,0,0,9
Egypt,16/11/2008,42,2,-1,0,25,5,0,73
Egypt,17/11/2008,40,0,0,0,7,3,0,50
Egypt,18/11/2008,28,0,0,0,9,3,0,40
Egypt,19/11/2008,21,2,1,0,21,4,0,49
Egypt,20/11/2008,9,0,0,0,0,4,0,13
Egypt,21/11/2008,3,0,0,0,0,0,0,3
Egypt,22/11/2008,10,0,0,0,3,9,0,22
Egypt,23/11/2008,65,0,0,0,22,14,0,101
Egypt,24/11/2008,28,0,1,0,9,1,0,39
Egypt,25/11/2008,20,0,-9,0,12,0,0,23
Egypt,26/11/2008,29,0,0,0,17,1,0,47
Egypt,27/11/2008,2,0,0,0,16,0,0,18
Egypt,28/11/2008,21,0,0,0,1,5,0,27
Egypt,29/11/2008,9,0,0,0,3,2,0,14
Egypt,30/11/2008,19,0,0,0,10,4,0,33
Eritrea,01/11/2008,0,0,0,0,0,0,0,0
Eritrea,02/11/2008,0,0,0,0,0,0,0,0
Eritrea,03/11/2008,0,0,0,0,3,0,0,3
Eritrea,04/11/2008,1,0,0,0,6,0,0,7
Eritrea,05/11/2008,0,0,0,0,-2,0,0,-2
Eritrea,06/11/2008,6,0,0,0,7,0,0,13
Eritrea,07/11/2008,11,0,0,0,6,0,0,17
Eritrea,08/11/2008,4,0,0,0,3,4,0,11
Eritrea,10/11/2008,3,0,0,0,6,4,0,13
Eritrea,11/11/2008,4,0,0,0,3,0,0,7
Eritrea,12/11/2008,10,0,0,0,0,0,0,10
Eritrea,13/11/2008,10,0,0,0,6,0,0,16
Eritrea,14/11/2008,0,0,0,0,0,0,0,0
Eritrea,15/11/2008,4,0,0,0,0,0,0,4
Eritrea,16/11/2008,0,0,0,0,0,0,0,0
Eritrea,17/11/2008,0,0,0,0,0,0,0,0
Eritrea,18/11/2008,0,0,0,0,0,0,0,0
Eritrea,19/11/2008,2,0,0,0,0,0,0,2
Eritrea,20/11/2008,0,0,0,0,0,0,0,0
Eritrea,21/11/2008,0,0,0,0,0,0,0,0
Eritrea,23/11/2008,3,0,0,0,3,0,0,6
Eritrea,24/11/2008,0,0,0,0,0,0,0,0
Eritrea,25/11/2008,0,0,0,0,0,0,0,0
Eritrea,27/11/2008,0,0,0,0,0,0,0,0
Eritrea,28/11/2008,6,0,0,0,0,0,0,6
Eritrea,29/11/2008,15,0,1,0,3,0,0,19
Eritrea,30/11/2008,22,0,0,0,0,0,0,22
Georgia,01/11/2008,9,0,0,0,4,0,0,13
Georgia,02/11/2008,3,0,0,0,0,2,0,5
Georgia,03/11/2008,12,0,0,0,0,3,0,15
Georgia,04/11/2008,8,0,0,0,3,2,0,13
Georgia,05/11/2008,7,0,-2,0,0,8,0,13
Georgia,06/11/2008,6,0,0,0,-2,4,0,8
Georgia,07/11/2008,5,0,-8,0,9,6,0,12
Georgia,08/11/2008,10,0,-4,0,0,1,0,7
Georgia,09/11/2008,3,0,0,0,0,0,0,3
Georgia,10/11/2008,11,0,0,0,3,0,0,14
Georgia,11/11/2008,10,0,0,0,-2,1,0,9
Georgia,12/11/2008,7,0,0,0,3,0,0,10
Georgia,13/11/2008,25,0,0,0,18,3,0,46
Georgia,14/11/2008,8,0,0,0,3,2,0,13
Georgia,15/11/2008,4,0,0,0,0,0,0,4
Georgia,16/11/2008,1,0,0,0,0,0,0,1
Georgia,17/11/2008,15,0,0,0,0,0,0,15
Georgia,18/11/2008,1,0,0,0,3,3,0,7
Georgia,19/11/2008,9,0,0,0,-1,0,0,8
Georgia,20/11/2008,3,0,0,0,0,0,0,3
Georgia,21/11/2008,0,0,0,0,0,0,0,0
Georgia,22/11/2008,0,0,0,0,0,0,0,0
Georgia,23/11/2008,15,0,0,0,6,1,0,22
Georgia,24/11/2008,2,0,0,0,9,2,0,13
Georgia,25/11/2008,26,0,0,0,15,2,0,43
Georgia,26/11/2008,9,0,0,0,3,0,0,12
Georgia,27/11/2008,9,0,0,0,3,0,0,12
Georgia,28/11/2008,9,0,0,0,-2,0,0,7
Georgia,29/11/2008,0,0,0,0,0,0,0,0
Georgia,30/11/2008,5,0,0,0,0,0,0,5
India,01/11/2008,23,0,0,0,15,2,0,40
India,02/11/2008,70,0,-1,0,27,11,0,107
India,03/11/2008,35,2,-2,0,1,1,0,37
India,04/11/2008,29,0,-1,0,6,10,0,44
India,05/11/2008,9,0,-2,0,-3,2,0,6
India,06/11/2008,43,0,0,0,2,6,0,51
India,07/11/2008,47,2,-1,0,12,2,0,62
India,08/11/2008,12,2,0,0,8,1,0,23
India,09/11/2008,31,4,-3,0,14,2,0,48
India,10/11/2008,26,0,0,0,17,5,0,48
India,11/11/2008,50,0,-2,0,13,6,0,67
India,12/11/2008,42,0,-2,0,16,2,0,58
India,13/11/2008,29,0,0,0,17,4,0,50
India,14/11/2008,28,2,-1,0,13,3,0,45
India,15/11/2008,28,0,-1,0,-1,4,0,30
India,16/11/2008,24,4,0,0,0,3,0,31
India,17/11/2008,55,4,0,0,7,6,0,72
India,18/11/2008,47,0,0,0,1,5,0,53
India,19/11/2008,82,0,-2,0,10,7,0,97
India,20/11/2008,39,0,-2,0,6,14,0,57
India,21/11/2008,6,0,0,0,0,0,0,6
India,22/11/2008,7,0,0,0,0,0,0,7
India,23/11/2008,90,2,-2,0,18,1,0,109
India,24/11/2008,105,2,1,0,-23,18,0,103
India,25/11/2008,95,0,-4,0,2,4,0,97
India,26/11/2008,64,0,-2,0,24,13,0,99
India,27/11/2008,6,0,0,0,4,3,0,13
India,28/11/2008,25,0,-1,0,-2,2,0,24
India,29/11/2008,11,0,-4,0,1,1,0,9
India,30/11/2008,40,2,0,0,-5,1,0,38
Iran,01/11/2008,43,0,0,0,7,2,0,52
Iran,02/11/2008,22,0,0,0,0,2,0,24
Iran,03/11/2008,30,0,0,0,4,11,0,45
Iran,04/11/2008,68,0,-1,0,16,9,0,92
Iran,05/11/2008,38,4,0,0,35,0,0,77
Iran,06/11/2008,26,0,0,0,-3,6,0,29
Iran,07/11/2008,32,0,0,0,1,2,0,35
Iran,08/11/2008,7,0,0,0,3,0,0,10
Iran,09/11/2008,34,0,0,0,33,2,0,69
Iran,10/11/2008,21,0,0,0,12,5,0,38
Iran,11/11/2008,32,0,0,0,27,5,0,64
Iran,12/11/2008,39,0,-2,0,-3,2,0,36
Iran,13/11/2008,96,0,3,0,72,10,0,181
Iran,14/11/2008,66,0,0,0,46,12,0,124
Iran,15/11/2008,31,0,0,0,33,3,0,67
Iran,16/11/2008,32,0,-2,0,21,5,0,56
Iran,17/11/2008,25,0,0,0,27,2,0,54
Iran,18/11/2008,78,0,0,0,13,5,0,96
Iran,19/11/2008,64,0,-2,0,55,7,0,124
Iran,20/11/2008,11,0,0,0,14,3,0,28
Iran,21/11/2008,8,0,0,0,-2,1,0,7
Iran,22/11/2008,3,0,0,0,6,0,0,9
Iran,23/11/2008,48,0,0,0,40,1,0,89
Iran,24/11/2008,32,0,-2,0,11,2,0,43
Iran,25/11/2008,41,0,-6,0,24,4,0,63
Iran,26/11/2008,71,2,2,0,5,5,0,85
Iran,27/11/2008,43,0,-1,0,2,0,0,44
Iran,28/11/2008,66,0,-2,0,36,0,0,100
Iran,29/11/2008,28,0,0,0,16,3,0,47
Iran,30/11/2008,20,0,0,0,12,6,0,38
Iraq,01/11/2008,99,0,4,0,18,11,0,132
Iraq,02/11/2008,111,0,1,0,33,21,0,166
Iraq,03/11/2008,67,0,-5,0,45,19,0,126
Iraq,04/11/2008,83,0,1,0,15,12,0,111
Iraq,05/11/2008,137,0,6,0,41,12,0,196
Iraq,06/11/2008,120,4,0,0,-13,8,0,119
Iraq,07/11/2008,41,0,0,0,17,16,0,74
Iraq,08/11/2008,69,0,0,0,-2,2,0,69
Iraq,09/11/2008,140,0,-4,0,25,23,0,184
Iraq,10/11/2008,87,2,1,0,19,15,0,124
Iraq,11/11/2008,111,0,2,0,17,10,0,140
Iraq,12/11/2008,166,0,-4,0,33,4,0,199
Iraq,13/11/2008,177,0,0,0,24,3,0,204
Iraq,14/11/2008,93,0,1,0,33,14,0,141
Iraq,15/11/2008,52,0,1,0,53,4,0,110
Iraq,16/11/2008,95,0,-1,0,58,12,0,164
Iraq,17/11/2008,145,0,-5,0,29,9,0,178
Iraq,18/11/2008,150,0,-8,0,58,20,0,220
Iraq,19/11/2008,111,0,2,0,22,24,0,159
Iraq,20/11/2008,39,0,0,0,47,2,0,88
Iraq,21/11/2008,30,0,0,0,0,2,0,32
Iraq,22/11/2008,-2,0,0,0,1,0,0,-1
Iraq,23/11/2008,84,4,2,0,25,9,0,124
Iraq,24/11/2008,55,4,-2,0,9,3,0,69
Iraq,25/11/2008,132,0,-1,0,27,11,0,169
Iraq,26/11/2008,73,0,1,0,16,5,0,95
Iraq,27/11/2008,69,2,0,0,21,4,0,96
Iraq,28/11/2008,94,0,1,0,28,7,0,130
Iraq,29/11/2008,41,0,0,0,27,0,0,68
Iraq,30/11/2008,87,0,1,0,5,23,0,116
Morocco,01/11/2008,4,0,0,0,15,1,0,20
Morocco,02/11/2008,4,0,0,0,12,4,0,20
Morocco,03/11/2008,5,0,1,0,94,3,0,103
Morocco,04/11/2008,12,0,0,0,24,0,0,36
Morocco,05/11/2008,2,0,0,0,15,0,0,17
Morocco,06/11/2008,4,0,0,0,54,0,0,58
Morocco,07/11/2008,3,2,0,0,0,0,0,5
Morocco,08/11/2008,0,0,0,0,0,0,0,0
Morocco,09/11/2008,6,0,0,0,9,0,0,15
Morocco,10/11/2008,31,0,0,0,0,0,0,31
Morocco,11/11/2008,0,0,0,0,7,0,0,7
Morocco,12/11/2008,2,0,0,0,6,0,0,8
Morocco,13/11/2008,0,0,0,0,6,0,0,6
Morocco,14/11/2008,1,0,0,0,15,0,0,16
Morocco,15/11/2008,2,0,0,0,25,2,0,29
Morocco,17/11/2008,8,0,0,0,0,0,0,8
Morocco,18/11/2008,3,0,0,0,6,0,0,9
Morocco,19/11/2008,2,0,0,0,15,0,0,17
Morocco,20/11/2008,3,0,0,0,3,0,0,6
Morocco,21/11/2008,0,0,0,0,0,0,0,0
Morocco,23/11/2008,0,2,0,0,0,0,0,2
Morocco,24/11/2008,3,0,0,0,0,0,0,3
Morocco,25/11/2008,-11,0,0,0,15,0,0,4
Morocco,26/11/2008,0,0,0,0,0,0,0,0
Morocco,27/11/2008,6,0,0,0,9,3,0,18
Morocco,28/11/2008,4,0,0,0,0,0,0,4
Morocco,29/11/2008,0,0,0,0,0,0,0,0
Morocco,30/11/2008,6,0,0,0,0,0,0,6
Nigeria,01/11/2008,5,0,0,0,6,0,0,11
Nigeria,02/11/2008,0,0,0,0,0,1,0,1
Nigeria,03/11/2008,25,0,0,0,9,3,0,37
Nigeria,04/11/2008,19,0,0,0,15,0,0,34
Nigeria,05/11/2008,23,0,0,0,9,0,0,32
Nigeria,06/11/2008,-1,0,0,0,0,1,0,0
Nigeria,07/11/2008,25,0,0,0,2,1,0,28
Nigeria,08/11/2008,0,0,0,0,0,1,0,1
Nigeria,09/11/2008,9,0,0,0,3,0,0,12
Nigeria,10/11/2008,11,0,0,0,0,0,0,11
Nigeria,11/11/2008,31,0,2,0,10,1,0,44
Nigeria,12/11/2008,13,0,0,0,18,0,0,31
Nigeria,13/11/2008,3,0,0,0,6,0,0,9
Nigeria,14/11/2008,1,0,0,0,24,0,0,25
Nigeria,15/11/2008,61,0,0,0,10,5,0,76
Nigeria,16/11/2008,44,0,0,0,0,0,0,44
Nigeria,17/11/2008,23,0,0,0,9,4,0,36
Nigeria,18/11/2008,27,0,0,0,3,8,0,38
Nigeria,19/11/2008,5,0,0,0,3,0,0,8
Nigeria,20/11/2008,15,0,0,0,3,1,0,19
Nigeria,21/11/2008,0,0,0,0,0,0,0,0
Nigeria,22/11/2008,3,0,0,0,-2,0,0,1
Nigeria,23/11/2008,20,0,0,0,3,2,0,25
Nigeria,24/11/2008,20,0,0,0,7,0,0,27
Nigeria,25/11/2008,24,0,0,0,0,1,0,25
Nigeria,26/11/2008,38,0,0,0,6,0,0,44
Nigeria,27/11/2008,21,0,0,0,3,0,0,24
Nigeria,28/11/2008,37,0,0,0,6,1,0,44
Nigeria,29/11/2008,138,0,0,0,15,11,0,164
Nigeria,30/11/2008,135,0,-2,0,21,7,0,161
Pakistan,01/11/2008,49,0,-7,0,30,13,0,85
Pakistan,02/11/2008,45,0,-1,0,33,9,0,86
Pakistan,03/11/2008,64,2,0,0,16,3,0,85
Pakistan,04/11/2008,99,2,0,0,15,12,0,128
Pakistan,05/11/2008,106,0,0,0,2,1,0,109
Pakistan,06/11/2008,79,0,0,0,1,1,0,81
Pakistan,07/11/2008,43,0,0,0,30,3,0,76
Pakistan,08/11/2008,12,0,-1,0,3,4,0,18
Pakistan,09/11/2008,47,0,0,0,7,0,0,54
Pakistan,10/11/2008,63,0,1,0,25,6,0,95
Pakistan,11/11/2008,93,0,0,0,3,3,0,99
Pakistan,12/11/2008,21,0,0,0,14,4,0,39
Pakistan,13/11/2008,155,2,0,0,33,2,0,192
Pakistan,14/11/2008,80,2,-2,0,26,3,0,109
Pakistan,15/11/2008,42,0,-2,0,31,0,0,71
Pakistan,16/11/2008,19,2,-1,0,19,1,0,40
Pakistan,17/11/2008,34,0,0,0,18,14,0,66
Pakistan,18/11/2008,85,0,0,0,24,6,0,115
Pakistan,19/11/2008,60,0,0,0,10,3,0,73
Pakistan,20/11/2008,29,0,0,0,17,0,0,46
Pakistan,21/11/2008,4,0,0,0,1,1,0,6
Pakistan,22/11/2008,37,0,0,0,0,0,0,37
Pakistan,23/11/2008,104,0,0,0,-4,5,0,105
Pakistan,24/11/2008,50,4,-2,0,1,2,0,55
Pakistan,25/11/2008,45,0,0,0,16,1,0,62
Pakistan,26/11/2008,73,0,-1,0,40,6,0,118
Pakistan,27/11/2008,81,0,-4,0,93,8,0,178
Pakistan,28/11/2008,207,0,0,0,70,23,0,300
Pakistan,29/11/2008,136,6,0,0,31,18,0,191
Pakistan,30/11/2008,163,0,-2,0,27,16,0,204
Sierra Leone,03/11/2008,2,0,0,0,0,0,0,2
Sierra Leone,04/11/2008,2,0,0,0,0,0,0,2
Sierra Leone,05/11/2008,0,0,0,0,0,0,0,0
Sierra Leone,06/11/2008,6,0,0,0,0,0,0,6
Sierra Leone,07/11/2008,3,0,0,0,0,0,0,3
Sierra Leone,09/11/2008,0,0,0,0,0,1,0,1
Sierra Leone,10/11/2008,0,0,0,0,0,0,0,0
Sierra Leone,11/11/2008,0,0,0,0,0,0,0,0
Sierra Leone,14/11/2008,10,0,0,0,3,1,0,14
Sierra Leone,18/11/2008,6,0,0,0,0,0,0,6
Sierra Leone,20/11/2008,0,0,0,0,-4,0,0,-4
Sierra Leone,21/11/2008,0,0,0,0,0,0,0,0
Sierra Leone,23/11/2008,1,0,0,0,0,0,0,1
Sierra Leone,24/11/2008,0,0,0,0,0,0,0,0
Sierra Leone,25/11/2008,0,0,0,0,0,0,0,0
Sierra Leone,26/11/2008,0,0,0,0,9,0,0,9
Sierra Leone,27/11/2008,1,0,0,0,11,0,0,12
Sierra Leone,28/11/2008,14,0,0,0,-1,0,0,13
Sierra Leone,29/11/2008,0,0,0,0,0,0,0,0
Somalia,01/11/2008,8,0,0,0,2,0,0,10
Somalia,02/11/2008,59,0,0,0,2,5,0,66
Somalia,03/11/2008,42,0,-2,0,31,0,0,71
Somalia,04/11/2008,33,2,0,0,24,0,0,59
Somalia,05/11/2008,12,0,0,0,55,1,0,68
Somalia,06/11/2008,6,0,0,0,24,0,0,30
Somalia,07/11/2008,19,0,0,0,0,4,0,23
Somalia,08/11/2008,5,0,0,0,12,0,0,17
Somalia,09/11/2008,62,0,0,0,6,0,0,68
Somalia,10/11/2008,108,0,0,0,92,1,0,201
Somalia,11/11/2008,81,2,2,0,30,6,0,121
Somalia,12/11/2008,111,0,0,0,23,6,0,140
Somalia,13/11/2008,99,0,0,0,12,3,0,114
Somalia,14/11/2008,37,0,0,0,13,1,0,51
Somalia,15/11/2008,19,0,0,0,5,2,0,26
Somalia,16/11/2008,52,0,0,0,-8,4,0,48
Somalia,17/11/2008,80,0,0,0,44,6,0,130
Somalia,18/11/2008,221,0,0,0,57,19,0,297
Somalia,19/11/2008,246,0,2,0,223,10,0,481
Somalia,20/11/2008,186,4,0,0,117,8,0,315
Somalia,21/11/2008,26,0,0,0,12,9,0,47
Somalia,22/11/2008,3,0,0,0,7,2,0,12
Somalia,23/11/2008,79,0,0,0,21,5,0,105
Somalia,24/11/2008,152,0,1,0,38,30,0,221
Somalia,25/11/2008,139,0,0,0,56,9,0,204
Somalia,26/11/2008,96,0,0,0,20,3,0,119
Somalia,27/11/2008,44,0,0,0,27,0,0,71
Somalia,28/11/2008,29,0,0,0,1,5,0,35
Somalia,29/11/2008,22,0,0,0,27,1,0,50
Somalia,30/11/2008,39,0,0,0,10,0,0,49
Syria,01/11/2008,73,0,0,0,5,0,0,78
Syria,02/11/2008,47,0,0,0,7,0,0,54
Syria,03/11/2008,39,0,0,0,26,8,0,73
Syria,04/11/2008,14,0,0,0,0,2,0,16
Syria,05/11/2008,14,0,0,0,1,0,0,15
Syria,06/11/2008,32,4,0,0,12,0,0,48
Syria,07/11/2008,24,0,0,0,6,1,0,31
Syria,08/11/2008,10,0,0,0,6,0,0,16
Syria,09/11/2008,13,0,0,0,4,3,0,20
Syria,10/11/2008,51,0,2,0,24,7,0,84
Syria,11/11/2008,46,0,0,0,7,0,0,53
Syria,12/11/2008,24,0,1,0,6,0,0,31
Syria,13/11/2008,-1,0,0,0,9,0,0,8
Syria,14/11/2008,12,0,2,0,3,0,0,17
Syria,15/11/2008,36,0,0,0,0,0,0,36
Syria,16/11/2008,32,0,-1,0,0,3,0,34
Syria,17/11/2008,22,0,0,0,-7,0,0,15
Syria,18/11/2008,20,0,0,0,-8,0,0,12
Syria,19/11/2008,5,0,0,0,7,2,0,14
Syria,20/11/2008,17,0,0,0,3,4,0,24
Syria,21/11/2008,9,0,0,0,3,0,0,12
Syria,22/11/2008,1,0,0,0,9,0,0,10
Syria,23/11/2008,16,0,0,0,1,6,0,23
Syria,24/11/2008,16,4,0,0,4,0,0,24
Syria,25/11/2008,29,2,0,0,-4,1,0,28
Syria,26/11/2008,18,0,0,0,-2,1,0,17
Syria,27/11/2008,23,0,0,0,9,2,0,34
Syria,28/11/2008,22,0,0,0,18,3,0,43
Syria,29/11/2008,7,2,0,0,6,4,0,19
Syria,30/11/2008,19,0,0,0,0,0,0,19
Yemen,01/11/2008,0,0,0,0,3,2,0,5
Yemen,02/11/2008,3,0,0,0,6,3,0,12
Yemen,03/11/2008,42,0,0,0,102,2,0,146
Yemen,04/11/2008,35,0,0,0,84,7,0,126
Yemen,05/11/2008,22,0,0,0,9,0,0,31
Yemen,06/11/2008,3,0,0,0,3,0,0,6
Yemen,07/11/2008,0,0,0,0,0,0,0,0
Yemen,08/11/2008,0,0,0,0,10,0,0,10
Yemen,09/11/2008,0,0,0,0,0,0,0,0
Yemen,10/11/2008,19,0,0,0,-1,0,0,18
Yemen,11/11/2008,10,0,0,0,0,2,0,12
Yemen,12/11/2008,26,0,0,0,-2,0,0,24
Yemen,13/11/2008,29,0,0,0,6,0,0,35
Yemen,14/11/2008,3,0,0,0,9,9,0,21
Yemen,15/11/2008,16,0,0,0,27,5,0,48
Yemen,16/11/2008,0,0,1,0,21,0,0,22
Yemen,17/11/2008,4,0,0,0,6,2,0,12
Yemen,18/11/2008,4,0,0,0,8,1,0,13
Yemen,19/11/2008,21,0,0,0,10,6,0,37
Yemen,20/11/2008,28,0,0,0,3,8,0,39
Yemen,21/11/2008,0,0,0,0,0,2,0,2
Yemen,22/11/2008,0,0,0,0,-4,0,0,-4
Yemen,23/11/2008,0,0,0,0,-2,0,0,-2
Yemen,24/11/2008,6,0,1,0,13,2,0,22
Yemen,25/11/2008,32,0,0,0,77,4,0,113
Yemen,26/11/2008,30,0,-1,0,34,1,0,64
Yemen,27/11/2008,12,0,0,0,30,13,0,55
Yemen,28/11/2008,2,0,0,0,15,0,0,17
Yemen,29/11/2008,2,0,0,0,0,0,0,2
Yemen,30/11/2008,2,0,0,0,6,0,0,8
Afghanistan,01/01/2008,7,0,0,0,3,0,0,10
Afghanistan,02/01/2008,140,4,0,0,49,4,0,197
Afghanistan,03/01/2008,30,0,-2,0,7,0,0,35
Afghanistan,04/01/2008,35,4,0,0,0,15,0,54
Afghanistan,05/01/2008,31,4,0,0,-10,10,0,35
Afghanistan,06/01/2008,49,0,0,0,8,7,0,64
Afghanistan,07/01/2008,106,0,0,0,15,11,0,132
Afghanistan,08/01/2008,62,0,1,0,32,9,0,104
Afghanistan,09/01/2008,164,0,1,0,39,7,0,211
Afghanistan,10/01/2008,180,0,2,0,67,15,0,264
Afghanistan,11/01/2008,126,0,2,0,35,11,0,174
Afghanistan,12/01/2008,62,0,0,0,4,6,0,72
Afghanistan,13/01/2008,88,0,0,0,-4,2,0,86
Afghanistan,14/01/2008,199,0,1,0,28,20,0,248
Afghanistan,15/01/2008,108,0,0,0,25,10,0,143
Afghanistan,16/01/2008,200,0,-1,0,27,19,0,245
Afghanistan,17/01/2008,123,0,2,0,52,26,0,203
Afghanistan,18/01/2008,167,0,3,0,59,20,0,249
Afghanistan,19/01/2008,129,0,-4,0,42,2,0,169
Afghanistan,20/01/2008,153,0,0,0,90,9,0,252
Afghanistan,21/01/2008,77,0,1,0,14,11,0,103
Afghanistan,22/01/2008,200,2,-2,0,96,14,0,310
Afghanistan,23/01/2008,213,4,-2,0,54,8,0,277
Afghanistan,24/01/2008,213,6,-4,0,71,19,0,305
Afghanistan,25/01/2008,94,0,0,0,24,8,0,126
Afghanistan,26/01/2008,118,0,0,0,50,1,0,169
Afghanistan,27/01/2008,92,0,-4,0,14,1,0,103
Afghanistan,28/01/2008,148,0,-4,0,37,1,0,182
Afghanistan,29/01/2008,270,0,0,0,51,8,0,329
Afghanistan,30/01/2008,186,0,0,0,23,11,0,220
Afghanistan,31/01/2008,125,0,0,0,15,26,0,166
Albania,01/01/2008,0,0,0,0,0,0,0,0
Albania,02/01/2008,6,0,-1,0,6,1,0,12
Albania,03/01/2008,6,0,-2,0,0,0,0,4
Albania,04/01/2008,4,0,-14,0,0,1,0,-9
Albania,05/01/2008,5,0,0,0,0,0,0,5
Albania,06/01/2008,-3,0,0,0,0,0,0,-3
Albania,07/01/2008,5,0,0,0,0,0,0,5
Albania,08/01/2008,5,0,-1,0,0,0,0,4
Albania,09/01/2008,18,0,-5,0,3,0,0,16
Albania,10/01/2008,25,0,-7,0,-5,5,0,18
Albania,11/01/2008,6,0,-1,0,-8,1,0,-2
Albania,12/01/2008,13,0,0,0,0,0,0,13
Albania,14/01/2008,22,0,-4,0,0,1,0,19
Albania,15/01/2008,16,0,1,0,9,0,0,26
Albania,16/01/2008,14,0,-8,0,15,0,0,21
Albania,17/01/2008,11,0,-7,0,-4,0,0,0
Albania,18/01/2008,9,0,-10,0,6,0,0,5
Albania,19/01/2008,0,0,-2,0,0,0,0,-2
Albania,20/01/2008,3,0,-4,0,6,1,0,6
Albania,21/01/2008,3,0,-22,0,3,13,0,-3
Albania,22/01/2008,6,0,-5,0,1,0,0,2
Albania,23/01/2008,19,0,-8,0,0,0,0,11
Albania,24/01/2008,23,0,-7,0,0,4,0,20
Albania,25/01/2008,13,0,-6,0,9,2,0,18
Albania,26/01/2008,2,0,-1,0,0,2,0,3
Albania,27/01/2008,7,0,-2,0,0,0,0,5
Albania,28/01/2008,7,0,-3,0,-1,0,0,3
Albania,29/01/2008,8,0,-3,0,18,1,0,24
Albania,30/01/2008,6,0,-6,0,20,0,0,20
Albania,31/01/2008,10,0,-2,0,3,1,0,12
Algeria,02/01/2008,3,0,0,0,0,0,0,3
Algeria,03/01/2008,8,0,0,0,0,3,0,11
Algeria,04/01/2008,2,0,0,0,0,0,0,2
Algeria,05/01/2008,0,0,0,0,3,0,0,3
Algeria,06/01/2008,6,0,0,0,0,-4,0,2
Algeria,07/01/2008,3,0,0,0,0,0,0,3
Algeria,08/01/2008,-1,0,0,0,0,0,0,-1
Algeria,09/01/2008,12,0,0,0,2,0,0,14
Algeria,10/01/2008,8,0,0,0,0,0,0,8
Algeria,11/01/2008,5,0,0,0,12,0,0,17
Algeria,12/01/2008,3,0,0,0,12,0,0,15
Algeria,13/01/2008,3,0,0,0,0,0,0,3
Algeria,14/01/2008,2,0,0,0,3,0,0,5
Algeria,15/01/2008,0,0,0,0,0,0,0,0
Algeria,16/01/2008,0,0,0,0,0,0,0,0
Algeria,17/01/2008,4,0,0,0,3,0,0,7
Algeria,18/01/2008,3,0,0,0,0,0,0,3
Algeria,19/01/2008,0,0,0,0,6,0,0,6
Algeria,20/01/2008,0,0,0,0,0,0,0,0
Algeria,21/01/2008,5,0,0,0,0,0,0,5
Algeria,22/01/2008,5,0,0,0,9,1,0,15
Algeria,23/01/2008,2,0,0,0,0,0,0,2
Algeria,24/01/2008,2,0,0,0,1,0,0,3
Algeria,25/01/2008,6,0,0,0,0,1,0,7
Algeria,26/01/2008,2,0,0,0,0,0,0,2
Algeria,27/01/2008,0,0,0,0,0,0,0,0
Algeria,28/01/2008,1,0,0,0,0,0,0,1
Algeria,29/01/2008,20,0,0,0,6,0,0,26
Algeria,30/01/2008,9,0,0,0,1,0,0,10
Algeria,31/01/2008,1,0,0,0,0,0,0,1
Bangladesh,01/01/2008,5,0,0,0,0,0,0,5
Bangladesh,02/01/2008,10,2,0,0,3,0,0,15
Bangladesh,03/01/2008,0,0,0,0,-2,0,0,-2
Bangladesh,04/01/2008,2,0,0,0,0,0,0,2
Bangladesh,05/01/2008,6,0,0,0,0,0,0,6
Bangladesh,06/01/2008,18,0,-2,0,9,3,0,28
Bangladesh,07/01/2008,14,0,0,0,1,0,0,15
Bangladesh,08/01/2008,10,0,-2,0,0,0,0,8
Bangladesh,09/01/2008,10,2,0,0,4,0,0,16
Bangladesh,10/01/2008,8,0,-3,0,27,0,0,32
Bangladesh,11/01/2008,16,0,2,0,0,2,0,20
Bangladesh,12/01/2008,2,0,-2,0,3,3,0,6
Bangladesh,13/01/2008,12,0,-2,0,16,0,0,26
Bangladesh,14/01/2008,14,0,0,0,3,2,0,19
Bangladesh,15/01/2008,6,0,0,0,8,2,0,16
Bangladesh,16/01/2008,44,0,-4,0,13,4,0,57
Bangladesh,17/01/2008,13,0,-1,0,12,9,0,33
Bangladesh,18/01/2008,19,0,0,0,0,1,0,20
Bangladesh,19/01/2008,7,0,0,0,-3,2,0,6
Bangladesh,20/01/2008,24,4,1,0,7,0,0,36
Bangladesh,21/01/2008,4,2,-4,0,0,1,0,3
Bangladesh,22/01/2008,14,0,0,0,0,0,0,14
Bangladesh,23/01/2008,38,0,0,0,12,0,0,50
Bangladesh,24/01/2008,13,0,0,0,3,2,0,18
Bangladesh,25/01/2008,10,0,0,0,6,3,0,19
Bangladesh,26/01/2008,0,0,0,0,6,0,0,6
Bangladesh,27/01/2008,9,0,0,0,6,0,0,15
Bangladesh,28/01/2008,3,0,0,0,9,0,0,12
Bangladesh,29/01/2008,22,0,0,0,3,0,0,25
Bangladesh,30/01/2008,3,0,0,0,16,0,0,19
Bangladesh,31/01/2008,3,0,0,0,9,3,0,15
Cameroon,02/01/2008,-2,0,0,0,-2,0,0,-4
Cameroon,04/01/2008,0,0,0,0,0,0,0,0
Cameroon,07/01/2008,0,0,0,0,0,0,0,0
Cameroon,08/01/2008,1,0,0,0,0,0,0,1
Cameroon,09/01/2008,0,0,0,0,0,0,0,0
Cameroon,10/01/2008,0,0,0,0,0,1,0,1
Cameroon,14/01/2008,0,0,0,0,0,0,0,0
Cameroon,15/01/2008,0,0,0,0,0,0,0,0
Cameroon,17/01/2008,3,0,0,0,0,0,0,3
Cameroon,18/01/2008,-2,0,0,0,0,0,0,-2
Cameroon,19/01/2008,0,0,0,0,9,0,0,9
Cameroon,20/01/2008,0,0,0,0,0,0,0,0
Cameroon,21/01/2008,0,0,0,0,0,0,0,0
Cameroon,22/01/2008,9,0,0,0,0,0,0,9
Cameroon,23/01/2008,1,0,0,0,0,0,0,1
Cameroon,24/01/2008,0,0,0,0,0,2,0,2
Cameroon,25/01/2008,1,0,0,0,3,0,0,4
Cameroon,29/01/2008,1,0,0,0,0,0,0,1
Cameroon,30/01/2008,-1,0,0,0,0,0,0,-1
Cameroon,31/01/2008,0,0,0,0,0,0,0,0
China,01/01/2008,5,0,0,0,0,0,0,5
China,02/01/2008,39,0,-1,0,71,8,0,117
China,03/01/2008,36,0,3,0,29,0,0,68
China,04/01/2008,31,4,3,0,52,6,0,96
China,05/01/2008,9,0,-1,0,2,4,0,14
China,06/01/2008,11,0,0,0,11,4,0,26
China,07/01/2008,47,0,-4,0,15,11,0,69
China,08/01/2008,32,0,0,0,17,2,0,51
China,09/01/2008,47,4,-1,0,27,25,0,102
China,10/01/2008,76,0,-2,0,36,12,0,122
China,11/01/2008,57,4,0,0,56,7,0,124
China,12/01/2008,-9,0,-5,0,35,10,0,31
China,13/01/2008,16,0,1,0,6,9,0,32
China,14/01/2008,49,0,-5,0,37,6,0,87
China,15/01/2008,49,0,0,0,5,2,0,56
China,16/01/2008,49,2,-2,0,20,6,0,75
China,17/01/2008,43,0,-1,0,12,11,0,65
China,18/01/2008,61,0,2,0,18,12,0,93
China,19/01/2008,22,0,-8,0,22,0,0,36
China,20/01/2008,64,0,-8,0,64,3,0,123
China,21/01/2008,36,0,-5,0,10,2,0,43
China,22/01/2008,10,2,1,0,10,6,0,29
China,23/01/2008,60,2,0,0,17,4,0,83
China,24/01/2008,39,0,-1,0,13,0,0,51
China,25/01/2008,72,0,-2,0,31,4,0,105
China,26/01/2008,33,0,-3,0,36,2,0,68
China,27/01/2008,12,0,-6,0,15,3,0,24
China,28/01/2008,38,2,2,0,34,2,0,78
China,29/01/2008,80,0,-2,0,43,9,0,130
China,30/01/2008,48,0,0,0,44,6,0,98
China,31/01/2008,69,2,-6,0,22,3,0,90
Egypt,01/01/2008,8,0,0,0,12,0,0,20
Egypt,02/01/2008,38,2,1,0,6,6,0,53
Egypt,03/01/2008,22,0,0,0,3,2,0,27
Egypt,04/01/2008,19,0,0,0,19,0,0,38
Egypt,05/01/2008,13,0,1,0,1,0,0,15
Egypt,06/01/2008,9,0,0,0,9,0,0,18
Egypt,07/01/2008,11,0,0,0,22,5,0,38
Egypt,08/01/2008,44,0,0,0,2,0,0,46
Egypt,09/01/2008,14,0,1,0,-7,1,0,9
Egypt,10/01/2008,18,0,0,0,15,1,0,34
Egypt,11/01/2008,24,0,1,0,77,1,0,103
Egypt,12/01/2008,2,0,0,0,4,0,0,6
Egypt,13/01/2008,15,0,0,0,-10,1,0,6
Egypt,14/01/2008,14,0,0,0,6,1,0,21
Egypt,15/01/2008,40,0,3,0,12,6,0,61
Egypt,16/01/2008,48,0,-2,0,-5,1,0,42
Egypt,17/01/2008,34,0,1,0,3,3,0,41
Egypt,18/01/2008,19,0,1,0,-8,0,0,12
Egypt,19/01/2008,31,0,0,0,9,0,0,40
Egypt,20/01/2008,25,0,0,0,12,2,0,39
Egypt,21/01/2008,62,0,-1,0,-4,6,0,63
Egypt,22/01/2008,145,2,-2,0,58,48,0,251
Egypt,23/01/2008,216,0,7,0,81,32,0,336
Egypt,24/01/2008,267,2,8,0,52,17,0,346
Egypt,25/01/2008,327,0,17,0,83,34,0,461
Egypt,26/01/2008,91,0,14,0,24,11,0,140
Egypt,27/01/2008,27,0,4,0,13,9,0,53
Egypt,28/01/2008,37,0,1,0,-2,0,0,36
Egypt,29/01/2008,57,0,4,0,28,1,0,90
Egypt,30/01/2008,115,0,3,0,45,7,0,170
Egypt,31/01/2008,31,0,4,0,3,10,0,48
Eritrea,01/01/2008,2,0,0,0,0,0,0,2
Eritrea,02/01/2008,11,0,0,0,-2,0,0,9
Eritrea,05/01/2008,0,0,0,0,3,2,0,5
Eritrea,09/01/2008,0,0,0,0,0,0,0,0
Eritrea,10/01/2008,0,0,0,0,0,1,0,1
Eritrea,12/01/2008,0,0,1,0,0,0,0,1
Eritrea,13/01/2008,4,0,0,0,0,0,0,4
Eritrea,14/01/2008,2,0,0,0,-3,0,0,-1
Eritrea,15/01/2008,6,0,0,0,0,0,0,6
Eritrea,16/01/2008,0,0,0,0,0,0,0,0
Eritrea,17/01/2008,0,0,0,0,3,0,0,3
Eritrea,18/01/2008,14,0,0,0,0,0,0,14
Eritrea,19/01/2008,0,0,0,0,3,0,0,3
Eritrea,20/01/2008,0,0,0,0,-4,0,0,-4
Eritrea,21/01/2008,0,0,0,0,0,0,0,0
Eritrea,22/01/2008,0,0,0,0,0,0,0,0
Eritrea,23/01/2008,4,0,0,0,3,0,0,7
Eritrea,24/01/2008,21,0,0,0,0,0,0,21
Eritrea,25/01/2008,27,0,0,0,0,0,0,27
Eritrea,26/01/2008,0,0,0,0,0,0,0,0
Eritrea,27/01/2008,2,0,0,0,0,0,0,2
Eritrea,28/01/2008,0,0,0,0,0,0,0,0
Eritrea,29/01/2008,0,0,0,0,0,0,0,0
Eritrea,30/01/2008,5,0,0,0,3,0,0,8
Eritrea,31/01/2008,8,0,0,0,0,1,0,9
Georgia,01/01/2008,-3,0,0,0,0,0,0,-3
Georgia,02/01/2008,0,0,0,0,3,0,0,3
Georgia,03/01/2008,3,0,0,0,3,0,0,6
Georgia,04/01/2008,4,0,0,0,12,2,0,18
Georgia,05/01/2008,0,0,0,0,6,3,0,9
Georgia,06/01/2008,4,0,2,0,3,2,0,11
Georgia,07/01/2008,2,0,-2,0,6,1,0,7
Georgia,08/01/2008,3,0,1,0,9,2,0,15
Georgia,09/01/2008,21,0,1,0,2,0,0,24
Georgia,10/01/2008,8,0,-1,0,7,0,0,14
Georgia,11/01/2008,22,0,0,0,12,2,0,36
Georgia,12/01/2008,9,0,0,0,3,4,0,16
Georgia,13/01/2008,3,0,1,0,-2,1,0,3
Georgia,14/01/2008,10,0,0,0,4,1,0,15
Georgia,15/01/2008,12,0,0,0,3,0,0,15
Georgia,16/01/2008,30,0,0,0,12,8,0,50
Georgia,17/01/2008,11,0,0,0,9,4,0,24
Georgia,18/01/2008,14,0,0,0,-1,2,0,15
Georgia,19/01/2008,2,0,0,0,-2,2,0,2
Georgia,20/01/2008,3,0,4,0,0,8,0,15
Georgia,21/01/2008,18,0,-2,0,3,4,0,23
Georgia,22/01/2008,25,0,0,0,0,0,0,25
Georgia,23/01/2008,8,0,0,0,0,0,0,8
Georgia,24/01/2008,11,0,0,0,5,2,0,18
Georgia,25/01/2008,13,0,-6,0,3,2,0,12
Georgia,26/01/2008,5,0,0,0,3,1,0,9
Georgia,27/01/2008,3,0,0,0,0,1,0,4
Georgia,28/01/2008,0,0,0,0,0,0,0,0
Georgia,29/01/2008,11,0,1,0,1,3,0,16
Georgia,30/01/2008,14,0,1,0,0,0,0,15
Georgia,31/01/2008,27,0,0,0,22,1,0,50
India,01/01/2008,4,0,0,0,0,1,0,5
India,02/01/2008,143,0,1,0,54,13,0,211
India,03/01/2008,28,0,0,0,-1,6,0,33
India,04/01/2008,25,0,0,0,11,2,0,38
India,05/01/2008,19,0,-2,0,1,0,0,18
India,06/01/2008,25,0,0,0,6,1,0,32
India,07/01/2008,25,0,0,0,15,2,0,42
India,08/01/2008,23,0,1,0,-3,5,0,26
India,09/01/2008,12,0,0,0,15,4,0,31
India,10/01/2008,31,0,0,0,58,11,0,100
India,11/01/2008,36,0,0,0,2,4,0,42
India,12/01/2008,23,0,0,0,0,1,0,24
India,13/01/2008,26,0,1,0,0,2,0,29
India,14/01/2008,26,0,1,0,17,6,0,50
India,15/01/2008,38,0,0,0,34,4,0,76
India,16/01/2008,44,0,-1,0,0,0,0,43
India,17/01/2008,21,2,-1,0,18,3,0,43
India,18/01/2008,44,0,-4,0,10,2,0,52
India,19/01/2008,24,0,0,0,6,0,0,30
India,20/01/2008,5,0,0,0,6,0,0,11
India,21/01/2008,55,0,-1,0,4,7,0,65
India,22/01/2008,21,2,-1,0,12,2,0,36
India,23/01/2008,28,0,0,0,15,6,0,49
India,24/01/2008,34,0,-2,0,13,3,0,48
India,25/01/2008,44,0,-6,0,12,4,0,54
India,26/01/2008,21,0,-6,0,22,1,0,38
India,27/01/2008,16,0,2,0,13,1,0,32
India,28/01/2008,22,0,1,0,30,1,0,54
India,29/01/2008,8,0,0,0,2,0,0,10
India,30/01/2008,37,0,0,0,30,1,0,68
India,31/01/2008,39,0,0,0,7,2,0,48
Iran,01/01/2008,5,0,0,0,3,0,0,8
Iran,02/01/2008,77,0,-3,0,23,1,0,98
Iran,03/01/2008,32,0,-2,0,28,2,0,60
Iran,04/01/2008,47,0,-4,0,27,2,0,72
Iran,05/01/2008,16,0,0,0,22,5,0,43
Iran,06/01/2008,5,0,3,0,-1,0,0,7
Iran,07/01/2008,22,0,0,0,30,2,0,54
Iran,08/01/2008,72,2,0,0,-1,10,0,83
Iran,09/01/2008,113,0,1,0,-3,17,0,128
Iran,10/01/2008,68,0,-2,0,11,12,0,89
Iran,11/01/2008,97,0,0,0,2,10,0,109
Iran,12/01/2008,92,0,-2,0,12,8,0,110
Iran,13/01/2008,45,0,-1,0,1,4,0,49
Iran,14/01/2008,108,0,1,0,-6,5,0,108
Iran,15/01/2008,77,0,0,0,1,3,0,81
Iran,16/01/2008,95,0,0,0,8,9,0,112
Iran,17/01/2008,77,0,-2,0,14,1,0,90
Iran,18/01/2008,58,0,-7,0,-11,9,0,49
Iran,19/01/2008,39,0,0,0,27,1,0,67
Iran,20/01/2008,33,0,0,0,14,4,0,51
Iran,21/01/2008,42,0,-4,0,7,9,0,54
Iran,22/01/2008,30,0,2,0,34,3,0,69
Iran,23/01/2008,30,2,1,0,17,1,0,51
Iran,24/01/2008,64,0,0,0,10,2,0,76
Iran,25/01/2008,8,0,-2,0,12,2,0,20
Iran,26/01/2008,39,0,-1,0,12,6,0,56
Iran,27/01/2008,9,0,0,0,7,3,0,19
Iran,28/01/2008,16,0,0,0,3,0,0,19
Iran,29/01/2008,22,0,0,0,6,3,0,31
Iran,30/01/2008,29,0,0,0,9,3,0,41
Iran,31/01/2008,61,0,0,0,25,19,0,105
Iraq,01/01/2008,13,4,0,0,2,2,0,21
Iraq,02/01/2008,155,6,1,0,10,23,0,195
Iraq,03/01/2008,44,0,-2,0,20,6,0,68
Iraq,04/01/2008,127,4,-2,0,14,21,0,164
Iraq,05/01/2008,74,4,0,0,-6,8,0,80
Iraq,06/01/2008,80,0,1,0,7,11,0,99
Iraq,07/01/2008,71,0,1,0,-14,7,0,65
Iraq,08/01/2008,152,2,0,0,2,10,0,166
Iraq,09/01/2008,173,2,1,0,25,8,0,209
Iraq,10/01/2008,149,0,1,0,50,28,0,228
Iraq,11/01/2008,107,2,1,0,-4,13,0,119
Iraq,12/01/2008,68,0,-2,0,4,5,0,75
Iraq,13/01/2008,44,0,0,0,8,4,0,56
Iraq,14/01/2008,67,2,1,0,21,2,0,93
Iraq,15/01/2008,143,0,0,0,29,7,0,179
Iraq,16/01/2008,142,0,0,0,36,25,0,203
Iraq,17/01/2008,65,2,0,0,24,7,0,98
Iraq,18/01/2008,174,0,1,0,29,9,0,213
Iraq,19/01/2008,34,0,1,0,15,2,0,52
Iraq,20/01/2008,23,0,1,0,15,14,0,53
Iraq,21/01/2008,48,0,1,0,12,9,0,70
Iraq,22/01/2008,53,4,-2,0,21,3,0,79
Iraq,23/01/2008,96,0,-1,0,13,5,0,113
Iraq,24/01/2008,121,0,1,0,39,20,0,181
Iraq,25/01/2008,69,2,-4,0,54,17,0,138
Iraq,26/01/2008,56,0,-2,0,-2,15,0,67
Iraq,27/01/2008,17,0,-2,0,21,5,0,41
Iraq,28/01/2008,37,0,1,0,-1,9,0,46
Iraq,29/01/2008,170,2,2,0,32,10,0,216
Iraq,30/01/2008,96,2,0,0,18,12,0,128
Iraq,31/01/2008,213,0,1,0,27,10,0,251
Morocco,02/01/2008,1,0,0,0,4,0,0,5
Morocco,03/01/2008,0,0,0,0,0,0,0,0
Morocco,04/01/2008,0,0,0,0,3,0,0,3
Morocco,05/01/2008,0,0,0,0,0,1,0,1
Morocco,06/01/2008,0,0,0,0,0,0,0,0
Morocco,07/01/2008,6,0,0,0,12,0,0,18
Morocco,08/01/2008,3,0,0,0,0,0,0,3
Morocco,09/01/2008,10,0,0,0,3,0,0,13
Morocco,10/01/2008,9,0,0,0,0,0,0,9
Morocco,11/01/2008,0,0,0,0,0,0,0,0
Morocco,12/01/2008,0,0,0,0,0,0,0,0
Morocco,13/01/2008,0,0,0,0,0,0,0,0
Morocco,14/01/2008,11,0,0,0,4,0,0,15
Morocco,15/01/2008,2,0,0,0,0,0,0,2
Morocco,16/01/2008,15,0,0,0,0,0,0,15
Morocco,17/01/2008,6,0,0,0,0,0,0,6
Morocco,18/01/2008,21,0,0,0,-2,1,0,20
Morocco,19/01/2008,1,0,0,0,6,0,0,7
Morocco,20/01/2008,0,0,0,0,6,0,0,6
Morocco,21/01/2008,2,0,0,0,-2,5,0,5
Morocco,22/01/2008,0,0,0,0,0,0,0,0
Morocco,23/01/2008,0,0,0,0,0,0,0,0
Morocco,24/01/2008,8,0,0,0,31,1,0,40
Morocco,25/01/2008,4,0,0,0,9,0,0,13
Morocco,26/01/2008,0,0,0,0,3,1,0,4
Morocco,27/01/2008,6,0,0,0,0,0,0,6
Morocco,28/01/2008,6,0,0,0,42,0,0,48
Morocco,29/01/2008,2,0,0,0,6,0,0,8
Morocco,30/01/2008,-1,0,0,0,0,0,0,-1
Morocco,31/01/2008,6,0,0,0,3,0,0,9
Nigeria,01/01/2008,0,0,0,0,0,0,0,0
Nigeria,02/01/2008,9,4,-2,0,15,2,0,28
Nigeria,03/01/2008,6,2,0,0,0,4,0,12
Nigeria,04/01/2008,6,0,0,0,0,0,0,6
Nigeria,05/01/2008,1,0,0,0,3,0,0,4
Nigeria,06/01/2008,6,0,0,0,0,0,0,6
Nigeria,07/01/2008,24,0,0,0,3,0,0,27
Nigeria,08/01/2008,22,0,0,0,2,0,0,24
Nigeria,09/01/2008,8,0,0,0,-4,0,0,4
Nigeria,10/01/2008,8,0,0,0,6,1,0,15
Nigeria,11/01/2008,14,0,0,0,9,0,0,23
Nigeria,12/01/2008,0,0,0,0,0,0,0,0
Nigeria,13/01/2008,6,0,0,0,0,0,0,6
Nigeria,14/01/2008,15,0,-1,0,-4,0,0,10
Nigeria,15/01/2008,11,0,2,0,18,0,0,31
Nigeria,16/01/2008,12,0,-2,0,3,3,0,16
Nigeria,17/01/2008,10,0,0,0,0,0,0,10
Nigeria,18/01/2008,8,0,0,0,-1,0,0,7
Nigeria,19/01/2008,2,0,0,0,-3,0,0,-1
Nigeria,20/01/2008,1,0,0,0,0,2,0,3
Nigeria,21/01/2008,11,0,0,0,6,0,0,17
Nigeria,22/01/2008,3,0,0,0,6,3,0,12
Nigeria,23/01/2008,8,0,0,0,12,0,0,20
Nigeria,24/01/2008,8,0,0,0,6,0,0,14
Nigeria,25/01/2008,1,0,0,0,0,1,0,2
Nigeria,26/01/2008,0,0,0,0,3,0,0,3
Nigeria,27/01/2008,1,0,0,0,6,0,0,7
Nigeria,28/01/2008,0,0,0,0,4,0,0,4
Nigeria,29/01/2008,0,0,0,0,21,4,0,25
Nigeria,30/01/2008,3,0,0,0,-4,0,0,-1
Nigeria,31/01/2008,2,0,0,0,0,13,0,15
Pakistan,01/01/2008,7,0,0,0,0,2,0,9
Pakistan,02/01/2008,193,6,-3,0,34,24,0,254
Pakistan,03/01/2008,30,0,4,0,-4,3,0,33
Pakistan,04/01/2008,40,0,-2,0,7,8,0,53
Pakistan,05/01/2008,27,0,0,0,-1,1,0,27
Pakistan,06/01/2008,77,2,0,0,11,4,0,94
Pakistan,07/01/2008,86,0,0,0,6,6,0,98
Pakistan,08/01/2008,20,0,2,0,23,3,0,48
Pakistan,09/01/2008,58,0,1,0,17,1,0,77
Pakistan,10/01/2008,81,4,0,0,36,23,0,144
Pakistan,11/01/2008,79,0,-4,0,17,10,0,102
Pakistan,12/01/2008,63,0,1,0,5,2,0,71
Pakistan,13/01/2008,22,0,0,0,3,0,0,25
Pakistan,14/01/2008,60,0,2,0,12,5,0,79
Pakistan,15/01/2008,54,0,0,0,30,1,0,85
Pakistan,16/01/2008,67,0,-1,0,37,3,0,106
Pakistan,17/01/2008,57,0,0,0,13,3,0,73
Pakistan,18/01/2008,72,0,0,0,-1,5,0,76
Pakistan,19/01/2008,47,0,1,0,20,2,0,70
Pakistan,20/01/2008,19,0,0,0,9,0,0,28
Pakistan,21/01/2008,86,0,-4,0,18,3,0,103
Pakistan,22/01/2008,56,2,-4,0,4,7,0,65
Pakistan,23/01/2008,63,0,0,0,19,7,0,89
Pakistan,24/01/2008,81,0,-17,0,7,3,0,74
Pakistan,25/01/2008,134,0,-4,0,18,12,0,160
Pakistan,26/01/2008,86,0,-8,0,14,9,0,101
Pakistan,27/01/2008,66,0,0,0,6,7,0,79
Pakistan,28/01/2008,79,0,1,0,31,7,0,118
Pakistan,29/01/2008,47,0,0,0,14,2,0,63
Pakistan,30/01/2008,46,0,0,0,22,6,0,74
Pakistan,31/01/2008,66,0,0,0,22,19,0,107
Sierra Leone,02/01/2008,-2,0,0,0,0,0,0,-2
Sierra Leone,03/01/2008,0,0,0,0,0,0,0,0
Sierra Leone,04/01/2008,5,0,0,0,0,0,0,5
Sierra Leone,06/01/2008,5,0,-1,0,3,0,0,7
Sierra Leone,07/01/2008,30,0,2,0,12,8,0,52
Sierra Leone,08/01/2008,9,0,0,0,9,10,0,28
Sierra Leone,09/01/2008,22,0,0,0,9,5,0,36
Sierra Leone,10/01/2008,36,0,0,0,12,3,0,51
Sierra Leone,11/01/2008,2,0,0,0,3,6,0,11
Sierra Leone,14/01/2008,4,0,0,0,6,0,0,10
Sierra Leone,15/01/2008,0,0,2,0,18,0,0,20
Sierra Leone,16/01/2008,0,0,-2,0,1,0,0,-1
Sierra Leone,18/01/2008,2,2,0,0,0,0,0,4
Sierra Leone,19/01/2008,9,0,0,0,0,0,0,9
Sierra Leone,20/01/2008,6,0,0,0,0,0,0,6
Sierra Leone,21/01/2008,-3,0,0,0,0,0,0,-3
Sierra Leone,22/01/2008,3,0,0,0,-4,0,0,-1
Sierra Leone,23/01/2008,6,0,0,0,3,0,0,9
Sierra Leone,24/01/2008,3,0,0,0,0,0,0,3
Sierra Leone,25/01/2008,0,0,0,0,0,0,0,0
Sierra Leone,28/01/2008,2,0,0,0,9,0,0,11
Sierra Leone,29/01/2008,0,0,0,0,0,0,0,0
Sierra Leone,30/01/2008,0,0,0,0,0,0,0,0
Sierra Leone,31/01/2008,0,0,0,0,0,0,0,0
Somalia,01/01/2008,3,0,0,0,0,0,0,3
Somalia,02/01/2008,57,0,0,0,-8,5,0,54
Somalia,03/01/2008,2,2,0,0,4,0,0,8
Somalia,04/01/2008,5,0,-4,0,-10,0,0,-9
Somalia,05/01/2008,1,0,1,0,0,0,0,2
Somalia,06/01/2008,12,0,0,0,0,0,0,12
Somalia,07/01/2008,5,0,2,0,3,0,0,10
Somalia,08/01/2008,0,0,0,0,0,0,0,0
Somalia,09/01/2008,12,0,0,0,0,0,0,12
Somalia,10/01/2008,16,0,0,0,0,-12,0,4
Somalia,11/01/2008,11,0,1,0,3,0,0,15
Somalia,12/01/2008,2,0,0,0,0,0,0,2
Somalia,13/01/2008,6,0,0,0,0,0,0,6
Somalia,14/01/2008,25,0,0,0,1,0,0,26
Somalia,15/01/2008,10,0,0,0,-6,2,0,6
Somalia,16/01/2008,11,0,0,0,0,1,0,12
Somalia,17/01/2008,0,0,0,0,0,0,0,0
Somalia,18/01/2008,17,0,0,0,13,0,0,30
Somalia,19/01/2008,9,0,0,0,0,1,0,10
Somalia,20/01/2008,10,0,0,0,6,1,0,17
Somalia,21/01/2008,5,0,0,0,8,0,0,13
Somalia,22/01/2008,17,0,0,0,6,1,0,24
Somalia,23/01/2008,12,0,1,0,12,3,0,28
Somalia,24/01/2008,18,0,0,0,12,2,0,32
Somalia,25/01/2008,1,0,0,0,6,8,0,15
Somalia,26/01/2008,5,0,0,0,0,0,0,5
Somalia,27/01/2008,-1,0,0,0,0,0,0,-1
Somalia,28/01/2008,4,0,0,0,4,0,0,8
Somalia,29/01/2008,6,2,0,0,0,0,0,8
Somalia,30/01/2008,22,0,0,0,0,3,0,25
Somalia,31/01/2008,14,0,1,0,-4,1,0,12
Syria,01/01/2008,0,0,0,0,0,0,0,0
Syria,02/01/2008,47,0,0,0,8,1,0,56
Syria,03/01/2008,9,0,0,0,0,0,0,9
Syria,04/01/2008,29,0,-2,0,13,2,0,42
Syria,05/01/2008,12,0,0,0,-2,1,0,11
Syria,06/01/2008,3,0,1,0,0,0,0,4
Syria,07/01/2008,5,0,0,0,3,0,0,8
Syria,08/01/2008,25,0,0,0,3,1,0,29
Syria,09/01/2008,18,0,0,0,6,1,0,25
Syria,10/01/2008,20,0,0,0,-2,0,0,18
Syria,11/01/2008,13,0,0,0,16,0,0,29
Syria,12/01/2008,4,0,0,0,0,0,0,4
Syria,13/01/2008,0,0,0,0,0,0,0,0
Syria,14/01/2008,28,0,0,0,8,0,0,36
Syria,15/01/2008,50,0,0,0,8,19,0,77
Syria,16/01/2008,62,0,-4,0,29,8,0,95
Syria,17/01/2008,7,0,0,0,39,12,0,58
Syria,18/01/2008,19,0,1,0,4,9,0,33
Syria,19/01/2008,5,0,2,0,10,0,0,17
Syria,20/01/2008,25,0,0,0,21,5,0,51
Syria,21/01/2008,19,0,0,0,5,4,0,28
Syria,22/01/2008,5,0,1,0,0,1,0,7
Syria,23/01/2008,4,0,0,0,3,1,0,8
Syria,24/01/2008,24,0,0,0,3,4,0,31
Syria,25/01/2008,62,2,0,0,3,22,0,89
Syria,26/01/2008,21,0,0,0,3,2,0,26
Syria,27/01/2008,16,0,0,0,0,1,0,17
Syria,28/01/2008,8,0,0,0,9,9,0,26
Syria,29/01/2008,32,0,0,0,30,7,0,69
Syria,30/01/2008,39,0,0,0,6,0,0,45
Syria,31/01/2008,10,0,0,0,12,2,0,24
Yemen,02/01/2008,0,0,0,0,1,0,0,1
Yemen,03/01/2008,0,0,0,0,3,0,0,3
Yemen,04/01/2008,0,0,0,0,3,0,0,3
Yemen,05/01/2008,0,0,0,0,0,0,0,0
Yemen,06/01/2008,0,0,0,0,0,0,0,0
Yemen,07/01/2008,0,0,0,0,-4,0,0,-4
Yemen,08/01/2008,9,0,0,0,3,0,0,12
Yemen,09/01/2008,5,0,0,0,3,0,0,8
Yemen,10/01/2008,11,0,0,0,3,2,0,16
Yemen,11/01/2008,14,0,0,0,6,0,0,20
Yemen,12/01/2008,8,0,0,0,-10,0,0,-2
Yemen,13/01/2008,36,0,0,0,8,1,0,45
Yemen,14/01/2008,20,0,0,0,4,4,0,28
Yemen,15/01/2008,0,0,0,0,3,-2,0,1
Yemen,16/01/2008,9,0,0,0,0,0,0,9
Yemen,17/01/2008,0,0,0,0,0,0,0,0
Yemen,18/01/2008,22,0,0,0,4,4,0,30
Yemen,19/01/2008,17,0,0,0,3,0,0,20
Yemen,20/01/2008,6,0,0,0,0,0,0,6
Yemen,21/01/2008,3,0,0,0,0,0,0,3
Yemen,22/01/2008,17,0,0,0,9,0,0,26
Yemen,23/01/2008,2,0,0,0,6,0,0,8
Yemen,24/01/2008,3,0,0,0,9,0,0,12
Yemen,25/01/2008,3,0,0,0,9,0,0,12
Yemen,26/01/2008,7,0,0,0,6,0,0,13
Yemen,27/01/2008,5,0,0,0,0,0,0,5
Yemen,28/01/2008,5,0,0,0,-1,0,0,4
Yemen,29/01/2008,0,0,0,0,6,0,0,6
Yemen,30/01/2008,9,0,0,0,3,0,0,12
Yemen,31/01/2008,0,0,0,0,0,0,0,0
Afghanistan,01/02/2013,85,0,0,0,37,20,0,142
Afghanistan,02/02/2013,65,0,-1,0,27,10,0,101
Afghanistan,03/02/2013,41,0,-4,0,24,8,0,69
Afghanistan,04/02/2013,106,6,0,0,31,6,0,149
Afghanistan,05/02/2013,99,0,-1,0,65,14,0,177
Afghanistan,06/02/2013,128,0,0,0,-2,8,0,134
Afghanistan,07/02/2013,107,0,0,0,14,7,0,128
Afghanistan,08/02/2013,202,4,-1,0,9,13,0,227
Afghanistan,09/02/2013,79,0,0,0,-8,1,0,72
Afghanistan,10/02/2013,164,0,-4,0,40,10,0,210
Afghanistan,11/02/2013,163,0,3,0,36,6,0,208
Afghanistan,12/02/2013,145,0,0,0,60,13,0,218
Afghanistan,13/02/2013,75,0,-8,0,32,14,0,113
Afghanistan,14/02/2013,98,4,-5,0,50,7,0,154
Afghanistan,15/02/2013,127,0,1,0,17,14,0,159
Afghanistan,16/02/2013,16,0,1,0,1,4,0,22
Afghanistan,17/02/2013,140,0,1,0,52,6,0,199
Afghanistan,18/02/2013,125,0,-1,0,34,51,0,209
Afghanistan,19/02/2013,97,4,-5,0,49,46,0,191
Afghanistan,20/02/2013,157,2,-5,0,53,10,0,217
Afghanistan,21/02/2013,122,0,0,0,10,29,0,161
Afghanistan,22/02/2013,200,6,0,0,13,13,0,232
Afghanistan,23/02/2013,64,2,0,0,45,8,0,119
Afghanistan,24/02/2013,146,2,-10,0,98,15,0,251
Afghanistan,25/02/2013,85,2,-1,0,61,13,0,160
Afghanistan,26/02/2013,234,2,0,0,39,48,0,323
Afghanistan,27/02/2013,120,4,1,0,65,26,0,216
Afghanistan,28/02/2013,188,0,-8,0,14,13,0,207
Albania,01/02/2013,17,0,0,0,0,7,0,24
Albania,02/02/2013,1,0,0,0,0,0,0,1
Albania,04/02/2013,-3,0,0,0,0,0,0,-3
Albania,05/02/2013,2,0,-2,0,-2,4,0,2
Albania,06/02/2013,5,0,0,0,0,0,0,5
Albania,07/02/2013,13,0,0,0,0,0,0,13
Albania,08/02/2013,0,0,0,0,0,0,0,0
Albania,09/02/2013,0,0,0,0,0,0,0,0
Albania,10/02/2013,4,0,0,0,0,0,0,4
Albania,11/02/2013,3,0,-1,0,0,0,0,2
Albania,12/02/2013,4,0,0,0,0,2,0,6
Albania,13/02/2013,5,0,0,0,0,0,0,5
Albania,14/02/2013,-7,0,0,0,0,2,0,-5
Albania,15/02/2013,-2,0,0,0,0,0,0,-2
Albania,16/02/2013,0,0,0,0,3,0,0,3
Albania,17/02/2013,13,0,0,0,-2,0,0,11
Albania,18/02/2013,0,0,-1,0,0,0,0,-1
Albania,19/02/2013,13,0,-1,0,0,2,0,14
Albania,20/02/2013,22,0,2,0,0,0,0,24
Albania,21/02/2013,10,0,0,0,3,0,0,13
Albania,22/02/2013,0,0,0,0,0,0,0,0
Albania,23/02/2013,14,0,0,0,0,0,0,14
Albania,24/02/2013,17,0,0,0,3,5,0,25
Albania,25/02/2013,3,0,0,0,3,4,0,10
Albania,26/02/2013,8,0,0,0,16,2,0,26
Albania,27/02/2013,2,0,0,0,6,0,0,8
Albania,28/02/2013,49,0,0,0,-2,3,0,50
Algeria,01/02/2013,59,0,1,0,15,5,0,80
Algeria,02/02/2013,42,0,0,0,20,0,0,62
Algeria,03/02/2013,17,0,0,0,16,0,0,33
Algeria,04/02/2013,56,0,0,0,9,0,0,65
Algeria,05/02/2013,30,0,0,0,22,6,0,58
Algeria,06/02/2013,10,0,0,0,4,0,0,14
Algeria,07/02/2013,29,0,0,0,24,1,0,54
Algeria,08/02/2013,45,0,0,0,24,6,0,75
Algeria,09/02/2013,21,0,0,0,3,4,0,28
Algeria,10/02/2013,106,0,0,0,22,2,0,130
Algeria,11/02/2013,46,0,0,0,0,3,0,49
Algeria,12/02/2013,41,0,0,0,6,0,0,47
Algeria,13/02/2013,13,0,0,0,-6,8,0,15
Algeria,14/02/2013,35,0,0,0,6,5,0,46
Algeria,15/02/2013,18,0,-1,0,1,7,0,25
Algeria,16/02/2013,4,0,0,0,3,2,0,9
Algeria,17/02/2013,4,0,0,0,0,1,0,5
Algeria,18/02/2013,7,4,0,0,9,0,0,20
Algeria,19/02/2013,12,0,0,0,-2,4,0,14
Algeria,20/02/2013,25,0,0,0,3,0,0,28
Algeria,21/02/2013,399,2,-11,0,152,41,0,583
Algeria,22/02/2013,52,0,-2,0,9,0,0,59
Algeria,23/02/2013,19,0,0,0,0,0,0,19
Algeria,24/02/2013,10,0,0,0,0,0,0,10
Algeria,25/02/2013,5,0,0,0,3,0,0,8
Algeria,26/02/2013,39,0,0,0,12,0,0,51
Algeria,27/02/2013,32,0,0,0,6,3,0,41
Algeria,28/02/2013,23,0,0,0,3,8,0,34
Bangladesh,01/02/2013,27,0,0,0,6,9,0,42
Bangladesh,02/02/2013,-1,0,0,0,-2,0,0,-3
Bangladesh,03/02/2013,22,0,0,0,8,0,0,30
Bangladesh,04/02/2013,27,0,0,0,12,3,0,42
Bangladesh,05/02/2013,22,0,0,0,18,4,0,44
Bangladesh,06/02/2013,24,2,0,0,16,7,0,49
Bangladesh,07/02/2013,50,0,0,0,15,5,0,70
Bangladesh,08/02/2013,10,0,0,0,-5,6,0,11
Bangladesh,09/02/2013,0,0,0,0,3,0,0,3
Bangladesh,10/02/2013,41,0,0,0,4,7,0,52
Bangladesh,11/02/2013,27,0,0,0,15,10,0,52
Bangladesh,12/02/2013,18,0,-4,0,9,2,0,25
Bangladesh,13/02/2013,26,0,0,0,19,13,0,58
Bangladesh,14/02/2013,19,0,1,0,6,5,0,31
Bangladesh,15/02/2013,20,0,2,0,33,6,0,61
Bangladesh,16/02/2013,0,0,0,0,0,0,0,0
Bangladesh,17/02/2013,27,0,0,0,36,8,0,71
Bangladesh,18/02/2013,42,2,3,0,30,15,0,92
Bangladesh,19/02/2013,16,0,0,0,9,8,0,33
Bangladesh,20/02/2013,30,0,1,0,7,6,0,44
Bangladesh,21/02/2013,30,0,0,0,6,0,0,36
Bangladesh,22/02/2013,35,0,0,0,12,14,0,61
Bangladesh,23/02/2013,45,4,1,0,13,8,0,71
Bangladesh,24/02/2013,5,0,1,0,9,4,0,19
Bangladesh,25/02/2013,27,0,0,0,3,5,0,35
Bangladesh,26/02/2013,11,0,0,0,9,4,0,24
Bangladesh,27/02/2013,25,0,-2,0,16,3,0,42
Bangladesh,28/02/2013,108,0,0,0,83,14,0,205
Cameroon,01/02/2013,-1,0,0,0,3,0,0,2
Cameroon,02/02/2013,0,0,0,0,12,0,0,12
Cameroon,03/02/2013,0,0,0,0,12,0,0,12
Cameroon,04/02/2013,0,0,0,0,3,0,0,3
Cameroon,05/02/2013,0,0,0,0,0,0,0,0
Cameroon,06/02/2013,8,0,0,0,0,0,0,8
Cameroon,07/02/2013,8,0,0,0,0,0,0,8
Cameroon,08/02/2013,1,0,0,0,12,0,0,13
Cameroon,09/02/2013,0,2,0,0,3,0,0,5
Cameroon,11/02/2013,0,0,0,0,0,0,0,0
Cameroon,12/02/2013,1,2,0,0,0,1,0,4
Cameroon,13/02/2013,0,0,0,0,0,1,0,1
Cameroon,14/02/2013,0,0,0,0,6,0,0,6
Cameroon,15/02/2013,0,0,0,0,0,0,0,0
Cameroon,16/02/2013,0,0,0,0,24,0,0,24
Cameroon,17/02/2013,0,0,0,0,6,0,0,6
Cameroon,18/02/2013,0,0,0,0,6,0,0,6
Cameroon,19/02/2013,8,0,-4,0,48,0,0,52
Cameroon,20/02/2013,4,0,-2,0,18,0,0,20
Cameroon,21/02/2013,26,0,0,0,9,4,0,39
Cameroon,22/02/2013,4,0,-4,0,9,0,0,9
Cameroon,23/02/2013,3,0,0,0,15,0,0,18
Cameroon,24/02/2013,0,0,0,0,3,0,0,3
Cameroon,25/02/2013,1,0,0,0,4,0,0,5
Cameroon,26/02/2013,6,0,0,0,18,0,0,24
Cameroon,27/02/2013,0,0,0,0,0,0,0,0
Cameroon,28/02/2013,3,0,0,0,9,0,0,12
China,01/02/2013,87,2,-6,0,68,15,0,166
China,02/02/2013,86,2,3,0,33,7,0,131
China,03/02/2013,61,0,-12,0,13,15,0,77
China,04/02/2013,151,6,0,0,72,18,0,247
China,05/02/2013,86,2,-11,0,42,15,0,134
China,06/02/2013,185,2,-4,0,65,15,0,263
China,07/02/2013,167,0,-13,0,62,13,0,229
China,08/02/2013,68,2,1,0,53,23,0,147
China,09/02/2013,43,0,2,0,13,13,0,71
China,10/02/2013,102,2,-1,0,53,7,0,163
China,11/02/2013,74,0,-10,0,24,10,0,98
China,12/02/2013,105,4,3,0,62,20,0,194
China,13/02/2013,134,0,0,0,23,43,0,200
China,14/02/2013,158,4,-3,0,25,32,0,216
China,15/02/2013,103,6,-5,0,7,12,0,123
China,16/02/2013,24,0,-2,0,2,6,0,30
China,17/02/2013,116,0,-3,0,57,17,0,187
China,18/02/2013,181,12,0,0,31,13,0,237
China,19/02/2013,176,4,-1,0,41,10,0,230
China,20/02/2013,225,2,-7,0,89,27,0,336
China,21/02/2013,181,6,-2,0,100,26,0,311
China,22/02/2013,85,2,1,0,76,23,0,187
China,23/02/2013,74,0,0,0,72,11,0,157
China,24/02/2013,98,0,0,0,28,15,0,141
China,25/02/2013,50,2,0,0,15,8,0,75
China,26/02/2013,120,10,-6,0,37,21,0,182
China,27/02/2013,158,6,-1,0,68,30,0,261
China,28/02/2013,170,6,-2,0,18,16,0,208
Egypt,01/02/2013,100,0,-1,0,77,59,0,235
Egypt,02/02/2013,41,0,-2,0,31,7,0,77
Egypt,03/02/2013,56,0,-8,0,30,23,0,101
Egypt,04/02/2013,115,0,-10,0,90,31,0,226
Egypt,05/02/2013,101,0,-18,0,56,10,0,149
Egypt,06/02/2013,115,0,-3,0,26,20,0,158
Egypt,07/02/2013,638,4,-5,0,291,123,0,1051
Egypt,08/02/2013,101,0,0,0,24,23,0,148
Egypt,09/02/2013,20,0,0,0,28,9,0,57
Egypt,10/02/2013,76,0,1,0,40,4,0,121
Egypt,11/02/2013,81,4,-12,0,50,24,0,147
Egypt,12/02/2013,56,0,1,0,35,27,0,119
Egypt,13/02/2013,68,0,-4,0,45,25,0,134
Egypt,14/02/2013,79,0,-1,0,29,15,0,122
Egypt,15/02/2013,56,0,-4,0,21,6,0,79
Egypt,16/02/2013,12,0,0,0,15,7,0,34
Egypt,17/02/2013,28,0,0,0,22,11,0,61
Egypt,18/02/2013,51,2,-4,0,15,11,0,75
Egypt,19/02/2013,71,0,-5,0,37,19,0,122
Egypt,20/02/2013,51,0,1,0,49,18,0,119
Egypt,21/02/2013,68,0,4,0,29,18,0,119
Egypt,22/02/2013,65,0,6,0,9,16,0,96
Egypt,23/02/2013,72,0,-7,0,29,35,0,129
Egypt,24/02/2013,39,4,5,0,28,23,0,99
Egypt,25/02/2013,32,0,7,0,25,28,0,92
Egypt,26/02/2013,96,0,-38,0,42,27,0,127
Egypt,27/02/2013,96,0,-11,0,6,19,0,110
Egypt,28/02/2013,31,0,-3,0,54,10,0,92
Eritrea,01/02/2013,5,0,0,0,5,1,0,11
Eritrea,02/02/2013,0,0,0,0,3,0,0,3
Eritrea,03/02/2013,0,0,0,0,0,0,0,0
Eritrea,04/02/2013,0,0,0,0,3,0,0,3
Eritrea,05/02/2013,4,0,0,0,0,0,0,4
Eritrea,06/02/2013,1,0,0,0,0,0,0,1
Eritrea,07/02/2013,3,0,0,0,9,0,0,12
Eritrea,08/02/2013,0,0,0,0,0,0,0,0
Eritrea,10/02/2013,3,0,0,0,0,0,0,3
Eritrea,11/02/2013,3,0,0,0,4,0,0,7
Eritrea,12/02/2013,3,0,0,0,6,0,0,9
Eritrea,13/02/2013,0,0,0,0,0,0,0,0
Eritrea,14/02/2013,0,0,0,0,0,0,0,0
Eritrea,16/02/2013,2,0,0,0,0,0,0,2
Eritrea,18/02/2013,2,0,0,0,3,0,0,5
Eritrea,19/02/2013,0,0,0,0,0,0,0,0
Eritrea,20/02/2013,0,0,0,0,0,0,0,0
Eritrea,23/02/2013,1,0,0,0,0,0,0,1
Eritrea,24/02/2013,0,0,0,0,0,0,0,0
Eritrea,25/02/2013,5,0,0,0,0,0,0,5
Eritrea,27/02/2013,3,0,0,0,0,0,0,3
Georgia,01/02/2013,3,0,0,0,0,0,0,3
Georgia,02/02/2013,7,0,0,0,0,0,0,7
Georgia,03/02/2013,0,0,0,0,6,0,0,6
Georgia,04/02/2013,0,0,0,0,9,0,0,9
Georgia,05/02/2013,4,0,0,0,0,0,0,4
Georgia,06/02/2013,5,0,-2,0,12,0,0,15
Georgia,07/02/2013,2,0,0,0,3,0,0,5
Georgia,08/02/2013,5,0,0,0,0,0,0,5
Georgia,09/02/2013,3,0,0,0,0,0,0,3
Georgia,10/02/2013,0,0,0,0,-2,0,0,-2
Georgia,11/02/2013,1,0,0,0,0,0,0,1
Georgia,12/02/2013,0,0,0,0,0,1,0,1
Georgia,13/02/2013,0,0,0,0,15,0,0,15
Georgia,14/02/2013,3,0,0,0,15,2,0,20
Georgia,15/02/2013,0,0,0,0,15,0,0,15
Georgia,16/02/2013,0,0,0,0,6,0,0,6
Georgia,17/02/2013,-2,0,0,0,0,0,0,-2
Georgia,18/02/2013,-2,0,0,0,0,2,0,0
Georgia,19/02/2013,6,0,0,0,3,1,0,10
Georgia,20/02/2013,-2,0,0,0,0,1,0,-1
Georgia,21/02/2013,3,0,0,0,15,0,0,18
Georgia,22/02/2013,8,0,0,0,0,0,0,8
Georgia,23/02/2013,1,0,0,0,0,0,0,1
Georgia,25/02/2013,16,0,0,0,0,0,0,16
Georgia,26/02/2013,10,0,0,0,6,0,0,16
Georgia,27/02/2013,0,0,0,0,-6,0,0,-6
Georgia,28/02/2013,11,0,0,0,0,0,0,11
India,01/02/2013,31,0,-4,0,14,8,0,49
India,02/02/2013,58,0,1,0,12,28,0,99
India,03/02/2013,68,0,0,0,2,11,0,81
India,04/02/2013,53,0,0,0,19,11,0,83
India,05/02/2013,65,4,-6,0,34,25,0,122
India,06/02/2013,70,0,-9,0,-2,24,0,83
India,07/02/2013,37,0,-5,0,44,8,0,84
India,08/02/2013,71,0,-5,0,19,12,0,97
India,09/02/2013,42,0,-2,0,28,6,0,74
India,10/02/2013,79,0,-3,0,15,10,0,101
India,11/02/2013,67,2,1,0,17,9,0,96
India,12/02/2013,80,2,-6,0,94,18,0,188
India,13/02/2013,80,0,1,0,44,46,0,171
India,14/02/2013,82,0,-4,0,14,29,0,121
India,15/02/2013,123,0,-5,0,26,15,0,159
India,16/02/2013,13,0,1,0,8,0,0,22
India,17/02/2013,33,2,-4,0,26,5,0,62
India,18/02/2013,63,2,0,0,2,13,0,80
India,19/02/2013,97,0,-3,0,26,22,0,142
India,20/02/2013,64,4,1,0,34,19,0,122
India,21/02/2013,54,2,2,0,8,13,0,79
India,22/02/2013,45,0,0,0,3,14,0,62
India,23/02/2013,44,0,-3,0,4,8,0,53
India,24/02/2013,60,0,-1,0,-2,4,0,61
India,25/02/2013,30,0,0,0,15,6,0,51
India,26/02/2013,41,2,2,0,24,7,0,76
India,27/02/2013,68,0,-2,0,28,9,0,103
India,28/02/2013,67,0,0,0,31,9,0,107
Iran,01/02/2013,193,0,-6,0,33,40,0,260
Iran,02/02/2013,120,0,2,0,14,10,0,146
Iran,03/02/2013,95,0,0,0,3,13,0,111
Iran,04/02/2013,195,0,5,0,34,26,0,260
Iran,05/02/2013,213,0,-6,0,71,34,0,312
Iran,06/02/2013,195,10,-1,0,-7,14,0,211
Iran,07/02/2013,162,0,-10,0,42,6,0,200
Iran,08/02/2013,96,2,-4,0,13,26,0,133
Iran,09/02/2013,165,0,0,0,30,4,0,199
Iran,10/02/2013,89,0,4,0,29,1,0,123
Iran,11/02/2013,57,0,-10,0,41,13,0,101
Iran,12/02/2013,146,4,-5,0,58,16,0,219
Iran,13/02/2013,168,0,1,0,11,4,0,184
Iran,14/02/2013,180,0,2,0,18,7,0,207
Iran,15/02/2013,84,0,2,0,45,7,0,138
Iran,16/02/2013,23,0,0,0,0,0,0,23
Iran,17/02/2013,113,0,-4,0,58,19,0,186
Iran,18/02/2013,48,0,-1,0,18,8,0,73
Iran,19/02/2013,58,0,0,0,60,7,0,125
Iran,20/02/2013,50,2,-3,0,64,7,0,120
Iran,21/02/2013,78,0,2,0,27,7,0,114
Iran,22/02/2013,124,0,-1,0,32,0,0,155
Iran,23/02/2013,67,2,2,0,32,2,0,105
Iran,24/02/2013,78,0,0,0,18,0,0,96
Iran,25/02/2013,24,0,1,0,55,6,0,86
Iran,26/02/2013,153,0,-1,0,60,19,0,231
Iran,27/02/2013,135,0,-4,0,18,11,0,160
Iran,28/02/2013,764,8,-24,0,339,101,0,1188
Iraq,01/02/2013,118,0,1,0,29,7,0,155
Iraq,02/02/2013,42,2,0,0,16,7,0,67
Iraq,03/02/2013,135,0,0,0,16,9,0,160
Iraq,04/02/2013,249,0,6,0,71,12,0,338
Iraq,05/02/2013,150,2,0,0,53,0,0,205
Iraq,06/02/2013,82,0,-2,0,39,8,0,127
Iraq,07/02/2013,158,0,2,0,38,25,0,223
Iraq,08/02/2013,155,0,0,0,4,21,0,180
Iraq,09/02/2013,98,0,3,0,8,11,0,120
Iraq,10/02/2013,79,0,0,0,-9,2,0,72
Iraq,11/02/2013,138,0,0,0,28,6,0,172
Iraq,12/02/2013,131,0,1,0,29,10,0,171
Iraq,13/02/2013,96,2,0,0,29,4,0,131
Iraq,14/02/2013,89,0,0,0,24,3,0,116
Iraq,15/02/2013,56,2,4,0,10,7,0,79
Iraq,16/02/2013,6,0,2,0,0,11,0,19
Iraq,17/02/2013,72,0,3,0,16,1,0,92
Iraq,18/02/2013,116,0,6,0,7,3,0,132
Iraq,19/02/2013,39,0,0,0,35,11,0,85
Iraq,20/02/2013,33,0,2,0,9,10,0,54
Iraq,21/02/2013,62,4,2,0,7,17,0,92
Iraq,22/02/2013,34,0,2,0,14,8,0,58
Iraq,23/02/2013,21,0,3,0,7,5,0,36
Iraq,24/02/2013,37,0,2,0,4,6,0,49
Iraq,25/02/2013,32,0,0,0,1,2,0,35
Iraq,26/02/2013,92,0,1,0,37,22,0,152
Iraq,27/02/2013,179,0,-6,0,22,21,0,216
Iraq,28/02/2013,180,0,0,0,63,15,0,258
Morocco,01/02/2013,2,0,-1,0,6,0,0,7
Morocco,02/02/2013,0,0,0,0,0,0,0,0
Morocco,03/02/2013,6,0,0,0,0,0,0,6
Morocco,04/02/2013,0,0,0,0,6,0,0,6
Morocco,05/02/2013,8,0,0,0,9,2,0,19
Morocco,06/02/2013,13,0,0,0,0,4,0,17
Morocco,07/02/2013,2,0,0,0,3,0,0,5
Morocco,08/02/2013,24,0,0,0,18,0,0,42
Morocco,09/02/2013,3,0,0,0,0,0,0,3
Morocco,10/02/2013,0,0,0,0,0,0,0,0
Morocco,11/02/2013,5,0,0,0,9,0,0,14
Morocco,12/02/2013,12,0,0,0,0,0,0,12
Morocco,13/02/2013,0,0,0,0,0,0,0,0
Morocco,14/02/2013,0,0,0,0,-1,1,0,0
Morocco,15/02/2013,0,0,0,0,0,0,0,0
Morocco,17/02/2013,1,0,-4,0,21,0,0,18
Morocco,18/02/2013,-1,0,0,0,9,5,0,13
Morocco,19/02/2013,8,0,0,0,0,0,0,8
Morocco,20/02/2013,11,0,0,0,0,15,0,26
Morocco,21/02/2013,461,0,-18,0,201,47,0,691
Morocco,22/02/2013,12,0,0,0,6,0,0,18
Morocco,23/02/2013,6,0,0,0,33,0,0,39
Morocco,24/02/2013,10,0,0,0,4,1,0,15
Morocco,25/02/2013,9,0,0,0,0,0,0,9
Morocco,26/02/2013,9,0,0,0,0,0,0,9
Morocco,27/02/2013,2,0,0,0,1,0,0,3
Morocco,28/02/2013,10,0,0,0,24,4,0,38
Nigeria,01/02/2013,10,2,0,0,17,7,0,36
Nigeria,02/02/2013,13,0,0,0,3,1,0,17
Nigeria,03/02/2013,14,0,0,0,6,2,0,22
Nigeria,04/02/2013,38,4,0,0,4,1,0,47
Nigeria,05/02/2013,7,2,0,0,7,1,0,17
Nigeria,06/02/2013,24,2,0,0,-20,3,0,9
Nigeria,07/02/2013,21,2,1,0,12,2,0,38
Nigeria,08/02/2013,34,0,0,0,16,0,0,50
Nigeria,09/02/2013,9,0,0,0,-3,3,0,9
Nigeria,10/02/2013,36,0,5,0,-1,3,0,43
Nigeria,11/02/2013,21,0,-2,0,5,5,0,29
Nigeria,12/02/2013,47,0,-6,0,10,3,0,54
Nigeria,13/02/2013,43,2,0,0,19,3,0,67
Nigeria,14/02/2013,16,0,1,0,24,5,0,46
Nigeria,15/02/2013,39,0,0,0,15,1,0,55
Nigeria,16/02/2013,5,0,0,0,3,0,0,8
Nigeria,17/02/2013,32,0,1,0,37,1,0,71
Nigeria,18/02/2013,55,0,-6,0,46,4,0,99
Nigeria,19/02/2013,63,0,-1,0,104,5,0,171
Nigeria,20/02/2013,23,4,-3,0,82,5,0,111
Nigeria,21/02/2013,50,0,-4,0,11,4,0,61
Nigeria,22/02/2013,32,0,4,0,18,0,0,54
Nigeria,23/02/2013,29,0,-4,0,30,5,0,60
Nigeria,24/02/2013,14,0,-2,0,12,0,0,24
Nigeria,25/02/2013,18,0,0,0,2,0,0,20
Nigeria,26/02/2013,58,0,0,0,3,4,0,65
Nigeria,27/02/2013,18,0,-4,0,10,0,0,24
Nigeria,28/02/2013,39,0,-1,0,1,1,0,40
Pakistan,01/02/2013,88,0,-3,0,19,19,0,123
Pakistan,02/02/2013,120,0,0,0,9,10,0,139
Pakistan,03/02/2013,54,0,0,0,-3,5,0,56
Pakistan,04/02/2013,118,4,1,0,4,4,0,131
Pakistan,05/02/2013,163,2,-2,0,94,27,0,284
Pakistan,06/02/2013,88,0,0,0,29,10,0,127
Pakistan,07/02/2013,143,0,3,0,54,9,0,209
Pakistan,08/02/2013,151,0,-1,0,11,14,0,175
Pakistan,09/02/2013,86,0,0,0,52,3,0,141
Pakistan,10/02/2013,76,0,0,0,24,12,0,112
Pakistan,11/02/2013,92,0,-2,0,27,4,0,121
Pakistan,12/02/2013,84,0,-2,0,26,10,0,118
Pakistan,13/02/2013,108,0,-1,0,21,9,0,137
Pakistan,14/02/2013,112,0,1,0,44,13,0,170
Pakistan,15/02/2013,124,0,-1,0,13,17,0,153
Pakistan,16/02/2013,17,0,0,0,10,2,0,29
Pakistan,17/02/2013,55,0,-1,0,69,7,0,130
Pakistan,18/02/2013,96,0,0,0,39,10,0,145
Pakistan,19/02/2013,131,0,-8,0,97,31,0,251
Pakistan,20/02/2013,64,0,0,0,67,22,0,153
Pakistan,21/02/2013,94,2,0,0,29,17,0,142
Pakistan,22/02/2013,80,2,0,0,56,16,0,154
Pakistan,23/02/2013,42,2,0,0,47,17,0,108
Pakistan,24/02/2013,44,0,1,0,46,10,0,101
Pakistan,25/02/2013,42,0,0,0,12,0,0,54
Pakistan,26/02/2013,89,0,1,0,9,3,0,102
Pakistan,27/02/2013,89,0,1,0,56,8,0,154
Pakistan,28/02/2013,141,0,0,0,197,42,0,380
Sierra Leone,01/02/2013,0,0,0,0,0,0,0,0
Sierra Leone,03/02/2013,0,0,0,0,0,0,0,0
Sierra Leone,04/02/2013,0,0,0,0,0,0,0,0
Sierra Leone,05/02/2013,5,0,0,0,12,0,0,17
Sierra Leone,06/02/2013,0,0,0,0,12,0,0,12
Sierra Leone,07/02/2013,0,0,0,0,0,0,0,0
Sierra Leone,08/02/2013,3,0,0,0,0,0,0,3
Sierra Leone,09/02/2013,0,0,0,0,0,0,0,0
Sierra Leone,10/02/2013,0,0,0,0,6,0,0,6
Sierra Leone,11/02/2013,0,0,0,0,0,0,0,0
Sierra Leone,12/02/2013,0,0,0,0,0,0,0,0
Sierra Leone,13/02/2013,0,0,0,0,3,0,0,3
Sierra Leone,14/02/2013,9,0,0,0,18,6,0,33
Sierra Leone,15/02/2013,1,0,0,0,6,1,0,8
Sierra Leone,17/02/2013,0,0,0,0,3,0,0,3
Sierra Leone,18/02/2013,0,0,0,0,0,0,0,0
Sierra Leone,19/02/2013,0,0,0,0,3,0,0,3
Sierra Leone,20/02/2013,5,0,-2,0,3,0,0,6
Sierra Leone,21/02/2013,1,0,0,0,0,0,0,1
Sierra Leone,22/02/2013,0,0,0,0,0,0,0,0
Sierra Leone,23/02/2013,0,0,0,0,0,0,0,0
Sierra Leone,24/02/2013,0,0,0,0,0,0,0,0
Sierra Leone,25/02/2013,0,0,0,0,0,0,0,0
Sierra Leone,26/02/2013,9,0,0,0,3,0,0,12
Sierra Leone,27/02/2013,0,0,0,0,0,2,0,2
Sierra Leone,28/02/2013,2,0,0,0,0,0,0,2
Somalia,01/02/2013,68,0,2,0,7,9,0,86
Somalia,02/02/2013,69,0,0,0,10,1,0,80
Somalia,03/02/2013,41,0,-4,0,0,0,0,37
Somalia,04/02/2013,55,0,0,0,28,6,0,89
Somalia,05/02/2013,64,2,0,0,38,23,0,127
Somalia,06/02/2013,29,0,1,0,-1,1,0,30
Somalia,07/02/2013,48,6,0,0,21,8,0,83
Somalia,08/02/2013,47,0,0,0,2,6,0,55
Somalia,09/02/2013,22,0,0,0,9,1,0,32
Somalia,10/02/2013,19,0,0,0,6,1,0,26
Somalia,11/02/2013,13,0,1,0,0,0,0,14
Somalia,12/02/2013,11,0,0,0,0,2,0,13
Somalia,13/02/2013,7,0,0,0,3,0,0,10
Somalia,14/02/2013,18,0,-1,0,3,0,0,20
Somalia,15/02/2013,24,0,0,0,8,0,0,32
Somalia,16/02/2013,2,0,0,0,-8,0,0,-6
Somalia,17/02/2013,20,0,0,0,6,3,0,29
Somalia,18/02/2013,7,0,2,0,-3,0,0,6
Somalia,19/02/2013,6,0,0,0,4,0,0,10
Somalia,20/02/2013,7,0,0,0,22,0,0,29
Somalia,21/02/2013,87,0,0,0,15,1,0,103
Somalia,22/02/2013,29,2,-3,0,12,2,0,42
Somalia,23/02/2013,37,2,-2,0,48,3,0,88
Somalia,24/02/2013,6,0,0,0,15,0,0,21
Somalia,25/02/2013,0,0,0,0,6,2,0,8
Somalia,26/02/2013,0,0,0,0,5,3,0,8
Somalia,27/02/2013,40,0,0,0,20,2,0,62
Somalia,28/02/2013,27,0,-6,0,7,2,0,30
Syria,01/02/2013,405,2,-30,0,64,88,0,529
Syria,02/02/2013,192,0,-15,0,-4,27,0,200
Syria,03/02/2013,153,0,-5,0,-14,38,0,172
Syria,04/02/2013,207,0,-4,0,63,29,0,295
Syria,05/02/2013,332,0,-14,0,38,37,0,393
Syria,06/02/2013,239,2,-5,0,70,33,0,339
Syria,07/02/2013,377,4,-10,0,74,50,0,495
Syria,08/02/2013,162,4,-12,0,10,15,0,179
Syria,09/02/2013,79,0,0,0,30,5,0,114
Syria,10/02/2013,90,0,-2,0,15,16,0,119
Syria,11/02/2013,147,0,-8,0,-2,39,0,176
Syria,12/02/2013,183,0,-11,0,49,27,0,248
Syria,13/02/2013,202,0,-6,0,21,9,0,226
Syria,14/02/2013,242,0,-7,0,27,17,0,279
Syria,15/02/2013,240,2,0,0,53,9,0,304
Syria,16/02/2013,84,0,0,0,9,5,0,98
Syria,17/02/2013,247,0,-3,0,21,37,0,302
Syria,18/02/2013,203,2,6,0,67,41,0,319
Syria,19/02/2013,191,0,4,0,42,24,0,261
Syria,20/02/2013,154,0,0,0,106,19,0,279
Syria,21/02/2013,151,0,-6,0,63,19,0,227
Syria,22/02/2013,85,0,-6,0,9,21,0,109
Syria,23/02/2013,78,0,0,0,9,3,0,90
Syria,24/02/2013,165,0,-8,0,30,15,0,202
Syria,25/02/2013,137,0,-10,0,10,15,0,152
Syria,26/02/2013,187,0,2,0,19,10,0,218
Syria,27/02/2013,288,12,-2,0,4,30,0,332
Syria,28/02/2013,367,6,-24,0,15,63,0,427
Yemen,01/02/2013,47,0,0,0,3,4,0,54
Yemen,02/02/2013,25,0,1,0,9,0,0,35
Yemen,03/02/2013,8,0,1,0,6,3,0,18
Yemen,04/02/2013,39,0,0,0,24,4,0,67
Yemen,05/02/2013,79,0,2,0,58,0,0,139
Yemen,06/02/2013,95,0,0,0,43,1,0,139
Yemen,07/02/2013,92,0,-4,0,13,2,0,103
Yemen,08/02/2013,110,0,0,0,19,5,0,134
Yemen,09/02/2013,33,0,0,0,3,4,0,40
Yemen,10/02/2013,18,0,0,0,13,5,0,36
Yemen,11/02/2013,28,0,0,0,8,1,0,37
Yemen,12/02/2013,26,0,0,0,5,0,0,31
Yemen,13/02/2013,16,0,0,0,4,2,0,22
Yemen,14/02/2013,35,0,2,0,6,6,0,49
Yemen,15/02/2013,16,0,-1,0,-4,0,0,11
Yemen,16/02/2013,2,0,0,0,0,0,0,2
Yemen,17/02/2013,30,0,0,0,6,7,0,43
Yemen,18/02/2013,18,0,0,0,-4,1,0,15
Yemen,19/02/2013,5,0,-2,0,6,0,0,9
Yemen,20/02/2013,14,0,0,0,21,2,0,37
Yemen,21/02/2013,111,0,0,0,22,4,0,137
Yemen,22/02/2013,72,0,0,0,1,4,0,77
Yemen,23/02/2013,64,0,0,0,11,16,0,91
Yemen,24/02/2013,20,0,0,0,18,10,0,48
Yemen,25/02/2013,7,0,0,0,0,0,0,7
Yemen,26/02/2013,18,0,0,0,6,0,0,24
Yemen,27/02/2013,6,0,0,0,-3,0,0,3
Yemen,28/02/2013,10,2,0,0,2,1,0,15
Afghanistan,01/01/2011,144,2,1,0,60,17,0,224
Afghanistan,02/01/2011,252,0,0,0,8,8,0,268
Afghanistan,03/01/2011,220,0,-2,0,15,13,0,246
Afghanistan,04/01/2011,172,0,-5,0,65,36,0,268
Afghanistan,05/01/2011,150,0,-2,0,97,29,0,274
Afghanistan,06/01/2011,192,4,-2,0,64,25,0,283
Afghanistan,07/01/2011,323,6,0,0,97,36,0,462
Afghanistan,08/01/2011,130,0,0,0,72,22,0,224
Afghanistan,09/01/2011,119,6,-1,0,29,6,0,159
Afghanistan,10/01/2011,174,0,-9,0,26,11,0,202
Afghanistan,11/01/2011,186,0,-1,0,48,20,0,253
Afghanistan,12/01/2011,238,0,-6,0,30,40,0,302
Afghanistan,13/01/2011,226,4,0,0,55,22,0,307
Afghanistan,14/01/2011,689,8,-10,0,208,52,0,947
Afghanistan,15/01/2011,415,8,1,0,92,75,0,591
Afghanistan,16/01/2011,191,4,0,0,32,21,0,248
Afghanistan,17/01/2011,165,8,0,0,61,7,0,241
Afghanistan,18/01/2011,189,6,0,0,34,26,0,255
Afghanistan,19/01/2011,85,2,0,0,-2,28,0,113
Afghanistan,20/01/2011,23,0,3,0,12,2,0,40
Afghanistan,21/01/2011,54,0,0,0,-2,5,0,57
Afghanistan,22/01/2011,221,0,-3,0,73,15,0,306
Afghanistan,23/01/2011,282,4,1,0,83,9,0,379
Afghanistan,24/01/2011,207,2,0,0,53,16,0,278
Afghanistan,25/01/2011,190,4,0,0,51,45,0,290
Afghanistan,26/01/2011,171,10,7,0,26,18,0,232
Afghanistan,27/01/2011,195,0,0,0,45,28,0,268
Afghanistan,28/01/2011,174,0,1,0,36,24,0,235
Afghanistan,29/01/2011,191,8,0,0,14,48,0,261
Afghanistan,30/01/2011,78,2,-1,0,9,25,0,113
Afghanistan,31/01/2011,153,0,6,0,43,4,0,206
Albania,01/01/2011,1,0,0,0,3,0,0,4
Albania,02/01/2011,3,0,0,0,0,0,0,3
Albania,03/01/2011,2,0,0,0,6,0,0,8
Albania,04/01/2011,10,0,0,0,12,0,0,22
Albania,05/01/2011,3,0,-1,0,-1,0,0,1
Albania,06/01/2011,5,0,-1,0,3,0,0,7
Albania,07/01/2011,0,0,0,0,0,0,0,0
Albania,08/01/2011,3,0,0,0,4,1,0,8
Albania,09/01/2011,2,0,0,0,6,0,0,8
Albania,10/01/2011,3,0,-1,0,9,0,0,11
Albania,11/01/2011,5,0,0,0,33,0,0,38
Albania,12/01/2011,6,0,0,0,3,1,0,10
Albania,13/01/2011,2,0,0,0,27,0,0,29
Albania,14/01/2011,4,0,-11,0,1,2,0,-4
Albania,15/01/2011,0,0,-6,0,3,0,0,-3
Albania,16/01/2011,0,0,0,0,0,1,0,1
Albania,17/01/2011,8,0,-6,0,4,0,0,6
Albania,18/01/2011,8,0,-2,0,18,0,0,24
Albania,19/01/2011,0,0,0,0,0,0,0,0
Albania,20/01/2011,0,0,0,0,0,0,0,0
Albania,21/01/2011,6,0,0,0,3,1,0,10
Albania,22/01/2011,24,0,-3,0,21,13,0,55
Albania,23/01/2011,24,0,0,0,3,4,0,31
Albania,24/01/2011,8,0,0,0,0,0,0,8
Albania,25/01/2011,11,2,2,0,8,2,0,25
Albania,26/01/2011,22,0,-3,0,3,-6,0,16
Albania,27/01/2011,6,0,1,0,3,0,0,10
Albania,28/01/2011,2,0,2,0,9,4,0,17
Albania,29/01/2011,0,0,0,0,0,0,0,0
Albania,30/01/2011,6,0,0,0,0,0,0,6
Albania,31/01/2011,11,0,1,0,6,4,0,22
Algeria,01/01/2011,2,0,0,0,0,1,0,3
Algeria,02/01/2011,4,0,0,0,0,0,0,4
Algeria,03/01/2011,4,0,0,0,21,0,0,25
Algeria,04/01/2011,11,0,0,0,18,0,0,29
Algeria,05/01/2011,23,0,0,0,18,4,0,45
Algeria,06/01/2011,14,0,0,0,7,2,0,23
Algeria,07/01/2011,103,6,2,0,59,27,0,197
Algeria,08/01/2011,303,0,-4,0,64,40,0,403
Algeria,09/01/2011,215,0,2,0,45,21,0,283
Algeria,10/01/2011,68,0,-2,0,18,12,0,96
Algeria,11/01/2011,54,0,0,0,2,5,0,61
Algeria,12/01/2011,20,0,0,0,-6,7,0,21
Algeria,13/01/2011,30,0,0,0,1,13,0,44
Algeria,14/01/2011,43,0,-2,0,10,25,0,76
Algeria,15/01/2011,2,0,0,0,9,4,0,15
Algeria,16/01/2011,10,0,3,0,6,17,0,36
Algeria,17/01/2011,55,0,1,0,5,39,0,100
Algeria,18/01/2011,35,0,0,0,33,38,0,106
Algeria,19/01/2011,2,4,0,0,21,28,0,55
Algeria,20/01/2011,0,0,0,0,0,0,0,0
Algeria,21/01/2011,2,0,0,0,10,1,0,13
Algeria,22/01/2011,14,0,1,0,55,38,0,108
Algeria,23/01/2011,23,0,0,0,0,8,0,31
Algeria,24/01/2011,3,0,0,0,4,10,0,17
Algeria,25/01/2011,14,0,0,0,19,14,0,47
Algeria,26/01/2011,26,0,-1,0,-11,26,0,40
Algeria,27/01/2011,10,0,-2,0,6,37,0,51
Algeria,28/01/2011,18,0,-3,0,0,15,0,30
Algeria,29/01/2011,63,0,-6,0,11,11,0,79
Algeria,30/01/2011,19,0,0,0,11,13,0,43
Algeria,31/01/2011,27,0,-4,0,3,7,0,33
Bangladesh,01/01/2011,7,0,0,0,47,3,0,57
Bangladesh,02/01/2011,27,0,0,0,4,1,0,32
Bangladesh,03/01/2011,7,0,0,0,4,2,0,13
Bangladesh,04/01/2011,41,2,0,0,3,4,0,50
Bangladesh,05/01/2011,48,0,0,0,4,4,0,56
Bangladesh,06/01/2011,25,0,0,0,4,0,0,29
Bangladesh,07/01/2011,8,0,0,0,1,0,0,9
Bangladesh,08/01/2011,14,0,0,0,3,0,0,17
Bangladesh,09/01/2011,12,0,0,0,15,1,0,28
Bangladesh,10/01/2011,10,0,-1,0,5,0,0,14
Bangladesh,11/01/2011,20,0,0,0,3,1,0,24
Bangladesh,12/01/2011,13,0,0,0,6,3,0,22
Bangladesh,13/01/2011,17,0,0,0,12,2,0,31
Bangladesh,14/01/2011,22,0,0,0,4,0,0,26
Bangladesh,15/01/2011,5,0,0,0,3,0,0,8
Bangladesh,16/01/2011,8,0,1,0,2,6,0,17
Bangladesh,17/01/2011,8,2,0,0,12,3,0,25
Bangladesh,18/01/2011,21,0,0,0,20,3,0,44
Bangladesh,19/01/2011,4,0,0,0,6,1,0,11
Bangladesh,20/01/2011,0,0,0,0,0,0,0,0
Bangladesh,21/01/2011,6,0,0,0,6,6,0,18
Bangladesh,22/01/2011,6,2,-8,0,-9,8,0,-1
Bangladesh,23/01/2011,0,0,-1,0,3,2,0,4
Bangladesh,24/01/2011,18,0,0,0,21,4,0,43
Bangladesh,25/01/2011,9,0,0,0,15,5,0,29
Bangladesh,26/01/2011,14,0,0,0,5,4,0,23
Bangladesh,27/01/2011,18,0,0,0,19,1,0,38
Bangladesh,28/01/2011,24,0,0,0,6,4,0,34
Bangladesh,29/01/2011,10,0,0,0,-4,3,0,9
Bangladesh,30/01/2011,5,0,0,0,-4,2,0,3
Bangladesh,31/01/2011,10,0,-4,0,4,2,0,12
Cameroon,01/01/2011,0,0,1,0,0,0,0,1
Cameroon,02/01/2011,0,0,1,0,0,0,0,1
Cameroon,03/01/2011,1,0,0,0,0,0,0,1
Cameroon,04/01/2011,1,0,0,0,0,0,0,1
Cameroon,05/01/2011,-2,0,0,0,0,0,0,-2
Cameroon,06/01/2011,0,0,0,0,0,0,0,0
Cameroon,07/01/2011,0,0,0,0,0,0,0,0
Cameroon,08/01/2011,0,0,0,0,0,0,0,0
Cameroon,10/01/2011,6,0,0,0,0,0,0,6
Cameroon,11/01/2011,0,0,0,0,0,0,0,0
Cameroon,12/01/2011,0,0,0,0,0,0,0,0
Cameroon,13/01/2011,1,0,0,0,0,0,0,1
Cameroon,14/01/2011,-2,0,0,0,0,0,0,-2
Cameroon,15/01/2011,0,0,0,0,-2,0,0,-2
Cameroon,16/01/2011,0,0,0,0,0,0,0,0
Cameroon,17/01/2011,1,0,0,0,0,1,0,2
Cameroon,18/01/2011,0,0,0,0,-7,1,0,-6
Cameroon,19/01/2011,6,0,0,0,3,0,0,9
Cameroon,22/01/2011,1,0,-2,0,0,0,0,-1
Cameroon,23/01/2011,22,0,0,0,0,0,0,22
Cameroon,24/01/2011,6,0,0,0,6,0,0,12
Cameroon,25/01/2011,2,0,0,0,3,0,0,5
Cameroon,26/01/2011,1,0,0,0,3,0,0,4
Cameroon,27/01/2011,2,0,0,0,0,0,0,2
Cameroon,28/01/2011,0,0,0,0,0,0,0,0
Cameroon,29/01/2011,0,0,0,0,0,0,0,0
Cameroon,30/01/2011,0,0,0,0,6,0,0,6
Cameroon,31/01/2011,1,0,0,0,0,0,0,1
China,01/01/2011,44,0,-3,0,10,10,0,61
China,02/01/2011,90,2,-3,0,27,3,0,119
China,03/01/2011,54,0,-5,0,17,13,0,79
China,04/01/2011,129,2,-1,0,51,7,0,188
China,05/01/2011,182,0,1,0,45,15,0,243
China,06/01/2011,91,8,-6,0,62,12,0,167
China,07/01/2011,127,8,0,0,25,7,0,167
China,08/01/2011,182,0,0,0,44,11,0,237
China,09/01/2011,115,0,-1,0,41,24,0,179
China,10/01/2011,115,4,-2,0,73,15,0,205
China,11/01/2011,164,0,-1,0,63,13,0,239
China,12/01/2011,161,2,-5,0,65,31,0,254
China,13/01/2011,159,2,-4,0,103,19,0,279
China,14/01/2011,227,6,-1,0,86,12,0,330
China,15/01/2011,67,0,-2,0,15,4,0,84
China,16/01/2011,134,6,1,0,127,29,0,297
China,17/01/2011,52,2,-5,0,-4,8,0,53
China,18/01/2011,163,0,-2,0,14,24,0,199
China,19/01/2011,96,0,0,0,-9,12,0,99
China,20/01/2011,3,0,0,0,15,0,0,18
China,21/01/2011,6,0,0,0,-4,0,0,2
China,22/01/2011,128,4,3,0,45,17,0,197
China,23/01/2011,129,0,-1,0,57,23,0,208
China,24/01/2011,135,2,-2,0,98,19,0,252
China,25/01/2011,189,4,-7,0,143,28,0,357
China,26/01/2011,204,10,0,0,142,25,0,381
China,27/01/2011,197,0,-4,0,70,22,0,285
China,28/01/2011,165,0,-9,0,51,27,0,234
China,29/01/2011,121,2,1,0,48,8,0,180
China,30/01/2011,125,2,-3,0,52,25,0,201
China,31/01/2011,147,6,-3,0,75,11,0,236
Egypt,01/01/2011,107,0,0,0,18,17,0,142
Egypt,02/01/2011,111,0,0,0,13,12,0,136
Egypt,03/01/2011,84,0,0,0,-1,5,0,88
Egypt,04/01/2011,66,0,0,0,13,4,0,83
Egypt,05/01/2011,44,0,0,0,0,6,0,50
Egypt,06/01/2011,51,0,0,0,9,4,0,64
Egypt,07/01/2011,51,0,-2,0,38,3,0,90
Egypt,08/01/2011,24,0,-5,0,36,3,0,58
Egypt,09/01/2011,28,0,-4,0,25,1,0,50
Egypt,10/01/2011,71,0,0,0,-2,11,0,80
Egypt,11/01/2011,54,0,0,0,-5,1,0,50
Egypt,12/01/2011,54,0,-2,0,13,8,0,73
Egypt,13/01/2011,57,0,-2,0,6,3,0,64
Egypt,14/01/2011,56,0,-2,0,25,2,0,81
Egypt,15/01/2011,8,0,0,0,13,0,0,21
Egypt,16/01/2011,56,0,0,0,29,16,0,101
Egypt,17/01/2011,36,0,-3,0,15,79,0,127
Egypt,18/01/2011,49,0,-2,0,33,24,0,104
Egypt,19/01/2011,24,0,0,0,2,15,0,41
Egypt,20/01/2011,2,0,0,0,12,1,0,15
Egypt,21/01/2011,3,0,0,0,9,0,0,12
Egypt,22/01/2011,33,0,0,0,27,4,0,64
Egypt,23/01/2011,75,0,-6,0,21,26,0,116
Egypt,24/01/2011,79,0,1,0,41,11,0,132
Egypt,25/01/2011,37,0,-4,0,24,25,0,82
Egypt,26/01/2011,120,0,4,0,115,92,0,331
Egypt,27/01/2011,198,0,-15,0,73,111,0,367
Egypt,28/01/2011,488,4,-41,0,165,208,0,824
Egypt,29/01/2011,452,0,-40,0,158,201,0,771
Egypt,30/01/2011,413,0,-20,0,172,139,0,704
Egypt,31/01/2011,682,6,-32,0,368,204,0,1228
Eritrea,02/01/2011,0,0,0,0,0,0,0,0
Eritrea,03/01/2011,0,0,0,0,-2,0,0,-2
Eritrea,04/01/2011,11,0,0,0,-2,0,0,9
Eritrea,05/01/2011,1,0,0,0,0,0,0,1
Eritrea,06/01/2011,0,0,0,0,-2,1,0,-1
Eritrea,07/01/2011,0,0,0,0,0,0,0,0
Eritrea,08/01/2011,0,0,0,0,0,3,0,3
Eritrea,09/01/2011,2,0,2,0,0,0,0,4
Eritrea,10/01/2011,3,0,-1,0,2,0,0,4
Eritrea,11/01/2011,0,0,0,0,0,0,0,0
Eritrea,12/01/2011,7,2,0,0,3,0,0,12
Eritrea,13/01/2011,7,0,0,0,9,2,0,18
Eritrea,14/01/2011,6,0,0,0,12,0,0,18
Eritrea,15/01/2011,0,0,0,0,0,0,0,0
Eritrea,17/01/2011,1,0,0,0,-2,0,0,-1
Eritrea,18/01/2011,0,0,0,0,0,0,0,0
Eritrea,22/01/2011,6,0,0,0,9,4,0,19
Eritrea,23/01/2011,10,0,0,0,0,6,0,16
Eritrea,24/01/2011,8,0,0,0,0,0,0,8
Eritrea,25/01/2011,19,0,0,0,0,2,0,21
Eritrea,26/01/2011,0,0,0,0,0,0,0,0
Eritrea,27/01/2011,0,0,0,0,0,0,0,0
Eritrea,28/01/2011,3,0,0,0,0,0,0,3
Eritrea,29/01/2011,0,0,0,0,0,0,0,0
Eritrea,30/01/2011,3,0,0,0,3,0,0,6
Eritrea,31/01/2011,0,0,0,0,3,0,0,3
Georgia,01/01/2011,3,0,1,0,3,2,0,9
Georgia,02/01/2011,13,2,0,0,-1,3,0,17
Georgia,03/01/2011,19,2,0,0,27,0,0,48
Georgia,04/01/2011,19,4,-2,0,6,1,0,28
Georgia,05/01/2011,14,0,0,0,18,2,0,34
Georgia,06/01/2011,33,0,-2,0,18,6,0,55
Georgia,07/01/2011,30,0,0,0,5,2,0,37
Georgia,08/01/2011,29,0,-4,0,4,2,0,31
Georgia,09/01/2011,17,0,0,0,16,2,0,35
Georgia,10/01/2011,55,4,0,0,7,2,0,68
Georgia,11/01/2011,14,2,-2,0,35,2,0,51
Georgia,12/01/2011,5,0,0,0,14,0,0,19
Georgia,13/01/2011,38,0,2,0,12,3,0,55
Georgia,14/01/2011,25,0,0,0,19,5,0,49
Georgia,15/01/2011,3,0,0,0,4,4,0,11
Georgia,16/01/2011,10,0,-2,0,15,2,0,25
Georgia,17/01/2011,31,0,-2,0,8,4,0,41
Georgia,18/01/2011,38,0,0,0,34,5,0,77
Georgia,19/01/2011,11,2,0,0,4,0,0,17
Georgia,20/01/2011,0,0,0,0,0,0,0,0
Georgia,21/01/2011,0,0,0,0,0,0,0,0
Georgia,22/01/2011,37,0,1,0,10,5,0,53
Georgia,23/01/2011,17,0,0,0,9,1,0,27
Georgia,24/01/2011,33,0,0,0,17,8,0,58
Georgia,25/01/2011,51,0,-2,0,50,9,0,108
Georgia,26/01/2011,46,6,1,0,22,5,0,80
Georgia,27/01/2011,49,0,2,0,22,6,0,79
Georgia,28/01/2011,25,0,0,0,34,11,0,70
Georgia,29/01/2011,8,0,-6,0,7,2,0,11
Georgia,30/01/2011,15,0,2,0,5,0,0,22
Georgia,31/01/2011,21,0,0,0,7,2,0,30
India,01/01/2011,24,2,0,0,9,21,0,56
India,02/01/2011,51,0,-5,0,13,14,0,73
India,03/01/2011,61,0,1,0,17,2,0,81
India,04/01/2011,29,0,0,0,11,4,0,44
India,05/01/2011,12,0,0,0,2,1,0,15
India,06/01/2011,62,0,0,0,24,7,0,93
India,07/01/2011,71,0,0,0,26,15,0,112
India,08/01/2011,53,8,0,0,3,8,0,72
India,09/01/2011,47,0,-3,0,82,11,0,137
India,10/01/2011,52,0,-2,0,34,7,0,91
India,11/01/2011,36,0,-3,0,22,11,0,66
India,12/01/2011,49,0,1,0,24,11,0,85
India,13/01/2011,59,2,0,0,28,4,0,93
India,14/01/2011,38,0,0,0,-12,3,0,29
India,15/01/2011,41,0,-1,0,9,7,0,56
India,16/01/2011,38,0,-5,0,41,7,0,81
India,17/01/2011,41,0,1,0,11,16,0,69
India,18/01/2011,73,2,-6,0,13,18,0,100
India,19/01/2011,31,0,0,0,1,8,0,40
India,20/01/2011,10,0,0,0,3,0,0,13
India,21/01/2011,2,0,0,0,9,0,0,11
India,22/01/2011,68,0,0,0,15,12,0,95
India,23/01/2011,49,2,-1,0,-3,7,0,54
India,24/01/2011,79,0,4,0,29,5,0,117
India,25/01/2011,96,0,-3,0,39,4,0,136
India,26/01/2011,64,0,-1,0,16,11,0,90
India,27/01/2011,62,0,5,0,42,15,0,124
India,28/01/2011,54,4,2,0,3,4,0,67
India,29/01/2011,57,0,-2,0,38,13,0,106
India,30/01/2011,36,4,2,0,12,12,0,66
India,31/01/2011,65,0,2,0,22,4,0,93
Iran,01/01/2011,26,0,0,0,36,2,0,64
Iran,02/01/2011,63,2,0,0,35,2,0,102
Iran,03/01/2011,88,0,0,0,53,4,0,145
Iran,04/01/2011,51,0,-2,0,58,8,0,115
Iran,05/01/2011,127,0,1,0,45,23,0,196
Iran,06/01/2011,104,0,0,0,85,19,0,208
Iran,07/01/2011,91,0,4,0,75,16,0,186
Iran,08/01/2011,64,2,0,0,111,19,0,196
Iran,09/01/2011,67,0,0,0,99,7,0,173
Iran,10/01/2011,105,6,2,0,172,16,0,301
Iran,11/01/2011,100,2,1,0,110,3,0,216
Iran,12/01/2011,67,0,-51,0,22,7,0,45
Iran,13/01/2011,40,2,-11,0,63,10,0,104
Iran,14/01/2011,124,2,-4,0,53,9,0,184
Iran,15/01/2011,46,0,4,0,7,3,0,60
Iran,16/01/2011,293,1,-6,0,218,60,0,566
Iran,17/01/2011,136,2,-9,0,103,12,0,244
Iran,18/01/2011,128,0,0,0,14,13,0,155
Iran,19/01/2011,35,0,1,0,20,2,0,58
Iran,20/01/2011,21,0,1,0,0,5,0,27
Iran,21/01/2011,3,0,1,0,4,0,0,8
Iran,22/01/2011,109,0,-2,0,55,18,0,180
Iran,23/01/2011,119,0,0,0,17,28,0,164
Iran,24/01/2011,26,0,0,0,56,20,0,102
Iran,25/01/2011,65,4,-2,0,59,20,0,146
Iran,26/01/2011,52,6,2,0,47,7,0,114
Iran,27/01/2011,104,2,0,0,13,19,0,138
Iran,28/01/2011,85,0,-2,0,38,17,0,138
Iran,29/01/2011,78,2,-4,0,91,18,0,185
Iran,30/01/2011,32,0,-8,0,30,5,0,59
Iran,31/01/2011,93,0,-3,0,95,15,0,200
Iraq,01/01/2011,161,0,2,0,21,5,0,189
Iraq,02/01/2011,186,0,0,0,54,24,0,264
Iraq,03/01/2011,132,0,-2,0,27,24,0,181
Iraq,04/01/2011,146,0,0,0,16,7,0,169
Iraq,05/01/2011,143,0,0,0,37,9,0,189
Iraq,06/01/2011,92,0,-1,0,79,12,0,182
Iraq,07/01/2011,102,0,-2,0,10,10,0,120
Iraq,08/01/2011,134,0,-11,0,44,12,0,179
Iraq,09/01/2011,129,0,0,0,28,5,0,162
Iraq,10/01/2011,180,0,1,0,32,7,0,220
Iraq,11/01/2011,240,0,-3,0,41,13,0,291
Iraq,12/01/2011,108,0,1,0,4,15,0,128
Iraq,13/01/2011,85,0,4,0,35,4,0,128
Iraq,14/01/2011,50,0,0,0,80,10,0,140
Iraq,15/01/2011,86,0,0,0,23,7,0,116
Iraq,16/01/2011,139,0,1,0,12,24,0,176
Iraq,17/01/2011,117,0,1,0,44,9,0,171
Iraq,18/01/2011,155,0,-2,0,87,27,0,267
Iraq,19/01/2011,38,0,0,0,7,10,0,55
Iraq,20/01/2011,30,0,1,0,6,0,0,37
Iraq,21/01/2011,11,0,0,0,15,0,0,26
Iraq,22/01/2011,271,2,-19,0,151,48,0,453
Iraq,23/01/2011,92,0,-2,0,6,18,0,114
Iraq,24/01/2011,111,0,3,0,55,9,0,178
Iraq,25/01/2011,95,0,0,0,61,17,0,173
Iraq,26/01/2011,126,42,0,0,17,13,0,198
Iraq,27/01/2011,100,10,2,0,24,5,0,141
Iraq,28/01/2011,87,0,4,0,16,8,0,115
Iraq,29/01/2011,58,2,5,0,10,2,0,77
Iraq,30/01/2011,34,0,-1,0,5,14,0,52
Iraq,31/01/2011,97,2,0,0,57,9,0,165
Morocco,01/01/2011,3,0,0,0,6,1,0,10
Morocco,02/01/2011,-1,0,0,0,0,1,0,0
Morocco,03/01/2011,0,0,0,0,3,0,0,3
Morocco,04/01/2011,6,0,0,0,5,0,0,11
Morocco,05/01/2011,11,0,-2,0,6,1,0,16
Morocco,06/01/2011,6,0,0,0,4,8,0,18
Morocco,07/01/2011,2,0,-2,0,9,0,0,9
Morocco,08/01/2011,0,0,0,0,0,0,0,0
Morocco,09/01/2011,4,0,0,0,0,0,0,4
Morocco,10/01/2011,0,0,0,0,0,4,0,4
Morocco,11/01/2011,2,0,0,0,0,0,0,2
Morocco,12/01/2011,8,0,0,0,3,0,0,11
Morocco,13/01/2011,10,0,2,0,24,0,0,36
Morocco,14/01/2011,25,0,0,0,4,3,0,32
Morocco,15/01/2011,11,0,0,0,3,0,0,14
Morocco,16/01/2011,6,0,0,0,0,1,0,7
Morocco,17/01/2011,19,0,0,0,0,1,0,20
Morocco,18/01/2011,21,0,0,0,19,1,0,41
Morocco,19/01/2011,6,0,0,0,0,0,0,6
Morocco,20/01/2011,2,0,0,0,0,0,0,2
Morocco,21/01/2011,0,0,0,0,0,0,0,0
Morocco,22/01/2011,18,0,0,0,3,2,0,23
Morocco,23/01/2011,13,0,-1,0,0,7,0,19
Morocco,24/01/2011,22,0,-3,0,-5,1,0,15
Morocco,25/01/2011,24,0,0,0,30,4,0,58
Morocco,26/01/2011,2,0,0,0,6,11,0,19
Morocco,27/01/2011,10,0,-2,0,1,0,0,9
Morocco,28/01/2011,2,0,0,0,10,4,0,16
Morocco,29/01/2011,23,0,0,0,0,4,0,27
Morocco,30/01/2011,1,0,0,0,15,2,0,18
Morocco,31/01/2011,5,0,0,0,18,2,0,25
Nigeria,01/01/2011,58,0,-4,0,2,4,0,60
Nigeria,02/01/2011,15,0,0,0,5,6,0,26
Nigeria,03/01/2011,23,0,0,0,19,2,0,44
Nigeria,04/01/2011,48,2,-1,0,20,4,0,73
Nigeria,05/01/2011,47,2,-4,0,1,2,0,48
Nigeria,06/01/2011,51,0,-2,0,6,8,0,63
Nigeria,07/01/2011,52,2,1,0,31,5,0,91
Nigeria,08/01/2011,58,0,-2,0,13,14,0,83
Nigeria,09/01/2011,59,0,-2,0,35,12,0,104
Nigeria,10/01/2011,31,0,-4,0,9,3,0,39
Nigeria,11/01/2011,82,0,0,0,37,10,0,129
Nigeria,12/01/2011,53,0,0,0,10,2,0,65
Nigeria,13/01/2011,21,0,0,0,9,0,0,30
Nigeria,14/01/2011,32,0,-9,0,9,2,0,34
Nigeria,15/01/2011,16,0,0,0,6,2,0,24
Nigeria,16/01/2011,29,4,0,0,1,0,0,34
Nigeria,17/01/2011,38,0,1,0,34,2,0,75
Nigeria,18/01/2011,48,0,-4,0,12,7,0,63
Nigeria,19/01/2011,12,0,0,0,12,2,0,26
Nigeria,20/01/2011,11,0,0,0,0,0,0,11
Nigeria,21/01/2011,0,0,-2,0,0,0,0,-2
Nigeria,22/01/2011,56,0,1,0,12,3,0,72
Nigeria,23/01/2011,42,2,-2,0,11,2,0,55
Nigeria,24/01/2011,93,0,-4,0,35,12,0,136
Nigeria,25/01/2011,53,0,0,0,48,9,0,110
Nigeria,26/01/2011,44,0,1,0,64,3,0,112
Nigeria,27/01/2011,23,0,-1,0,25,2,0,49
Nigeria,28/01/2011,54,0,0,0,24,1,0,79
Nigeria,29/01/2011,118,2,0,0,24,17,0,161
Nigeria,30/01/2011,63,2,1,0,1,9,0,76
Nigeria,31/01/2011,12,0,0,0,2,1,0,15
Pakistan,01/01/2011,74,0,-3,0,66,15,0,152
Pakistan,02/01/2011,101,4,0,0,36,6,0,147
Pakistan,03/01/2011,85,2,-1,0,26,3,0,115
Pakistan,04/01/2011,164,0,2,0,44,9,0,219
Pakistan,05/01/2011,184,0,3,0,111,11,0,309
Pakistan,06/01/2011,232,0,1,0,541,29,0,803
Pakistan,07/01/2011,410,2,-9,0,1372,113,0,1888
Pakistan,08/01/2011,105,2,1,0,135,11,0,254
Pakistan,09/01/2011,91,0,1,0,58,13,0,163
Pakistan,10/01/2011,151,0,0,0,15,58,0,224
Pakistan,11/01/2011,75,0,-2,0,9,38,0,120
Pakistan,12/01/2011,124,0,3,0,68,35,0,230
Pakistan,13/01/2011,99,2,1,0,45,14,0,161
Pakistan,14/01/2011,249,0,-1,0,91,21,0,360
Pakistan,15/01/2011,108,10,0,0,20,15,0,153
Pakistan,16/01/2011,79,0,1,0,34,4,0,118
Pakistan,17/01/2011,80,0,1,0,9,11,0,101
Pakistan,18/01/2011,96,0,0,0,37,24,0,157
Pakistan,19/01/2011,32,0,0,0,-3,19,0,48
Pakistan,20/01/2011,2,0,0,0,6,0,0,8
Pakistan,21/01/2011,15,0,0,0,7,4,0,26
Pakistan,22/01/2011,52,0,-4,0,51,6,0,105
Pakistan,23/01/2011,51,0,0,0,18,4,0,73
Pakistan,24/01/2011,40,0,0,0,22,2,0,64
Pakistan,25/01/2011,97,4,0,0,59,6,0,166
Pakistan,26/01/2011,113,4,2,0,70,24,0,213
Pakistan,27/01/2011,80,4,-4,0,-8,14,0,86
Pakistan,28/01/2011,68,2,-2,0,25,6,0,99
Pakistan,29/01/2011,65,2,1,0,41,25,0,134
Pakistan,30/01/2011,61,0,0,0,21,8,0,90
Pakistan,31/01/2011,61,0,0,0,22,5,0,88
Sierra Leone,01/01/2011,0,0,0,0,0,2,0,2
Sierra Leone,02/01/2011,0,0,-2,0,3,0,0,1
Sierra Leone,03/01/2011,4,0,-19,0,-4,0,0,-19
Sierra Leone,04/01/2011,17,0,-3,0,9,0,0,23
Sierra Leone,05/01/2011,20,0,-11,0,0,0,0,9
Sierra Leone,06/01/2011,4,0,0,0,0,0,0,4
Sierra Leone,07/01/2011,0,2,0,0,0,0,0,2
Sierra Leone,08/01/2011,0,0,0,0,0,0,0,0
Sierra Leone,09/01/2011,4,0,0,0,0,4,0,8
Sierra Leone,10/01/2011,3,0,0,0,3,0,0,6
Sierra Leone,11/01/2011,10,0,0,0,0,0,0,10
Sierra Leone,12/01/2011,-6,0,0,0,6,4,0,4
Sierra Leone,13/01/2011,2,0,0,0,0,0,0,2
Sierra Leone,14/01/2011,-3,0,0,0,6,0,0,3
Sierra Leone,15/01/2011,0,0,0,0,0,0,0,0
Sierra Leone,16/01/2011,8,0,0,0,6,0,0,14
Sierra Leone,17/01/2011,2,0,0,0,3,0,0,5
Sierra Leone,18/01/2011,10,0,0,0,3,0,0,13
Sierra Leone,19/01/2011,0,0,0,0,0,0,0,0
Sierra Leone,20/01/2011,0,0,0,0,0,0,0,0
Sierra Leone,21/01/2011,6,0,0,0,0,0,0,6
Sierra Leone,22/01/2011,11,0,0,0,0,1,0,12
Sierra Leone,23/01/2011,1,0,0,0,0,0,0,1
Sierra Leone,24/01/2011,-1,0,0,0,-2,0,0,-3
Sierra Leone,25/01/2011,9,0,0,0,-2,0,0,7
Sierra Leone,26/01/2011,7,0,0,0,0,1,0,8
Sierra Leone,27/01/2011,1,0,0,0,0,0,0,1
Sierra Leone,28/01/2011,6,0,0,0,0,0,0,6
Sierra Leone,29/01/2011,0,0,0,0,6,0,0,6
Sierra Leone,30/01/2011,0,0,0,0,0,0,0,0
Sierra Leone,31/01/2011,7,0,0,0,6,0,0,13
Somalia,01/01/2011,17,0,0,0,27,4,0,48
Somalia,02/01/2011,25,0,0,0,73,3,0,101
Somalia,03/01/2011,17,4,-2,0,20,6,0,45
Somalia,04/01/2011,39,0,0,0,18,0,0,57
Somalia,05/01/2011,48,0,0,0,11,2,0,61
Somalia,06/01/2011,63,0,0,0,26,0,0,89
Somalia,07/01/2011,57,0,-2,0,5,10,0,70
Somalia,08/01/2011,31,0,0,0,30,8,0,69
Somalia,09/01/2011,7,0,0,0,2,2,0,11
Somalia,10/01/2011,13,0,0,0,54,10,0,77
Somalia,11/01/2011,36,0,0,0,20,16,0,72
Somalia,12/01/2011,20,2,3,0,17,1,0,43
Somalia,13/01/2011,49,0,0,0,63,2,0,114
Somalia,14/01/2011,34,0,0,0,38,1,0,73
Somalia,15/01/2011,18,0,0,0,-8,0,0,10
Somalia,16/01/2011,25,0,0,0,33,0,0,58
Somalia,17/01/2011,19,0,0,0,17,0,0,36
Somalia,18/01/2011,64,0,0,0,99,1,0,164
Somalia,19/01/2011,36,0,0,0,22,0,0,58
Somalia,20/01/2011,3,0,3,0,0,0,0,6
Somalia,21/01/2011,44,0,0,0,-1,0,0,43
Somalia,22/01/2011,191,0,2,0,60,25,0,278
Somalia,23/01/2011,118,0,0,0,57,16,0,191
Somalia,24/01/2011,102,0,0,0,65,3,0,170
Somalia,25/01/2011,89,4,0,0,105,16,0,214
Somalia,26/01/2011,72,0,0,0,41,4,0,117
Somalia,27/01/2011,46,0,-1,0,27,2,0,74
Somalia,28/01/2011,43,0,0,0,49,1,0,93
Somalia,29/01/2011,87,0,0,0,49,1,0,137
Somalia,30/01/2011,159,0,0,0,79,0,0,238
Somalia,31/01/2011,70,0,0,0,78,1,0,149
Syria,01/01/2011,19,0,0,0,-2,0,0,17
Syria,02/01/2011,11,0,0,0,3,0,0,14
Syria,03/01/2011,6,0,0,0,15,1,0,22
Syria,04/01/2011,6,0,0,0,6,0,0,12
Syria,05/01/2011,14,0,-2,0,45,2,0,59
Syria,06/01/2011,10,0,0,0,2,1,0,13
Syria,07/01/2011,3,0,2,0,21,5,0,31
Syria,08/01/2011,5,0,0,0,-2,2,0,5
Syria,09/01/2011,4,0,1,0,2,0,0,7
Syria,10/01/2011,7,0,0,0,21,0,0,28
Syria,11/01/2011,36,0,-4,0,20,0,0,52
Syria,12/01/2011,59,0,-46,0,13,11,0,37
Syria,13/01/2011,48,0,-20,0,42,8,0,78
Syria,14/01/2011,32,0,-2,0,21,0,0,51
Syria,15/01/2011,16,0,-1,0,3,12,0,30
Syria,16/01/2011,14,0,1,0,12,6,0,33
Syria,17/01/2011,28,0,-2,0,34,3,0,63
Syria,18/01/2011,31,0,-12,0,15,3,0,37
Syria,19/01/2011,38,0,-4,0,2,0,0,36
Syria,20/01/2011,4,0,0,0,-4,0,0,0
Syria,21/01/2011,4,0,0,0,3,0,0,7
Syria,22/01/2011,36,0,0,0,10,3,0,49
Syria,23/01/2011,12,0,0,0,27,1,0,40
Syria,24/01/2011,34,0,0,0,14,4,0,52
Syria,25/01/2011,29,0,-4,0,18,7,0,50
Syria,26/01/2011,36,0,0,0,9,8,0,53
Syria,27/01/2011,35,0,-2,0,2,12,0,47
Syria,28/01/2011,56,0,0,0,0,5,0,61
Syria,29/01/2011,22,0,2,0,-6,1,0,19
Syria,30/01/2011,12,0,-2,0,2,1,0,13
Syria,31/01/2011,21,0,0,0,-2,9,0,28
Yemen,01/01/2011,2,0,-8,0,0,2,0,-4
Yemen,02/01/2011,15,0,-10,0,18,1,0,24
Yemen,03/01/2011,7,0,0,0,-3,4,0,8
Yemen,04/01/2011,13,0,0,0,0,1,0,14
Yemen,05/01/2011,26,0,-4,0,15,0,0,37
Yemen,06/01/2011,17,0,-4,0,6,0,0,19
Yemen,07/01/2011,34,0,0,0,33,2,0,69
Yemen,08/01/2011,34,0,0,0,16,4,0,54
Yemen,09/01/2011,5,0,0,0,0,1,0,6
Yemen,10/01/2011,17,0,0,0,12,2,0,31
Yemen,11/01/2011,8,0,-4,0,7,2,0,13
Yemen,12/01/2011,15,0,0,0,6,0,0,21
Yemen,13/01/2011,9,0,0,0,11,4,0,24
Yemen,14/01/2011,18,0,0,0,3,0,0,21
Yemen,15/01/2011,6,0,0,0,3,1,0,10
Yemen,16/01/2011,18,0,0,0,9,1,0,28
Yemen,17/01/2011,38,0,1,0,39,0,0,78
Yemen,18/01/2011,58,0,6,0,41,15,0,120
Yemen,19/01/2011,7,0,0,0,21,6,0,34
Yemen,20/01/2011,1,0,0,0,3,0,0,4
Yemen,21/01/2011,0,0,0,0,0,0,0,0
Yemen,22/01/2011,48,0,0,0,16,6,0,70
Yemen,23/01/2011,52,0,0,0,7,11,0,70
Yemen,24/01/2011,14,0,-1,0,3,7,0,23
Yemen,25/01/2011,7,0,0,0,40,2,0,49
Yemen,26/01/2011,27,0,0,0,28,3,0,58
Yemen,27/01/2011,29,0,-18,0,15,31,0,57
Yemen,28/01/2011,52,0,-15,0,14,42,0,93
Yemen,29/01/2011,26,0,3,0,18,16,0,63
Yemen,30/01/2011,12,0,2,0,13,18,0,45
Yemen,31/01/2011,11,0,-6,0,19,12,0,36
Afghanistan,01/03/2013,187,0,-2,0,51,12,0,248
Afghanistan,02/03/2013,100,0,0,0,7,1,0,108
Afghanistan,03/03/2013,64,2,0,0,6,9,0,81
Afghanistan,04/03/2013,80,4,0,0,10,3,0,97
Afghanistan,05/03/2013,121,0,0,0,5,11,0,137
Afghanistan,06/03/2013,108,2,-1,0,18,10,0,137
Afghanistan,07/03/2013,116,0,-2,0,11,20,0,145
Afghanistan,08/03/2013,193,0,2,0,34,19,0,248
Afghanistan,09/03/2013,226,0,4,0,25,4,0,259
Afghanistan,10/03/2013,12,0,0,0,3,0,0,15
Afghanistan,11/03/2013,267,2,5,0,30,26,0,330
Afghanistan,12/03/2013,210,0,0,0,34,33,0,277
Afghanistan,13/03/2013,134,0,0,0,56,68,0,258
Afghanistan,14/03/2013,410,2,-5,0,136,70,0,613
Afghanistan,15/03/2013,151,0,1,0,3,3,0,158
Afghanistan,16/03/2013,153,0,0,0,7,7,0,167
Afghanistan,17/03/2013,145,2,0,0,14,4,0,165
Afghanistan,18/03/2013,130,2,0,0,30,17,0,179
Afghanistan,19/03/2013,103,2,1,0,39,15,0,160
Afghanistan,20/03/2013,144,2,0,0,25,13,0,184
Afghanistan,21/03/2013,153,4,0,0,22,12,0,191
Afghanistan,22/03/2013,88,0,-2,0,55,6,0,147
Afghanistan,23/03/2013,142,0,0,0,54,24,0,220
Afghanistan,24/03/2013,76,0,0,0,20,38,0,134
Afghanistan,25/03/2013,108,0,-2,0,40,4,0,150
Afghanistan,26/03/2013,113,0,2,0,22,14,0,151
Afghanistan,27/03/2013,177,6,-8,0,1,14,0,190
Afghanistan,28/03/2013,96,0,0,0,8,12,0,116
Afghanistan,29/03/2013,76,0,0,0,-4,12,0,84
Afghanistan,30/03/2013,62,0,0,0,-6,0,0,56
Afghanistan,31/03/2013,7,0,0,0,3,4,0,14
Albania,01/03/2013,6,0,1,0,0,1,0,8
Albania,02/03/2013,-1,0,1,0,21,18,0,39
Albania,03/03/2013,3,0,0,0,12,5,0,20
Albania,04/03/2013,10,0,-2,0,12,2,0,22
Albania,05/03/2013,-2,0,0,0,0,2,0,0
Albania,06/03/2013,6,0,0,0,0,0,0,6
Albania,07/03/2013,10,0,0,0,6,1,0,17
Albania,08/03/2013,10,0,0,0,6,0,0,16
Albania,09/03/2013,6,0,0,0,0,0,0,6
Albania,11/03/2013,0,0,0,0,0,0,0,0
Albania,12/03/2013,1,0,0,0,1,0,0,2
Albania,13/03/2013,0,0,0,0,-2,0,0,-2
Albania,14/03/2013,2,0,0,0,0,0,0,2
Albania,15/03/2013,0,0,0,0,0,0,0,0
Albania,16/03/2013,2,0,0,0,6,0,0,8
Albania,17/03/2013,5,0,0,0,30,1,0,36
Albania,18/03/2013,10,0,-2,0,2,0,0,10
Albania,19/03/2013,8,0,0,0,3,0,0,11
Albania,20/03/2013,16,0,0,0,0,0,0,16
Albania,21/03/2013,4,0,0,0,0,0,0,4
Albania,22/03/2013,5,0,0,0,6,0,0,11
Albania,23/03/2013,36,0,0,0,12,0,0,48
Albania,24/03/2013,8,0,0,0,0,0,0,8
Albania,25/03/2013,-2,0,0,0,9,2,0,9
Albania,26/03/2013,0,0,0,0,0,0,0,0
Albania,27/03/2013,5,0,-1,0,-4,0,0,0
Albania,28/03/2013,2,0,0,0,18,0,0,20
Albania,29/03/2013,5,0,0,0,0,0,0,5
Albania,30/03/2013,6,0,0,0,0,1,0,7
Albania,31/03/2013,0,0,0,0,0,0,0,0
Algeria,01/03/2013,71,0,0,0,7,2,0,80
Algeria,02/03/2013,127,0,0,0,3,13,0,143
Algeria,03/03/2013,238,0,0,0,33,12,0,283
Algeria,04/03/2013,296,0,0,0,65,36,0,397
Algeria,05/03/2013,41,0,-4,0,3,4,0,44
Algeria,06/03/2013,65,2,0,0,3,4,0,74
Algeria,07/03/2013,24,0,0,0,0,2,0,26
Algeria,08/03/2013,6,0,0,0,0,0,0,6
Algeria,09/03/2013,0,0,0,0,0,0,0,0
Algeria,11/03/2013,7,0,0,0,15,4,0,26
Algeria,12/03/2013,1,0,0,0,0,0,0,1
Algeria,13/03/2013,128,0,-1,0,38,31,0,196
Algeria,14/03/2013,23,0,0,0,0,0,0,23
Algeria,15/03/2013,16,0,0,0,30,0,0,46
Algeria,16/03/2013,5,0,0,0,15,0,0,20
Algeria,17/03/2013,22,0,0,0,3,0,0,25
Algeria,18/03/2013,31,0,0,0,3,2,0,36
Algeria,19/03/2013,32,0,0,0,3,2,0,37
Algeria,20/03/2013,11,0,0,0,0,2,0,13
Algeria,21/03/2013,170,0,2,0,39,23,0,234
Algeria,22/03/2013,8,0,0,0,0,0,0,8
Algeria,23/03/2013,84,0,0,0,12,4,0,100
Algeria,24/03/2013,22,0,0,0,6,0,0,28
Algeria,25/03/2013,18,0,0,0,-1,1,0,18
Algeria,26/03/2013,20,0,-2,0,-1,1,0,18
Algeria,27/03/2013,367,0,-4,0,166,58,0,587
Algeria,28/03/2013,12,0,-6,0,0,2,0,8
Algeria,29/03/2013,2,0,0,0,3,0,0,5
Algeria,30/03/2013,309,4,-21,0,152,27,0,471
Algeria,31/03/2013,17,0,1,0,20,1,0,39
Bangladesh,01/03/2013,68,0,-1,0,33,18,0,118
Bangladesh,02/03/2013,62,2,0,0,67,12,0,143
Bangladesh,03/03/2013,48,0,0,0,32,9,0,89
Bangladesh,04/03/2013,31,2,0,0,26,6,0,65
Bangladesh,05/03/2013,35,0,0,0,16,2,0,53
Bangladesh,06/03/2013,34,0,0,0,9,11,0,54
Bangladesh,07/03/2013,68,0,-1,0,42,8,0,117
Bangladesh,08/03/2013,11,0,0,0,18,8,0,37
Bangladesh,09/03/2013,22,0,0,0,34,12,0,68
Bangladesh,10/03/2013,0,0,0,0,0,0,0,0
Bangladesh,11/03/2013,51,0,0,0,12,6,0,69
Bangladesh,12/03/2013,18,0,1,0,19,0,0,38
Bangladesh,13/03/2013,32,0,0,0,7,2,0,41
Bangladesh,14/03/2013,50,0,0,0,18,4,0,72
Bangladesh,15/03/2013,39,2,0,0,12,4,0,57
Bangladesh,16/03/2013,15,0,0,0,6,7,0,28
Bangladesh,17/03/2013,12,0,1,0,0,12,0,25
Bangladesh,18/03/2013,14,0,0,0,4,5,0,23
Bangladesh,19/03/2013,27,0,1,0,6,2,0,36
Bangladesh,20/03/2013,24,0,0,0,27,2,0,53
Bangladesh,21/03/2013,27,0,0,0,4,1,0,32
Bangladesh,22/03/2013,19,0,0,0,18,2,0,39
Bangladesh,23/03/2013,27,0,0,0,26,4,0,57
Bangladesh,24/03/2013,12,0,0,0,0,6,0,18
Bangladesh,25/03/2013,47,0,0,0,5,7,0,59
Bangladesh,26/03/2013,5,0,1,0,6,5,0,17
Bangladesh,27/03/2013,21,0,-2,0,12,5,0,36
Bangladesh,28/03/2013,19,0,0,0,-2,0,0,17
Bangladesh,29/03/2013,13,0,0,0,-2,1,0,12
Bangladesh,30/03/2013,11,0,0,0,6,0,0,17
Bangladesh,31/03/2013,14,0,0,0,3,2,0,19
Cameroon,01/03/2013,8,0,0,0,13,0,0,21
Cameroon,02/03/2013,2,0,0,0,0,0,0,2
Cameroon,03/03/2013,3,0,0,0,0,4,0,7
Cameroon,04/03/2013,10,0,0,0,0,0,0,10
Cameroon,05/03/2013,15,0,-2,0,9,0,0,22
Cameroon,06/03/2013,0,0,0,0,15,0,0,15
Cameroon,07/03/2013,0,0,0,0,0,0,0,0
Cameroon,08/03/2013,2,0,0,0,0,0,0,2
Cameroon,09/03/2013,8,0,0,0,0,0,0,8
Cameroon,10/03/2013,0,0,0,0,0,4,0,4
Cameroon,11/03/2013,9,0,0,0,4,1,0,14
Cameroon,12/03/2013,5,0,0,0,-4,0,0,1
Cameroon,13/03/2013,0,4,0,0,-2,4,0,6
Cameroon,14/03/2013,1,0,0,0,-2,0,0,-1
Cameroon,15/03/2013,0,0,0,0,0,0,0,0
Cameroon,16/03/2013,10,0,0,0,0,0,0,10
Cameroon,17/03/2013,0,0,0,0,0,0,0,0
Cameroon,18/03/2013,33,0,0,0,0,0,0,33
Cameroon,19/03/2013,2,0,0,0,6,0,0,8
Cameroon,20/03/2013,0,0,0,0,3,0,0,3
Cameroon,21/03/2013,6,0,0,0,39,0,0,45
Cameroon,22/03/2013,7,4,0,0,0,2,0,13
Cameroon,23/03/2013,18,0,0,0,0,0,0,18
Cameroon,24/03/2013,0,0,0,0,-4,0,0,-4
Cameroon,25/03/2013,25,0,0,0,-3,0,0,22
Cameroon,26/03/2013,19,0,0,0,5,16,0,40
Cameroon,27/03/2013,7,0,0,0,0,4,0,11
Cameroon,28/03/2013,4,2,0,0,2,6,0,14
Cameroon,29/03/2013,21,0,0,0,0,0,0,21
Cameroon,30/03/2013,1,0,0,0,0,0,0,1
Cameroon,31/03/2013,6,0,0,0,0,0,0,6
China,01/03/2013,130,8,-7,0,56,21,0,208
China,02/03/2013,54,0,-1,0,20,7,0,80
China,03/03/2013,50,0,-3,0,55,18,0,120
China,04/03/2013,117,0,-4,0,53,15,0,181
China,05/03/2013,109,6,-19,0,97,21,0,214
China,06/03/2013,143,4,8,0,46,25,0,226
China,07/03/2013,173,2,-2,0,54,23,0,250
China,08/03/2013,260,4,-2,0,80,28,0,370
China,09/03/2013,184,4,2,0,34,24,0,248
China,10/03/2013,3,0,0,0,-2,0,0,1
China,11/03/2013,142,2,-14,0,105,19,0,254
China,12/03/2013,156,8,1,0,84,15,0,264
China,13/03/2013,168,2,-1,0,97,20,0,286
China,14/03/2013,195,2,-6,0,68,25,0,284
China,15/03/2013,168,0,-4,0,60,22,0,246
China,16/03/2013,107,0,-1,0,27,14,0,147
China,17/03/2013,86,0,2,0,10,19,0,117
China,18/03/2013,139,4,-2,0,48,11,0,200
China,19/03/2013,182,2,-6,0,115,30,0,323
China,20/03/2013,152,0,-7,0,83,26,0,254
China,21/03/2013,140,4,-4,0,48,23,0,211
China,22/03/2013,149,4,2,0,21,19,0,195
China,23/03/2013,138,0,0,0,44,14,0,196
China,24/03/2013,24,0,0,0,32,8,0,64
China,25/03/2013,209,6,-4,0,101,29,0,341
China,26/03/2013,145,2,-5,0,74,15,0,231
China,27/03/2013,107,2,-2,0,44,15,0,166
China,28/03/2013,87,10,-1,0,66,18,0,180
China,29/03/2013,179,6,-6,0,58,25,0,262
China,30/03/2013,47,0,0,0,4,7,0,58
China,31/03/2013,24,2,0,0,22,3,0,51
Egypt,01/03/2013,22,0,-2,0,22,10,0,52
Egypt,02/03/2013,50,6,3,0,10,21,0,90
Egypt,03/03/2013,82,0,-1,0,57,38,0,176
Egypt,04/03/2013,69,0,-1,0,69,23,0,160
Egypt,05/03/2013,58,2,-3,0,37,13,0,107
Egypt,06/03/2013,138,0,-1,0,32,20,0,189
Egypt,07/03/2013,29,0,-2,0,15,16,0,58
Egypt,08/03/2013,48,0,-2,0,11,10,0,67
Egypt,09/03/2013,76,0,-8,0,56,30,0,154
Egypt,10/03/2013,4,0,0,0,3,0,0,7
Egypt,11/03/2013,69,0,-5,0,40,16,0,120
Egypt,12/03/2013,60,2,-1,0,15,13,0,89
Egypt,13/03/2013,50,0,0,0,26,12,0,88
Egypt,14/03/2013,74,2,4,0,1,6,0,87
Egypt,15/03/2013,97,2,-3,0,6,17,0,119
Egypt,16/03/2013,72,0,-1,0,4,15,0,90
Egypt,17/03/2013,26,2,0,0,11,6,0,45
Egypt,18/03/2013,39,0,-6,0,9,10,0,52
Egypt,19/03/2013,113,2,1,0,48,25,0,189
Egypt,20/03/2013,31,0,-3,0,29,10,0,67
Egypt,21/03/2013,64,0,0,0,31,27,0,122
Egypt,22/03/2013,38,0,0,0,34,18,0,90
Egypt,23/03/2013,102,0,-4,0,32,0,0,130
Egypt,24/03/2013,13,0,0,0,17,0,0,30
Egypt,25/03/2013,63,2,-4,0,41,11,0,113
Egypt,26/03/2013,68,0,1,0,38,6,0,113
Egypt,27/03/2013,72,4,-1,0,44,27,0,146
Egypt,28/03/2013,76,0,3,0,41,16,0,136
Egypt,29/03/2013,50,0,-5,0,22,27,0,94
Egypt,30/03/2013,47,0,0,0,18,5,0,70
Egypt,31/03/2013,46,0,0,0,-26,5,0,25
Eritrea,01/03/2013,1,0,0,0,0,0,0,1
Eritrea,02/03/2013,0,0,0,0,1,0,0,1
Eritrea,03/03/2013,4,0,0,0,0,0,0,4
Eritrea,04/03/2013,0,2,0,0,0,0,0,2
Eritrea,05/03/2013,-1,0,0,0,0,0,0,-1
Eritrea,06/03/2013,3,0,0,0,-1,2,0,4
Eritrea,07/03/2013,3,0,0,0,0,0,0,3
Eritrea,08/03/2013,0,0,0,0,0,0,0,0
Eritrea,09/03/2013,0,0,0,0,0,0,0,0
Eritrea,11/03/2013,0,0,0,0,2,0,0,2
Eritrea,12/03/2013,0,0,0,0,6,0,0,6
Eritrea,13/03/2013,6,0,0,0,3,2,0,11
Eritrea,14/03/2013,5,0,0,0,6,3,0,14
Eritrea,15/03/2013,0,0,0,0,0,0,0,0
Eritrea,16/03/2013,0,0,0,0,0,0,0,0
Eritrea,19/03/2013,0,0,0,0,0,0,0,0
Eritrea,20/03/2013,1,0,0,0,0,0,0,1
Eritrea,21/03/2013,4,4,0,0,3,0,0,11
Eritrea,22/03/2013,2,0,0,0,0,0,0,2
Eritrea,27/03/2013,0,0,0,0,3,0,0,3
Eritrea,28/03/2013,5,0,0,0,15,0,0,20
Eritrea,29/03/2013,0,0,0,0,9,0,0,9
Georgia,01/03/2013,1,0,0,0,0,0,0,1
Georgia,02/03/2013,25,0,0,0,21,2,0,48
Georgia,03/03/2013,0,0,0,0,0,0,0,0
Georgia,04/03/2013,8,0,0,0,0,0,0,8
Georgia,05/03/2013,1,0,0,0,0,0,0,1
Georgia,06/03/2013,15,0,0,0,0,0,0,15
Georgia,07/03/2013,1,0,0,0,6,2,0,9
Georgia,08/03/2013,0,0,0,0,9,0,0,9
Georgia,09/03/2013,2,0,0,0,0,8,0,10
Georgia,11/03/2013,5,0,0,0,0,0,0,5
Georgia,12/03/2013,0,0,0,0,0,0,0,0
Georgia,13/03/2013,6,0,0,0,0,0,0,6
Georgia,14/03/2013,-2,0,0,0,3,0,0,1
Georgia,15/03/2013,4,0,0,0,0,0,0,4
Georgia,16/03/2013,-1,0,0,0,0,0,0,-1
Georgia,17/03/2013,0,0,0,0,0,0,0,0
Georgia,18/03/2013,7,0,0,0,0,0,0,7
Georgia,19/03/2013,11,0,-2,0,0,1,0,10
Georgia,20/03/2013,3,0,0,0,0,0,0,3
Georgia,21/03/2013,8,0,0,0,6,0,0,14
Georgia,22/03/2013,6,0,-2,0,0,0,0,4
Georgia,25/03/2013,-1,0,-2,0,-2,0,0,-5
Georgia,26/03/2013,3,0,-4,0,0,0,0,-1
Georgia,27/03/2013,1,0,0,0,0,1,0,2
Georgia,28/03/2013,-1,0,0,0,-1,0,0,-2
Georgia,29/03/2013,-1,0,0,0,0,0,0,-1
Georgia,30/03/2013,0,0,0,0,0,0,0,0
India,01/03/2013,75,0,-2,0,20,19,0,112
India,02/03/2013,29,8,-1,0,24,11,0,71
India,03/03/2013,87,0,4,0,20,15,0,126
India,04/03/2013,65,0,-4,0,24,5,0,90
India,05/03/2013,76,0,-1,0,59,18,0,152
India,06/03/2013,66,6,-3,0,7,11,0,87
India,07/03/2013,68,4,0,0,17,18,0,107
India,08/03/2013,78,0,-3,0,28,10,0,113
India,09/03/2013,36,0,-4,0,38,30,0,100
India,10/03/2013,3,0,0,0,0,0,0,3
India,11/03/2013,50,0,0,0,33,23,0,106
India,12/03/2013,75,0,-4,0,25,18,0,114
India,13/03/2013,126,2,-1,0,24,10,0,161
India,14/03/2013,62,2,-2,0,44,18,0,124
India,15/03/2013,78,0,-2,0,28,15,0,119
India,16/03/2013,81,0,-4,0,26,10,0,113
India,17/03/2013,48,2,3,0,23,8,0,84
India,18/03/2013,66,4,-1,0,17,11,0,97
India,19/03/2013,73,2,-3,0,32,22,0,126
India,20/03/2013,44,2,-9,0,6,16,0,59
India,21/03/2013,80,0,-6,0,26,25,0,125
India,22/03/2013,77,0,-2,0,19,17,0,111
India,23/03/2013,156,0,2,0,60,20,0,238
India,24/03/2013,14,0,0,0,6,4,0,24
India,25/03/2013,41,2,-1,0,20,9,0,71
India,26/03/2013,109,2,-31,0,-6,10,0,84
India,27/03/2013,48,0,-11,0,4,6,0,47
India,28/03/2013,99,0,2,0,33,4,0,138
India,29/03/2013,81,0,-10,0,8,20,0,99
India,30/03/2013,19,0,0,0,9,6,0,34
India,31/03/2013,24,0,0,0,3,5,0,32
Iran,01/03/2013,46,0,-2,0,32,10,0,86
Iran,02/03/2013,52,0,0,0,13,12,0,77
Iran,03/03/2013,46,2,1,0,18,15,0,82
Iran,04/03/2013,99,0,1,0,39,5,0,144
Iran,05/03/2013,79,4,7,0,96,14,0,200
Iran,06/03/2013,141,2,-12,0,103,26,0,260
Iran,07/03/2013,219,2,-2,0,220,26,0,465
Iran,08/03/2013,175,0,-2,0,150,22,0,345
Iran,09/03/2013,218,0,4,0,158,38,0,418
Iran,10/03/2013,0,0,0,0,0,0,0,0
Iran,11/03/2013,143,0,2,0,169,51,0,365
Iran,12/03/2013,57,2,6,0,63,6,0,134
Iran,13/03/2013,45,0,0,0,74,7,0,126
Iran,14/03/2013,139,1,0,0,66,15,0,221
Iran,15/03/2013,139,0,0,0,54,13,0,206
Iran,16/03/2013,82,0,0,0,3,2,0,87
Iran,17/03/2013,82,0,1,0,35,-2,0,116
Iran,18/03/2013,82,0,1,0,22,9,0,114
Iran,19/03/2013,67,0,-4,0,5,2,0,70
Iran,20/03/2013,131,0,1,0,48,23,0,203
Iran,21/03/2013,141,0,2,0,29,15,0,187
Iran,22/03/2013,98,0,-12,0,60,13,0,159
Iran,23/03/2013,118,0,-16,0,4,10,0,116
Iran,24/03/2013,35,0,2,0,-4,0,0,33
Iran,25/03/2013,74,0,0,0,9,19,0,102
Iran,26/03/2013,74,0,0,0,79,1,0,154
Iran,27/03/2013,52,0,-3,0,3,5,0,57
Iran,28/03/2013,140,0,-2,0,22,9,0,169
Iran,29/03/2013,99,0,0,0,51,7,0,157
Iran,30/03/2013,6,0,1,0,12,0,0,19
Iran,31/03/2013,9,0,0,0,0,0,0,9
Iraq,01/03/2013,128,0,-4,0,47,13,0,184
Iraq,02/03/2013,164,0,-5,0,8,3,0,170
Iraq,03/03/2013,88,0,-3,0,10,14,0,109
Iraq,04/03/2013,98,0,-3,0,19,22,0,136
Iraq,05/03/2013,142,0,-1,0,31,13,0,185
Iraq,06/03/2013,138,0,0,0,-2,3,0,139
Iraq,07/03/2013,133,0,-1,0,34,9,0,175
Iraq,08/03/2013,64,0,-2,0,49,0,0,111
Iraq,09/03/2013,117,0,-12,0,72,16,0,193
Iraq,10/03/2013,0,0,0,0,3,0,0,3
Iraq,11/03/2013,126,0,0,0,38,10,0,174
Iraq,12/03/2013,52,0,0,0,26,8,0,86
Iraq,13/03/2013,86,0,2,0,3,12,0,103
Iraq,14/03/2013,129,0,0,0,7,3,0,139
Iraq,15/03/2013,68,0,2,0,20,6,0,96
Iraq,16/03/2013,59,2,1,0,10,10,0,82
Iraq,17/03/2013,90,4,0,0,37,44,0,175
Iraq,18/03/2013,101,0,-2,0,46,10,0,155
Iraq,19/03/2013,181,10,0,0,54,9,0,254
Iraq,20/03/2013,142,6,0,0,46,14,0,208
Iraq,21/03/2013,247,12,-6,0,59,38,0,350
Iraq,22/03/2013,108,4,0,0,34,8,0,154
Iraq,23/03/2013,106,12,2,0,32,8,0,160
Iraq,24/03/2013,88,0,0,0,6,8,0,102
Iraq,25/03/2013,96,0,2,0,82,12,0,192
Iraq,26/03/2013,51,0,-5,0,-1,7,0,52
Iraq,27/03/2013,109,0,-10,0,34,7,0,140
Iraq,28/03/2013,95,0,-2,0,40,5,0,138
Iraq,29/03/2013,134,12,0,0,3,12,0,161
Iraq,30/03/2013,61,0,0,0,0,21,0,82
Iraq,31/03/2013,26,0,2,0,3,0,0,31
Morocco,01/03/2013,2,0,0,0,6,3,0,11
Morocco,02/03/2013,7,0,0,0,1,1,0,9
Morocco,03/03/2013,2,0,0,0,-3,0,0,-1
Morocco,04/03/2013,3,0,2,0,6,2,0,13
Morocco,05/03/2013,10,0,0,0,6,0,0,16
Morocco,06/03/2013,3,0,0,0,0,0,0,3
Morocco,07/03/2013,1,0,0,0,18,0,0,19
Morocco,08/03/2013,8,0,0,0,13,0,0,21
Morocco,09/03/2013,2,0,0,0,12,0,0,14
Morocco,11/03/2013,0,0,0,0,2,0,0,2
Morocco,12/03/2013,7,0,0,0,2,0,0,9
Morocco,13/03/2013,1,0,0,0,3,0,0,4
Morocco,14/03/2013,-2,0,0,0,-2,1,0,-3
Morocco,15/03/2013,-3,0,3,0,21,2,0,23
Morocco,16/03/2013,3,0,0,0,0,4,0,7
Morocco,17/03/2013,14,0,0,0,3,4,0,21
Morocco,18/03/2013,41,0,0,0,0,1,0,42
Morocco,19/03/2013,11,0,0,0,-6,0,0,5
Morocco,20/03/2013,1,0,0,0,0,0,0,1
Morocco,21/03/2013,-5,0,0,0,0,0,0,-5
Morocco,22/03/2013,7,0,0,0,0,0,0,7
Morocco,23/03/2013,12,0,0,0,0,2,0,14
Morocco,24/03/2013,0,0,0,0,0,0,0,0
Morocco,25/03/2013,9,0,0,0,0,0,0,9
Morocco,26/03/2013,6,0,0,0,0,0,0,6
Morocco,27/03/2013,0,0,0,0,3,0,0,3
Morocco,28/03/2013,0,0,0,0,3,0,0,3
Morocco,29/03/2013,0,0,0,0,4,3,0,7
Morocco,30/03/2013,60,0,0,0,22,4,0,86
Morocco,31/03/2013,0,0,0,0,3,0,0,3
Nigeria,01/03/2013,26,0,0,0,20,1,0,47
Nigeria,02/03/2013,3,0,0,0,13,2,0,18
Nigeria,03/03/2013,9,0,-2,0,15,1,0,23
Nigeria,04/03/2013,14,0,0,0,2,7,0,23
Nigeria,05/03/2013,21,0,0,0,19,9,0,49
Nigeria,06/03/2013,9,0,0,0,20,5,0,34
Nigeria,07/03/2013,11,0,1,0,15,1,0,28
Nigeria,08/03/2013,21,0,1,0,15,7,0,44
Nigeria,09/03/2013,84,0,0,0,6,6,0,96
Nigeria,10/03/2013,3,0,0,0,0,0,0,3
Nigeria,11/03/2013,81,0,-4,0,3,8,0,88
Nigeria,12/03/2013,69,0,0,0,-4,5,0,70
Nigeria,13/03/2013,30,0,0,0,19,4,0,53
Nigeria,14/03/2013,34,0,1,0,33,-3,0,65
Nigeria,15/03/2013,53,0,0,0,42,3,0,98
Nigeria,16/03/2013,34,0,0,0,36,2,0,72
Nigeria,17/03/2013,14,0,0,0,15,2,0,31
Nigeria,18/03/2013,34,0,0,0,23,4,0,61
Nigeria,19/03/2013,27,0,1,0,-4,4,0,28
Nigeria,20/03/2013,20,0,0,0,12,9,0,41
Nigeria,21/03/2013,17,4,0,0,28,4,0,53
Nigeria,22/03/2013,17,0,-2,0,10,11,0,36
Nigeria,23/03/2013,8,0,2,0,47,14,0,71
Nigeria,24/03/2013,4,0,0,0,0,0,0,4
Nigeria,25/03/2013,34,0,-4,0,37,7,0,74
Nigeria,26/03/2013,15,2,-1,0,34,0,0,50
Nigeria,27/03/2013,20,0,0,0,15,2,0,37
Nigeria,28/03/2013,14,0,1,0,27,2,0,44
Nigeria,29/03/2013,6,0,2,0,4,4,0,16
Nigeria,30/03/2013,0,0,-6,0,0,0,0,-6
Nigeria,31/03/2013,5,0,0,0,0,0,0,5
Pakistan,01/03/2013,130,0,-6,0,56,23,0,203
Pakistan,02/03/2013,86,0,0,0,54,6,0,146
Pakistan,03/03/2013,129,0,0,0,78,16,0,223
Pakistan,04/03/2013,138,0,1,0,136,18,0,293
Pakistan,05/03/2013,66,0,-2,0,47,6,0,117
Pakistan,06/03/2013,106,0,-3,0,50,34,0,187
Pakistan,07/03/2013,149,0,-4,0,58,8,0,211
Pakistan,08/03/2013,110,0,3,0,34,9,0,156
Pakistan,09/03/2013,180,4,4,0,18,28,0,234
Pakistan,10/03/2013,-3,0,0,0,3,0,0,0
Pakistan,11/03/2013,67,2,-1,0,36,12,0,116
Pakistan,12/03/2013,29,0,2,0,17,13,0,61
Pakistan,13/03/2013,108,0,2,0,17,18,0,145
Pakistan,14/03/2013,88,0,-1,0,27,21,0,135
Pakistan,15/03/2013,133,0,2,0,39,13,0,187
Pakistan,16/03/2013,131,0,-5,0,29,22,0,177
Pakistan,17/03/2013,72,0,-4,0,7,16,0,91
Pakistan,18/03/2013,49,0,1,0,24,10,0,84
Pakistan,19/03/2013,138,0,-4,0,4,14,0,152
Pakistan,20/03/2013,84,0,-1,0,24,8,0,115
Pakistan,21/03/2013,93,0,7,0,57,11,0,168
Pakistan,22/03/2013,35,4,0,0,31,10,0,80
Pakistan,23/03/2013,182,0,2,0,22,14,0,220
Pakistan,24/03/2013,50,0,0,0,18,0,0,68
Pakistan,25/03/2013,73,0,-2,0,36,1,0,108
Pakistan,26/03/2013,89,0,-3,0,13,31,0,130
Pakistan,27/03/2013,63,0,0,0,40,10,0,113
Pakistan,28/03/2013,116,0,1,0,60,9,0,186
Pakistan,29/03/2013,78,0,2,0,20,16,0,116
Pakistan,30/03/2013,47,2,0,0,12,1,0,62
Pakistan,31/03/2013,19,0,0,0,1,0,0,20
Sierra Leone,01/03/2013,1,0,0,0,0,0,0,1
Sierra Leone,02/03/2013,2,0,0,0,0,0,0,2
Sierra Leone,03/03/2013,0,0,0,0,0,0,0,0
Sierra Leone,04/03/2013,0,0,0,0,0,0,0,0
Sierra Leone,05/03/2013,1,0,0,0,0,0,0,1
Sierra Leone,06/03/2013,2,0,0,0,0,0,0,2
Sierra Leone,07/03/2013,9,0,0,0,0,0,0,9
Sierra Leone,08/03/2013,3,0,0,0,3,0,0,6
Sierra Leone,09/03/2013,0,0,0,0,0,0,0,0
Sierra Leone,11/03/2013,0,0,0,0,3,0,0,3
Sierra Leone,12/03/2013,0,0,0,0,4,0,0,4
Sierra Leone,13/03/2013,0,0,0,0,0,0,0,0
Sierra Leone,14/03/2013,0,0,0,0,0,0,0,0
Sierra Leone,15/03/2013,0,0,0,0,0,0,0,0
Sierra Leone,18/03/2013,2,0,0,0,0,0,0,2
Sierra Leone,19/03/2013,0,0,0,0,0,0,0,0
Sierra Leone,20/03/2013,0,0,0,0,0,0,0,0
Sierra Leone,21/03/2013,-1,0,0,0,0,0,0,-1
Sierra Leone,22/03/2013,1,0,0,0,0,0,0,1
Sierra Leone,23/03/2013,0,0,0,0,6,0,0,6
Sierra Leone,25/03/2013,0,0,0,0,12,0,0,12
Sierra Leone,26/03/2013,0,0,0,0,8,0,0,8
Sierra Leone,27/03/2013,1,0,0,0,6,0,0,7
Sierra Leone,28/03/2013,4,0,0,0,-6,0,0,-2
Sierra Leone,29/03/2013,1,0,0,0,0,0,0,1
Sierra Leone,30/03/2013,2,0,0,0,0,0,0,2
Somalia,01/03/2013,14,0,-2,0,6,5,0,23
Somalia,02/03/2013,18,0,-2,0,10,2,0,28
Somalia,03/03/2013,5,2,0,0,14,7,0,28
Somalia,04/03/2013,86,0,0,0,29,23,0,138
Somalia,05/03/2013,44,0,0,0,26,21,0,91
Somalia,06/03/2013,57,0,-1,0,27,8,0,91
Somalia,07/03/2013,0,0,0,0,-2,2,0,0
Somalia,08/03/2013,5,0,0,0,-3,5,0,7
Somalia,09/03/2013,50,0,0,0,-6,6,0,50
Somalia,11/03/2013,13,0,0,0,-1,4,0,16
Somalia,12/03/2013,26,0,0,0,-5,0,0,21
Somalia,13/03/2013,31,0,0,0,10,0,0,41
Somalia,14/03/2013,16,0,0,0,-2,1,0,15
Somalia,15/03/2013,5,0,0,0,0,1,0,6
Somalia,16/03/2013,18,0,0,0,6,0,0,24
Somalia,17/03/2013,17,0,0,0,8,10,0,35
Somalia,18/03/2013,10,0,0,0,5,6,0,21
Somalia,19/03/2013,29,0,0,0,3,0,0,32
Somalia,20/03/2013,9,0,0,0,45,3,0,57
Somalia,21/03/2013,3,0,-2,0,25,7,0,33
Somalia,22/03/2013,29,0,0,0,12,3,0,44
Somalia,23/03/2013,-6,0,0,0,-10,6,0,-10
Somalia,24/03/2013,0,0,0,0,1,4,0,5
Somalia,25/03/2013,58,0,0,0,6,2,0,66
Somalia,26/03/2013,30,0,0,0,13,2,0,45
Somalia,27/03/2013,17,0,0,0,12,2,0,31
Somalia,28/03/2013,-6,0,0,0,15,0,0,9
Somalia,29/03/2013,10,0,1,0,6,6,0,23
Somalia,30/03/2013,3,0,0,0,9,0,0,12
Somalia,31/03/2013,3,0,0,0,0,0,0,3
Syria,01/03/2013,258,2,-13,0,45,32,0,324
Syria,02/03/2013,160,2,-8,0,-8,13,0,159
Syria,03/03/2013,214,0,-6,0,12,5,0,225
Syria,04/03/2013,352,0,-6,0,-3,80,0,423
Syria,05/03/2013,246,4,-1,0,-4,56,0,301
Syria,06/03/2013,258,0,-1,0,-30,45,0,272
Syria,07/03/2013,181,1,-6,0,31,35,0,242
Syria,08/03/2013,183,0,-12,0,22,16,0,209
Syria,09/03/2013,156,0,0,0,-2,8,0,162
Syria,10/03/2013,8,0,0,0,3,2,0,13
Syria,11/03/2013,330,0,-1,0,25,36,0,390
Syria,12/03/2013,130,10,3,0,53,20,0,216
Syria,13/03/2013,161,4,9,0,58,19,0,251
Syria,14/03/2013,282,11,16,0,23,19,0,351
Syria,15/03/2013,271,6,-1,0,4,19,0,299
Syria,16/03/2013,205,0,-1,0,21,11,0,236
Syria,17/03/2013,208,2,-2,0,10,20,0,238
Syria,18/03/2013,335,4,0,0,80,32,0,451
Syria,19/03/2013,293,8,-2,0,35,31,0,365
Syria,20/03/2013,276,0,2,0,25,16,0,319
Syria,21/03/2013,167,0,2,0,-9,9,0,169
Syria,22/03/2013,300,2,-52,0,33,10,0,293
Syria,23/03/2013,308,4,-110,0,18,14,0,234
Syria,24/03/2013,207,0,-4,0,8,54,0,265
Syria,25/03/2013,290,0,-15,0,49,21,0,345
Syria,26/03/2013,132,12,-6,0,49,24,0,211
Syria,27/03/2013,263,10,-10,0,23,31,0,317
Syria,28/03/2013,292,0,-6,0,104,43,0,433
Syria,29/03/2013,180,0,0,0,95,28,0,303
Syria,30/03/2013,1,0,1,0,30,11,0,43
Syria,31/03/2013,44,0,0,0,4,19,0,67
Yemen,01/03/2013,-2,0,0,0,-2,4,0,0
Yemen,02/03/2013,47,0,-2,0,9,0,0,54
Yemen,03/03/2013,14,0,0,0,6,0,0,20
Yemen,04/03/2013,36,0,-1,0,10,26,0,71
Yemen,05/03/2013,29,0,0,0,-4,2,0,27
Yemen,06/03/2013,63,0,0,0,7,0,0,70
Yemen,07/03/2013,50,2,0,0,22,13,0,87
Yemen,08/03/2013,22,0,0,0,6,0,0,28
Yemen,09/03/2013,42,0,0,0,14,4,0,60
Yemen,11/03/2013,2,0,0,0,3,4,0,9
Yemen,12/03/2013,11,0,0,0,9,2,0,22
Yemen,13/03/2013,51,0,0,0,6,5,0,62
Yemen,14/03/2013,6,0,0,0,2,4,0,12
Yemen,15/03/2013,23,0,0,0,13,1,0,37
Yemen,16/03/2013,24,0,0,0,-5,5,0,24
Yemen,17/03/2013,6,2,0,0,3,4,0,15
Yemen,18/03/2013,32,0,0,0,16,3,0,51
Yemen,19/03/2013,-2,0,0,0,-14,1,0,-15
Yemen,20/03/2013,28,0,-3,0,0,1,0,26
Yemen,21/03/2013,16,0,0,0,0,0,0,16
Yemen,22/03/2013,11,0,0,0,-4,3,0,10
Yemen,23/03/2013,36,0,2,0,6,4,0,48
Yemen,24/03/2013,8,0,0,0,6,0,0,14
Yemen,25/03/2013,26,0,0,0,24,0,0,50
Yemen,26/03/2013,18,0,0,0,11,3,0,32
Yemen,27/03/2013,15,0,0,0,21,3,0,39
Yemen,28/03/2013,30,0,0,0,20,1,0,51
Yemen,29/03/2013,0,0,0,0,3,2,0,5
Yemen,30/03/2013,9,0,0,0,0,0,0,9
Yemen,31/03/2013,0,0,0,0,12,0,0,12
Afghanistan,01/02/2008,297,0,1,0,6,18,0,322
Afghanistan,02/02/2008,134,0,3,0,9,16,0,162
Afghanistan,03/02/2008,89,4,-6,0,16,6,0,109
Afghanistan,04/02/2008,244,2,0,0,79,41,0,366
Afghanistan,05/02/2008,202,2,0,0,87,12,0,303
Afghanistan,06/02/2008,202,0,-8,0,40,9,0,243
Afghanistan,07/02/2008,308,2,-1,0,70,13,0,392
Afghanistan,08/02/2008,176,0,1,0,70,8,0,255
Afghanistan,09/02/2008,125,0,2,0,14,7,0,148
Afghanistan,10/02/2008,148,0,2,0,8,9,0,167
Afghanistan,11/02/2008,351,0,2,0,110,33,0,496
Afghanistan,12/02/2008,134,4,1,0,62,3,0,204
Afghanistan,13/02/2008,90,0,2,0,6,0,0,98
Afghanistan,14/02/2008,69,0,0,0,34,3,0,106
Afghanistan,15/02/2008,62,0,0,0,26,8,0,96
Afghanistan,16/02/2008,81,0,0,0,25,22,0,128
Afghanistan,17/02/2008,94,0,0,0,29,25,0,148
Afghanistan,18/02/2008,134,0,0,0,49,36,0,219
Afghanistan,19/02/2008,135,0,-2,0,33,23,0,189
Afghanistan,20/02/2008,66,0,0,0,8,4,0,78
Afghanistan,21/02/2008,77,0,-1,0,15,7,0,98
Afghanistan,22/02/2008,83,0,-6,0,-2,9,0,84
Afghanistan,23/02/2008,70,0,1,0,32,6,0,109
Afghanistan,24/02/2008,98,2,-2,0,0,8,0,106
Afghanistan,25/02/2008,108,4,0,0,33,21,0,166
Afghanistan,26/02/2008,149,0,0,0,67,5,0,221
Afghanistan,27/02/2008,103,0,0,0,30,2,0,135
Afghanistan,28/02/2008,325,0,2,0,8,13,0,348
Afghanistan,29/02/2008,224,2,3,0,86,24,0,339
Albania,01/02/2008,10,0,-7,0,3,0,0,6
Albania,02/02/2008,-1,0,-4,0,12,0,0,7
Albania,03/02/2008,3,0,-4,0,0,3,0,2
Albania,04/02/2008,30,0,-4,0,1,0,0,27
Albania,05/02/2008,17,0,-1,0,-2,0,0,14
Albania,06/02/2008,30,0,-3,0,0,0,0,27
Albania,07/02/2008,0,0,-7,0,2,1,0,-4
Albania,08/02/2008,10,0,-7,0,4,0,0,7
Albania,09/02/2008,3,0,-10,0,12,0,0,5
Albania,10/02/2008,1,0,-8,0,0,2,0,-5
Albania,11/02/2008,34,0,-4,0,3,3,0,36
Albania,12/02/2008,6,0,-2,0,0,1,0,5
Albania,13/02/2008,29,2,-6,0,0,8,0,33
Albania,14/02/2008,67,0,-14,0,6,3,0,62
Albania,15/02/2008,100,0,-26,0,7,17,0,98
Albania,16/02/2008,96,0,-16,0,3,9,0,92
Albania,17/02/2008,153,0,-35,0,3,23,0,144
Albania,18/02/2008,109,2,-22,0,35,29,0,153
Albania,19/02/2008,67,2,-10,0,6,23,0,88
Albania,20/02/2008,64,0,-8,0,-1,6,0,61
Albania,21/02/2008,115,0,-4,0,9,17,0,137
Albania,22/02/2008,130,0,-3,0,3,47,0,177
Albania,23/02/2008,44,0,-2,0,0,11,0,53
Albania,24/02/2008,54,0,0,0,3,8,0,65
Albania,25/02/2008,65,0,-3,0,12,21,0,95
Albania,26/02/2008,48,0,-4,0,0,7,0,51
Albania,27/02/2008,36,0,-5,0,3,1,0,35
Albania,28/02/2008,22,0,-3,0,0,0,0,19
Albania,29/02/2008,8,0,-1,0,0,2,0,9
Algeria,01/02/2008,8,0,0,0,6,0,0,14
Algeria,02/02/2008,2,0,0,0,0,0,0,2
Algeria,03/02/2008,0,0,0,0,0,0,0,0
Algeria,04/02/2008,12,0,0,0,3,1,0,16
Algeria,05/02/2008,5,0,0,0,0,3,0,8
Algeria,06/02/2008,0,0,0,0,0,0,0,0
Algeria,07/02/2008,3,0,0,0,0,1,0,4
Algeria,08/02/2008,12,0,0,0,6,2,0,20
Algeria,09/02/2008,3,0,0,0,15,3,0,21
Algeria,10/02/2008,10,0,0,0,3,3,0,16
Algeria,11/02/2008,0,0,0,0,-1,0,0,-1
Algeria,12/02/2008,-6,0,0,0,0,2,0,-4
Algeria,13/02/2008,-1,0,0,0,0,0,0,-1
Algeria,14/02/2008,4,0,0,0,33,2,0,39
Algeria,15/02/2008,2,0,0,0,0,0,0,2
Algeria,16/02/2008,9,2,0,0,7,0,0,18
Algeria,17/02/2008,3,0,0,0,9,0,0,12
Algeria,18/02/2008,0,0,1,0,6,1,0,8
Algeria,19/02/2008,42,0,0,0,0,3,0,45
Algeria,20/02/2008,-15,0,0,0,3,3,0,-9
Algeria,21/02/2008,0,0,-1,0,0,0,0,-1
Algeria,22/02/2008,0,0,0,0,0,0,0,0
Algeria,23/02/2008,15,0,0,0,-4,0,0,11
Algeria,24/02/2008,5,0,0,0,0,0,0,5
Algeria,25/02/2008,14,0,0,0,0,0,0,14
Algeria,26/02/2008,0,0,0,0,12,0,0,12
Algeria,27/02/2008,5,2,0,0,27,0,0,34
Algeria,28/02/2008,1,0,0,0,12,0,0,13
Algeria,29/02/2008,18,0,-2,0,-5,4,0,15
Bangladesh,01/02/2008,3,0,0,0,9,0,0,12
Bangladesh,02/02/2008,4,0,0,0,3,0,0,7
Bangladesh,03/02/2008,10,0,0,0,4,0,0,14
Bangladesh,04/02/2008,4,0,-4,0,18,1,0,19
Bangladesh,05/02/2008,13,0,0,0,-1,2,0,14
Bangladesh,06/02/2008,0,0,0,0,10,0,0,10
Bangladesh,07/02/2008,5,0,0,0,8,0,0,13
Bangladesh,08/02/2008,1,0,0,0,21,0,0,22
Bangladesh,09/02/2008,0,0,0,0,13,0,0,13
Bangladesh,10/02/2008,11,0,1,0,9,0,0,21
Bangladesh,11/02/2008,7,0,0,0,12,0,0,19
Bangladesh,12/02/2008,11,0,0,0,6,1,0,18
Bangladesh,13/02/2008,7,0,0,0,6,4,0,17
Bangladesh,14/02/2008,13,0,0,0,2,1,0,16
Bangladesh,15/02/2008,3,0,0,0,7,1,0,11
Bangladesh,16/02/2008,-1,0,0,0,3,0,0,2
Bangladesh,17/02/2008,0,0,0,0,9,0,0,9
Bangladesh,18/02/2008,8,0,0,0,3,1,0,12
Bangladesh,19/02/2008,8,0,0,0,-2,5,0,11
Bangladesh,20/02/2008,1,0,0,0,6,0,0,7
Bangladesh,21/02/2008,7,0,0,0,12,0,0,19
Bangladesh,22/02/2008,8,0,0,0,3,0,0,11
Bangladesh,23/02/2008,4,0,0,0,2,1,0,7
Bangladesh,24/02/2008,12,0,0,0,12,0,0,24
Bangladesh,25/02/2008,22,0,0,0,1,0,0,23
Bangladesh,26/02/2008,10,0,0,0,-4,1,0,7
Bangladesh,27/02/2008,2,0,1,0,15,0,0,18
Bangladesh,28/02/2008,9,0,0,0,3,1,0,13
Bangladesh,29/02/2008,0,0,0,0,9,0,0,9
Cameroon,01/02/2008,0,0,0,0,0,0,0,0
Cameroon,02/02/2008,20,0,0,0,0,0,0,20
Cameroon,03/02/2008,23,0,0,0,0,0,0,23
Cameroon,04/02/2008,30,0,0,0,0,0,0,30
Cameroon,05/02/2008,66,0,1,0,1,1,0,69
Cameroon,06/02/2008,36,0,0,0,11,0,0,47
Cameroon,07/02/2008,18,0,0,0,6,0,0,24
Cameroon,08/02/2008,33,0,0,0,1,0,0,34
Cameroon,09/02/2008,7,0,-4,0,0,0,0,3
Cameroon,10/02/2008,9,0,0,0,0,0,0,9
Cameroon,11/02/2008,14,0,0,0,6,2,0,22
Cameroon,12/02/2008,0,0,0,0,6,0,0,6
Cameroon,13/02/2008,0,0,0,0,0,0,0,0
Cameroon,14/02/2008,2,0,0,0,3,1,0,6
Cameroon,15/02/2008,0,0,0,0,6,0,0,6
Cameroon,16/02/2008,0,0,0,0,3,0,0,3
Cameroon,17/02/2008,-9,0,0,0,1,0,0,-8
Cameroon,18/02/2008,-1,0,0,0,6,0,0,5
Cameroon,19/02/2008,0,0,0,0,3,0,0,3
Cameroon,20/02/2008,0,0,0,0,5,0,0,5
Cameroon,21/02/2008,21,0,-2,0,12,2,0,33
Cameroon,22/02/2008,0,0,0,0,0,0,0,0
Cameroon,23/02/2008,0,0,0,0,0,0,0,0
Cameroon,25/02/2008,1,0,0,0,0,0,0,1
Cameroon,26/02/2008,-4,0,0,0,0,0,0,-4
Cameroon,27/02/2008,0,0,0,0,0,3,0,3
Cameroon,28/02/2008,2,2,0,0,0,3,0,7
Cameroon,29/02/2008,9,0,0,0,0,0,0,9
China,01/02/2008,75,0,-2,0,28,5,0,106
China,02/02/2008,71,4,0,0,28,3,0,106
China,03/02/2008,94,4,0,0,9,3,0,110
China,04/02/2008,93,2,1,0,76,6,0,178
China,05/02/2008,102,2,-2,0,48,4,0,154
China,06/02/2008,72,0,0,0,44,6,0,122
China,07/02/2008,73,0,-1,0,23,6,0,101
China,08/02/2008,55,0,-4,0,24,4,0,79
China,09/02/2008,43,0,0,0,0,3,0,46
China,10/02/2008,43,0,-1,0,34,8,0,84
China,11/02/2008,18,0,-4,0,239,3,0,256
China,12/02/2008,100,0,-3,0,121,2,0,220
China,13/02/2008,101,2,3,0,38,8,0,152
China,14/02/2008,85,10,-2,0,33,12,0,138
China,15/02/2008,112,0,-4,0,41,12,0,161
China,16/02/2008,51,0,-4,0,22,4,0,73
China,17/02/2008,72,0,4,0,11,8,0,95
China,18/02/2008,191,0,1,0,22,4,0,218
China,19/02/2008,160,0,-8,0,37,9,0,198
China,20/02/2008,140,0,-7,0,29,17,0,179
China,21/02/2008,199,0,0,0,69,14,0,282
China,22/02/2008,59,2,-7,0,32,2,0,88
China,23/02/2008,44,0,-3,0,22,10,0,73
China,24/02/2008,38,0,-1,0,15,9,0,61
China,25/02/2008,57,4,-1,0,52,13,0,125
China,26/02/2008,71,0,5,0,24,5,0,105
China,27/02/2008,42,0,9,0,50,9,0,110
China,28/02/2008,78,0,2,0,22,4,0,106
China,29/02/2008,95,0,-1,0,70,7,0,171
Egypt,01/02/2008,41,0,23,0,-2,5,0,67
Egypt,02/02/2008,47,0,7,0,27,6,0,87
Egypt,03/02/2008,158,0,9,0,46,9,0,222
Egypt,04/02/2008,256,0,10,0,43,75,0,384
Egypt,05/02/2008,215,0,18,0,55,37,0,325
Egypt,06/02/2008,116,0,6,0,4,5,0,131
Egypt,07/02/2008,133,4,1,0,46,19,0,203
Egypt,08/02/2008,32,0,5,0,2,0,0,39
Egypt,09/02/2008,50,0,3,0,8,3,0,64
Egypt,10/02/2008,41,0,1,0,26,3,0,71
Egypt,11/02/2008,40,0,5,0,6,2,0,53
Egypt,12/02/2008,20,0,2,0,4,0,0,26
Egypt,13/02/2008,9,4,-1,0,28,3,0,43
Egypt,14/02/2008,24,0,4,0,5,10,0,43
Egypt,15/02/2008,23,0,0,0,7,2,0,32
Egypt,16/02/2008,38,0,0,0,22,1,0,61
Egypt,17/02/2008,23,0,0,0,8,0,0,31
Egypt,18/02/2008,56,0,-2,0,7,2,0,63
Egypt,19/02/2008,44,0,0,0,18,3,0,65
Egypt,20/02/2008,8,0,2,0,24,4,0,38
Egypt,21/02/2008,16,0,0,0,9,4,0,29
Egypt,22/02/2008,11,0,0,0,2,0,0,13
Egypt,23/02/2008,8,0,0,0,22,1,0,31
Egypt,24/02/2008,58,0,7,0,9,11,0,85
Egypt,25/02/2008,122,0,2,0,13,3,0,140
Egypt,26/02/2008,30,0,0,0,34,1,0,65
Egypt,27/02/2008,56,0,0,0,-2,2,0,56
Egypt,28/02/2008,65,0,0,0,21,0,0,86
Egypt,29/02/2008,39,0,0,0,6,0,0,45
Eritrea,01/02/2008,2,0,1,0,0,0,0,3
Eritrea,04/02/2008,1,0,0,0,0,0,0,1
Eritrea,05/02/2008,5,0,0,0,0,2,0,7
Eritrea,06/02/2008,-2,0,0,0,3,0,0,1
Eritrea,07/02/2008,3,0,0,0,0,0,0,3
Eritrea,08/02/2008,4,0,0,0,9,0,0,13
Eritrea,09/02/2008,0,0,0,0,0,0,0,0
Eritrea,10/02/2008,0,0,0,0,0,0,0,0
Eritrea,12/02/2008,3,0,0,0,0,0,0,3
Eritrea,13/02/2008,8,0,0,0,0,0,0,8
Eritrea,14/02/2008,3,0,0,0,0,0,0,3
Eritrea,15/02/2008,40,0,0,0,0,0,0,40
Eritrea,16/02/2008,14,0,0,0,0,2,0,16
Eritrea,17/02/2008,2,0,0,0,-4,0,0,-2
Eritrea,18/02/2008,3,0,0,0,0,0,0,3
Eritrea,19/02/2008,24,0,0,0,3,0,0,27
Eritrea,20/02/2008,3,0,0,0,9,0,0,12
Eritrea,21/02/2008,24,0,0,0,0,0,0,24
Eritrea,22/02/2008,19,0,0,0,15,2,0,36
Eritrea,24/02/2008,0,0,0,0,-3,0,0,-3
Eritrea,25/02/2008,6,0,0,0,-8,0,0,-2
Eritrea,26/02/2008,9,0,0,0,2,0,0,11
Eritrea,27/02/2008,0,0,0,0,6,0,0,6
Eritrea,28/02/2008,7,0,0,0,7,0,0,14
Eritrea,29/02/2008,1,0,0,0,0,0,0,1
Georgia,01/02/2008,17,0,0,0,21,0,0,38
Georgia,02/02/2008,4,0,0,0,6,1,0,11
Georgia,03/02/2008,7,0,0,0,7,0,0,14
Georgia,04/02/2008,16,0,0,0,5,0,0,21
Georgia,05/02/2008,16,0,0,0,8,1,0,25
Georgia,06/02/2008,20,0,0,0,6,4,0,30
Georgia,07/02/2008,17,0,0,0,3,0,0,20
Georgia,08/02/2008,4,0,0,0,3,3,0,10
Georgia,09/02/2008,6,0,0,0,0,0,0,6
Georgia,10/02/2008,9,0,-1,0,-1,4,0,11
Georgia,11/02/2008,10,0,-2,0,5,0,0,13
Georgia,12/02/2008,19,0,0,0,9,0,0,28
Georgia,13/02/2008,28,0,0,0,9,4,0,41
Georgia,14/02/2008,39,0,-2,0,3,2,0,42
Georgia,15/02/2008,7,0,0,0,-1,1,0,7
Georgia,16/02/2008,3,0,0,0,-2,2,0,3
Georgia,17/02/2008,12,0,0,0,-2,2,0,12
Georgia,18/02/2008,3,0,0,0,3,1,0,7
Georgia,19/02/2008,12,0,-2,0,1,3,0,14
Georgia,20/02/2008,7,0,0,0,4,2,0,13
Georgia,21/02/2008,20,0,-1,0,4,2,0,25
Georgia,22/02/2008,3,2,0,0,4,0,0,9
Georgia,23/02/2008,0,2,1,0,3,0,0,6
Georgia,24/02/2008,0,0,0,0,0,3,0,3
Georgia,25/02/2008,5,0,0,0,13,1,0,19
Georgia,26/02/2008,4,0,-1,0,0,2,0,5
Georgia,27/02/2008,6,0,0,0,7,0,0,13
Georgia,28/02/2008,16,0,0,0,18,0,0,34
Georgia,29/02/2008,23,0,-1,0,6,2,0,30
India,01/02/2008,37,0,0,0,5,5,0,47
India,02/02/2008,25,0,1,0,4,2,0,32
India,03/02/2008,42,0,0,0,8,4,0,54
India,04/02/2008,30,0,0,0,13,8,0,51
India,05/02/2008,29,0,-1,0,14,3,0,45
India,06/02/2008,27,0,0,0,9,2,0,38
India,07/02/2008,34,0,-3,0,34,3,0,68
India,08/02/2008,60,0,0,0,25,10,0,95
India,09/02/2008,10,0,-1,0,6,3,0,18
India,10/02/2008,49,2,-1,0,13,0,0,63
India,11/02/2008,31,2,0,0,15,0,0,48
India,12/02/2008,28,0,1,0,12,6,0,47
India,13/02/2008,31,2,-1,0,23,4,0,59
India,14/02/2008,34,0,0,0,1,2,0,37
India,15/02/2008,38,0,-2,0,8,10,0,54
India,16/02/2008,22,0,0,0,7,4,0,33
India,17/02/2008,33,0,0,0,6,1,0,40
India,18/02/2008,26,2,-1,0,1,0,0,28
India,19/02/2008,13,0,0,0,3,1,0,17
India,20/02/2008,24,0,-2,0,9,6,0,37
India,21/02/2008,45,2,-5,0,12,1,0,55
India,22/02/2008,18,0,0,0,18,3,0,39
India,23/02/2008,15,0,-2,0,0,3,0,16
India,24/02/2008,15,0,0,0,8,5,0,28
India,25/02/2008,32,0,0,0,4,5,0,41
India,26/02/2008,25,0,0,0,7,2,0,34
India,27/02/2008,18,0,0,0,17,9,0,44
India,28/02/2008,13,0,0,0,3,2,0,18
India,29/02/2008,18,0,0,0,16,4,0,38
Iran,01/02/2008,20,0,1,0,6,1,0,28
Iran,02/02/2008,14,0,0,0,8,3,0,25
Iran,03/02/2008,35,0,0,0,24,0,0,59
Iran,04/02/2008,44,0,-2,0,15,4,0,61
Iran,05/02/2008,15,0,1,0,19,5,0,40
Iran,06/02/2008,20,0,1,0,33,3,0,57
Iran,07/02/2008,26,2,2,0,11,2,0,43
Iran,08/02/2008,16,0,0,0,8,5,0,29
Iran,09/02/2008,19,0,0,0,6,2,0,27
Iran,10/02/2008,35,0,0,0,18,6,0,59
Iran,11/02/2008,28,0,0,0,11,6,0,45
Iran,12/02/2008,54,0,0,0,26,3,0,83
Iran,13/02/2008,107,0,3,0,14,7,0,131
Iran,14/02/2008,93,0,0,0,7,20,0,120
Iran,15/02/2008,94,0,0,0,3,26,0,123
Iran,16/02/2008,42,0,0,0,10,1,0,53
Iran,17/02/2008,68,0,1,0,10,5,0,84
Iran,18/02/2008,65,0,-7,0,19,2,0,79
Iran,19/02/2008,37,0,1,0,31,2,0,71
Iran,20/02/2008,47,0,8,0,-4,17,0,68
Iran,21/02/2008,70,0,7,0,12,6,0,95
Iran,22/02/2008,29,0,4,0,13,9,0,55
Iran,23/02/2008,15,0,1,0,7,10,0,33
Iran,24/02/2008,17,0,1,0,0,0,0,18
Iran,25/02/2008,76,0,1,0,11,1,0,89
Iran,26/02/2008,57,0,3,0,13,0,0,73
Iran,27/02/2008,48,0,0,0,26,5,0,79
Iran,28/02/2008,52,0,0,0,9,12,0,73
Iran,29/02/2008,36,2,0,0,27,4,0,69
Iraq,01/02/2008,112,0,0,0,30,8,0,150
Iraq,02/02/2008,79,2,14,0,30,2,0,127
Iraq,03/02/2008,121,0,1,0,-4,2,0,120
Iraq,04/02/2008,241,0,5,0,42,6,0,294
Iraq,05/02/2008,251,2,2,0,24,9,0,288
Iraq,06/02/2008,229,0,-1,0,16,10,0,254
Iraq,07/02/2008,71,0,1,0,34,7,0,113
Iraq,08/02/2008,85,2,-1,0,24,25,0,135
Iraq,09/02/2008,69,0,2,0,18,8,0,97
Iraq,10/02/2008,83,0,0,0,34,20,0,137
Iraq,11/02/2008,79,0,-2,0,33,14,0,124
Iraq,12/02/2008,65,10,13,0,74,12,0,174
Iraq,13/02/2008,113,4,1,0,-6,14,0,126
Iraq,14/02/2008,126,4,0,0,29,5,0,164
Iraq,15/02/2008,128,2,1,0,28,13,0,172
Iraq,16/02/2008,66,2,2,0,5,2,0,77
Iraq,17/02/2008,71,0,1,0,16,4,0,92
Iraq,18/02/2008,107,0,1,0,6,20,0,134
Iraq,19/02/2008,108,0,0,0,15,5,0,128
Iraq,20/02/2008,89,0,1,0,15,9,0,114
Iraq,21/02/2008,175,0,-7,0,9,19,0,196
Iraq,22/02/2008,304,0,-2,0,59,15,0,376
Iraq,23/02/2008,251,0,-2,0,21,11,0,281
Iraq,24/02/2008,288,0,4,0,43,19,0,354
Iraq,25/02/2008,323,0,-1,0,7,8,0,337
Iraq,26/02/2008,249,0,-1,0,21,14,0,283
Iraq,27/02/2008,292,0,-2,0,51,20,0,361
Iraq,28/02/2008,332,0,-4,0,59,31,0,418
Iraq,29/02/2008,291,14,2,0,77,25,0,409
Morocco,01/02/2008,4,0,0,0,1,0,0,5
Morocco,02/02/2008,0,0,0,0,0,0,0,0
Morocco,03/02/2008,6,0,0,0,0,0,0,6
Morocco,04/02/2008,9,0,0,0,3,0,0,12
Morocco,05/02/2008,3,0,0,0,0,0,0,3
Morocco,06/02/2008,0,0,0,0,3,0,0,3
Morocco,07/02/2008,15,0,0,0,3,0,0,18
Morocco,08/02/2008,9,0,0,0,30,0,0,39
Morocco,09/02/2008,2,0,0,0,-1,0,0,1
Morocco,10/02/2008,2,0,0,0,6,0,0,8
Morocco,11/02/2008,5,0,0,0,21,2,0,28
Morocco,12/02/2008,1,0,0,0,15,3,0,19
Morocco,13/02/2008,18,0,1,0,6,0,0,25
Morocco,14/02/2008,3,0,1,0,1,0,0,5
Morocco,15/02/2008,8,0,0,0,-8,0,0,0
Morocco,16/02/2008,1,0,0,0,10,0,0,11
Morocco,17/02/2008,5,0,0,0,0,1,0,6
Morocco,18/02/2008,11,0,0,0,16,0,0,27
Morocco,19/02/2008,6,0,0,0,18,2,0,26
Morocco,20/02/2008,13,0,1,0,18,2,0,34
Morocco,21/02/2008,0,0,0,0,3,0,0,3
Morocco,22/02/2008,4,0,0,0,15,0,0,19
Morocco,23/02/2008,-1,0,0,0,51,1,0,51
Morocco,24/02/2008,1,0,0,0,36,0,0,37
Morocco,25/02/2008,0,0,0,0,15,0,0,15
Morocco,26/02/2008,0,0,0,0,18,3,0,21
Morocco,27/02/2008,8,0,0,0,19,0,0,27
Morocco,28/02/2008,6,0,0,0,1,0,0,7
Morocco,29/02/2008,4,0,0,0,0,0,0,4
Nigeria,01/02/2008,-9,0,1,0,0,12,0,4
Nigeria,02/02/2008,3,0,0,0,0,0,0,3
Nigeria,03/02/2008,7,0,0,0,0,0,0,7
Nigeria,04/02/2008,42,0,0,0,0,0,0,42
Nigeria,05/02/2008,11,0,0,0,0,0,0,11
Nigeria,06/02/2008,11,0,0,0,0,0,0,11
Nigeria,07/02/2008,53,0,0,0,0,1,0,54
Nigeria,08/02/2008,12,0,0,0,6,0,0,18
Nigeria,09/02/2008,6,0,0,0,3,3,0,12
Nigeria,10/02/2008,8,0,0,0,0,0,0,8
Nigeria,11/02/2008,43,0,0,0,6,0,0,49
Nigeria,12/02/2008,5,2,0,0,0,2,0,9
Nigeria,13/02/2008,18,0,0,0,3,1,0,22
Nigeria,14/02/2008,2,0,0,0,3,0,0,5
Nigeria,15/02/2008,5,0,0,0,-6,0,0,-1
Nigeria,16/02/2008,5,0,0,0,0,0,0,5
Nigeria,17/02/2008,4,0,0,0,3,0,0,7
Nigeria,18/02/2008,10,0,-2,0,0,0,0,8
Nigeria,19/02/2008,3,0,0,0,0,2,0,5
Nigeria,20/02/2008,6,0,0,0,0,0,0,6
Nigeria,21/02/2008,13,2,0,0,3,1,0,19
Nigeria,22/02/2008,17,0,0,0,6,0,0,23
Nigeria,23/02/2008,1,0,0,0,0,1,0,2
Nigeria,24/02/2008,0,0,0,0,3,0,0,3
Nigeria,25/02/2008,4,0,0,0,12,3,0,19
Nigeria,26/02/2008,23,0,5,0,9,3,0,40
Nigeria,27/02/2008,36,0,0,0,0,3,0,39
Nigeria,28/02/2008,12,0,-2,0,0,1,0,11
Nigeria,29/02/2008,0,0,0,0,0,1,0,1
Pakistan,01/02/2008,88,0,-4,0,4,7,0,95
Pakistan,02/02/2008,24,0,-2,0,6,6,0,34
Pakistan,03/02/2008,33,0,-2,0,4,6,0,41
Pakistan,04/02/2008,69,0,-4,0,58,16,0,139
Pakistan,05/02/2008,105,0,-2,0,61,3,0,167
Pakistan,06/02/2008,89,0,-2,0,17,5,0,109
Pakistan,07/02/2008,82,8,-1,0,25,10,0,124
Pakistan,08/02/2008,89,0,0,0,11,1,0,101
Pakistan,09/02/2008,39,0,0,0,7,0,0,46
Pakistan,10/02/2008,79,0,0,0,42,12,0,133
Pakistan,11/02/2008,141,0,0,0,109,7,0,257
Pakistan,12/02/2008,75,4,0,0,26,9,0,114
Pakistan,13/02/2008,77,0,1,0,20,2,0,100
Pakistan,14/02/2008,46,0,0,0,30,2,0,78
Pakistan,15/02/2008,65,0,-2,0,35,12,0,110
Pakistan,16/02/2008,54,0,-4,0,41,25,0,116
Pakistan,17/02/2008,63,0,-1,0,-2,31,0,91
Pakistan,18/02/2008,78,0,-6,0,45,19,0,136
Pakistan,19/02/2008,102,0,-3,0,14,10,0,123
Pakistan,20/02/2008,93,2,-6,0,8,10,0,107
Pakistan,21/02/2008,97,0,-6,0,14,16,0,121
Pakistan,22/02/2008,21,0,-4,0,30,2,0,49
Pakistan,23/02/2008,42,0,-5,0,18,3,0,58
Pakistan,24/02/2008,62,0,-3,0,22,4,0,85
Pakistan,25/02/2008,43,0,0,0,59,1,0,103
Pakistan,26/02/2008,79,0,0,0,107,11,0,197
Pakistan,27/02/2008,51,0,-3,0,47,19,0,114
Pakistan,28/02/2008,85,0,0,0,23,6,0,114
Pakistan,29/02/2008,62,0,2,0,13,9,0,86
Sierra Leone,04/02/2008,5,0,0,0,12,0,0,17
Sierra Leone,05/02/2008,0,0,0,0,3,0,0,3
Sierra Leone,06/02/2008,2,0,0,0,6,0,0,8
Sierra Leone,07/02/2008,8,0,0,0,0,0,0,8
Sierra Leone,08/02/2008,11,0,0,0,0,0,0,11
Sierra Leone,09/02/2008,0,0,0,0,15,0,0,15
Sierra Leone,11/02/2008,3,0,0,0,4,1,0,8
Sierra Leone,12/02/2008,8,0,0,0,0,2,0,10
Sierra Leone,13/02/2008,2,0,0,0,6,0,0,8
Sierra Leone,14/02/2008,0,0,0,0,0,0,0,0
Sierra Leone,15/02/2008,0,0,0,0,0,0,0,0
Sierra Leone,17/02/2008,0,0,0,0,0,0,0,0
Sierra Leone,18/02/2008,0,0,0,0,0,0,0,0
Sierra Leone,19/02/2008,1,0,0,0,0,0,0,1
Sierra Leone,20/02/2008,1,0,0,0,0,0,0,1
Sierra Leone,21/02/2008,0,0,0,0,3,0,0,3
Sierra Leone,22/02/2008,1,0,1,0,21,0,0,23
Sierra Leone,24/02/2008,3,0,0,0,0,0,0,3
Sierra Leone,25/02/2008,3,0,0,0,0,0,0,3
Sierra Leone,26/02/2008,0,0,0,0,0,0,0,0
Sierra Leone,27/02/2008,0,0,0,0,-6,0,0,-6
Sierra Leone,28/02/2008,4,0,0,0,3,0,0,7
Sierra Leone,29/02/2008,0,0,0,0,0,0,0,0
Somalia,01/02/2008,1,0,0,0,2,2,0,5
Somalia,02/02/2008,7,0,0,0,0,0,0,7
Somalia,03/02/2008,0,0,0,0,0,0,0,0
Somalia,04/02/2008,1,0,0,0,11,0,0,12
Somalia,05/02/2008,24,0,0,0,0,0,0,24
Somalia,06/02/2008,34,0,0,0,0,0,0,34
Somalia,07/02/2008,9,0,0,0,-2,0,0,7
Somalia,08/02/2008,20,0,0,0,20,0,0,40
Somalia,09/02/2008,9,0,0,0,5,0,0,14
Somalia,10/02/2008,29,0,0,0,2,0,0,31
Somalia,11/02/2008,4,0,0,0,6,0,0,10
Somalia,12/02/2008,11,0,0,0,3,0,0,14
Somalia,13/02/2008,11,0,0,0,-4,0,0,7
Somalia,14/02/2008,17,0,0,0,0,0,0,17
Somalia,15/02/2008,7,0,0,0,4,2,0,13
Somalia,16/02/2008,9,0,0,0,0,2,0,11
Somalia,17/02/2008,9,0,0,0,2,2,0,13
Somalia,18/02/2008,2,0,0,0,3,0,0,5
Somalia,19/02/2008,-3,0,0,0,-2,0,0,-5
Somalia,20/02/2008,-1,0,0,0,0,0,0,-1
Somalia,21/02/2008,-1,0,0,0,0,1,0,0
Somalia,22/02/2008,2,0,0,0,3,0,0,5
Somalia,23/02/2008,5,0,0,0,3,0,0,8
Somalia,24/02/2008,5,0,0,0,0,0,0,5
Somalia,25/02/2008,6,0,0,0,3,0,0,9
Somalia,26/02/2008,8,0,0,0,3,0,0,11
Somalia,27/02/2008,18,0,0,0,3,0,0,21
Somalia,28/02/2008,61,0,-2,0,11,2,0,72
Somalia,29/02/2008,25,2,0,0,19,0,0,46
Syria,01/02/2008,36,0,0,0,3,2,0,41
Syria,02/02/2008,14,0,0,0,12,1,0,27
Syria,03/02/2008,7,0,0,0,6,0,0,13
Syria,04/02/2008,2,0,0,0,6,1,0,9
Syria,05/02/2008,22,0,0,0,18,1,0,41
Syria,06/02/2008,56,0,0,0,0,1,0,57
Syria,07/02/2008,25,0,0,0,0,0,0,25
Syria,08/02/2008,14,0,1,0,0,1,0,16
Syria,09/02/2008,5,0,2,0,0,0,0,7
Syria,10/02/2008,63,0,-1,0,5,5,0,72
Syria,11/02/2008,29,0,0,0,6,2,0,37
Syria,12/02/2008,5,0,0,0,9,8,0,22
Syria,13/02/2008,45,0,1,0,0,14,0,60
Syria,14/02/2008,55,0,1,0,0,15,0,71
Syria,15/02/2008,27,0,0,0,0,2,0,29
Syria,16/02/2008,17,0,0,0,13,0,0,30
Syria,17/02/2008,9,0,0,0,1,0,0,10
Syria,18/02/2008,36,0,0,0,21,0,0,57
Syria,19/02/2008,53,0,0,0,39,0,0,92
Syria,20/02/2008,26,0,0,0,9,4,0,39
Syria,21/02/2008,56,0,0,0,6,5,0,67
Syria,22/02/2008,13,0,0,0,20,11,0,44
Syria,23/02/2008,18,0,0,0,11,0,0,29
Syria,24/02/2008,1,0,0,0,1,0,0,2
Syria,25/02/2008,2,0,0,0,0,0,0,2
Syria,26/02/2008,19,0,0,0,0,0,0,19
Syria,27/02/2008,15,0,0,0,-1,0,0,14
Syria,28/02/2008,7,0,-4,0,18,2,0,23
Syria,29/02/2008,9,0,0,0,-9,0,0,0
Yemen,01/02/2008,13,0,0,0,0,0,0,13
Yemen,02/02/2008,6,0,0,0,0,0,0,6
Yemen,03/02/2008,0,0,0,0,0,0,0,0
Yemen,04/02/2008,3,0,0,0,0,0,0,3
Yemen,05/02/2008,13,0,0,0,0,0,0,13
Yemen,06/02/2008,14,0,0,0,15,0,0,29
Yemen,07/02/2008,29,0,0,0,27,0,0,56
Yemen,08/02/2008,31,2,0,0,21,0,0,54
Yemen,09/02/2008,12,0,0,0,15,1,0,28
Yemen,10/02/2008,9,0,0,0,12,0,0,21
Yemen,11/02/2008,11,0,0,0,0,0,0,11
Yemen,12/02/2008,0,0,-1,0,0,2,0,1
Yemen,13/02/2008,16,0,-1,0,1,0,0,16
Yemen,14/02/2008,19,0,0,0,0,8,0,27
Yemen,16/02/2008,0,0,0,0,0,0,0,0
Yemen,17/02/2008,3,0,0,0,7,0,0,10
Yemen,19/02/2008,0,0,-1,0,0,0,0,-1
Yemen,20/02/2008,15,0,0,0,3,0,0,18
Yemen,21/02/2008,10,0,0,0,0,4,0,14
Yemen,22/02/2008,2,0,0,0,12,3,0,17
Yemen,23/02/2008,0,0,0,0,12,0,0,12
Yemen,24/02/2008,1,0,0,0,33,0,0,34
Yemen,25/02/2008,10,0,0,0,0,0,0,10
Yemen,26/02/2008,9,0,0,0,0,0,0,9
Yemen,27/02/2008,20,0,0,0,6,2,0,28
Yemen,28/02/2008,21,0,0,0,0,2,0,23
Yemen,29/02/2008,28,0,0,0,9,1,0,38
Afghanistan,01/01/2013,81,0,0,0,-13,4,0,72
Afghanistan,02/01/2013,112,0,0,0,32,2,0,146
Afghanistan,03/01/2013,298,0,0,0,55,18,0,371
Afghanistan,04/01/2013,94,0,0,0,17,12,0,123
Afghanistan,05/01/2013,52,0,0,0,10,4,0,66
Afghanistan,06/01/2013,174,0,-2,0,-6,21,0,187
Afghanistan,07/01/2013,182,0,-5,0,-3,15,0,189
Afghanistan,08/01/2013,146,0,0,0,37,19,0,202
Afghanistan,09/01/2013,71,4,-1,0,-10,19,0,83
Afghanistan,10/01/2013,110,2,-3,0,58,12,0,179
Afghanistan,11/01/2013,241,0,-13,0,49,17,0,294
Afghanistan,12/01/2013,156,0,0,0,40,10,0,206
Afghanistan,13/01/2013,121,0,0,0,20,14,0,155
Afghanistan,14/01/2013,115,4,-2,0,14,11,0,142
Afghanistan,15/01/2013,154,0,0,0,18,3,0,175
Afghanistan,16/01/2013,212,0,-2,0,89,26,0,325
Afghanistan,17/01/2013,256,2,-1,0,18,11,0,286
Afghanistan,18/01/2013,103,4,0,0,17,4,0,128
Afghanistan,19/01/2013,88,0,0,0,29,10,0,127
Afghanistan,20/01/2013,48,2,0,0,15,3,0,68
Afghanistan,21/01/2013,268,0,-4,0,15,18,0,297
Afghanistan,22/01/2013,165,0,0,0,50,7,0,222
Afghanistan,23/01/2013,66,0,0,0,21,1,0,88
Afghanistan,24/01/2013,231,0,1,0,54,14,0,300
Afghanistan,25/01/2013,217,2,0,0,38,33,0,290
Afghanistan,26/01/2013,115,2,-2,0,5,6,0,126
Afghanistan,27/01/2013,78,0,-4,0,0,14,0,88
Afghanistan,28/01/2013,114,2,0,0,15,7,0,138
Afghanistan,29/01/2013,104,0,-3,0,4,8,0,113
Afghanistan,30/01/2013,174,2,-1,0,18,11,0,204
Afghanistan,31/01/2013,172,0,-6,0,33,21,0,220
Albania,01/01/2013,0,0,-1,0,3,0,0,2
Albania,02/01/2013,0,0,0,0,0,0,0,0
Albania,03/01/2013,0,0,0,0,6,0,0,6
Albania,04/01/2013,0,0,0,0,9,2,0,11
Albania,05/01/2013,4,0,0,0,0,4,0,8
Albania,06/01/2013,0,0,0,0,0,1,0,1
Albania,07/01/2013,6,0,0,0,0,2,0,8
Albania,08/01/2013,3,0,0,0,0,0,0,3
Albania,09/01/2013,1,0,0,0,6,0,0,7
Albania,10/01/2013,0,0,0,0,3,0,0,3
Albania,11/01/2013,3,0,-1,0,0,0,0,2
Albania,12/01/2013,0,0,0,0,3,0,0,3
Albania,13/01/2013,4,0,0,0,9,0,0,13
Albania,14/01/2013,5,0,0,0,3,0,0,8
Albania,15/01/2013,0,0,0,0,1,0,0,1
Albania,16/01/2013,21,0,0,0,0,0,0,21
Albania,17/01/2013,9,0,0,0,0,2,0,11
Albania,18/01/2013,1,0,0,0,0,3,0,4
Albania,19/01/2013,6,0,0,0,0,0,0,6
Albania,20/01/2013,18,0,0,0,0,0,0,18
Albania,21/01/2013,7,0,0,0,0,15,0,22
Albania,22/01/2013,1,0,0,0,0,4,0,5
Albania,24/01/2013,4,0,0,0,0,0,0,4
Albania,25/01/2013,4,0,0,0,0,0,0,4
Albania,26/01/2013,3,0,0,0,0,2,0,5
Albania,27/01/2013,2,0,0,0,0,0,0,2
Albania,28/01/2013,-1,0,0,0,0,0,0,-1
Albania,29/01/2013,0,0,0,0,0,0,0,0
Albania,30/01/2013,2,0,0,0,0,1,0,3
Albania,31/01/2013,0,0,0,0,0,0,0,0
Algeria,01/01/2013,598,2,-4,0,191,69,0,856
Algeria,02/01/2013,93,0,0,0,34,4,0,131
Algeria,03/01/2013,69,0,-2,0,14,6,0,87
Algeria,04/01/2013,714,10,-4,0,228,67,0,1015
Algeria,05/01/2013,20,0,-8,0,3,1,0,16
Algeria,06/01/2013,-3,0,-2,0,3,0,0,-2
Algeria,07/01/2013,226,2,-2,0,30,43,0,299
Algeria,08/01/2013,181,0,0,0,46,17,0,244
Algeria,09/01/2013,4,0,0,0,12,0,0,16
Algeria,10/01/2013,12,0,0,0,9,0,0,21
Algeria,11/01/2013,5,0,0,0,0,0,0,5
Algeria,12/01/2013,119,0,0,0,20,9,0,148
Algeria,13/01/2013,447,10,-4,0,64,45,0,562
Algeria,14/01/2013,226,2,0,0,88,31,0,347
Algeria,15/01/2013,45,0,0,0,24,3,0,72
Algeria,16/01/2013,312,0,0,0,226,40,0,578
Algeria,17/01/2013,799,8,1,0,272,93,0,1173
Algeria,18/01/2013,751,2,1,0,206,87,0,1047
Algeria,19/01/2013,551,0,-2,0,234,87,0,870
Algeria,20/01/2013,186,0,0,0,22,40,0,248
Algeria,21/01/2013,1061,6,-3,0,222,162,0,1448
Algeria,22/01/2013,279,0,0,0,54,39,0,372
Algeria,23/01/2013,97,0,0,0,24,8,0,129
Algeria,24/01/2013,324,8,-1,0,73,26,0,430
Algeria,25/01/2013,127,0,2,0,48,4,0,181
Algeria,26/01/2013,86,0,0,0,6,1,0,93
Algeria,27/01/2013,60,0,0,0,1,4,0,65
Algeria,28/01/2013,64,0,2,0,21,14,0,101
Algeria,29/01/2013,76,0,0,0,10,2,0,88
Algeria,30/01/2013,57,0,0,0,-1,3,0,59
Algeria,31/01/2013,38,0,0,0,27,6,0,71
Bangladesh,01/01/2013,22,0,0,0,0,4,0,26
Bangladesh,02/01/2013,16,0,0,0,0,4,0,20
Bangladesh,03/01/2013,16,0,0,0,-6,2,0,12
Bangladesh,04/01/2013,9,0,0,0,6,5,0,20
Bangladesh,05/01/2013,8,0,0,0,6,1,0,15
Bangladesh,06/01/2013,7,0,0,0,7,1,0,15
Bangladesh,07/01/2013,25,0,0,0,8,0,0,33
Bangladesh,08/01/2013,17,0,1,0,7,2,0,27
Bangladesh,09/01/2013,22,0,0,0,22,5,0,49
Bangladesh,10/01/2013,13,0,0,0,-1,4,0,16
Bangladesh,11/01/2013,39,0,0,0,24,1,0,64
Bangladesh,12/01/2013,11,0,1,0,22,1,0,35
Bangladesh,13/01/2013,22,0,1,0,3,5,0,31
Bangladesh,14/01/2013,30,0,0,0,3,1,0,34
Bangladesh,15/01/2013,31,0,0,0,14,4,0,49
Bangladesh,16/01/2013,28,0,0,0,6,10,0,44
Bangladesh,17/01/2013,1,0,-4,0,-1,3,0,-1
Bangladesh,18/01/2013,5,0,1,0,6,3,0,15
Bangladesh,19/01/2013,7,0,0,0,-4,13,0,16
Bangladesh,20/01/2013,2,0,0,0,0,0,0,2
Bangladesh,21/01/2013,34,2,1,0,62,25,0,124
Bangladesh,22/01/2013,43,0,0,0,36,6,0,85
Bangladesh,23/01/2013,10,0,0,0,30,3,0,43
Bangladesh,24/01/2013,22,0,2,0,28,11,0,63
Bangladesh,25/01/2013,3,0,0,0,-5,1,0,-1
Bangladesh,26/01/2013,22,0,0,0,0,0,0,22
Bangladesh,27/01/2013,31,0,0,0,10,1,0,42
Bangladesh,28/01/2013,42,0,0,0,16,4,0,62
Bangladesh,29/01/2013,7,0,0,0,6,1,0,14
Bangladesh,30/01/2013,29,0,2,0,-4,8,0,35
Bangladesh,31/01/2013,13,0,0,0,15,0,0,28
Cameroon,01/01/2013,1,0,0,0,3,0,0,4
Cameroon,02/01/2013,-4,0,0,0,1,2,0,-1
Cameroon,03/01/2013,19,0,0,0,0,0,0,19
Cameroon,04/01/2013,1,0,0,0,0,0,0,1
Cameroon,05/01/2013,0,0,0,0,0,0,0,0
Cameroon,06/01/2013,0,0,0,0,0,0,0,0
Cameroon,07/01/2013,0,0,0,0,2,0,0,2
Cameroon,08/01/2013,2,0,0,0,-2,0,0,0
Cameroon,09/01/2013,0,0,0,0,17,0,0,17
Cameroon,10/01/2013,-2,0,0,0,18,0,0,16
Cameroon,11/01/2013,0,0,0,0,0,0,0,0
Cameroon,12/01/2013,0,0,0,0,0,0,0,0
Cameroon,15/01/2013,0,0,0,0,0,0,0,0
Cameroon,17/01/2013,2,0,0,0,3,0,0,5
Cameroon,21/01/2013,0,0,0,0,0,0,0,0
Cameroon,22/01/2013,3,0,0,0,0,0,0,3
Cameroon,23/01/2013,0,0,0,0,0,0,0,0
Cameroon,24/01/2013,0,0,0,0,0,0,0,0
Cameroon,25/01/2013,1,0,0,0,0,0,0,1
Cameroon,27/01/2013,0,0,0,0,0,0,0,0
Cameroon,28/01/2013,0,0,0,0,3,0,0,3
Cameroon,29/01/2013,-1,0,0,0,0,0,0,-1
Cameroon,30/01/2013,2,0,0,0,0,0,0,2
Cameroon,31/01/2013,-3,0,0,0,15,0,0,12
China,01/01/2013,52,0,4,0,60,4,0,120
China,02/01/2013,123,0,-3,0,113,24,0,257
China,03/01/2013,150,0,1,0,74,14,0,239
China,04/01/2013,88,2,0,0,120,18,0,228
China,05/01/2013,92,0,-2,0,52,9,0,151
China,06/01/2013,60,0,-13,0,44,6,0,97
China,07/01/2013,155,2,0,0,100,15,0,272
China,08/01/2013,192,2,-4,0,10,19,0,219
China,09/01/2013,114,4,-1,0,95,10,0,222
China,10/01/2013,163,2,-4,0,53,15,0,229
China,11/01/2013,131,2,0,0,12,8,0,153
China,12/01/2013,129,0,0,0,22,4,0,155
China,13/01/2013,85,0,0,0,56,12,0,153
China,14/01/2013,157,2,-3,0,94,12,0,262
China,15/01/2013,168,0,-30,0,50,20,0,208
China,16/01/2013,157,0,-12,0,68,27,0,240
China,17/01/2013,123,0,-10,0,47,12,0,172
China,18/01/2013,134,2,-14,0,51,23,0,196
China,19/01/2013,69,0,1,0,45,12,0,127
China,20/01/2013,32,0,0,0,15,5,0,52
China,21/01/2013,130,6,-3,0,16,6,0,155
China,22/01/2013,159,4,0,0,29,11,0,203
China,23/01/2013,49,0,-4,0,23,10,0,78
China,24/01/2013,74,0,-2,0,37,24,0,133
China,25/01/2013,108,2,-3,0,78,25,0,210
China,26/01/2013,116,0,3,0,15,11,0,145
China,27/01/2013,83,2,0,0,23,2,0,110
China,28/01/2013,107,2,-6,0,55,15,0,173
China,29/01/2013,119,2,-4,0,52,12,0,181
China,30/01/2013,93,0,-6,0,76,23,0,186
China,31/01/2013,201,4,5,0,80,20,0,310
Egypt,01/01/2013,58,0,-1,0,64,8,0,129
Egypt,02/01/2013,47,0,-6,0,83,11,0,135
Egypt,03/01/2013,46,0,0,0,43,2,0,91
Egypt,04/01/2013,79,0,1,0,24,19,0,123
Egypt,05/01/2013,37,0,-10,0,28,20,0,75
Egypt,06/01/2013,56,4,-4,0,11,4,0,71
Egypt,07/01/2013,76,0,-6,0,11,10,0,91
Egypt,08/01/2013,76,2,-2,0,48,18,0,142
Egypt,09/01/2013,34,0,0,0,37,14,0,85
Egypt,10/01/2013,69,0,0,0,26,0,0,95
Egypt,11/01/2013,49,0,0,0,22,1,0,72
Egypt,12/01/2013,44,0,0,0,29,4,0,77
Egypt,13/01/2013,69,0,-2,0,61,1,0,129
Egypt,14/01/2013,78,2,0,0,44,9,0,133
Egypt,15/01/2013,47,0,1,0,35,4,0,87
Egypt,16/01/2013,52,0,0,0,15,5,0,72
Egypt,17/01/2013,32,0,0,0,24,10,0,66
Egypt,18/01/2013,36,2,0,0,12,4,0,54
Egypt,19/01/2013,30,0,1,0,6,1,0,38
Egypt,20/01/2013,16,0,0,0,0,4,0,20
Egypt,21/01/2013,138,0,-1,0,41,19,0,197
Egypt,22/01/2013,53,0,0,0,45,27,0,125
Egypt,23/01/2013,20,0,0,0,-5,12,0,27
Egypt,24/01/2013,105,0,0,0,30,33,0,168
Egypt,25/01/2013,130,0,-2,0,42,35,0,205
Egypt,26/01/2013,78,0,1,0,8,13,0,100
Egypt,27/01/2013,75,0,0,0,23,18,0,116
Egypt,28/01/2013,61,2,1,0,58,15,0,137
Egypt,29/01/2013,58,0,-4,0,54,10,0,118
Egypt,30/01/2013,61,0,-5,0,17,16,0,89
Egypt,31/01/2013,68,0,-3,0,8,13,0,86
Eritrea,01/01/2013,6,0,0,0,25,8,0,39
Eritrea,02/01/2013,2,0,0,0,0,1,0,3
Eritrea,03/01/2013,0,0,0,0,9,4,0,13
Eritrea,04/01/2013,3,0,0,0,0,0,0,3
Eritrea,05/01/2013,0,0,0,0,-4,0,0,-4
Eritrea,07/01/2013,9,0,0,0,0,0,0,9
Eritrea,08/01/2013,0,0,0,0,0,0,0,0
Eritrea,09/01/2013,0,0,0,0,3,0,0,3
Eritrea,10/01/2013,3,0,0,0,-3,0,0,0
Eritrea,11/01/2013,0,0,0,0,0,4,0,4
Eritrea,13/01/2013,0,0,0,0,3,0,0,3
Eritrea,14/01/2013,0,0,0,0,0,0,0,0
Eritrea,15/01/2013,0,0,0,0,0,0,0,0
Eritrea,16/01/2013,3,0,0,0,6,0,0,9
Eritrea,17/01/2013,0,0,0,0,3,0,0,3
Eritrea,18/01/2013,0,0,0,0,-2,0,0,-2
Eritrea,19/01/2013,0,0,0,0,4,0,0,4
Eritrea,21/01/2013,3,0,0,0,-7,0,0,-4
Eritrea,22/01/2013,3,0,0,0,3,0,0,6
Eritrea,24/01/2013,0,0,0,0,0,0,0,0
Eritrea,25/01/2013,0,0,0,0,1,0,0,1
Eritrea,26/01/2013,0,0,0,0,0,0,0,0
Eritrea,27/01/2013,3,0,0,0,0,2,0,5
Eritrea,28/01/2013,0,0,0,0,0,0,0,0
Eritrea,29/01/2013,0,0,0,0,-4,1,0,-3
Eritrea,30/01/2013,17,0,0,0,17,1,0,35
Eritrea,31/01/2013,4,0,0,0,-2,1,0,3
Georgia,01/01/2013,0,0,0,0,0,0,0,0
Georgia,02/01/2013,0,0,0,0,-2,0,0,-2
Georgia,03/01/2013,6,0,0,0,0,0,0,6
Georgia,04/01/2013,1,0,-2,0,0,2,0,1
Georgia,05/01/2013,0,0,0,0,0,0,0,0
Georgia,06/01/2013,0,0,0,0,0,0,0,0
Georgia,07/01/2013,-1,0,0,0,0,0,0,-1
Georgia,08/01/2013,3,0,0,0,0,1,0,4
Georgia,09/01/2013,4,0,0,0,0,0,0,4
Georgia,10/01/2013,4,0,0,0,7,0,0,11
Georgia,11/01/2013,2,0,0,0,3,0,0,5
Georgia,12/01/2013,1,0,0,0,-3,0,0,-2
Georgia,13/01/2013,0,0,0,0,-4,0,0,-4
Georgia,14/01/2013,6,0,2,0,-3,0,0,5
Georgia,15/01/2013,5,0,-2,0,-5,0,0,-2
Georgia,16/01/2013,28,0,0,0,6,1,0,35
Georgia,17/01/2013,-6,0,0,0,6,0,0,0
Georgia,18/01/2013,2,0,0,0,0,0,0,2
Georgia,19/01/2013,0,0,0,0,3,0,0,3
Georgia,20/01/2013,2,0,0,0,4,0,0,6
Georgia,21/01/2013,-1,0,0,0,1,1,0,1
Georgia,22/01/2013,5,0,-1,0,0,1,0,5
Georgia,23/01/2013,2,0,-4,0,0,0,0,-2
Georgia,24/01/2013,5,0,0,0,-4,2,0,3
Georgia,25/01/2013,9,0,3,0,-2,0,0,10
Georgia,26/01/2013,336,0,4,0,139,46,0,525
Georgia,27/01/2013,0,0,0,0,6,0,0,6
Georgia,28/01/2013,-2,0,0,0,-2,0,0,-4
Georgia,29/01/2013,7,0,0,0,3,3,0,13
Georgia,30/01/2013,1,0,0,0,0,0,0,1
Georgia,31/01/2013,3,0,0,0,6,2,0,11
India,01/01/2013,42,0,1,0,-2,8,0,49
India,02/01/2013,47,0,1,0,20,13,0,81
India,03/01/2013,52,2,1,0,5,22,0,82
India,04/01/2013,53,0,0,0,6,16,0,75
India,05/01/2013,60,0,-1,0,5,11,0,75
India,06/01/2013,92,2,-1,0,6,24,0,123
India,07/01/2013,64,2,-2,0,19,9,0,92
India,08/01/2013,77,0,-1,0,20,8,0,104
India,09/01/2013,73,2,1,0,14,18,0,108
India,10/01/2013,114,0,-1,0,16,31,0,160
India,11/01/2013,33,0,0,0,1,16,0,50
India,12/01/2013,48,0,-1,0,10,9,0,66
India,13/01/2013,48,0,1,0,31,10,0,90
India,14/01/2013,60,6,0,0,15,18,0,99
India,15/01/2013,69,0,-1,0,27,24,0,119
India,16/01/2013,84,2,-2,0,40,18,0,142
India,17/01/2013,70,0,2,0,14,13,0,99
India,18/01/2013,47,2,-6,0,3,9,0,55
India,19/01/2013,47,0,1,0,13,5,0,66
India,20/01/2013,15,0,0,0,9,5,0,29
India,21/01/2013,53,0,-2,0,1,13,0,65
India,22/01/2013,77,0,1,0,-2,12,0,88
India,23/01/2013,36,0,-2,0,19,8,0,61
India,24/01/2013,90,0,-1,0,17,17,0,123
India,25/01/2013,54,0,-2,0,15,12,0,79
India,26/01/2013,49,0,0,0,16,12,0,77
India,27/01/2013,46,0,-2,0,8,2,0,54
India,28/01/2013,72,2,2,0,25,7,0,108
India,29/01/2013,62,2,-5,0,10,6,0,75
India,30/01/2013,45,0,-6,0,8,7,0,54
India,31/01/2013,39,2,-1,0,0,6,0,46
Iran,01/01/2013,23,0,0,0,16,4,0,43
Iran,02/01/2013,16,0,0,0,11,2,0,29
Iran,03/01/2013,42,0,0,0,42,4,0,88
Iran,04/01/2013,58,0,1,0,61,15,0,135
Iran,05/01/2013,38,4,-1,0,37,1,0,79
Iran,06/01/2013,73,0,2,0,27,3,0,105
Iran,07/01/2013,119,2,1,0,24,12,0,158
Iran,08/01/2013,177,0,-2,0,94,12,0,281
Iran,09/01/2013,211,4,-3,0,22,20,0,254
Iran,10/01/2013,86,6,-1,0,37,19,0,147
Iran,11/01/2013,71,6,1,0,32,6,0,116
Iran,12/01/2013,41,0,-1,0,45,9,0,94
Iran,13/01/2013,117,0,-2,0,26,11,0,152
Iran,14/01/2013,95,2,-8,0,30,12,0,131
Iran,15/01/2013,37,0,0,0,-2,3,0,38
Iran,16/01/2013,45,0,0,0,19,12,0,76
Iran,17/01/2013,38,0,1,0,-21,10,0,28
Iran,18/01/2013,25,2,0,0,20,0,0,47
Iran,19/01/2013,373,0,-1,0,179,60,0,611
Iran,20/01/2013,17,0,0,0,21,1,0,39
Iran,21/01/2013,58,0,0,0,12,12,0,82
Iran,22/01/2013,43,6,-1,0,36,20,0,104
Iran,23/01/2013,31,0,0,0,2,1,0,34
Iran,24/01/2013,101,0,0,0,28,9,0,138
Iran,25/01/2013,73,0,0,0,35,8,0,116
Iran,26/01/2013,78,4,-2,0,4,6,0,90
Iran,27/01/2013,102,0,2,0,78,4,0,186
Iran,28/01/2013,118,2,-2,0,71,19,0,208
Iran,29/01/2013,131,0,2,0,59,17,0,209
Iran,30/01/2013,129,0,1,0,37,21,0,188
Iran,31/01/2013,492,2,-8,0,94,33,0,613
Iraq,01/01/2013,36,0,0,0,9,13,0,58
Iraq,02/01/2013,62,0,3,0,1,12,0,78
Iraq,03/01/2013,195,0,1,0,35,1,0,232
Iraq,04/01/2013,101,0,-1,0,3,11,0,114
Iraq,05/01/2013,63,0,-1,0,12,5,0,79
Iraq,06/01/2013,71,0,1,0,6,0,0,78
Iraq,07/01/2013,132,0,1,0,24,13,0,170
Iraq,08/01/2013,141,0,1,0,62,17,0,221
Iraq,09/01/2013,63,2,0,0,93,18,0,176
Iraq,10/01/2013,56,0,0,0,28,3,0,87
Iraq,11/01/2013,59,0,0,0,33,8,0,100
Iraq,12/01/2013,56,0,0,0,25,0,0,81
Iraq,13/01/2013,53,0,3,0,18,5,0,79
Iraq,14/01/2013,64,2,0,0,13,13,0,92
Iraq,15/01/2013,74,0,0,0,12,3,0,89
Iraq,16/01/2013,74,0,0,0,66,3,0,143
Iraq,17/01/2013,154,0,-1,0,46,21,0,220
Iraq,18/01/2013,126,0,0,0,21,9,0,156
Iraq,19/01/2013,58,0,0,0,20,0,0,78
Iraq,20/01/2013,11,0,0,0,12,0,0,23
Iraq,21/01/2013,70,0,0,0,20,7,0,97
Iraq,22/01/2013,65,0,0,0,38,3,0,106
Iraq,23/01/2013,17,0,0,0,6,2,0,25
Iraq,24/01/2013,347,2,-5,0,49,9,0,402
Iraq,25/01/2013,146,0,-5,0,24,10,0,175
Iraq,26/01/2013,85,2,0,0,23,8,0,118
Iraq,27/01/2013,44,0,-2,0,18,7,0,67
Iraq,28/01/2013,73,0,1,0,30,9,0,113
Iraq,29/01/2013,127,2,-1,0,48,4,0,180
Iraq,30/01/2013,114,10,0,0,46,3,0,173
Iraq,31/01/2013,170,4,0,0,11,15,0,200
Morocco,01/01/2013,-2,0,0,0,0,0,0,-2
Morocco,02/01/2013,2,0,0,0,15,5,0,22
Morocco,03/01/2013,6,0,0,0,6,1,0,13
Morocco,04/01/2013,3,0,0,0,0,0,0,3
Morocco,05/01/2013,0,0,0,0,3,0,0,3
Morocco,06/01/2013,2,0,0,0,0,0,0,2
Morocco,07/01/2013,-1,0,0,0,2,0,0,1
Morocco,08/01/2013,32,0,0,0,5,3,0,40
Morocco,09/01/2013,18,0,0,0,12,0,0,30
Morocco,10/01/2013,3,0,0,0,7,7,0,17
Morocco,11/01/2013,0,0,0,0,-2,0,0,-2
Morocco,12/01/2013,0,0,0,0,0,1,0,1
Morocco,13/01/2013,0,0,0,0,0,3,0,3
Morocco,14/01/2013,28,0,0,0,0,3,0,31
Morocco,15/01/2013,7,0,0,0,2,1,0,10
Morocco,16/01/2013,2,2,0,0,2,0,0,6
Morocco,17/01/2013,8,0,0,0,0,0,0,8
Morocco,18/01/2013,29,0,-2,0,15,3,0,45
Morocco,19/01/2013,16,0,0,0,0,0,0,16
Morocco,20/01/2013,0,0,0,0,0,0,0,0
Morocco,21/01/2013,60,0,-2,0,2,11,0,71
Morocco,22/01/2013,16,0,0,0,-2,0,0,14
Morocco,23/01/2013,12,0,0,0,2,2,0,16
Morocco,24/01/2013,9,0,0,0,-1,0,0,8
Morocco,25/01/2013,100,0,-4,0,23,13,0,132
Morocco,26/01/2013,11,0,0,0,0,1,0,12
Morocco,27/01/2013,9,0,0,0,5,1,0,15
Morocco,28/01/2013,41,0,0,0,22,7,0,70
Morocco,29/01/2013,4,0,0,0,0,1,0,5
Morocco,30/01/2013,6,0,0,0,3,1,0,10
Morocco,31/01/2013,8,0,0,0,12,0,0,20
Nigeria,01/01/2013,12,0,0,0,5,2,0,19
Nigeria,02/01/2013,10,0,0,0,8,3,0,21
Nigeria,03/01/2013,12,0,0,0,12,0,0,24
Nigeria,04/01/2013,6,0,0,0,12,3,0,21
Nigeria,05/01/2013,12,0,0,0,1,1,0,14
Nigeria,06/01/2013,18,0,-1,0,22,0,0,39
Nigeria,07/01/2013,18,0,-7,0,-1,6,0,16
Nigeria,08/01/2013,15,4,-8,0,-8,2,0,5
Nigeria,09/01/2013,26,0,1,0,2,2,0,31
Nigeria,10/01/2013,32,10,0,0,13,5,0,60
Nigeria,11/01/2013,45,0,0,0,5,3,0,53
Nigeria,12/01/2013,56,2,0,0,6,2,0,66
Nigeria,13/01/2013,27,0,3,0,-1,7,0,36
Nigeria,14/01/2013,50,0,0,0,42,3,0,95
Nigeria,15/01/2013,90,0,0,0,0,7,0,97
Nigeria,16/01/2013,52,0,-1,0,12,1,0,64
Nigeria,17/01/2013,86,0,0,0,27,4,0,117
Nigeria,18/01/2013,61,0,0,0,1,1,0,63
Nigeria,19/01/2013,34,0,0,0,-2,1,0,33
Nigeria,20/01/2013,2,0,0,0,0,0,0,2
Nigeria,21/01/2013,46,0,0,0,4,12,0,62
Nigeria,22/01/2013,66,0,-1,0,19,9,0,93
Nigeria,23/01/2013,29,0,0,0,17,1,0,47
Nigeria,24/01/2013,25,0,1,0,2,3,0,31
Nigeria,25/01/2013,31,0,0,0,33,3,0,67
Nigeria,26/01/2013,26,0,0,0,30,6,0,62
Nigeria,27/01/2013,23,0,0,0,34,2,0,59
Nigeria,28/01/2013,36,0,0,0,-3,0,0,33
Nigeria,29/01/2013,19,0,-2,0,-7,4,0,14
Nigeria,30/01/2013,88,6,2,0,11,7,0,114
Nigeria,31/01/2013,51,0,1,0,12,7,0,71
Pakistan,01/01/2013,53,0,0,0,0,22,0,75
Pakistan,02/01/2013,100,0,0,0,46,8,0,154
Pakistan,03/01/2013,138,0,0,0,55,4,0,197
Pakistan,04/01/2013,124,0,2,0,33,7,0,166
Pakistan,05/01/2013,65,0,0,0,10,1,0,76
Pakistan,06/01/2013,169,0,0,0,20,35,0,224
Pakistan,07/01/2013,87,0,0,0,51,8,0,146
Pakistan,08/01/2013,105,0,-5,0,55,12,0,167
Pakistan,09/01/2013,149,0,0,0,32,37,0,218
Pakistan,10/01/2013,164,0,-2,0,5,9,0,176
Pakistan,11/01/2013,130,0,-2,0,27,22,0,177
Pakistan,12/01/2013,112,6,1,0,7,22,0,148
Pakistan,13/01/2013,59,0,0,0,11,6,0,76
Pakistan,14/01/2013,84,0,6,0,32,8,0,130
Pakistan,15/01/2013,172,2,-4,0,110,21,0,301
Pakistan,16/01/2013,83,0,-2,0,70,12,0,163
Pakistan,17/01/2013,112,0,-6,0,119,25,0,250
Pakistan,18/01/2013,116,2,-3,0,48,7,0,170
Pakistan,19/01/2013,72,2,0,0,25,14,0,113
Pakistan,20/01/2013,49,0,0,0,9,3,0,61
Pakistan,21/01/2013,159,2,-1,0,65,26,0,251
Pakistan,22/01/2013,102,0,-2,0,29,15,0,144
Pakistan,23/01/2013,50,0,0,0,27,2,0,79
Pakistan,24/01/2013,192,0,0,0,129,14,0,335
Pakistan,25/01/2013,139,0,2,0,132,9,0,282
Pakistan,26/01/2013,55,0,-2,0,37,4,0,94
Pakistan,27/01/2013,30,0,-6,0,41,1,0,66
Pakistan,28/01/2013,28,0,0,0,48,6,0,82
Pakistan,29/01/2013,89,0,-2,0,20,6,0,113
Pakistan,30/01/2013,85,0,3,0,42,9,0,139
Pakistan,31/01/2013,85,0,1,0,11,6,0,103
Sierra Leone,01/01/2013,0,0,0,0,0,0,0,0
Sierra Leone,02/01/2013,0,0,0,0,0,0,0,0
Sierra Leone,03/01/2013,2,0,0,0,0,0,0,2
Sierra Leone,04/01/2013,9,0,0,0,0,0,0,9
Sierra Leone,05/01/2013,0,0,0,0,3,0,0,3
Sierra Leone,06/01/2013,0,0,0,0,6,0,0,6
Sierra Leone,08/01/2013,-1,0,0,0,0,0,0,-1
Sierra Leone,09/01/2013,6,0,0,0,-2,0,0,4
Sierra Leone,10/01/2013,0,0,0,0,6,0,0,6
Sierra Leone,11/01/2013,0,0,0,0,0,0,0,0
Sierra Leone,12/01/2013,0,0,0,0,3,0,0,3
Sierra Leone,14/01/2013,0,0,0,0,6,0,0,6
Sierra Leone,15/01/2013,0,0,0,0,3,0,0,3
Sierra Leone,16/01/2013,0,0,0,0,6,2,0,8
Sierra Leone,17/01/2013,4,0,0,0,6,1,0,11
Sierra Leone,18/01/2013,0,0,0,0,3,0,0,3
Sierra Leone,19/01/2013,1,0,-2,0,0,0,0,-1
Sierra Leone,21/01/2013,1,0,0,0,1,0,0,2
Sierra Leone,22/01/2013,14,0,0,0,37,4,0,55
Sierra Leone,23/01/2013,3,0,0,0,6,0,0,9
Sierra Leone,24/01/2013,3,0,0,0,3,1,0,7
Sierra Leone,25/01/2013,0,0,0,0,9,0,0,9
Sierra Leone,26/01/2013,0,0,0,0,0,2,0,2
Sierra Leone,27/01/2013,0,0,0,0,0,1,0,1
Sierra Leone,28/01/2013,0,2,0,0,0,0,0,2
Sierra Leone,29/01/2013,1,0,0,0,0,0,0,1
Sierra Leone,30/01/2013,0,0,0,0,0,0,0,0
Sierra Leone,31/01/2013,-1,0,0,0,3,0,0,2
Somalia,01/01/2013,14,0,0,0,12,0,0,26
Somalia,02/01/2013,15,0,0,0,0,2,0,17
Somalia,03/01/2013,15,0,0,0,6,1,0,22
Somalia,04/01/2013,33,0,0,0,18,0,0,51
Somalia,05/01/2013,18,0,0,0,6,0,0,24
Somalia,06/01/2013,11,0,0,0,10,0,0,21
Somalia,07/01/2013,32,0,0,0,-4,4,0,32
Somalia,08/01/2013,28,0,0,0,15,1,0,44
Somalia,09/01/2013,11,0,2,0,-10,0,0,3
Somalia,10/01/2013,40,0,1,0,2,2,0,45
Somalia,11/01/2013,11,0,0,0,0,0,0,11
Somalia,12/01/2013,160,2,0,0,14,6,0,182
Somalia,13/01/2013,37,0,0,0,42,2,0,81
Somalia,14/01/2013,75,0,0,0,34,6,0,115
Somalia,15/01/2013,61,0,0,0,27,5,0,93
Somalia,16/01/2013,78,0,0,0,20,0,0,98
Somalia,17/01/2013,112,0,0,0,20,4,0,136
Somalia,18/01/2013,33,0,0,0,1,0,0,34
Somalia,19/01/2013,37,2,0,0,25,3,0,67
Somalia,20/01/2013,6,4,0,0,-2,1,0,9
Somalia,21/01/2013,71,0,0,0,3,3,0,77
Somalia,22/01/2013,49,0,2,0,13,0,0,64
Somalia,23/01/2013,10,0,0,0,3,0,0,13
Somalia,24/01/2013,49,0,0,0,6,3,0,58
Somalia,25/01/2013,78,0,0,0,42,0,0,120
Somalia,26/01/2013,34,0,0,0,9,0,0,43
Somalia,27/01/2013,20,0,-1,0,7,0,0,26
Somalia,28/01/2013,34,0,0,0,0,2,0,36
Somalia,29/01/2013,32,4,0,0,11,15,0,62
Somalia,30/01/2013,24,0,0,0,-2,0,0,22
Somalia,31/01/2013,19,0,-4,0,6,9,0,30
Syria,01/01/2013,143,0,0,0,3,0,0,146
Syria,02/01/2013,177,0,-3,0,21,12,0,207
Syria,03/01/2013,127,0,-1,0,53,6,0,185
Syria,04/01/2013,109,4,-4,0,44,10,0,163
Syria,05/01/2013,53,4,-4,0,16,10,0,79
Syria,06/01/2013,199,0,-22,0,2,9,0,188
Syria,07/01/2013,196,2,-10,0,39,5,0,232
Syria,08/01/2013,222,4,-5,0,22,15,0,258
Syria,09/01/2013,148,4,-3,0,4,13,0,166
Syria,10/01/2013,158,0,-6,0,51,4,0,207
Syria,11/01/2013,184,0,-6,0,26,17,0,221
Syria,12/01/2013,69,4,-3,0,0,2,0,72
Syria,13/01/2013,90,4,-5,0,8,15,0,112
Syria,14/01/2013,140,0,0,0,16,22,0,178
Syria,15/01/2013,127,2,-3,0,21,4,0,151
Syria,16/01/2013,92,4,0,0,4,3,0,103
Syria,17/01/2013,157,10,1,0,43,17,0,228
Syria,18/01/2013,147,6,1,0,6,13,0,173
Syria,19/01/2013,88,0,-2,0,11,9,0,106
Syria,20/01/2013,67,0,0,0,4,2,0,73
Syria,21/01/2013,175,0,1,0,54,24,0,254
Syria,22/01/2013,152,4,1,0,16,17,0,190
Syria,23/01/2013,72,0,0,0,12,18,0,102
Syria,24/01/2013,148,2,0,0,59,10,0,219
Syria,25/01/2013,147,2,-6,0,20,7,0,170
Syria,26/01/2013,169,0,-7,0,-10,10,0,162
Syria,27/01/2013,220,0,1,0,18,5,0,244
Syria,28/01/2013,186,12,1,0,58,13,0,270
Syria,29/01/2013,137,24,-6,0,19,9,0,183
Syria,30/01/2013,406,12,1,0,-7,25,0,437
Syria,31/01/2013,353,2,-7,0,1,35,0,384
Yemen,01/01/2013,0,0,0,0,3,0,0,3
Yemen,02/01/2013,10,0,0,0,18,0,0,28
Yemen,03/01/2013,30,0,0,0,3,8,0,41
Yemen,04/01/2013,31,0,0,0,9,1,0,41
Yemen,05/01/2013,21,0,0,0,9,0,0,30
Yemen,06/01/2013,13,0,0,0,7,5,0,25
Yemen,07/01/2013,54,0,-2,0,24,6,0,82
Yemen,08/01/2013,37,0,0,0,15,5,0,57
Yemen,09/01/2013,25,0,0,0,-2,3,0,26
Yemen,10/01/2013,7,0,0,0,9,1,0,17
Yemen,11/01/2013,5,0,0,0,3,0,0,8
Yemen,12/01/2013,13,0,-6,0,-2,2,0,7
Yemen,13/01/2013,10,0,0,0,4,1,0,15
Yemen,14/01/2013,22,0,0,0,19,5,0,46
Yemen,15/01/2013,6,0,0,0,0,2,0,8
Yemen,16/01/2013,6,0,0,0,0,2,0,8
Yemen,17/01/2013,10,0,-2,0,-2,1,0,7
Yemen,18/01/2013,45,0,0,0,6,0,0,51
Yemen,19/01/2013,238,0,0,0,103,28,0,369
Yemen,20/01/2013,27,0,0,0,1,3,0,31
Yemen,21/01/2013,56,0,0,0,13,1,0,70
Yemen,22/01/2013,69,2,0,0,0,0,0,71
Yemen,23/01/2013,21,0,0,0,0,0,0,21
Yemen,24/01/2013,107,0,0,0,3,0,0,110
Yemen,25/01/2013,29,0,0,0,21,6,0,56
Yemen,26/01/2013,4,0,0,0,7,1,0,12
Yemen,27/01/2013,3,0,0,0,-1,0,0,2
Yemen,28/01/2013,24,0,0,0,6,3,0,33
Yemen,29/01/2013,43,0,1,0,5,0,0,49
Yemen,30/01/2013,21,0,0,0,-4,2,0,19
Yemen,31/01/2013,53,0,0,0,6,7,0,66
Afghanistan,01/03/2011,240,8,-28,0,27,34,0,281
Afghanistan,02/03/2011,271,4,3,0,12,31,0,321
Afghanistan,03/03/2011,457,4,0,0,24,44,0,529
Afghanistan,04/03/2011,440,8,-1,0,57,32,0,536
Afghanistan,05/03/2011,200,2,0,0,29,15,0,246
Afghanistan,06/03/2011,135,2,0,0,5,16,0,158
Afghanistan,07/03/2011,234,2,0,0,47,19,0,302
Afghanistan,08/03/2011,219,0,0,0,28,44,0,291
Afghanistan,09/03/2011,240,4,4,0,29,26,0,303
Afghanistan,10/03/2011,322,2,-4,0,12,29,0,361
Afghanistan,11/03/2011,174,2,-2,0,26,16,0,216
Afghanistan,12/03/2011,119,4,0,0,6,8,0,137
Afghanistan,13/03/2011,112,2,0,0,16,51,0,181
Afghanistan,14/03/2011,155,2,-4,0,23,19,0,195
Afghanistan,15/03/2011,139,0,0,0,35,21,0,195
Afghanistan,16/03/2011,283,0,0,0,19,27,0,329
Afghanistan,17/03/2011,265,0,-2,0,25,53,0,341
Afghanistan,18/03/2011,258,0,-1,0,42,37,0,336
Afghanistan,19/03/2011,211,0,1,0,94,41,0,347
Afghanistan,20/03/2011,166,0,2,0,31,17,0,216
Afghanistan,21/03/2011,292,0,1,0,78,14,0,385
Afghanistan,22/03/2011,225,2,-1,0,78,19,0,323
Afghanistan,23/03/2011,312,0,3,0,55,30,0,400
Afghanistan,24/03/2011,274,0,1,0,35,24,0,334
Afghanistan,25/03/2011,192,0,4,0,42,5,0,243
Afghanistan,26/03/2011,174,4,-2,0,13,7,0,196
Afghanistan,27/03/2011,137,0,0,0,33,5,0,175
Afghanistan,28/03/2011,299,2,2,0,66,41,0,410
Afghanistan,29/03/2011,845,8,-7,0,308,139,0,1293
Afghanistan,30/03/2011,159,0,-3,0,18,12,0,186
Afghanistan,31/03/2011,271,0,-10,0,59,29,0,349
Albania,01/03/2011,0,0,0,0,0,0,0,0
Albania,02/03/2011,28,0,0,0,1,4,0,33
Albania,03/03/2011,62,0,0,0,15,3,0,80
Albania,04/03/2011,28,0,0,0,12,4,0,44
Albania,05/03/2011,-1,0,0,0,11,6,0,16
Albania,06/03/2011,11,0,-1,0,0,1,0,11
Albania,07/03/2011,9,0,0,0,12,0,0,21
Albania,08/03/2011,73,0,0,0,3,1,0,77
Albania,09/03/2011,20,0,0,0,0,0,0,20
Albania,10/03/2011,10,0,0,0,0,0,0,10
Albania,11/03/2011,24,0,0,0,9,4,0,37
Albania,12/03/2011,11,0,-1,0,-4,0,0,6
Albania,13/03/2011,0,0,0,0,0,0,0,0
Albania,14/03/2011,4,0,0,0,9,0,0,13
Albania,15/03/2011,6,0,0,0,0,0,0,6
Albania,16/03/2011,24,0,0,0,54,1,0,79
Albania,17/03/2011,16,0,4,0,10,4,0,34
Albania,18/03/2011,33,0,1,0,12,6,0,52
Albania,19/03/2011,11,0,1,0,3,2,0,17
Albania,20/03/2011,23,0,0,0,6,0,0,29
Albania,21/03/2011,3,0,0,0,12,2,0,17
Albania,22/03/2011,2,0,1,0,6,2,0,11
Albania,23/03/2011,12,0,-1,0,13,3,0,27
Albania,24/03/2011,16,0,-2,0,0,2,0,16
Albania,25/03/2011,3,0,0,0,3,2,0,8
Albania,26/03/2011,-1,0,0,0,6,0,0,5
Albania,27/03/2011,11,0,0,0,0,0,0,11
Albania,28/03/2011,15,0,0,0,12,4,0,31
Albania,29/03/2011,7,0,0,0,0,1,0,8
Albania,30/03/2011,16,0,0,0,3,2,0,21
Albania,31/03/2011,4,0,-3,0,9,1,0,11
Algeria,01/03/2011,9,0,0,0,0,4,0,13
Algeria,02/03/2011,32,0,-2,0,-2,6,0,34
Algeria,03/03/2011,21,0,0,0,6,12,0,39
Algeria,04/03/2011,21,0,0,0,4,9,0,34
Algeria,05/03/2011,13,0,0,0,20,1,0,34
Algeria,06/03/2011,10,0,0,0,10,1,0,21
Algeria,07/03/2011,17,0,0,0,0,1,0,18
Algeria,08/03/2011,33,0,0,0,12,6,0,51
Algeria,09/03/2011,32,2,-1,0,-10,1,0,24
Algeria,10/03/2011,3,0,0,0,0,6,0,9
Algeria,11/03/2011,1,0,0,0,7,5,0,13
Algeria,12/03/2011,10,0,0,0,3,1,0,14
Algeria,13/03/2011,10,0,5,0,0,0,0,15
Algeria,14/03/2011,4,0,0,0,1,0,0,5
Algeria,15/03/2011,1,0,0,0,-2,1,0,0
Algeria,16/03/2011,8,0,0,0,3,3,0,14
Algeria,17/03/2011,15,0,0,0,0,8,0,23
Algeria,18/03/2011,14,0,-2,0,-8,0,0,4
Algeria,19/03/2011,3,0,0,0,9,1,0,13
Algeria,20/03/2011,13,0,0,0,8,0,0,21
Algeria,21/03/2011,16,0,0,0,6,0,0,22
Algeria,22/03/2011,71,0,0,0,15,1,0,87
Algeria,23/03/2011,15,0,0,0,9,2,0,26
Algeria,24/03/2011,15,0,0,0,3,3,0,21
Algeria,25/03/2011,21,0,1,0,3,3,0,28
Algeria,26/03/2011,12,0,0,0,-4,7,0,15
Algeria,27/03/2011,12,0,0,0,9,5,0,26
Algeria,28/03/2011,18,0,0,0,12,4,0,34
Algeria,29/03/2011,6,0,0,0,0,2,0,8
Algeria,30/03/2011,12,0,0,0,0,6,0,18
Algeria,31/03/2011,14,0,1,0,1,0,0,16
Bangladesh,01/03/2011,32,2,-1,0,40,15,0,88
Bangladesh,02/03/2011,55,0,-7,0,26,14,0,88
Bangladesh,03/03/2011,99,0,-4,0,9,4,0,108
Bangladesh,04/03/2011,80,0,-3,0,0,8,0,85
Bangladesh,05/03/2011,56,0,-4,0,-3,9,0,58
Bangladesh,06/03/2011,63,0,0,0,22,7,0,92
Bangladesh,07/03/2011,36,0,0,0,7,2,0,45
Bangladesh,08/03/2011,80,0,-4,0,27,7,0,110
Bangladesh,09/03/2011,45,0,9,0,7,1,0,62
Bangladesh,10/03/2011,41,4,-2,0,11,5,0,59
Bangladesh,11/03/2011,41,0,0,0,6,0,0,47
Bangladesh,12/03/2011,16,0,0,0,1,9,0,26
Bangladesh,13/03/2011,6,0,0,0,19,2,0,27
Bangladesh,14/03/2011,22,0,1,0,-11,6,0,18
Bangladesh,15/03/2011,89,0,0,0,0,4,0,93
Bangladesh,16/03/2011,48,0,0,0,2,4,0,54
Bangladesh,17/03/2011,49,0,-2,0,4,8,0,59
Bangladesh,18/03/2011,44,0,0,0,108,1,0,153
Bangladesh,19/03/2011,23,0,0,0,31,0,0,54
Bangladesh,20/03/2011,24,0,0,0,23,1,0,48
Bangladesh,21/03/2011,29,0,0,0,16,0,0,45
Bangladesh,22/03/2011,37,0,0,0,21,7,0,65
Bangladesh,23/03/2011,36,0,0,0,7,14,0,57
Bangladesh,24/03/2011,28,0,0,0,21,6,0,55
Bangladesh,25/03/2011,34,0,1,0,0,2,0,37
Bangladesh,26/03/2011,17,0,1,0,0,1,0,19
Bangladesh,27/03/2011,17,2,-3,0,-6,4,0,14
Bangladesh,28/03/2011,24,0,3,0,10,0,0,37
Bangladesh,29/03/2011,24,0,1,0,6,0,0,31
Bangladesh,30/03/2011,6,0,0,0,10,0,0,16
Bangladesh,31/03/2011,16,0,0,0,8,8,0,32
Cameroon,01/03/2011,0,0,0,0,0,0,0,0
Cameroon,02/03/2011,8,0,0,0,0,0,0,8
Cameroon,03/03/2011,2,0,0,0,0,0,0,2
Cameroon,04/03/2011,6,0,0,0,12,0,0,18
Cameroon,05/03/2011,6,0,0,0,13,0,0,19
Cameroon,06/03/2011,0,0,0,0,3,0,0,3
Cameroon,07/03/2011,6,0,0,0,0,2,0,8
Cameroon,08/03/2011,1,0,0,0,6,2,0,9
Cameroon,09/03/2011,3,2,0,0,3,0,0,8
Cameroon,10/03/2011,0,0,0,0,0,0,0,0
Cameroon,11/03/2011,0,0,0,0,0,0,0,0
Cameroon,12/03/2011,0,0,0,0,0,0,0,0
Cameroon,13/03/2011,0,0,0,0,0,0,0,0
Cameroon,14/03/2011,0,0,0,0,0,0,0,0
Cameroon,15/03/2011,6,0,0,0,0,0,0,6
Cameroon,16/03/2011,0,0,0,0,0,0,0,0
Cameroon,17/03/2011,0,0,0,0,0,0,0,0
Cameroon,18/03/2011,6,0,0,0,0,0,0,6
Cameroon,19/03/2011,0,0,0,0,3,0,0,3
Cameroon,21/03/2011,3,0,0,0,0,0,0,3
Cameroon,22/03/2011,0,0,0,0,0,0,0,0
Cameroon,23/03/2011,0,0,0,0,3,0,0,3
Cameroon,24/03/2011,0,0,0,0,0,0,0,0
Cameroon,26/03/2011,0,0,0,0,0,1,0,1
Cameroon,28/03/2011,0,0,0,0,0,2,0,2
Cameroon,29/03/2011,2,0,0,0,0,2,0,4
Cameroon,30/03/2011,0,0,0,0,9,0,0,9
Cameroon,31/03/2011,0,0,0,0,0,0,0,0
China,01/03/2011,115,4,17,0,88,13,0,237
China,02/03/2011,120,4,5,0,42,26,0,197
China,03/03/2011,193,10,0,0,60,10,0,273
China,04/03/2011,285,2,-2,0,73,26,0,384
China,05/03/2011,102,0,-1,0,20,8,0,129
China,06/03/2011,92,0,-10,0,33,16,0,131
China,07/03/2011,194,2,-24,0,26,20,0,218
China,08/03/2011,218,6,-11,0,22,21,0,256
China,09/03/2011,179,2,-37,0,62,31,0,237
China,10/03/2011,197,0,-30,0,81,27,0,275
China,11/03/2011,166,2,2,0,32,25,0,227
China,12/03/2011,58,0,5,0,12,14,0,89
China,13/03/2011,82,0,1,0,32,9,0,124
China,14/03/2011,173,4,0,0,15,16,0,208
China,15/03/2011,75,0,2,0,53,16,0,146
China,16/03/2011,163,0,-8,0,22,12,0,189
China,17/03/2011,204,2,0,0,27,35,0,268
China,18/03/2011,192,0,0,0,43,16,0,251
China,19/03/2011,101,4,0,0,21,4,0,130
China,20/03/2011,88,6,-9,0,49,15,0,149
China,21/03/2011,212,2,-23,0,71,25,0,287
China,22/03/2011,164,2,-4,0,24,33,0,219
China,23/03/2011,98,4,-6,0,40,11,0,147
China,24/03/2011,141,0,3,0,75,14,0,233
China,25/03/2011,150,0,0,0,75,12,0,237
China,26/03/2011,82,8,1,0,56,2,0,149
China,27/03/2011,84,4,0,0,64,7,0,159
China,28/03/2011,154,4,7,0,73,32,0,270
China,29/03/2011,183,0,0,0,37,25,0,245
China,30/03/2011,125,0,-4,0,83,9,0,213
China,31/03/2011,181,6,-2,0,159,13,0,357
Egypt,01/03/2011,390,6,-16,0,66,64,0,510
Egypt,02/03/2011,228,0,-33,0,43,49,0,287
Egypt,03/03/2011,227,4,-76,0,81,40,0,276
Egypt,04/03/2011,192,2,-36,0,57,46,0,261
Egypt,05/03/2011,129,0,-10,0,55,46,0,220
Egypt,06/03/2011,155,8,-11,0,37,30,0,219
Egypt,07/03/2011,199,10,-2,0,53,54,0,314
Egypt,08/03/2011,228,0,5,0,56,43,0,332
Egypt,09/03/2011,149,2,-20,0,53,54,0,238
Egypt,10/03/2011,154,2,-19,0,12,45,0,194
Egypt,11/03/2011,155,4,-12,0,24,41,0,212
Egypt,12/03/2011,81,0,-7,0,15,14,0,103
Egypt,13/03/2011,104,0,-8,0,61,12,0,169
Egypt,14/03/2011,83,0,-6,0,14,20,0,111
Egypt,15/03/2011,146,0,-5,0,50,53,0,244
Egypt,16/03/2011,228,4,-4,0,62,45,0,335
Egypt,17/03/2011,196,6,-21,0,24,27,0,232
Egypt,18/03/2011,141,0,0,0,21,46,0,208
Egypt,19/03/2011,115,0,-9,0,24,28,0,158
Egypt,20/03/2011,74,2,-9,0,58,38,0,163
Egypt,21/03/2011,338,2,-11,0,93,99,0,521
Egypt,22/03/2011,532,6,-34,0,211,92,0,807
Egypt,23/03/2011,97,0,-15,0,27,32,0,141
Egypt,24/03/2011,128,2,-14,0,37,33,0,186
Egypt,25/03/2011,172,2,-10,0,85,24,0,273
Egypt,26/03/2011,98,0,-2,0,31,12,0,139
Egypt,27/03/2011,157,0,-18,0,38,16,0,193
Egypt,28/03/2011,78,0,-9,0,10,25,0,104
Egypt,29/03/2011,95,0,-5,0,47,31,0,168
Egypt,30/03/2011,50,0,-24,0,12,7,0,45
Egypt,31/03/2011,92,0,-42,0,57,29,0,136
Eritrea,01/03/2011,0,6,2,0,3,2,0,13
Eritrea,02/03/2011,1,0,0,0,33,0,0,34
Eritrea,03/03/2011,21,8,0,0,51,4,0,84
Eritrea,04/03/2011,3,0,0,0,15,2,0,20
Eritrea,05/03/2011,0,0,0,0,0,0,0,0
Eritrea,06/03/2011,0,0,0,0,0,0,0,0
Eritrea,07/03/2011,1,2,0,0,3,1,0,7
Eritrea,08/03/2011,0,0,0,0,2,1,0,3
Eritrea,11/03/2011,4,0,0,0,3,4,0,11
Eritrea,12/03/2011,0,0,0,0,0,0,0,0
Eritrea,13/03/2011,3,0,0,0,0,0,0,3
Eritrea,14/03/2011,12,0,0,0,0,0,0,12
Eritrea,15/03/2011,14,0,0,0,9,0,0,23
Eritrea,16/03/2011,2,0,-1,0,2,0,0,3
Eritrea,17/03/2011,2,0,0,0,0,0,0,2
Eritrea,18/03/2011,12,0,0,0,0,0,0,12
Eritrea,19/03/2011,17,0,0,0,-2,0,0,15
Eritrea,20/03/2011,0,0,0,0,0,2,0,2
Eritrea,21/03/2011,2,0,0,0,0,0,0,2
Eritrea,22/03/2011,0,0,0,0,0,0,0,0
Eritrea,23/03/2011,6,0,0,0,0,0,0,6
Eritrea,24/03/2011,3,0,0,0,0,0,0,3
Eritrea,25/03/2011,0,0,0,0,6,0,0,6
Eritrea,26/03/2011,8,0,0,0,3,0,0,11
Eritrea,27/03/2011,0,4,0,0,-2,2,0,4
Eritrea,28/03/2011,8,0,0,0,0,0,0,8
Eritrea,29/03/2011,7,0,0,0,0,4,0,11
Eritrea,30/03/2011,3,0,0,0,0,0,0,3
Eritrea,31/03/2011,5,0,0,0,3,0,0,8
Georgia,01/03/2011,35,4,-3,0,49,5,0,90
Georgia,02/03/2011,50,2,1,0,36,6,0,95
Georgia,03/03/2011,48,0,-1,0,11,11,0,69
Georgia,04/03/2011,26,2,-2,0,25,5,0,56
Georgia,05/03/2011,20,0,0,0,10,0,0,30
Georgia,06/03/2011,42,0,0,0,8,7,0,57
Georgia,07/03/2011,32,0,-2,0,37,5,0,72
Georgia,08/03/2011,45,0,0,0,4,3,0,52
Georgia,09/03/2011,37,2,1,0,36,6,0,82
Georgia,10/03/2011,-1,0,0,0,0,0,0,-1
Georgia,11/03/2011,27,4,0,0,32,6,0,69
Georgia,12/03/2011,30,0,0,0,-2,2,0,30
Georgia,13/03/2011,7,0,1,0,3,2,0,13
Georgia,14/03/2011,29,0,-2,0,2,1,0,30
Georgia,15/03/2011,40,0,2,0,13,3,0,58
Georgia,16/03/2011,32,6,2,0,18,3,0,61
Georgia,17/03/2011,29,2,0,0,7,8,0,46
Georgia,18/03/2011,34,0,0,0,11,2,0,47
Georgia,19/03/2011,10,0,0,0,12,5,0,27
Georgia,20/03/2011,19,0,0,0,-1,0,0,18
Georgia,21/03/2011,45,4,0,0,17,5,0,71
Georgia,22/03/2011,68,0,2,0,17,15,0,102
Georgia,23/03/2011,78,8,-4,0,17,4,0,103
Georgia,24/03/2011,44,0,-2,0,17,8,0,67
Georgia,25/03/2011,62,0,0,0,46,10,0,118
Georgia,26/03/2011,24,0,1,0,23,7,0,55
Georgia,27/03/2011,46,0,0,0,6,0,0,52
Georgia,28/03/2011,54,0,2,0,10,2,0,68
Georgia,29/03/2011,39,4,0,0,-3,4,0,44
Georgia,30/03/2011,8,0,0,0,-2,0,0,6
Georgia,31/03/2011,40,0,1,0,44,12,0,97
India,01/03/2011,90,6,-1,0,21,18,0,134
India,02/03/2011,84,0,1,0,48,9,0,142
India,03/03/2011,76,2,-5,0,59,8,0,140
India,04/03/2011,81,2,-6,0,44,14,0,135
India,05/03/2011,53,4,-2,0,36,8,0,99
India,06/03/2011,100,4,-2,0,6,12,0,120
India,07/03/2011,84,2,-6,0,16,5,0,101
India,08/03/2011,57,4,0,0,14,17,0,92
India,09/03/2011,42,0,-5,0,11,14,0,62
India,10/03/2011,72,2,-15,0,34,2,0,95
India,11/03/2011,93,0,-3,0,15,3,0,108
India,12/03/2011,33,0,-3,0,16,4,0,50
India,13/03/2011,27,2,0,0,14,8,0,51
India,14/03/2011,64,0,-3,0,44,14,0,119
India,15/03/2011,66,2,-8,0,19,15,0,94
India,16/03/2011,29,0,-2,0,19,10,0,56
India,17/03/2011,75,4,-20,0,13,9,0,81
India,18/03/2011,117,0,0,0,15,15,0,147
India,19/03/2011,49,0,3,0,16,11,0,79
India,20/03/2011,60,0,-2,0,13,5,0,76
India,21/03/2011,98,0,3,0,35,10,0,146
India,22/03/2011,104,2,-2,0,9,15,0,128
India,23/03/2011,67,0,-6,0,15,13,0,89
India,24/03/2011,70,2,0,0,14,12,0,98
India,25/03/2011,53,0,0,0,28,1,0,82
India,26/03/2011,40,2,-2,0,18,7,0,65
India,27/03/2011,29,14,-4,0,10,6,0,55
India,28/03/2011,53,8,0,0,11,11,0,83
India,29/03/2011,69,0,-9,0,19,1,0,80
India,30/03/2011,30,0,-8,0,14,5,0,41
India,31/03/2011,39,4,-7,0,5,3,0,44
Iran,01/03/2011,65,2,0,0,47,24,0,138
Iran,02/03/2011,48,4,-1,0,11,31,0,93
Iran,03/03/2011,87,0,0,0,35,8,0,130
Iran,04/03/2011,136,4,2,0,48,20,0,210
Iran,05/03/2011,219,2,-3,0,172,55,0,445
Iran,06/03/2011,14,0,-1,0,8,3,0,24
Iran,07/03/2011,71,0,-4,0,0,7,0,74
Iran,08/03/2011,65,0,-2,0,40,11,0,114
Iran,09/03/2011,134,2,3,0,87,13,0,239
Iran,10/03/2011,107,0,-5,0,58,23,0,183
Iran,11/03/2011,60,2,0,0,23,6,0,91
Iran,12/03/2011,28,0,0,0,9,3,0,40
Iran,13/03/2011,54,0,0,0,13,4,0,71
Iran,14/03/2011,136,0,1,0,26,8,0,171
Iran,15/03/2011,172,0,-3,0,48,11,0,228
Iran,16/03/2011,163,0,-3,0,65,23,0,248
Iran,17/03/2011,125,0,-2,0,34,22,0,179
Iran,18/03/2011,71,0,2,0,43,7,0,123
Iran,19/03/2011,50,0,-2,0,26,15,0,89
Iran,20/03/2011,62,4,0,0,52,6,0,124
Iran,21/03/2011,107,4,-2,0,52,28,0,189
Iran,22/03/2011,142,6,0,0,36,23,0,207
Iran,23/03/2011,118,0,0,0,76,5,0,199
Iran,24/03/2011,153,0,-5,0,67,1,0,216
Iran,25/03/2011,107,0,0,0,47,5,0,159
Iran,26/03/2011,43,0,-1,0,20,5,0,67
Iran,27/03/2011,55,0,0,0,52,16,0,123
Iran,28/03/2011,65,2,1,0,28,3,0,99
Iran,29/03/2011,95,0,0,0,25,19,0,139
Iran,30/03/2011,68,0,1,0,33,13,0,115
Iran,31/03/2011,111,0,0,0,51,13,0,175
Iraq,01/03/2011,177,4,-2,0,35,37,0,251
Iraq,02/03/2011,299,2,-1,0,107,90,0,497
Iraq,03/03/2011,288,6,8,0,69,51,0,422
Iraq,04/03/2011,166,0,2,0,49,33,0,250
Iraq,05/03/2011,89,0,0,0,75,6,0,170
Iraq,06/03/2011,79,0,-5,0,65,28,0,167
Iraq,07/03/2011,76,6,2,0,47,17,0,148
Iraq,08/03/2011,175,0,2,0,70,35,0,282
Iraq,09/03/2011,170,2,-2,0,63,24,0,257
Iraq,10/03/2011,269,2,-1,0,74,22,0,366
Iraq,11/03/2011,101,0,7,0,24,18,0,150
Iraq,12/03/2011,101,0,0,0,8,14,0,123
Iraq,13/03/2011,37,6,-2,0,55,2,0,98
Iraq,14/03/2011,90,0,-6,0,32,12,0,128
Iraq,15/03/2011,109,2,-2,0,42,34,0,185
Iraq,16/03/2011,65,0,-2,0,52,26,0,141
Iraq,17/03/2011,129,2,-2,0,53,20,0,202
Iraq,18/03/2011,138,0,2,0,31,26,0,197
Iraq,19/03/2011,56,0,0,0,23,32,0,111
Iraq,20/03/2011,235,4,-4,0,28,50,0,313
Iraq,21/03/2011,320,2,0,0,45,62,0,429
Iraq,22/03/2011,303,0,0,0,19,29,0,351
Iraq,23/03/2011,158,2,-5,0,17,24,0,196
Iraq,24/03/2011,146,0,-2,0,17,21,0,182
Iraq,25/03/2011,105,0,-3,0,14,20,0,136
Iraq,26/03/2011,94,0,-2,0,38,31,0,161
Iraq,27/03/2011,129,0,0,0,13,25,0,167
Iraq,28/03/2011,130,0,-3,0,6,13,0,146
Iraq,29/03/2011,205,2,-2,0,-5,16,0,216
Iraq,30/03/2011,177,0,0,0,-1,16,0,192
Iraq,31/03/2011,190,2,-3,0,16,5,0,210
Morocco,01/03/2011,14,0,0,0,4,6,0,24
Morocco,02/03/2011,8,0,0,0,7,3,0,18
Morocco,03/03/2011,7,0,1,0,-5,3,0,6
Morocco,04/03/2011,9,0,0,0,0,4,0,13
Morocco,05/03/2011,5,0,-12,0,0,2,0,-5
Morocco,06/03/2011,5,0,-1,0,1,5,0,10
Morocco,07/03/2011,3,0,-4,0,1,8,0,8
Morocco,08/03/2011,1,0,0,0,0,8,0,9
Morocco,09/03/2011,67,0,-17,0,-2,8,0,56
Morocco,10/03/2011,18,0,-20,0,1,1,0,0
Morocco,11/03/2011,11,0,0,0,5,-1,0,15
Morocco,12/03/2011,12,0,-2,0,0,0,0,10
Morocco,13/03/2011,4,0,0,0,3,0,0,7
Morocco,14/03/2011,8,0,-1,0,8,2,0,17
Morocco,15/03/2011,20,0,-2,0,9,8,0,35
Morocco,16/03/2011,9,0,1,0,4,0,0,14
Morocco,17/03/2011,11,0,0,0,6,6,0,23
Morocco,18/03/2011,3,0,-2,0,4,2,0,7
Morocco,19/03/2011,6,0,0,0,0,0,0,6
Morocco,20/03/2011,3,0,0,0,0,2,0,5
Morocco,21/03/2011,5,0,-14,0,4,7,0,2
Morocco,22/03/2011,22,0,0,0,-4,3,0,21
Morocco,23/03/2011,2,0,-10,0,6,4,0,2
Morocco,24/03/2011,17,0,-8,0,6,1,0,16
Morocco,25/03/2011,3,0,0,0,-4,2,0,1
Morocco,26/03/2011,7,0,0,0,-2,4,0,9
Morocco,27/03/2011,2,0,-3,0,0,0,0,-1
Morocco,28/03/2011,7,0,0,0,0,5,0,12
Morocco,29/03/2011,-3,0,0,0,12,0,0,9
Morocco,30/03/2011,15,0,0,0,0,0,0,15
Morocco,31/03/2011,9,0,-2,0,1,0,0,8
Nigeria,01/03/2011,60,0,-4,0,19,5,0,80
Nigeria,02/03/2011,58,2,-2,0,10,4,0,72
Nigeria,03/03/2011,37,0,0,0,24,6,0,67
Nigeria,04/03/2011,31,0,-8,0,32,0,0,55
Nigeria,05/03/2011,14,0,0,0,14,10,0,38
Nigeria,06/03/2011,56,0,1,0,21,3,0,81
Nigeria,07/03/2011,57,0,0,0,11,9,0,77
Nigeria,08/03/2011,22,0,2,0,11,4,0,39
Nigeria,09/03/2011,31,2,-9,0,10,5,0,39
Nigeria,10/03/2011,35,0,-1,0,31,1,0,66
Nigeria,11/03/2011,57,8,-5,0,11,2,0,73
Nigeria,12/03/2011,31,0,-1,0,-7,3,0,26
Nigeria,13/03/2011,15,0,0,0,3,0,0,18
Nigeria,14/03/2011,79,0,0,0,12,3,0,94
Nigeria,15/03/2011,19,0,-2,0,7,4,0,28
Nigeria,16/03/2011,27,0,0,0,-12,2,0,17
Nigeria,17/03/2011,51,0,1,0,5,6,0,63
Nigeria,18/03/2011,55,0,0,0,9,3,0,67
Nigeria,19/03/2011,90,0,0,0,5,2,0,97
Nigeria,20/03/2011,36,4,0,0,9,10,0,59
Nigeria,21/03/2011,31,0,0,0,6,0,0,37
Nigeria,22/03/2011,76,0,2,0,31,5,0,114
Nigeria,23/03/2011,36,0,0,0,7,3,0,46
Nigeria,24/03/2011,22,0,-2,0,24,9,0,53
Nigeria,25/03/2011,19,0,-2,0,15,2,0,34
Nigeria,26/03/2011,19,0,0,0,16,0,0,35
Nigeria,27/03/2011,12,0,0,0,1,1,0,14
Nigeria,28/03/2011,22,0,4,0,36,6,0,68
Nigeria,29/03/2011,33,0,1,0,14,1,0,49
Nigeria,30/03/2011,26,0,-4,0,4,2,0,28
Nigeria,31/03/2011,55,0,-6,0,37,6,0,92
Pakistan,01/03/2011,101,2,-4,0,39,19,0,157
Pakistan,02/03/2011,448,2,-1,0,130,45,0,624
Pakistan,03/03/2011,808,0,-36,0,283,132,0,1187
Pakistan,04/03/2011,109,2,-7,0,20,14,0,138
Pakistan,05/03/2011,44,0,0,0,40,7,0,91
Pakistan,06/03/2011,113,0,0,0,42,14,0,169
Pakistan,07/03/2011,64,6,2,0,27,3,0,102
Pakistan,08/03/2011,98,0,0,0,23,15,0,136
Pakistan,09/03/2011,83,2,1,0,60,10,0,156
Pakistan,10/03/2011,156,0,1,0,38,7,0,202
Pakistan,11/03/2011,24,6,0,0,2,8,0,40
Pakistan,12/03/2011,56,0,0,0,19,2,0,77
Pakistan,13/03/2011,58,0,1,0,24,7,0,90
Pakistan,14/03/2011,99,0,0,0,98,26,0,223
Pakistan,15/03/2011,115,0,1,0,66,19,0,201
Pakistan,16/03/2011,249,2,-9,0,-60,7,0,189
Pakistan,17/03/2011,127,0,-2,0,-7,10,0,128
Pakistan,18/03/2011,94,0,-1,0,14,15,0,122
Pakistan,19/03/2011,63,4,-1,0,8,3,0,77
Pakistan,20/03/2011,44,0,0,0,9,6,0,59
Pakistan,21/03/2011,45,0,0,0,19,14,0,78
Pakistan,22/03/2011,70,0,-1,0,34,29,0,132
Pakistan,23/03/2011,62,0,-3,0,24,5,0,88
Pakistan,24/03/2011,80,0,0,0,16,12,0,108
Pakistan,25/03/2011,48,2,1,0,12,8,0,71
Pakistan,26/03/2011,42,2,-6,0,6,10,0,54
Pakistan,27/03/2011,60,2,-2,0,27,6,0,93
Pakistan,28/03/2011,89,2,0,0,7,11,0,109
Pakistan,29/03/2011,110,0,2,0,41,7,0,160
Pakistan,30/03/2011,28,0,0,0,96,5,0,129
Pakistan,31/03/2011,69,0,2,0,51,10,0,132
Sierra Leone,01/03/2011,11,0,0,0,6,0,0,17
Sierra Leone,02/03/2011,0,0,0,0,1,0,0,1
Sierra Leone,03/03/2011,14,0,0,0,3,0,0,17
Sierra Leone,04/03/2011,-2,2,0,0,3,0,0,3
Sierra Leone,05/03/2011,0,0,0,0,0,0,0,0
Sierra Leone,06/03/2011,1,0,0,0,9,0,0,10
Sierra Leone,07/03/2011,6,0,0,0,3,2,0,11
Sierra Leone,08/03/2011,9,0,0,0,0,2,0,11
Sierra Leone,09/03/2011,39,0,0,0,23,0,0,62
Sierra Leone,10/03/2011,16,0,0,0,6,0,0,22
Sierra Leone,11/03/2011,20,0,0,0,9,12,0,41
Sierra Leone,12/03/2011,4,0,0,0,6,6,0,16
Sierra Leone,13/03/2011,0,0,0,0,9,0,0,9
Sierra Leone,14/03/2011,0,0,0,0,3,1,0,4
Sierra Leone,15/03/2011,5,0,0,0,0,0,0,5
Sierra Leone,16/03/2011,0,0,0,0,0,2,0,2
Sierra Leone,17/03/2011,2,0,0,0,0,0,0,2
Sierra Leone,18/03/2011,6,0,0,0,0,0,0,6
Sierra Leone,19/03/2011,0,0,0,0,0,2,0,2
Sierra Leone,20/03/2011,0,0,0,0,0,0,0,0
Sierra Leone,21/03/2011,0,0,0,0,0,0,0,0
Sierra Leone,22/03/2011,-1,0,0,0,0,0,0,-1
Sierra Leone,23/03/2011,7,0,0,0,0,1,0,8
Sierra Leone,24/03/2011,1,0,0,0,3,3,0,7
Sierra Leone,25/03/2011,10,0,0,0,15,0,0,25
Sierra Leone,26/03/2011,4,0,0,0,0,0,0,4
Sierra Leone,27/03/2011,1,0,0,0,0,0,0,1
Sierra Leone,28/03/2011,2,0,0,0,0,0,0,2
Sierra Leone,29/03/2011,8,0,0,0,0,0,0,8
Sierra Leone,30/03/2011,0,0,0,0,7,0,0,7
Sierra Leone,31/03/2011,4,0,0,0,9,2,0,15
Somalia,01/03/2011,92,2,1,0,53,7,0,155
Somalia,02/03/2011,95,0,0,0,90,3,0,188
Somalia,03/03/2011,109,2,-10,0,39,1,0,141
Somalia,04/03/2011,64,0,-2,0,20,0,0,82
Somalia,05/03/2011,26,0,0,0,3,1,0,30
Somalia,06/03/2011,37,0,0,0,28,7,0,72
Somalia,07/03/2011,54,8,0,0,11,16,0,89
Somalia,08/03/2011,43,2,-4,0,13,10,0,64
Somalia,09/03/2011,57,2,0,0,23,10,0,92
Somalia,10/03/2011,132,2,0,0,77,10,0,221
Somalia,11/03/2011,80,2,1,0,56,10,0,149
Somalia,12/03/2011,30,2,0,0,25,4,0,61
Somalia,13/03/2011,12,0,0,0,4,2,0,18
Somalia,14/03/2011,87,0,0,0,87,4,0,178
Somalia,15/03/2011,63,0,0,0,69,6,0,138
Somalia,16/03/2011,43,2,0,0,37,5,0,87
Somalia,17/03/2011,46,0,0,0,-17,2,0,31
Somalia,18/03/2011,17,0,0,0,-9,4,0,12
Somalia,19/03/2011,29,4,0,0,-8,0,0,25
Somalia,20/03/2011,13,0,0,0,6,1,0,20
Somalia,21/03/2011,54,0,-2,0,2,1,0,55
Somalia,22/03/2011,42,0,0,0,18,1,0,61
Somalia,23/03/2011,55,0,0,0,-2,2,0,55
Somalia,24/03/2011,73,2,0,0,16,1,0,92
Somalia,25/03/2011,45,0,2,0,17,4,0,68
Somalia,26/03/2011,25,0,3,0,0,0,0,28
Somalia,27/03/2011,60,0,-8,0,65,3,0,120
Somalia,28/03/2011,76,0,0,0,8,1,0,85
Somalia,29/03/2011,51,0,0,0,4,0,0,55
Somalia,30/03/2011,85,0,0,0,40,4,0,129
Somalia,31/03/2011,54,2,0,0,28,3,0,87
Syria,01/03/2011,5,0,0,0,2,2,0,9
Syria,02/03/2011,29,0,0,0,8,3,0,40
Syria,03/03/2011,48,0,0,0,22,9,0,79
Syria,04/03/2011,44,0,3,0,7,9,0,63
Syria,05/03/2011,25,0,3,0,18,6,0,52
Syria,06/03/2011,46,0,1,0,2,6,0,55
Syria,07/03/2011,23,0,0,0,14,9,0,46
Syria,08/03/2011,41,0,-4,0,22,19,0,78
Syria,09/03/2011,75,0,1,0,15,4,0,95
Syria,10/03/2011,48,4,0,0,18,5,0,75
Syria,11/03/2011,24,4,0,0,18,7,0,53
Syria,12/03/2011,20,0,0,0,6,3,0,29
Syria,13/03/2011,65,0,0,0,21,13,0,99
Syria,14/03/2011,18,0,0,0,4,3,0,25
Syria,15/03/2011,17,0,0,0,15,5,0,37
Syria,16/03/2011,39,0,6,0,20,9,0,74
Syria,17/03/2011,13,0,3,0,35,8,0,59
Syria,18/03/2011,59,0,0,0,4,8,0,71
Syria,19/03/2011,58,0,-2,0,28,14,0,98
Syria,20/03/2011,104,0,-8,0,58,19,0,173
Syria,21/03/2011,153,0,0,0,50,59,0,262
Syria,22/03/2011,111,0,5,0,36,19,0,171
Syria,23/03/2011,251,2,-3,0,26,37,0,313
Syria,24/03/2011,269,0,-6,0,44,55,0,362
Syria,25/03/2011,170,0,-19,0,20,36,0,207
Syria,26/03/2011,99,0,-7,0,16,37,0,145
Syria,27/03/2011,489,22,-15,0,204,113,0,813
Syria,28/03/2011,162,0,-5,0,39,47,0,243
Syria,29/03/2011,133,0,-30,0,39,19,0,161
Syria,30/03/2011,70,0,-10,0,21,7,0,88
Syria,31/03/2011,142,0,-22,0,47,22,0,189
Yemen,01/03/2011,88,2,-3,0,33,19,0,139
Yemen,02/03/2011,33,0,-9,0,36,26,0,86
Yemen,03/03/2011,68,0,-12,0,18,10,0,84
Yemen,04/03/2011,79,0,-2,0,12,18,0,107
Yemen,05/03/2011,19,0,-9,0,15,16,0,41
Yemen,06/03/2011,85,0,-2,0,15,8,0,106
Yemen,07/03/2011,55,0,-3,0,38,16,0,106
Yemen,08/03/2011,80,2,-2,0,24,12,0,116
Yemen,09/03/2011,41,2,-6,0,11,14,0,62
Yemen,10/03/2011,73,0,-10,0,20,4,0,87
Yemen,11/03/2011,80,0,0,0,9,18,0,107
Yemen,12/03/2011,81,0,-7,0,6,20,0,100
Yemen,13/03/2011,81,0,-2,0,10,14,0,103
Yemen,14/03/2011,112,0,-3,0,32,16,0,157
Yemen,15/03/2011,91,2,0,0,21,30,0,144
Yemen,16/03/2011,69,0,-4,0,16,10,0,91
Yemen,17/03/2011,30,2,-2,0,-8,3,0,25
Yemen,18/03/2011,143,0,-2,0,72,23,0,236
Yemen,19/03/2011,129,6,2,0,41,32,0,210
Yemen,20/03/2011,100,6,-37,0,12,48,0,129
Yemen,21/03/2011,107,0,-41,0,20,59,0,145
Yemen,22/03/2011,252,0,-78,0,20,40,0,234
Yemen,23/03/2011,125,0,-19,0,19,19,0,144
Yemen,24/03/2011,81,0,-10,0,31,17,0,119
Yemen,25/03/2011,249,2,-17,0,82,52,0,368
Yemen,26/03/2011,557,12,-30,0,154,94,0,787
Yemen,27/03/2011,85,0,-12,0,14,25,0,112
Yemen,28/03/2011,117,0,-8,0,3,18,0,130
Yemen,29/03/2011,85,0,-2,0,-10,11,0,84
Yemen,30/03/2011,83,0,-12,0,8,6,0,85
Yemen,31/03/2011,52,0,-4,0,10,6,0,64
Afghanistan,01/02/2011,289,4,1,0,58,5,0,357
Afghanistan,02/02/2011,251,2,2,0,68,21,0,344
Afghanistan,03/02/2011,253,0,0,0,-9,21,0,265
Afghanistan,04/02/2011,152,4,0,0,50,16,0,222
Afghanistan,05/02/2011,116,0,7,0,6,11,0,140
Afghanistan,06/02/2011,136,0,-2,0,20,6,0,160
Afghanistan,07/02/2011,254,2,6,0,45,16,0,323
Afghanistan,08/02/2011,114,0,0,0,15,17,0,146
Afghanistan,09/02/2011,233,2,-7,0,10,46,0,284
Afghanistan,10/02/2011,262,2,3,0,41,73,0,381
Afghanistan,11/02/2011,200,2,-4,0,87,42,0,327
Afghanistan,12/02/2011,371,0,1,0,44,77,0,493
Afghanistan,13/02/2011,132,2,1,0,-8,25,0,152
Afghanistan,14/02/2011,147,2,1,0,46,13,0,209
Afghanistan,15/02/2011,218,0,-15,0,25,33,0,261
Afghanistan,16/02/2011,168,0,-14,0,64,39,0,257
Afghanistan,17/02/2011,101,2,-10,0,14,14,0,121
Afghanistan,18/02/2011,28,0,0,0,1,7,0,36
Afghanistan,19/02/2011,279,0,6,0,51,28,0,364
Afghanistan,20/02/2011,315,0,0,0,28,7,0,350
Afghanistan,21/02/2011,267,0,2,0,7,58,0,334
Afghanistan,22/02/2011,81,0,0,0,32,17,0,130
Afghanistan,23/02/2011,105,2,0,0,9,4,0,120
Afghanistan,24/02/2011,214,4,4,0,37,17,0,276
Afghanistan,25/02/2011,214,2,0,0,20,37,0,273
Afghanistan,26/02/2011,112,0,0,0,20,12,0,144
Afghanistan,27/02/2011,138,0,0,0,13,31,0,182
Afghanistan,28/02/2011,187,10,-3,0,3,24,0,221
Albania,01/02/2011,15,0,0,0,0,7,0,22
Albania,02/02/2011,3,0,0,0,11,0,0,14
Albania,03/02/2011,1,0,-1,0,2,0,0,2
Albania,04/02/2011,11,2,0,0,3,6,0,22
Albania,05/02/2011,1,0,0,0,3,3,0,7
Albania,06/02/2011,0,0,0,0,3,4,0,7
Albania,07/02/2011,6,0,0,0,9,0,0,15
Albania,08/02/2011,11,0,1,0,12,0,0,24
Albania,09/02/2011,6,0,-1,0,21,2,0,28
Albania,10/02/2011,9,0,0,0,3,2,0,14
Albania,11/02/2011,9,0,0,0,0,4,0,13
Albania,12/02/2011,4,0,0,0,-1,0,0,3
Albania,13/02/2011,10,0,0,0,0,7,0,17
Albania,14/02/2011,34,0,0,0,0,0,0,34
Albania,15/02/2011,-2,0,1,0,0,3,0,2
Albania,16/02/2011,27,0,-2,0,30,2,0,57
Albania,17/02/2011,27,0,-2,0,9,4,0,38
Albania,19/02/2011,13,0,0,0,6,0,0,19
Albania,20/02/2011,1,0,0,0,9,0,0,10
Albania,21/02/2011,9,0,3,0,3,0,0,15
Albania,22/02/2011,-1,0,0,0,12,1,0,12
Albania,23/02/2011,70,0,-5,0,90,15,0,170
Albania,24/02/2011,33,2,0,0,50,1,0,86
Albania,25/02/2011,1,0,0,0,0,0,0,1
Albania,26/02/2011,6,0,0,0,21,1,0,28
Albania,27/02/2011,10,0,0,0,9,0,0,19
Albania,28/02/2011,14,0,0,0,3,1,0,18
Algeria,01/02/2011,27,0,-4,0,6,16,0,45
Algeria,02/02/2011,31,0,-2,0,19,27,0,75
Algeria,03/02/2011,21,0,-6,0,18,16,0,49
Algeria,04/02/2011,19,0,-4,0,18,26,0,59
Algeria,05/02/2011,2,0,0,0,15,4,0,21
Algeria,06/02/2011,2,0,0,0,12,4,0,18
Algeria,07/02/2011,17,0,-3,0,34,14,0,62
Algeria,08/02/2011,11,0,0,0,6,6,0,23
Algeria,09/02/2011,10,0,0,0,3,11,0,24
Algeria,10/02/2011,5,0,0,0,2,5,0,12
Algeria,11/02/2011,11,0,-6,0,12,2,0,19
Algeria,12/02/2011,49,0,4,0,27,31,0,111
Algeria,13/02/2011,17,0,2,0,29,10,0,58
Algeria,14/02/2011,18,0,0,0,5,9,0,32
Algeria,15/02/2011,50,0,0,0,4,18,0,72
Algeria,16/02/2011,15,0,-2,0,9,7,0,29
Algeria,17/02/2011,31,0,0,0,1,4,0,36
Algeria,18/02/2011,2,0,1,0,3,6,0,12
Algeria,19/02/2011,46,0,-2,0,26,28,0,98
Algeria,20/02/2011,27,0,0,0,21,31,0,79
Algeria,21/02/2011,15,0,0,0,9,12,0,36
Algeria,22/02/2011,41,0,0,0,-3,11,0,49
Algeria,23/02/2011,27,0,0,0,4,19,0,50
Algeria,24/02/2011,27,0,-4,0,29,8,0,60
Algeria,25/02/2011,56,0,0,0,32,17,0,105
Algeria,26/02/2011,20,0,0,0,-2,13,0,31
Algeria,27/02/2011,5,0,0,0,2,11,0,18
Algeria,28/02/2011,39,0,0,0,-2,2,0,39
Bangladesh,01/02/2011,29,0,1,0,18,2,0,50
Bangladesh,02/02/2011,22,0,0,0,77,1,0,100
Bangladesh,03/02/2011,8,0,0,0,13,0,0,21
Bangladesh,04/02/2011,13,0,0,0,2,1,0,16
Bangladesh,05/02/2011,18,0,1,0,-19,2,0,2
Bangladesh,06/02/2011,6,0,0,0,9,0,0,15
Bangladesh,07/02/2011,2,0,3,0,18,4,0,27
Bangladesh,08/02/2011,16,0,0,0,9,2,0,27
Bangladesh,09/02/2011,28,0,0,0,4,3,0,35
Bangladesh,10/02/2011,33,0,0,0,27,2,0,62
Bangladesh,11/02/2011,42,0,0,0,3,3,0,48
Bangladesh,12/02/2011,16,0,0,0,18,0,0,34
Bangladesh,13/02/2011,12,2,1,0,21,3,0,39
Bangladesh,14/02/2011,6,2,0,0,21,1,0,30
Bangladesh,15/02/2011,55,0,0,0,27,0,0,82
Bangladesh,16/02/2011,32,0,0,0,15,6,0,53
Bangladesh,17/02/2011,17,0,-3,0,9,4,0,27
Bangladesh,18/02/2011,6,0,0,0,0,0,0,6
Bangladesh,19/02/2011,5,0,-1,0,7,5,0,16
Bangladesh,20/02/2011,16,0,0,0,6,6,0,28
Bangladesh,21/02/2011,34,0,-2,0,30,12,0,74
Bangladesh,22/02/2011,39,2,-6,0,14,11,0,60
Bangladesh,23/02/2011,16,0,-3,0,7,9,0,29
Bangladesh,24/02/2011,16,0,-2,0,4,1,0,19
Bangladesh,25/02/2011,7,0,0,0,6,2,0,15
Bangladesh,26/02/2011,16,0,0,0,6,3,0,25
Bangladesh,27/02/2011,4,0,0,0,22,2,0,28
Bangladesh,28/02/2011,132,0,-5,0,69,19,0,215
Cameroon,01/02/2011,0,0,0,0,-1,1,0,0
Cameroon,02/02/2011,4,0,0,0,0,0,0,4
Cameroon,03/02/2011,0,0,0,0,0,0,0,0
Cameroon,04/02/2011,3,0,0,0,3,0,0,6
Cameroon,07/02/2011,-8,0,0,0,0,1,0,-7
Cameroon,08/02/2011,0,0,0,0,0,0,0,0
Cameroon,09/02/2011,0,0,0,0,0,0,0,0
Cameroon,10/02/2011,5,0,0,0,6,0,0,11
Cameroon,11/02/2011,-3,0,0,0,0,0,0,-3
Cameroon,13/02/2011,0,0,0,0,3,0,0,3
Cameroon,14/02/2011,0,0,0,0,0,0,0,0
Cameroon,15/02/2011,1,0,0,0,3,0,0,4
Cameroon,16/02/2011,3,0,0,0,0,3,0,6
Cameroon,17/02/2011,0,0,0,0,0,0,0,0
Cameroon,19/02/2011,1,0,0,0,0,6,0,7
Cameroon,20/02/2011,0,0,0,0,0,3,0,3
Cameroon,21/02/2011,2,0,0,0,0,0,0,2
Cameroon,22/02/2011,2,0,1,0,0,0,0,3
Cameroon,23/02/2011,9,0,-1,0,-2,1,0,7
Cameroon,24/02/2011,0,0,0,0,0,0,0,0
Cameroon,25/02/2011,3,0,0,0,-4,0,0,-1
Cameroon,26/02/2011,0,0,0,0,0,0,0,0
Cameroon,27/02/2011,22,0,0,0,0,0,0,22
Cameroon,28/02/2011,2,0,0,0,0,0,0,2
China,01/02/2011,128,12,-7,0,45,19,0,197
China,02/02/2011,82,2,-7,0,66,29,0,172
China,03/02/2011,138,0,-1,0,65,11,0,213
China,04/02/2011,104,0,-10,0,79,11,0,184
China,05/02/2011,54,0,0,0,24,6,0,84
China,06/02/2011,72,2,-1,0,45,16,0,134
China,07/02/2011,144,0,-3,0,65,11,0,217
China,08/02/2011,59,1,-7,0,28,13,0,94
China,09/02/2011,111,7,1,0,142,14,0,275
China,10/02/2011,78,0,-4,0,94,17,0,185
China,11/02/2011,109,7,-3,0,11,21,0,145
China,12/02/2011,67,3,-1,0,52,14,0,135
China,13/02/2011,65,4,1,0,39,9,0,118
China,14/02/2011,135,6,-4,0,106,14,0,257
China,15/02/2011,163,2,-8,0,43,14,0,214
China,16/02/2011,116,2,-6,0,89,16,0,217
China,17/02/2011,112,0,-5,0,38,12,0,157
China,18/02/2011,3,0,0,0,9,0,0,12
China,19/02/2011,99,0,-5,0,68,21,0,183
China,20/02/2011,126,8,-4,0,59,16,0,205
China,21/02/2011,150,4,1,0,99,19,0,273
China,22/02/2011,104,4,-22,0,76,36,0,198
China,23/02/2011,166,0,2,0,89,34,0,291
China,24/02/2011,100,0,4,0,98,30,0,232
China,25/02/2011,153,0,-8,0,77,22,0,244
China,26/02/2011,77,0,-6,0,56,14,0,141
China,27/02/2011,69,0,-3,0,3,18,0,87
China,28/02/2011,127,0,-8,0,14,18,0,151
Egypt,01/02/2011,910,6,-104,0,383,232,0,1427
Egypt,02/02/2011,829,8,-93,0,356,247,0,1347
Egypt,03/02/2011,577,4,-80,0,226,206,0,933
Egypt,04/02/2011,583,0,-121,0,252,184,0,898
Egypt,05/02/2011,411,4,-117,0,145,149,0,592
Egypt,06/02/2011,365,4,-47,0,95,140,0,557
Egypt,07/02/2011,374,4,-44,0,46,96,0,476
Egypt,08/02/2011,221,6,-30,0,95,84,0,376
Egypt,09/02/2011,284,2,-40,0,101,92,0,439
Egypt,10/02/2011,322,0,-178,0,82,135,0,361
Egypt,11/02/2011,742,10,-234,0,310,284,0,1112
Egypt,12/02/2011,670,4,-128,0,425,328,0,1299
Egypt,13/02/2011,388,0,-78,0,174,171,0,655
Egypt,14/02/2011,402,4,-94,0,230,184,0,726
Egypt,15/02/2011,475,6,-79,0,183,200,0,785
Egypt,16/02/2011,611,8,-45,0,175,238,0,987
Egypt,17/02/2011,272,2,-39,0,34,94,0,363
Egypt,18/02/2011,23,0,-6,0,5,9,0,31
Egypt,19/02/2011,415,4,-67,0,78,152,0,582
Egypt,20/02/2011,342,2,-29,0,113,138,0,566
Egypt,21/02/2011,365,0,-55,0,141,110,0,561
Egypt,22/02/2011,579,6,-16,0,159,154,0,882
Egypt,23/02/2011,688,24,-50,0,424,189,0,1275
Egypt,24/02/2011,361,6,-16,0,193,134,0,678
Egypt,25/02/2011,302,4,-10,0,131,97,0,524
Egypt,26/02/2011,197,0,-21,0,113,79,0,368
Egypt,27/02/2011,276,4,-67,0,145,74,0,432
Egypt,28/02/2011,210,0,-17,0,81,69,0,343
Eritrea,01/02/2011,0,0,0,0,0,0,0,0
Eritrea,02/02/2011,0,0,0,0,0,0,0,0
Eritrea,03/02/2011,10,0,0,0,9,3,0,22
Eritrea,04/02/2011,8,0,0,0,9,3,0,20
Eritrea,05/02/2011,10,0,0,0,9,3,0,22
Eritrea,06/02/2011,2,0,0,0,0,0,0,2
Eritrea,07/02/2011,0,0,0,0,0,0,0,0
Eritrea,08/02/2011,0,0,0,0,6,0,0,6
Eritrea,09/02/2011,16,0,0,0,6,0,0,22
Eritrea,10/02/2011,0,0,0,0,0,0,0,0
Eritrea,11/02/2011,5,0,0,0,12,2,0,19
Eritrea,13/02/2011,7,0,0,0,3,0,0,10
Eritrea,14/02/2011,3,0,0,0,3,0,0,6
Eritrea,15/02/2011,0,0,0,0,-4,0,0,-4
Eritrea,16/02/2011,0,2,0,0,0,0,0,2
Eritrea,17/02/2011,2,0,0,0,0,0,0,2
Eritrea,19/02/2011,3,0,0,0,0,0,0,3
Eritrea,20/02/2011,4,0,0,0,0,0,0,4
Eritrea,21/02/2011,6,0,0,0,0,0,0,6
Eritrea,22/02/2011,15,0,0,0,0,0,0,15
Eritrea,23/02/2011,2,0,0,0,12,2,0,16
Eritrea,24/02/2011,0,0,0,0,3,0,0,3
Eritrea,25/02/2011,7,0,0,0,0,3,0,10
Eritrea,26/02/2011,7,0,0,0,9,2,0,18
Eritrea,27/02/2011,0,0,0,0,0,0,0,0
Eritrea,28/02/2011,10,0,2,0,0,0,0,12
Georgia,01/02/2011,55,0,-2,0,35,9,0,97
Georgia,02/02/2011,20,2,0,0,23,3,0,48
Georgia,03/02/2011,23,0,1,0,6,-2,0,28
Georgia,04/02/2011,39,2,-1,0,22,4,0,66
Georgia,05/02/2011,17,0,-4,0,7,7,0,27
Georgia,06/02/2011,17,0,-4,0,9,2,0,24
Georgia,07/02/2011,35,0,-2,0,9,4,0,46
Georgia,08/02/2011,40,2,0,0,34,2,0,78
Georgia,09/02/2011,50,0,0,0,35,5,0,90
Georgia,10/02/2011,63,0,0,0,28,11,0,102
Georgia,11/02/2011,16,0,0,0,16,2,0,34
Georgia,12/02/2011,14,0,-4,0,7,1,0,18
Georgia,13/02/2011,7,0,0,0,12,8,0,27
Georgia,14/02/2011,37,0,0,0,24,9,0,70
Georgia,15/02/2011,26,0,-3,0,13,3,0,39
Georgia,16/02/2011,32,2,-1,0,40,8,0,81
Georgia,17/02/2011,27,0,0,0,-2,7,0,32
Georgia,18/02/2011,7,0,0,0,0,0,0,7
Georgia,19/02/2011,9,0,0,0,8,0,0,17
Georgia,20/02/2011,19,0,0,0,4,2,0,25
Georgia,21/02/2011,76,2,1,0,68,8,0,155
Georgia,22/02/2011,51,0,0,0,28,1,0,80
Georgia,23/02/2011,48,2,-2,0,11,7,0,66
Georgia,24/02/2011,39,0,1,0,41,3,0,84
Georgia,25/02/2011,37,0,-2,0,10,7,0,52
Georgia,26/02/2011,33,0,0,0,13,3,0,49
Georgia,27/02/2011,16,0,0,0,10,5,0,31
Georgia,28/02/2011,28,2,-1,0,2,5,0,36
India,01/02/2011,20,0,1,0,16,9,0,46
India,02/02/2011,82,0,-1,0,24,10,0,115
India,03/02/2011,93,0,-4,0,9,5,0,103
India,04/02/2011,32,0,0,0,14,9,0,55
India,05/02/2011,35,4,2,0,9,12,0,62
India,06/02/2011,59,0,-2,0,20,3,0,80
India,07/02/2011,67,6,0,0,46,9,0,128
India,08/02/2011,94,2,-1,0,28,4,0,127
India,09/02/2011,39,0,0,0,34,8,0,81
India,10/02/2011,80,0,-5,0,16,20,0,111
India,11/02/2011,67,0,-4,0,18,15,0,96
India,12/02/2011,50,0,0,0,5,11,0,66
India,13/02/2011,44,8,-3,0,8,12,0,69
India,14/02/2011,67,0,0,0,24,7,0,98
India,15/02/2011,47,0,-2,0,44,14,0,103
India,16/02/2011,42,0,-4,0,13,7,0,58
India,17/02/2011,46,0,0,0,9,5,0,60
India,18/02/2011,0,0,0,0,0,0,0,0
India,19/02/2011,88,0,1,0,37,19,0,145
India,20/02/2011,64,0,-2,0,17,17,0,96
India,21/02/2011,71,2,-9,0,1,42,0,107
India,22/02/2011,74,0,-21,0,12,18,0,83
India,23/02/2011,56,0,-10,0,0,16,0,62
India,24/02/2011,62,2,-4,0,10,8,0,78
India,25/02/2011,59,0,0,0,14,2,0,75
India,26/02/2011,35,2,-2,0,21,5,0,61
India,27/02/2011,58,6,-1,0,66,11,0,140
India,28/02/2011,59,2,-5,0,57,4,0,117
Iran,01/02/2011,141,0,-4,0,86,59,0,282
Iran,02/02/2011,115,0,0,0,40,16,0,171
Iran,03/02/2011,132,4,-9,0,68,16,0,211
Iran,04/02/2011,159,0,1,0,80,33,0,273
Iran,05/02/2011,185,0,-7,0,79,35,0,292
Iran,06/02/2011,110,2,-2,0,96,25,0,231
Iran,07/02/2011,61,0,-6,0,22,32,0,109
Iran,08/02/2011,20,2,0,0,68,15,0,105
Iran,09/02/2011,81,4,-6,0,116,36,0,231
Iran,10/02/2011,57,0,-10,0,84,21,0,152
Iran,11/02/2011,119,0,-26,0,22,18,0,133
Iran,12/02/2011,74,0,-3,0,47,65,0,183
Iran,13/02/2011,66,4,-3,0,4,49,0,120
Iran,14/02/2011,152,0,-11,0,63,63,0,267
Iran,15/02/2011,263,0,-7,0,70,57,0,383
Iran,16/02/2011,526,0,-18,0,242,104,0,854
Iran,17/02/2011,148,0,4,0,28,32,0,212
Iran,18/02/2011,8,0,0,0,3,2,0,13
Iran,19/02/2011,95,0,2,0,26,26,0,149
Iran,20/02/2011,122,4,-3,0,47,29,0,199
Iran,21/02/2011,123,0,4,0,31,25,0,183
Iran,22/02/2011,133,2,-9,0,67,34,0,227
Iran,23/02/2011,81,0,4,0,39,28,0,152
Iran,24/02/2011,146,0,1,0,47,15,0,209
Iran,25/02/2011,59,0,0,0,71,9,0,139
Iran,26/02/2011,51,0,0,0,42,4,0,97
Iran,27/02/2011,66,0,-1,0,29,12,0,106
Iran,28/02/2011,63,0,-8,0,16,8,0,79
Iraq,01/02/2011,142,2,-2,0,10,14,0,166
Iraq,02/02/2011,109,4,-4,0,58,19,0,186
Iraq,03/02/2011,216,24,-8,0,102,21,0,355
Iraq,04/02/2011,385,4,-8,0,174,58,0,613
Iraq,05/02/2011,124,0,-4,0,42,3,0,165
Iraq,06/02/2011,92,4,-2,0,103,7,0,204
Iraq,07/02/2011,60,2,-1,0,64,7,0,132
Iraq,08/02/2011,51,0,-2,0,70,9,0,128
Iraq,09/02/2011,90,0,-1,0,18,12,0,119
Iraq,10/02/2011,114,2,-3,0,27,7,0,147
Iraq,11/02/2011,77,2,3,0,32,8,0,122
Iraq,12/02/2011,86,0,0,0,10,38,0,134
Iraq,13/02/2011,57,0,0,0,-4,28,0,81
Iraq,14/02/2011,39,0,-5,0,-9,3,0,28
Iraq,15/02/2011,94,0,-10,0,35,25,0,144
Iraq,16/02/2011,129,0,-1,0,16,53,0,197
Iraq,17/02/2011,180,0,-8,0,20,21,0,213
Iraq,18/02/2011,11,0,0,0,0,1,0,12
Iraq,19/02/2011,88,2,0,0,18,13,0,121
Iraq,20/02/2011,76,4,-1,0,-2,13,0,90
Iraq,21/02/2011,95,0,0,0,-7,20,0,108
Iraq,22/02/2011,192,10,0,0,31,32,0,265
Iraq,23/02/2011,157,2,3,0,84,23,0,269
Iraq,24/02/2011,130,0,4,0,65,32,0,231
Iraq,25/02/2011,125,0,1,0,71,28,0,225
Iraq,26/02/2011,105,0,-3,0,27,19,0,148
Iraq,27/02/2011,83,0,-5,0,15,18,0,111
Iraq,28/02/2011,152,0,2,0,77,27,0,258
Morocco,01/02/2011,4,0,1,0,3,2,0,10
Morocco,02/02/2011,7,0,-2,0,21,6,0,32
Morocco,03/02/2011,10,0,0,0,1,2,0,13
Morocco,04/02/2011,10,0,0,0,6,2,0,18
Morocco,05/02/2011,0,0,0,0,0,2,0,2
Morocco,06/02/2011,12,0,0,0,3,0,0,15
Morocco,07/02/2011,-1,0,-10,0,0,0,0,-11
Morocco,08/02/2011,-1,0,0,0,12,2,0,13
Morocco,09/02/2011,13,0,-4,0,15,2,0,26
Morocco,10/02/2011,9,0,-4,0,15,0,0,20
Morocco,11/02/2011,12,0,-4,0,7,3,0,18
Morocco,12/02/2011,14,0,0,0,6,1,0,21
Morocco,13/02/2011,7,0,0,0,0,6,0,13
Morocco,14/02/2011,-3,0,0,0,-2,3,0,-2
Morocco,15/02/2011,9,0,0,0,59,3,0,71
Morocco,16/02/2011,22,0,0,0,30,3,0,55
Morocco,17/02/2011,4,4,0,0,8,2,0,18
Morocco,18/02/2011,0,0,0,0,0,1,0,1
Morocco,19/02/2011,43,0,-4,0,12,12,0,63
Morocco,20/02/2011,42,0,0,0,12,20,0,74
Morocco,21/02/2011,54,0,-2,0,-6,21,0,67
Morocco,22/02/2011,15,4,1,0,9,8,0,37
Morocco,23/02/2011,25,4,0,0,23,9,0,61
Morocco,24/02/2011,11,0,0,0,21,10,0,42
Morocco,25/02/2011,5,0,0,0,6,3,0,14
Morocco,26/02/2011,-5,0,0,0,0,7,0,2
Morocco,27/02/2011,8,0,0,0,0,9,0,17
Morocco,28/02/2011,8,0,0,0,4,3,0,15
Nigeria,01/02/2011,24,0,1,0,18,6,0,49
Nigeria,02/02/2011,18,0,2,0,32,2,0,54
Nigeria,03/02/2011,18,0,-2,0,9,2,0,27
Nigeria,04/02/2011,54,2,-6,0,7,9,0,66
Nigeria,05/02/2011,10,2,-3,0,16,2,0,27
Nigeria,06/02/2011,10,0,0,0,3,1,0,14
Nigeria,07/02/2011,27,0,-4,0,22,7,0,52
Nigeria,08/02/2011,21,0,0,0,55,8,0,84
Nigeria,09/02/2011,39,0,1,0,19,2,0,61
Nigeria,10/02/2011,17,0,1,0,1,2,0,21
Nigeria,11/02/2011,25,0,0,0,18,4,0,47
Nigeria,12/02/2011,25,0,2,0,6,7,0,40
Nigeria,13/02/2011,16,0,0,0,-6,1,0,11
Nigeria,14/02/2011,21,2,1,0,33,16,0,73
Nigeria,15/02/2011,56,8,0,0,11,1,0,76
Nigeria,16/02/2011,89,0,0,0,22,6,0,117
Nigeria,17/02/2011,33,0,0,0,-9,2,0,26
Nigeria,18/02/2011,0,0,0,0,0,0,0,0
Nigeria,19/02/2011,32,0,-3,0,7,4,0,40
Nigeria,20/02/2011,19,0,0,0,6,0,0,25
Nigeria,21/02/2011,14,0,-2,0,5,9,0,26
Nigeria,22/02/2011,150,2,1,0,8,6,0,167
Nigeria,23/02/2011,49,0,-2,0,4,2,0,53
Nigeria,24/02/2011,76,0,4,0,21,8,0,109
Nigeria,25/02/2011,27,0,0,0,21,6,0,54
Nigeria,26/02/2011,9,0,0,0,27,5,0,41
Nigeria,27/02/2011,19,0,0,0,24,2,0,45
Nigeria,28/02/2011,23,2,2,0,11,6,0,44
Pakistan,01/02/2011,64,0,3,0,23,10,0,100
Pakistan,02/02/2011,88,0,0,0,28,10,0,126
Pakistan,03/02/2011,97,2,-2,0,13,16,0,126
Pakistan,04/02/2011,109,8,-3,0,70,5,0,189
Pakistan,05/02/2011,45,2,0,0,-7,4,0,44
Pakistan,06/02/2011,58,0,0,0,23,23,0,104
Pakistan,07/02/2011,110,0,0,0,56,15,0,181
Pakistan,08/02/2011,146,2,0,0,52,5,0,205
Pakistan,09/02/2011,74,6,-25,0,23,4,0,82
Pakistan,10/02/2011,105,2,-8,0,5,43,0,147
Pakistan,11/02/2011,97,0,-9,0,75,13,0,176
Pakistan,12/02/2011,84,0,0,0,71,9,0,164
Pakistan,13/02/2011,51,0,-1,0,29,7,0,86
Pakistan,14/02/2011,111,0,-8,0,20,12,0,135
Pakistan,15/02/2011,154,0,-5,0,41,14,0,204
Pakistan,16/02/2011,170,16,0,0,55,20,0,261
Pakistan,17/02/2011,55,0,1,0,35,12,0,103
Pakistan,18/02/2011,7,0,0,0,6,0,0,13
Pakistan,19/02/2011,99,0,-2,0,22,9,0,128
Pakistan,20/02/2011,137,2,0,0,32,14,0,185
Pakistan,21/02/2011,220,2,16,0,57,35,0,330
Pakistan,22/02/2011,56,0,0,0,26,8,0,90
Pakistan,23/02/2011,77,0,1,0,35,6,0,119
Pakistan,24/02/2011,59,0,0,0,48,10,0,117
Pakistan,25/02/2011,64,4,0,0,60,8,0,136
Pakistan,26/02/2011,35,0,0,0,21,7,0,63
Pakistan,27/02/2011,57,0,-2,0,18,0,0,73
Pakistan,28/02/2011,104,0,1,0,70,3,0,178
Sierra Leone,01/02/2011,0,0,0,0,0,0,0,0
Sierra Leone,02/02/2011,-2,0,0,0,3,0,0,1
Sierra Leone,03/02/2011,1,0,0,0,3,0,0,4
Sierra Leone,04/02/2011,2,0,0,0,3,0,0,5
Sierra Leone,05/02/2011,3,0,0,0,0,0,0,3
Sierra Leone,06/02/2011,0,0,0,0,0,1,0,1
Sierra Leone,07/02/2011,3,0,1,0,0,0,0,4
Sierra Leone,08/02/2011,67,0,2,0,15,1,0,85
Sierra Leone,09/02/2011,44,0,4,0,4,3,0,55
Sierra Leone,10/02/2011,8,0,0,0,3,0,0,11
Sierra Leone,11/02/2011,15,0,1,0,12,3,0,31
Sierra Leone,12/02/2011,8,0,0,0,3,0,0,11
Sierra Leone,13/02/2011,8,0,0,0,0,0,0,8
Sierra Leone,14/02/2011,17,0,0,0,3,0,0,20
Sierra Leone,15/02/2011,11,0,0,0,6,0,0,17
Sierra Leone,16/02/2011,1,0,0,0,0,0,0,1
Sierra Leone,17/02/2011,6,0,0,0,0,0,0,6
Sierra Leone,19/02/2011,14,0,0,0,3,2,0,19
Sierra Leone,20/02/2011,0,0,0,0,0,0,0,0
Sierra Leone,21/02/2011,5,0,-2,0,0,3,0,6
Sierra Leone,22/02/2011,2,0,0,0,0,3,0,5
Sierra Leone,23/02/2011,5,0,0,0,-2,0,0,3
Sierra Leone,24/02/2011,-1,0,3,0,4,1,0,7
Sierra Leone,25/02/2011,9,0,0,0,0,0,0,9
Sierra Leone,26/02/2011,1,0,0,0,0,0,0,1
Sierra Leone,27/02/2011,0,0,0,0,-4,0,0,-4
Sierra Leone,28/02/2011,18,0,0,0,0,0,0,18
Somalia,01/02/2011,96,0,0,0,34,11,0,141
Somalia,02/02/2011,58,0,1,0,42,7,0,108
Somalia,03/02/2011,81,0,0,0,104,25,0,210
Somalia,04/02/2011,83,0,-2,0,64,12,0,157
Somalia,05/02/2011,40,0,0,0,18,3,0,61
Somalia,06/02/2011,72,0,0,0,60,13,0,145
Somalia,07/02/2011,59,0,0,0,72,5,0,136
Somalia,08/02/2011,62,2,-2,0,23,8,0,93
Somalia,09/02/2011,121,2,1,0,-16,18,0,126
Somalia,10/02/2011,65,0,0,0,-6,8,0,67
Somalia,11/02/2011,82,0,1,0,136,6,0,225
Somalia,12/02/2011,25,0,0,0,14,8,0,47
Somalia,13/02/2011,88,0,-6,0,16,6,0,104
Somalia,14/02/2011,44,0,-2,0,25,4,0,71
Somalia,15/02/2011,73,0,0,0,39,5,0,117
Somalia,16/02/2011,147,0,-16,0,272,21,0,424
Somalia,17/02/2011,57,0,-2,0,103,38,0,196
Somalia,18/02/2011,0,0,0,0,24,0,0,24
Somalia,19/02/2011,100,0,0,0,143,24,0,267
Somalia,20/02/2011,69,0,0,0,72,6,0,147
Somalia,21/02/2011,62,0,1,0,28,6,0,97
Somalia,22/02/2011,294,0,0,0,108,16,0,418
Somalia,23/02/2011,393,4,0,0,121,40,0,558
Somalia,24/02/2011,1615,12,-8,0,306,104,0,2029
Somalia,25/02/2011,92,0,0,0,54,5,0,151
Somalia,26/02/2011,69,0,0,0,49,3,0,121
Somalia,27/02/2011,48,0,0,0,32,15,0,95
Somalia,28/02/2011,155,0,0,0,45,12,0,212
Syria,01/02/2011,62,0,-2,0,21,17,0,98
Syria,02/02/2011,45,0,-6,0,23,21,0,83
Syria,03/02/2011,34,0,-7,0,33,6,0,66
Syria,04/02/2011,23,0,-4,0,8,20,0,47
Syria,05/02/2011,12,0,0,0,6,4,0,22
Syria,06/02/2011,26,0,0,0,1,4,0,31
Syria,07/02/2011,22,0,0,0,0,1,0,23
Syria,08/02/2011,8,0,0,0,3,0,0,11
Syria,09/02/2011,13,0,0,0,13,4,0,30
Syria,10/02/2011,20,0,-4,0,27,2,0,45
Syria,11/02/2011,22,0,0,0,12,1,0,35
Syria,12/02/2011,27,0,0,0,9,3,0,39
Syria,13/02/2011,26,0,-2,0,8,2,0,34
Syria,14/02/2011,34,0,-2,0,28,0,0,60
Syria,15/02/2011,-3,0,-2,0,45,8,0,48
Syria,16/02/2011,45,0,0,0,45,3,0,93
Syria,17/02/2011,25,0,0,0,15,0,0,40
Syria,18/02/2011,0,0,0,0,0,1,0,1
Syria,19/02/2011,17,0,0,0,12,23,0,52
Syria,20/02/2011,18,0,-2,0,3,8,0,27
Syria,21/02/2011,18,0,0,0,6,8,0,32
Syria,22/02/2011,40,0,0,0,5,1,0,46
Syria,23/02/2011,14,0,0,0,10,2,0,26
Syria,24/02/2011,7,0,0,0,11,9,0,27
Syria,25/02/2011,35,0,2,0,8,7,0,52
Syria,26/02/2011,11,0,4,0,11,9,0,35
Syria,27/02/2011,17,0,-2,0,11,12,0,38
Syria,28/02/2011,18,0,0,0,5,5,0,28
Yemen,01/02/2011,53,0,-1,0,7,16,0,75
Yemen,02/02/2011,65,0,-15,0,32,27,0,109
Yemen,03/02/2011,84,0,-20,0,23,19,0,106
Yemen,04/02/2011,37,0,-6,0,3,16,0,50
Yemen,05/02/2011,16,0,-8,0,9,13,0,30
Yemen,06/02/2011,46,0,-2,0,5,10,0,59
Yemen,07/02/2011,31,0,-12,0,12,3,0,34
Yemen,08/02/2011,4,0,0,0,3,1,0,8
Yemen,09/02/2011,32,0,0,0,8,7,0,47
Yemen,10/02/2011,26,0,-2,0,0,10,0,34
Yemen,11/02/2011,19,0,0,0,6,5,0,30
Yemen,12/02/2011,37,0,0,0,7,12,0,56
Yemen,13/02/2011,89,0,-5,0,5,8,0,97
Yemen,14/02/2011,85,0,-11,0,28,20,0,122
Yemen,15/02/2011,192,0,-12,0,-1,30,0,209
Yemen,16/02/2011,159,0,1,0,33,26,0,219
Yemen,17/02/2011,122,2,2,0,35,22,0,183
Yemen,18/02/2011,29,0,0,0,18,9,0,56
Yemen,19/02/2011,159,0,-1,0,52,51,0,261
Yemen,20/02/2011,96,0,-4,0,54,50,0,196
Yemen,21/02/2011,84,2,-1,0,25,53,0,163
Yemen,22/02/2011,73,0,-11,0,47,25,0,134
Yemen,23/02/2011,39,2,-9,0,37,22,0,91
Yemen,24/02/2011,39,0,-6,0,7,14,0,54
Yemen,25/02/2011,48,0,-8,0,0,17,0,57
Yemen,26/02/2011,45,0,-6,0,3,4,0,46
Yemen,27/02/2011,10,0,-8,0,-2,25,0,25
Yemen,28/02/2011,97,0,-14,0,58,23,0,164
Afghanistan,01/03/2008,142,2,2,0,21,2,0,169
Afghanistan,02/03/2008,165,6,1,0,31,20,0,223
Afghanistan,03/03/2008,130,2,1,0,7,11,0,151
Afghanistan,04/03/2008,121,4,0,0,21,25,0,171
Afghanistan,05/03/2008,90,2,0,0,49,17,0,158
Afghanistan,06/03/2008,154,2,0,0,69,23,0,248
Afghanistan,07/03/2008,132,0,0,0,33,6,0,171
Afghanistan,08/03/2008,45,0,-4,0,10,15,0,66
Afghanistan,09/03/2008,36,0,-1,0,5,1,0,41
Afghanistan,10/03/2008,73,0,0,0,10,10,0,93
Afghanistan,11/03/2008,125,0,-4,0,9,59,0,189
Afghanistan,12/03/2008,237,0,-15,0,47,116,0,385
Afghanistan,13/03/2008,78,0,0,0,15,9,0,102
Afghanistan,14/03/2008,106,0,-2,0,81,7,0,192
Afghanistan,15/03/2008,51,0,0,0,45,14,0,110
Afghanistan,16/03/2008,141,0,0,0,44,11,0,196
Afghanistan,17/03/2008,132,0,1,0,13,57,0,203
Afghanistan,18/03/2008,134,2,0,0,-1,23,0,158
Afghanistan,19/03/2008,59,0,0,0,11,4,0,74
Afghanistan,20/03/2008,74,0,0,0,3,19,0,96
Afghanistan,21/03/2008,119,0,0,0,23,10,0,152
Afghanistan,22/03/2008,24,0,1,0,6,3,0,34
Afghanistan,23/03/2008,37,0,0,0,25,3,0,65
Afghanistan,24/03/2008,73,0,-1,0,28,7,0,107
Afghanistan,25/03/2008,102,6,0,0,77,5,0,190
Afghanistan,26/03/2008,55,0,0,0,7,3,0,65
Afghanistan,27/03/2008,120,0,1,0,25,11,0,157
Afghanistan,28/03/2008,208,0,0,0,9,7,0,224
Afghanistan,29/03/2008,139,4,-4,0,10,11,0,160
Afghanistan,30/03/2008,66,0,-1,0,38,12,0,115
Afghanistan,31/03/2008,77,2,1,0,55,10,0,145
Albania,01/03/2008,4,0,-2,0,0,0,0,2
Albania,02/03/2008,9,2,0,0,0,0,0,11
Albania,03/03/2008,26,0,0,0,0,0,0,26
Albania,04/03/2008,38,0,2,0,9,0,0,49
Albania,05/03/2008,8,0,0,0,3,2,0,13
Albania,06/03/2008,23,0,0,0,39,0,0,62
Albania,07/03/2008,23,0,-2,0,14,0,0,35
Albania,08/03/2008,47,0,-1,0,54,3,0,103
Albania,09/03/2008,6,0,0,0,0,0,0,6
Albania,10/03/2008,34,0,1,0,48,0,0,83
Albania,11/03/2008,24,0,0,0,4,0,0,28
Albania,12/03/2008,2,0,0,0,0,2,0,4
Albania,13/03/2008,6,0,-1,0,18,0,0,23
Albania,14/03/2008,34,0,0,0,18,-3,0,49
Albania,15/03/2008,18,0,0,0,0,0,0,18
Albania,16/03/2008,2,0,0,0,0,1,0,3
Albania,17/03/2008,84,0,-15,0,53,5,0,127
Albania,18/03/2008,72,0,-19,0,32,11,0,96
Albania,19/03/2008,43,0,-1,0,22,0,0,64
Albania,20/03/2008,27,0,0,0,-10,2,0,19
Albania,21/03/2008,35,0,0,0,2,0,0,37
Albania,22/03/2008,0,0,-1,0,0,0,0,-1
Albania,23/03/2008,5,0,0,0,0,0,0,5
Albania,24/03/2008,24,0,-1,0,-5,0,0,18
Albania,25/03/2008,7,0,-1,0,7,1,0,14
Albania,26/03/2008,0,0,-1,0,12,6,0,17
Albania,27/03/2008,6,0,-3,0,6,0,0,9
Albania,28/03/2008,17,0,0,0,6,0,0,23
Albania,29/03/2008,7,0,0,0,0,0,0,7
Albania,30/03/2008,17,0,0,0,0,5,0,22
Albania,31/03/2008,0,0,-2,0,3,1,0,2
Algeria,01/03/2008,0,0,0,0,0,0,0,0
Algeria,02/03/2008,-1,0,0,0,-1,1,0,-1
Algeria,03/03/2008,0,0,0,0,2,0,0,2
Algeria,04/03/2008,6,0,0,0,0,0,0,6
Algeria,05/03/2008,7,0,0,0,3,0,0,10
Algeria,06/03/2008,2,0,0,0,0,0,0,2
Algeria,07/03/2008,6,0,0,0,-1,0,0,5
Algeria,08/03/2008,0,0,-2,0,-4,0,0,-6
Algeria,09/03/2008,2,0,0,0,6,0,0,8
Algeria,10/03/2008,10,0,0,0,12,3,0,25
Algeria,11/03/2008,12,0,0,0,4,0,0,16
Algeria,12/03/2008,-2,0,2,0,9,0,0,9
Algeria,13/03/2008,9,0,2,0,4,0,0,15
Algeria,14/03/2008,13,0,0,0,31,0,0,44
Algeria,15/03/2008,2,0,0,0,22,0,0,24
Algeria,16/03/2008,9,0,0,0,34,0,0,43
Algeria,17/03/2008,16,2,0,0,48,0,0,66
Algeria,18/03/2008,0,2,0,0,34,0,0,36
Algeria,19/03/2008,2,0,0,0,6,0,0,8
Algeria,20/03/2008,6,0,0,0,3,0,0,9
Algeria,21/03/2008,-3,0,-2,0,9,0,0,4
Algeria,22/03/2008,6,0,0,0,35,0,0,41
Algeria,23/03/2008,9,0,0,0,14,2,0,25
Algeria,24/03/2008,2,0,0,0,43,0,0,45
Algeria,25/03/2008,0,0,0,0,17,0,0,17
Algeria,26/03/2008,0,0,0,0,-16,0,0,-16
Algeria,27/03/2008,0,4,0,0,6,1,0,11
Algeria,28/03/2008,5,0,0,0,6,0,0,11
Algeria,29/03/2008,0,0,0,0,0,0,0,0
Algeria,30/03/2008,0,0,0,0,0,0,0,0
Algeria,31/03/2008,1,0,0,0,7,0,0,8
Bangladesh,01/03/2008,0,0,0,0,0,0,0,0
Bangladesh,02/03/2008,0,0,0,0,0,0,0,0
Bangladesh,03/03/2008,8,4,0,0,6,3,0,21
Bangladesh,04/03/2008,2,0,-2,0,3,0,0,3
Bangladesh,05/03/2008,0,0,-8,0,3,7,0,2
Bangladesh,06/03/2008,3,0,0,0,20,0,0,23
Bangladesh,07/03/2008,19,0,-2,0,15,0,0,32
Bangladesh,08/03/2008,3,4,0,0,3,1,0,11
Bangladesh,09/03/2008,6,0,0,0,0,0,0,6
Bangladesh,10/03/2008,2,0,0,0,0,0,0,2
Bangladesh,11/03/2008,41,0,-2,0,14,4,0,57
Bangladesh,12/03/2008,20,0,0,0,12,1,0,33
Bangladesh,13/03/2008,2,0,0,0,6,0,0,8
Bangladesh,14/03/2008,5,0,-2,0,3,0,0,6
Bangladesh,15/03/2008,6,0,0,0,0,0,0,6
Bangladesh,16/03/2008,0,0,0,0,-4,0,0,-4
Bangladesh,17/03/2008,6,0,-2,0,3,0,0,7
Bangladesh,18/03/2008,14,0,0,0,15,0,0,29
Bangladesh,19/03/2008,8,0,0,0,8,0,0,16
Bangladesh,20/03/2008,8,0,-2,0,3,3,0,12
Bangladesh,21/03/2008,5,0,0,0,4,3,0,12
Bangladesh,22/03/2008,14,0,0,0,0,2,0,16
Bangladesh,23/03/2008,17,0,0,0,3,4,0,24
Bangladesh,24/03/2008,6,0,-1,0,16,1,0,22
Bangladesh,25/03/2008,0,0,0,0,6,2,0,8
Bangladesh,26/03/2008,11,0,0,0,-2,2,0,11
Bangladesh,27/03/2008,6,0,0,0,0,0,0,6
Bangladesh,28/03/2008,4,0,0,0,0,0,0,4
Bangladesh,29/03/2008,19,0,0,0,0,12,0,31
Bangladesh,30/03/2008,8,0,0,0,1,4,0,13
Bangladesh,31/03/2008,20,0,-2,0,9,2,0,29
Cameroon,01/03/2008,0,0,0,0,0,3,0,3
Cameroon,02/03/2008,2,0,0,0,0,3,0,5
Cameroon,03/03/2008,3,0,0,0,3,2,0,8
Cameroon,04/03/2008,6,0,0,0,6,2,0,14
Cameroon,05/03/2008,1,0,0,0,6,0,0,7
Cameroon,06/03/2008,8,0,0,0,0,4,0,12
Cameroon,07/03/2008,3,4,0,0,0,0,0,7
Cameroon,10/03/2008,-1,0,0,0,0,0,0,-1
Cameroon,11/03/2008,1,0,0,0,3,0,0,4
Cameroon,12/03/2008,3,0,0,0,3,0,0,6
Cameroon,13/03/2008,0,0,0,0,0,2,0,2
Cameroon,14/03/2008,3,0,0,0,0,0,0,3
Cameroon,15/03/2008,3,0,0,0,0,0,0,3
Cameroon,16/03/2008,0,0,0,0,0,2,0,2
Cameroon,17/03/2008,0,0,0,0,0,0,0,0
Cameroon,18/03/2008,0,0,0,0,0,0,0,0
Cameroon,21/03/2008,0,0,0,0,3,2,0,5
Cameroon,22/03/2008,0,0,0,0,0,0,0,0
Cameroon,24/03/2008,0,0,0,0,0,0,0,0
Cameroon,25/03/2008,3,0,0,0,0,2,0,5
Cameroon,26/03/2008,3,0,0,0,0,0,0,3
Cameroon,28/03/2008,0,0,0,0,0,0,0,0
Cameroon,30/03/2008,0,0,0,0,0,0,0,0
Cameroon,31/03/2008,3,0,0,0,0,0,0,3
China,01/03/2008,34,4,4,0,42,10,0,94
China,02/03/2008,28,0,0,0,2,14,0,44
China,03/03/2008,96,0,-8,0,53,2,0,143
China,04/03/2008,83,4,-2,0,25,12,0,122
China,05/03/2008,104,0,-3,0,47,13,0,161
China,06/03/2008,124,0,3,0,29,19,0,175
China,07/03/2008,74,2,0,0,6,11,0,93
China,08/03/2008,47,0,0,0,18,8,0,73
China,09/03/2008,29,0,2,0,0,5,0,36
China,10/03/2008,38,4,-2,0,36,16,0,92
China,11/03/2008,13,0,-2,0,22,8,0,41
China,12/03/2008,71,0,-3,0,55,9,0,132
China,13/03/2008,79,0,0,0,37,13,0,129
China,14/03/2008,166,0,2,0,59,40,0,267
China,15/03/2008,118,0,4,0,53,30,0,205
China,16/03/2008,148,2,2,0,35,24,0,211
China,17/03/2008,66,0,-2,0,49,18,0,131
China,18/03/2008,145,0,-16,0,59,51,0,239
China,19/03/2008,59,0,-12,0,5,12,0,64
China,20/03/2008,139,0,0,0,16,18,0,173
China,21/03/2008,111,0,-6,0,74,35,0,214
China,22/03/2008,53,0,-1,0,24,17,0,93
China,23/03/2008,81,0,-9,0,14,8,0,94
China,24/03/2008,121,0,0,0,62,31,0,214
China,25/03/2008,78,0,-11,0,44,25,0,136
China,26/03/2008,42,0,-5,0,21,4,0,62
China,27/03/2008,61,2,0,0,5,14,0,82
China,28/03/2008,60,0,1,0,36,9,0,106
China,29/03/2008,25,6,-2,0,45,13,0,87
China,30/03/2008,52,2,-4,0,21,8,0,79
China,31/03/2008,45,0,-4,0,13,10,0,64
Egypt,01/03/2008,16,2,0,0,7,0,0,25
Egypt,02/03/2008,34,0,2,0,0,1,0,37
Egypt,03/03/2008,65,0,1,0,-1,9,0,74
Egypt,04/03/2008,32,0,1,0,21,0,0,54
Egypt,05/03/2008,20,0,0,0,7,2,0,29
Egypt,06/03/2008,31,0,1,0,21,9,0,62
Egypt,07/03/2008,20,0,1,0,1,5,0,27
Egypt,08/03/2008,24,0,1,0,0,0,0,25
Egypt,09/03/2008,54,0,0,0,0,3,0,57
Egypt,10/03/2008,49,0,0,0,6,0,0,55
Egypt,11/03/2008,114,0,-2,0,-12,6,0,106
Egypt,12/03/2008,49,0,0,0,-9,2,0,42
Egypt,13/03/2008,23,0,0,0,9,2,0,34
Egypt,14/03/2008,14,0,0,0,3,1,0,18
Egypt,15/03/2008,9,0,0,0,19,2,0,30
Egypt,16/03/2008,6,0,0,0,6,4,0,16
Egypt,17/03/2008,18,0,0,0,-4,0,0,14
Egypt,18/03/2008,68,0,0,0,10,0,0,78
Egypt,19/03/2008,3,0,0,0,3,1,0,7
Egypt,20/03/2008,2,0,0,0,0,1,0,3
Egypt,21/03/2008,21,0,0,0,4,5,0,30
Egypt,22/03/2008,7,0,0,0,0,0,0,7
Egypt,23/03/2008,42,0,3,0,1,5,0,51
Egypt,24/03/2008,27,0,0,0,-5,5,0,27
Egypt,25/03/2008,21,2,1,0,15,2,0,41
Egypt,26/03/2008,56,0,0,0,34,4,0,94
Egypt,27/03/2008,57,0,0,0,18,4,0,79
Egypt,28/03/2008,51,0,1,0,35,0,0,87
Egypt,29/03/2008,8,0,0,0,9,0,0,17
Egypt,30/03/2008,-1,0,0,0,37,4,0,40
Egypt,31/03/2008,26,0,0,0,-19,1,0,8
Eritrea,01/03/2008,3,0,0,0,12,0,0,15
Eritrea,02/03/2008,0,0,0,0,0,0,0,0
Eritrea,03/03/2008,10,0,0,0,0,0,0,10
Eritrea,04/03/2008,0,0,0,0,0,0,0,0
Eritrea,05/03/2008,0,0,0,0,0,0,0,0
Eritrea,06/03/2008,3,0,0,0,0,0,0,3
Eritrea,07/03/2008,1,0,0,0,0,0,0,1
Eritrea,08/03/2008,24,2,1,0,33,0,0,60
Eritrea,10/03/2008,45,0,0,0,30,0,0,75
Eritrea,11/03/2008,-6,0,0,0,0,4,0,-2
Eritrea,12/03/2008,9,0,0,0,0,0,0,9
Eritrea,13/03/2008,7,0,0,0,0,0,0,7
Eritrea,14/03/2008,20,0,0,0,3,0,0,23
Eritrea,15/03/2008,0,0,0,0,0,0,0,0
Eritrea,17/03/2008,0,0,0,0,6,0,0,6
Eritrea,18/03/2008,3,0,0,0,3,0,0,6
Eritrea,20/03/2008,2,0,0,0,-8,0,0,-6
Eritrea,21/03/2008,-7,0,0,0,0,0,0,-7
Eritrea,22/03/2008,-9,0,0,0,0,0,0,-9
Eritrea,23/03/2008,16,0,0,0,15,0,0,31
Eritrea,24/03/2008,17,0,0,0,0,0,0,17
Eritrea,25/03/2008,0,0,0,0,6,0,0,6
Eritrea,26/03/2008,0,0,0,0,0,0,0,0
Eritrea,30/03/2008,8,0,0,0,3,4,0,15
Eritrea,31/03/2008,3,0,0,0,0,0,0,3
Georgia,01/03/2008,25,0,0,0,-4,2,0,23
Georgia,02/03/2008,3,0,0,0,0,0,0,3
Georgia,03/03/2008,7,0,0,0,3,2,0,12
Georgia,04/03/2008,11,0,0,0,3,2,0,16
Georgia,05/03/2008,7,2,0,0,0,2,0,11
Georgia,06/03/2008,29,0,0,0,0,2,0,31
Georgia,07/03/2008,43,2,-1,0,4,4,0,52
Georgia,08/03/2008,8,0,0,0,18,0,0,26
Georgia,09/03/2008,-3,0,0,0,-2,0,0,-5
Georgia,10/03/2008,0,0,0,0,0,1,0,1
Georgia,11/03/2008,2,0,-1,0,2,0,0,3
Georgia,12/03/2008,2,0,0,0,4,0,0,6
Georgia,13/03/2008,4,0,0,0,13,3,0,20
Georgia,14/03/2008,17,0,-2,0,9,0,0,24
Georgia,15/03/2008,4,0,0,0,6,1,0,11
Georgia,16/03/2008,3,0,0,0,6,0,0,9
Georgia,17/03/2008,2,0,0,0,3,0,0,5
Georgia,18/03/2008,11,0,0,0,3,4,0,18
Georgia,19/03/2008,0,0,0,0,0,0,0,0
Georgia,20/03/2008,6,0,0,0,0,0,0,6
Georgia,21/03/2008,9,0,0,0,0,0,0,9
Georgia,22/03/2008,3,0,0,0,3,0,0,6
Georgia,23/03/2008,1,0,0,0,0,2,0,3
Georgia,24/03/2008,21,0,0,0,15,2,0,38
Georgia,25/03/2008,9,0,0,0,8,2,0,19
Georgia,26/03/2008,26,0,0,0,-6,2,0,22
Georgia,27/03/2008,14,0,0,0,6,2,0,22
Georgia,28/03/2008,55,0,0,0,0,2,0,57
Georgia,29/03/2008,21,0,0,0,6,0,0,27
Georgia,30/03/2008,6,0,0,0,-6,1,0,1
Georgia,31/03/2008,5,0,0,0,-2,0,0,3
India,01/03/2008,13,0,0,0,-3,2,0,12
India,02/03/2008,23,0,0,0,7,5,0,35
India,03/03/2008,7,2,0,0,34,1,0,44
India,04/03/2008,25,4,0,0,36,9,0,74
India,05/03/2008,41,2,0,0,4,1,0,48
India,06/03/2008,28,4,0,0,5,5,0,42
India,07/03/2008,25,0,0,0,6,2,0,33
India,08/03/2008,11,2,0,0,-3,13,0,23
India,09/03/2008,10,0,0,0,-4,1,0,7
India,10/03/2008,30,0,0,0,13,13,0,56
India,11/03/2008,17,0,0,0,9,11,0,37
India,12/03/2008,22,0,-2,0,18,4,0,42
India,13/03/2008,5,0,0,0,-3,3,0,5
India,14/03/2008,72,0,-3,0,65,22,0,156
India,15/03/2008,39,0,0,0,37,3,0,79
India,16/03/2008,41,0,2,0,22,5,0,70
India,17/03/2008,38,0,0,0,16,3,0,57
India,18/03/2008,108,0,-6,0,7,11,0,120
India,19/03/2008,27,0,0,0,3,4,0,34
India,20/03/2008,33,0,0,0,35,4,0,72
India,21/03/2008,51,0,-4,0,10,3,0,60
India,22/03/2008,20,0,0,0,18,0,0,38
India,23/03/2008,37,0,0,0,11,5,0,53
India,24/03/2008,66,0,4,0,22,10,0,102
India,25/03/2008,41,0,1,0,9,9,0,60
India,26/03/2008,24,2,1,0,-1,7,0,33
India,27/03/2008,22,0,-4,0,10,6,0,34
India,28/03/2008,26,0,0,0,29,14,0,69
India,29/03/2008,34,0,0,0,13,7,0,54
India,30/03/2008,79,2,0,0,13,9,0,103
India,31/03/2008,19,0,0,0,15,1,0,35
Iran,01/03/2008,64,2,0,0,27,8,0,101
Iran,02/03/2008,119,0,0,0,20,21,0,160
Iran,03/03/2008,117,0,1,0,42,11,0,171
Iran,04/03/2008,98,0,2,0,29,9,0,138
Iran,05/03/2008,46,2,1,0,7,4,0,60
Iran,06/03/2008,51,0,1,0,17,16,0,85
Iran,07/03/2008,53,0,-3,0,10,3,0,63
Iran,08/03/2008,34,0,0,0,12,2,0,48
Iran,09/03/2008,22,0,0,0,34,6,0,62
Iran,10/03/2008,40,0,0,0,24,3,0,67
Iran,11/03/2008,67,0,-14,0,69,4,0,126
Iran,12/03/2008,96,0,-12,0,13,10,0,107
Iran,13/03/2008,27,0,0,0,37,3,0,67
Iran,14/03/2008,141,0,6,0,49,17,0,213
Iran,15/03/2008,24,0,2,0,-1,13,0,38
Iran,16/03/2008,52,0,1,0,9,13,0,75
Iran,17/03/2008,54,0,0,0,13,8,0,75
Iran,18/03/2008,83,0,0,0,6,9,0,98
Iran,19/03/2008,33,0,0,0,6,2,0,41
Iran,20/03/2008,25,0,0,0,36,1,0,62
Iran,21/03/2008,30,0,-2,0,6,2,0,36
Iran,22/03/2008,30,0,1,0,3,2,0,36
Iran,23/03/2008,82,0,3,0,7,4,0,96
Iran,24/03/2008,26,0,-2,0,6,3,0,33
Iran,25/03/2008,115,0,-2,0,9,5,0,127
Iran,26/03/2008,67,2,-2,0,34,6,0,107
Iran,27/03/2008,43,0,-1,0,10,3,0,55
Iran,28/03/2008,58,0,0,0,28,0,0,86
Iran,29/03/2008,93,0,-1,0,16,18,0,126
Iran,30/03/2008,71,0,-2,0,21,5,0,95
Iran,31/03/2008,21,0,0,0,10,6,0,37
Iraq,01/03/2008,71,0,1,0,24,10,0,106
Iraq,02/03/2008,180,0,-4,0,22,14,0,212
Iraq,03/03/2008,149,0,-3,0,38,29,0,213
Iraq,04/03/2008,141,0,-5,0,21,20,0,177
Iraq,05/03/2008,149,0,1,0,9,6,0,165
Iraq,06/03/2008,129,4,0,0,28,27,0,188
Iraq,07/03/2008,102,6,-1,0,33,15,0,155
Iraq,08/03/2008,55,6,-4,0,41,26,0,124
Iraq,09/03/2008,65,2,0,0,13,8,0,88
Iraq,10/03/2008,99,0,0,0,25,9,0,133
Iraq,11/03/2008,158,2,2,0,9,23,0,194
Iraq,12/03/2008,143,0,-10,0,-9,3,0,127
Iraq,13/03/2008,39,0,-4,0,48,3,0,86
Iraq,14/03/2008,145,2,-5,0,55,13,0,210
Iraq,15/03/2008,57,0,0,0,43,15,0,115
Iraq,16/03/2008,135,2,-4,0,43,26,0,202
Iraq,17/03/2008,153,2,-2,0,25,18,0,196
Iraq,18/03/2008,136,12,2,0,19,22,0,191
Iraq,19/03/2008,84,4,-1,0,-4,12,0,95
Iraq,20/03/2008,201,2,1,0,51,17,0,272
Iraq,21/03/2008,73,2,0,0,26,12,0,113
Iraq,22/03/2008,64,2,1,0,14,6,0,87
Iraq,23/03/2008,122,0,0,0,16,20,0,158
Iraq,24/03/2008,55,0,2,0,45,11,0,113
Iraq,25/03/2008,141,10,2,0,83,8,0,244
Iraq,26/03/2008,172,0,0,0,53,8,0,233
Iraq,27/03/2008,128,6,9,0,50,17,0,210
Iraq,28/03/2008,193,4,5,0,41,22,0,265
Iraq,29/03/2008,182,0,0,0,60,10,0,252
Iraq,30/03/2008,140,4,-2,0,5,8,0,155
Iraq,31/03/2008,55,0,-2,0,15,19,0,87
Morocco,01/03/2008,4,0,0,0,3,0,0,7
Morocco,02/03/2008,10,0,0,0,0,0,0,10
Morocco,03/03/2008,6,0,0,0,-3,2,0,5
Morocco,04/03/2008,-1,0,0,0,6,2,0,7
Morocco,05/03/2008,24,0,0,0,3,0,0,27
Morocco,06/03/2008,0,0,-2,0,9,0,0,7
Morocco,07/03/2008,2,0,0,0,7,0,0,9
Morocco,08/03/2008,0,0,0,0,0,0,0,0
Morocco,10/03/2008,0,0,0,0,6,0,0,6
Morocco,11/03/2008,5,0,0,0,3,0,0,8
Morocco,12/03/2008,3,0,0,0,3,0,0,6
Morocco,13/03/2008,12,0,0,0,9,0,0,21
Morocco,14/03/2008,6,0,0,0,3,0,0,9
Morocco,15/03/2008,4,0,0,0,0,0,0,4
Morocco,16/03/2008,0,0,0,0,0,0,0,0
Morocco,17/03/2008,25,0,0,0,3,1,0,29
Morocco,18/03/2008,0,0,0,0,-2,0,0,-2
Morocco,19/03/2008,15,0,0,0,-1,0,0,14
Morocco,20/03/2008,1,0,0,0,21,1,0,23
Morocco,21/03/2008,1,0,0,0,6,0,0,7
Morocco,22/03/2008,8,0,0,0,0,0,0,8
Morocco,23/03/2008,3,0,0,0,0,0,0,3
Morocco,24/03/2008,5,0,0,0,3,0,0,8
Morocco,25/03/2008,3,0,0,0,6,0,0,9
Morocco,26/03/2008,0,0,0,0,0,0,0,0
Morocco,27/03/2008,0,0,0,0,0,0,0,0
Morocco,28/03/2008,16,0,0,0,9,1,0,26
Morocco,29/03/2008,4,0,0,0,0,1,0,5
Morocco,30/03/2008,4,0,0,0,9,0,0,13
Morocco,31/03/2008,1,0,0,0,-2,1,0,0
Nigeria,01/03/2008,-1,0,-2,0,4,2,0,3
Nigeria,02/03/2008,-1,0,0,0,-2,0,0,-3
Nigeria,03/03/2008,3,0,0,0,3,0,0,6
Nigeria,04/03/2008,4,0,0,0,3,1,0,8
Nigeria,05/03/2008,16,0,0,0,6,2,0,24
Nigeria,06/03/2008,2,0,1,0,0,0,0,3
Nigeria,07/03/2008,-4,0,0,0,4,0,0,0
Nigeria,08/03/2008,10,0,0,0,0,0,0,10
Nigeria,09/03/2008,0,0,0,0,0,0,0,0
Nigeria,10/03/2008,-2,0,0,0,9,0,0,7
Nigeria,11/03/2008,20,0,0,0,10,0,0,30
Nigeria,12/03/2008,1,2,0,0,0,1,0,4
Nigeria,13/03/2008,4,0,0,0,3,1,0,8
Nigeria,14/03/2008,13,0,0,0,9,10,0,32
Nigeria,15/03/2008,-2,0,0,0,0,0,0,-2
Nigeria,16/03/2008,0,0,0,0,3,0,0,3
Nigeria,17/03/2008,9,0,0,0,-2,5,0,12
Nigeria,18/03/2008,14,0,0,0,-4,4,0,14
Nigeria,19/03/2008,2,0,0,0,6,0,0,8
Nigeria,20/03/2008,16,0,4,0,3,0,0,23
Nigeria,21/03/2008,7,0,0,0,9,3,0,19
Nigeria,22/03/2008,5,0,0,0,0,9,0,14
Nigeria,23/03/2008,2,0,0,0,0,0,0,2
Nigeria,24/03/2008,29,0,0,0,0,2,0,31
Nigeria,25/03/2008,1,0,-4,0,0,1,0,-2
Nigeria,26/03/2008,-1,0,0,0,3,0,0,2
Nigeria,27/03/2008,0,0,0,0,0,0,0,0
Nigeria,28/03/2008,2,0,0,0,3,0,0,5
Nigeria,29/03/2008,0,0,0,0,1,0,0,1
Nigeria,30/03/2008,0,0,0,0,0,0,0,0
Nigeria,31/03/2008,-1,0,0,0,12,1,0,12
Pakistan,01/03/2008,24,0,0,0,9,5,0,38
Pakistan,02/03/2008,29,0,-2,0,1,9,0,37
Pakistan,03/03/2008,59,0,0,0,44,4,0,107
Pakistan,04/03/2008,35,0,0,0,25,1,0,61
Pakistan,05/03/2008,25,0,0,0,15,0,0,40
Pakistan,06/03/2008,30,0,0,0,35,10,0,75
Pakistan,07/03/2008,70,2,-6,0,55,4,0,125
Pakistan,08/03/2008,21,0,0,0,13,5,0,39
Pakistan,09/03/2008,9,0,0,0,3,3,0,15
Pakistan,10/03/2008,65,0,-4,0,33,1,0,95
Pakistan,11/03/2008,82,0,-3,0,42,9,0,130
Pakistan,12/03/2008,11,0,-2,0,42,5,0,56
Pakistan,13/03/2008,26,0,1,0,11,4,0,42
Pakistan,14/03/2008,25,0,2,0,34,10,0,71
Pakistan,15/03/2008,14,0,1,0,3,3,0,21
Pakistan,16/03/2008,37,0,0,0,7,2,0,46
Pakistan,17/03/2008,41,0,-2,0,4,8,0,51
Pakistan,18/03/2008,32,0,0,0,54,2,0,88
Pakistan,19/03/2008,31,0,-2,0,5,19,0,53
Pakistan,20/03/2008,97,2,0,0,11,4,0,114
Pakistan,21/03/2008,77,0,0,0,1,6,0,84
Pakistan,22/03/2008,7,0,0,0,-6,2,0,3
Pakistan,23/03/2008,23,0,0,0,14,3,0,40
Pakistan,24/03/2008,18,0,1,0,24,5,0,48
Pakistan,25/03/2008,66,0,2,0,48,8,0,124
Pakistan,26/03/2008,59,0,0,0,13,1,0,73
Pakistan,27/03/2008,47,0,0,0,-9,8,0,46
Pakistan,28/03/2008,24,0,0,0,15,5,0,44
Pakistan,29/03/2008,104,0,0,0,4,11,0,119
Pakistan,30/03/2008,33,0,0,0,7,4,0,44
Pakistan,31/03/2008,36,0,0,0,37,7,0,80
Sierra Leone,02/03/2008,0,0,0,0,0,0,0,0
Sierra Leone,03/03/2008,-2,0,0,0,-4,0,0,-6
Sierra Leone,04/03/2008,2,0,0,0,0,0,0,2
Sierra Leone,05/03/2008,4,0,0,0,0,0,0,4
Sierra Leone,06/03/2008,0,0,0,0,3,0,0,3
Sierra Leone,07/03/2008,3,0,0,0,10,0,0,13
Sierra Leone,08/03/2008,0,0,0,0,3,0,0,3
Sierra Leone,09/03/2008,0,0,0,0,6,0,0,6
Sierra Leone,10/03/2008,-2,0,0,0,6,0,0,4
Sierra Leone,11/03/2008,-2,0,0,0,15,0,0,13
Sierra Leone,12/03/2008,3,0,1,0,0,4,0,8
Sierra Leone,13/03/2008,4,0,0,0,0,0,0,4
Sierra Leone,14/03/2008,0,0,0,0,3,2,0,5
Sierra Leone,15/03/2008,-1,0,0,0,0,0,0,-1
Sierra Leone,19/03/2008,4,0,0,0,0,0,0,4
Sierra Leone,20/03/2008,2,0,0,0,6,0,0,8
Sierra Leone,21/03/2008,3,0,0,0,6,0,0,9
Sierra Leone,23/03/2008,-2,0,0,0,9,0,0,7
Sierra Leone,24/03/2008,0,0,0,0,3,2,0,5
Sierra Leone,26/03/2008,1,0,0,0,0,0,0,1
Sierra Leone,27/03/2008,1,0,0,0,0,0,0,1
Sierra Leone,28/03/2008,0,0,0,0,0,2,0,2
Sierra Leone,29/03/2008,2,0,0,0,0,0,0,2
Somalia,01/03/2008,26,0,0,0,5,0,0,31
Somalia,02/03/2008,2,0,0,0,0,0,0,2
Somalia,03/03/2008,85,0,0,0,1,12,0,98
Somalia,04/03/2008,72,0,0,0,6,8,0,86
Somalia,05/03/2008,35,2,0,0,12,2,0,51
Somalia,06/03/2008,39,2,1,0,3,0,0,45
Somalia,07/03/2008,15,0,0,0,3,3,0,21
Somalia,08/03/2008,23,0,0,0,9,4,0,36
Somalia,09/03/2008,0,0,0,0,0,0,0,0
Somalia,10/03/2008,2,0,0,0,0,0,0,2
Somalia,11/03/2008,13,0,0,0,6,1,0,20
Somalia,12/03/2008,3,4,0,0,-2,1,0,6
Somalia,13/03/2008,13,0,0,0,0,0,0,13
Somalia,14/03/2008,16,0,1,0,6,0,0,23
Somalia,15/03/2008,7,0,0,0,0,2,0,9
Somalia,16/03/2008,6,0,0,0,-8,0,0,-2
Somalia,17/03/2008,13,0,0,0,-2,0,0,11
Somalia,18/03/2008,47,0,0,0,0,0,0,47
Somalia,19/03/2008,19,0,0,0,0,0,0,19
Somalia,20/03/2008,40,0,0,0,0,0,0,40
Somalia,21/03/2008,25,0,0,0,0,0,0,25
Somalia,22/03/2008,0,0,0,0,0,0,0,0
Somalia,23/03/2008,30,0,0,0,0,0,0,30
Somalia,24/03/2008,15,0,0,0,6,0,0,21
Somalia,25/03/2008,18,0,0,0,0,0,0,18
Somalia,26/03/2008,13,0,0,0,3,2,0,18
Somalia,27/03/2008,12,0,1,0,0,0,0,13
Somalia,28/03/2008,16,0,0,0,10,0,0,26
Somalia,29/03/2008,2,0,0,0,2,0,0,4
Somalia,30/03/2008,2,0,0,0,0,1,0,3
Somalia,31/03/2008,12,0,0,0,0,6,0,18
Syria,01/03/2008,-8,0,0,0,0,0,0,-8
Syria,02/03/2008,0,0,0,0,4,24,0,28
Syria,03/03/2008,18,0,0,0,3,13,0,34
Syria,04/03/2008,-3,0,0,0,9,7,0,13
Syria,05/03/2008,9,0,1,0,0,1,0,11
Syria,06/03/2008,70,0,2,0,12,1,0,85
Syria,07/03/2008,30,0,0,0,8,1,0,39
Syria,08/03/2008,10,0,0,0,3,6,0,19
Syria,09/03/2008,20,0,0,0,0,0,0,20
Syria,10/03/2008,7,0,0,0,6,1,0,14
Syria,11/03/2008,23,0,0,0,-17,0,0,6
Syria,12/03/2008,25,0,0,0,8,3,0,36
Syria,13/03/2008,5,0,0,0,3,0,0,8
Syria,14/03/2008,8,0,0,0,16,11,0,35
Syria,15/03/2008,23,0,0,0,0,14,0,37
Syria,16/03/2008,17,0,0,0,10,1,0,28
Syria,17/03/2008,0,0,0,0,0,0,0,0
Syria,18/03/2008,13,0,0,0,12,1,0,26
Syria,19/03/2008,12,0,0,0,3,1,0,16
Syria,20/03/2008,22,0,0,0,9,6,0,37
Syria,21/03/2008,27,0,0,0,6,16,0,49
Syria,22/03/2008,16,0,0,0,1,6,0,23
Syria,23/03/2008,1,0,0,0,9,1,0,11
Syria,24/03/2008,40,0,1,0,9,2,0,52
Syria,25/03/2008,42,2,0,0,3,1,0,48
Syria,26/03/2008,7,0,0,0,12,1,0,20
Syria,27/03/2008,34,2,0,0,0,0,0,36
Syria,28/03/2008,2,0,0,0,7,0,0,9
Syria,29/03/2008,-1,0,0,0,9,6,0,14
Syria,30/03/2008,14,0,0,0,0,2,0,16
Syria,31/03/2008,9,0,0,0,3,0,0,12
Yemen,01/03/2008,9,0,0,0,0,1,0,10
Yemen,02/03/2008,-2,0,0,0,2,0,0,0
Yemen,03/03/2008,6,4,0,0,0,1,0,11
Yemen,04/03/2008,8,2,0,0,0,2,0,12
Yemen,05/03/2008,16,0,0,0,12,2,0,30
Yemen,06/03/2008,3,0,0,0,0,4,0,7
Yemen,07/03/2008,5,0,0,0,3,0,0,8
Yemen,08/03/2008,0,0,0,0,0,0,0,0
Yemen,09/03/2008,2,0,0,0,0,0,0,2
Yemen,10/03/2008,6,0,0,0,0,0,0,6
Yemen,11/03/2008,-2,0,0,0,0,0,0,-2
Yemen,12/03/2008,1,0,0,0,-2,0,0,-1
Yemen,13/03/2008,0,0,0,0,9,0,0,9
Yemen,14/03/2008,5,0,3,0,48,0,0,56
Yemen,15/03/2008,0,0,0,0,0,0,0,0
Yemen,16/03/2008,9,0,0,0,6,0,0,15
Yemen,17/03/2008,10,0,1,0,0,0,0,11
Yemen,18/03/2008,19,0,0,0,0,6,0,25
Yemen,19/03/2008,4,0,0,0,0,5,0,9
Yemen,20/03/2008,18,0,1,0,6,3,0,28
Yemen,21/03/2008,22,0,0,0,0,0,0,22
Yemen,22/03/2008,25,0,1,0,9,0,0,35
Yemen,23/03/2008,42,0,0,0,18,4,0,64
Yemen,24/03/2008,17,0,0,0,0,0,0,17
Yemen,25/03/2008,25,0,0,0,0,1,0,26
Yemen,26/03/2008,58,0,0,0,3,2,0,63
Yemen,27/03/2008,34,0,0,0,3,4,0,41
Yemen,28/03/2008,4,0,1,0,3,5,0,13
Yemen,29/03/2008,6,0,2,0,9,0,0,17
Yemen,30/03/2008,7,0,0,0,0,6,0,13
Yemen,31/03/2008,1,0,0,0,0,0,0,1
Afghanistan,01/01/2006,2,0,-3,0,4,0,0,3
Afghanistan,02/01/2006,16,0,0,0,6,0,0,22
Afghanistan,03/01/2006,3,0,0,0,-6,8,0,5
Afghanistan,04/01/2006,31,0,0,0,11,0,0,42
Afghanistan,05/01/2006,21,0,0,0,1,2,0,24
Afghanistan,06/01/2006,17,0,0,0,0,2,0,19
Afghanistan,07/01/2006,49,0,0,0,6,4,0,59
Afghanistan,08/01/2006,13,0,0,0,9,5,0,27
Afghanistan,09/01/2006,41,0,-1,0,8,5,0,53
Afghanistan,10/01/2006,50,0,0,0,6,1,0,57
Afghanistan,11/01/2006,29,0,0,0,-2,3,0,30
Afghanistan,12/01/2006,24,0,0,0,33,1,0,58
Afghanistan,13/01/2006,32,0,0,0,19,2,0,53
Afghanistan,14/01/2006,68,0,0,0,1,0,0,69
Afghanistan,15/01/2006,48,0,1,0,3,27,0,79
Afghanistan,16/01/2006,64,0,0,0,3,18,0,85
Afghanistan,17/01/2006,21,0,0,0,10,1,0,32
Afghanistan,18/01/2006,38,0,1,0,0,5,0,44
Afghanistan,19/01/2006,53,0,0,0,7,3,0,63
Afghanistan,20/01/2006,23,0,0,0,7,3,0,33
Afghanistan,21/01/2006,18,0,0,0,14,0,0,32
Afghanistan,22/01/2006,16,0,0,0,-4,0,0,12
Afghanistan,23/01/2006,27,0,0,0,1,3,0,31
Afghanistan,24/01/2006,17,0,0,0,1,0,0,18
Afghanistan,25/01/2006,7,0,0,0,0,0,0,7
Afghanistan,26/01/2006,14,0,0,0,0,0,0,14
Afghanistan,27/01/2006,7,0,0,0,3,1,0,11
Afghanistan,28/01/2006,17,0,0,0,3,0,0,20
Afghanistan,29/01/2006,10,0,0,0,1,2,0,13
Afghanistan,30/01/2006,38,0,0,0,12,4,0,54
Afghanistan,31/01/2006,59,2,0,0,21,8,0,90
Albania,01/01/2006,9,0,0,0,6,0,0,15
Albania,02/01/2006,5,0,0,0,0,0,0,5
Albania,03/01/2006,0,0,0,0,3,0,0,3
Albania,04/01/2006,5,0,0,0,3,0,0,8
Albania,05/01/2006,1,0,0,0,0,0,0,1
Albania,06/01/2006,8,0,-1,0,0,0,0,7
Albania,07/01/2006,6,0,0,0,3,0,0,9
Albania,08/01/2006,1,0,0,0,0,0,0,1
Albania,09/01/2006,10,0,0,0,0,0,0,10
Albania,10/01/2006,2,0,-4,0,0,0,0,-2
Albania,11/01/2006,4,0,0,0,0,0,0,4
Albania,12/01/2006,0,0,0,0,0,0,0,0
Albania,13/01/2006,-1,0,0,0,0,0,0,-1
Albania,14/01/2006,4,0,-1,0,0,1,0,4
Albania,15/01/2006,-2,0,0,0,0,1,0,-1
Albania,16/01/2006,0,0,0,0,0,2,0,2
Albania,17/01/2006,-1,0,-1,0,9,0,0,7
Albania,18/01/2006,4,0,0,0,0,0,0,4
Albania,19/01/2006,0,0,0,0,0,0,0,0
Albania,20/01/2006,0,0,0,0,0,0,0,0
Albania,21/01/2006,31,0,-9,0,10,2,0,34
Albania,22/01/2006,19,0,0,0,1,0,0,20
Albania,23/01/2006,18,0,0,0,6,0,0,24
Albania,24/01/2006,2,0,0,0,3,1,0,6
Albania,25/01/2006,10,0,0,0,0,3,0,13
Albania,26/01/2006,2,0,0,0,8,1,0,11
Albania,27/01/2006,0,0,0,0,-2,0,0,-2
Albania,28/01/2006,0,0,0,0,0,0,0,0
Albania,29/01/2006,7,0,0,0,0,0,0,7
Albania,30/01/2006,6,0,0,0,0,0,0,6
Albania,31/01/2006,2,0,0,0,0,0,0,2
Algeria,01/01/2006,0,0,0,0,-2,0,0,-2
Algeria,02/01/2006,6,0,0,0,0,0,0,6
Algeria,03/01/2006,3,0,0,0,3,0,0,6
Algeria,05/01/2006,3,0,0,0,0,0,0,3
Algeria,06/01/2006,0,0,0,0,0,0,0,0
Algeria,07/01/2006,0,0,0,0,0,0,0,0
Algeria,08/01/2006,0,0,0,0,0,2,0,2
Algeria,09/01/2006,0,0,0,0,0,0,0,0
Algeria,10/01/2006,3,0,0,0,0,0,0,3
Algeria,11/01/2006,0,0,0,0,3,6,0,9
Algeria,12/01/2006,1,0,0,0,6,3,0,10
Algeria,13/01/2006,0,0,0,0,0,0,0,0
Algeria,14/01/2006,7,0,0,0,0,5,0,12
Algeria,15/01/2006,0,0,0,0,0,0,0,0
Algeria,16/01/2006,1,0,0,0,6,0,0,7
Algeria,18/01/2006,4,0,0,0,0,0,0,4
Algeria,19/01/2006,0,0,0,0,0,0,0,0
Algeria,20/01/2006,3,0,0,0,0,0,0,3
Algeria,21/01/2006,0,0,0,0,0,0,0,0
Algeria,22/01/2006,0,0,0,0,0,0,0,0
Algeria,23/01/2006,4,0,0,0,3,0,0,7
Algeria,24/01/2006,0,0,0,0,0,0,0,0
Algeria,25/01/2006,4,0,0,0,3,0,0,7
Algeria,26/01/2006,0,0,0,0,9,1,0,10
Algeria,27/01/2006,0,0,0,0,0,0,0,0
Algeria,28/01/2006,0,0,0,0,0,0,0,0
Algeria,29/01/2006,0,0,0,0,0,0,0,0
Algeria,30/01/2006,0,0,0,0,4,0,0,4
Algeria,31/01/2006,4,0,0,0,0,0,0,4
Bangladesh,03/01/2006,6,0,0,0,0,0,0,6
Bangladesh,04/01/2006,3,0,0,0,0,0,0,3
Bangladesh,05/01/2006,17,0,0,0,0,0,0,17
Bangladesh,07/01/2006,3,0,0,0,3,0,0,6
Bangladesh,08/01/2006,0,0,0,0,3,0,0,3
Bangladesh,10/01/2006,3,0,0,0,0,0,0,3
Bangladesh,14/01/2006,6,0,0,0,6,2,0,14
Bangladesh,15/01/2006,9,0,0,0,0,0,0,9
Bangladesh,16/01/2006,14,0,0,0,0,0,0,14
Bangladesh,17/01/2006,3,0,0,0,6,0,0,9
Bangladesh,18/01/2006,18,0,0,0,12,6,0,36
Bangladesh,19/01/2006,18,0,0,0,0,0,0,18
Bangladesh,20/01/2006,3,0,0,0,0,0,0,3
Bangladesh,21/01/2006,0,0,0,0,-2,0,0,-2
Bangladesh,22/01/2006,0,0,0,0,0,0,0,0
Bangladesh,23/01/2006,7,0,0,0,3,2,0,12
Bangladesh,24/01/2006,22,0,0,0,18,0,0,40
Bangladesh,25/01/2006,20,0,0,0,10,2,0,32
Bangladesh,26/01/2006,17,0,0,0,3,0,0,20
Bangladesh,27/01/2006,9,0,0,0,0,0,0,9
Bangladesh,29/01/2006,0,0,0,0,0,0,0,0
Bangladesh,30/01/2006,2,0,0,0,3,0,0,5
Bangladesh,31/01/2006,5,0,0,0,0,0,0,5
Cameroon,03/01/2006,2,0,0,0,0,0,0,2
Cameroon,04/01/2006,0,0,0,0,0,4,0,4
Cameroon,05/01/2006,0,0,0,0,0,0,0,0
Cameroon,06/01/2006,4,0,0,0,0,0,0,4
Cameroon,09/01/2006,0,0,0,0,0,0,0,0
Cameroon,11/01/2006,0,0,0,0,0,0,0,0
Cameroon,12/01/2006,0,0,0,0,0,0,0,0
Cameroon,13/01/2006,0,0,0,0,0,0,0,0
Cameroon,16/01/2006,0,0,0,0,0,0,0,0
Cameroon,17/01/2006,6,0,0,0,0,0,0,6
Cameroon,18/01/2006,3,0,0,0,0,0,0,3
Cameroon,19/01/2006,2,0,0,0,0,0,0,2
Cameroon,20/01/2006,0,0,0,0,0,0,0,0
Cameroon,21/01/2006,0,0,0,0,0,0,0,0
Cameroon,23/01/2006,0,0,0,0,0,0,0,0
Cameroon,24/01/2006,0,0,0,0,-2,0,0,-2
Cameroon,25/01/2006,0,0,0,0,-2,0,0,-2
Cameroon,27/01/2006,9,0,0,0,0,1,0,10
Cameroon,28/01/2006,0,0,0,0,0,0,0,0
Cameroon,30/01/2006,0,0,0,0,0,0,0,0
Cameroon,31/01/2006,4,0,0,0,0,0,0,4
China,01/01/2006,11,0,0,0,6,2,0,19
China,02/01/2006,14,0,0,0,9,0,0,23
China,03/01/2006,6,0,0,0,27,0,0,33
China,04/01/2006,2,0,0,0,45,0,0,47
China,05/01/2006,8,0,0,0,-1,3,0,10
China,06/01/2006,10,0,0,0,7,1,0,18
China,07/01/2006,3,0,0,0,-4,1,0,0
China,08/01/2006,5,0,-1,0,0,0,0,4
China,09/01/2006,28,0,2,0,7,2,0,39
China,10/01/2006,38,0,0,0,0,3,0,41
China,11/01/2006,19,0,0,0,4,0,0,23
China,12/01/2006,15,0,0,0,-2,3,0,16
China,13/01/2006,5,0,0,0,12,6,0,23
China,14/01/2006,3,0,0,0,0,0,0,3
China,15/01/2006,11,0,0,0,0,0,0,11
China,16/01/2006,15,0,0,0,6,1,0,22
China,17/01/2006,27,0,0,0,16,3,0,46
China,18/01/2006,12,0,0,0,12,1,0,25
China,19/01/2006,15,0,0,0,7,1,0,23
China,20/01/2006,22,0,0,0,0,0,0,22
China,21/01/2006,4,0,0,0,-2,2,0,4
China,22/01/2006,22,0,0,0,-4,1,0,19
China,23/01/2006,30,0,-2,0,9,1,0,38
China,24/01/2006,13,0,0,0,0,1,0,14
China,25/01/2006,28,0,-4,0,17,4,0,45
China,26/01/2006,15,0,1,0,11,1,0,28
China,27/01/2006,18,0,0,0,3,2,0,23
China,28/01/2006,12,0,0,0,9,4,0,25
China,29/01/2006,6,0,-2,0,1,5,0,10
China,30/01/2006,6,0,0,0,9,0,0,15
China,31/01/2006,13,0,0,0,9,0,0,22
Egypt,01/01/2006,0,0,0,0,15,0,0,15
Egypt,02/01/2006,15,0,0,0,0,0,0,15
Egypt,03/01/2006,6,0,1,0,9,8,0,24
Egypt,04/01/2006,47,0,2,0,14,8,0,71
Egypt,05/01/2006,16,0,0,0,10,2,0,28
Egypt,06/01/2006,21,0,0,0,3,2,0,26
Egypt,07/01/2006,19,0,0,0,17,0,0,36
Egypt,08/01/2006,3,0,0,0,0,0,0,3
Egypt,09/01/2006,26,0,0,0,4,1,0,31
Egypt,10/01/2006,18,0,0,0,21,0,0,39
Egypt,11/01/2006,9,0,0,0,0,0,0,9
Egypt,12/01/2006,5,0,0,0,9,0,0,14
Egypt,13/01/2006,7,0,0,0,4,0,0,11
Egypt,14/01/2006,14,0,0,0,-6,5,0,13
Egypt,15/01/2006,6,0,0,0,0,0,0,6
Egypt,16/01/2006,1,0,0,0,-2,1,0,0
Egypt,17/01/2006,7,0,0,0,6,0,0,13
Egypt,18/01/2006,10,0,0,0,3,5,0,18
Egypt,19/01/2006,41,0,0,0,-6,3,0,38
Egypt,20/01/2006,1,0,0,0,0,0,0,1
Egypt,21/01/2006,0,0,0,0,0,2,0,2
Egypt,22/01/2006,0,0,0,0,0,0,0,0
Egypt,23/01/2006,7,0,0,0,0,0,0,7
Egypt,24/01/2006,7,0,0,0,3,0,0,10
Egypt,25/01/2006,0,0,0,0,3,0,0,3
Egypt,26/01/2006,1,0,0,0,-2,0,0,-1
Egypt,27/01/2006,-3,0,0,0,0,0,0,-3
Egypt,28/01/2006,0,0,0,0,2,0,0,2
Egypt,29/01/2006,-1,0,0,0,6,0,0,5
Egypt,30/01/2006,12,0,0,0,12,2,0,26
Egypt,31/01/2006,14,0,0,0,63,0,0,77
Eritrea,01/01/2006,0,0,0,0,0,0,0,0
Eritrea,02/01/2006,81,0,0,0,0,0,0,81
Eritrea,03/01/2006,0,0,0,0,0,0,0,0
Eritrea,04/01/2006,84,0,0,0,0,0,0,84
Eritrea,05/01/2006,1,0,0,0,0,0,0,1
Eritrea,06/01/2006,0,0,0,0,3,0,0,3
Eritrea,07/01/2006,0,0,0,0,0,0,0,0
Eritrea,09/01/2006,22,0,0,0,9,0,0,31
Eritrea,10/01/2006,13,0,0,0,3,0,0,16
Eritrea,11/01/2006,10,0,0,0,0,0,0,10
Eritrea,12/01/2006,3,0,0,0,0,1,0,4
Eritrea,13/01/2006,5,0,0,0,0,0,0,5
Eritrea,14/01/2006,4,0,0,0,0,0,0,4
Eritrea,15/01/2006,0,0,0,0,0,0,0,0
Eritrea,17/01/2006,0,0,0,0,0,0,0,0
Eritrea,18/01/2006,0,0,0,0,0,0,0,0
Eritrea,19/01/2006,1,0,0,0,0,0,0,1
Eritrea,20/01/2006,9,0,0,0,0,0,0,9
Eritrea,21/01/2006,0,0,0,0,0,0,0,0
Eritrea,22/01/2006,0,0,0,0,0,0,0,0
Eritrea,23/01/2006,2,0,0,0,0,0,0,2
Eritrea,24/01/2006,-1,0,0,0,0,0,0,-1
Eritrea,25/01/2006,0,0,0,0,0,0,0,0
Eritrea,28/01/2006,0,0,0,0,0,0,0,0
Eritrea,30/01/2006,8,0,0,0,0,0,0,8
Georgia,03/01/2006,0,0,0,0,0,0,0,0
Georgia,04/01/2006,0,0,0,0,0,0,0,0
Georgia,05/01/2006,2,0,0,0,0,0,0,2
Georgia,07/01/2006,15,0,0,0,0,0,0,15
Georgia,09/01/2006,0,0,0,0,0,0,0,0
Georgia,10/01/2006,-2,0,0,0,0,0,0,-2
Georgia,11/01/2006,0,0,0,0,15,0,0,15
Georgia,12/01/2006,0,0,0,0,6,0,0,6
Georgia,14/01/2006,0,0,0,0,0,0,0,0
Georgia,15/01/2006,2,0,0,0,0,0,0,2
Georgia,16/01/2006,0,0,0,0,3,0,0,3
Georgia,17/01/2006,0,0,0,0,0,0,0,0
Georgia,19/01/2006,0,0,0,0,0,0,0,0
Georgia,20/01/2006,0,0,0,0,0,4,0,4
Georgia,22/01/2006,0,0,0,0,0,0,0,0
Georgia,23/01/2006,3,0,0,0,3,0,0,6
Georgia,24/01/2006,1,0,0,0,0,0,0,1
Georgia,25/01/2006,4,0,0,0,0,1,0,5
Georgia,26/01/2006,2,0,0,0,0,0,0,2
Georgia,27/01/2006,3,0,0,0,0,0,0,3
Georgia,28/01/2006,0,0,0,0,0,1,0,1
Georgia,29/01/2006,0,0,0,0,0,0,0,0
Georgia,30/01/2006,-2,0,0,0,9,0,0,7
Georgia,31/01/2006,2,0,0,0,0,0,0,2
India,02/01/2006,0,0,0,0,0,2,0,2
India,03/01/2006,0,0,0,0,3,1,0,4
India,04/01/2006,0,0,0,0,0,0,0,0
India,05/01/2006,2,0,0,0,0,0,0,2
India,06/01/2006,24,0,0,0,3,0,0,27
India,07/01/2006,4,0,0,0,6,0,0,10
India,08/01/2006,5,0,1,0,6,0,0,12
India,09/01/2006,6,0,0,0,2,0,0,8
India,10/01/2006,2,0,0,0,0,2,0,4
India,11/01/2006,8,0,0,0,0,1,0,9
India,12/01/2006,5,0,0,0,0,0,0,5
India,13/01/2006,10,0,-1,0,9,0,0,18
India,14/01/2006,7,0,1,0,0,4,0,12
India,15/01/2006,7,0,0,0,0,1,0,8
India,16/01/2006,2,0,0,0,3,0,0,5
India,17/01/2006,3,0,0,0,0,0,0,3
India,18/01/2006,5,0,0,0,0,0,0,5
India,19/01/2006,8,0,0,0,7,0,0,15
India,20/01/2006,2,0,0,0,12,0,0,14
India,21/01/2006,0,0,0,0,9,0,0,9
India,22/01/2006,7,0,0,0,0,1,0,8
India,23/01/2006,14,0,0,0,0,0,0,14
India,24/01/2006,4,0,0,0,0,0,0,4
India,25/01/2006,21,0,-2,0,0,2,0,21
India,26/01/2006,4,0,0,0,0,0,0,4
India,27/01/2006,4,0,0,0,0,0,0,4
India,28/01/2006,4,0,0,0,3,0,0,7
India,29/01/2006,1,0,0,0,3,0,0,4
India,30/01/2006,20,0,0,0,9,0,0,29
India,31/01/2006,5,2,1,0,3,0,0,11
Iran,01/01/2006,1,0,0,0,3,0,0,4
Iran,02/01/2006,8,0,0,0,25,1,0,34
Iran,03/01/2006,2,0,0,0,3,0,0,5
Iran,04/01/2006,6,0,0,0,7,0,0,13
Iran,05/01/2006,27,0,0,0,-2,6,0,31
Iran,06/01/2006,26,0,0,0,18,0,0,44
Iran,07/01/2006,16,0,0,0,9,1,0,26
Iran,08/01/2006,0,0,0,0,12,0,0,12
Iran,09/01/2006,15,0,0,0,16,1,0,32
Iran,10/01/2006,30,0,0,0,3,1,0,34
Iran,11/01/2006,12,0,1,0,3,0,0,16
Iran,12/01/2006,31,0,1,0,6,1,0,39
Iran,13/01/2006,45,0,0,0,7,6,0,58
Iran,14/01/2006,-4,0,0,0,6,0,0,2
Iran,15/01/2006,6,0,-2,0,6,0,0,10
Iran,16/01/2006,33,0,0,0,3,0,0,36
Iran,17/01/2006,28,0,0,0,0,2,0,30
Iran,18/01/2006,41,0,0,0,4,2,0,47
Iran,19/01/2006,23,0,0,0,23,2,0,48
Iran,20/01/2006,16,0,2,0,3,4,0,25
Iran,21/01/2006,1,0,0,0,1,0,0,2
Iran,22/01/2006,9,2,-1,0,0,0,0,10
Iran,23/01/2006,17,4,-1,0,30,26,0,76
Iran,24/01/2006,11,0,0,0,19,2,0,32
Iran,25/01/2006,25,0,0,0,6,2,0,33
Iran,26/01/2006,24,0,1,0,6,0,0,31
Iran,27/01/2006,12,0,0,0,15,0,0,27
Iran,28/01/2006,38,0,1,0,11,3,0,53
Iran,29/01/2006,10,0,0,0,-10,1,0,1
Iran,30/01/2006,13,0,0,0,9,2,0,24
Iran,31/01/2006,13,0,2,0,26,1,0,42
Iraq,01/01/2006,20,0,0,0,1,6,0,27
Iraq,02/01/2006,17,0,-4,0,-3,2,0,12
Iraq,03/01/2006,26,0,1,0,12,1,0,40
Iraq,04/01/2006,48,0,-1,0,6,3,0,56
Iraq,05/01/2006,27,0,0,0,10,6,0,43
Iraq,06/01/2006,21,4,1,0,-12,5,0,19
Iraq,07/01/2006,28,0,0,0,10,3,0,41
Iraq,08/01/2006,27,0,0,0,0,7,0,34
Iraq,09/01/2006,27,0,-8,0,39,8,0,66
Iraq,10/01/2006,29,0,5,0,20,3,0,57
Iraq,11/01/2006,29,2,-4,0,14,0,0,41
Iraq,12/01/2006,65,0,-2,0,42,7,0,112
Iraq,13/01/2006,16,0,0,0,20,4,0,40
Iraq,14/01/2006,39,4,-5,0,6,2,0,46
Iraq,15/01/2006,7,0,0,0,24,3,0,34
Iraq,16/01/2006,35,0,0,0,42,2,0,79
Iraq,17/01/2006,65,0,0,0,44,1,0,110
Iraq,18/01/2006,38,4,1,0,-5,4,0,42
Iraq,19/01/2006,76,4,-6,0,11,5,0,90
Iraq,20/01/2006,34,0,-4,0,7,12,0,49
Iraq,21/01/2006,25,0,0,0,6,0,0,31
Iraq,22/01/2006,45,0,-1,0,16,0,0,60
Iraq,23/01/2006,25,0,-1,0,5,9,0,38
Iraq,24/01/2006,10,0,-4,0,18,2,0,26
Iraq,25/01/2006,24,0,0,0,18,3,0,45
Iraq,26/01/2006,28,0,0,0,31,4,0,63
Iraq,27/01/2006,29,0,0,0,0,3,0,32
Iraq,28/01/2006,35,2,0,0,5,8,0,50
Iraq,29/01/2006,18,0,-2,0,0,11,0,27
Iraq,30/01/2006,22,0,1,0,27,5,0,55
Iraq,31/01/2006,35,0,0,0,11,5,0,51
Morocco,01/01/2006,3,0,0,0,-3,0,0,0
Morocco,02/01/2006,0,0,0,0,6,0,0,6
Morocco,03/01/2006,0,0,0,0,2,0,0,2
Morocco,04/01/2006,0,0,0,0,9,0,0,9
Morocco,05/01/2006,4,0,0,0,0,2,0,6
Morocco,06/01/2006,2,0,0,0,6,0,0,8
Morocco,07/01/2006,4,0,0,0,0,0,0,4
Morocco,08/01/2006,0,0,0,0,0,0,0,0
Morocco,09/01/2006,4,0,0,0,0,0,0,4
Morocco,10/01/2006,-3,0,0,0,0,0,0,-3
Morocco,11/01/2006,-3,0,0,0,9,0,0,6
Morocco,12/01/2006,1,0,0,0,6,0,0,7
Morocco,14/01/2006,3,0,0,0,21,0,0,24
Morocco,15/01/2006,3,0,1,0,39,3,0,46
Morocco,16/01/2006,0,0,0,0,12,2,0,14
Morocco,17/01/2006,-1,0,0,0,3,0,0,2
Morocco,18/01/2006,0,0,0,0,-2,0,0,-2
Morocco,19/01/2006,12,0,0,0,6,0,0,18
Morocco,21/01/2006,3,0,0,0,6,0,0,9
Morocco,22/01/2006,1,0,0,0,0,0,0,1
Morocco,23/01/2006,0,0,0,0,15,0,0,15
Morocco,24/01/2006,3,0,0,0,34,6,0,43
Morocco,26/01/2006,9,0,0,0,3,0,0,12
Morocco,27/01/2006,0,0,0,0,0,0,0,0
Morocco,29/01/2006,0,0,0,0,0,0,0,0
Morocco,30/01/2006,0,0,0,0,0,0,0,0
Morocco,31/01/2006,1,0,0,0,3,7,0,11
Nigeria,01/01/2006,0,0,0,0,0,0,0,0
Nigeria,02/01/2006,17,0,0,0,3,0,0,20
Nigeria,03/01/2006,8,0,0,0,6,1,0,15
Nigeria,04/01/2006,5,0,0,0,-4,1,0,2
Nigeria,05/01/2006,12,0,-2,0,-3,3,0,10
Nigeria,06/01/2006,1,0,0,0,0,0,0,1
Nigeria,07/01/2006,11,0,0,0,0,-2,0,9
Nigeria,08/01/2006,4,0,-2,0,8,0,0,10
Nigeria,09/01/2006,12,0,1,0,9,0,0,22
Nigeria,10/01/2006,9,0,0,0,-2,1,0,8
Nigeria,11/01/2006,5,0,2,0,-4,2,0,5
Nigeria,12/01/2006,3,0,0,0,3,0,0,6
Nigeria,13/01/2006,4,0,1,0,6,0,0,11
Nigeria,14/01/2006,3,0,0,0,3,1,0,7
Nigeria,15/01/2006,4,0,0,0,0,0,0,4
Nigeria,16/01/2006,12,0,0,0,-1,1,0,12
Nigeria,17/01/2006,12,0,0,0,2,1,0,15
Nigeria,18/01/2006,23,0,0,0,0,1,0,24
Nigeria,19/01/2006,17,0,0,0,7,4,0,28
Nigeria,20/01/2006,23,0,0,0,6,3,0,32
Nigeria,21/01/2006,1,0,0,0,7,0,0,8
Nigeria,22/01/2006,6,0,0,0,0,0,0,6
Nigeria,23/01/2006,6,0,0,0,7,1,0,14
Nigeria,24/01/2006,19,0,-10,0,0,0,0,9
Nigeria,25/01/2006,8,0,-2,0,-2,0,0,4
Nigeria,26/01/2006,4,0,0,0,3,0,0,7
Nigeria,27/01/2006,13,0,0,0,11,6,0,30
Nigeria,28/01/2006,-1,0,0,0,3,2,0,4
Nigeria,29/01/2006,2,0,0,0,-2,0,0,0
Nigeria,30/01/2006,14,0,0,0,1,0,0,15
Nigeria,31/01/2006,9,0,1,0,6,0,0,16
Pakistan,01/01/2006,3,0,0,0,6,0,0,9
Pakistan,02/01/2006,8,0,0,0,1,0,0,9
Pakistan,03/01/2006,5,0,0,0,9,0,0,14
Pakistan,04/01/2006,9,0,0,0,5,0,0,14
Pakistan,05/01/2006,5,0,0,0,3,0,0,8
Pakistan,06/01/2006,1,0,0,0,7,3,0,11
Pakistan,07/01/2006,1,0,0,0,0,0,0,1
Pakistan,08/01/2006,-1,0,0,0,-2,0,0,-3
Pakistan,09/01/2006,10,6,0,0,9,0,0,25
Pakistan,10/01/2006,6,0,-8,0,3,0,0,1
Pakistan,11/01/2006,5,0,-8,0,3,0,0,0
Pakistan,12/01/2006,9,0,0,0,0,0,0,9
Pakistan,13/01/2006,37,0,0,0,13,0,0,50
Pakistan,14/01/2006,44,0,0,0,0,7,0,51
Pakistan,15/01/2006,22,0,0,0,0,0,0,22
Pakistan,16/01/2006,23,0,0,0,3,2,0,28
Pakistan,17/01/2006,8,0,0,0,1,0,0,9
Pakistan,18/01/2006,12,0,0,0,-4,2,0,10
Pakistan,19/01/2006,26,0,1,0,6,2,0,35
Pakistan,20/01/2006,7,0,0,0,0,0,0,7
Pakistan,21/01/2006,9,0,0,0,9,3,0,21
Pakistan,22/01/2006,17,0,0,0,0,6,0,23
Pakistan,23/01/2006,11,2,0,0,9,5,0,27
Pakistan,24/01/2006,1,0,0,0,0,0,0,1
Pakistan,25/01/2006,30,0,0,0,3,9,0,42
Pakistan,26/01/2006,17,0,0,0,21,0,0,38
Pakistan,27/01/2006,7,0,0,0,0,0,0,7
Pakistan,28/01/2006,4,0,0,0,0,0,0,4
Pakistan,29/01/2006,18,0,0,0,9,0,0,27
Pakistan,30/01/2006,18,0,0,0,-4,5,0,19
Pakistan,31/01/2006,5,0,0,0,14,0,0,19
Sierra Leone,03/01/2006,3,0,0,0,0,0,0,3
Sierra Leone,04/01/2006,0,0,0,0,0,0,0,0
Sierra Leone,05/01/2006,2,0,0,0,0,0,0,2
Sierra Leone,06/01/2006,0,0,0,0,0,0,0,0
Sierra Leone,07/01/2006,0,0,0,0,0,0,0,0
Sierra Leone,09/01/2006,4,0,0,0,0,0,0,4
Sierra Leone,11/01/2006,0,0,0,0,3,0,0,3
Sierra Leone,12/01/2006,0,0,0,0,0,0,0,0
Sierra Leone,13/01/2006,4,0,0,0,0,0,0,4
Sierra Leone,14/01/2006,0,0,0,0,0,0,0,0
Sierra Leone,15/01/2006,0,0,0,0,0,0,0,0
Sierra Leone,16/01/2006,0,0,2,0,0,2,0,4
Sierra Leone,17/01/2006,0,0,0,0,-2,0,0,-2
Sierra Leone,18/01/2006,1,0,0,0,13,0,0,14
Sierra Leone,19/01/2006,0,0,0,0,3,0,0,3
Sierra Leone,20/01/2006,3,0,0,0,12,0,0,15
Sierra Leone,21/01/2006,0,0,0,0,0,0,0,0
Sierra Leone,23/01/2006,3,0,1,0,3,0,0,7
Sierra Leone,24/01/2006,0,0,0,0,0,0,0,0
Sierra Leone,25/01/2006,0,0,0,0,9,0,0,9
Sierra Leone,26/01/2006,4,0,0,0,3,0,0,7
Sierra Leone,27/01/2006,5,0,0,0,3,1,0,9
Sierra Leone,29/01/2006,2,0,0,0,0,0,0,2
Sierra Leone,30/01/2006,-2,0,0,0,0,0,0,-2
Sierra Leone,31/01/2006,3,0,0,0,0,0,0,3
Somalia,02/01/2006,38,0,0,0,0,0,0,38
Somalia,03/01/2006,3,0,0,0,0,0,0,3
Somalia,04/01/2006,27,0,0,0,0,0,0,27
Somalia,05/01/2006,2,0,0,0,0,1,0,3
Somalia,06/01/2006,0,0,0,0,0,0,0,0
Somalia,07/01/2006,5,0,0,0,27,0,0,32
Somalia,08/01/2006,0,0,0,0,0,0,0,0
Somalia,09/01/2006,-4,0,0,0,0,0,0,-4
Somalia,10/01/2006,1,0,0,0,0,3,0,4
Somalia,11/01/2006,2,0,0,0,-4,0,0,-2
Somalia,12/01/2006,0,0,0,0,0,0,0,0
Somalia,13/01/2006,2,2,0,0,0,0,0,4
Somalia,14/01/2006,0,0,0,0,0,0,0,0
Somalia,15/01/2006,0,0,0,0,3,0,0,3
Somalia,16/01/2006,0,2,0,0,3,0,0,5
Somalia,17/01/2006,7,0,0,0,6,0,0,13
Somalia,18/01/2006,0,0,0,0,5,0,0,5
Somalia,19/01/2006,3,2,0,0,0,0,0,5
Somalia,20/01/2006,9,0,0,0,0,1,0,10
Somalia,21/01/2006,4,0,0,0,0,0,0,4
Somalia,22/01/2006,0,0,0,0,3,0,0,3
Somalia,23/01/2006,17,0,0,0,-8,0,0,9
Somalia,24/01/2006,3,0,0,0,0,2,0,5
Somalia,25/01/2006,3,2,0,0,0,0,0,5
Somalia,26/01/2006,4,0,0,0,-2,0,0,2
Somalia,27/01/2006,0,0,0,0,-2,0,0,-2
Somalia,28/01/2006,0,0,0,0,0,0,0,0
Somalia,29/01/2006,6,0,0,0,3,0,0,9
Somalia,30/01/2006,1,0,0,0,-2,0,0,-1
Somalia,31/01/2006,4,0,0,0,3,0,0,7
Syria,01/01/2006,1,0,0,0,15,0,0,16
Syria,02/01/2006,10,0,-2,0,-2,0,0,6
Syria,03/01/2006,23,0,0,0,3,0,0,26
Syria,04/01/2006,6,0,1,0,0,0,0,7
Syria,05/01/2006,2,0,-4,0,9,0,0,7
Syria,06/01/2006,-4,0,0,0,3,0,0,-1
Syria,07/01/2006,8,0,0,0,3,0,0,11
Syria,08/01/2006,-1,0,0,0,0,0,0,-1
Syria,09/01/2006,17,0,0,0,0,0,0,17
Syria,10/01/2006,9,0,0,0,4,1,0,14
Syria,11/01/2006,25,0,0,0,6,0,0,31
Syria,12/01/2006,15,0,0,0,3,0,0,18
Syria,13/01/2006,3,0,0,0,1,4,0,8
Syria,14/01/2006,0,0,-6,0,1,4,0,-1
Syria,15/01/2006,1,0,0,0,0,0,0,1
Syria,16/01/2006,2,0,0,0,0,0,0,2
Syria,17/01/2006,8,0,0,0,1,0,0,9
Syria,18/01/2006,9,0,0,0,0,0,0,9
Syria,19/01/2006,0,0,0,0,1,1,0,2
Syria,20/01/2006,0,0,0,0,0,1,0,1
Syria,21/01/2006,2,0,0,0,0,0,0,2
Syria,22/01/2006,11,2,-4,0,3,-2,0,10
Syria,23/01/2006,4,0,0,0,0,0,0,4
Syria,24/01/2006,3,0,0,0,0,0,0,3
Syria,25/01/2006,0,0,0,0,0,1,0,1
Syria,26/01/2006,2,0,0,0,12,0,0,14
Syria,27/01/2006,2,0,5,0,17,0,0,24
Syria,28/01/2006,4,0,0,0,0,1,0,5
Syria,29/01/2006,6,0,0,0,0,0,0,6
Syria,30/01/2006,0,0,0,0,0,0,0,0
Yemen,01/01/2006,0,0,0,0,5,0,0,5
Yemen,02/01/2006,1,0,0,0,2,0,0,3
Yemen,03/01/2006,7,0,0,0,6,0,0,13
Yemen,04/01/2006,-1,0,0,0,0,0,0,-1
Yemen,05/01/2006,-5,0,0,0,0,0,0,-5
Yemen,06/01/2006,12,4,0,0,-2,0,0,14
Yemen,07/01/2006,0,0,0,0,0,0,0,0
Yemen,08/01/2006,0,0,0,0,0,0,0,0
Yemen,09/01/2006,0,0,0,0,0,3,0,3
Yemen,10/01/2006,1,0,0,0,12,0,0,13
Yemen,11/01/2006,7,0,0,0,0,1,0,8
Yemen,12/01/2006,3,0,0,0,9,0,0,12
Yemen,13/01/2006,1,0,0,0,0,0,0,1
Yemen,14/01/2006,6,0,0,0,0,0,0,6
Yemen,15/01/2006,0,0,0,0,0,0,0,0
Yemen,16/01/2006,-1,0,0,0,0,0,0,-1
Yemen,17/01/2006,0,0,0,0,0,0,0,0
Yemen,18/01/2006,6,0,0,0,-2,0,0,4
Yemen,19/01/2006,13,0,0,0,0,9,0,22
Yemen,20/01/2006,0,0,0,0,0,0,0,0
Yemen,21/01/2006,0,0,0,0,0,0,0,0
Yemen,22/01/2006,0,0,0,0,6,0,0,6
Yemen,23/01/2006,0,0,0,0,1,0,0,1
Yemen,24/01/2006,0,0,0,0,0,0,0,0
Yemen,25/01/2006,-1,0,0,0,0,0,0,-1
Yemen,26/01/2006,0,0,0,0,0,0,0,0
Yemen,28/01/2006,0,0,0,0,0,0,0,0
Yemen,29/01/2006,0,0,0,0,0,0,0,0
Yemen,30/01/2006,0,0,0,0,0,0,0,0
Afghanistan,01/02/2006,16,2,0,0,12,3,0,33
Afghanistan,02/02/2006,13,2,0,0,3,2,0,20
Afghanistan,03/02/2006,28,0,0,0,14,7,0,49
Afghanistan,04/02/2006,18,0,0,0,0,4,0,22
Afghanistan,05/02/2006,19,0,0,0,10,8,0,37
Afghanistan,06/02/2006,11,0,0,0,13,8,0,32
Afghanistan,07/02/2006,30,0,0,0,21,17,0,68
Afghanistan,08/02/2006,13,0,0,0,30,9,0,52
Afghanistan,09/02/2006,52,0,0,0,30,15,0,97
Afghanistan,10/02/2006,32,0,0,0,4,4,0,40
Afghanistan,11/02/2006,55,0,0,0,3,2,0,60
Afghanistan,12/02/2006,26,0,0,0,9,2,0,37
Afghanistan,13/02/2006,25,0,0,0,24,2,0,51
Afghanistan,14/02/2006,34,0,0,0,15,0,0,49
Afghanistan,15/02/2006,28,0,0,0,10,0,0,38
Afghanistan,16/02/2006,37,0,0,0,25,6,0,68
Afghanistan,17/02/2006,9,0,0,0,10,2,0,21
Afghanistan,18/02/2006,6,0,0,0,-3,4,0,7
Afghanistan,19/02/2006,20,0,0,0,15,1,0,36
Afghanistan,20/02/2006,11,0,0,0,-3,0,0,8
Afghanistan,21/02/2006,38,0,0,0,13,11,0,62
Afghanistan,22/02/2006,17,0,2,0,0,8,0,27
Afghanistan,23/02/2006,9,0,0,0,15,2,0,26
Afghanistan,24/02/2006,-1,0,0,0,13,0,0,12
Afghanistan,25/02/2006,18,0,0,0,1,2,0,21
Afghanistan,26/02/2006,5,0,0,0,-2,0,0,3
Afghanistan,27/02/2006,16,0,0,0,10,0,0,26
Afghanistan,28/02/2006,17,6,0,0,9,2,0,34
Albania,01/02/2006,2,0,0,0,0,0,0,2
Albania,02/02/2006,0,0,0,0,0,0,0,0
Albania,03/02/2006,9,0,0,0,3,3,0,15
Albania,04/02/2006,3,0,0,0,0,3,0,6
Albania,05/02/2006,8,0,2,0,0,0,0,10
Albania,06/02/2006,0,0,0,0,3,1,0,4
Albania,07/02/2006,1,0,-1,0,0,0,0,0
Albania,08/02/2006,0,0,-6,0,0,1,0,-5
Albania,09/02/2006,0,0,0,0,0,0,0,0
Albania,10/02/2006,4,0,0,0,0,1,0,5
Albania,11/02/2006,2,0,0,0,0,0,0,2
Albania,12/02/2006,0,0,0,0,0,0,0,0
Albania,13/02/2006,2,0,0,0,0,0,0,2
Albania,14/02/2006,2,0,0,0,0,0,0,2
Albania,15/02/2006,12,0,0,0,0,0,0,12
Albania,16/02/2006,19,0,0,0,-2,0,0,17
Albania,17/02/2006,2,0,0,0,0,3,0,5
Albania,18/02/2006,0,0,0,0,4,0,0,4
Albania,19/02/2006,2,0,0,0,0,0,0,2
Albania,20/02/2006,16,0,0,0,3,0,0,19
Albania,21/02/2006,3,0,0,0,6,0,0,9
Albania,22/02/2006,0,0,0,0,0,0,0,0
Albania,23/02/2006,2,4,0,0,7,0,0,13
Albania,24/02/2006,2,0,0,0,-2,0,0,0
Albania,25/02/2006,6,0,-1,0,0,0,0,5
Albania,26/02/2006,3,0,0,0,0,2,0,5
Albania,27/02/2006,17,0,0,0,3,0,0,20
Albania,28/02/2006,17,0,0,0,3,0,0,20
Algeria,01/02/2006,6,0,0,0,0,4,0,10
Algeria,02/02/2006,0,0,1,0,0,0,0,1
Algeria,03/02/2006,0,0,0,0,0,0,0,0
Algeria,04/02/2006,0,0,0,0,0,0,0,0
Algeria,06/02/2006,1,0,0,0,0,2,0,3
Algeria,07/02/2006,-3,0,0,0,0,0,0,-3
Algeria,08/02/2006,1,0,0,0,0,0,0,1
Algeria,09/02/2006,3,0,0,0,0,2,0,5
Algeria,10/02/2006,0,0,0,0,6,0,0,6
Algeria,11/02/2006,-11,0,0,0,0,0,0,-11
Algeria,12/02/2006,2,0,0,0,0,0,0,2
Algeria,13/02/2006,7,0,0,0,-2,1,0,6
Algeria,14/02/2006,7,0,0,0,3,0,0,10
Algeria,16/02/2006,0,0,1,0,0,0,0,1
Algeria,17/02/2006,1,0,0,0,3,1,0,5
Algeria,18/02/2006,0,0,0,0,0,0,0,0
Algeria,19/02/2006,1,0,0,0,-1,1,0,1
Algeria,20/02/2006,6,0,0,0,3,0,0,9
Algeria,21/02/2006,0,0,0,0,0,0,0,0
Algeria,22/02/2006,1,0,-1,0,0,0,0,0
Algeria,23/02/2006,9,0,0,0,12,0,0,21
Algeria,24/02/2006,0,0,0,0,0,0,0,0
Algeria,25/02/2006,1,0,0,0,0,0,0,1
Algeria,27/02/2006,40,0,0,0,3,0,0,43
Bangladesh,01/02/2006,7,0,0,0,3,0,0,10
Bangladesh,02/02/2006,0,0,0,0,9,2,0,11
Bangladesh,03/02/2006,0,0,0,0,0,1,0,1
Bangladesh,04/02/2006,0,0,0,0,0,1,0,1
Bangladesh,05/02/2006,0,0,0,0,0,0,0,0
Bangladesh,06/02/2006,6,0,0,0,3,2,0,11
Bangladesh,07/02/2006,3,0,1,0,0,0,0,4
Bangladesh,08/02/2006,0,0,0,0,0,0,0,0
Bangladesh,09/02/2006,12,0,0,0,6,0,0,18
Bangladesh,10/02/2006,0,0,0,0,0,2,0,2
Bangladesh,11/02/2006,0,0,0,0,0,1,0,1
Bangladesh,12/02/2006,0,0,0,0,0,3,0,3
Bangladesh,13/02/2006,-1,0,0,0,6,0,0,5
Bangladesh,14/02/2006,6,0,0,0,0,1,0,7
Bangladesh,15/02/2006,2,0,0,0,6,0,0,8
Bangladesh,16/02/2006,0,0,0,0,0,1,0,1
Bangladesh,17/02/2006,4,0,0,0,6,0,0,10
Bangladesh,18/02/2006,0,0,0,0,0,0,0,0
Bangladesh,19/02/2006,13,2,0,0,3,1,0,19
Bangladesh,20/02/2006,0,0,0,0,9,4,0,13
Bangladesh,21/02/2006,6,0,0,0,1,0,0,7
Bangladesh,22/02/2006,2,0,0,0,0,0,0,2
Bangladesh,24/02/2006,0,0,0,0,15,0,0,15
Bangladesh,25/02/2006,9,0,0,0,0,0,0,9
Bangladesh,27/02/2006,0,0,0,0,-2,0,0,-2
Bangladesh,28/02/2006,2,0,0,0,3,0,0,5
Cameroon,01/02/2006,2,0,0,0,0,0,0,2
Cameroon,02/02/2006,0,0,0,0,-4,1,0,-3
Cameroon,03/02/2006,10,0,0,0,0,1,0,11
Cameroon,04/02/2006,0,0,0,0,0,0,0,0
Cameroon,05/02/2006,3,0,0,0,3,0,0,6
Cameroon,06/02/2006,2,0,0,0,-1,0,0,1
Cameroon,07/02/2006,0,0,0,0,0,0,0,0
Cameroon,08/02/2006,0,0,0,0,0,0,0,0
Cameroon,09/02/2006,0,0,0,0,0,0,0,0
Cameroon,10/02/2006,7,2,0,0,0,0,0,9
Cameroon,12/02/2006,2,0,0,0,9,0,0,11
Cameroon,13/02/2006,0,2,0,0,0,0,0,2
Cameroon,14/02/2006,5,0,0,0,2,0,0,7
Cameroon,15/02/2006,0,0,0,0,0,0,0,0
Cameroon,16/02/2006,0,0,0,0,0,0,0,0
Cameroon,17/02/2006,0,0,0,0,0,0,0,0
Cameroon,18/02/2006,0,0,0,0,0,1,0,1
Cameroon,19/02/2006,0,0,0,0,0,0,0,0
Cameroon,20/02/2006,0,0,0,0,0,0,0,0
Cameroon,21/02/2006,0,0,0,0,0,0,0,0
Cameroon,22/02/2006,0,0,0,0,0,0,0,0
Cameroon,23/02/2006,3,0,0,0,0,0,0,3
Cameroon,25/02/2006,0,0,0,0,0,0,0,0
Cameroon,27/02/2006,2,0,0,0,0,0,0,2
Cameroon,28/02/2006,0,0,0,0,0,0,0,0
China,01/02/2006,-10,0,0,0,3,0,0,-7
China,02/02/2006,11,0,0,0,11,3,0,25
China,03/02/2006,13,0,0,0,-3,0,0,10
China,04/02/2006,3,0,0,0,3,3,0,9
China,05/02/2006,5,0,0,0,3,0,0,8
China,06/02/2006,30,0,0,0,4,2,0,36
China,07/02/2006,49,0,0,0,4,2,0,55
China,08/02/2006,15,0,0,0,36,0,0,51
China,09/02/2006,1,0,1,0,22,0,0,24
China,10/02/2006,21,0,0,0,6,6,0,33
China,11/02/2006,15,0,0,0,4,0,0,19
China,12/02/2006,5,2,0,0,18,1,0,26
China,13/02/2006,20,8,0,0,18,5,0,51
China,14/02/2006,19,0,0,0,11,6,0,36
China,15/02/2006,58,0,1,0,15,6,0,80
China,16/02/2006,49,0,-1,0,19,4,0,71
China,17/02/2006,25,0,1,0,22,0,0,48
China,18/02/2006,20,0,0,0,5,0,0,25
China,19/02/2006,28,2,0,0,-1,0,0,29
China,20/02/2006,18,0,0,0,16,0,0,34
China,21/02/2006,30,0,-1,0,11,13,0,53
China,22/02/2006,26,0,-2,0,14,4,0,42
China,23/02/2006,19,0,0,0,4,4,0,27
China,24/02/2006,24,0,1,0,9,3,0,37
China,25/02/2006,8,0,1,0,3,1,0,13
China,26/02/2006,7,0,-1,0,0,2,0,8
China,27/02/2006,18,0,0,0,33,1,0,52
China,28/02/2006,24,0,0,0,18,3,0,45
Egypt,01/02/2006,10,0,0,0,9,0,0,19
Egypt,02/02/2006,2,0,0,0,9,0,0,11
Egypt,03/02/2006,14,0,0,0,9,3,0,26
Egypt,04/02/2006,1,0,0,0,6,0,0,7
Egypt,05/02/2006,2,0,-2,0,0,0,0,0
Egypt,06/02/2006,6,0,0,0,0,2,0,8
Egypt,07/02/2006,-2,2,0,0,18,6,0,24
Egypt,08/02/2006,0,0,0,0,0,2,0,2
Egypt,09/02/2006,30,0,0,0,35,3,0,68
Egypt,10/02/2006,23,0,0,0,61,14,0,98
Egypt,11/02/2006,30,0,0,0,51,4,0,85
Egypt,12/02/2006,-1,0,0,0,0,2,0,1
Egypt,13/02/2006,9,0,0,0,0,0,0,9
Egypt,14/02/2006,10,0,0,0,0,0,0,10
Egypt,15/02/2006,2,0,0,0,0,0,0,2
Egypt,16/02/2006,1,0,0,0,3,2,0,6
Egypt,17/02/2006,1,0,0,0,0,0,0,1
Egypt,18/02/2006,0,0,0,0,3,0,0,3
Egypt,19/02/2006,5,0,-6,0,0,1,0,0
Egypt,20/02/2006,6,0,0,0,0,0,0,6
Egypt,21/02/2006,3,0,0,0,0,0,0,3
Egypt,22/02/2006,15,0,0,0,0,0,0,15
Egypt,23/02/2006,2,0,0,0,0,0,0,2
Egypt,24/02/2006,1,0,0,0,7,0,0,8
Egypt,25/02/2006,0,0,0,0,0,0,0,0
Egypt,26/02/2006,0,0,0,0,1,0,0,1
Egypt,27/02/2006,-1,0,0,0,3,0,0,2
Egypt,28/02/2006,9,0,0,0,0,0,0,9
Eritrea,01/02/2006,0,0,0,0,0,0,0,0
Eritrea,02/02/2006,7,0,0,0,0,0,0,7
Eritrea,04/02/2006,0,0,0,0,0,0,0,0
Eritrea,05/02/2006,0,0,0,0,0,0,0,0
Eritrea,06/02/2006,10,0,0,0,3,0,0,13
Eritrea,07/02/2006,6,0,0,0,0,0,0,6
Eritrea,08/02/2006,0,0,0,0,0,0,0,0
Eritrea,09/02/2006,-1,0,0,0,0,0,0,-1
Eritrea,10/02/2006,0,0,0,0,0,0,0,0
Eritrea,11/02/2006,0,0,0,0,0,4,0,4
Eritrea,12/02/2006,0,0,0,0,0,0,0,0
Eritrea,14/02/2006,0,0,0,0,3,0,0,3
Eritrea,15/02/2006,0,0,0,0,0,0,0,0
Eritrea,16/02/2006,3,0,0,0,0,0,0,3
Eritrea,18/02/2006,75,0,0,0,0,0,0,75
Eritrea,19/02/2006,63,0,0,0,0,0,0,63
Eritrea,20/02/2006,66,0,0,0,0,0,0,66
Eritrea,21/02/2006,3,0,0,0,0,0,0,3
Eritrea,22/02/2006,5,0,0,0,0,0,0,5
Eritrea,23/02/2006,2,0,0,0,0,0,0,2
Eritrea,24/02/2006,-2,0,0,0,0,0,0,-2
Eritrea,25/02/2006,0,0,0,0,0,0,0,0
Eritrea,28/02/2006,0,0,0,0,0,0,0,0
Georgia,01/02/2006,4,0,1,0,0,0,0,5
Georgia,02/02/2006,0,0,0,0,-2,0,0,-2
Georgia,03/02/2006,-8,0,0,0,0,0,0,-8
Georgia,04/02/2006,10,0,0,0,6,0,0,16
Georgia,05/02/2006,0,0,0,0,3,0,0,3
Georgia,06/02/2006,0,0,0,0,0,0,0,0
Georgia,07/02/2006,0,0,0,0,0,0,0,0
Georgia,08/02/2006,0,0,0,0,0,0,0,0
Georgia,09/02/2006,-3,0,0,0,3,0,0,0
Georgia,10/02/2006,1,0,0,0,0,2,0,3
Georgia,11/02/2006,0,0,0,0,3,2,0,5
Georgia,13/02/2006,3,0,0,0,0,1,0,4
Georgia,14/02/2006,2,0,0,0,0,0,0,2
Georgia,16/02/2006,1,0,0,0,0,0,0,1
Georgia,17/02/2006,3,0,0,0,0,0,0,3
Georgia,19/02/2006,0,0,0,0,0,0,0,0
Georgia,20/02/2006,3,0,0,0,6,0,0,9
Georgia,21/02/2006,0,0,0,0,0,0,0,0
Georgia,22/02/2006,0,0,0,0,0,0,0,0
Georgia,23/02/2006,1,0,0,0,0,0,0,1
Georgia,24/02/2006,0,0,0,0,0,0,0,0
Georgia,26/02/2006,0,0,0,0,3,0,0,3
Georgia,27/02/2006,4,0,1,0,0,0,0,5
Georgia,28/02/2006,1,0,1,0,0,0,0,2
India,01/02/2006,5,0,0,0,0,0,0,5
India,02/02/2006,0,2,0,0,0,0,0,2
India,03/02/2006,1,0,0,0,0,0,0,1
India,04/02/2006,3,0,0,0,0,0,0,3
India,05/02/2006,5,0,0,0,2,1,0,8
India,06/02/2006,-1,0,0,0,3,0,0,2
India,07/02/2006,7,0,0,0,6,4,0,17
India,08/02/2006,-1,0,0,0,0,0,0,-1
India,09/02/2006,0,0,0,0,0,0,0,0
India,11/02/2006,0,0,1,0,0,2,0,3
India,12/02/2006,8,0,0,0,0,0,0,8
India,13/02/2006,1,0,0,0,0,0,0,1
India,14/02/2006,3,0,0,0,6,1,0,10
India,15/02/2006,7,0,0,0,0,2,0,9
India,16/02/2006,-1,0,0,0,3,1,0,3
India,17/02/2006,0,0,0,0,0,0,0,0
India,18/02/2006,2,0,0,0,6,0,0,8
India,19/02/2006,6,0,0,0,0,0,0,6
India,20/02/2006,16,0,0,0,6,0,0,22
India,21/02/2006,-1,0,0,0,0,0,0,-1
India,22/02/2006,4,6,0,0,0,3,0,13
India,23/02/2006,1,0,0,0,0,0,0,1
India,24/02/2006,0,0,0,0,0,0,0,0
India,25/02/2006,1,0,0,0,3,0,0,4
India,26/02/2006,0,0,0,0,0,0,0,0
India,27/02/2006,1,0,0,0,-1,2,0,2
India,28/02/2006,15,0,0,0,6,0,0,21
Iran,01/02/2006,34,0,1,0,7,0,0,42
Iran,02/02/2006,14,0,2,0,4,2,0,22
Iran,03/02/2006,16,0,0,0,1,3,0,20
Iran,04/02/2006,28,0,0,0,3,5,0,36
Iran,05/02/2006,18,0,2,0,1,12,0,33
Iran,06/02/2006,47,0,3,0,5,7,0,62
Iran,07/02/2006,32,0,0,0,10,9,0,51
Iran,08/02/2006,14,0,-4,0,12,0,0,22
Iran,09/02/2006,26,0,0,0,12,9,0,47
Iran,10/02/2006,10,0,2,0,21,6,0,39
Iran,11/02/2006,6,0,0,0,-4,0,0,2
Iran,12/02/2006,29,0,1,0,3,3,0,36
Iran,13/02/2006,21,0,0,0,2,1,0,24
Iran,14/02/2006,38,0,3,0,10,3,0,54
Iran,15/02/2006,19,2,2,0,21,3,0,47
Iran,16/02/2006,33,0,0,0,4,0,0,37
Iran,17/02/2006,-2,4,1,0,0,1,0,4
Iran,18/02/2006,8,0,0,0,0,10,0,18
Iran,19/02/2006,5,0,3,0,0,3,0,11
Iran,20/02/2006,23,6,0,0,9,3,0,41
Iran,21/02/2006,28,0,0,0,7,1,0,36
Iran,22/02/2006,22,0,0,0,7,3,0,32
Iran,23/02/2006,36,0,1,0,3,3,0,43
Iran,24/02/2006,-7,0,0,0,1,0,0,-6
Iran,25/02/2006,6,0,1,0,0,2,0,9
Iran,26/02/2006,16,0,1,0,1,2,0,20
Iran,27/02/2006,10,0,2,0,3,3,0,18
Iran,28/02/2006,23,0,0,0,2,2,0,27
Iraq,01/02/2006,55,0,1,0,49,14,0,119
Iraq,02/02/2006,33,2,1,0,3,4,0,43
Iraq,03/02/2006,50,0,1,0,10,0,0,61
Iraq,04/02/2006,43,0,0,0,7,6,0,56
Iraq,05/02/2006,30,0,0,0,3,2,0,35
Iraq,06/02/2006,28,8,0,0,19,3,0,58
Iraq,07/02/2006,63,2,1,0,22,3,0,91
Iraq,08/02/2006,36,0,0,0,34,3,0,73
Iraq,09/02/2006,45,0,-2,0,11,4,0,58
Iraq,10/02/2006,14,0,2,0,9,2,0,27
Iraq,11/02/2006,81,0,1,0,23,0,0,105
Iraq,12/02/2006,37,0,0,0,0,22,0,59
Iraq,13/02/2006,46,2,0,0,19,4,0,71
Iraq,14/02/2006,37,0,0,0,46,3,0,86
Iraq,15/02/2006,34,0,-1,0,88,7,0,128
Iraq,16/02/2006,54,0,0,0,33,5,0,92
Iraq,17/02/2006,59,0,0,0,23,4,0,86
Iraq,18/02/2006,9,0,0,0,9,0,0,18
Iraq,19/02/2006,17,0,0,0,7,4,0,28
Iraq,20/02/2006,20,4,1,0,29,2,0,56
Iraq,21/02/2006,21,0,0,0,34,17,0,72
Iraq,22/02/2006,29,0,0,0,6,9,0,44
Iraq,23/02/2006,46,0,0,0,14,2,0,62
Iraq,24/02/2006,75,0,0,0,21,21,0,117
Iraq,25/02/2006,43,0,0,0,9,9,0,61
Iraq,26/02/2006,35,0,1,0,1,6,0,43
Iraq,27/02/2006,59,0,0,0,28,6,0,93
Iraq,28/02/2006,123,0,1,0,53,6,0,183
Morocco,01/02/2006,0,0,0,0,0,0,0,0
Morocco,02/02/2006,2,0,1,0,18,0,0,21
Morocco,03/02/2006,0,0,0,0,3,0,0,3
Morocco,05/02/2006,1,0,0,0,9,0,0,10
Morocco,06/02/2006,0,0,0,0,0,0,0,0
Morocco,07/02/2006,2,0,0,0,12,0,0,14
Morocco,08/02/2006,3,0,0,0,17,0,0,20
Morocco,09/02/2006,0,0,0,0,0,0,0,0
Morocco,10/02/2006,0,0,0,0,0,0,0,0
Morocco,11/02/2006,-6,0,0,0,0,0,0,-6
Morocco,12/02/2006,6,0,0,0,-10,0,0,-4
Morocco,13/02/2006,4,0,0,0,6,0,0,10
Morocco,14/02/2006,1,0,0,0,0,0,0,1
Morocco,15/02/2006,1,0,0,0,0,0,0,1
Morocco,16/02/2006,-5,0,-1,0,0,0,0,-6
Morocco,17/02/2006,-1,0,0,0,3,0,0,2
Morocco,18/02/2006,0,0,0,0,0,0,0,0
Morocco,19/02/2006,0,2,0,0,0,0,0,2
Morocco,20/02/2006,2,0,0,0,0,0,0,2
Morocco,21/02/2006,-2,0,0,0,0,4,0,2
Morocco,22/02/2006,2,0,0,0,0,0,0,2
Morocco,23/02/2006,3,0,0,0,0,0,0,3
Morocco,24/02/2006,3,0,0,0,2,0,0,5
Morocco,26/02/2006,0,0,0,0,0,0,0,0
Morocco,27/02/2006,-1,0,0,0,0,0,0,-1
Morocco,28/02/2006,2,0,0,0,0,0,0,2
Nigeria,01/02/2006,10,0,0,0,-2,0,0,8
Nigeria,02/02/2006,10,0,1,0,4,2,0,17
Nigeria,03/02/2006,26,0,1,0,3,0,0,30
Nigeria,04/02/2006,0,0,0,0,-1,0,0,-1
Nigeria,05/02/2006,5,0,0,0,2,0,0,7
Nigeria,06/02/2006,19,0,0,0,3,3,0,25
Nigeria,07/02/2006,19,0,0,0,6,7,0,32
Nigeria,08/02/2006,15,0,1,0,3,5,0,24
Nigeria,09/02/2006,3,0,0,0,0,0,0,3
Nigeria,10/02/2006,24,0,2,0,2,0,0,28
Nigeria,11/02/2006,-1,0,0,0,0,2,0,1
Nigeria,12/02/2006,11,0,0,0,3,0,0,14
Nigeria,13/02/2006,16,0,-2,0,0,0,0,14
Nigeria,14/02/2006,1,4,0,0,7,0,0,12
Nigeria,15/02/2006,4,0,1,0,10,3,0,18
Nigeria,16/02/2006,13,0,0,0,0,0,0,13
Nigeria,17/02/2006,25,0,0,0,0,0,0,25
Nigeria,18/02/2006,4,0,0,0,0,0,0,4
Nigeria,19/02/2006,6,0,-2,0,0,0,0,4
Nigeria,20/02/2006,22,0,2,0,9,9,0,42
Nigeria,21/02/2006,3,0,-3,0,6,0,0,6
Nigeria,22/02/2006,2,0,1,0,6,2,0,11
Nigeria,23/02/2006,1,0,0,0,16,0,0,17
Nigeria,24/02/2006,16,0,0,0,6,7,0,29
Nigeria,25/02/2006,2,0,0,0,-2,0,0,0
Nigeria,26/02/2006,1,0,0,0,0,0,0,1
Nigeria,27/02/2006,22,0,0,0,1,3,0,26
Nigeria,28/02/2006,16,0,0,0,0,2,0,18
Pakistan,01/02/2006,8,0,0,0,3,1,0,12
Pakistan,02/02/2006,9,0,0,0,9,5,0,23
Pakistan,03/02/2006,6,0,0,0,18,2,0,26
Pakistan,04/02/2006,19,0,0,0,0,2,0,21
Pakistan,05/02/2006,3,4,0,0,-8,7,0,6
Pakistan,06/02/2006,8,0,0,0,9,7,0,24
Pakistan,07/02/2006,6,0,0,0,12,6,0,24
Pakistan,08/02/2006,30,0,0,0,27,8,0,65
Pakistan,09/02/2006,29,0,0,0,15,4,0,48
Pakistan,10/02/2006,9,0,0,0,3,0,0,12
Pakistan,11/02/2006,17,0,0,0,0,0,0,17
Pakistan,12/02/2006,0,0,0,0,-1,0,0,-1
Pakistan,13/02/2006,35,0,0,0,0,11,0,46
Pakistan,14/02/2006,9,0,0,0,10,3,0,22
Pakistan,15/02/2006,28,0,0,0,34,1,0,63
Pakistan,16/02/2006,20,0,0,0,25,5,0,50
Pakistan,17/02/2006,27,0,0,0,-1,1,0,27
Pakistan,18/02/2006,0,0,0,0,0,0,0,0
Pakistan,19/02/2006,25,0,0,0,0,3,0,28
Pakistan,20/02/2006,34,0,0,0,3,5,0,42
Pakistan,21/02/2006,9,0,0,0,9,2,0,20
Pakistan,22/02/2006,24,0,0,0,3,0,0,27
Pakistan,23/02/2006,2,0,0,0,0,0,0,2
Pakistan,24/02/2006,3,0,0,0,21,1,0,25
Pakistan,25/02/2006,1,0,0,0,1,2,0,4
Pakistan,26/02/2006,11,0,-1,0,7,0,0,17
Pakistan,27/02/2006,10,0,0,0,27,2,0,39
Pakistan,28/02/2006,14,0,0,0,0,0,0,14
Sierra Leone,01/02/2006,5,0,-6,0,3,0,0,2
Sierra Leone,02/02/2006,9,0,0,0,0,0,0,9
Sierra Leone,03/02/2006,0,0,0,0,0,0,0,0
Sierra Leone,07/02/2006,9,0,0,0,18,1,0,28
Sierra Leone,08/02/2006,0,0,0,0,0,0,0,0
Sierra Leone,09/02/2006,5,0,0,0,3,1,0,9
Sierra Leone,10/02/2006,10,0,0,0,6,0,0,16
Sierra Leone,13/02/2006,0,0,0,0,0,0,0,0
Sierra Leone,14/02/2006,0,0,0,0,1,0,0,1
Sierra Leone,15/02/2006,6,0,0,0,0,0,0,6
Sierra Leone,16/02/2006,0,0,0,0,0,0,0,0
Sierra Leone,17/02/2006,0,0,0,0,0,0,0,0
Sierra Leone,20/02/2006,0,0,0,0,0,0,0,0
Sierra Leone,21/02/2006,1,0,0,0,0,0,0,1
Sierra Leone,22/02/2006,0,0,0,0,0,0,0,0
Sierra Leone,23/02/2006,5,0,0,0,0,0,0,5
Sierra Leone,24/02/2006,2,0,0,0,0,0,0,2
Sierra Leone,27/02/2006,0,0,0,0,0,0,0,0
Somalia,01/02/2006,0,0,0,0,3,0,0,3
Somalia,02/02/2006,0,0,0,0,-1,0,0,-1
Somalia,03/02/2006,5,0,0,0,15,3,0,23
Somalia,04/02/2006,0,0,0,0,0,0,0,0
Somalia,05/02/2006,0,0,0,0,0,0,0,0
Somalia,06/02/2006,27,0,0,0,6,12,0,45
Somalia,07/02/2006,6,0,0,0,0,1,0,7
Somalia,08/02/2006,2,0,0,0,3,0,0,5
Somalia,09/02/2006,2,0,0,0,0,0,0,2
Somalia,10/02/2006,6,0,0,0,0,0,0,6
Somalia,11/02/2006,0,0,0,0,6,0,0,6
Somalia,12/02/2006,3,0,0,0,3,1,0,7
Somalia,13/02/2006,3,0,0,0,0,2,0,5
Somalia,14/02/2006,9,0,0,0,6,0,0,15
Somalia,15/02/2006,9,0,0,0,6,0,0,15
Somalia,16/02/2006,3,2,0,0,0,0,0,5
Somalia,17/02/2006,0,0,0,0,3,0,0,3
Somalia,18/02/2006,27,0,0,0,0,2,0,29
Somalia,19/02/2006,27,0,0,0,6,3,0,36
Somalia,20/02/2006,24,0,0,0,6,0,0,30
Somalia,21/02/2006,2,0,0,0,0,0,0,2
Somalia,22/02/2006,7,0,0,0,0,0,0,7
Somalia,23/02/2006,2,4,0,0,0,0,0,6
Somalia,24/02/2006,1,0,1,0,15,0,0,17
Somalia,25/02/2006,3,0,0,0,6,0,0,9
Somalia,26/02/2006,3,0,0,0,0,1,0,4
Somalia,27/02/2006,4,0,0,0,0,0,0,4
Somalia,28/02/2006,3,0,-2,0,0,0,0,1
Syria,01/02/2006,1,0,0,0,3,0,0,4
Syria,02/02/2006,16,0,0,0,0,7,0,23
Syria,03/02/2006,7,0,0,0,0,3,0,10
Syria,04/02/2006,1,0,0,0,0,4,0,5
Syria,05/02/2006,22,0,-4,0,9,5,0,32
Syria,06/02/2006,14,0,0,0,30,13,0,57
Syria,07/02/2006,6,0,0,0,-2,6,0,10
Syria,08/02/2006,3,0,0,0,0,0,0,3
Syria,09/02/2006,4,0,0,0,0,10,0,14
Syria,10/02/2006,1,0,0,0,9,0,0,10
Syria,11/02/2006,-1,0,0,0,17,3,0,19
Syria,12/02/2006,5,0,-2,0,4,0,0,7
Syria,13/02/2006,8,0,0,0,1,5,0,14
Syria,14/02/2006,23,0,-4,0,6,2,0,27
Syria,15/02/2006,3,0,-4,0,15,3,0,17
Syria,16/02/2006,2,0,-3,0,33,1,0,33
Syria,17/02/2006,1,0,0,0,21,1,0,23
Syria,18/02/2006,13,0,0,0,0,2,0,15
Syria,19/02/2006,9,0,0,0,2,2,0,13
Syria,20/02/2006,8,0,-2,0,6,0,0,12
Syria,21/02/2006,4,0,0,0,0,0,0,4
Syria,22/02/2006,-10,0,0,0,0,0,0,-10
Syria,23/02/2006,5,0,-6,0,3,0,0,2
Syria,24/02/2006,3,0,0,0,3,2,0,8
Syria,25/02/2006,0,0,0,0,0,0,0,0
Syria,26/02/2006,0,0,0,0,4,0,0,4
Syria,27/02/2006,3,0,0,0,0,0,0,3
Syria,28/02/2006,7,0,0,0,-2,5,0,10
Yemen,01/02/2006,-1,0,0,0,0,0,0,-1
Yemen,02/02/2006,0,0,0,0,0,0,0,0
Yemen,03/02/2006,-1,0,0,0,9,0,0,8
Yemen,04/02/2006,0,0,0,0,0,0,0,0
Yemen,05/02/2006,-2,0,0,0,0,0,0,-2
Yemen,06/02/2006,10,0,0,0,10,0,0,20
Yemen,07/02/2006,12,0,0,0,0,4,0,16
Yemen,08/02/2006,2,0,0,0,6,1,0,9
Yemen,09/02/2006,7,0,0,0,10,0,0,17
Yemen,10/02/2006,2,0,0,0,1,0,0,3
Yemen,11/02/2006,1,0,0,0,3,0,0,4
Yemen,12/02/2006,5,0,0,0,9,0,0,14
Yemen,13/02/2006,11,0,0,0,6,0,0,17
Yemen,14/02/2006,7,0,0,0,12,2,0,21
Yemen,15/02/2006,9,0,0,0,21,2,0,32
Yemen,16/02/2006,0,0,0,0,3,0,0,3
Yemen,17/02/2006,3,0,0,0,12,0,0,15
Yemen,18/02/2006,9,0,0,0,0,0,0,9
Yemen,19/02/2006,5,0,0,0,0,0,0,5
Yemen,21/02/2006,0,0,0,0,3,8,0,11
Yemen,22/02/2006,1,0,0,0,3,0,0,4
Yemen,23/02/2006,0,0,0,0,0,0,0,0
Yemen,24/02/2006,6,0,0,0,6,0,0,12
Yemen,25/02/2006,0,0,0,0,0,0,0,0
Yemen,26/02/2006,5,0,0,0,12,0,0,17
Yemen,28/02/2006,6,0,0,0,3,0,0,9
Afghanistan,01/01/2005,5,0,0,0,3,1,0,9
Afghanistan,02/01/2005,43,2,0,0,-4,0,0,41
Afghanistan,03/01/2005,47,0,0,0,3,0,0,50
Afghanistan,04/01/2005,33,0,0,0,3,4,0,40
Afghanistan,05/01/2005,38,0,-2,0,3,0,0,39
Afghanistan,06/01/2005,17,0,0,0,10,0,0,27
Afghanistan,07/01/2005,8,0,0,0,0,0,0,8
Afghanistan,08/01/2005,12,0,0,0,6,0,0,18
Afghanistan,09/01/2005,9,0,0,0,0,0,0,9
Afghanistan,10/01/2005,12,0,0,0,21,2,0,35
Afghanistan,11/01/2005,5,0,0,0,10,1,0,16
Afghanistan,12/01/2005,13,0,0,0,10,1,0,24
Afghanistan,13/01/2005,15,0,0,0,18,3,0,36
Afghanistan,14/01/2005,7,0,0,0,12,0,0,19
Afghanistan,15/01/2005,8,0,0,0,9,8,0,25
Afghanistan,16/01/2005,33,0,0,0,12,1,0,46
Afghanistan,17/01/2005,9,0,0,0,22,0,0,31
Afghanistan,18/01/2005,19,0,0,0,9,0,0,28
Afghanistan,19/01/2005,16,0,0,0,6,2,0,24
Afghanistan,20/01/2005,13,0,0,0,0,3,0,16
Afghanistan,21/01/2005,6,0,0,0,3,0,0,9
Afghanistan,22/01/2005,0,0,0,0,4,0,0,4
Afghanistan,23/01/2005,18,0,0,0,9,6,0,33
Afghanistan,24/01/2005,7,0,0,0,9,1,0,17
Afghanistan,25/01/2005,1,8,0,0,30,0,0,39
Afghanistan,26/01/2005,14,0,0,0,7,2,0,23
Afghanistan,27/01/2005,14,0,1,0,6,0,0,21
Afghanistan,28/01/2005,16,0,0,0,9,4,0,29
Afghanistan,29/01/2005,6,0,0,0,9,2,0,17
Afghanistan,30/01/2005,14,0,0,0,0,0,0,14
Afghanistan,31/01/2005,14,2,0,0,18,1,0,35
Afghanistan,01/02/2005,6,2,0,0,-6,2,0,4
Afghanistan,02/02/2005,9,0,0,0,24,3,0,36
Afghanistan,03/02/2005,10,0,0,0,3,2,0,15
Afghanistan,04/02/2005,17,0,0,0,18,2,0,37
Afghanistan,05/02/2005,12,4,-2,0,5,9,0,28
Afghanistan,06/02/2005,3,0,0,0,0,0,0,3
Afghanistan,07/02/2005,25,2,2,0,1,4,0,34
Afghanistan,08/02/2005,8,0,-4,0,12,2,0,18
Afghanistan,09/02/2005,13,0,0,0,27,0,0,40
Afghanistan,10/02/2005,12,0,0,0,1,3,0,16
Afghanistan,11/02/2005,2,2,0,0,-6,2,0,0
Afghanistan,12/02/2005,4,0,0,0,0,4,0,8
Afghanistan,13/02/2005,14,0,0,0,6,0,0,20
Afghanistan,14/02/2005,13,0,1,0,0,0,0,14
Afghanistan,15/02/2005,31,2,-2,0,10,1,0,42
Afghanistan,16/02/2005,21,0,0,0,0,1,0,22
Afghanistan,17/02/2005,17,0,0,0,3,0,0,20
Afghanistan,18/02/2005,3,0,0,0,0,0,0,3
Afghanistan,19/02/2005,2,0,0,0,0,0,0,2
Afghanistan,20/02/2005,9,0,0,0,3,0,0,12
Afghanistan,21/02/2005,12,0,-1,0,13,1,0,25
Afghanistan,22/02/2005,0,0,0,0,1,0,0,1
Afghanistan,23/02/2005,4,0,0,0,-4,2,0,2
Afghanistan,24/02/2005,8,0,0,0,9,0,0,17
Afghanistan,25/02/2005,8,0,0,0,2,0,0,10
Afghanistan,26/02/2005,11,0,-4,0,0,2,0,9
Afghanistan,27/02/2005,17,0,0,0,9,0,0,26
Afghanistan,28/02/2005,15,0,0,0,0,0,0,15
Afghanistan,01/03/2005,8,0,0,0,7,0,0,15
Afghanistan,02/03/2005,13,0,0,0,9,3,0,25
Afghanistan,03/03/2005,25,0,0,0,9,1,0,35
Afghanistan,04/03/2005,2,0,-2,0,0,1,0,1
Afghanistan,05/03/2005,14,0,0,0,6,0,0,20
Afghanistan,06/03/2005,13,2,0,0,-5,6,0,16
Afghanistan,07/03/2005,21,0,0,0,-3,0,0,18
Afghanistan,08/03/2005,16,0,0,0,0,3,0,19
Afghanistan,09/03/2005,19,0,0,0,4,6,0,29
Afghanistan,10/03/2005,6,0,0,0,-6,0,0,0
Afghanistan,11/03/2005,2,0,0,0,8,0,0,10
Afghanistan,12/03/2005,13,0,0,0,0,3,0,16
Afghanistan,13/03/2005,25,0,0,0,3,3,0,31
Afghanistan,14/03/2005,10,0,0,0,3,3,0,16
Afghanistan,15/03/2005,20,0,0,0,12,2,0,34
Afghanistan,16/03/2005,19,0,1,0,9,0,0,29
Afghanistan,17/03/2005,6,0,-4,0,6,0,0,8
Afghanistan,18/03/2005,10,0,0,0,9,1,0,20
Afghanistan,19/03/2005,-4,0,0,0,0,4,0,0
Afghanistan,20/03/2005,7,0,0,0,0,0,0,7
Afghanistan,21/03/2005,4,0,0,0,0,0,0,4
Afghanistan,22/03/2005,24,0,1,0,17,6,0,48
Afghanistan,23/03/2005,8,2,0,0,3,0,0,13
Afghanistan,24/03/2005,21,0,0,0,3,1,0,25
Afghanistan,25/03/2005,21,0,0,0,1,3,0,25
Afghanistan,26/03/2005,7,0,0,0,2,0,0,9
Afghanistan,27/03/2005,18,0,0,0,0,0,0,18
Afghanistan,28/03/2005,-1,0,0,0,0,1,0,0
Afghanistan,29/03/2005,14,0,3,0,7,1,0,25
Afghanistan,30/03/2005,17,0,0,0,12,6,0,35
Afghanistan,31/03/2005,17,0,0,0,36,3,0,56
Afghanistan,01/04/2005,5,0,0,0,3,0,0,8
Afghanistan,02/04/2005,7,0,0,0,0,1,0,8
Afghanistan,03/04/2005,21,0,0,0,-3,0,0,18
Afghanistan,04/04/2005,9,0,-4,0,6,0,0,11
Afghanistan,05/04/2005,15,0,0,0,0,0,0,15
Afghanistan,06/04/2005,22,0,0,0,0,5,0,27
Afghanistan,07/04/2005,12,0,0,0,6,4,0,22
Afghanistan,08/04/2005,20,0,0,0,3,1,0,24
Afghanistan,09/04/2005,1,0,0,0,21,0,0,22
Afghanistan,10/04/2005,0,0,0,0,9,0,0,9
Afghanistan,11/04/2005,6,0,0,0,9,0,0,15
Afghanistan,12/04/2005,13,0,0,0,-2,2,0,13
Afghanistan,13/04/2005,20,0,0,0,27,1,0,48
Afghanistan,14/04/2005,30,0,1,0,6,3,0,40
Afghanistan,15/04/2005,5,0,0,0,1,6,0,12
Afghanistan,16/04/2005,4,0,0,0,6,0,0,10
Afghanistan,17/04/2005,0,0,0,0,0,0,0,0
Afghanistan,18/04/2005,10,0,0,0,13,6,0,29
Afghanistan,19/04/2005,44,0,0,0,7,0,0,51
Afghanistan,20/04/2005,30,0,-2,0,1,1,0,30
Afghanistan,21/04/2005,5,2,0,0,6,2,0,15
Afghanistan,22/04/2005,4,0,0,0,7,0,0,11
Afghanistan,23/04/2005,11,0,0,0,0,0,0,11
Afghanistan,24/04/2005,16,0,0,0,1,2,0,19
Afghanistan,25/04/2005,12,0,0,0,9,3,0,24
Afghanistan,26/04/2005,10,0,0,0,16,0,0,26
Afghanistan,27/04/2005,5,0,0,0,26,0,0,31
Afghanistan,28/04/2005,4,0,0,0,7,2,0,13
Afghanistan,29/04/2005,9,0,0,0,7,0,0,16
Afghanistan,30/04/2005,0,0,0,0,0,0,0,0
Afghanistan,01/05/2005,5,0,0,0,3,0,0,8
Afghanistan,02/05/2005,20,0,1,0,9,2,0,32
Afghanistan,03/05/2005,-5,0,0,0,6,1,0,2
Afghanistan,04/05/2005,31,0,0,0,-1,6,0,36
Afghanistan,05/05/2005,66,0,0,0,3,10,0,79
Afghanistan,06/05/2005,8,0,0,0,19,0,0,27
Afghanistan,07/05/2005,1,0,0,0,21,1,0,23
Afghanistan,08/05/2005,44,0,-7,0,0,0,0,37
Afghanistan,09/05/2005,-2,0,-2,0,6,0,0,2
Afghanistan,10/05/2005,2,0,0,0,0,0,0,2
Afghanistan,11/05/2005,13,0,0,0,2,1,0,16
Afghanistan,12/05/2005,16,0,0,0,0,1,0,17
Afghanistan,13/05/2005,13,0,0,0,5,5,0,23
Afghanistan,14/05/2005,22,0,0,0,1,7,0,30
Afghanistan,15/05/2005,27,0,0,0,6,4,0,37
Afghanistan,16/05/2005,10,0,0,0,0,8,0,18
Afghanistan,17/05/2005,22,0,0,0,24,1,0,47
Afghanistan,18/05/2005,19,6,0,0,0,0,0,25
Afghanistan,19/05/2005,16,0,0,0,6,0,0,22
Afghanistan,20/05/2005,12,0,0,0,0,2,0,14
Afghanistan,21/05/2005,6,2,0,0,15,0,0,23
Afghanistan,22/05/2005,17,0,0,0,0,7,0,24
Afghanistan,23/05/2005,33,0,-1,0,9,4,0,45
Afghanistan,24/05/2005,10,0,0,0,12,1,0,23
Afghanistan,25/05/2005,0,0,0,0,3,0,0,3
Afghanistan,26/05/2005,3,0,0,0,0,5,0,8
Afghanistan,27/05/2005,4,0,0,0,-6,9,0,7
Afghanistan,28/05/2005,0,0,0,0,6,6,0,12
Afghanistan,29/05/2005,14,0,0,0,1,2,0,17
Afghanistan,30/05/2005,16,0,0,0,10,0,0,26
Afghanistan,31/05/2005,13,0,0,0,0,10,0,23
Afghanistan,01/06/2005,39,0,0,0,14,3,0,56
Afghanistan,02/06/2005,17,0,0,0,-4,0,0,13
Afghanistan,03/06/2005,0,0,-2,0,0,1,0,-1
Afghanistan,04/06/2005,21,0,0,0,4,3,0,28
Afghanistan,05/06/2005,9,0,0,0,3,0,0,12
Afghanistan,06/06/2005,9,0,0,0,1,2,0,12
Afghanistan,07/06/2005,10,0,0,0,-4,0,0,6
Afghanistan,08/06/2005,16,0,0,0,6,4,0,26
Afghanistan,09/06/2005,14,0,0,0,12,3,0,29
Afghanistan,10/06/2005,11,0,0,0,9,1,0,21
Afghanistan,11/06/2005,2,0,0,0,12,1,0,15
Afghanistan,12/06/2005,14,0,0,0,14,2,0,30
Afghanistan,13/06/2005,11,0,3,0,9,8,0,31
Afghanistan,14/06/2005,37,0,0,0,12,3,0,52
Afghanistan,15/06/2005,21,0,0,0,-2,0,0,19
Afghanistan,16/06/2005,6,0,0,0,-6,1,0,1
Afghanistan,17/06/2005,9,0,0,0,-4,0,0,5
Afghanistan,18/06/2005,23,0,0,0,0,1,0,24
Afghanistan,19/06/2005,10,0,0,0,0,0,0,10
Afghanistan,20/06/2005,10,0,0,0,6,2,0,18
Afghanistan,21/06/2005,23,0,0,0,9,0,0,32
Afghanistan,22/06/2005,43,0,0,0,10,2,0,55
Afghanistan,23/06/2005,28,0,0,0,9,9,0,46
Afghanistan,24/06/2005,13,0,0,0,7,2,0,22
Afghanistan,25/06/2005,28,0,0,0,0,2,0,30
Afghanistan,26/06/2005,17,0,-4,0,0,0,0,13
Afghanistan,27/06/2005,9,0,-12,0,36,2,0,35
Afghanistan,28/06/2005,19,0,-4,0,11,1,0,27
Afghanistan,29/06/2005,23,0,0,0,2,1,0,26
Afghanistan,30/06/2005,17,0,0,0,3,2,0,22
Afghanistan,01/07/2005,10,0,0,0,3,0,0,13
Afghanistan,02/07/2005,23,0,0,0,3,0,0,26
Afghanistan,03/07/2005,12,0,-2,0,0,5,0,15
Afghanistan,04/07/2005,29,0,0,0,-1,0,0,28
Afghanistan,05/07/2005,10,0,1,0,1,4,0,16
Afghanistan,06/07/2005,26,0,0,0,2,1,0,29
Afghanistan,07/07/2005,42,0,-6,0,12,9,0,57
Afghanistan,08/07/2005,6,0,-10,0,0,1,0,-3
Afghanistan,09/07/2005,22,0,0,0,-4,0,0,18
Afghanistan,10/07/2005,13,0,0,0,12,8,0,33
Afghanistan,11/07/2005,35,0,1,0,-2,4,0,38
Afghanistan,12/07/2005,1,0,0,0,13,2,0,16
Afghanistan,13/07/2005,19,0,0,0,28,2,0,49
Afghanistan,14/07/2005,14,4,0,0,3,0,0,21
Afghanistan,15/07/2005,11,0,0,0,12,15,0,38
Afghanistan,16/07/2005,5,0,0,0,6,0,0,11
Afghanistan,17/07/2005,36,0,0,0,12,0,0,48
Afghanistan,18/07/2005,22,2,0,0,9,0,0,33
Afghanistan,19/07/2005,12,0,0,0,15,1,0,28
Afghanistan,20/07/2005,16,0,0,0,14,0,0,30
Afghanistan,21/07/2005,12,0,0,0,9,2,0,23
Afghanistan,22/07/2005,33,0,0,0,-2,0,0,31
Afghanistan,23/07/2005,-3,0,0,0,4,1,0,2
Afghanistan,24/07/2005,30,0,0,0,15,1,0,46
Afghanistan,25/07/2005,27,0,0,0,21,9,0,57
Afghanistan,26/07/2005,12,0,0,0,3,0,0,15
Afghanistan,27/07/2005,15,0,0,0,3,0,0,18
Afghanistan,28/07/2005,16,0,0,0,19,1,0,36
Afghanistan,29/07/2005,29,0,0,0,12,0,0,41
Afghanistan,30/07/2005,9,0,0,0,2,2,0,13
Afghanistan,31/07/2005,3,0,0,0,3,0,0,6
Afghanistan,01/08/2005,4,0,0,0,20,2,0,26
Afghanistan,02/08/2005,32,0,0,0,6,0,0,38
Afghanistan,03/08/2005,-1,0,1,0,2,1,0,3
Afghanistan,04/08/2005,15,0,0,0,6,0,0,21
Afghanistan,05/08/2005,17,0,0,0,7,0,0,24
Afghanistan,06/08/2005,16,0,0,0,13,2,0,31
Afghanistan,07/08/2005,27,0,0,0,9,0,0,36
Afghanistan,08/08/2005,11,0,0,0,15,0,0,26
Afghanistan,09/08/2005,18,0,0,0,6,0,0,24
Afghanistan,10/08/2005,18,0,0,0,0,3,0,21
Afghanistan,11/08/2005,18,0,0,0,-2,0,0,16
Afghanistan,12/08/2005,11,0,0,0,3,0,0,14
Afghanistan,13/08/2005,15,2,0,0,3,0,0,20
Afghanistan,14/08/2005,22,0,0,0,7,0,0,29
Afghanistan,15/08/2005,2,0,0,0,-2,2,0,2
Afghanistan,16/08/2005,3,0,0,0,0,0,0,3
Afghanistan,17/08/2005,24,0,1,0,12,0,0,37
Afghanistan,18/08/2005,17,0,0,0,9,8,0,34
Afghanistan,19/08/2005,28,0,0,0,-4,3,0,27
Afghanistan,20/08/2005,16,0,0,0,6,0,0,22
Afghanistan,21/08/2005,26,0,0,0,-4,2,0,24
Afghanistan,22/08/2005,12,0,0,0,-6,0,0,6
Afghanistan,23/08/2005,33,0,0,0,0,0,0,33
Afghanistan,24/08/2005,23,0,3,0,-18,0,0,8
Afghanistan,25/08/2005,10,2,0,0,9,0,0,21
Afghanistan,26/08/2005,10,0,0,0,9,0,0,19
Afghanistan,27/08/2005,12,0,0,0,-1,0,0,11
Afghanistan,28/08/2005,21,0,0,0,15,4,0,40
Afghanistan,29/08/2005,12,0,-1,0,13,7,0,31
Afghanistan,30/08/2005,4,0,0,0,0,0,0,4
Afghanistan,31/08/2005,13,2,1,0,12,0,0,28
Afghanistan,01/09/2005,9,0,0,0,11,8,0,28
Afghanistan,02/09/2005,18,0,0,0,6,2,0,26
Afghanistan,03/09/2005,16,0,0,0,24,0,0,40
Afghanistan,04/09/2005,4,0,1,0,0,0,0,5
Afghanistan,05/09/2005,6,0,0,0,6,0,0,12
Afghanistan,06/09/2005,28,0,1,0,9,0,0,38
Afghanistan,07/09/2005,8,0,0,0,3,0,0,11
Afghanistan,08/09/2005,9,0,0,0,-2,1,0,8
Afghanistan,09/09/2005,13,0,0,0,3,4,0,20
Afghanistan,10/09/2005,14,0,0,0,27,4,0,45
Afghanistan,11/09/2005,19,0,0,0,0,0,0,19
Afghanistan,12/09/2005,11,0,0,0,2,2,0,15
Afghanistan,13/09/2005,51,0,0,0,6,5,0,62
Afghanistan,14/09/2005,4,0,0,0,27,2,0,33
Afghanistan,15/09/2005,22,0,0,0,3,5,0,30
Afghanistan,16/09/2005,10,0,-1,0,3,0,0,12
Afghanistan,17/09/2005,21,0,0,0,6,3,0,30
Afghanistan,18/09/2005,17,0,-1,0,7,2,0,25
Afghanistan,19/09/2005,15,0,1,0,16,4,0,36
Afghanistan,20/09/2005,36,0,0,0,1,2,0,39
Afghanistan,21/09/2005,28,0,-2,0,0,1,0,27
Afghanistan,22/09/2005,12,0,-8,0,6,2,0,12
Afghanistan,23/09/2005,26,0,0,0,3,0,0,29
Afghanistan,24/09/2005,6,0,0,0,0,0,0,6
Afghanistan,25/09/2005,5,0,0,0,6,3,0,14
Afghanistan,26/09/2005,9,0,0,0,19,0,0,28
Afghanistan,27/09/2005,6,0,-6,0,18,0,0,18
Afghanistan,28/09/2005,14,0,0,0,12,7,0,33
Afghanistan,29/09/2005,14,0,0,0,25,5,0,44
Afghanistan,30/09/2005,13,0,0,0,9,3,0,25
Afghanistan,01/10/2005,12,0,0,0,3,0,0,15
Afghanistan,02/10/2005,7,0,0,0,3,0,0,10
Afghanistan,03/10/2005,12,0,0,0,12,3,0,27
Afghanistan,04/10/2005,32,0,0,0,10,1,0,43
Afghanistan,05/10/2005,16,0,0,0,33,7,0,56
Afghanistan,06/10/2005,24,0,0,0,19,2,0,45
Afghanistan,07/10/2005,18,0,-2,0,20,4,0,40
Afghanistan,08/10/2005,5,0,0,0,1,0,0,6
Afghanistan,09/10/2005,34,0,0,0,7,5,0,46
Afghanistan,10/10/2005,26,0,0,0,3,6,0,35
Afghanistan,11/10/2005,14,0,0,0,15,11,0,40
Afghanistan,12/10/2005,51,0,0,0,3,5,0,59
Afghanistan,13/10/2005,31,0,0,0,6,10,0,47
Afghanistan,14/10/2005,8,0,0,0,24,1,0,33
Afghanistan,15/10/2005,11,0,0,0,6,0,0,17
Afghanistan,16/10/2005,10,0,0,0,6,3,0,19
Afghanistan,17/10/2005,6,0,0,0,3,5,0,14
Afghanistan,18/10/2005,5,0,1,0,3,0,0,9
Afghanistan,19/10/2005,12,0,0,0,12,1,0,25
Afghanistan,20/10/2005,28,0,0,0,13,0,0,41
Afghanistan,21/10/2005,11,0,0,0,0,2,0,13
Afghanistan,22/10/2005,14,0,0,0,18,8,0,40
Afghanistan,23/10/2005,20,0,0,0,21,3,0,44
Afghanistan,24/10/2005,27,0,0,0,0,4,0,31
Afghanistan,25/10/2005,6,0,0,0,7,4,0,17
Afghanistan,26/10/2005,8,0,-1,0,1,0,0,8
Afghanistan,27/10/2005,6,0,0,0,18,2,0,26
Afghanistan,28/10/2005,3,0,0,0,18,0,0,21
Afghanistan,29/10/2005,29,0,1,0,10,3,0,43
Afghanistan,30/10/2005,24,0,0,0,9,0,0,33
Afghanistan,31/10/2005,3,0,0,0,8,0,0,11
Afghanistan,01/11/2005,16,0,0,0,6,0,0,22
Afghanistan,02/11/2005,6,0,1,0,11,2,0,20
Afghanistan,03/11/2005,13,0,0,0,4,3,0,20
Afghanistan,04/11/2005,16,0,0,0,1,0,0,17
Afghanistan,05/11/2005,14,0,0,0,7,0,0,21
Afghanistan,06/11/2005,13,0,0,0,5,0,0,18
Afghanistan,07/11/2005,4,0,0,0,15,1,0,20
Afghanistan,08/11/2005,34,0,0,0,15,0,0,49
Afghanistan,09/11/2005,18,0,0,0,6,13,0,37
Afghanistan,10/11/2005,18,0,0,0,3,4,0,25
Afghanistan,11/11/2005,0,0,0,0,9,2,0,11
Afghanistan,12/11/2005,6,0,-2,0,-1,1,0,4
Afghanistan,13/11/2005,21,0,1,0,20,2,0,44
Afghanistan,14/11/2005,4,0,0,0,8,0,0,12
Afghanistan,15/11/2005,3,0,0,0,9,0,0,12
Afghanistan,16/11/2005,22,0,0,0,10,0,0,32
Afghanistan,17/11/2005,21,0,0,0,14,1,0,36
Afghanistan,18/11/2005,-4,0,0,0,6,4,0,6
Afghanistan,19/11/2005,14,0,0,0,7,1,0,22
Afghanistan,20/11/2005,1,0,0,0,-2,0,0,-1
Afghanistan,21/11/2005,10,0,0,0,15,0,0,25
Afghanistan,22/11/2005,11,0,0,0,10,1,0,22
Afghanistan,23/11/2005,5,0,0,0,1,1,0,7
Afghanistan,24/11/2005,0,0,0,0,12,2,0,14
Afghanistan,25/11/2005,8,0,1,0,0,3,0,12
Afghanistan,26/11/2005,21,0,0,0,-2,4,0,23
Afghanistan,27/11/2005,12,0,0,0,12,0,0,24
Afghanistan,28/11/2005,12,0,0,0,3,0,0,15
Afghanistan,29/11/2005,33,2,1,0,-1,2,0,37
Afghanistan,30/11/2005,16,0,0,0,4,0,0,20
Afghanistan,01/12/2005,4,0,0,0,3,0,0,7
Afghanistan,02/12/2005,6,0,0,0,-2,0,0,4
Afghanistan,03/12/2005,39,0,0,0,6,3,0,48
Afghanistan,04/12/2005,58,0,0,0,21,3,0,82
Afghanistan,05/12/2005,18,0,0,0,6,2,0,26
Afghanistan,06/12/2005,5,0,0,0,8,0,0,13
Afghanistan,07/12/2005,10,0,0,0,3,1,0,14
Afghanistan,08/12/2005,34,0,0,0,18,7,0,59
Afghanistan,09/12/2005,34,0,0,0,9,1,0,44
Afghanistan,10/12/2005,15,0,0,0,3,2,0,20
Afghanistan,11/12/2005,26,0,0,0,3,3,0,32
Afghanistan,12/12/2005,8,0,0,0,12,0,0,20
Afghanistan,13/12/2005,9,0,0,0,18,1,0,28
Afghanistan,14/12/2005,28,0,0,0,20,3,0,51
Afghanistan,15/12/2005,8,0,0,0,18,3,0,29
Afghanistan,16/12/2005,8,2,0,0,12,0,0,22
Afghanistan,17/12/2005,27,0,0,0,9,0,0,36
Afghanistan,18/12/2005,20,0,0,0,0,0,0,20
Afghanistan,19/12/2005,18,0,0,0,7,2,0,27
Afghanistan,20/12/2005,26,0,0,0,15,0,0,41
Afghanistan,21/12/2005,6,0,0,0,9,0,0,15
Afghanistan,22/12/2005,7,0,0,0,4,1,0,12
Afghanistan,23/12/2005,17,0,0,0,12,0,0,29
Afghanistan,24/12/2005,15,0,0,0,-2,0,0,13
Afghanistan,25/12/2005,11,0,0,0,0,2,0,13
Afghanistan,26/12/2005,3,0,0,0,-2,0,0,1
Afghanistan,27/12/2005,17,0,0,0,10,0,0,27
Afghanistan,28/12/2005,9,0,0,0,6,0,0,15
Afghanistan,29/12/2005,12,0,0,0,3,7,0,22
Afghanistan,30/12/2005,2,0,0,0,0,0,0,2
Afghanistan,31/12/2005,28,0,0,0,7,6,0,41
Albania,01/01/2005,1,0,0,0,0,0,0,1
Albania,03/01/2005,12,0,0,0,0,0,0,12
Albania,04/01/2005,3,0,0,0,0,0,0,3
Albania,05/01/2005,7,0,0,0,6,0,0,13
Albania,06/01/2005,2,0,0,0,0,1,0,3
Albania,07/01/2005,15,0,0,0,0,0,0,15
Albania,08/01/2005,28,0,0,0,0,3,0,31
Albania,09/01/2005,8,0,0,0,0,5,0,13
Albania,10/01/2005,32,0,0,0,12,2,0,46
Albania,11/01/2005,11,0,-4,0,0,2,0,9
Albania,12/01/2005,18,0,-3,0,9,2,0,26
Albania,13/01/2005,11,0,1,0,0,6,0,18
Albania,14/01/2005,5,0,0,0,-2,0,0,3
Albania,16/01/2005,-7,0,0,0,0,0,0,-7
Albania,17/01/2005,9,0,0,0,3,0,0,12
Albania,18/01/2005,0,0,0,0,30,2,0,32
Albania,19/01/2005,28,0,0,0,0,0,0,28
Albania,20/01/2005,4,0,0,0,6,0,0,10
Albania,21/01/2005,0,0,-1,0,6,0,0,5
Albania,22/01/2005,0,0,0,0,1,0,0,1
Albania,23/01/2005,9,0,0,0,0,0,0,9
Albania,24/01/2005,12,2,-2,0,9,0,0,21
Albania,25/01/2005,0,0,0,0,0,0,0,0
Albania,26/01/2005,11,0,0,0,0,0,0,11
Albania,27/01/2005,10,0,0,0,-2,0,0,8
Albania,28/01/2005,21,0,-1,0,9,0,0,29
Albania,29/01/2005,7,0,0,0,0,0,0,7
Albania,30/01/2005,4,0,0,0,0,0,0,4
Albania,31/01/2005,1,0,0,0,0,0,0,1
Albania,01/02/2005,0,0,2,0,8,0,0,10
Albania,02/02/2005,0,0,0,0,9,0,0,9
Albania,03/02/2005,4,0,0,0,12,0,0,16
Albania,04/02/2005,3,0,0,0,0,0,0,3
Albania,06/02/2005,-1,0,0,0,0,0,0,-1
Albania,07/02/2005,13,0,0,0,4,0,0,17
Albania,08/02/2005,7,0,-2,0,0,0,0,5
Albania,09/02/2005,10,0,-1,0,0,0,0,9
Albania,10/02/2005,1,0,0,0,0,0,0,1
Albania,11/02/2005,4,0,0,0,15,0,0,19
Albania,12/02/2005,0,0,0,0,3,0,0,3
Albania,13/02/2005,16,0,0,0,3,0,0,19
Albania,14/02/2005,23,0,0,0,8,0,0,31
Albania,15/02/2005,-1,0,0,0,0,0,0,-1
Albania,16/02/2005,0,0,0,0,0,2,0,2
Albania,17/02/2005,0,0,0,0,0,0,0,0
Albania,18/02/2005,2,0,0,0,0,0,0,2
Albania,19/02/2005,2,0,0,0,0,0,0,2
Albania,20/02/2005,6,0,0,0,0,0,0,6
Albania,21/02/2005,0,0,0,0,0,0,0,0
Albania,22/02/2005,0,0,0,0,0,0,0,0
Albania,23/02/2005,2,0,0,0,0,0,0,2
Albania,24/02/2005,13,0,0,0,0,0,0,13
Albania,25/02/2005,0,0,0,0,0,0,0,0
Albania,26/02/2005,0,0,0,0,2,2,0,4
Albania,27/02/2005,4,0,0,0,0,0,0,4
Albania,01/03/2005,4,0,0,0,15,1,0,20
Albania,02/03/2005,0,0,0,0,3,0,0,3
Albania,03/03/2005,5,0,0,0,6,0,0,11
Albania,04/03/2005,4,0,0,0,0,0,0,4
Albania,05/03/2005,5,0,0,0,0,0,0,5
Albania,06/03/2005,0,0,0,0,9,0,0,9
Albania,07/03/2005,0,0,0,0,0,0,0,0
Albania,08/03/2005,15,0,-26,0,34,6,0,29
Albania,09/03/2005,11,0,-6,0,24,1,0,30
Albania,10/03/2005,2,0,0,0,27,4,0,33
Albania,11/03/2005,19,0,-2,0,18,0,0,35
Albania,12/03/2005,6,0,-1,0,0,0,0,5
Albania,13/03/2005,13,0,-3,0,4,2,0,16
Albania,14/03/2005,6,0,0,0,22,2,0,30
Albania,15/03/2005,21,0,-6,0,22,0,0,37
Albania,16/03/2005,18,0,0,0,27,0,0,45
Albania,17/03/2005,13,0,-6,0,6,0,0,13
Albania,18/03/2005,1,0,-6,0,12,0,0,7
Albania,19/03/2005,3,0,0,0,12,0,0,15
Albania,20/03/2005,6,0,0,0,0,0,0,6
Albania,21/03/2005,7,0,0,0,11,0,0,18
Albania,22/03/2005,0,0,0,0,3,0,0,3
Albania,23/03/2005,9,2,-3,0,16,8,0,32
Albania,24/03/2005,12,0,0,0,9,2,0,23
Albania,25/03/2005,-2,0,0,0,-4,0,0,-6
Albania,26/03/2005,1,0,0,0,0,2,0,3
Albania,27/03/2005,-3,0,0,0,9,3,0,9
Albania,28/03/2005,8,0,-1,0,3,2,0,12
Albania,29/03/2005,3,0,0,0,6,0,0,9
Albania,30/03/2005,2,0,0,0,0,0,0,2
Albania,31/03/2005,6,0,0,0,1,0,0,7
Albania,01/04/2005,4,0,0,0,9,0,0,13
Albania,02/04/2005,0,0,0,0,6,0,0,6
Albania,03/04/2005,5,0,0,0,0,0,0,5
Albania,04/04/2005,-2,0,0,0,6,0,0,4
Albania,05/04/2005,-3,0,0,0,0,0,0,-3
Albania,06/04/2005,3,0,0,0,9,0,0,12
Albania,07/04/2005,-2,0,0,0,6,0,0,4
Albania,08/04/2005,0,0,0,0,9,0,0,9
Albania,10/04/2005,0,0,0,0,0,0,0,0
Albania,11/04/2005,0,0,0,0,3,0,0,3
Albania,12/04/2005,8,0,0,0,0,1,0,9
Albania,13/04/2005,4,0,0,0,0,2,0,6
Albania,14/04/2005,0,0,0,0,0,0,0,0
Albania,15/04/2005,8,0,0,0,21,4,0,33
Albania,16/04/2005,22,0,0,0,-3,0,0,19
Albania,17/04/2005,14,0,0,0,4,0,0,18
Albania,18/04/2005,10,0,0,0,9,2,0,21
Albania,19/04/2005,12,0,0,0,6,0,0,18
Albania,20/04/2005,2,0,0,0,0,0,0,2
Albania,21/04/2005,0,0,0,0,3,0,0,3
Albania,22/04/2005,8,0,0,0,9,0,0,17
Albania,23/04/2005,0,0,1,0,3,6,0,10
Albania,25/04/2005,-3,0,0,0,3,2,0,2
Albania,26/04/2005,9,0,0,0,0,0,0,9
Albania,27/04/2005,4,0,0,0,6,0,0,10
Albania,28/04/2005,2,0,0,0,0,0,0,2
Albania,29/04/2005,0,0,0,0,0,0,0,0
Albania,30/04/2005,3,0,0,0,3,0,0,6
Albania,01/05/2005,0,0,0,0,0,0,0,0
Albania,02/05/2005,2,0,0,0,0,0,0,2
Albania,03/05/2005,4,0,0,0,0,0,0,4
Albania,04/05/2005,0,0,0,0,0,0,0,0
Albania,05/05/2005,8,0,0,0,1,0,0,9
Albania,06/05/2005,-3,0,0,0,-2,0,0,-5
Albania,08/05/2005,0,0,0,0,-6,0,0,-6
Albania,09/05/2005,0,0,0,0,0,0,0,0
Albania,10/05/2005,0,0,0,0,-1,1,0,0
Albania,11/05/2005,3,0,0,0,6,0,0,9
Albania,12/05/2005,2,0,0,0,-2,0,0,0
Albania,13/05/2005,5,0,0,0,0,0,0,5
Albania,14/05/2005,0,0,1,0,9,6,0,16
Albania,15/05/2005,0,0,0,0,0,0,0,0
Albania,16/05/2005,0,0,0,0,7,0,0,7
Albania,17/05/2005,7,0,0,0,3,0,0,10
Albania,18/05/2005,-1,0,-1,0,3,6,0,7
Albania,19/05/2005,12,2,-1,0,3,0,0,16
Albania,20/05/2005,-1,0,0,0,0,0,0,-1
Albania,22/05/2005,0,0,0,0,0,0,0,0
Albania,23/05/2005,0,0,0,0,0,0,0,0
Albania,24/05/2005,12,0,0,0,-5,0,0,7
Albania,25/05/2005,7,0,0,0,0,0,0,7
Albania,26/05/2005,0,0,0,0,0,0,0,0
Albania,27/05/2005,0,0,0,0,3,0,0,3
Albania,28/05/2005,4,0,0,0,9,0,0,13
Albania,30/05/2005,15,0,0,0,3,0,0,18
Albania,31/05/2005,0,0,0,0,3,0,0,3
Albania,01/06/2005,3,0,0,0,3,0,0,6
Albania,02/06/2005,1,0,0,0,6,3,0,10
Albania,03/06/2005,6,0,0,0,0,0,0,6
Albania,04/06/2005,9,0,0,0,0,0,0,9
Albania,05/06/2005,0,0,0,0,0,0,0,0
Albania,06/06/2005,6,0,0,0,8,2,0,16
Albania,07/06/2005,8,0,0,0,7,2,0,17
Albania,08/06/2005,4,0,0,0,3,0,0,7
Albania,09/06/2005,5,0,0,0,6,0,0,11
Albania,10/06/2005,5,0,0,0,12,1,0,18
Albania,11/06/2005,-2,0,0,0,0,0,0,-2
Albania,12/06/2005,4,0,0,0,0,0,0,4
Albania,13/06/2005,6,0,0,0,3,0,0,9
Albania,14/06/2005,6,0,0,0,0,0,0,6
Albania,15/06/2005,7,0,0,0,12,0,0,19
Albania,16/06/2005,2,0,0,0,0,0,0,2
Albania,17/06/2005,15,0,0,0,13,1,0,29
Albania,18/06/2005,0,0,0,0,3,0,0,3
Albania,19/06/2005,0,0,0,0,6,4,0,10
Albania,20/06/2005,4,0,-1,0,2,0,0,5
Albania,21/06/2005,0,0,0,0,0,0,0,0
Albania,22/06/2005,0,0,0,0,0,0,0,0
Albania,23/06/2005,16,0,0,0,-4,1,0,13
Albania,24/06/2005,7,2,0,0,8,0,0,17
Albania,25/06/2005,0,0,0,0,0,0,0,0
Albania,26/06/2005,0,0,0,0,0,2,0,2
Albania,27/06/2005,12,0,0,0,15,3,0,30
Albania,28/06/2005,1,0,0,0,0,0,0,1
Albania,29/06/2005,3,0,0,0,-3,0,0,0
Albania,30/06/2005,2,0,0,0,0,1,0,3
Albania,01/07/2005,3,0,0,0,3,2,0,8
Albania,02/07/2005,6,0,-6,0,6,0,0,6
Albania,03/07/2005,9,0,1,0,1,1,0,12
Albania,04/07/2005,2,0,1,0,2,1,0,6
Albania,05/07/2005,0,0,0,0,-2,0,0,-2
Albania,06/07/2005,11,0,0,0,6,0,0,17
Albania,07/07/2005,0,0,0,0,-4,0,0,-4
Albania,08/07/2005,5,0,0,0,12,0,0,17
Albania,09/07/2005,-1,0,0,0,3,0,0,2
Albania,11/07/2005,33,0,0,0,3,0,0,36
Albania,12/07/2005,5,0,0,0,6,2,0,13
Albania,13/07/2005,36,0,0,0,0,0,0,36
Albania,14/07/2005,4,0,0,0,6,0,0,10
Albania,15/07/2005,1,0,0,0,0,0,0,1
Albania,16/07/2005,4,0,0,0,0,0,0,4
Albania,18/07/2005,2,0,0,0,6,0,0,8
Albania,19/07/2005,0,0,0,0,0,0,0,0
Albania,20/07/2005,1,0,-2,0,0,0,0,-1
Albania,21/07/2005,0,0,0,0,0,0,0,0
Albania,22/07/2005,4,0,0,0,19,1,0,24
Albania,23/07/2005,9,0,0,0,3,0,0,12
Albania,25/07/2005,4,0,0,0,3,5,0,12
Albania,26/07/2005,9,0,0,0,3,2,0,14
Albania,27/07/2005,2,0,0,0,3,0,0,5
Albania,28/07/2005,0,0,1,0,0,0,0,1
Albania,29/07/2005,1,0,0,0,0,0,0,1
Albania,30/07/2005,0,0,0,0,0,3,0,3
Albania,31/07/2005,-1,0,0,0,9,0,0,8
Albania,01/08/2005,0,0,-1,0,3,0,0,2
Albania,03/08/2005,2,0,-2,0,0,0,0,0
Albania,04/08/2005,7,0,0,0,0,0,0,7
Albania,05/08/2005,0,0,0,0,0,0,0,0
Albania,06/08/2005,0,0,0,0,0,0,0,0
Albania,07/08/2005,0,0,0,0,0,1,0,1
Albania,08/08/2005,10,0,0,0,0,0,0,10
Albania,09/08/2005,7,0,0,0,-4,0,0,3
Albania,10/08/2005,13,2,0,0,-4,0,0,11
Albania,11/08/2005,-1,0,0,0,0,0,0,-1
Albania,12/08/2005,0,0,-1,0,0,0,0,-1
Albania,13/08/2005,-1,0,0,0,0,0,0,-1
Albania,16/08/2005,2,0,0,0,0,0,0,2
Albania,17/08/2005,8,0,0,0,3,0,0,11
Albania,18/08/2005,24,0,-1,0,0,0,0,23
Albania,19/08/2005,1,0,0,0,0,0,0,1
Albania,20/08/2005,0,0,0,0,0,0,0,0
Albania,22/08/2005,2,0,0,0,0,0,0,2
Albania,23/08/2005,2,0,0,0,3,6,0,11
Albania,24/08/2005,3,0,0,0,0,0,0,3
Albania,25/08/2005,1,0,0,0,0,0,0,1
Albania,26/08/2005,4,0,0,0,0,0,0,4
Albania,27/08/2005,4,0,0,0,0,0,0,4
Albania,28/08/2005,19,0,0,0,0,0,0,19
Albania,29/08/2005,9,0,0,0,0,0,0,9
Albania,30/08/2005,0,0,2,0,3,0,0,5
Albania,31/08/2005,3,0,0,0,6,0,0,9
Albania,01/09/2005,4,0,-3,0,0,1,0,2
Albania,02/09/2005,5,0,0,0,0,0,0,5
Albania,04/09/2005,0,0,0,0,0,0,0,0
Albania,05/09/2005,22,0,-1,0,4,0,0,25
Albania,06/09/2005,6,0,0,0,1,0,0,7
Albania,07/09/2005,2,0,0,0,0,0,0,2
Albania,08/09/2005,17,0,0,0,0,0,0,17
Albania,09/09/2005,0,0,1,0,0,6,0,7
Albania,10/09/2005,10,0,1,0,6,2,0,19
Albania,11/09/2005,0,0,0,0,0,0,0,0
Albania,12/09/2005,5,0,2,0,3,0,0,10
Albania,13/09/2005,2,0,0,0,0,0,0,2
Albania,14/09/2005,0,0,0,0,3,0,0,3
Albania,15/09/2005,2,0,0,0,0,0,0,2
Albania,16/09/2005,4,0,0,0,-2,0,0,2
Albania,17/09/2005,0,0,0,0,6,0,0,6
Albania,18/09/2005,3,0,0,0,18,0,0,21
Albania,19/09/2005,5,0,0,0,-1,0,0,4
Albania,20/09/2005,6,0,0,0,0,0,0,6
Albania,21/09/2005,29,2,0,0,3,3,0,37
Albania,22/09/2005,12,0,0,0,0,0,0,12
Albania,23/09/2005,8,0,0,0,0,0,0,8
Albania,24/09/2005,2,0,0,0,0,0,0,2
Albania,25/09/2005,0,0,0,0,6,0,0,6
Albania,26/09/2005,5,0,0,0,0,0,0,5
Albania,27/09/2005,7,0,0,0,0,0,0,7
Albania,28/09/2005,5,0,0,0,0,0,0,5
Albania,29/09/2005,7,0,0,0,6,3,0,16
Albania,30/09/2005,5,0,0,0,3,0,0,8
Albania,01/10/2005,9,0,0,0,0,0,0,9
Albania,02/10/2005,0,0,0,0,0,0,0,0
Albania,03/10/2005,5,0,0,0,0,0,0,5
Albania,04/10/2005,1,0,0,0,2,1,0,4
Albania,05/10/2005,11,0,0,0,0,0,0,11
Albania,06/10/2005,4,0,0,0,6,0,0,10
Albania,07/10/2005,26,0,-1,0,3,0,0,28
Albania,08/10/2005,4,0,-1,0,0,0,0,3
Albania,09/10/2005,0,0,0,0,0,0,0,0
Albania,10/10/2005,0,0,0,0,0,0,0,0
Albania,11/10/2005,0,0,0,0,3,3,0,6
Albania,12/10/2005,6,0,0,0,6,0,0,12
Albania,13/10/2005,-1,0,0,0,3,0,0,2
Albania,14/10/2005,6,0,-1,0,0,0,0,5
Albania,15/10/2005,8,0,0,0,0,0,0,8
Albania,16/10/2005,-1,0,0,0,0,0,0,-1
Albania,17/10/2005,-2,0,0,0,0,0,0,-2
Albania,18/10/2005,0,0,-2,0,6,0,0,4
Albania,19/10/2005,17,0,-1,0,4,2,0,22
Albania,20/10/2005,9,0,0,0,0,1,0,10
Albania,21/10/2005,2,0,-3,0,0,0,0,-1
Albania,22/10/2005,6,0,0,0,0,0,0,6
Albania,23/10/2005,-2,0,0,0,0,0,0,-2
Albania,24/10/2005,2,0,0,0,0,3,0,5
Albania,25/10/2005,7,0,-1,0,18,0,0,24
Albania,26/10/2005,4,0,-1,0,3,4,0,10
Albania,27/10/2005,13,0,-2,0,0,0,0,11
Albania,28/10/2005,2,0,0,0,0,0,0,2
Albania,29/10/2005,0,0,1,0,3,3,0,7
Albania,31/10/2005,5,0,0,0,0,0,0,5
Albania,01/11/2005,7,0,-1,0,0,0,0,6
Albania,02/11/2005,6,0,0,0,0,0,0,6
Albania,03/11/2005,5,0,0,0,0,0,0,5
Albania,04/11/2005,2,0,0,0,0,0,0,2
Albania,05/11/2005,7,0,0,0,0,0,0,7
Albania,06/11/2005,5,0,0,0,0,0,0,5
Albania,07/11/2005,12,4,0,0,6,0,0,22
Albania,08/11/2005,12,0,0,0,6,0,0,18
Albania,09/11/2005,0,0,-2,0,-2,1,0,-3
Albania,10/11/2005,0,0,0,0,0,1,0,1
Albania,11/11/2005,2,0,-1,0,0,0,0,1
Albania,12/11/2005,0,0,-2,0,0,0,0,-2
Albania,13/11/2005,3,0,0,0,0,0,0,3
Albania,14/11/2005,0,0,0,0,0,0,0,0
Albania,15/11/2005,11,0,-2,0,4,0,0,13
Albania,16/11/2005,18,0,0,0,0,0,0,18
Albania,17/11/2005,11,0,0,0,3,4,0,18
Albania,18/11/2005,14,0,0,0,10,0,0,24
Albania,19/11/2005,10,0,0,0,0,1,0,11
Albania,20/11/2005,0,0,0,0,0,0,0,0
Albania,21/11/2005,4,0,-1,0,3,6,0,12
Albania,22/11/2005,34,0,0,0,0,1,0,35
Albania,23/11/2005,13,0,0,0,0,1,0,14
Albania,24/11/2005,2,0,-2,0,-2,0,0,-2
Albania,25/11/2005,9,0,0,0,-1,0,0,8
Albania,26/11/2005,9,0,0,0,0,0,0,9
Albania,27/11/2005,0,0,0,0,0,1,0,1
Albania,28/11/2005,4,0,0,0,7,0,0,11
Albania,29/11/2005,3,0,-1,0,9,0,0,11
Albania,30/11/2005,15,0,0,0,32,1,0,48
Albania,01/12/2005,0,0,0,0,6,0,0,6
Albania,02/12/2005,2,0,0,0,0,0,0,2
Albania,03/12/2005,0,0,0,0,3,0,0,3
Albania,04/12/2005,7,0,0,0,0,0,0,7
Albania,05/12/2005,0,0,0,0,3,0,0,3
Albania,06/12/2005,0,0,0,0,-4,2,0,-2
Albania,07/12/2005,9,0,0,0,3,6,0,18
Albania,08/12/2005,1,0,0,0,9,0,0,10
Albania,09/12/2005,15,0,0,0,7,0,0,22
Albania,10/12/2005,0,0,0,0,0,0,0,0
Albania,12/12/2005,3,0,0,0,0,0,0,3
Albania,13/12/2005,-1,0,-1,0,3,0,0,1
Albania,14/12/2005,5,0,-2,0,1,0,0,4
Albania,15/12/2005,9,0,0,0,1,0,0,10
Albania,16/12/2005,3,0,1,0,0,0,0,4
Albania,17/12/2005,4,0,0,0,0,0,0,4
Albania,18/12/2005,0,0,0,0,3,0,0,3
Albania,19/12/2005,10,0,-1,0,-6,0,0,3
Albania,20/12/2005,0,0,0,0,0,0,0,0
Albania,21/12/2005,1,0,0,0,0,0,0,1
Albania,22/12/2005,-1,0,0,0,3,0,0,2
Albania,23/12/2005,1,0,0,0,0,0,0,1
Albania,25/12/2005,2,0,0,0,3,1,0,6
Albania,26/12/2005,9,0,-3,0,3,0,0,9
Albania,27/12/2005,0,0,-3,0,0,0,0,-3
Albania,28/12/2005,3,0,0,0,3,0,0,6
Albania,29/12/2005,1,0,-2,0,0,0,0,-1
Albania,30/12/2005,12,0,0,0,6,0,0,18
Albania,31/12/2005,0,0,0,0,3,0,0,3
Algeria,03/01/2005,3,0,0,0,0,0,0,3
Algeria,04/01/2005,-6,0,0,0,0,0,0,-6
Algeria,05/01/2005,0,0,-4,0,0,0,0,-4
Algeria,06/01/2005,-6,0,0,0,0,0,0,-6
Algeria,07/01/2005,-1,0,0,0,1,0,0,0
Algeria,08/01/2005,-2,0,0,0,0,0,0,-2
Algeria,09/01/2005,0,0,0,0,0,0,0,0
Algeria,10/01/2005,0,0,0,0,0,0,0,0
Algeria,11/01/2005,-1,0,0,0,0,2,0,1
Algeria,12/01/2005,7,0,0,0,3,0,0,10
Algeria,13/01/2005,0,0,0,0,3,2,0,5
Algeria,14/01/2005,0,0,0,0,0,0,0,0
Algeria,15/01/2005,0,0,0,0,0,0,0,0
Algeria,16/01/2005,0,0,0,0,0,0,0,0
Algeria,17/01/2005,0,0,0,0,-1,0,0,-1
Algeria,18/01/2005,0,0,0,0,3,0,0,3
Algeria,19/01/2005,5,0,0,0,18,0,0,23
Algeria,20/01/2005,-1,0,0,0,0,0,0,-1
Algeria,21/01/2005,0,0,0,0,9,0,0,9
Algeria,22/01/2005,0,0,0,0,0,0,0,0
Algeria,23/01/2005,0,0,0,0,0,0,0,0
Algeria,24/01/2005,0,0,0,0,0,0,0,0
Algeria,25/01/2005,3,0,0,0,0,0,0,3
Algeria,26/01/2005,5,0,0,0,6,0,0,11
Algeria,27/01/2005,2,0,0,0,0,0,0,2
Algeria,28/01/2005,4,0,0,0,2,1,0,7
Algeria,29/01/2005,4,0,0,0,0,0,0,4
Algeria,30/01/2005,3,0,0,0,0,0,0,3
Algeria,31/01/2005,3,0,0,0,0,0,0,3
Algeria,01/02/2005,5,0,0,0,3,0,0,8
Algeria,02/02/2005,3,0,0,0,0,0,0,3
Algeria,03/02/2005,0,0,0,0,0,0,0,0
Algeria,04/02/2005,-6,0,0,0,0,0,0,-6
Algeria,05/02/2005,0,0,0,0,0,0,0,0
Algeria,06/02/2005,2,0,0,0,3,0,0,5
Algeria,07/02/2005,0,0,0,0,3,0,0,3
Algeria,08/02/2005,0,0,0,0,0,0,0,0
Algeria,09/02/2005,0,0,0,0,0,0,0,0
Algeria,10/02/2005,0,0,0,0,0,0,0,0
Algeria,11/02/2005,0,0,0,0,0,0,0,0
Algeria,12/02/2005,7,0,0,0,0,1,0,8
Algeria,13/02/2005,0,0,0,0,6,0,0,6
Algeria,14/02/2005,0,0,0,0,0,0,0,0
Algeria,15/02/2005,0,0,0,0,0,0,0,0
Algeria,16/02/2005,6,0,0,0,12,0,0,18
Algeria,17/02/2005,-1,0,0,0,0,0,0,-1
Algeria,18/02/2005,0,0,0,0,3,0,0,3
Algeria,19/02/2005,0,0,0,0,0,0,0,0
Algeria,20/02/2005,7,0,0,0,0,0,0,7
Algeria,21/02/2005,0,0,0,0,0,0,0,0
Algeria,22/02/2005,0,0,0,0,0,0,0,0
Algeria,23/02/2005,0,0,0,0,0,0,0,0
Algeria,24/02/2005,-2,0,0,0,0,0,0,-2
Algeria,25/02/2005,-1,0,0,0,3,0,0,2
Algeria,26/02/2005,0,0,0,0,0,0,0,0
Algeria,27/02/2005,0,0,0,0,3,0,0,3
Algeria,28/02/2005,0,0,0,0,3,0,0,3
Algeria,01/03/2005,0,0,0,0,0,0,0,0
Algeria,02/03/2005,0,0,0,0,0,0,0,0
Algeria,03/03/2005,0,0,0,0,3,0,0,3
Algeria,04/03/2005,2,0,0,0,0,0,0,2
Algeria,05/03/2005,0,0,0,0,9,0,0,9
Algeria,06/03/2005,0,0,0,0,3,0,0,3
Algeria,07/03/2005,0,0,0,0,0,0,0,0
Algeria,08/03/2005,0,0,0,0,0,0,0,0
Algeria,09/03/2005,2,0,0,0,0,0,0,2
Algeria,10/03/2005,5,0,0,0,12,0,0,17
Algeria,11/03/2005,-2,0,0,0,1,0,0,-1
Algeria,12/03/2005,0,0,0,0,9,0,0,9
Algeria,13/03/2005,0,0,0,0,0,0,0,0
Algeria,14/03/2005,3,0,0,0,0,0,0,3
Algeria,15/03/2005,0,0,0,0,6,0,0,6
Algeria,16/03/2005,-1,0,0,0,0,0,0,-1
Algeria,17/03/2005,1,0,0,0,0,0,0,1
Algeria,18/03/2005,5,0,0,0,24,0,0,29
Algeria,19/03/2005,10,0,0,0,0,0,0,10
Algeria,20/03/2005,1,0,0,0,0,0,0,1
Algeria,21/03/2005,2,0,-1,0,0,0,0,1
Algeria,22/03/2005,1,0,0,0,0,2,0,3
Algeria,23/03/2005,7,0,0,0,0,0,0,7
Algeria,24/03/2005,10,0,0,0,3,0,0,13
Algeria,25/03/2005,0,0,0,0,0,0,0,0
Algeria,26/03/2005,3,0,0,0,0,0,0,3
Algeria,27/03/2005,0,0,0,0,0,6,0,6
Algeria,28/03/2005,0,0,0,0,0,0,0,0
Algeria,29/03/2005,2,0,0,0,0,0,0,2
Algeria,30/03/2005,3,0,0,0,3,0,0,6
Algeria,31/03/2005,-1,0,0,0,0,0,0,-1
Algeria,01/04/2005,9,0,1,0,6,0,0,16
Algeria,02/04/2005,9,0,0,0,10,0,0,19
Algeria,03/04/2005,2,0,0,0,0,0,0,2
Algeria,05/04/2005,6,0,1,0,-2,0,0,5
Algeria,06/04/2005,4,0,0,0,0,0,0,4
Algeria,07/04/2005,-1,0,0,0,0,0,0,-1
Algeria,08/04/2005,-2,0,0,0,0,0,0,-2
Algeria,09/04/2005,-2,0,0,0,0,0,0,-2
Algeria,10/04/2005,0,0,0,0,0,0,0,0
Algeria,11/04/2005,-2,0,1,0,6,0,0,5
Algeria,12/04/2005,0,0,0,0,0,0,0,0
Algeria,13/04/2005,19,0,0,0,24,0,0,43
Algeria,14/04/2005,5,0,0,0,24,0,0,29
Algeria,15/04/2005,2,0,0,0,6,0,0,8
Algeria,16/04/2005,0,0,0,0,0,0,0,0
Algeria,17/04/2005,1,0,0,0,3,0,0,4
Algeria,18/04/2005,1,0,0,0,3,0,0,4
Algeria,19/04/2005,3,0,0,0,0,0,0,3
Algeria,20/04/2005,0,0,0,0,0,0,0,0
Algeria,21/04/2005,4,0,0,0,6,0,0,10
Algeria,22/04/2005,3,0,0,0,9,0,0,12
Algeria,23/04/2005,0,0,0,0,0,0,0,0
Algeria,24/04/2005,0,0,0,0,0,0,0,0
Algeria,25/04/2005,0,0,0,0,12,0,0,12
Algeria,26/04/2005,0,0,0,0,0,0,0,0
Algeria,27/04/2005,0,0,0,0,3,2,0,5
Algeria,28/04/2005,-5,0,0,0,3,0,0,-2
Algeria,30/04/2005,0,0,0,0,0,0,0,0
Algeria,01/05/2005,1,0,-4,0,0,0,0,-3
Algeria,02/05/2005,0,0,0,0,0,0,0,0
Algeria,03/05/2005,7,0,0,0,6,0,0,13
Algeria,04/05/2005,0,0,0,0,0,0,0,0
Algeria,05/05/2005,1,0,0,0,0,0,0,1
Algeria,06/05/2005,0,0,0,0,0,0,0,0
Algeria,09/05/2005,4,0,0,0,0,0,0,4
Algeria,10/05/2005,-1,0,0,0,0,0,0,-1
Algeria,11/05/2005,6,0,0,0,0,0,0,6
Algeria,13/05/2005,0,0,0,0,0,0,0,0
Algeria,14/05/2005,0,0,0,0,0,0,0,0
Algeria,16/05/2005,0,0,0,0,0,0,0,0
Algeria,17/05/2005,-6,0,0,0,6,0,0,0
Algeria,18/05/2005,3,0,0,0,18,0,0,21
Algeria,19/05/2005,3,0,0,0,0,0,0,3
Algeria,20/05/2005,3,0,0,0,3,0,0,6
Algeria,22/05/2005,2,0,0,0,0,1,0,3
Algeria,23/05/2005,-5,0,-1,0,0,3,0,-3
Algeria,24/05/2005,-5,0,0,0,0,0,0,-5
Algeria,25/05/2005,12,0,0,0,0,2,0,14
Algeria,26/05/2005,6,0,0,0,-2,4,0,8
Algeria,27/05/2005,-2,0,0,0,0,0,0,-2
Algeria,28/05/2005,0,0,0,0,0,0,0,0
Algeria,29/05/2005,0,0,0,0,0,0,0,0
Algeria,30/05/2005,0,0,0,0,1,0,0,1
Algeria,31/05/2005,9,0,0,0,0,2,0,11
Algeria,01/06/2005,3,0,0,0,0,0,0,3
Algeria,02/06/2005,0,0,0,0,0,0,0,0
Algeria,03/06/2005,3,0,0,0,0,0,0,3
Algeria,04/06/2005,0,0,0,0,9,0,0,9
Algeria,05/06/2005,30,0,0,0,21,3,0,54
Algeria,06/06/2005,2,0,0,0,-2,0,0,0
Algeria,07/06/2005,7,0,0,0,6,0,0,13
Algeria,08/06/2005,1,0,0,0,5,0,0,6
Algeria,09/06/2005,3,0,0,0,0,0,0,3
Algeria,11/06/2005,7,0,0,0,0,0,0,7
Algeria,12/06/2005,0,0,0,0,0,0,0,0
Algeria,13/06/2005,0,0,0,0,1,0,0,1
Algeria,14/06/2005,0,0,0,0,0,0,0,0
Algeria,15/06/2005,1,0,1,0,21,0,0,23
Algeria,16/06/2005,0,0,0,0,0,0,0,0
Algeria,17/06/2005,17,0,0,0,9,0,0,26
Algeria,18/06/2005,0,0,0,0,0,0,0,0
Algeria,19/06/2005,9,0,0,0,0,0,0,9
Algeria,20/06/2005,9,0,0,0,6,0,0,15
Algeria,21/06/2005,0,0,0,0,0,0,0,0
Algeria,22/06/2005,4,0,0,0,0,0,0,4
Algeria,23/06/2005,6,0,0,0,0,0,0,6
Algeria,24/06/2005,0,0,0,0,0,0,0,0
Algeria,25/06/2005,0,0,0,0,6,2,0,8
Algeria,26/06/2005,0,0,0,0,0,0,0,0
Algeria,27/06/2005,0,0,0,0,0,0,0,0
Algeria,28/06/2005,-1,0,0,0,15,0,0,14
Algeria,29/06/2005,0,0,0,0,0,0,0,0
Algeria,30/06/2005,7,0,0,0,6,0,0,13
Algeria,01/07/2005,0,0,0,0,0,2,0,2
Algeria,02/07/2005,3,0,0,0,3,0,0,6
Algeria,03/07/2005,3,0,0,0,0,0,0,3
Algeria,04/07/2005,3,0,0,0,-9,0,0,-6
Algeria,05/07/2005,4,0,0,0,3,1,0,8
Algeria,06/07/2005,0,0,0,0,0,0,0,0
Algeria,07/07/2005,1,0,0,0,0,6,0,7
Algeria,08/07/2005,0,0,0,0,0,0,0,0
Algeria,09/07/2005,9,0,0,0,0,0,0,9
Algeria,10/07/2005,8,0,0,0,3,1,0,12
Algeria,11/07/2005,2,0,0,0,0,2,0,4
Algeria,12/07/2005,0,0,0,0,0,0,0,0
Algeria,13/07/2005,3,0,0,0,6,0,0,9
Algeria,14/07/2005,6,0,0,0,0,0,0,6
Algeria,15/07/2005,0,0,0,0,0,0,0,0
Algeria,16/07/2005,4,0,0,0,0,0,0,4
Algeria,17/07/2005,0,0,0,0,0,0,0,0
Algeria,18/07/2005,0,0,0,0,3,0,0,3
Algeria,19/07/2005,6,0,0,0,6,1,0,13
Algeria,20/07/2005,0,0,0,0,0,0,0,0
Algeria,21/07/2005,1,0,0,0,39,9,0,49
Algeria,22/07/2005,4,0,0,0,9,0,0,13
Algeria,23/07/2005,3,0,0,0,14,2,0,19
Algeria,24/07/2005,0,0,0,0,0,0,0,0
Algeria,25/07/2005,2,0,0,0,19,0,0,21
Algeria,26/07/2005,6,0,-1,0,14,0,0,19
Algeria,27/07/2005,37,0,0,0,44,1,0,82
Algeria,28/07/2005,15,0,0,0,6,1,0,22
Algeria,29/07/2005,18,0,0,0,3,2,0,23
Algeria,30/07/2005,3,0,0,0,6,1,0,10
Algeria,31/07/2005,6,0,0,0,18,0,0,24
Algeria,01/08/2005,1,0,0,0,3,0,0,4
Algeria,02/08/2005,0,0,0,0,3,0,0,3
Algeria,03/08/2005,31,0,0,0,33,0,0,64
Algeria,04/08/2005,0,0,0,0,6,0,0,6
Algeria,05/08/2005,0,0,0,0,5,0,0,5
Algeria,06/08/2005,4,0,0,0,0,0,0,4
Algeria,08/08/2005,0,0,0,0,1,0,0,1
Algeria,09/08/2005,0,0,0,0,0,0,0,0
Algeria,10/08/2005,9,0,0,0,0,3,0,12
Algeria,11/08/2005,-1,0,0,0,0,0,0,-1
Algeria,12/08/2005,6,0,0,0,3,3,0,12
Algeria,13/08/2005,4,0,0,0,3,0,0,7
Algeria,14/08/2005,1,0,0,0,3,3,0,7
Algeria,15/08/2005,6,0,0,0,0,0,0,6
Algeria,16/08/2005,0,0,0,0,0,0,0,0
Algeria,17/08/2005,0,0,0,0,3,0,0,3
Algeria,18/08/2005,6,0,0,0,-1,0,0,5
Algeria,19/08/2005,1,0,0,0,-4,0,0,-3
Algeria,20/08/2005,1,0,0,0,0,2,0,3
Algeria,21/08/2005,0,0,0,0,0,0,0,0
Algeria,22/08/2005,0,0,0,0,21,0,0,21
Algeria,23/08/2005,0,0,0,0,2,0,0,2
Algeria,24/08/2005,1,0,0,0,-2,0,0,-1
Algeria,25/08/2005,5,0,0,0,0,2,0,7
Algeria,26/08/2005,0,0,0,0,3,0,0,3
Algeria,27/08/2005,0,0,0,0,9,0,0,9
Algeria,28/08/2005,0,0,0,0,0,0,0,0
Algeria,29/08/2005,0,0,0,0,3,0,0,3
Algeria,30/08/2005,8,0,0,0,0,0,0,8
Algeria,31/08/2005,4,0,0,0,0,0,0,4
Algeria,01/09/2005,0,0,0,0,0,1,0,1
Algeria,03/09/2005,3,0,0,0,0,0,0,3
Algeria,04/09/2005,0,0,0,0,0,0,0,0
Algeria,05/09/2005,0,0,0,0,0,0,0,0
Algeria,06/09/2005,0,0,0,0,0,2,0,2
Algeria,07/09/2005,12,0,0,0,15,0,0,27
Algeria,08/09/2005,9,0,0,0,1,1,0,11
Algeria,09/09/2005,0,0,0,0,0,0,0,0
Algeria,10/09/2005,3,0,0,0,0,0,0,3
Algeria,11/09/2005,2,2,0,0,-2,1,0,3
Algeria,13/09/2005,2,0,0,0,4,0,0,6
Algeria,14/09/2005,4,0,0,0,12,0,0,16
Algeria,15/09/2005,-3,0,-2,0,15,2,0,12
Algeria,16/09/2005,7,0,0,0,3,2,0,12
Algeria,17/09/2005,0,0,0,0,0,0,0,0
Algeria,18/09/2005,0,0,0,0,0,0,0,0
Algeria,19/09/2005,7,0,0,0,1,0,0,8
Algeria,20/09/2005,4,0,0,0,6,0,0,10
Algeria,21/09/2005,3,0,0,0,0,0,0,3
Algeria,22/09/2005,0,0,0,0,12,0,0,12
Algeria,23/09/2005,22,0,0,0,0,0,0,22
Algeria,24/09/2005,4,0,0,0,0,0,0,4
Algeria,25/09/2005,0,0,0,0,0,0,0,0
Algeria,26/09/2005,36,0,0,0,36,0,0,72
Algeria,27/09/2005,1,0,0,0,9,2,0,12
Algeria,28/09/2005,4,0,0,0,6,0,0,10
Algeria,29/09/2005,8,0,0,0,0,2,0,10
Algeria,30/09/2005,3,0,0,0,0,2,0,5
Algeria,01/10/2005,4,0,0,0,3,0,0,7
Algeria,02/10/2005,11,0,0,0,0,2,0,13
Algeria,03/10/2005,12,0,0,0,0,0,0,12
Algeria,04/10/2005,0,0,0,0,0,0,0,0
Algeria,05/10/2005,2,0,0,0,3,0,0,5
Algeria,06/10/2005,0,0,0,0,0,2,0,2
Algeria,07/10/2005,0,0,0,0,0,0,0,0
Algeria,08/10/2005,4,0,0,0,0,0,0,4
Algeria,09/10/2005,2,0,0,0,0,1,0,3
Algeria,10/10/2005,2,0,0,0,12,0,0,14
Algeria,11/10/2005,0,0,0,0,0,0,0,0
Algeria,12/10/2005,7,0,0,0,0,0,0,7
Algeria,13/10/2005,3,0,0,0,9,0,0,12
Algeria,14/10/2005,-2,0,0,0,3,0,0,1
Algeria,15/10/2005,17,0,0,0,0,2,0,19
Algeria,16/10/2005,2,0,0,0,0,0,0,2
Algeria,17/10/2005,0,0,0,0,0,0,0,0
Algeria,18/10/2005,0,0,0,0,0,0,0,0
Algeria,19/10/2005,6,0,0,0,-4,0,0,2
Algeria,20/10/2005,5,0,0,0,0,0,0,5
Algeria,21/10/2005,0,0,0,0,-2,0,0,-2
Algeria,22/10/2005,0,0,0,0,0,0,0,0
Algeria,23/10/2005,11,0,0,0,3,0,0,14
Algeria,24/10/2005,0,0,0,0,0,0,0,0
Algeria,25/10/2005,0,0,0,0,0,0,0,0
Algeria,26/10/2005,2,0,0,0,12,0,0,14
Algeria,27/10/2005,0,0,0,0,3,2,0,5
Algeria,28/10/2005,6,0,0,0,6,0,0,12
Algeria,29/10/2005,6,0,0,0,0,0,0,6
Algeria,30/10/2005,5,0,0,0,3,0,0,8
Algeria,31/10/2005,6,0,0,0,-3,0,0,3
Algeria,01/11/2005,12,0,0,0,0,0,0,12
Algeria,02/11/2005,2,0,0,0,3,0,0,5
Algeria,03/11/2005,6,0,0,0,0,0,0,6
Algeria,04/11/2005,4,0,0,0,12,0,0,16
Algeria,05/11/2005,2,0,0,0,9,0,0,11
Algeria,06/11/2005,0,0,0,0,0,0,0,0
Algeria,07/11/2005,6,0,0,0,3,0,0,9
Algeria,08/11/2005,5,0,0,0,18,2,0,25
Algeria,09/11/2005,18,0,0,0,3,9,0,30
Algeria,10/11/2005,3,0,0,0,0,0,0,3
Algeria,11/11/2005,18,0,0,0,3,6,0,27
Algeria,12/11/2005,2,0,0,0,3,0,0,5
Algeria,13/11/2005,0,0,0,0,0,0,0,0
Algeria,14/11/2005,-3,0,0,0,6,0,0,3
Algeria,15/11/2005,0,0,0,0,0,0,0,0
Algeria,16/11/2005,-1,0,0,0,0,0,0,-1
Algeria,17/11/2005,40,0,0,0,18,1,0,59
Algeria,18/11/2005,2,0,0,0,15,0,0,17
Algeria,19/11/2005,0,0,0,0,0,0,0,0
Algeria,20/11/2005,0,0,0,0,0,0,0,0
Algeria,21/11/2005,0,0,0,0,0,0,0,0
Algeria,22/11/2005,0,0,0,0,0,0,0,0
Algeria,23/11/2005,0,0,0,0,0,0,0,0
Algeria,24/11/2005,8,0,0,0,31,1,0,40
Algeria,25/11/2005,0,0,0,0,0,0,0,0
Algeria,26/11/2005,0,0,0,0,0,0,0,0
Algeria,27/11/2005,3,0,0,0,0,0,0,3
Algeria,28/11/2005,10,0,0,0,0,4,0,14
Algeria,29/11/2005,10,0,2,0,3,6,0,21
Algeria,30/11/2005,0,0,0,0,15,2,0,17
Algeria,01/12/2005,3,0,0,0,9,0,0,12
Algeria,02/12/2005,12,0,0,0,0,0,0,12
Algeria,03/12/2005,3,0,0,0,0,0,0,3
Algeria,04/12/2005,0,0,0,0,0,0,0,0
Algeria,06/12/2005,0,0,0,0,3,0,0,3
Algeria,07/12/2005,0,0,0,0,0,0,0,0
Algeria,08/12/2005,0,0,0,0,6,0,0,6
Algeria,09/12/2005,-1,0,0,0,9,0,0,8
Algeria,10/12/2005,1,0,0,0,0,0,0,1
Algeria,11/12/2005,0,0,0,0,0,0,0,0
Algeria,12/12/2005,2,0,0,0,2,0,0,4
Algeria,13/12/2005,0,0,0,0,36,3,0,39
Algeria,14/12/2005,6,0,0,0,29,0,0,35
Algeria,15/12/2005,6,0,0,0,0,0,0,6
Algeria,16/12/2005,20,0,0,0,13,0,0,33
Algeria,17/12/2005,0,0,0,0,3,0,0,3
Algeria,19/12/2005,5,0,0,0,0,0,0,5
Algeria,20/12/2005,13,0,0,0,12,0,0,25
Algeria,21/12/2005,0,0,0,0,0,0,0,0
Algeria,22/12/2005,2,2,1,0,-2,0,0,3
Algeria,23/12/2005,-1,0,1,0,12,0,0,12
Algeria,24/12/2005,4,0,0,0,0,4,0,8
Algeria,25/12/2005,0,0,0,0,0,0,0,0
Algeria,26/12/2005,0,0,0,0,-2,0,0,-2
Algeria,27/12/2005,2,0,0,0,0,1,0,3
Algeria,28/12/2005,0,0,0,0,3,0,0,3
Algeria,29/12/2005,0,0,0,0,3,0,0,3
Algeria,30/12/2005,2,0,0,0,6,0,0,8
Algeria,31/12/2005,2,0,0,0,0,0,0,2
Bangladesh,01/01/2005,7,0,0,0,0,0,0,7
Bangladesh,02/01/2005,6,0,0,0,0,0,0,6
Bangladesh,03/01/2005,0,0,0,0,0,0,0,0
Bangladesh,04/01/2005,0,0,0,0,3,0,0,3
Bangladesh,05/01/2005,12,0,0,0,0,0,0,12
Bangladesh,07/01/2005,0,0,0,0,0,0,0,0
Bangladesh,08/01/2005,0,0,0,0,0,0,0,0
Bangladesh,09/01/2005,-1,0,0,0,0,0,0,-1
Bangladesh,10/01/2005,-1,0,0,0,0,0,0,-1
Bangladesh,11/01/2005,6,0,0,0,0,2,0,8
Bangladesh,12/01/2005,6,0,0,0,0,0,0,6
Bangladesh,13/01/2005,0,0,0,0,0,0,0,0
Bangladesh,14/01/2005,0,0,0,0,6,0,0,6
Bangladesh,15/01/2005,0,0,0,0,0,0,0,0
Bangladesh,18/01/2005,3,0,0,0,0,0,0,3
Bangladesh,19/01/2005,0,0,0,0,0,0,0,0
Bangladesh,20/01/2005,1,0,0,0,3,0,0,4
Bangladesh,21/01/2005,0,0,0,0,0,0,0,0
Bangladesh,22/01/2005,0,0,0,0,0,1,0,1
Bangladesh,24/01/2005,3,0,0,0,0,2,0,5
Bangladesh,25/01/2005,2,0,0,0,3,0,0,5
Bangladesh,26/01/2005,0,0,0,0,-2,0,0,-2
Bangladesh,27/01/2005,4,0,0,0,6,0,0,10
Bangladesh,28/01/2005,2,0,0,0,0,4,0,6
Bangladesh,29/01/2005,0,0,0,0,0,0,0,0
Bangladesh,30/01/2005,0,0,0,0,0,0,0,0
Bangladesh,31/01/2005,9,0,1,0,0,0,0,10
Bangladesh,01/02/2005,0,0,0,0,0,0,0,0
Bangladesh,02/02/2005,-1,0,0,0,0,0,0,-1
Bangladesh,04/02/2005,3,0,0,0,0,0,0,3
Bangladesh,05/02/2005,3,0,0,0,0,1,0,4
Bangladesh,06/02/2005,6,0,0,0,0,0,0,6
Bangladesh,07/02/2005,2,0,0,0,15,0,0,17
Bangladesh,08/02/2005,0,0,0,0,6,0,0,6
Bangladesh,09/02/2005,4,0,0,0,0,0,0,4
Bangladesh,10/02/2005,3,0,0,0,0,0,0,3
Bangladesh,11/02/2005,2,0,0,0,3,0,0,5
Bangladesh,12/02/2005,0,0,0,0,0,0,0,0
Bangladesh,13/02/2005,0,0,0,0,0,0,0,0
Bangladesh,14/02/2005,2,0,0,0,0,0,0,2
Bangladesh,15/02/2005,1,0,0,0,3,0,0,4
Bangladesh,16/02/2005,0,0,0,0,-2,0,0,-2
Bangladesh,17/02/2005,11,0,0,0,0,0,0,11
Bangladesh,18/02/2005,6,0,0,0,0,0,0,6
Bangladesh,19/02/2005,0,0,0,0,3,0,0,3
Bangladesh,20/02/2005,3,0,0,0,0,0,0,3
Bangladesh,21/02/2005,9,0,0,0,3,0,0,12
Bangladesh,22/02/2005,0,0,0,0,-4,0,0,-4
Bangladesh,23/02/2005,9,0,0,0,0,0,0,9
Bangladesh,24/02/2005,0,0,0,0,0,2,0,2
Bangladesh,25/02/2005,3,0,0,0,3,4,0,10
Bangladesh,26/02/2005,6,0,0,0,12,6,0,24
Bangladesh,27/02/2005,15,0,0,0,0,3,0,18
Bangladesh,28/02/2005,30,0,0,0,4,8,0,42
Bangladesh,01/03/2005,12,0,0,0,6,0,0,18
Bangladesh,02/03/2005,26,0,-1,0,11,6,0,42
Bangladesh,03/03/2005,22,0,0,0,0,7,0,29
Bangladesh,04/03/2005,9,0,0,0,0,2,0,11
Bangladesh,06/03/2005,-1,0,0,0,0,0,0,-1
Bangladesh,07/03/2005,3,0,0,0,0,0,0,3
Bangladesh,08/03/2005,6,0,0,0,0,6,0,12
Bangladesh,09/03/2005,0,0,0,0,0,1,0,1
Bangladesh,10/03/2005,2,0,0,0,0,0,0,2
Bangladesh,11/03/2005,4,0,0,0,0,0,0,4
Bangladesh,12/03/2005,6,0,0,0,3,2,0,11
Bangladesh,13/03/2005,3,0,0,0,0,0,0,3
Bangladesh,14/03/2005,3,0,0,0,3,1,0,7
Bangladesh,15/03/2005,5,0,-6,0,-2,2,0,-1
Bangladesh,16/03/2005,0,0,0,0,0,0,0,0
Bangladesh,17/03/2005,0,0,0,0,0,0,0,0
Bangladesh,18/03/2005,3,0,0,0,24,2,0,29
Bangladesh,20/03/2005,2,0,0,0,0,1,0,3
Bangladesh,21/03/2005,3,0,0,0,15,0,0,18
Bangladesh,22/03/2005,10,0,0,0,9,0,0,19
Bangladesh,23/03/2005,3,0,0,0,0,6,0,9
Bangladesh,24/03/2005,3,0,0,0,0,0,0,3
Bangladesh,25/03/2005,1,0,0,0,0,0,0,1
Bangladesh,26/03/2005,21,0,0,0,12,2,0,35
Bangladesh,28/03/2005,11,0,0,0,0,2,0,13
Bangladesh,29/03/2005,6,0,0,0,0,0,0,6
Bangladesh,30/03/2005,6,0,0,0,4,0,0,10
Bangladesh,31/03/2005,0,0,0,0,6,0,0,6
Bangladesh,01/04/2005,3,0,0,0,0,2,0,5
Bangladesh,04/04/2005,0,0,0,0,0,0,0,0
Bangladesh,05/04/2005,0,0,0,0,0,0,0,0
Bangladesh,06/04/2005,0,0,0,0,0,0,0,0
Bangladesh,07/04/2005,4,0,0,0,0,0,0,4
Bangladesh,08/04/2005,3,0,0,0,0,0,0,3
Bangladesh,09/04/2005,1,0,0,0,0,1,0,2
Bangladesh,10/04/2005,2,0,0,0,0,0,0,2
Bangladesh,11/04/2005,0,0,0,0,0,0,0,0
Bangladesh,12/04/2005,27,0,0,0,15,0,0,42
Bangladesh,13/04/2005,0,0,0,0,0,0,0,0
Bangladesh,14/04/2005,0,0,0,0,0,0,0,0
Bangladesh,15/04/2005,3,0,0,0,1,0,0,4
Bangladesh,17/04/2005,9,0,0,0,3,0,0,12
Bangladesh,18/04/2005,5,0,0,0,11,0,0,16
Bangladesh,19/04/2005,0,0,0,0,0,0,0,0
Bangladesh,20/04/2005,6,0,0,0,0,0,0,6
Bangladesh,21/04/2005,0,0,0,0,0,0,0,0
Bangladesh,22/04/2005,7,0,0,0,3,2,0,12
Bangladesh,24/04/2005,2,0,0,0,0,0,0,2
Bangladesh,25/04/2005,1,0,0,0,0,4,0,5
Bangladesh,26/04/2005,3,0,0,0,0,4,0,7
Bangladesh,27/04/2005,-3,0,0,0,3,0,0,0
Bangladesh,28/04/2005,0,0,0,0,0,6,0,6
Bangladesh,29/04/2005,0,0,0,0,0,1,0,1
Bangladesh,30/04/2005,1,0,0,0,3,0,0,4
Bangladesh,01/05/2005,1,0,0,0,3,0,0,4
Bangladesh,02/05/2005,3,0,0,0,3,0,0,6
Bangladesh,03/05/2005,5,0,0,0,0,0,0,5
Bangladesh,04/05/2005,3,0,0,0,0,0,0,3
Bangladesh,05/05/2005,13,0,0,0,6,0,0,19
Bangladesh,06/05/2005,6,0,1,0,0,0,0,7
Bangladesh,07/05/2005,0,0,0,0,3,0,0,3
Bangladesh,08/05/2005,0,0,0,0,6,0,0,6
Bangladesh,09/05/2005,0,0,0,0,0,0,0,0
Bangladesh,10/05/2005,1,0,0,0,0,0,0,1
Bangladesh,11/05/2005,0,0,0,0,3,0,0,3
Bangladesh,12/05/2005,6,0,0,0,3,4,0,13
Bangladesh,13/05/2005,2,0,0,0,0,4,0,6
Bangladesh,14/05/2005,7,0,0,0,6,0,0,13
Bangladesh,15/05/2005,8,0,1,0,3,0,0,12
Bangladesh,16/05/2005,0,0,0,0,-2,1,0,-1
Bangladesh,17/05/2005,0,0,0,0,3,0,0,3
Bangladesh,18/05/2005,1,0,0,0,0,0,0,1
Bangladesh,19/05/2005,0,0,0,0,18,0,0,18
Bangladesh,21/05/2005,0,0,0,0,0,0,0,0
Bangladesh,22/05/2005,0,0,0,0,0,1,0,1
Bangladesh,23/05/2005,16,0,0,0,6,2,0,24
Bangladesh,24/05/2005,1,0,0,0,6,0,0,7
Bangladesh,25/05/2005,0,0,0,0,4,0,0,4
Bangladesh,26/05/2005,2,0,0,0,1,1,0,4
Bangladesh,27/05/2005,0,0,0,0,0,0,0,0
Bangladesh,28/05/2005,3,0,0,0,0,0,0,3
Bangladesh,29/05/2005,0,0,0,0,3,0,0,3
Bangladesh,30/05/2005,6,0,0,0,3,0,0,9
Bangladesh,31/05/2005,0,0,0,0,2,0,0,2
Bangladesh,01/06/2005,0,0,0,0,3,0,0,3
Bangladesh,02/06/2005,1,0,0,0,0,0,0,1
Bangladesh,03/06/2005,6,0,0,0,3,0,0,9
Bangladesh,04/06/2005,3,0,0,0,0,0,0,3
Bangladesh,05/06/2005,-1,0,0,0,0,0,0,-1
Bangladesh,06/06/2005,2,0,0,0,3,0,0,5
Bangladesh,13/06/2005,0,0,0,0,0,0,0,0
Bangladesh,14/06/2005,0,0,0,0,6,0,0,6
Bangladesh,15/06/2005,0,0,0,0,0,0,0,0
Bangladesh,16/06/2005,11,0,0,0,3,0,0,14
Bangladesh,21/06/2005,0,0,0,0,0,0,0,0
Bangladesh,22/06/2005,0,0,0,0,0,1,0,1
Bangladesh,23/06/2005,3,0,0,0,0,0,0,3
Bangladesh,24/06/2005,0,0,0,0,0,0,0,0
Bangladesh,25/06/2005,0,0,0,0,0,0,0,0
Bangladesh,26/06/2005,1,0,0,0,0,0,0,1
Bangladesh,27/06/2005,2,0,0,0,-4,0,0,-2
Bangladesh,28/06/2005,0,0,0,0,0,0,0,0
Bangladesh,29/06/2005,3,0,0,0,0,2,0,5
Bangladesh,30/06/2005,2,0,0,0,0,0,0,2
Bangladesh,01/07/2005,3,0,0,0,3,0,0,6
Bangladesh,02/07/2005,0,0,0,0,0,0,0,0
Bangladesh,04/07/2005,2,0,0,0,0,0,0,2
Bangladesh,05/07/2005,0,0,0,0,-2,0,0,-2
Bangladesh,06/07/2005,-3,0,0,0,0,0,0,-3
Bangladesh,07/07/2005,0,0,0,0,0,0,0,0
Bangladesh,08/07/2005,4,0,0,0,0,0,0,4
Bangladesh,09/07/2005,3,0,0,0,0,0,0,3
Bangladesh,11/07/2005,4,0,0,0,0,0,0,4
Bangladesh,12/07/2005,13,0,0,0,0,0,0,13
Bangladesh,13/07/2005,3,0,0,0,0,0,0,3
Bangladesh,14/07/2005,1,0,0,0,3,0,0,4
Bangladesh,15/07/2005,3,0,-1,0,0,0,0,2
Bangladesh,16/07/2005,3,0,0,0,0,0,0,3
Bangladesh,17/07/2005,0,0,0,0,0,0,0,0
Bangladesh,18/07/2005,3,0,0,0,0,0,0,3
Bangladesh,19/07/2005,3,0,0,0,3,0,0,6
Bangladesh,20/07/2005,5,0,0,0,0,0,0,5
Bangladesh,22/07/2005,0,0,0,0,0,0,0,0
Bangladesh,23/07/2005,0,0,0,0,0,0,0,0
Bangladesh,24/07/2005,0,0,0,0,0,1,0,1
Bangladesh,25/07/2005,3,0,0,0,0,0,0,3
Bangladesh,26/07/2005,3,0,0,0,0,0,0,3
Bangladesh,27/07/2005,0,0,0,0,0,0,0,0
Bangladesh,28/07/2005,0,0,0,0,0,1,0,1
Bangladesh,29/07/2005,0,0,0,0,0,0,0,0
Bangladesh,30/07/2005,0,0,0,0,0,0,0,0
Bangladesh,31/07/2005,0,0,0,0,6,0,0,6
Bangladesh,01/08/2005,0,0,-1,0,3,0,0,2
Bangladesh,02/08/2005,0,0,0,0,0,0,0,0
Bangladesh,03/08/2005,3,0,0,0,0,0,0,3
Bangladesh,04/08/2005,0,0,0,0,0,0,0,0
Bangladesh,05/08/2005,2,0,0,0,0,0,0,2
Bangladesh,06/08/2005,0,0,0,0,0,0,0,0
Bangladesh,07/08/2005,3,0,0,0,6,0,0,9
Bangladesh,08/08/2005,0,0,0,0,0,0,0,0
Bangladesh,13/08/2005,0,0,0,0,0,0,0,0
Bangladesh,15/08/2005,0,0,0,0,0,0,0,0
Bangladesh,16/08/2005,0,0,0,0,0,0,0,0
Bangladesh,17/08/2005,10,0,0,0,9,8,0,27
Bangladesh,18/08/2005,0,0,0,0,6,1,0,7
Bangladesh,19/08/2005,8,0,0,0,3,0,0,11
Bangladesh,20/08/2005,0,0,0,0,0,0,0,0
Bangladesh,21/08/2005,9,0,0,0,0,0,0,9
Bangladesh,22/08/2005,0,0,0,0,0,0,0,0
Bangladesh,23/08/2005,1,0,0,0,6,0,0,7
Bangladesh,24/08/2005,0,0,0,0,0,0,0,0
Bangladesh,26/08/2005,5,0,0,0,12,0,0,17
Bangladesh,27/08/2005,0,0,0,0,6,0,0,6
Bangladesh,28/08/2005,0,0,0,0,3,0,0,3
Bangladesh,29/08/2005,0,0,0,0,0,0,0,0
Bangladesh,30/08/2005,3,0,0,0,0,0,0,3
Bangladesh,31/08/2005,0,0,0,0,3,0,0,3
Bangladesh,01/09/2005,0,0,0,0,0,0,0,0
Bangladesh,02/09/2005,0,0,0,0,0,0,0,0
Bangladesh,03/09/2005,0,0,0,0,0,0,0,0
Bangladesh,05/09/2005,0,0,0,0,0,0,0,0
Bangladesh,06/09/2005,2,0,0,0,0,0,0,2
Bangladesh,07/09/2005,4,0,0,0,0,0,0,4
Bangladesh,08/09/2005,1,0,0,0,6,0,0,7
Bangladesh,09/09/2005,0,0,0,0,0,1,0,1
Bangladesh,10/09/2005,0,0,0,0,0,0,0,0
Bangladesh,11/09/2005,0,0,0,0,0,0,0,0
Bangladesh,12/09/2005,2,0,0,0,9,2,0,13
Bangladesh,13/09/2005,0,0,0,0,0,0,0,0
Bangladesh,14/09/2005,0,0,0,0,0,0,0,0
Bangladesh,15/09/2005,0,0,0,0,0,0,0,0
Bangladesh,17/09/2005,0,0,0,0,0,0,0,0
Bangladesh,18/09/2005,0,0,0,0,0,0,0,0
Bangladesh,19/09/2005,1,0,0,0,3,0,0,4
Bangladesh,20/09/2005,1,0,0,0,0,0,0,1
Bangladesh,21/09/2005,0,0,0,0,0,0,0,0
Bangladesh,22/09/2005,0,0,0,0,0,0,0,0
Bangladesh,23/09/2005,-2,0,0,0,3,1,0,2
Bangladesh,26/09/2005,0,0,0,0,0,2,0,2
Bangladesh,27/09/2005,1,0,0,0,0,4,0,5
Bangladesh,29/09/2005,0,2,-6,0,0,6,0,2
Bangladesh,30/09/2005,3,0,0,0,3,1,0,7
Bangladesh,01/10/2005,6,0,0,0,0,0,0,6
Bangladesh,03/10/2005,3,0,0,0,0,0,0,3
Bangladesh,04/10/2005,0,0,0,0,3,0,0,3
Bangladesh,05/10/2005,1,0,0,0,0,0,0,1
Bangladesh,07/10/2005,0,0,0,0,0,0,0,0
Bangladesh,08/10/2005,0,0,0,0,0,4,0,4
Bangladesh,10/10/2005,7,0,0,0,12,2,0,21
Bangladesh,11/10/2005,19,2,0,0,-2,0,0,19
Bangladesh,12/10/2005,12,2,0,0,0,0,0,14
Bangladesh,13/10/2005,0,0,0,0,0,0,0,0
Bangladesh,14/10/2005,0,0,0,0,0,0,0,0
Bangladesh,15/10/2005,0,0,0,0,0,0,0,0
Bangladesh,16/10/2005,2,0,0,0,0,0,0,2
Bangladesh,17/10/2005,11,0,0,0,3,0,0,14
Bangladesh,18/10/2005,24,0,0,0,3,11,0,38
Bangladesh,19/10/2005,5,0,0,0,0,3,0,8
Bangladesh,20/10/2005,2,0,0,0,0,0,0,2
Bangladesh,21/10/2005,7,0,0,0,3,0,0,10
Bangladesh,22/10/2005,2,0,0,0,0,0,0,2
Bangladesh,23/10/2005,4,0,0,0,0,0,0,4
Bangladesh,24/10/2005,0,0,0,0,0,0,0,0
Bangladesh,25/10/2005,9,0,0,0,9,0,0,18
Bangladesh,26/10/2005,5,0,0,0,0,0,0,5
Bangladesh,27/10/2005,0,0,0,0,0,0,0,0
Bangladesh,29/10/2005,4,0,0,0,5,1,0,10
Bangladesh,30/10/2005,0,0,0,0,0,0,0,0
Bangladesh,31/10/2005,0,0,0,0,3,0,0,3
Bangladesh,01/11/2005,0,0,0,0,3,0,0,3
Bangladesh,03/11/2005,0,0,0,0,3,0,0,3
Bangladesh,04/11/2005,0,0,0,0,3,0,0,3
Bangladesh,06/11/2005,0,0,0,0,0,0,0,0
Bangladesh,07/11/2005,0,0,0,0,0,1,0,1
Bangladesh,08/11/2005,0,0,0,0,0,0,0,0
Bangladesh,10/11/2005,0,0,0,0,0,0,0,0
Bangladesh,11/11/2005,0,0,-2,0,0,0,0,-2
Bangladesh,12/11/2005,2,0,0,0,0,0,0,2
Bangladesh,13/11/2005,0,0,0,0,0,0,0,0
Bangladesh,14/11/2005,21,0,0,0,0,12,0,33
Bangladesh,15/11/2005,0,0,0,0,0,0,0,0
Bangladesh,16/11/2005,2,0,0,0,0,0,0,2
Bangladesh,17/11/2005,3,0,-2,0,0,1,0,2
Bangladesh,18/11/2005,0,0,0,0,0,0,0,0
Bangladesh,19/11/2005,3,0,0,0,0,0,0,3
Bangladesh,20/11/2005,0,0,0,0,0,0,0,0
Bangladesh,21/11/2005,3,0,0,0,0,0,0,3
Bangladesh,22/11/2005,0,0,0,0,0,0,0,0
Bangladesh,23/11/2005,2,0,0,0,0,0,0,2
Bangladesh,24/11/2005,5,0,-1,0,0,0,0,4
Bangladesh,25/11/2005,5,0,0,0,9,0,0,14
Bangladesh,26/11/2005,0,0,0,0,0,0,0,0
Bangladesh,27/11/2005,0,0,0,0,0,0,0,0
Bangladesh,28/11/2005,0,0,0,0,0,0,0,0
Bangladesh,29/11/2005,3,0,-4,0,0,3,0,2
Bangladesh,30/11/2005,6,0,0,0,0,0,0,6
Bangladesh,01/12/2005,4,0,0,0,0,0,0,4
Bangladesh,02/12/2005,0,0,0,0,0,0,0,0
Bangladesh,03/12/2005,0,0,0,0,0,1,0,1
Bangladesh,04/12/2005,4,0,0,0,3,0,0,7
Bangladesh,05/12/2005,-1,0,-2,0,0,0,0,-3
Bangladesh,06/12/2005,0,0,0,0,9,0,0,9
Bangladesh,07/12/2005,0,0,0,0,0,0,0,0
Bangladesh,08/12/2005,23,0,0,0,6,3,0,32
Bangladesh,09/12/2005,0,0,0,0,9,0,0,9
Bangladesh,11/12/2005,0,0,0,0,0,0,0,0
Bangladesh,12/12/2005,6,0,0,0,15,0,0,21
Bangladesh,13/12/2005,5,0,0,0,15,0,0,20
Bangladesh,14/12/2005,4,0,0,0,1,0,0,5
Bangladesh,15/12/2005,8,0,0,0,9,0,0,17
Bangladesh,16/12/2005,2,0,0,0,0,1,0,3
Bangladesh,17/12/2005,1,0,0,0,3,0,0,4
Bangladesh,18/12/2005,2,0,0,0,0,0,0,2
Bangladesh,19/12/2005,4,0,0,0,9,3,0,16
Bangladesh,20/12/2005,11,0,0,0,9,0,0,20
Bangladesh,21/12/2005,0,0,0,0,0,0,0,0
Bangladesh,22/12/2005,6,0,-1,0,12,0,0,17
Bangladesh,23/12/2005,0,0,0,0,0,0,0,0
Bangladesh,24/12/2005,1,0,0,0,0,0,0,1
Bangladesh,25/12/2005,0,0,0,0,-2,0,0,-2
Bangladesh,27/12/2005,5,0,0,0,4,2,0,11
Bangladesh,28/12/2005,2,0,0,0,0,3,0,5
Bangladesh,29/12/2005,4,0,0,0,0,2,0,6
Bangladesh,30/12/2005,-1,0,0,0,-2,0,0,-3
Bangladesh,31/12/2005,0,0,0,0,0,0,0,0
Cameroon,01/01/2005,1,0,0,0,0,0,0,1
Cameroon,06/01/2005,0,0,0,0,0,0,0,0
Cameroon,07/01/2005,0,0,0,0,0,0,0,0
Cameroon,10/01/2005,0,0,0,0,0,0,0,0
Cameroon,12/01/2005,0,0,0,0,0,0,0,0
Cameroon,14/01/2005,0,0,0,0,0,0,0,0
Cameroon,17/01/2005,0,0,0,0,0,0,0,0
Cameroon,18/01/2005,0,0,0,0,0,0,0,0
Cameroon,19/01/2005,0,0,0,0,0,0,0,0
Cameroon,20/01/2005,0,0,0,0,0,0,0,0
Cameroon,23/01/2005,0,0,0,0,0,0,0,0
Cameroon,24/01/2005,0,0,0,0,0,0,0,0
Cameroon,25/01/2005,0,0,0,0,0,0,0,0
Cameroon,26/01/2005,0,0,0,0,0,0,0,0
Cameroon,27/01/2005,0,0,0,0,0,0,0,0
Cameroon,28/01/2005,0,0,0,0,0,0,0,0
Cameroon,30/01/2005,0,0,0,0,0,0,0,0
Cameroon,31/01/2005,0,0,0,0,0,0,0,0
Cameroon,01/02/2005,1,0,0,0,0,0,0,1
Cameroon,02/02/2005,0,0,0,0,0,0,0,0
Cameroon,05/02/2005,0,0,0,0,0,0,0,0
Cameroon,06/02/2005,0,0,0,0,0,0,0,0
Cameroon,07/02/2005,5,0,0,0,0,0,0,5
Cameroon,08/02/2005,2,0,0,0,3,0,0,5
Cameroon,09/02/2005,0,0,0,0,3,0,0,3
Cameroon,10/02/2005,0,0,0,0,0,0,0,0
Cameroon,12/02/2005,7,0,0,0,0,0,0,7
Cameroon,13/02/2005,0,0,0,0,0,0,0,0
Cameroon,15/02/2005,0,0,0,0,0,0,0,0
Cameroon,16/02/2005,0,0,0,0,0,0,0,0
Cameroon,17/02/2005,19,0,0,0,0,0,0,19
Cameroon,18/02/2005,1,0,0,0,15,1,0,17
Cameroon,22/02/2005,0,0,0,0,0,0,0,0
Cameroon,23/02/2005,0,0,0,0,0,0,0,0
Cameroon,24/02/2005,2,0,0,0,0,0,0,2
Cameroon,25/02/2005,0,0,0,0,0,0,0,0
Cameroon,26/02/2005,0,0,0,0,0,0,0,0
Cameroon,28/02/2005,-1,0,0,0,3,0,0,2
Cameroon,01/03/2005,1,0,0,0,0,0,0,1
Cameroon,02/03/2005,4,0,0,0,3,0,0,7
Cameroon,03/03/2005,3,0,0,0,0,0,0,3
Cameroon,04/03/2005,0,0,0,0,0,0,0,0
Cameroon,05/03/2005,0,0,0,0,0,0,0,0
Cameroon,06/03/2005,0,0,0,0,0,0,0,0
Cameroon,07/03/2005,3,0,0,0,3,0,0,6
Cameroon,08/03/2005,4,0,0,0,0,0,0,4
Cameroon,09/03/2005,0,0,0,0,0,0,0,0
Cameroon,10/03/2005,0,0,0,0,6,0,0,6
Cameroon,11/03/2005,9,0,1,0,4,0,0,14
Cameroon,13/03/2005,0,0,0,0,0,0,0,0
Cameroon,14/03/2005,0,0,0,0,6,0,0,6
Cameroon,15/03/2005,0,0,0,0,0,0,0,0
Cameroon,17/03/2005,4,0,0,0,0,0,0,4
Cameroon,18/03/2005,11,0,0,0,0,0,0,11
Cameroon,19/03/2005,0,0,0,0,0,0,0,0
Cameroon,21/03/2005,0,0,0,0,0,0,0,0
Cameroon,22/03/2005,1,0,0,0,1,1,0,3
Cameroon,24/03/2005,3,0,0,0,0,0,0,3
Cameroon,25/03/2005,0,0,0,0,0,0,0,0
Cameroon,28/03/2005,4,0,0,0,0,0,0,4
Cameroon,29/03/2005,2,0,0,0,0,0,0,2
Cameroon,01/04/2005,0,0,0,0,3,0,0,3
Cameroon,03/04/2005,0,0,0,0,0,0,0,0
Cameroon,05/04/2005,0,0,0,0,0,0,0,0
Cameroon,06/04/2005,0,0,0,0,0,0,0,0
Cameroon,07/04/2005,8,0,0,0,0,0,0,8
Cameroon,08/04/2005,0,2,0,0,0,0,0,2
Cameroon,11/04/2005,-2,0,0,0,0,0,0,-2
Cameroon,12/04/2005,0,0,0,0,0,0,0,0
Cameroon,13/04/2005,0,0,0,0,0,0,0,0
Cameroon,14/04/2005,1,0,0,0,0,0,0,1
Cameroon,15/04/2005,1,0,0,0,0,0,0,1
Cameroon,18/04/2005,3,0,0,0,0,0,0,3
Cameroon,20/04/2005,2,0,0,0,0,0,0,2
Cameroon,21/04/2005,0,0,0,0,0,0,0,0
Cameroon,22/04/2005,1,0,0,0,0,0,0,1
Cameroon,25/04/2005,0,0,0,0,0,0,0,0
Cameroon,26/04/2005,0,0,0,0,0,0,0,0
Cameroon,27/04/2005,0,0,0,0,12,0,0,12
Cameroon,28/04/2005,9,0,-2,0,0,0,0,7
Cameroon,29/04/2005,0,0,0,0,0,0,0,0
Cameroon,01/05/2005,0,0,0,0,0,0,0,0
Cameroon,03/05/2005,1,0,0,0,0,0,0,1
Cameroon,04/05/2005,0,0,0,0,0,0,0,0
Cameroon,06/05/2005,3,0,0,0,0,1,0,4
Cameroon,09/05/2005,0,0,0,0,0,0,0,0
Cameroon,10/05/2005,1,0,0,0,3,0,0,4
Cameroon,11/05/2005,-3,0,0,0,0,0,0,-3
Cameroon,13/05/2005,0,0,0,0,3,0,0,3
Cameroon,16/05/2005,-1,0,0,0,0,0,0,-1
Cameroon,17/05/2005,2,0,0,0,0,0,0,2
Cameroon,18/05/2005,6,0,0,0,0,0,0,6
Cameroon,19/05/2005,0,0,0,0,3,0,0,3
Cameroon,20/05/2005,0,0,0,0,12,0,0,12
Cameroon,22/05/2005,0,0,0,0,1,0,0,1
Cameroon,23/05/2005,0,0,0,0,0,0,0,0
Cameroon,24/05/2005,0,0,0,0,0,0,0,0
Cameroon,26/05/2005,0,0,0,0,0,0,0,0
Cameroon,27/05/2005,2,0,0,0,0,0,0,2
Cameroon,28/05/2005,0,0,0,0,0,0,0,0
Cameroon,29/05/2005,0,0,0,0,0,0,0,0
Cameroon,30/05/2005,3,0,0,0,0,0,0,3
Cameroon,02/06/2005,2,0,0,0,0,0,0,2
Cameroon,03/06/2005,0,0,0,0,0,0,0,0
Cameroon,06/06/2005,6,0,0,0,3,0,0,9
Cameroon,07/06/2005,0,0,0,0,0,0,0,0
Cameroon,08/06/2005,2,0,0,0,0,0,0,2
Cameroon,11/06/2005,0,0,0,0,0,-1,0,-1
Cameroon,14/06/2005,2,0,0,0,2,0,0,4
Cameroon,16/06/2005,4,0,0,0,-2,0,0,2
Cameroon,17/06/2005,1,0,0,0,-2,0,0,-1
Cameroon,19/06/2005,0,0,0,0,0,0,0,0
Cameroon,20/06/2005,0,0,0,0,0,1,0,1
Cameroon,21/06/2005,0,0,0,0,-2,1,0,-1
Cameroon,22/06/2005,1,0,0,0,0,0,0,1
Cameroon,23/06/2005,0,0,0,0,0,0,0,0
Cameroon,24/06/2005,0,0,0,0,-2,0,0,-2
Cameroon,26/06/2005,0,0,0,0,0,0,0,0
Cameroon,27/06/2005,2,0,0,0,3,0,0,5
Cameroon,28/06/2005,8,0,0,0,0,0,0,8
Cameroon,29/06/2005,11,0,0,0,0,2,0,13
Cameroon,30/06/2005,1,2,0,0,0,0,0,3
Cameroon,01/07/2005,0,0,0,0,3,0,0,3
Cameroon,03/07/2005,0,0,0,0,0,0,0,0
Cameroon,04/07/2005,0,0,0,0,0,0,0,0
Cameroon,05/07/2005,0,0,0,0,0,0,0,0
Cameroon,06/07/2005,0,0,0,0,0,0,0,0
Cameroon,08/07/2005,1,0,0,0,0,0,0,1
Cameroon,11/07/2005,8,0,0,0,0,0,0,8
Cameroon,12/07/2005,0,0,0,0,0,0,0,0
Cameroon,13/07/2005,3,0,0,0,0,0,0,3
Cameroon,14/07/2005,0,0,0,0,0,0,0,0
Cameroon,15/07/2005,0,0,0,0,0,0,0,0
Cameroon,18/07/2005,2,0,0,0,0,0,0,2
Cameroon,19/07/2005,5,0,0,0,0,0,0,5
Cameroon,21/07/2005,8,0,0,0,0,0,0,8
Cameroon,22/07/2005,1,0,0,0,3,0,0,4
Cameroon,23/07/2005,0,0,0,0,0,0,0,0
Cameroon,25/07/2005,7,0,0,0,0,0,0,7
Cameroon,26/07/2005,-3,0,0,0,0,0,0,-3
Cameroon,27/07/2005,1,0,0,0,0,0,0,1
Cameroon,28/07/2005,4,0,0,0,3,0,0,7
Cameroon,01/08/2005,0,0,2,0,0,0,0,2
Cameroon,02/08/2005,0,0,0,0,0,0,0,0
Cameroon,03/08/2005,1,0,0,0,0,0,0,1
Cameroon,04/08/2005,0,0,0,0,6,0,0,6
Cameroon,05/08/2005,2,0,0,0,0,4,0,6
Cameroon,08/08/2005,0,0,0,0,0,0,0,0
Cameroon,09/08/2005,2,0,0,0,3,2,0,7
Cameroon,10/08/2005,0,0,0,0,0,0,0,0
Cameroon,11/08/2005,2,0,0,0,0,1,0,3
Cameroon,12/08/2005,0,0,0,0,0,0,0,0
Cameroon,14/08/2005,0,0,0,0,6,0,0,6
Cameroon,16/08/2005,1,0,0,0,0,0,0,1
Cameroon,17/08/2005,0,0,0,0,0,0,0,0
Cameroon,18/08/2005,2,0,0,0,0,0,0,2
Cameroon,19/08/2005,1,0,0,0,0,0,0,1
Cameroon,22/08/2005,2,0,0,0,3,0,0,5
Cameroon,23/08/2005,0,0,0,0,0,1,0,1
Cameroon,25/08/2005,0,0,0,0,0,0,0,0
Cameroon,26/08/2005,0,0,0,0,0,0,0,0
Cameroon,27/08/2005,0,0,0,0,0,0,0,0
Cameroon,30/08/2005,-1,0,0,0,0,0,0,-1
Cameroon,31/08/2005,0,0,0,0,0,0,0,0
Cameroon,01/09/2005,1,0,0,0,0,0,0,1
Cameroon,02/09/2005,3,0,0,0,0,0,0,3
Cameroon,05/09/2005,2,0,0,0,0,0,0,2
Cameroon,06/09/2005,0,0,0,0,0,0,0,0
Cameroon,07/09/2005,6,0,0,0,0,0,0,6
Cameroon,08/09/2005,4,0,0,0,0,0,0,4
Cameroon,09/09/2005,0,0,0,0,0,0,0,0
Cameroon,10/09/2005,2,0,0,0,0,0,0,2
Cameroon,12/09/2005,0,0,0,0,0,0,0,0
Cameroon,13/09/2005,0,0,0,0,0,0,0,0
Cameroon,14/09/2005,0,0,0,0,0,2,0,2
Cameroon,15/09/2005,3,0,0,0,0,3,0,6
Cameroon,16/09/2005,4,0,0,0,15,0,0,19
Cameroon,19/09/2005,8,0,0,0,3,0,0,11
Cameroon,20/09/2005,0,0,0,0,0,0,0,0
Cameroon,21/09/2005,0,0,0,0,0,0,0,0
Cameroon,22/09/2005,-1,0,0,0,0,0,0,-1
Cameroon,23/09/2005,0,0,0,0,0,0,0,0
Cameroon,29/09/2005,16,0,0,0,0,2,0,18
Cameroon,30/09/2005,0,0,0,0,0,0,0,0
Cameroon,02/10/2005,0,0,0,0,0,3,0,3
Cameroon,03/10/2005,0,0,0,0,0,0,0,0
Cameroon,04/10/2005,0,0,0,0,0,0,0,0
Cameroon,05/10/2005,0,0,0,0,0,0,0,0
Cameroon,06/10/2005,4,0,0,0,0,0,0,4
Cameroon,07/10/2005,0,0,0,0,0,0,0,0
Cameroon,09/10/2005,3,0,0,0,0,0,0,3
Cameroon,10/10/2005,0,0,-4,0,0,0,0,-4
Cameroon,11/10/2005,0,0,0,0,0,0,0,0
Cameroon,12/10/2005,1,0,0,0,0,0,0,1
Cameroon,13/10/2005,0,0,0,0,0,0,0,0
Cameroon,15/10/2005,0,0,0,0,0,0,0,0
Cameroon,17/10/2005,0,0,0,0,0,0,0,0
Cameroon,19/10/2005,3,0,0,0,0,0,0,3
Cameroon,20/10/2005,3,0,0,0,0,0,0,3
Cameroon,21/10/2005,0,0,0,0,0,0,0,0
Cameroon,23/10/2005,0,0,0,0,0,0,0,0
Cameroon,24/10/2005,3,0,0,0,0,0,0,3
Cameroon,25/10/2005,0,0,0,0,0,0,0,0
Cameroon,26/10/2005,0,0,0,0,0,0,0,0
Cameroon,27/10/2005,-1,0,0,0,0,0,0,-1
Cameroon,30/10/2005,0,0,0,0,0,0,0,0
Cameroon,01/11/2005,0,0,0,0,-2,1,0,-1
Cameroon,02/11/2005,0,0,0,0,0,0,0,0
Cameroon,03/11/2005,0,0,0,0,0,0,0,0
Cameroon,04/11/2005,0,0,1,0,3,0,0,4
Cameroon,06/11/2005,0,0,0,0,0,0,0,0
Cameroon,07/11/2005,3,0,0,0,0,0,0,3
Cameroon,08/11/2005,0,0,0,0,-2,0,0,-2
Cameroon,09/11/2005,1,0,0,0,0,0,0,1
Cameroon,10/11/2005,0,0,0,0,0,0,0,0
Cameroon,13/11/2005,0,0,0,0,0,0,0,0
Cameroon,14/11/2005,0,0,0,0,0,0,0,0
Cameroon,15/11/2005,4,0,0,0,0,0,0,4
Cameroon,16/11/2005,6,0,0,0,0,0,0,6
Cameroon,17/11/2005,0,0,0,0,0,0,0,0
Cameroon,18/11/2005,0,0,0,0,0,0,0,0
Cameroon,21/11/2005,4,0,-4,0,0,0,0,0
Cameroon,22/11/2005,0,0,0,0,0,0,0,0
Cameroon,23/11/2005,1,0,0,0,0,0,0,1
Cameroon,25/11/2005,2,0,0,0,0,0,0,2
Cameroon,28/11/2005,4,0,0,0,3,2,0,9
Cameroon,29/11/2005,2,0,0,0,0,0,0,2
Cameroon,30/11/2005,1,0,0,0,0,0,0,1
Cameroon,01/12/2005,2,0,0,0,0,0,0,2
Cameroon,02/12/2005,0,0,0,0,0,0,0,0
Cameroon,03/12/2005,0,0,0,0,0,0,0,0
Cameroon,04/12/2005,0,0,0,0,0,0,0,0
Cameroon,05/12/2005,1,0,0,0,-2,0,0,-1
Cameroon,07/12/2005,0,0,0,0,6,0,0,6
Cameroon,08/12/2005,0,0,0,0,0,0,0,0
Cameroon,09/12/2005,4,0,0,0,0,0,0,4
Cameroon,12/12/2005,6,0,0,0,3,2,0,11
Cameroon,13/12/2005,-1,0,0,0,0,0,0,-1
Cameroon,14/12/2005,1,0,0,0,0,0,0,1
Cameroon,15/12/2005,0,0,0,0,0,1,0,1
Cameroon,18/12/2005,7,0,-1,0,3,0,0,9
Cameroon,20/12/2005,0,0,0,0,0,0,0,0
Cameroon,22/12/2005,5,0,0,0,0,0,0,5
Cameroon,24/12/2005,15,0,0,0,0,0,0,15
Cameroon,25/12/2005,9,0,0,0,3,0,0,12
Cameroon,27/12/2005,11,0,0,0,0,3,0,14
China,01/01/2005,0,0,0,0,0,0,0,0
China,02/01/2005,16,6,0,0,0,1,0,23
China,03/01/2005,8,0,0,0,0,7,0,15
China,04/01/2005,28,0,0,0,3,2,0,33
China,05/01/2005,2,0,0,0,3,0,0,5
China,06/01/2005,9,0,0,0,0,4,0,13
China,07/01/2005,-1,0,0,0,3,0,0,2
China,08/01/2005,-1,0,0,0,0,0,0,-1
China,09/01/2005,3,0,0,0,0,0,0,3
China,10/01/2005,11,0,0,0,6,0,0,17
China,11/01/2005,6,0,0,0,3,0,0,9
China,12/01/2005,16,0,0,0,3,0,0,19
China,13/01/2005,11,0,0,0,3,1,0,15
China,14/01/2005,1,0,0,0,13,2,0,16
China,15/01/2005,1,0,0,0,12,0,0,13
China,16/01/2005,3,0,0,0,0,0,0,3
China,17/01/2005,0,0,0,0,3,0,0,3
China,18/01/2005,4,0,0,0,-3,8,0,9
China,19/01/2005,15,0,0,0,9,0,0,24
China,20/01/2005,3,0,0,0,-1,3,0,5
China,21/01/2005,5,0,-1,0,-1,2,0,5
China,22/01/2005,5,0,0,0,-6,0,0,-1
China,23/01/2005,25,0,0,0,4,0,0,29
China,24/01/2005,16,0,-6,0,17,7,0,34
China,25/01/2005,18,2,2,0,15,1,0,38
China,26/01/2005,8,0,0,0,10,3,0,21
China,27/01/2005,13,0,0,0,21,0,0,34
China,28/01/2005,2,0,0,0,4,1,0,7
China,29/01/2005,0,0,0,0,0,1,0,1
China,30/01/2005,2,0,0,0,0,0,0,2
China,31/01/2005,21,0,0,0,6,2,0,29
China,01/02/2005,18,0,0,0,3,0,0,21
China,02/02/2005,9,0,0,0,2,3,0,14
China,03/02/2005,8,4,0,0,0,1,0,13
China,04/02/2005,3,0,0,0,21,0,0,24
China,05/02/2005,0,0,0,0,12,0,0,12
China,06/02/2005,5,0,0,0,0,0,0,5
China,07/02/2005,4,0,0,0,8,0,0,12
China,08/02/2005,14,0,-2,0,12,1,0,25
China,09/02/2005,7,0,0,0,8,2,0,17
China,10/02/2005,5,0,0,0,0,2,0,7
China,11/02/2005,8,2,0,0,12,0,0,22
China,12/02/2005,5,0,0,0,0,0,0,5
China,13/02/2005,3,0,1,0,-1,0,0,3
China,14/02/2005,0,0,0,0,0,3,0,3
China,15/02/2005,8,0,0,0,8,0,0,16
China,16/02/2005,1,0,0,0,0,0,0,1
China,17/02/2005,2,2,0,0,0,2,0,6
China,18/02/2005,12,0,0,0,12,2,0,26
China,19/02/2005,16,0,0,0,0,0,0,16
China,20/02/2005,7,0,0,0,0,0,0,7
China,21/02/2005,4,0,0,0,0,0,0,4
China,22/02/2005,9,0,0,0,0,0,0,9
China,23/02/2005,8,0,0,0,9,4,0,21
China,24/02/2005,17,0,-4,0,0,0,0,13
China,25/02/2005,6,2,0,0,7,0,0,15
China,26/02/2005,2,0,0,0,3,0,0,5
China,27/02/2005,6,0,0,0,6,1,0,13
China,28/02/2005,17,0,0,0,13,1,0,31
China,01/03/2005,6,0,0,0,6,3,0,15
China,02/03/2005,10,0,0,0,6,0,0,16
China,03/03/2005,19,0,1,0,2,0,0,22
China,04/03/2005,18,0,0,0,0,0,0,18
China,05/03/2005,2,0,0,0,-4,0,0,-2
China,06/03/2005,0,0,0,0,0,0,0,0
China,07/03/2005,14,2,0,0,-2,0,0,14
China,08/03/2005,19,0,0,0,7,2,0,28
China,09/03/2005,17,0,-1,0,9,1,0,26
China,10/03/2005,17,0,-7,0,9,3,0,22
China,11/03/2005,10,0,2,0,9,4,0,25
China,12/03/2005,0,0,-18,0,3,0,0,-15
China,13/03/2005,24,0,0,0,3,0,0,27
China,14/03/2005,21,0,0,0,11,1,0,33
China,15/03/2005,22,2,0,0,9,5,0,38
China,16/03/2005,7,0,0,0,-6,1,0,2
China,17/03/2005,18,0,-1,0,12,0,0,29
China,18/03/2005,34,0,1,0,6,0,0,41
China,19/03/2005,3,0,0,0,6,0,0,9
China,20/03/2005,11,0,0,0,0,0,0,11
China,21/03/2005,3,0,1,0,3,2,0,9
China,22/03/2005,28,0,-1,0,16,0,0,43
China,23/03/2005,27,0,0,0,4,1,0,32
China,24/03/2005,4,0,0,0,0,2,0,6
China,25/03/2005,3,0,0,0,3,0,0,6
China,26/03/2005,6,0,-1,0,3,4,0,12
China,27/03/2005,0,0,0,0,3,0,0,3
China,28/03/2005,6,0,0,0,12,0,0,18
China,29/03/2005,2,0,0,0,-3,2,0,1
China,30/03/2005,12,0,0,0,-2,0,0,10
China,31/03/2005,27,0,0,0,0,0,0,27
China,01/04/2005,11,0,0,0,0,5,0,16
China,02/04/2005,5,0,0,0,15,2,0,22
China,03/04/2005,13,0,0,0,6,2,0,21
China,04/04/2005,12,0,0,0,3,5,0,20
China,05/04/2005,9,0,0,0,1,8,0,18
China,06/04/2005,13,0,0,0,6,5,0,24
China,07/04/2005,6,0,0,0,13,0,0,19
China,08/04/2005,2,0,0,0,9,5,0,16
China,09/04/2005,12,0,0,0,7,0,0,19
China,10/04/2005,-1,0,0,0,10,1,0,10
China,11/04/2005,3,0,0,0,26,6,0,35
China,12/04/2005,7,0,0,0,12,2,0,21
China,13/04/2005,24,0,0,0,-7,3,0,20
China,14/04/2005,2,0,1,0,15,4,0,22
China,15/04/2005,1,0,0,0,12,0,0,13
China,16/04/2005,4,0,0,0,7,4,0,15
China,17/04/2005,2,0,-2,0,3,10,0,13
China,18/04/2005,12,0,0,0,17,1,0,30
China,19/04/2005,9,0,0,0,12,2,0,23
China,20/04/2005,30,0,0,0,4,4,0,38
China,21/04/2005,18,0,0,0,3,3,0,24
China,22/04/2005,18,0,0,0,-1,4,0,21
China,23/04/2005,14,0,0,0,0,1,0,15
China,24/04/2005,7,0,0,0,3,0,0,10
China,25/04/2005,23,0,0,0,0,9,0,32
China,26/04/2005,11,0,0,0,3,7,0,21
China,27/04/2005,-2,0,0,0,9,0,0,7
China,28/04/2005,19,0,0,0,-2,0,0,17
China,29/04/2005,9,0,1,0,0,0,0,10
China,30/04/2005,6,0,0,0,6,0,0,12
China,01/05/2005,0,0,0,0,-1,2,0,1
China,02/05/2005,5,0,0,0,3,0,0,8
China,03/05/2005,15,0,1,0,1,2,0,19
China,04/05/2005,-1,0,0,0,4,0,0,3
China,05/05/2005,0,0,0,0,3,0,0,3
China,06/05/2005,3,0,0,0,0,0,0,3
China,07/05/2005,-7,0,0,0,0,0,0,-7
China,08/05/2005,4,0,0,0,9,2,0,15
China,09/05/2005,6,0,-4,0,12,0,0,14
China,10/05/2005,11,0,0,0,0,0,0,11
China,11/05/2005,7,0,0,0,0,2,0,9
China,12/05/2005,6,0,0,0,6,1,0,13
China,13/05/2005,12,0,0,0,-8,2,0,6
China,14/05/2005,1,0,0,0,-4,0,0,-3
China,15/05/2005,16,0,0,0,0,3,0,19
China,16/05/2005,19,4,0,0,0,0,0,23
China,17/05/2005,13,0,0,0,0,1,0,14
China,18/05/2005,13,0,1,0,3,0,0,17
China,19/05/2005,19,0,0,0,0,1,0,20
China,20/05/2005,12,0,0,0,21,0,0,33
China,21/05/2005,5,0,0,0,16,0,0,21
China,22/05/2005,6,0,0,0,-2,0,0,4
China,23/05/2005,16,0,0,0,4,0,0,20
China,24/05/2005,18,0,0,0,20,1,0,39
China,25/05/2005,20,0,0,0,9,0,0,29
China,26/05/2005,15,0,0,0,14,7,0,36
China,27/05/2005,23,0,0,0,9,6,0,38
China,28/05/2005,11,0,0,0,3,2,0,16
China,29/05/2005,5,0,0,0,3,2,0,10
China,30/05/2005,-1,0,0,0,3,2,0,4
China,31/05/2005,4,0,0,0,7,3,0,14
China,01/06/2005,5,0,0,0,-2,0,0,3
China,02/06/2005,11,0,0,0,6,0,0,17
China,03/06/2005,2,0,-4,0,10,8,0,16
China,04/06/2005,13,0,0,0,6,0,0,19
China,05/06/2005,25,0,0,0,6,0,0,31
China,06/06/2005,33,2,0,0,0,0,0,35
China,07/06/2005,52,0,0,0,9,0,0,61
China,08/06/2005,65,0,0,0,3,1,0,69
China,09/06/2005,34,0,0,0,15,4,0,53
China,10/06/2005,-2,0,0,0,15,2,0,15
China,11/06/2005,13,0,0,0,2,0,0,15
China,12/06/2005,26,0,0,0,6,2,0,34
China,13/06/2005,12,0,0,0,14,0,0,26
China,14/06/2005,17,0,0,0,3,2,0,22
China,15/06/2005,6,0,0,0,0,2,0,8
China,16/06/2005,13,0,0,0,-6,3,0,10
China,17/06/2005,16,0,0,0,9,6,0,31
China,18/06/2005,9,0,0,0,9,0,0,18
China,19/06/2005,14,2,0,0,3,0,0,19
China,20/06/2005,21,2,0,0,12,0,0,35
China,21/06/2005,8,0,0,0,1,6,0,15
China,22/06/2005,15,0,0,0,0,0,0,15
China,23/06/2005,13,0,0,0,6,2,0,21
China,24/06/2005,4,2,0,0,3,1,0,10
China,25/06/2005,-2,0,0,0,0,0,0,-2
China,26/06/2005,3,0,1,0,18,0,0,22
China,27/06/2005,24,0,0,0,-2,0,0,22
China,28/06/2005,12,0,-6,0,0,0,0,6
China,29/06/2005,-4,0,0,0,14,1,0,11
China,30/06/2005,17,0,0,0,15,1,0,33
China,01/07/2005,19,0,0,0,6,0,0,25
China,02/07/2005,2,0,0,0,0,0,0,2
China,03/07/2005,-4,0,0,0,15,0,0,11
China,04/07/2005,30,0,0,0,3,2,0,35
China,05/07/2005,2,0,0,0,3,0,0,5
China,06/07/2005,0,0,0,0,3,0,0,3
China,07/07/2005,1,0,0,0,0,3,0,4
China,08/07/2005,10,0,0,0,12,3,0,25
China,09/07/2005,3,0,0,0,-2,0,0,1
China,10/07/2005,2,0,0,0,0,0,0,2
China,11/07/2005,0,0,0,0,6,1,0,7
China,12/07/2005,14,0,-6,0,-4,0,0,4
China,13/07/2005,4,0,0,0,6,0,0,10
China,14/07/2005,8,0,0,0,9,0,0,17
China,15/07/2005,32,2,0,0,7,2,0,43
China,16/07/2005,21,0,0,0,0,0,0,21
China,17/07/2005,1,0,0,0,-1,3,0,3
China,18/07/2005,1,0,0,0,13,0,0,14
China,19/07/2005,8,0,0,0,12,2,0,22
China,20/07/2005,6,0,0,0,4,1,0,11
China,21/07/2005,11,0,-1,0,0,0,0,10
China,22/07/2005,9,0,0,0,3,0,0,12
China,23/07/2005,5,0,0,0,-4,2,0,3
China,24/07/2005,30,0,-1,0,12,0,0,41
China,25/07/2005,15,8,-1,0,3,0,0,25
China,26/07/2005,15,0,0,0,-1,1,0,15
China,27/07/2005,10,0,0,0,0,5,0,15
China,28/07/2005,17,0,0,0,4,1,0,22
China,29/07/2005,6,0,0,0,0,2,0,8
China,30/07/2005,5,0,0,0,1,0,0,6
China,31/07/2005,11,0,0,0,-1,0,0,10
China,01/08/2005,21,0,-3,0,23,0,0,41
China,02/08/2005,25,0,0,0,12,0,0,37
China,03/08/2005,8,0,0,0,-1,1,0,8
China,04/08/2005,18,0,0,0,-2,2,0,18
China,05/08/2005,26,0,0,0,22,0,0,48
China,06/08/2005,3,0,0,0,16,0,0,19
China,07/08/2005,4,0,1,0,3,0,0,8
China,08/08/2005,12,0,1,0,9,0,0,22
China,09/08/2005,-3,0,0,0,-4,2,0,-5
China,10/08/2005,23,0,0,0,15,0,0,38
China,11/08/2005,14,0,0,0,6,5,0,25
China,12/08/2005,10,0,2,0,6,2,0,20
China,13/08/2005,5,0,0,0,3,0,0,8
China,14/08/2005,10,0,0,0,6,0,0,16
China,15/08/2005,7,0,0,0,22,0,0,29
China,16/08/2005,-2,0,0,0,0,-2,0,-4
China,17/08/2005,6,0,0,0,3,2,0,11
China,18/08/2005,8,0,0,0,6,0,0,14
China,19/08/2005,15,0,1,0,7,2,0,25
China,20/08/2005,9,0,0,0,2,8,0,19
China,21/08/2005,18,0,0,0,-4,-2,0,12
China,22/08/2005,18,0,0,0,0,0,0,18
China,23/08/2005,31,0,0,0,9,0,0,40
China,24/08/2005,16,0,0,0,15,0,0,31
China,25/08/2005,15,0,0,0,0,7,0,22
China,26/08/2005,2,0,0,0,6,0,0,8
China,27/08/2005,4,0,1,0,0,0,0,5
China,28/08/2005,7,0,0,0,3,0,0,10
China,29/08/2005,1,0,0,0,15,1,0,17
China,30/08/2005,2,0,0,0,15,7,0,24
China,31/08/2005,5,0,-1,0,14,4,0,22
China,01/09/2005,22,0,0,0,12,0,0,34
China,02/09/2005,15,0,0,0,14,0,0,29
China,03/09/2005,4,0,0,0,3,0,0,7
China,04/09/2005,8,0,0,0,6,0,0,14
China,05/09/2005,15,2,0,0,0,2,0,19
China,06/09/2005,28,2,0,0,10,0,0,40
China,07/09/2005,24,0,0,0,-2,1,0,23
China,08/09/2005,12,0,0,0,3,1,0,16
China,09/09/2005,8,0,0,0,1,0,0,9
China,10/09/2005,7,0,0,0,0,1,0,8
China,11/09/2005,13,0,1,0,0,2,0,16
China,12/09/2005,20,2,0,0,6,2,0,30
China,13/09/2005,13,0,0,0,2,6,0,21
China,14/09/2005,13,0,0,0,1,1,0,15
China,15/09/2005,3,0,0,0,-5,4,0,2
China,16/09/2005,7,0,1,0,1,5,0,14
China,17/09/2005,1,0,0,0,4,1,0,6
China,18/09/2005,-4,0,0,0,0,0,0,-4
China,19/09/2005,29,0,0,0,6,5,0,40
China,20/09/2005,-1,4,0,0,-3,0,0,0
China,21/09/2005,34,0,0,0,0,0,0,34
China,22/09/2005,3,0,-1,0,6,0,0,8
China,23/09/2005,0,0,0,0,7,1,0,8
China,24/09/2005,2,0,0,0,0,7,0,9
China,25/09/2005,13,0,0,0,0,0,0,13
China,26/09/2005,3,0,0,0,4,0,0,7
China,27/09/2005,5,0,0,0,15,0,0,20
China,28/09/2005,13,0,0,0,3,0,0,16
China,29/09/2005,6,0,1,0,0,1,0,8
China,30/09/2005,10,0,0,0,-4,3,0,9
China,01/10/2005,11,0,0,0,0,2,0,13
China,02/10/2005,9,0,0,0,1,0,0,10
China,03/10/2005,5,0,0,0,3,0,0,8
China,04/10/2005,4,0,0,0,12,0,0,16
China,05/10/2005,25,0,0,0,2,0,0,27
China,06/10/2005,13,0,-6,0,4,0,0,11
China,07/10/2005,7,0,0,0,-1,0,0,6
China,08/10/2005,17,0,0,0,3,4,0,24
China,09/10/2005,32,0,-2,0,0,2,0,32
China,10/10/2005,17,0,0,0,0,1,0,18
China,11/10/2005,7,0,0,0,3,2,0,12
China,12/10/2005,5,0,0,0,12,3,0,20
China,13/10/2005,2,0,0,0,4,2,0,8
China,14/10/2005,-2,0,0,0,0,0,0,-2
China,15/10/2005,6,0,0,0,-1,0,0,5
China,16/10/2005,8,0,0,0,0,0,0,8
China,17/10/2005,8,0,0,0,-2,2,0,8
China,18/10/2005,32,0,0,0,6,4,0,42
China,19/10/2005,16,0,0,0,3,5,0,24
China,20/10/2005,11,0,0,0,9,1,0,21
China,21/10/2005,15,0,0,0,6,0,0,21
China,22/10/2005,14,0,0,0,12,0,0,26
China,23/10/2005,10,2,0,0,1,0,0,13
China,24/10/2005,26,2,0,0,-2,2,0,28
China,25/10/2005,13,0,0,0,12,0,0,25
China,26/10/2005,28,0,0,0,12,0,0,40
China,27/10/2005,0,0,0,0,6,0,0,6
China,28/10/2005,3,0,-4,0,0,0,0,-1
China,29/10/2005,0,0,0,0,9,0,0,9
China,30/10/2005,-2,0,0,0,3,0,0,1
China,31/10/2005,15,0,0,0,-2,0,0,13
China,01/11/2005,1,0,1,0,3,2,0,7
China,02/11/2005,9,0,0,0,9,1,0,19
China,03/11/2005,9,0,0,0,-3,0,0,6
China,04/11/2005,-1,0,0,0,18,0,0,17
China,05/11/2005,2,0,0,0,0,1,0,3
China,06/11/2005,1,0,0,0,3,0,0,4
China,07/11/2005,5,0,0,0,0,1,0,6
China,08/11/2005,20,0,0,0,3,2,0,25
China,09/11/2005,1,0,0,0,4,0,0,5
China,10/11/2005,20,0,0,0,15,1,0,36
China,11/11/2005,9,0,0,0,2,0,0,11
China,12/11/2005,13,0,0,0,-2,0,0,11
China,13/11/2005,-1,0,0,0,3,2,0,4
China,14/11/2005,8,0,0,0,-4,2,0,6
China,15/11/2005,14,0,0,0,9,3,0,26
China,16/11/2005,13,0,-1,0,3,2,0,17
China,17/11/2005,16,0,0,0,2,1,0,19
China,18/11/2005,39,0,3,0,-2,1,0,41
China,19/11/2005,6,0,0,0,9,0,0,15
China,20/11/2005,8,0,-5,0,6,4,0,13
China,21/11/2005,6,0,2,0,6,0,0,14
China,22/11/2005,4,0,0,0,12,0,0,16
China,23/11/2005,4,0,0,0,15,0,0,19
China,24/11/2005,14,0,0,0,-2,1,0,13
China,25/11/2005,-1,0,0,0,3,3,0,5
China,26/11/2005,-2,0,0,0,6,1,0,5
China,27/11/2005,0,0,0,0,0,0,0,0
China,28/11/2005,17,0,0,0,15,0,0,32
China,29/11/2005,21,0,0,0,15,0,0,36
China,30/11/2005,22,0,0,0,3,1,0,26
China,01/12/2005,7,0,0,0,3,0,0,10
China,02/12/2005,11,0,0,0,5,2,0,18
China,03/12/2005,17,0,0,0,-2,0,0,15
China,04/12/2005,9,0,0,0,3,3,0,15
China,05/12/2005,1,0,0,0,12,0,0,13
China,06/12/2005,5,0,0,0,15,1,0,21
China,07/12/2005,6,0,0,0,3,0,0,9
China,08/12/2005,-3,0,0,0,6,2,0,5
China,09/12/2005,-2,0,0,0,9,5,0,12
China,10/12/2005,9,0,0,0,3,2,0,14
China,11/12/2005,3,0,0,0,3,0,0,6
China,12/12/2005,5,0,0,0,10,0,0,15
China,13/12/2005,17,0,0,0,31,0,0,48
China,14/12/2005,17,0,0,0,9,3,0,29
China,15/12/2005,7,0,0,0,9,6,0,22
China,16/12/2005,5,0,0,0,9,5,0,19
China,17/12/2005,9,0,0,0,3,0,0,12
China,18/12/2005,12,0,0,0,-2,1,0,11
China,19/12/2005,24,0,0,0,1,3,0,28
China,20/12/2005,7,2,0,0,3,1,0,13
China,21/12/2005,10,0,0,0,2,2,0,14
China,22/12/2005,20,0,1,0,16,0,0,37
China,23/12/2005,1,0,0,0,3,4,0,8
China,24/12/2005,8,0,0,0,3,0,0,11
China,25/12/2005,8,0,0,0,0,0,0,8
China,26/12/2005,-1,0,0,0,0,2,0,1
China,27/12/2005,1,0,0,0,-2,0,0,-1
China,28/12/2005,5,0,0,0,-2,1,0,4
China,29/12/2005,2,0,-4,0,0,0,0,-2
China,30/12/2005,1,0,0,0,3,0,0,4
China,31/12/2005,0,0,-2,0,2,2,0,2
Egypt,01/01/2005,1,0,0,0,0,2,0,3
Egypt,02/01/2005,15,0,0,0,-2,0,0,13
Egypt,03/01/2005,7,0,0,0,3,0,0,10
Egypt,04/01/2005,4,6,0,0,0,0,0,10
Egypt,05/01/2005,9,0,0,0,24,0,0,33
Egypt,06/01/2005,21,0,0,0,37,3,0,61
Egypt,07/01/2005,9,0,0,0,13,0,0,22
Egypt,08/01/2005,6,0,0,0,12,0,0,18
Egypt,09/01/2005,9,0,0,0,4,0,0,13
Egypt,10/01/2005,8,0,0,0,7,0,0,15
Egypt,11/01/2005,13,0,-4,0,17,0,0,26
Egypt,12/01/2005,-1,0,0,0,0,0,0,-1
Egypt,13/01/2005,3,0,0,0,42,5,0,50
Egypt,14/01/2005,3,0,0,0,12,0,0,15
Egypt,15/01/2005,0,0,0,0,0,1,0,1
Egypt,16/01/2005,2,0,0,0,0,2,0,4
Egypt,17/01/2005,3,0,1,0,-6,2,0,0
Egypt,18/01/2005,6,0,0,0,0,3,0,9
Egypt,19/01/2005,1,0,0,0,0,2,0,3
Egypt,20/01/2005,15,0,0,0,4,0,0,19
Egypt,21/01/2005,25,0,0,0,0,0,0,25
Egypt,22/01/2005,3,0,0,0,0,0,0,3
Egypt,23/01/2005,0,0,0,0,0,1,0,1
Egypt,24/01/2005,4,0,0,0,0,1,0,5
Egypt,25/01/2005,0,0,0,0,10,0,0,10
Egypt,26/01/2005,32,0,0,0,12,0,0,44
Egypt,27/01/2005,6,0,-1,0,0,0,0,5
Egypt,28/01/2005,-1,0,0,0,14,4,0,17
Egypt,29/01/2005,2,0,1,0,6,0,0,9
Egypt,30/01/2005,10,0,0,0,-2,3,0,11
Egypt,31/01/2005,28,0,0,0,8,0,0,36
Egypt,01/02/2005,28,0,0,0,-6,2,0,24
Egypt,02/02/2005,11,0,0,0,-1,2,0,12
Egypt,03/02/2005,10,0,1,0,-6,0,0,5
Egypt,04/02/2005,4,0,0,0,-6,4,0,2
Egypt,05/02/2005,11,0,0,0,0,0,0,11
Egypt,06/02/2005,29,0,0,0,18,2,0,49
Egypt,07/02/2005,1,0,-2,0,3,5,0,7
Egypt,08/02/2005,8,0,0,0,-6,0,0,2
Egypt,09/02/2005,12,0,0,0,9,0,0,21
Egypt,10/02/2005,4,0,0,0,14,0,0,18
Egypt,11/02/2005,16,0,0,0,0,0,0,16
Egypt,12/02/2005,0,0,0,0,0,0,0,0
Egypt,13/02/2005,9,0,0,0,2,1,0,12
Egypt,14/02/2005,6,0,0,0,15,1,0,22
Egypt,15/02/2005,5,0,0,0,9,0,0,14
Egypt,16/02/2005,20,0,0,0,0,0,0,20
Egypt,17/02/2005,2,0,0,0,3,2,0,7
Egypt,18/02/2005,-3,0,0,0,3,3,0,3
Egypt,19/02/2005,2,0,0,0,0,4,0,6
Egypt,20/02/2005,13,0,0,0,0,3,0,16
Egypt,21/02/2005,0,0,0,0,0,0,0,0
Egypt,22/02/2005,1,0,0,0,0,0,0,1
Egypt,23/02/2005,26,0,2,0,0,0,0,28
Egypt,24/02/2005,3,0,0,0,0,0,0,3
Egypt,25/02/2005,2,0,0,0,9,3,0,14
Egypt,26/02/2005,-1,0,0,0,18,3,0,20
Egypt,27/02/2005,4,0,-2,0,0,0,0,2
Egypt,28/02/2005,-3,0,0,0,0,0,0,-3
Egypt,01/03/2005,10,0,0,0,0,0,0,10
Egypt,02/03/2005,0,0,0,0,-2,6,0,4
Egypt,03/03/2005,-2,0,0,0,0,0,0,-2
Egypt,04/03/2005,3,0,0,0,0,0,0,3
Egypt,05/03/2005,-1,0,0,0,0,0,0,-1
Egypt,06/03/2005,-1,0,0,0,3,0,0,2
Egypt,07/03/2005,2,0,0,0,0,1,0,3
Egypt,08/03/2005,5,0,0,0,9,1,0,15
Egypt,09/03/2005,32,0,1,0,-3,0,0,30
Egypt,10/03/2005,1,0,0,0,-4,3,0,0
Egypt,11/03/2005,0,0,0,0,12,0,0,12
Egypt,12/03/2005,1,0,0,0,-6,0,0,-5
Egypt,13/03/2005,6,0,0,0,3,0,0,9
Egypt,14/03/2005,0,0,0,0,6,0,0,6
Egypt,15/03/2005,10,0,0,0,-1,4,0,13
Egypt,16/03/2005,-7,0,0,0,-2,1,0,-8
Egypt,17/03/2005,10,0,0,0,0,2,0,12
Egypt,18/03/2005,3,0,0,0,1,0,0,4
Egypt,19/03/2005,3,0,0,0,3,0,0,6
Egypt,20/03/2005,34,0,0,0,0,6,0,40
Egypt,21/03/2005,4,0,0,0,3,0,0,7
Egypt,22/03/2005,3,0,0,0,4,4,0,11
Egypt,23/03/2005,7,0,0,0,7,0,0,14
Egypt,24/03/2005,-21,0,0,0,0,0,0,-21
Egypt,25/03/2005,5,0,0,0,0,1,0,6
Egypt,26/03/2005,-4,0,0,0,0,0,0,-4
Egypt,27/03/2005,12,0,0,0,24,0,0,36
Egypt,28/03/2005,4,0,0,0,0,0,0,4
Egypt,29/03/2005,0,0,0,0,0,1,0,1
Egypt,30/03/2005,8,0,0,0,6,0,0,14
Egypt,31/03/2005,3,0,0,0,0,2,0,5
Egypt,01/04/2005,3,0,0,0,-2,0,0,1
Egypt,02/04/2005,4,0,0,0,0,0,0,4
Egypt,03/04/2005,7,0,0,0,0,1,0,8
Egypt,04/04/2005,8,0,0,0,15,0,0,23
Egypt,05/04/2005,25,0,0,0,0,0,0,25
Egypt,06/04/2005,0,0,0,0,0,0,0,0
Egypt,07/04/2005,8,0,-2,0,0,0,0,6
Egypt,08/04/2005,3,0,0,0,0,0,0,3
Egypt,09/04/2005,4,0,0,0,6,0,0,10
Egypt,10/04/2005,0,0,0,0,0,0,0,0
Egypt,11/04/2005,0,0,0,0,-2,0,0,-2
Egypt,12/04/2005,2,0,0,0,0,1,0,3
Egypt,13/04/2005,4,0,0,0,3,0,0,7
Egypt,14/04/2005,20,0,0,0,9,0,0,29
Egypt,15/04/2005,22,0,0,0,3,0,0,25
Egypt,16/04/2005,3,0,0,0,0,0,0,3
Egypt,17/04/2005,-3,2,0,0,0,0,0,-1
Egypt,18/04/2005,12,0,0,0,0,10,0,22
Egypt,19/04/2005,2,0,0,0,0,0,0,2
Egypt,20/04/2005,4,0,0,0,0,0,0,4
Egypt,21/04/2005,4,0,0,0,1,0,0,5
Egypt,22/04/2005,0,0,0,0,0,0,0,0
Egypt,23/04/2005,1,0,0,0,-2,7,0,6
Egypt,24/04/2005,4,0,1,0,1,0,0,6
Egypt,25/04/2005,-1,0,0,0,0,0,0,-1
Egypt,26/04/2005,0,0,-3,0,0,3,0,0
Egypt,27/04/2005,-2,0,0,0,6,0,0,4
Egypt,28/04/2005,-5,0,0,0,0,0,0,-5
Egypt,29/04/2005,1,0,0,0,3,0,0,4
Egypt,30/04/2005,4,0,0,0,0,0,0,4
Egypt,01/05/2005,4,0,0,0,1,0,0,5
Egypt,02/05/2005,2,0,0,0,3,0,0,5
Egypt,03/05/2005,17,0,0,0,0,4,0,21
Egypt,04/05/2005,1,0,0,0,-8,0,0,-7
Egypt,05/05/2005,4,0,0,0,3,1,0,8
Egypt,06/05/2005,-1,0,0,0,9,0,0,8
Egypt,07/05/2005,0,0,0,0,3,0,0,3
Egypt,08/05/2005,1,0,0,0,0,0,0,1
Egypt,09/05/2005,-1,0,0,0,9,0,0,8
Egypt,10/05/2005,9,0,-2,0,0,0,0,7
Egypt,11/05/2005,-1,0,0,0,6,0,0,5
Egypt,12/05/2005,18,0,2,0,3,0,0,23
Egypt,13/05/2005,1,0,0,0,0,0,0,1
Egypt,14/05/2005,2,0,0,0,1,2,0,5
Egypt,15/05/2005,2,0,1,0,3,0,0,6
Egypt,16/05/2005,5,0,0,0,0,1,0,6
Egypt,17/05/2005,-20,0,0,0,0,1,0,-19
Egypt,18/05/2005,14,0,-2,0,12,4,0,28
Egypt,19/05/2005,3,0,0,0,26,2,0,31
Egypt,20/05/2005,11,0,0,0,18,0,0,29
Egypt,21/05/2005,7,0,0,0,3,1,0,11
Egypt,22/05/2005,7,0,0,0,3,0,0,10
Egypt,23/05/2005,12,0,1,0,6,0,0,19
Egypt,24/05/2005,4,0,1,0,7,0,0,12
Egypt,25/05/2005,0,0,0,0,0,0,0,0
Egypt,26/05/2005,13,0,-4,0,6,4,0,19
Egypt,27/05/2005,10,0,0,0,3,0,0,13
Egypt,28/05/2005,2,0,0,0,2,2,0,6
Egypt,29/05/2005,5,0,0,0,3,0,0,8
Egypt,30/05/2005,2,0,0,0,-2,2,0,2
Egypt,31/05/2005,10,0,0,0,0,1,0,11
Egypt,01/06/2005,-2,0,0,0,0,2,0,0
Egypt,02/06/2005,-1,0,0,0,0,0,0,-1
Egypt,03/06/2005,3,0,0,0,-3,0,0,0
Egypt,04/06/2005,5,0,0,0,0,1,0,6
Egypt,05/06/2005,3,0,0,0,0,1,0,4
Egypt,06/06/2005,9,0,0,0,0,0,0,9
Egypt,07/06/2005,42,0,0,0,0,0,0,42
Egypt,08/06/2005,1,0,-4,0,24,1,0,22
Egypt,09/06/2005,2,0,0,0,3,1,0,6
Egypt,10/06/2005,8,0,0,0,0,0,0,8
Egypt,11/06/2005,1,0,0,0,-2,0,0,-1
Egypt,12/06/2005,8,0,0,0,-4,2,0,6
Egypt,13/06/2005,9,0,0,0,0,0,0,9
Egypt,14/06/2005,13,0,0,0,-6,1,0,8
Egypt,15/06/2005,0,0,1,0,3,0,0,4
Egypt,16/06/2005,3,0,0,0,3,0,0,6
Egypt,17/06/2005,24,0,0,0,3,0,0,27
Egypt,18/06/2005,9,0,-4,0,1,0,0,6
Egypt,19/06/2005,9,0,0,0,3,2,0,14
Egypt,20/06/2005,0,0,0,0,3,0,0,3
Egypt,21/06/2005,24,0,0,0,9,4,0,37
Egypt,22/06/2005,8,0,0,0,10,2,0,20
Egypt,23/06/2005,0,0,0,0,6,0,0,6
Egypt,24/06/2005,4,0,0,0,-1,2,0,5
Egypt,25/06/2005,0,0,0,0,6,2,0,8
Egypt,26/06/2005,10,0,0,0,0,0,0,10
Egypt,27/06/2005,-2,0,0,0,6,1,0,5
Egypt,28/06/2005,25,0,0,0,4,1,0,30
Egypt,29/06/2005,21,0,0,0,6,3,0,30
Egypt,30/06/2005,0,0,0,0,0,0,0,0
Egypt,01/07/2005,-1,0,-1,0,3,0,0,1
Egypt,02/07/2005,3,0,0,0,0,1,0,4
Egypt,03/07/2005,3,0,0,0,12,2,0,17
Egypt,04/07/2005,-3,0,0,0,8,0,0,5
Egypt,05/07/2005,37,0,0,0,-1,0,0,36
Egypt,06/07/2005,2,0,0,0,14,2,0,18
Egypt,07/07/2005,32,0,0,0,17,2,0,51
Egypt,08/07/2005,49,0,2,0,28,3,0,82
Egypt,09/07/2005,10,0,3,0,6,0,0,19
Egypt,10/07/2005,8,0,0,0,0,4,0,12
Egypt,11/07/2005,10,0,0,0,3,0,0,13
Egypt,12/07/2005,5,0,0,0,15,3,0,23
Egypt,13/07/2005,13,0,0,0,3,2,0,18
Egypt,14/07/2005,28,0,0,0,39,0,0,67
Egypt,15/07/2005,13,0,0,0,34,0,0,47
Egypt,16/07/2005,5,0,0,0,0,0,0,5
Egypt,17/07/2005,3,0,0,0,0,0,0,3
Egypt,18/07/2005,13,0,0,0,19,1,0,33
Egypt,19/07/2005,31,0,0,0,9,0,0,40
Egypt,20/07/2005,8,0,0,0,12,2,0,22
Egypt,21/07/2005,3,0,0,0,30,0,0,33
Egypt,22/07/2005,8,0,0,0,9,1,0,18
Egypt,23/07/2005,47,0,0,0,12,17,0,76
Egypt,24/07/2005,41,0,0,0,3,7,0,51
Egypt,25/07/2005,11,0,0,0,18,0,0,29
Egypt,26/07/2005,17,0,0,0,3,3,0,23
Egypt,27/07/2005,23,0,0,0,33,1,0,57
Egypt,28/07/2005,25,0,0,0,12,0,0,37
Egypt,29/07/2005,27,0,0,0,18,2,0,47
Egypt,30/07/2005,4,0,0,0,15,2,0,21
Egypt,31/07/2005,1,0,0,0,0,0,0,1
Egypt,01/08/2005,9,0,0,0,11,2,0,22
Egypt,02/08/2005,0,0,0,0,0,0,0,0
Egypt,03/08/2005,0,0,0,0,9,0,0,9
Egypt,04/08/2005,5,0,0,0,6,0,0,11
Egypt,05/08/2005,-5,0,0,0,-2,1,0,-6
Egypt,06/08/2005,1,0,0,0,0,0,0,1
Egypt,07/08/2005,7,0,0,0,-2,0,0,5
Egypt,08/08/2005,0,0,0,0,-4,0,0,-4
Egypt,09/08/2005,16,0,0,0,-2,1,0,15
Egypt,10/08/2005,6,0,0,0,6,1,0,13
Egypt,11/08/2005,0,0,0,0,-2,1,0,-1
Egypt,12/08/2005,-1,0,2,0,18,2,0,21
Egypt,13/08/2005,0,0,0,0,-2,0,0,-2
Egypt,14/08/2005,14,0,0,0,9,0,0,23
Egypt,15/08/2005,1,0,0,0,3,0,0,4
Egypt,16/08/2005,-3,0,0,0,12,0,0,9
Egypt,17/08/2005,9,0,0,0,6,3,0,18
Egypt,18/08/2005,1,0,0,0,6,8,0,15
Egypt,19/08/2005,9,0,0,0,3,0,0,12
Egypt,20/08/2005,12,0,0,0,-2,12,0,22
Egypt,21/08/2005,2,0,0,0,6,0,0,8
Egypt,22/08/2005,10,0,0,0,-1,-1,0,8
Egypt,23/08/2005,15,0,0,0,8,0,0,23
Egypt,24/08/2005,-3,0,0,0,-2,1,0,-4
Egypt,25/08/2005,13,0,0,0,3,0,0,16
Egypt,26/08/2005,6,0,0,0,6,0,0,12
Egypt,27/08/2005,0,0,0,0,0,1,0,1
Egypt,28/08/2005,9,0,0,0,-3,0,0,6
Egypt,29/08/2005,31,0,1,0,3,0,0,35
Egypt,30/08/2005,10,0,0,0,6,3,0,19
Egypt,31/08/2005,30,0,0,0,-5,1,0,26
Egypt,01/09/2005,17,0,0,0,1,0,0,18
Egypt,02/09/2005,-3,0,0,0,0,0,0,-3
Egypt,03/09/2005,2,0,3,0,-6,0,0,-1
Egypt,04/09/2005,13,0,1,0,3,0,0,17
Egypt,05/09/2005,8,0,0,0,0,0,0,8
Egypt,06/09/2005,4,0,-2,0,6,0,0,8
Egypt,07/09/2005,17,0,0,0,0,3,0,20
Egypt,08/09/2005,5,0,0,0,2,3,0,10
Egypt,09/09/2005,-5,0,0,0,-3,3,0,-5
Egypt,10/09/2005,0,0,0,0,3,3,0,6
Egypt,11/09/2005,31,0,0,0,0,2,0,33
Egypt,12/09/2005,25,0,0,0,4,0,0,29
Egypt,13/09/2005,39,0,-1,0,0,4,0,42
Egypt,14/09/2005,38,0,1,0,9,2,0,50
Egypt,15/09/2005,47,0,2,0,10,0,0,59
Egypt,16/09/2005,6,0,1,0,6,2,0,15
Egypt,17/09/2005,26,0,0,0,11,4,0,41
Egypt,18/09/2005,29,0,0,0,0,2,0,31
Egypt,19/09/2005,1,0,0,0,3,0,0,4
Egypt,20/09/2005,14,0,0,0,6,0,0,20
Egypt,21/09/2005,-10,0,0,0,0,0,0,-10
Egypt,22/09/2005,9,0,0,0,0,0,0,9
Egypt,23/09/2005,6,0,0,0,2,2,0,10
Egypt,24/09/2005,5,0,0,0,6,0,0,11
Egypt,25/09/2005,16,0,0,0,0,0,0,16
Egypt,26/09/2005,-16,0,0,0,12,0,0,-4
Egypt,27/09/2005,6,0,0,0,1,0,0,7
Egypt,28/09/2005,6,0,0,0,2,0,0,8
Egypt,29/09/2005,3,12,0,0,1,0,0,16
Egypt,30/09/2005,0,0,0,0,0,0,0,0
Egypt,01/10/2005,0,0,0,0,12,0,0,12
Egypt,02/10/2005,3,0,0,0,3,0,0,6
Egypt,03/10/2005,12,0,0,0,3,0,0,15
Egypt,04/10/2005,0,0,0,0,0,0,0,0
Egypt,05/10/2005,0,0,0,0,15,0,0,15
Egypt,06/10/2005,3,0,0,0,0,0,0,3
Egypt,07/10/2005,7,0,-2,0,-3,0,0,2
Egypt,08/10/2005,9,4,0,0,1,-2,0,12
Egypt,09/10/2005,10,0,0,0,2,0,0,12
Egypt,10/10/2005,2,0,0,0,0,-4,0,-2
Egypt,11/10/2005,3,0,-1,0,0,1,0,3
Egypt,12/10/2005,3,0,0,0,3,0,0,6
Egypt,13/10/2005,3,0,0,0,0,0,0,3
Egypt,14/10/2005,0,0,0,0,0,0,0,0
Egypt,15/10/2005,5,0,0,0,9,0,0,14
Egypt,16/10/2005,2,0,0,0,8,0,0,10
Egypt,17/10/2005,5,0,0,0,0,1,0,6
Egypt,18/10/2005,5,0,0,0,10,0,0,15
Egypt,19/10/2005,2,0,0,0,3,1,0,6
Egypt,20/10/2005,10,2,0,0,4,0,0,16
Egypt,21/10/2005,5,0,0,0,3,0,0,8
Egypt,22/10/2005,5,0,0,0,0,0,0,5
Egypt,23/10/2005,17,0,-2,0,0,0,0,15
Egypt,24/10/2005,6,0,0,0,6,0,0,12
Egypt,25/10/2005,13,0,0,0,3,3,0,19
Egypt,26/10/2005,7,0,0,0,6,0,0,13
Egypt,27/10/2005,3,0,-1,0,3,14,0,19
Egypt,28/10/2005,8,0,0,0,0,0,0,8
Egypt,29/10/2005,17,0,0,0,0,0,0,17
Egypt,30/10/2005,8,0,0,0,3,0,0,11
Egypt,31/10/2005,-6,0,0,0,0,2,0,-4
Egypt,01/11/2005,10,0,-2,0,1,0,0,9
Egypt,02/11/2005,3,0,0,0,0,0,0,3
Egypt,03/11/2005,6,0,0,0,0,2,0,8
Egypt,04/11/2005,0,0,0,0,0,0,0,0
Egypt,05/11/2005,-11,0,0,0,3,0,0,-8
Egypt,06/11/2005,7,0,0,0,5,0,0,12
Egypt,07/11/2005,-5,0,0,0,3,0,0,-2
Egypt,08/11/2005,3,0,0,0,6,0,0,9
Egypt,09/11/2005,3,0,0,0,6,0,0,9
Egypt,10/11/2005,4,0,0,0,3,0,0,7
Egypt,11/11/2005,21,0,-2,0,15,0,0,34
Egypt,12/11/2005,0,0,0,0,0,6,0,6
Egypt,13/11/2005,10,0,1,0,0,1,0,12
Egypt,14/11/2005,2,0,0,0,0,0,0,2
Egypt,15/11/2005,5,2,0,0,-2,2,0,7
Egypt,16/11/2005,0,0,0,0,3,0,0,3
Egypt,17/11/2005,3,0,0,0,0,0,0,3
Egypt,18/11/2005,3,0,0,0,3,0,0,6
Egypt,19/11/2005,0,0,0,0,3,0,0,3
Egypt,20/11/2005,3,0,0,0,0,0,0,3
Egypt,21/11/2005,10,0,0,0,0,0,0,10
Egypt,22/11/2005,8,0,0,0,3,0,0,11
Egypt,23/11/2005,2,0,0,0,0,0,0,2
Egypt,24/11/2005,0,0,0,0,3,0,0,3
Egypt,25/11/2005,-3,0,0,0,-2,0,0,-5
Egypt,26/11/2005,3,0,0,0,-4,3,0,2
Egypt,27/11/2005,0,0,0,0,3,0,0,3
Egypt,28/11/2005,5,0,0,0,3,4,0,12
Egypt,29/11/2005,5,0,0,0,0,2,0,7
Egypt,30/11/2005,1,0,0,0,13,0,0,14
Egypt,01/12/2005,3,0,1,0,3,0,0,7
Egypt,02/12/2005,1,0,0,0,0,0,0,1
Egypt,03/12/2005,15,0,0,0,0,0,0,15
Egypt,04/12/2005,34,0,0,0,0,1,0,35
Egypt,05/12/2005,3,0,0,0,0,0,0,3
Egypt,06/12/2005,8,0,0,0,12,2,0,22
Egypt,07/12/2005,16,0,0,0,0,0,0,16
Egypt,08/12/2005,18,0,0,0,5,0,0,23
Egypt,09/12/2005,14,0,0,0,1,0,0,15
Egypt,10/12/2005,21,0,-1,0,4,5,0,29
Egypt,11/12/2005,37,0,0,0,4,0,0,41
Egypt,12/12/2005,3,0,0,0,0,0,0,3
Egypt,13/12/2005,-2,0,0,0,3,0,0,1
Egypt,14/12/2005,16,0,0,0,6,3,0,25
Egypt,15/12/2005,5,0,0,0,3,3,0,11
Egypt,16/12/2005,3,0,0,0,-1,0,0,2
Egypt,17/12/2005,15,0,0,0,-5,2,0,12
Egypt,18/12/2005,1,0,0,0,2,0,0,3
Egypt,19/12/2005,0,0,0,0,0,0,0,0
Egypt,20/12/2005,16,0,0,0,1,3,0,20
Egypt,21/12/2005,9,0,0,0,0,0,0,9
Egypt,22/12/2005,3,0,0,0,6,0,0,9
Egypt,23/12/2005,9,0,0,0,15,0,0,24
Egypt,24/12/2005,0,0,0,0,6,0,0,6
Egypt,25/12/2005,6,0,0,0,0,0,0,6
Egypt,26/12/2005,9,0,0,0,12,0,0,21
Egypt,27/12/2005,1,0,0,0,3,1,0,5
Egypt,28/12/2005,5,0,1,0,18,2,0,26
Egypt,29/12/2005,12,0,0,0,23,1,0,36
Egypt,30/12/2005,14,0,0,0,3,1,0,18
Egypt,31/12/2005,9,0,0,0,0,1,0,10
Eritrea,03/01/2005,11,0,0,0,6,2,0,19
Eritrea,04/01/2005,0,0,0,0,0,1,0,1
Eritrea,05/01/2005,4,0,0,0,9,0,0,13
Eritrea,06/01/2005,3,0,0,0,0,0,0,3
Eritrea,07/01/2005,3,0,0,0,0,0,0,3
Eritrea,11/01/2005,0,0,0,0,0,0,0,0
Eritrea,12/01/2005,0,0,0,0,0,0,0,0
Eritrea,13/01/2005,0,0,0,0,0,0,0,0
Eritrea,14/01/2005,1,0,0,0,0,0,0,1
Eritrea,16/01/2005,0,0,0,0,0,0,0,0
Eritrea,17/01/2005,0,0,0,0,3,0,0,3
Eritrea,18/01/2005,4,0,0,0,0,0,0,4
Eritrea,19/01/2005,1,0,0,0,0,0,0,1
Eritrea,21/01/2005,9,0,0,0,0,0,0,9
Eritrea,25/01/2005,0,0,0,0,0,0,0,0
Eritrea,26/01/2005,0,0,0,0,0,0,0,0
Eritrea,27/01/2005,0,0,0,0,0,0,0,0
Eritrea,28/01/2005,4,0,0,0,0,0,0,4
Eritrea,29/01/2005,0,0,0,0,0,0,0,0
Eritrea,30/01/2005,3,0,0,0,3,0,0,6
Eritrea,31/01/2005,0,0,0,0,0,0,0,0
Eritrea,01/02/2005,0,0,0,0,0,0,0,0
Eritrea,02/02/2005,13,0,0,0,0,0,0,13
Eritrea,04/02/2005,1,0,0,0,12,0,0,13
Eritrea,06/02/2005,0,0,0,0,0,0,0,0
Eritrea,07/02/2005,0,0,0,0,0,0,0,0
Eritrea,08/02/2005,-3,0,0,0,0,0,0,-3
Eritrea,09/02/2005,0,0,0,0,0,0,0,0
Eritrea,10/02/2005,0,0,0,0,0,0,0,0
Eritrea,11/02/2005,8,0,0,0,0,0,0,8
Eritrea,12/02/2005,0,0,0,0,0,0,0,0
Eritrea,14/02/2005,8,0,0,0,0,0,0,8
Eritrea,15/02/2005,2,0,0,0,0,0,0,2
Eritrea,16/02/2005,4,0,0,0,0,0,0,4
Eritrea,17/02/2005,6,0,0,0,0,2,0,8
Eritrea,18/02/2005,0,0,0,0,0,0,0,0
Eritrea,20/02/2005,0,0,0,0,3,0,0,3
Eritrea,21/02/2005,6,0,0,0,1,1,0,8
Eritrea,22/02/2005,0,0,0,0,0,0,0,0
Eritrea,23/02/2005,3,0,0,0,0,0,0,3
Eritrea,24/02/2005,0,0,0,0,3,0,0,3
Eritrea,25/02/2005,0,0,0,0,0,0,0,0
Eritrea,26/02/2005,0,0,0,0,0,0,0,0
Eritrea,27/02/2005,4,0,0,0,0,0,0,4
Eritrea,28/02/2005,0,0,0,0,0,0,0,0
Eritrea,01/03/2005,3,0,0,0,-2,0,0,1
Eritrea,02/03/2005,5,0,0,0,0,0,0,5
Eritrea,05/03/2005,0,0,0,0,0,0,0,0
Eritrea,06/03/2005,4,0,0,0,0,0,0,4
Eritrea,07/03/2005,-1,0,0,0,0,0,0,-1
Eritrea,08/03/2005,0,0,0,0,3,0,0,3
Eritrea,09/03/2005,0,0,0,0,0,0,0,0
Eritrea,10/03/2005,6,0,0,0,0,0,0,6
Eritrea,11/03/2005,8,0,0,0,0,0,0,8
Eritrea,12/03/2005,0,0,0,0,6,0,0,6
Eritrea,14/03/2005,6,0,0,0,10,0,0,16
Eritrea,15/03/2005,0,0,0,0,0,0,0,0
Eritrea,16/03/2005,0,0,0,0,0,0,0,0
Eritrea,18/03/2005,0,0,0,0,0,0,0,0
Eritrea,21/03/2005,3,0,0,0,3,0,0,6
Eritrea,22/03/2005,0,0,0,0,0,0,0,0
Eritrea,23/03/2005,-3,0,0,0,0,0,0,-3
Eritrea,24/03/2005,0,0,0,0,0,0,0,0
Eritrea,25/03/2005,0,0,0,0,15,0,0,15
Eritrea,26/03/2005,0,0,0,0,0,0,0,0
Eritrea,28/03/2005,0,0,0,0,0,0,0,0
Eritrea,29/03/2005,0,0,0,0,0,0,0,0
Eritrea,31/03/2005,3,0,0,0,3,0,0,6
Eritrea,03/04/2005,0,0,0,0,0,0,0,0
Eritrea,04/04/2005,2,0,0,0,0,0,0,2
Eritrea,05/04/2005,0,0,0,0,0,0,0,0
Eritrea,06/04/2005,0,2,0,0,0,0,0,2
Eritrea,07/04/2005,6,0,0,0,0,0,0,6
Eritrea,08/04/2005,0,0,0,0,0,0,0,0
Eritrea,10/04/2005,0,0,0,0,0,0,0,0
Eritrea,11/04/2005,0,0,0,0,0,0,0,0
Eritrea,12/04/2005,0,0,0,0,0,0,0,0
Eritrea,13/04/2005,2,0,0,0,0,0,0,2
Eritrea,14/04/2005,0,0,0,0,0,0,0,0
Eritrea,15/04/2005,2,0,0,0,0,0,0,2
Eritrea,16/04/2005,0,0,0,0,0,0,0,0
Eritrea,18/04/2005,0,0,0,0,0,0,0,0
Eritrea,19/04/2005,0,0,0,0,0,0,0,0
Eritrea,20/04/2005,0,0,0,0,0,0,0,0
Eritrea,21/04/2005,17,0,0,0,0,0,0,17
Eritrea,22/04/2005,2,0,0,0,0,0,0,2
Eritrea,25/04/2005,2,0,0,0,-2,0,0,0
Eritrea,26/04/2005,1,0,0,0,0,0,0,1
Eritrea,27/04/2005,0,0,0,0,0,0,0,0
Eritrea,28/04/2005,0,0,0,0,3,0,0,3
Eritrea,30/04/2005,0,0,0,0,0,0,0,0
Eritrea,03/05/2005,0,0,0,0,0,2,0,2
Eritrea,04/05/2005,0,0,0,0,0,0,0,0
Eritrea,05/05/2005,0,0,0,0,0,4,0,4
Eritrea,09/05/2005,3,0,0,0,0,0,0,3
Eritrea,10/05/2005,4,0,0,0,0,0,0,4
Eritrea,11/05/2005,-2,0,0,0,1,0,0,-1
Eritrea,12/05/2005,-2,0,0,0,0,0,0,-2
Eritrea,13/05/2005,36,0,0,0,0,0,0,36
Eritrea,16/05/2005,0,0,0,0,0,0,0,0
Eritrea,17/05/2005,-33,0,0,0,3,0,0,-30
Eritrea,18/05/2005,0,0,0,0,0,0,0,0
Eritrea,19/05/2005,0,0,0,0,0,0,0,0
Eritrea,22/05/2005,2,0,0,0,-2,0,0,0
Eritrea,23/05/2005,0,0,0,0,0,0,0,0
Eritrea,24/05/2005,0,0,0,0,6,0,0,6
Eritrea,25/05/2005,3,0,0,0,0,0,0,3
Eritrea,26/05/2005,0,0,0,0,0,0,0,0
Eritrea,27/05/2005,0,0,0,0,0,0,0,0
Eritrea,30/05/2005,0,0,0,0,-2,0,0,-2
Eritrea,31/05/2005,0,0,0,0,0,0,0,0
Eritrea,02/06/2005,0,0,0,0,0,0,0,0
Eritrea,05/06/2005,1,0,0,0,0,0,0,1
Eritrea,06/06/2005,0,0,0,0,3,0,0,3
Eritrea,07/06/2005,0,0,0,0,0,0,0,0
Eritrea,08/06/2005,2,0,0,0,-2,0,0,0
Eritrea,09/06/2005,0,0,0,0,0,0,0,0
Eritrea,10/06/2005,0,0,0,0,0,0,0,0
Eritrea,12/06/2005,4,0,0,0,0,0,0,4
Eritrea,13/06/2005,2,0,0,0,0,0,0,2
Eritrea,14/06/2005,-1,0,0,0,-2,0,0,-3
Eritrea,15/06/2005,0,0,0,0,0,0,0,0
Eritrea,16/06/2005,0,0,0,0,6,2,0,8
Eritrea,17/06/2005,2,0,0,0,0,0,0,2
Eritrea,18/06/2005,6,0,0,0,0,0,0,6
Eritrea,19/06/2005,0,0,0,0,0,0,0,0
Eritrea,20/06/2005,2,0,0,0,0,0,0,2
Eritrea,21/06/2005,0,0,0,0,0,0,0,0
Eritrea,22/06/2005,0,0,0,0,-4,0,0,-4
Eritrea,23/06/2005,0,0,0,0,0,0,0,0
Eritrea,24/06/2005,0,0,0,0,0,0,0,0
Eritrea,25/06/2005,0,0,0,0,0,0,0,0
Eritrea,26/06/2005,0,0,0,0,0,0,0,0
Eritrea,27/06/2005,2,0,0,0,0,0,0,2
Eritrea,28/06/2005,-2,0,0,0,2,2,0,2
Eritrea,29/06/2005,0,0,0,0,0,0,0,0
Eritrea,01/07/2005,0,0,0,0,0,0,0,0
Eritrea,02/07/2005,0,0,0,0,0,0,0,0
Eritrea,03/07/2005,4,0,0,0,6,0,0,10
Eritrea,04/07/2005,-1,0,0,0,0,0,0,-1
Eritrea,05/07/2005,1,0,0,0,0,0,0,1
Eritrea,06/07/2005,0,0,0,0,0,0,0,0
Eritrea,07/07/2005,0,0,0,0,0,0,0,0
Eritrea,08/07/2005,0,0,0,0,0,0,0,0
Eritrea,09/07/2005,2,0,0,0,0,0,0,2
Eritrea,11/07/2005,-1,0,0,0,0,0,0,-1
Eritrea,14/07/2005,2,0,0,0,0,0,0,2
Eritrea,15/07/2005,0,0,0,0,0,0,0,0
Eritrea,16/07/2005,4,0,0,0,0,0,0,4
Eritrea,17/07/2005,0,0,0,0,3,0,0,3
Eritrea,19/07/2005,0,0,0,0,0,0,0,0
Eritrea,20/07/2005,8,0,0,0,9,0,0,17
Eritrea,24/07/2005,0,0,0,0,3,0,0,3
Eritrea,26/07/2005,0,0,0,0,0,0,0,0
Eritrea,27/07/2005,1,0,0,0,0,0,0,1
Eritrea,28/07/2005,0,0,0,0,3,0,0,3
Eritrea,29/07/2005,2,0,0,0,6,0,0,8
Eritrea,30/07/2005,1,0,0,0,3,0,0,4
Eritrea,31/07/2005,1,0,0,0,0,0,0,1
Eritrea,01/08/2005,2,0,0,0,0,2,0,4
Eritrea,02/08/2005,2,0,0,0,0,2,0,4
Eritrea,03/08/2005,0,0,0,0,0,0,0,0
Eritrea,04/08/2005,0,0,0,0,0,0,0,0
Eritrea,05/08/2005,0,0,0,0,0,1,0,1
Eritrea,07/08/2005,1,0,0,0,0,0,0,1
Eritrea,08/08/2005,2,0,0,0,0,0,0,2
Eritrea,09/08/2005,3,0,0,0,0,0,0,3
Eritrea,10/08/2005,0,0,0,0,0,0,0,0
Eritrea,11/08/2005,0,0,0,0,0,0,0,0
Eritrea,14/08/2005,0,0,0,0,0,0,0,0
Eritrea,15/08/2005,0,0,0,0,0,0,0,0
Eritrea,16/08/2005,0,0,0,0,0,0,0,0
Eritrea,17/08/2005,0,0,0,0,0,0,0,0
Eritrea,19/08/2005,0,0,0,0,0,0,0,0
Eritrea,22/08/2005,0,0,0,0,0,0,0,0
Eritrea,23/08/2005,0,0,0,0,0,0,0,0
Eritrea,24/08/2005,0,0,0,0,0,0,0,0
Eritrea,27/08/2005,2,0,0,0,0,0,0,2
Eritrea,28/08/2005,0,0,0,0,0,0,0,0
Eritrea,29/08/2005,6,0,0,0,0,0,0,6
Eritrea,30/08/2005,0,0,0,0,0,0,0,0
Eritrea,02/09/2005,0,0,1,0,3,0,0,4
Eritrea,08/09/2005,2,0,0,0,0,0,0,2
Eritrea,11/09/2005,0,0,0,0,0,0,0,0
Eritrea,13/09/2005,4,0,0,0,1,0,0,5
Eritrea,14/09/2005,2,0,0,0,3,0,0,5
Eritrea,15/09/2005,0,0,0,0,6,0,0,6
Eritrea,16/09/2005,9,0,0,0,4,0,0,13
Eritrea,18/09/2005,0,0,0,0,3,0,0,3
Eritrea,19/09/2005,1,0,0,0,0,0,0,1
Eritrea,20/09/2005,1,0,0,0,3,0,0,4
Eritrea,21/09/2005,0,0,0,0,0,0,0,0
Eritrea,22/09/2005,6,0,0,0,0,0,0,6
Eritrea,23/09/2005,4,0,0,0,0,0,0,4
Eritrea,30/09/2005,0,0,0,0,0,0,0,0
Eritrea,04/10/2005,4,0,0,0,0,0,0,4
Eritrea,05/10/2005,4,0,0,0,6,0,0,10
Eritrea,06/10/2005,0,0,0,0,9,0,0,9
Eritrea,08/10/2005,1,0,0,0,0,0,0,1
Eritrea,09/10/2005,0,0,0,0,0,0,0,0
Eritrea,10/10/2005,-3,0,0,0,0,0,0,-3
Eritrea,11/10/2005,0,0,0,0,0,1,0,1
Eritrea,12/10/2005,2,0,0,0,0,0,0,2
Eritrea,14/10/2005,0,0,0,0,0,0,0,0
Eritrea,15/10/2005,2,0,0,0,0,0,0,2
Eritrea,16/10/2005,0,0,0,0,0,0,0,0
Eritrea,17/10/2005,-6,2,0,0,3,0,0,-1
Eritrea,18/10/2005,-11,0,0,0,8,0,0,-3
Eritrea,19/10/2005,-3,0,0,0,3,0,0,0
Eritrea,20/10/2005,0,0,0,0,0,0,0,0
Eritrea,21/10/2005,5,0,0,0,9,0,0,14
Eritrea,22/10/2005,3,0,0,0,0,0,0,3
Eritrea,23/10/2005,0,0,0,0,0,0,0,0
Eritrea,24/10/2005,1,0,0,0,0,1,0,2
Eritrea,25/10/2005,4,0,0,0,18,0,0,22
Eritrea,26/10/2005,2,0,0,0,3,0,0,5
Eritrea,27/10/2005,0,0,0,0,0,0,0,0
Eritrea,28/10/2005,0,0,0,0,3,0,0,3
Eritrea,29/10/2005,0,0,0,0,3,0,0,3
Eritrea,31/10/2005,0,0,0,0,0,0,0,0
Eritrea,02/11/2005,4,0,0,0,3,0,0,7
Eritrea,03/11/2005,3,0,0,0,9,0,0,12
Eritrea,04/11/2005,11,0,0,0,12,4,0,27
Eritrea,05/11/2005,8,0,0,0,6,0,0,14
Eritrea,06/11/2005,0,0,0,0,0,0,0,0
Eritrea,07/11/2005,2,0,0,0,0,0,0,2
Eritrea,08/11/2005,5,0,0,0,0,1,0,6
Eritrea,09/11/2005,0,0,0,0,0,0,0,0
Eritrea,10/11/2005,0,0,0,0,0,0,0,0
Eritrea,11/11/2005,0,0,0,0,0,0,0,0
Eritrea,12/11/2005,-3,0,0,0,9,0,0,6
Eritrea,13/11/2005,6,0,0,0,0,0,0,6
Eritrea,14/11/2005,0,0,0,0,4,0,0,4
Eritrea,16/11/2005,0,0,0,0,0,0,0,0
Eritrea,17/11/2005,0,0,0,0,0,0,0,0
Eritrea,18/11/2005,0,0,0,0,3,0,0,3
Eritrea,19/11/2005,6,0,0,0,-26,1,0,-19
Eritrea,21/11/2005,4,0,0,0,-6,0,0,-2
Eritrea,22/11/2005,4,0,0,0,9,0,0,13
Eritrea,23/11/2005,-1,0,0,0,6,0,0,5
Eritrea,24/11/2005,2,0,0,0,6,0,0,8
Eritrea,25/11/2005,0,0,0,0,9,0,0,9
Eritrea,26/11/2005,0,0,0,0,0,0,0,0
Eritrea,27/11/2005,4,0,0,0,0,0,0,4
Eritrea,28/11/2005,6,0,0,0,0,0,0,6
Eritrea,29/11/2005,0,0,0,0,0,0,0,0
Eritrea,30/11/2005,1,0,0,0,0,0,0,1
Eritrea,01/12/2005,0,0,0,0,0,0,0,0
Eritrea,02/12/2005,0,0,0,0,-1,0,0,-1
Eritrea,03/12/2005,2,0,0,0,0,0,0,2
Eritrea,04/12/2005,1,0,0,0,9,0,0,10
Eritrea,05/12/2005,1,0,0,0,-2,0,0,-1
Eritrea,06/12/2005,4,0,0,0,6,0,0,10
Eritrea,07/12/2005,-4,0,0,0,18,0,0,14
Eritrea,08/12/2005,-2,0,0,0,0,4,0,2
Eritrea,09/12/2005,4,0,0,0,0,0,0,4
Eritrea,10/12/2005,3,0,0,0,6,0,0,9
Eritrea,11/12/2005,7,0,0,0,0,0,0,7
Eritrea,12/12/2005,1,0,0,0,12,0,0,13
Eritrea,13/12/2005,1,0,0,0,60,0,0,61
Eritrea,14/12/2005,-19,0,0,0,4,0,0,-15
Eritrea,15/12/2005,0,0,0,0,3,0,0,3
Eritrea,16/12/2005,0,0,0,0,0,2,0,2
Eritrea,17/12/2005,3,0,0,0,0,0,0,3
Eritrea,20/12/2005,0,0,0,0,0,1,0,1
Eritrea,21/12/2005,0,0,0,0,0,0,0,0
Eritrea,22/12/2005,2,0,0,0,0,1,0,3
Eritrea,23/12/2005,-6,0,0,0,3,0,0,-3
Eritrea,28/12/2005,-1,0,0,0,0,0,0,-1
Eritrea,29/12/2005,0,0,0,0,3,0,0,3
Eritrea,30/12/2005,2,0,0,0,0,0,0,2
Eritrea,31/12/2005,0,0,0,0,3,0,0,3
Georgia,01/01/2005,0,0,0,0,0,2,0,2
Georgia,03/01/2005,0,0,0,0,0,0,0,0
Georgia,05/01/2005,3,0,0,0,0,1,0,4
Georgia,06/01/2005,5,0,0,0,-4,0,0,1
Georgia,07/01/2005,3,0,0,0,0,0,0,3
Georgia,08/01/2005,0,0,0,0,3,0,0,3
Georgia,10/01/2005,1,0,0,0,0,0,0,1
Georgia,11/01/2005,2,0,0,0,0,0,0,2
Georgia,12/01/2005,0,0,0,0,0,0,0,0
Georgia,13/01/2005,0,0,0,0,3,2,0,5
Georgia,14/01/2005,0,0,0,0,0,0,0,0
Georgia,15/01/2005,2,0,0,0,0,0,0,2
Georgia,17/01/2005,2,0,0,0,0,0,0,2
Georgia,18/01/2005,0,0,0,0,0,0,0,0
Georgia,20/01/2005,0,0,0,0,0,0,0,0
Georgia,22/01/2005,0,0,0,0,0,0,0,0
Georgia,23/01/2005,0,0,0,0,3,0,0,3
Georgia,24/01/2005,2,0,0,0,0,0,0,2
Georgia,26/01/2005,0,0,0,0,0,0,0,0
Georgia,27/01/2005,10,0,0,0,0,0,0,10
Georgia,28/01/2005,3,0,0,0,0,0,0,3
Georgia,29/01/2005,0,0,0,0,0,0,0,0
Georgia,30/01/2005,2,0,0,0,0,0,0,2
Georgia,31/01/2005,0,0,-1,0,0,2,0,1
Georgia,01/02/2005,2,0,0,0,3,0,0,5
Georgia,02/02/2005,0,0,0,0,3,0,0,3
Georgia,03/02/2005,4,0,0,0,0,0,0,4
Georgia,05/02/2005,4,0,0,0,0,1,0,5
Georgia,06/02/2005,0,0,0,0,0,0,0,0
Georgia,07/02/2005,0,0,0,0,0,0,0,0
Georgia,08/02/2005,0,0,0,0,0,0,0,0
Georgia,09/02/2005,-1,0,0,0,0,0,0,-1
Georgia,10/02/2005,4,0,0,0,0,0,0,4
Georgia,11/02/2005,0,0,0,0,0,0,0,0
Georgia,12/02/2005,0,0,0,0,0,0,0,0
Georgia,13/02/2005,0,0,0,0,0,0,0,0
Georgia,14/02/2005,-1,0,0,0,0,0,0,-1
Georgia,15/02/2005,0,0,-2,0,0,0,0,-2
Georgia,16/02/2005,0,0,0,0,0,0,0,0
Georgia,17/02/2005,0,0,-2,0,6,0,0,4
Georgia,18/02/2005,2,0,0,0,0,0,0,2
Georgia,19/02/2005,0,0,0,0,0,0,0,0
Georgia,20/02/2005,0,0,0,0,0,0,0,0
Georgia,21/02/2005,0,0,0,0,0,0,0,0
Georgia,22/02/2005,0,0,0,0,0,0,0,0
Georgia,23/02/2005,0,0,0,0,0,0,0,0
Georgia,24/02/2005,3,0,0,0,0,0,0,3
Georgia,25/02/2005,3,0,0,0,0,1,0,4
Georgia,28/02/2005,0,0,0,0,3,0,0,3
Georgia,01/03/2005,0,0,0,0,0,0,0,0
Georgia,02/03/2005,0,0,0,0,-2,0,0,-2
Georgia,03/03/2005,2,0,-2,0,1,2,0,3
Georgia,04/03/2005,4,0,0,0,0,0,0,4
Georgia,05/03/2005,0,0,0,0,0,0,0,0
Georgia,06/03/2005,0,0,0,0,0,0,0,0
Georgia,07/03/2005,2,0,0,0,0,0,0,2
Georgia,08/03/2005,0,0,0,0,0,1,0,1
Georgia,09/03/2005,0,0,0,0,-6,0,0,-6
Georgia,10/03/2005,2,0,0,0,0,0,0,2
Georgia,11/03/2005,27,0,0,0,0,0,0,27
Georgia,12/03/2005,0,0,0,0,0,1,0,1
Georgia,13/03/2005,1,0,0,0,0,0,0,1
Georgia,14/03/2005,0,0,0,0,0,0,0,0
Georgia,15/03/2005,0,0,0,0,0,0,0,0
Georgia,16/03/2005,0,0,0,0,0,0,0,0
Georgia,17/03/2005,9,0,-6,0,0,0,0,3
Georgia,18/03/2005,3,0,0,0,0,2,0,5
Georgia,19/03/2005,0,0,0,0,0,0,0,0
Georgia,21/03/2005,1,0,0,0,0,0,0,1
Georgia,22/03/2005,3,0,0,0,6,0,0,9
Georgia,23/03/2005,8,0,0,0,0,2,0,10
Georgia,24/03/2005,9,0,0,0,0,0,0,9
Georgia,25/03/2005,2,0,0,0,0,0,0,2
Georgia,26/03/2005,0,0,0,0,0,0,0,0
Georgia,28/03/2005,0,0,0,0,3,0,0,3
Georgia,29/03/2005,0,0,0,0,6,1,0,7
Georgia,30/03/2005,4,0,1,0,0,0,0,5
Georgia,31/03/2005,11,0,0,0,3,2,0,16
Georgia,01/04/2005,3,0,0,0,0,0,0,3
Georgia,03/04/2005,0,0,0,0,0,0,0,0
Georgia,05/04/2005,2,0,0,0,0,0,0,2
Georgia,06/04/2005,0,0,0,0,0,0,0,0
Georgia,07/04/2005,0,0,0,0,0,0,0,0
Georgia,08/04/2005,3,0,0,0,0,0,0,3
Georgia,09/04/2005,3,0,0,0,0,0,0,3
Georgia,10/04/2005,0,0,0,0,0,0,0,0
Georgia,11/04/2005,3,0,0,0,0,0,0,3
Georgia,12/04/2005,0,0,0,0,0,0,0,0
Georgia,13/04/2005,0,0,0,0,0,0,0,0
Georgia,15/04/2005,4,0,0,0,0,0,0,4
Georgia,16/04/2005,0,0,0,0,0,0,0,0
Georgia,18/04/2005,0,0,0,0,0,0,0,0
Georgia,19/04/2005,0,0,0,0,0,0,0,0
Georgia,20/04/2005,9,0,0,0,0,0,0,9
Georgia,21/04/2005,4,0,0,0,6,0,0,10
Georgia,22/04/2005,0,0,0,0,6,0,0,6
Georgia,23/04/2005,0,0,0,0,0,0,0,0
Georgia,24/04/2005,-1,0,0,0,0,0,0,-1
Georgia,25/04/2005,-5,0,0,0,0,0,0,-5
Georgia,26/04/2005,0,0,0,0,3,0,0,3
Georgia,27/04/2005,0,0,0,0,3,0,0,3
Georgia,28/04/2005,0,0,0,0,0,0,0,0
Georgia,29/04/2005,1,0,0,0,-4,0,0,-3
Georgia,30/04/2005,1,0,0,0,0,0,0,1
Georgia,01/05/2005,2,0,0,0,-2,0,0,0
Georgia,02/05/2005,0,2,0,0,0,2,0,4
Georgia,03/05/2005,0,0,0,0,3,0,0,3
Georgia,04/05/2005,-3,0,0,0,0,0,0,-3
Georgia,05/05/2005,3,0,0,0,6,5,0,14
Georgia,06/05/2005,4,0,0,0,0,2,0,6
Georgia,07/05/2005,0,0,0,0,0,0,0,0
Georgia,08/05/2005,2,0,0,0,0,0,0,2
Georgia,09/05/2005,3,0,0,0,0,0,0,3
Georgia,10/05/2005,0,0,0,0,0,0,0,0
Georgia,11/05/2005,0,0,0,0,0,0,0,0
Georgia,12/05/2005,-3,0,0,0,0,2,0,-1
Georgia,13/05/2005,4,0,0,0,0,0,0,4
Georgia,14/05/2005,10,0,1,0,4,0,0,15
Georgia,15/05/2005,-1,0,0,0,0,0,0,-1
Georgia,16/05/2005,3,0,0,0,0,1,0,4
Georgia,17/05/2005,2,0,1,0,0,0,0,3
Georgia,18/05/2005,5,0,0,0,0,2,0,7
Georgia,19/05/2005,0,0,0,0,3,0,0,3
Georgia,20/05/2005,0,0,0,0,0,2,0,2
Georgia,21/05/2005,4,0,0,0,0,0,0,4
Georgia,23/05/2005,0,0,0,0,3,0,0,3
Georgia,24/05/2005,0,0,0,0,0,0,0,0
Georgia,25/05/2005,0,0,0,0,0,0,0,0
Georgia,26/05/2005,0,0,0,0,3,0,0,3
Georgia,28/05/2005,0,0,0,0,3,0,0,3
Georgia,29/05/2005,0,0,0,0,0,2,0,2
Georgia,30/05/2005,-6,0,0,0,0,1,0,-5
Georgia,01/06/2005,3,0,0,0,0,0,0,3
Georgia,02/06/2005,0,0,0,0,0,0,0,0
Georgia,03/06/2005,-1,0,0,0,0,0,0,-1
Georgia,06/06/2005,0,0,0,0,0,0,0,0
Georgia,07/06/2005,0,0,0,0,0,0,0,0
Georgia,08/06/2005,0,0,0,0,0,1,0,1
Georgia,09/06/2005,0,0,0,0,0,0,0,0
Georgia,10/06/2005,4,0,0,0,0,0,0,4
Georgia,14/06/2005,0,0,0,0,-2,0,0,-2
Georgia,15/06/2005,-1,0,0,0,0,0,0,-1
Georgia,16/06/2005,0,0,0,0,0,0,0,0
Georgia,17/06/2005,0,0,0,0,0,0,0,0
Georgia,18/06/2005,3,0,0,0,3,0,0,6
Georgia,19/06/2005,0,0,0,0,0,0,0,0
Georgia,20/06/2005,3,0,0,0,0,0,0,3
Georgia,21/06/2005,0,0,0,0,0,0,0,0
Georgia,22/06/2005,0,0,0,0,0,0,0,0
Georgia,23/06/2005,2,0,0,0,0,0,0,2
Georgia,24/06/2005,0,0,0,0,0,0,0,0
Georgia,25/06/2005,0,0,0,0,3,0,0,3
Georgia,26/06/2005,0,0,0,0,0,2,0,2
Georgia,27/06/2005,0,0,0,0,0,0,0,0
Georgia,29/06/2005,0,0,0,0,0,0,0,0
Georgia,30/06/2005,8,0,0,0,0,0,0,8
Georgia,01/07/2005,2,0,0,0,0,0,0,2
Georgia,04/07/2005,2,0,0,0,0,2,0,4
Georgia,07/07/2005,6,0,0,0,0,0,0,6
Georgia,08/07/2005,2,0,0,0,2,0,0,4
Georgia,09/07/2005,0,0,0,0,3,0,0,3
Georgia,11/07/2005,0,0,0,0,0,0,0,0
Georgia,12/07/2005,3,0,0,0,0,0,0,3
Georgia,14/07/2005,2,0,0,0,0,0,0,2
Georgia,15/07/2005,0,0,0,0,0,0,0,0
Georgia,16/07/2005,0,0,0,0,0,0,0,0
Georgia,18/07/2005,0,0,0,0,1,0,0,1
Georgia,19/07/2005,3,0,0,0,6,0,0,9
Georgia,20/07/2005,4,0,0,0,6,0,0,10
Georgia,21/07/2005,2,0,0,0,3,2,0,7
Georgia,22/07/2005,0,0,0,0,0,0,0,0
Georgia,23/07/2005,0,0,0,0,0,0,0,0
Georgia,24/07/2005,2,0,0,0,3,0,0,5
Georgia,25/07/2005,2,0,0,0,0,0,0,2
Georgia,27/07/2005,3,0,0,0,0,0,0,3
Georgia,28/07/2005,1,0,0,0,3,0,0,4
Georgia,29/07/2005,0,0,0,0,1,0,0,1
Georgia,01/08/2005,0,0,0,0,0,1,0,1
Georgia,03/08/2005,0,0,0,0,0,0,0,0
Georgia,05/08/2005,15,0,0,0,0,0,0,15
Georgia,06/08/2005,0,0,0,0,3,0,0,3
Georgia,08/08/2005,6,0,0,0,0,0,0,6
Georgia,09/08/2005,0,0,0,0,0,0,0,0
Georgia,10/08/2005,0,0,0,0,0,0,0,0
Georgia,11/08/2005,3,0,0,0,0,2,0,5
Georgia,12/08/2005,3,0,0,0,0,0,0,3
Georgia,15/08/2005,17,0,0,0,0,0,0,17
Georgia,16/08/2005,3,0,0,0,0,0,0,3
Georgia,17/08/2005,5,0,0,0,0,0,0,5
Georgia,18/08/2005,6,0,0,0,3,0,0,9
Georgia,19/08/2005,3,0,0,0,0,0,0,3
Georgia,20/08/2005,3,0,0,0,0,0,0,3
Georgia,23/08/2005,0,0,0,0,0,0,0,0
Georgia,24/08/2005,2,0,0,0,4,0,0,6
Georgia,25/08/2005,1,0,0,0,3,1,0,5
Georgia,26/08/2005,5,0,0,0,3,2,0,10
Georgia,27/08/2005,0,0,0,0,0,0,0,0
Georgia,28/08/2005,0,0,0,0,0,0,0,0
Georgia,29/08/2005,0,0,0,0,9,0,0,9
Georgia,30/08/2005,0,0,0,0,0,0,0,0
Georgia,31/08/2005,2,0,0,0,0,0,0,2
Georgia,01/09/2005,0,0,0,0,3,0,0,3
Georgia,02/09/2005,3,0,0,0,0,0,0,3
Georgia,03/09/2005,0,0,0,0,0,0,0,0
Georgia,05/09/2005,3,0,0,0,0,0,0,3
Georgia,06/09/2005,0,0,0,0,0,0,0,0
Georgia,07/09/2005,0,0,0,0,0,0,0,0
Georgia,08/09/2005,-3,0,0,0,0,0,0,-3
Georgia,09/09/2005,3,0,0,0,0,0,0,3
Georgia,10/09/2005,0,0,0,0,0,0,0,0
Georgia,11/09/2005,0,0,0,0,3,0,0,3
Georgia,12/09/2005,7,0,0,0,0,0,0,7
Georgia,13/09/2005,0,0,0,0,0,0,0,0
Georgia,14/09/2005,0,0,0,0,0,0,0,0
Georgia,15/09/2005,0,0,0,0,0,0,0,0
Georgia,18/09/2005,1,2,0,0,0,0,0,3
Georgia,19/09/2005,-1,0,1,0,0,0,0,0
Georgia,22/09/2005,0,0,0,0,3,0,0,3
Georgia,23/09/2005,0,0,0,0,0,1,0,1
Georgia,27/09/2005,0,0,0,0,6,0,0,6
Georgia,28/09/2005,0,0,0,0,0,0,0,0
Georgia,29/09/2005,0,0,0,0,0,0,0,0
Georgia,30/09/2005,0,0,0,0,0,0,0,0
Georgia,02/10/2005,2,0,0,0,0,0,0,2
Georgia,03/10/2005,0,0,0,0,0,0,0,0
Georgia,04/10/2005,7,0,0,0,0,0,0,7
Georgia,05/10/2005,0,0,0,0,0,0,0,0
Georgia,06/10/2005,3,0,0,0,3,0,0,6
Georgia,07/10/2005,0,0,0,0,0,0,0,0
Georgia,09/10/2005,0,0,0,0,0,0,0,0
Georgia,10/10/2005,0,0,0,0,3,0,0,3
Georgia,11/10/2005,0,0,0,0,0,0,0,0
Georgia,12/10/2005,-2,0,0,0,0,0,0,-2
Georgia,13/10/2005,0,0,0,0,0,1,0,1
Georgia,19/10/2005,6,0,0,0,0,0,0,6
Georgia,20/10/2005,0,0,0,0,0,0,0,0
Georgia,22/10/2005,0,0,0,0,0,0,0,0
Georgia,26/10/2005,0,0,0,0,0,0,0,0
Georgia,27/10/2005,0,0,0,0,0,0,0,0
Georgia,31/10/2005,3,0,0,0,0,0,0,3
Georgia,01/11/2005,4,0,0,0,0,0,0,4
Georgia,02/11/2005,6,0,0,0,0,0,0,6
Georgia,03/11/2005,0,0,0,0,3,0,0,3
Georgia,04/11/2005,0,0,0,0,0,0,0,0
Georgia,07/11/2005,-1,0,0,0,0,0,0,-1
Georgia,08/11/2005,6,2,0,0,-2,2,0,8
Georgia,09/11/2005,0,0,0,0,0,2,0,2
Georgia,10/11/2005,0,2,0,0,0,4,0,6
Georgia,11/11/2005,1,0,0,0,0,0,0,1
Georgia,12/11/2005,0,0,0,0,0,1,0,1
Georgia,13/11/2005,0,0,0,0,3,0,0,3
Georgia,14/11/2005,5,0,0,0,3,0,0,8
Georgia,15/11/2005,0,0,0,0,0,0,0,0
Georgia,16/11/2005,0,0,0,0,6,0,0,6
Georgia,17/11/2005,0,0,0,0,3,0,0,3
Georgia,22/11/2005,0,0,0,0,0,0,0,0
Georgia,23/11/2005,0,0,0,0,6,0,0,6
Georgia,24/11/2005,-3,0,0,0,0,0,0,-3
Georgia,25/11/2005,2,0,0,0,0,0,0,2
Georgia,28/11/2005,0,0,0,0,0,0,0,0
Georgia,30/11/2005,2,0,0,0,3,0,0,5
Georgia,01/12/2005,0,0,0,0,0,0,0,0
Georgia,02/12/2005,3,0,0,0,0,0,0,3
Georgia,05/12/2005,6,0,0,0,0,0,0,6
Georgia,07/12/2005,0,0,0,0,0,0,0,0
Georgia,08/12/2005,6,0,0,0,6,2,0,14
Georgia,09/12/2005,0,0,0,0,-1,1,0,0
Georgia,10/12/2005,0,0,0,0,0,0,0,0
Georgia,12/12/2005,3,0,0,0,3,0,0,6
Georgia,13/12/2005,3,0,0,0,3,0,0,6
Georgia,14/12/2005,0,0,0,0,-2,0,0,-2
Georgia,15/12/2005,6,0,0,0,0,0,0,6
Georgia,16/12/2005,1,0,0,0,0,0,0,1
Georgia,19/12/2005,0,0,0,0,0,0,0,0
Georgia,20/12/2005,0,0,0,0,0,0,0,0
Georgia,21/12/2005,0,0,0,0,0,0,0,0
Georgia,22/12/2005,1,0,0,0,0,0,0,1
Georgia,27/12/2005,-1,0,0,0,0,0,0,-1
Georgia,29/12/2005,0,0,0,0,0,0,0,0
Georgia,30/12/2005,2,0,0,0,0,0,0,2
Georgia,31/12/2005,2,0,0,0,-3,0,0,-1
India,01/01/2005,1,2,0,0,0,0,0,3
India,02/01/2005,3,0,0,0,9,0,0,12
India,03/01/2005,10,2,0,0,2,2,0,16
India,04/01/2005,13,0,0,0,0,0,0,13
India,05/01/2005,4,0,0,0,0,0,0,4
India,06/01/2005,8,0,0,0,0,0,0,8
India,07/01/2005,15,2,-1,0,3,2,0,21
India,08/01/2005,-1,0,-1,0,0,0,0,-2
India,09/01/2005,2,0,0,0,-4,0,0,-2
India,10/01/2005,4,0,0,0,-2,0,0,2
India,11/01/2005,1,2,0,0,-2,0,0,1
India,12/01/2005,0,0,0,0,6,0,0,6
India,13/01/2005,7,0,0,0,0,1,0,8
India,14/01/2005,0,0,0,0,0,0,0,0
India,15/01/2005,0,0,0,0,0,0,0,0
India,16/01/2005,0,0,0,0,3,2,0,5
India,17/01/2005,9,0,0,0,0,0,0,9
India,18/01/2005,5,0,1,0,0,0,0,6
India,19/01/2005,0,0,0,0,0,0,0,0
India,20/01/2005,2,0,0,0,0,0,0,2
India,21/01/2005,1,0,0,0,0,0,0,1
India,22/01/2005,1,0,0,0,3,0,0,4
India,23/01/2005,0,0,0,0,3,2,0,5
India,24/01/2005,0,0,0,0,6,1,0,7
India,25/01/2005,16,0,0,0,0,0,0,16
India,26/01/2005,5,0,0,0,3,1,0,9
India,27/01/2005,21,0,0,0,0,2,0,23
India,28/01/2005,1,0,0,0,0,0,0,1
India,29/01/2005,1,0,0,0,0,0,0,1
India,30/01/2005,0,2,0,0,0,3,0,5
India,31/01/2005,4,0,0,0,0,3,0,7
India,01/02/2005,21,0,0,0,-2,0,0,19
India,02/02/2005,11,0,0,0,0,1,0,12
India,03/02/2005,-1,0,0,0,0,0,0,-1
India,04/02/2005,14,0,0,0,6,0,0,20
India,05/02/2005,0,0,0,0,0,0,0,0
India,06/02/2005,2,0,0,0,0,0,0,2
India,07/02/2005,4,0,0,0,3,1,0,8
India,08/02/2005,0,0,0,0,0,0,0,0
India,09/02/2005,-7,0,0,0,6,2,0,1
India,10/02/2005,7,0,0,0,3,1,0,11
India,11/02/2005,16,0,0,0,3,0,0,19
India,12/02/2005,0,0,0,0,3,1,0,4
India,13/02/2005,1,0,0,0,-2,0,0,-1
India,14/02/2005,7,0,0,0,3,1,0,11
India,15/02/2005,6,0,0,0,3,3,0,12
India,16/02/2005,4,2,-1,0,0,0,0,5
India,17/02/2005,3,4,0,0,-2,1,0,6
India,18/02/2005,8,0,0,0,-2,1,0,7
India,19/02/2005,0,0,0,0,0,0,0,0
India,20/02/2005,3,0,0,0,0,0,0,3
India,21/02/2005,4,0,-1,0,0,0,0,3
India,22/02/2005,4,0,0,0,0,4,0,8
India,23/02/2005,12,0,0,0,3,1,0,16
India,24/02/2005,1,0,-1,0,9,1,0,10
India,25/02/2005,0,0,0,0,3,2,0,5
India,26/02/2005,15,0,0,0,0,0,0,15
India,27/02/2005,3,0,0,0,3,0,0,6
India,28/02/2005,11,0,0,0,0,0,0,11
India,01/03/2005,13,2,0,0,0,0,0,15
India,02/03/2005,3,0,0,0,-2,0,0,1
India,03/03/2005,5,0,0,0,0,0,0,5
India,04/03/2005,7,0,0,0,0,0,0,7
India,05/03/2005,-1,0,-2,0,3,1,0,1
India,06/03/2005,1,2,0,0,0,1,0,4
India,07/03/2005,14,0,0,0,3,3,0,20
India,08/03/2005,13,0,0,0,-4,0,0,9
India,09/03/2005,2,0,0,0,1,0,0,3
India,10/03/2005,4,2,0,0,0,0,0,6
India,11/03/2005,2,0,0,0,3,1,0,6
India,12/03/2005,0,4,0,0,0,0,0,4
India,13/03/2005,3,0,0,0,6,0,0,9
India,14/03/2005,19,0,0,0,0,2,0,21
India,15/03/2005,2,0,-1,0,-1,3,0,3
India,16/03/2005,0,0,0,0,0,1,0,1
India,17/03/2005,3,0,0,0,9,0,0,12
India,18/03/2005,10,0,0,0,0,6,0,16
India,19/03/2005,2,0,0,0,0,1,0,3
India,20/03/2005,2,0,0,0,0,0,0,2
India,21/03/2005,-1,0,0,0,-2,0,0,-3
India,22/03/2005,0,0,1,0,6,0,0,7
India,23/03/2005,0,0,0,0,3,0,0,3
India,24/03/2005,6,0,0,0,0,0,0,6
India,25/03/2005,0,0,0,0,0,0,0,0
India,26/03/2005,0,0,0,0,0,0,0,0
India,27/03/2005,3,0,0,0,0,0,0,3
India,28/03/2005,2,0,0,0,0,0,0,2
India,29/03/2005,1,0,0,0,0,0,0,1
India,30/03/2005,6,0,0,0,0,0,0,6
India,31/03/2005,2,0,-2,0,1,2,0,3
India,01/04/2005,10,0,0,0,0,1,0,11
India,02/04/2005,7,0,0,0,6,8,0,21
India,03/04/2005,2,0,0,0,0,0,0,2
India,04/04/2005,0,0,0,0,0,0,0,0
India,05/04/2005,0,0,0,0,0,0,0,0
India,06/04/2005,2,0,0,0,0,0,0,2
India,07/04/2005,3,0,0,0,0,0,0,3
India,08/04/2005,-1,0,0,0,6,0,0,5
India,09/04/2005,7,0,0,0,0,1,0,8
India,10/04/2005,3,0,0,0,-1,2,0,4
India,11/04/2005,6,0,0,0,6,0,0,12
India,12/04/2005,6,0,0,0,1,0,0,7
India,13/04/2005,8,0,0,0,3,1,0,12
India,14/04/2005,6,0,0,0,3,1,0,10
India,15/04/2005,4,0,0,0,-2,0,0,2
India,16/04/2005,2,0,0,0,0,0,0,2
India,17/04/2005,7,0,0,0,2,0,0,9
India,18/04/2005,8,0,0,0,-4,0,0,4
India,19/04/2005,1,0,0,0,0,0,0,1
India,20/04/2005,3,0,0,0,-6,0,0,-3
India,21/04/2005,12,0,0,0,0,1,0,13
India,22/04/2005,14,0,0,0,0,0,0,14
India,23/04/2005,7,0,0,0,0,0,0,7
India,24/04/2005,3,0,0,0,4,0,0,7
India,25/04/2005,4,0,0,0,2,2,0,8
India,26/04/2005,-1,0,-1,0,0,0,0,-2
India,27/04/2005,10,0,0,0,6,1,0,17
India,28/04/2005,8,0,0,0,3,0,0,11
India,29/04/2005,0,0,0,0,0,0,0,0
India,30/04/2005,5,0,0,0,-1,0,0,4
India,01/05/2005,4,0,0,0,3,0,0,7
India,02/05/2005,0,0,0,0,6,3,0,9
India,03/05/2005,1,0,1,0,6,3,0,11
India,04/05/2005,1,0,0,0,0,0,0,1
India,05/05/2005,5,0,0,0,6,0,0,11
India,06/05/2005,20,2,0,0,0,2,0,24
India,07/05/2005,6,0,0,0,18,3,0,27
India,08/05/2005,0,0,0,0,0,2,0,2
India,09/05/2005,-3,0,0,0,0,0,0,-3
India,10/05/2005,4,0,0,0,0,0,0,4
India,11/05/2005,4,0,0,0,-2,0,0,2
India,12/05/2005,13,0,0,0,0,2,0,15
India,13/05/2005,12,0,0,0,-2,3,0,13
India,14/05/2005,-1,0,0,0,0,0,0,-1
India,15/05/2005,-1,0,-1,0,3,0,0,1
India,16/05/2005,3,0,0,0,6,0,0,9
India,17/05/2005,3,2,0,0,3,0,0,8
India,18/05/2005,6,0,0,0,3,0,0,9
India,19/05/2005,0,0,0,0,3,0,0,3
India,20/05/2005,-1,0,0,0,3,0,0,2
India,21/05/2005,6,0,0,0,0,0,0,6
India,22/05/2005,1,0,0,0,0,0,0,1
India,23/05/2005,5,0,0,0,0,3,0,8
India,24/05/2005,-1,0,0,0,0,0,0,-1
India,25/05/2005,14,0,-3,0,0,3,0,14
India,26/05/2005,9,0,0,0,0,0,0,9
India,27/05/2005,-1,0,0,0,6,1,0,6
India,28/05/2005,0,0,0,0,3,0,0,3
India,29/05/2005,2,0,0,0,0,1,0,3
India,30/05/2005,9,0,0,0,0,2,0,11
India,31/05/2005,4,0,0,0,0,8,0,12
India,01/06/2005,1,0,0,0,3,0,0,4
India,02/06/2005,15,0,0,0,12,0,0,27
India,03/06/2005,0,2,0,0,0,2,0,4
India,04/06/2005,0,0,0,0,0,0,0,0
India,05/06/2005,8,0,0,0,0,0,0,8
India,06/06/2005,2,2,0,0,0,0,0,4
India,07/06/2005,-1,0,0,0,3,0,0,2
India,08/06/2005,7,0,0,0,0,0,0,7
India,09/06/2005,3,0,0,0,3,1,0,7
India,10/06/2005,7,0,0,0,2,1,0,10
India,11/06/2005,4,0,0,0,0,0,0,4
India,12/06/2005,-4,0,0,0,0,2,0,-2
India,13/06/2005,2,0,0,0,6,0,0,8
India,14/06/2005,3,0,0,0,0,0,0,3
India,15/06/2005,16,0,0,0,3,0,0,19
India,16/06/2005,1,0,0,0,6,0,0,7
India,17/06/2005,0,0,0,0,0,0,0,0
India,18/06/2005,1,0,0,0,0,3,0,4
India,19/06/2005,1,0,0,0,0,0,0,1
India,20/06/2005,0,0,0,0,3,0,0,3
India,21/06/2005,1,0,0,0,0,0,0,1
India,22/06/2005,5,0,0,0,0,0,0,5
India,23/06/2005,2,0,0,0,0,0,0,2
India,24/06/2005,5,0,0,0,3,0,0,8
India,25/06/2005,0,0,0,0,0,0,0,0
India,26/06/2005,2,0,0,0,0,0,0,2
India,27/06/2005,0,0,0,0,0,0,0,0
India,28/06/2005,0,0,0,0,0,0,0,0
India,29/06/2005,8,0,0,0,-4,7,0,11
India,30/06/2005,-3,0,0,0,0,3,0,0
India,01/07/2005,2,0,0,0,0,0,0,2
India,02/07/2005,0,0,0,0,0,0,0,0
India,03/07/2005,-1,0,-2,0,0,0,0,-3
India,04/07/2005,9,0,0,0,-2,0,0,7
India,05/07/2005,0,0,0,0,3,0,0,3
India,06/07/2005,12,0,0,0,0,0,0,12
India,07/07/2005,2,0,-1,0,0,0,0,1
India,08/07/2005,1,0,0,0,3,0,0,4
India,09/07/2005,0,0,0,0,0,0,0,0
India,10/07/2005,11,0,-1,0,0,2,0,12
India,11/07/2005,0,0,0,0,-2,1,0,-1
India,12/07/2005,7,0,0,0,0,1,0,8
India,13/07/2005,1,0,0,0,0,0,0,1
India,14/07/2005,2,0,0,0,0,0,0,2
India,15/07/2005,2,2,0,0,3,0,0,7
India,16/07/2005,0,0,0,0,3,0,0,3
India,17/07/2005,3,0,0,0,3,0,0,6
India,18/07/2005,6,0,0,0,0,0,0,6
India,19/07/2005,3,0,0,0,1,1,0,5
India,20/07/2005,7,0,0,0,-2,3,0,8
India,21/07/2005,11,0,0,0,-2,0,0,9
India,22/07/2005,4,0,0,0,0,0,0,4
India,23/07/2005,-2,0,0,0,-2,1,0,-3
India,24/07/2005,14,0,0,0,0,1,0,15
India,25/07/2005,3,0,0,0,3,0,0,6
India,26/07/2005,1,0,0,0,0,0,0,1
India,27/07/2005,21,0,-1,0,12,0,0,32
India,28/07/2005,3,0,0,0,0,0,0,3
India,29/07/2005,15,0,0,0,9,4,0,28
India,30/07/2005,0,0,0,0,0,0,0,0
India,31/07/2005,22,0,0,0,0,1,0,23
India,01/08/2005,2,0,0,0,0,0,0,2
India,02/08/2005,2,2,0,0,0,1,0,5
India,03/08/2005,0,0,0,0,0,0,0,0
India,04/08/2005,6,0,0,0,0,0,0,6
India,05/08/2005,7,0,0,0,0,1,0,8
India,06/08/2005,0,0,0,0,0,0,0,0
India,07/08/2005,1,0,0,0,0,1,0,2
India,08/08/2005,7,0,0,0,0,0,0,7
India,09/08/2005,3,0,0,0,0,0,0,3
India,10/08/2005,3,0,0,0,0,1,0,4
India,11/08/2005,4,0,0,0,6,0,0,10
India,12/08/2005,0,0,0,0,0,0,0,0
India,13/08/2005,3,0,0,0,3,0,0,6
India,14/08/2005,3,0,0,0,0,0,0,3
India,15/08/2005,3,0,0,0,9,0,0,12
India,16/08/2005,10,0,0,0,0,0,0,10
India,17/08/2005,3,0,0,0,0,4,0,7
India,18/08/2005,0,0,0,0,0,0,0,0
India,19/08/2005,4,0,0,0,0,1,0,5
India,20/08/2005,0,0,0,0,0,0,0,0
India,21/08/2005,1,0,0,0,0,0,0,1
India,22/08/2005,0,0,0,0,0,0,0,0
India,23/08/2005,1,0,0,0,3,0,0,4
India,24/08/2005,13,0,0,0,-6,0,0,7
India,25/08/2005,3,0,0,0,3,1,0,7
India,26/08/2005,4,0,0,0,0,0,0,4
India,27/08/2005,6,0,0,0,3,0,0,9
India,28/08/2005,11,0,0,0,0,0,0,11
India,29/08/2005,1,0,0,0,0,2,0,3
India,30/08/2005,12,0,0,0,0,1,0,13
India,31/08/2005,3,0,0,0,0,1,0,4
India,01/09/2005,7,0,0,0,3,0,0,10
India,02/09/2005,13,2,0,0,0,0,0,15
India,03/09/2005,-1,0,0,0,0,0,0,-1
India,04/09/2005,0,0,0,0,1,0,0,1
India,05/09/2005,3,0,0,0,0,0,0,3
India,06/09/2005,1,0,0,0,0,1,0,2
India,07/09/2005,12,0,0,0,3,3,0,18
India,08/09/2005,2,0,0,0,0,0,0,2
India,09/09/2005,12,0,0,0,-1,1,0,12
India,10/09/2005,0,0,0,0,0,1,0,1
India,11/09/2005,2,0,0,0,0,0,0,2
India,12/09/2005,4,0,0,0,-6,0,0,-2
India,13/09/2005,14,0,0,0,0,0,0,14
India,14/09/2005,-2,0,-1,0,0,0,0,-3
India,15/09/2005,-4,0,0,0,6,0,0,2
India,16/09/2005,5,0,0,0,-1,0,0,4
India,17/09/2005,0,0,0,0,0,0,0,0
India,18/09/2005,2,0,0,0,0,0,0,2
India,19/09/2005,2,2,1,0,3,0,0,8
India,20/09/2005,2,0,0,0,0,0,0,2
India,21/09/2005,4,0,0,0,0,0,0,4
India,22/09/2005,3,0,0,0,0,0,0,3
India,23/09/2005,0,0,0,0,0,0,0,0
India,24/09/2005,1,0,0,0,0,0,0,1
India,25/09/2005,6,0,0,0,0,0,0,6
India,26/09/2005,-1,0,-1,0,0,1,0,-1
India,27/09/2005,2,0,-1,0,0,0,0,1
India,28/09/2005,5,0,1,0,0,0,0,6
India,29/09/2005,14,0,0,0,0,0,0,14
India,30/09/2005,5,0,0,0,9,0,0,14
India,01/10/2005,0,0,0,0,0,0,0,0
India,02/10/2005,0,0,0,0,0,1,0,1
India,03/10/2005,0,0,0,0,0,0,0,0
India,04/10/2005,3,0,0,0,0,0,0,3
India,05/10/2005,16,0,0,0,-4,4,0,16
India,06/10/2005,3,0,0,0,3,0,0,6
India,07/10/2005,3,0,0,0,0,0,0,3
India,08/10/2005,5,0,0,0,-2,0,0,3
India,09/10/2005,4,2,0,0,3,0,0,9
India,10/10/2005,2,0,0,0,-2,4,0,4
India,11/10/2005,2,0,0,0,3,4,0,9
India,12/10/2005,1,0,0,0,3,0,0,4
India,13/10/2005,7,0,0,0,0,0,0,7
India,14/10/2005,6,0,0,0,0,0,0,6
India,15/10/2005,2,0,0,0,0,0,0,2
India,16/10/2005,4,0,0,0,0,0,0,4
India,17/10/2005,7,0,0,0,0,0,0,7
India,18/10/2005,14,0,0,0,3,0,0,17
India,19/10/2005,7,0,0,0,6,0,0,13
India,20/10/2005,26,0,0,0,0,0,0,26
India,21/10/2005,0,0,0,0,3,0,0,3
India,22/10/2005,7,2,0,0,3,0,0,12
India,23/10/2005,0,0,0,0,3,0,0,3
India,24/10/2005,5,0,0,0,0,0,0,5
India,25/10/2005,2,0,0,0,0,2,0,4
India,26/10/2005,0,0,0,0,9,0,0,9
India,27/10/2005,0,0,0,0,0,1,0,1
India,28/10/2005,3,0,0,0,3,0,0,6
India,29/10/2005,7,0,-1,0,3,0,0,9
India,30/10/2005,0,0,0,0,0,0,0,0
India,31/10/2005,-3,0,0,0,6,0,0,3
India,01/11/2005,5,0,0,0,0,4,0,9
India,02/11/2005,4,0,0,0,0,3,0,7
India,03/11/2005,3,0,-2,0,0,1,0,2
India,04/11/2005,3,0,0,0,0,0,0,3
India,05/11/2005,1,0,0,0,0,0,0,1
India,06/11/2005,6,0,0,0,0,0,0,6
India,07/11/2005,3,0,-2,0,0,2,0,3
India,08/11/2005,9,2,0,0,-2,0,0,9
India,09/11/2005,1,0,0,0,-4,0,0,-3
India,10/11/2005,15,0,-4,0,-2,0,0,9
India,11/11/2005,5,2,0,0,0,0,0,7
India,12/11/2005,0,0,0,0,3,0,0,3
India,13/11/2005,0,0,1,0,0,0,0,1
India,14/11/2005,15,0,-1,0,0,0,0,14
India,15/11/2005,2,0,0,0,0,0,0,2
India,16/11/2005,6,0,0,0,0,0,0,6
India,17/11/2005,0,0,0,0,0,0,0,0
India,18/11/2005,0,0,0,0,0,1,0,1
India,19/11/2005,3,0,0,0,0,0,0,3
India,20/11/2005,0,0,0,0,3,0,0,3
India,21/11/2005,12,0,0,0,0,1,0,13
India,22/11/2005,4,0,0,0,0,1,0,5
India,23/11/2005,3,0,0,0,0,0,0,3
India,24/11/2005,3,0,0,0,0,1,0,4
India,25/11/2005,2,0,0,0,0,0,0,2
India,26/11/2005,0,2,0,0,0,0,0,2
India,28/11/2005,0,0,0,0,0,0,0,0
India,29/11/2005,15,0,0,0,-6,0,0,9
India,30/11/2005,-4,0,0,0,0,0,0,-4
India,01/12/2005,-1,0,0,0,0,2,0,1
India,02/12/2005,0,0,0,0,0,0,0,0
India,03/12/2005,0,0,0,0,0,0,0,0
India,04/12/2005,5,0,0,0,12,3,0,20
India,05/12/2005,4,0,0,0,0,2,0,6
India,06/12/2005,3,0,0,0,-6,0,0,-3
India,07/12/2005,4,0,0,0,0,2,0,6
India,08/12/2005,8,0,0,0,6,0,0,14
India,09/12/2005,7,0,0,0,0,1,0,8
India,10/12/2005,2,0,0,0,0,0,0,2
India,11/12/2005,0,0,0,0,3,0,0,3
India,12/12/2005,0,0,0,0,3,0,0,3
India,13/12/2005,3,0,0,0,0,0,0,3
India,14/12/2005,6,0,0,0,10,1,0,17
India,15/12/2005,3,0,0,0,0,0,0,3
India,16/12/2005,6,0,0,0,0,0,0,6
India,17/12/2005,12,0,0,0,3,0,0,15
India,18/12/2005,0,0,0,0,0,6,0,6
India,19/12/2005,0,0,0,0,0,0,0,0
India,20/12/2005,0,0,0,0,3,0,0,3
India,21/12/2005,0,0,0,0,0,0,0,0
India,22/12/2005,0,0,-1,0,-3,0,0,-4
India,23/12/2005,7,0,-2,0,6,0,0,11
India,24/12/2005,5,0,-1,0,0,0,0,4
India,25/12/2005,0,0,0,0,0,1,0,1
India,26/12/2005,4,0,0,0,0,0,0,4
India,27/12/2005,-3,0,0,0,0,1,0,-2
India,28/12/2005,3,0,0,0,0,0,0,3
India,29/12/2005,8,0,0,0,3,0,0,11
India,30/12/2005,5,0,0,0,3,0,0,8
India,31/12/2005,6,0,0,0,0,1,0,7
Iran,01/01/2005,0,0,0,0,9,0,0,9
Iran,02/01/2005,4,0,0,0,0,0,0,4
Iran,03/01/2005,-7,0,0,0,6,0,0,-1
Iran,04/01/2005,4,0,0,0,0,2,0,6
Iran,05/01/2005,5,0,0,0,0,0,0,5
Iran,06/01/2005,13,0,2,0,13,0,0,28
Iran,07/01/2005,15,0,0,0,3,5,0,23
Iran,08/01/2005,16,0,0,0,9,0,0,25
Iran,09/01/2005,6,0,0,0,3,6,0,15
Iran,10/01/2005,4,0,0,0,9,0,0,13
Iran,11/01/2005,5,2,-1,0,6,2,0,14
Iran,12/01/2005,12,0,0,0,10,2,0,24
Iran,13/01/2005,13,0,0,0,6,1,0,20
Iran,14/01/2005,-1,0,0,0,0,0,0,-1
Iran,15/01/2005,17,0,0,0,-1,0,0,16
Iran,16/01/2005,12,0,0,0,9,0,0,21
Iran,17/01/2005,10,0,0,0,11,0,0,21
Iran,18/01/2005,22,0,0,0,9,0,0,31
Iran,19/01/2005,5,2,0,0,9,0,0,16
Iran,20/01/2005,19,0,0,0,5,0,0,24
Iran,21/01/2005,20,0,0,0,-4,0,0,16
Iran,22/01/2005,3,0,0,0,6,0,0,9
Iran,23/01/2005,31,0,0,0,26,0,0,57
Iran,24/01/2005,6,0,0,0,15,1,0,22
Iran,25/01/2005,2,0,0,0,15,1,0,18
Iran,26/01/2005,9,0,0,0,0,2,0,11
Iran,27/01/2005,30,0,0,0,0,0,0,30
Iran,28/01/2005,2,0,0,0,1,9,0,12
Iran,29/01/2005,25,0,0,0,0,9,0,34
Iran,30/01/2005,2,0,0,0,6,1,0,9
Iran,31/01/2005,9,0,-2,0,3,2,0,12
Iran,01/02/2005,8,0,-2,0,3,1,0,10
Iran,02/02/2005,6,0,0,0,-2,0,0,4
Iran,03/02/2005,-1,0,0,0,3,2,0,4
Iran,04/02/2005,9,0,0,0,0,0,0,9
Iran,05/02/2005,14,0,0,0,0,0,0,14
Iran,06/02/2005,19,0,2,0,-2,1,0,20
Iran,07/02/2005,6,0,0,0,-7,3,0,2
Iran,08/02/2005,7,0,0,0,6,0,0,13
Iran,09/02/2005,21,0,0,0,12,0,0,33
Iran,10/02/2005,11,0,4,0,14,5,0,34
Iran,11/02/2005,2,0,0,0,6,0,0,8
Iran,12/02/2005,-3,0,0,0,3,0,0,0
Iran,13/02/2005,31,2,0,0,0,0,0,33
Iran,14/02/2005,12,0,0,0,-2,2,0,12
Iran,15/02/2005,8,0,0,0,1,0,0,9
Iran,16/02/2005,19,2,2,0,7,0,0,30
Iran,17/02/2005,9,0,0,0,2,0,0,11
Iran,18/02/2005,3,0,0,0,0,0,0,3
Iran,19/02/2005,6,0,0,0,1,0,0,7
Iran,20/02/2005,4,0,0,0,0,1,0,5
Iran,21/02/2005,-1,0,0,0,8,2,0,9
Iran,22/02/2005,11,0,0,0,6,11,0,28
Iran,23/02/2005,4,0,0,0,-2,4,0,6
Iran,24/02/2005,12,0,2,0,-2,2,0,14
Iran,25/02/2005,1,0,0,0,15,2,0,18
Iran,26/02/2005,2,0,0,0,0,4,0,6
Iran,27/02/2005,3,0,0,0,0,0,0,3
Iran,28/02/2005,6,0,0,0,3,0,0,9
Iran,01/03/2005,7,0,0,0,8,4,0,19
Iran,02/03/2005,6,0,-2,0,0,1,0,5
Iran,03/03/2005,9,0,0,0,-7,2,0,4
Iran,04/03/2005,5,0,0,0,-3,1,0,3
Iran,05/03/2005,4,0,0,0,0,0,0,4
Iran,06/03/2005,2,0,0,0,-4,0,0,-2
Iran,07/03/2005,13,0,0,0,20,1,0,34
Iran,08/03/2005,22,0,1,0,22,2,0,47
Iran,09/03/2005,22,0,0,0,12,1,0,35
Iran,10/03/2005,3,0,0,0,0,16,0,19
Iran,11/03/2005,-4,0,0,0,9,3,0,8
Iran,12/03/2005,3,0,0,0,-6,0,0,-3
Iran,13/03/2005,3,0,0,0,0,0,0,3
Iran,14/03/2005,3,0,-2,0,3,0,0,4
Iran,15/03/2005,7,0,0,0,-4,0,0,3
Iran,16/03/2005,13,0,0,0,6,0,0,19
Iran,17/03/2005,10,2,1,0,-1,0,0,12
Iran,18/03/2005,1,0,-1,0,11,0,0,11
Iran,19/03/2005,2,0,0,0,0,0,0,2
Iran,20/03/2005,12,0,0,0,0,3,0,15
Iran,21/03/2005,3,0,0,0,0,0,0,3
Iran,22/03/2005,2,0,0,0,4,0,0,6
Iran,23/03/2005,8,0,0,0,-3,0,0,5
Iran,24/03/2005,5,0,-3,0,0,0,0,2
Iran,25/03/2005,8,0,0,0,-6,0,0,2
Iran,26/03/2005,2,0,0,0,21,4,0,27
Iran,27/03/2005,20,0,0,0,54,0,0,74
Iran,28/03/2005,7,0,0,0,0,0,0,7
Iran,29/03/2005,-1,0,0,0,9,0,0,8
Iran,30/03/2005,-4,0,0,0,0,0,0,-4
Iran,31/03/2005,4,0,0,0,0,0,0,4
Iran,01/04/2005,8,0,0,0,3,5,0,16
Iran,02/04/2005,5,0,1,0,1,2,0,9
Iran,03/04/2005,3,0,0,0,-2,4,0,5
Iran,04/04/2005,8,0,0,0,0,4,0,12
Iran,05/04/2005,13,0,0,0,2,1,0,16
Iran,06/04/2005,19,0,0,0,6,1,0,26
Iran,07/04/2005,18,0,0,0,4,0,0,22
Iran,08/04/2005,3,0,0,0,0,1,0,4
Iran,09/04/2005,4,0,0,0,6,0,0,10
Iran,10/04/2005,18,0,1,0,3,0,0,22
Iran,11/04/2005,5,0,0,0,0,1,0,6
Iran,12/04/2005,12,0,0,0,3,6,0,21
Iran,13/04/2005,-2,0,0,0,0,0,0,-2
Iran,14/04/2005,12,0,0,0,3,1,0,16
Iran,15/04/2005,8,0,0,0,0,0,0,8
Iran,16/04/2005,10,0,0,0,3,0,0,13
Iran,17/04/2005,4,0,1,0,1,3,0,9
Iran,18/04/2005,4,0,0,0,3,0,0,7
Iran,19/04/2005,11,0,0,0,0,0,0,11
Iran,20/04/2005,12,0,0,0,0,3,0,15
Iran,21/04/2005,5,0,0,0,0,0,0,5
Iran,22/04/2005,1,0,0,0,0,0,0,1
Iran,23/04/2005,4,0,0,0,0,0,0,4
Iran,24/04/2005,4,0,-2,0,-6,0,0,-4
Iran,25/04/2005,16,0,0,0,7,0,0,23
Iran,26/04/2005,6,0,0,0,6,0,0,12
Iran,27/04/2005,9,0,0,0,0,0,0,9
Iran,28/04/2005,1,0,0,0,6,0,0,7
Iran,29/04/2005,9,0,0,0,3,2,0,14
Iran,30/04/2005,23,0,0,0,6,0,0,29
Iran,01/05/2005,3,0,0,0,0,3,0,6
Iran,02/05/2005,0,0,0,0,3,0,0,3
Iran,03/05/2005,13,0,0,0,12,0,0,25
Iran,04/05/2005,15,0,0,0,4,1,0,20
Iran,05/05/2005,2,0,2,0,7,2,0,13
Iran,06/05/2005,3,0,0,0,6,0,0,9
Iran,07/05/2005,2,0,0,0,6,0,0,8
Iran,08/05/2005,11,0,0,0,-4,0,0,7
Iran,09/05/2005,3,0,0,0,3,0,0,6
Iran,10/05/2005,8,0,0,0,0,1,0,9
Iran,11/05/2005,5,0,1,0,0,4,0,10
Iran,12/05/2005,8,0,0,0,-3,2,0,7
Iran,13/05/2005,3,0,0,0,5,1,0,9
Iran,14/05/2005,6,0,0,0,16,8,0,30
Iran,15/05/2005,4,0,0,0,5,0,0,9
Iran,16/05/2005,0,0,2,0,15,-6,0,11
Iran,17/05/2005,6,0,0,0,-4,2,0,4
Iran,18/05/2005,18,0,0,0,7,3,0,28
Iran,19/05/2005,30,0,0,0,18,1,0,49
Iran,20/05/2005,12,0,0,0,3,1,0,16
Iran,21/05/2005,6,0,0,0,0,0,0,6
Iran,22/05/2005,-1,0,0,0,4,2,0,5
Iran,23/05/2005,9,0,-5,0,-2,0,0,2
Iran,24/05/2005,1,0,1,0,20,1,0,23
Iran,25/05/2005,0,0,0,0,3,0,0,3
Iran,26/05/2005,-2,0,0,0,0,0,0,-2
Iran,27/05/2005,1,0,0,0,1,3,0,5
Iran,28/05/2005,4,0,0,0,1,2,0,7
Iran,29/05/2005,25,0,2,0,6,3,0,36
Iran,30/05/2005,17,0,0,0,15,0,0,32
Iran,31/05/2005,21,0,0,0,3,2,0,26
Iran,01/06/2005,2,0,0,0,4,1,0,7
Iran,02/06/2005,13,0,0,0,-4,3,0,12
Iran,03/06/2005,2,0,0,0,3,5,0,10
Iran,04/06/2005,0,0,0,0,0,0,0,0
Iran,05/06/2005,7,0,0,0,0,0,0,7
Iran,06/06/2005,6,0,0,0,2,0,0,8
Iran,07/06/2005,2,0,1,0,3,0,0,6
Iran,08/06/2005,8,0,0,0,1,3,0,12
Iran,09/06/2005,5,0,-4,0,3,0,0,4
Iran,10/06/2005,29,0,0,0,12,0,0,41
Iran,11/06/2005,4,0,0,0,0,0,0,4
Iran,12/06/2005,8,0,0,0,6,0,0,14
Iran,13/06/2005,12,0,0,0,4,1,0,17
Iran,14/06/2005,20,0,0,0,-4,1,0,17
Iran,15/06/2005,0,0,0,0,-1,0,0,-1
Iran,16/06/2005,2,0,0,0,6,4,0,12
Iran,17/06/2005,4,0,2,0,23,14,0,43
Iran,18/06/2005,14,0,0,0,0,1,0,15
Iran,19/06/2005,-3,0,0,0,3,8,0,8
Iran,20/06/2005,0,0,0,0,0,3,0,3
Iran,21/06/2005,3,0,0,0,3,0,0,6
Iran,22/06/2005,8,0,0,0,-1,1,0,8
Iran,23/06/2005,9,0,0,0,6,1,0,16
Iran,24/06/2005,4,0,0,0,3,5,0,12
Iran,25/06/2005,7,0,0,0,-2,0,0,5
Iran,26/06/2005,-1,0,0,0,-4,0,0,-5
Iran,27/06/2005,13,0,0,0,-2,1,0,12
Iran,28/06/2005,6,0,-1,0,9,0,0,14
Iran,29/06/2005,24,0,0,0,3,0,0,27
Iran,30/06/2005,6,0,0,0,2,1,0,9
Iran,01/07/2005,7,0,0,0,0,6,0,13
Iran,02/07/2005,3,0,0,0,0,0,0,3
Iran,03/07/2005,14,0,0,0,-14,2,0,2
Iran,04/07/2005,30,0,0,0,-4,0,0,26
Iran,05/07/2005,19,0,-2,0,2,2,0,21
Iran,06/07/2005,22,0,0,0,-1,0,0,21
Iran,07/07/2005,0,0,0,0,7,0,0,7
Iran,08/07/2005,0,0,0,0,0,0,0,0
Iran,09/07/2005,0,4,0,0,0,0,0,4
Iran,10/07/2005,3,0,0,0,-4,0,0,-1
Iran,11/07/2005,0,0,0,0,0,0,0,0
Iran,12/07/2005,6,0,0,0,0,0,0,6
Iran,13/07/2005,17,0,0,0,6,11,0,34
Iran,14/07/2005,18,0,0,0,3,1,0,22
Iran,15/07/2005,1,0,0,0,7,0,0,8
Iran,16/07/2005,1,0,0,0,2,0,0,3
Iran,17/07/2005,4,0,0,0,6,3,0,13
Iran,18/07/2005,9,0,0,0,0,0,0,9
Iran,19/07/2005,4,0,0,0,9,0,0,13
Iran,20/07/2005,12,0,0,0,4,5,0,21
Iran,21/07/2005,2,0,-1,0,3,0,0,4
Iran,22/07/2005,5,0,0,0,0,1,0,6
Iran,23/07/2005,16,0,0,0,0,0,0,16
Iran,24/07/2005,12,0,0,0,0,0,0,12
Iran,25/07/2005,5,0,0,0,0,0,0,5
Iran,26/07/2005,3,0,0,0,3,0,0,6
Iran,27/07/2005,7,0,0,0,-4,0,0,3
Iran,28/07/2005,1,0,0,0,-4,0,0,-3
Iran,29/07/2005,0,0,0,0,0,0,0,0
Iran,30/07/2005,2,0,0,0,2,4,0,8
Iran,31/07/2005,1,0,0,0,0,0,0,1
Iran,01/08/2005,6,0,0,0,0,0,0,6
Iran,02/08/2005,4,0,0,0,9,3,0,16
Iran,03/08/2005,8,0,0,0,0,1,0,9
Iran,04/08/2005,6,0,0,0,3,5,0,14
Iran,05/08/2005,14,0,-1,0,6,2,0,21
Iran,06/08/2005,12,0,0,0,-2,1,0,11
Iran,07/08/2005,2,0,-6,0,0,0,0,-4
Iran,08/08/2005,6,0,0,0,6,0,0,12
Iran,09/08/2005,20,0,1,0,1,5,0,27
Iran,10/08/2005,19,0,1,0,0,2,0,22
Iran,11/08/2005,12,0,0,0,6,4,0,22
Iran,12/08/2005,11,0,0,0,3,1,0,15
Iran,13/08/2005,0,0,0,0,3,0,0,3
Iran,14/08/2005,9,0,0,0,9,0,0,18
Iran,15/08/2005,9,0,0,0,-4,1,0,6
Iran,16/08/2005,-1,0,0,0,0,0,0,-1
Iran,17/08/2005,1,0,0,0,0,0,0,1
Iran,18/08/2005,3,0,0,0,3,0,0,6
Iran,19/08/2005,6,0,0,0,-7,1,0,0
Iran,20/08/2005,3,0,0,0,0,0,0,3
Iran,21/08/2005,17,0,0,0,9,0,0,26
Iran,22/08/2005,4,0,0,0,1,0,0,5
Iran,23/08/2005,20,0,0,0,9,5,0,34
Iran,24/08/2005,9,0,0,0,7,4,0,20
Iran,25/08/2005,15,0,0,0,-5,2,0,12
Iran,26/08/2005,8,0,0,0,0,1,0,9
Iran,27/08/2005,5,0,0,0,-1,0,0,4
Iran,28/08/2005,29,0,0,0,0,0,0,29
Iran,29/08/2005,10,0,0,0,4,0,0,14
Iran,30/08/2005,0,0,0,0,0,3,0,3
Iran,31/08/2005,37,0,0,0,0,7,0,44
Iran,01/09/2005,3,0,0,0,-5,0,0,-2
Iran,02/09/2005,4,0,-2,0,0,0,0,2
Iran,03/09/2005,0,0,0,0,0,0,0,0
Iran,04/09/2005,2,0,0,0,-1,0,0,1
Iran,05/09/2005,10,0,0,0,6,0,0,16
Iran,06/09/2005,0,0,0,0,1,0,0,1
Iran,07/09/2005,10,2,-2,0,7,0,0,17
Iran,08/09/2005,4,0,0,0,0,0,0,4
Iran,09/09/2005,1,0,0,0,0,0,0,1
Iran,10/09/2005,5,0,0,0,7,0,0,12
Iran,11/09/2005,2,0,0,0,3,0,0,5
Iran,12/09/2005,6,0,0,0,9,0,0,15
Iran,13/09/2005,0,0,0,0,0,0,0,0
Iran,14/09/2005,18,0,0,0,7,5,0,30
Iran,15/09/2005,35,0,0,0,0,1,0,36
Iran,16/09/2005,7,0,0,0,6,1,0,14
Iran,17/09/2005,18,0,0,0,6,0,0,24
Iran,18/09/2005,13,0,0,0,9,0,0,22
Iran,19/09/2005,2,0,0,0,1,1,0,4
Iran,20/09/2005,16,0,0,0,0,0,0,16
Iran,21/09/2005,15,0,1,0,-6,4,0,14
Iran,22/09/2005,23,0,0,0,7,6,0,36
Iran,23/09/2005,6,0,0,0,22,1,0,29
Iran,24/09/2005,17,0,1,0,0,0,0,18
Iran,25/09/2005,5,0,0,0,6,0,0,11
Iran,26/09/2005,7,0,0,0,7,0,0,14
Iran,27/09/2005,4,0,0,0,3,0,0,7
Iran,28/09/2005,14,0,0,0,9,2,0,25
Iran,29/09/2005,-2,0,0,0,7,9,0,14
Iran,30/09/2005,0,0,0,0,0,0,0,0
Iran,01/10/2005,16,0,0,0,3,0,0,19
Iran,02/10/2005,8,0,0,0,9,2,0,19
Iran,03/10/2005,4,0,0,0,1,0,0,5
Iran,04/10/2005,24,0,0,0,0,0,0,24
Iran,05/10/2005,5,0,0,0,-2,0,0,3
Iran,06/10/2005,12,0,0,0,0,1,0,13
Iran,07/10/2005,-2,0,1,0,2,0,0,1
Iran,08/10/2005,1,0,0,0,0,0,0,1
Iran,09/10/2005,6,0,0,0,-4,1,0,3
Iran,10/10/2005,6,0,0,0,0,0,0,6
Iran,11/10/2005,1,0,0,0,3,0,0,4
Iran,12/10/2005,12,0,0,0,12,0,0,24
Iran,13/10/2005,14,0,0,0,0,0,0,14
Iran,14/10/2005,18,0,0,0,0,0,0,18
Iran,15/10/2005,19,0,0,0,15,12,0,46
Iran,16/10/2005,12,0,-1,0,0,1,0,12
Iran,17/10/2005,26,4,0,0,1,1,0,32
Iran,18/10/2005,22,0,0,0,18,0,0,40
Iran,19/10/2005,20,0,0,0,7,2,0,29
Iran,20/10/2005,6,0,0,0,3,1,0,10
Iran,21/10/2005,0,0,0,0,0,2,0,2
Iran,22/10/2005,0,0,-2,0,15,2,0,15
Iran,23/10/2005,5,0,0,0,6,2,0,13
Iran,24/10/2005,9,0,0,0,3,0,0,12
Iran,25/10/2005,3,0,0,0,15,0,0,18
Iran,26/10/2005,20,0,0,0,-2,3,0,21
Iran,27/10/2005,15,0,-3,0,15,3,0,30
Iran,28/10/2005,33,0,0,0,9,6,0,48
Iran,29/10/2005,6,0,0,0,3,1,0,10
Iran,30/10/2005,2,0,0,0,9,3,0,14
Iran,31/10/2005,9,0,0,0,11,0,0,20
Iran,01/11/2005,12,4,0,0,0,1,0,17
Iran,02/11/2005,14,0,0,0,1,3,0,18
Iran,03/11/2005,10,0,0,0,-7,1,0,4
Iran,04/11/2005,10,0,1,0,1,1,0,13
Iran,05/11/2005,23,0,0,0,3,0,0,26
Iran,06/11/2005,13,0,0,0,3,0,0,16
Iran,07/11/2005,14,0,0,0,0,0,0,14
Iran,08/11/2005,16,0,0,0,4,1,0,21
Iran,09/11/2005,22,0,0,0,-8,0,0,14
Iran,10/11/2005,24,0,0,0,0,3,0,27
Iran,11/11/2005,13,0,0,0,-2,2,0,13
Iran,12/11/2005,-1,0,0,0,0,0,0,-1
Iran,13/11/2005,9,0,0,0,0,1,0,10
Iran,14/11/2005,9,0,0,0,0,0,0,9
Iran,15/11/2005,16,0,0,0,-4,4,0,16
Iran,16/11/2005,14,0,1,0,9,0,0,24
Iran,17/11/2005,6,2,0,0,4,0,0,12
Iran,18/11/2005,16,0,0,0,3,9,0,28
Iran,19/11/2005,12,0,0,0,3,7,0,22
Iran,20/11/2005,5,0,0,0,0,0,0,5
Iran,21/11/2005,9,0,0,0,6,0,0,15
Iran,22/11/2005,4,0,0,0,9,0,0,13
Iran,23/11/2005,24,0,0,0,3,0,0,27
Iran,24/11/2005,10,0,0,0,2,5,0,17
Iran,25/11/2005,11,0,0,0,0,0,0,11
Iran,26/11/2005,12,0,0,0,13,2,0,27
Iran,27/11/2005,0,0,0,0,9,14,0,23
Iran,28/11/2005,6,0,0,0,3,1,0,10
Iran,29/11/2005,-4,0,0,0,11,1,0,8
Iran,30/11/2005,-2,0,0,0,-12,2,0,-12
Iran,01/12/2005,37,0,0,0,17,0,0,54
Iran,02/12/2005,5,0,0,0,-2,0,0,3
Iran,03/12/2005,5,0,0,0,0,0,0,5
Iran,04/12/2005,10,0,0,0,6,0,0,16
Iran,05/12/2005,31,0,0,0,6,0,0,37
Iran,06/12/2005,-1,0,0,0,-2,3,0,0
Iran,07/12/2005,7,0,2,0,0,0,0,9
Iran,08/12/2005,21,0,0,0,0,0,0,21
Iran,09/12/2005,15,0,0,0,0,0,0,15
Iran,10/12/2005,21,0,0,0,0,0,0,21
Iran,11/12/2005,21,0,0,0,18,1,0,40
Iran,12/12/2005,29,0,0,0,12,0,0,41
Iran,13/12/2005,6,0,0,0,1,0,0,7
Iran,14/12/2005,4,0,0,0,7,2,0,13
Iran,15/12/2005,23,0,0,0,1,2,0,26
Iran,16/12/2005,12,0,0,0,12,4,0,28
Iran,17/12/2005,31,0,0,0,1,0,0,32
Iran,18/12/2005,10,0,0,0,1,0,0,11
Iran,19/12/2005,13,0,0,0,3,2,0,18
Iran,20/12/2005,9,0,0,0,0,2,0,11
Iran,21/12/2005,34,0,0,0,11,4,0,49
Iran,22/12/2005,3,0,0,0,1,0,0,4
Iran,23/12/2005,5,0,0,0,12,2,0,19
Iran,24/12/2005,7,0,0,0,11,0,0,18
Iran,25/12/2005,6,0,0,0,9,2,0,17
Iran,26/12/2005,3,0,0,0,0,0,0,3
Iran,27/12/2005,11,0,0,0,18,1,0,30
Iran,28/12/2005,9,0,0,0,5,0,0,14
Iran,29/12/2005,3,0,0,0,-2,9,0,10
Iran,30/12/2005,2,0,0,0,0,0,0,2
Iran,31/12/2005,8,0,0,0,3,2,0,13
Iraq,01/01/2005,17,0,1,0,46,3,0,67
Iraq,02/01/2005,77,0,-3,0,7,9,0,90
Iraq,03/01/2005,29,0,0,0,10,8,0,47
Iraq,04/01/2005,26,6,0,0,13,9,0,54
Iraq,05/01/2005,68,6,3,0,27,12,0,116
Iraq,06/01/2005,22,2,2,0,42,22,0,90
Iraq,07/01/2005,21,0,0,0,9,11,0,41
Iraq,08/01/2005,36,0,3,0,45,10,0,94
Iraq,09/01/2005,33,0,1,0,22,1,0,57
Iraq,10/01/2005,26,0,1,0,21,4,0,52
Iraq,11/01/2005,75,0,0,0,2,13,0,90
Iraq,12/01/2005,93,4,0,0,31,6,0,134
Iraq,13/01/2005,58,0,0,0,30,11,0,99
Iraq,14/01/2005,20,0,0,0,6,7,0,33
Iraq,15/01/2005,54,0,0,0,16,3,0,73
Iraq,16/01/2005,28,0,0,0,16,13,0,57
Iraq,17/01/2005,70,0,0,0,28,16,0,114
Iraq,18/01/2005,96,2,-1,0,15,11,0,123
Iraq,19/01/2005,70,0,-1,0,32,8,0,109
Iraq,20/01/2005,113,0,2,0,10,19,0,144
Iraq,21/01/2005,32,0,-2,0,44,5,0,79
Iraq,22/01/2005,20,0,-1,0,11,4,0,34
Iraq,23/01/2005,60,2,-2,0,40,9,0,109
Iraq,24/01/2005,89,0,0,0,70,6,0,165
Iraq,25/01/2005,70,2,0,0,10,11,0,93
Iraq,26/01/2005,103,0,-1,0,30,9,0,141
Iraq,27/01/2005,88,0,-6,0,23,17,0,122
Iraq,28/01/2005,91,0,-4,0,14,89,0,190
Iraq,29/01/2005,59,0,0,0,16,26,0,101
Iraq,30/01/2005,123,0,3,0,15,47,0,188
Iraq,31/01/2005,148,8,1,0,-5,22,0,174
Iraq,01/02/2005,87,2,3,0,20,14,0,126
Iraq,02/02/2005,36,0,0,0,25,9,0,70
Iraq,03/02/2005,99,2,0,0,16,12,0,129
Iraq,04/02/2005,24,0,-2,0,20,2,0,44
Iraq,05/02/2005,52,10,-1,0,43,11,0,115
Iraq,06/02/2005,33,2,0,0,-9,3,0,29
Iraq,07/02/2005,58,2,-2,0,5,16,0,79
Iraq,08/02/2005,37,0,-1,0,7,6,0,49
Iraq,09/02/2005,72,2,2,0,14,8,0,98
Iraq,10/02/2005,24,0,-1,0,18,5,0,46
Iraq,11/02/2005,32,0,1,0,1,9,0,43
Iraq,12/02/2005,24,0,0,0,1,3,0,28
Iraq,13/02/2005,80,0,-1,0,35,11,0,125
Iraq,14/02/2005,47,0,3,0,11,16,0,77
Iraq,15/02/2005,38,2,-2,0,7,10,0,55
Iraq,16/02/2005,55,2,2,0,9,6,0,74
Iraq,17/02/2005,23,0,-2,0,20,12,0,53
Iraq,18/02/2005,58,0,0,0,22,0,0,80
Iraq,19/02/2005,52,0,1,0,6,7,0,66
Iraq,20/02/2005,22,0,-2,0,14,1,0,35
Iraq,21/02/2005,43,2,1,0,25,4,0,75
Iraq,22/02/2005,50,0,3,0,16,8,0,77
Iraq,23/02/2005,99,0,-2,0,45,10,0,152
Iraq,24/02/2005,44,0,0,0,35,7,0,86
Iraq,25/02/2005,53,0,1,0,57,3,0,114
Iraq,26/02/2005,37,0,0,0,1,11,0,49
Iraq,27/02/2005,23,0,-2,0,27,3,0,51
Iraq,28/02/2005,54,0,3,0,-3,8,0,62
Iraq,01/03/2005,19,4,4,0,12,10,0,49
Iraq,02/03/2005,48,0,0,0,-10,11,0,49
Iraq,03/03/2005,62,2,-1,0,-2,3,0,64
Iraq,04/03/2005,13,0,1,0,10,2,0,26
Iraq,05/03/2005,12,0,0,0,13,1,0,26
Iraq,06/03/2005,13,0,0,0,9,0,0,22
Iraq,07/03/2005,35,6,1,0,17,-2,0,57
Iraq,08/03/2005,87,0,1,0,0,5,0,93
Iraq,09/03/2005,59,0,0,0,20,0,0,79
Iraq,10/03/2005,58,0,0,0,14,9,0,81
Iraq,11/03/2005,40,0,2,0,11,0,0,53
Iraq,12/03/2005,2,0,0,0,11,6,0,19
Iraq,13/03/2005,81,0,0,0,12,6,0,99
Iraq,14/03/2005,48,0,1,0,30,0,0,79
Iraq,15/03/2005,32,0,0,0,9,3,0,44
Iraq,16/03/2005,49,2,2,0,22,10,0,85
Iraq,17/03/2005,56,0,0,0,22,14,0,92
Iraq,18/03/2005,30,0,0,0,32,4,0,66
Iraq,19/03/2005,23,0,0,0,-4,12,0,31
Iraq,20/03/2005,58,2,0,0,27,31,0,118
Iraq,21/03/2005,50,0,0,0,25,7,0,82
Iraq,22/03/2005,14,0,3,0,18,2,0,37
Iraq,23/03/2005,39,0,0,0,10,6,0,55
Iraq,24/03/2005,42,0,0,0,1,8,0,51
Iraq,25/03/2005,14,0,2,0,-2,3,0,17
Iraq,26/03/2005,24,0,0,0,-4,5,0,25
Iraq,27/03/2005,15,0,0,0,23,5,0,43
Iraq,28/03/2005,44,0,0,0,28,1,0,73
Iraq,29/03/2005,56,0,1,0,29,7,0,93
Iraq,30/03/2005,25,0,0,0,36,2,0,63
Iraq,31/03/2005,19,0,-8,0,25,4,0,40
Iraq,01/04/2005,23,0,-6,0,25,4,0,46
Iraq,02/04/2005,18,0,0,0,-2,4,0,20
Iraq,03/04/2005,23,0,0,0,0,0,0,23
Iraq,04/04/2005,47,0,0,0,23,5,0,75
Iraq,05/04/2005,21,0,-3,0,16,3,0,37
Iraq,06/04/2005,57,0,1,0,5,3,0,66
Iraq,07/04/2005,10,0,0,0,9,4,0,23
Iraq,08/04/2005,5,0,-1,0,6,8,0,18
Iraq,09/04/2005,6,0,0,0,3,0,0,9
Iraq,10/04/2005,9,0,-8,0,2,1,0,4
Iraq,11/04/2005,25,0,0,0,23,1,0,49
Iraq,12/04/2005,26,0,0,0,63,12,0,101
Iraq,13/04/2005,55,0,2,0,23,2,0,82
Iraq,14/04/2005,34,0,0,0,9,1,0,44
Iraq,15/04/2005,30,0,0,0,-2,1,0,29
Iraq,16/04/2005,6,0,0,0,0,2,0,8
Iraq,17/04/2005,-2,0,0,0,0,0,0,-2
Iraq,18/04/2005,18,0,0,0,8,6,0,32
Iraq,19/04/2005,39,2,0,0,4,5,0,50
Iraq,20/04/2005,22,0,1,0,12,5,0,40
Iraq,21/04/2005,67,0,-4,0,28,2,0,93
Iraq,22/04/2005,51,0,0,0,3,4,0,58
Iraq,23/04/2005,23,0,2,0,8,10,0,43
Iraq,24/04/2005,11,0,0,0,6,1,0,18
Iraq,25/04/2005,35,0,0,0,17,0,0,52
Iraq,26/04/2005,48,0,0,0,-2,7,0,53
Iraq,27/04/2005,19,0,0,0,51,10,0,80
Iraq,28/04/2005,49,0,-1,0,60,3,0,111
Iraq,29/04/2005,79,2,2,0,8,3,0,94
Iraq,30/04/2005,62,0,1,0,6,2,0,71
Iraq,01/05/2005,19,0,3,0,34,1,0,57
Iraq,02/05/2005,59,0,0,0,38,5,0,102
Iraq,03/05/2005,65,0,0,0,5,1,0,71
Iraq,04/05/2005,49,0,-4,0,35,0,0,80
Iraq,05/05/2005,39,0,-3,0,30,15,0,81
Iraq,06/05/2005,40,0,-2,0,25,20,0,83
Iraq,07/05/2005,9,0,-1,0,-1,11,0,18
Iraq,08/05/2005,49,0,-4,0,30,4,0,79
Iraq,09/05/2005,26,0,1,0,18,4,0,49
Iraq,10/05/2005,44,6,0,0,21,9,0,80
Iraq,11/05/2005,43,0,-2,0,24,3,0,68
Iraq,12/05/2005,37,0,-4,0,26,2,0,61
Iraq,13/05/2005,25,0,0,0,19,4,0,48
Iraq,14/05/2005,53,0,0,0,10,9,0,72
Iraq,15/05/2005,20,2,0,0,3,6,0,31
Iraq,16/05/2005,40,0,1,0,23,6,0,70
Iraq,17/05/2005,31,0,0,0,34,4,0,69
Iraq,18/05/2005,45,2,0,0,52,2,0,101
Iraq,19/05/2005,32,0,1,0,27,8,0,68
Iraq,20/05/2005,76,2,0,0,33,8,0,119
Iraq,21/05/2005,4,0,0,0,26,4,0,34
Iraq,22/05/2005,22,0,0,0,22,4,0,48
Iraq,23/05/2005,30,0,0,0,19,10,0,59
Iraq,24/05/2005,34,2,0,0,20,2,0,58
Iraq,25/05/2005,47,0,1,0,21,5,0,74
Iraq,26/05/2005,36,2,0,0,3,0,0,41
Iraq,27/05/2005,22,0,0,0,15,6,0,43
Iraq,28/05/2005,48,0,0,0,9,27,0,84
Iraq,29/05/2005,36,0,0,0,21,8,0,65
Iraq,30/05/2005,16,0,0,0,28,0,0,44
Iraq,31/05/2005,52,0,0,0,16,3,0,71
Iraq,01/06/2005,50,0,0,0,28,16,0,94
Iraq,02/06/2005,28,0,0,0,3,11,0,42
Iraq,03/06/2005,11,0,0,0,11,0,0,22
Iraq,04/06/2005,20,0,0,0,9,8,0,37
Iraq,05/06/2005,14,0,0,0,24,0,0,38
Iraq,06/06/2005,34,0,-4,0,13,1,0,44
Iraq,07/06/2005,33,0,0,0,27,4,0,64
Iraq,08/06/2005,59,0,0,0,15,2,0,76
Iraq,09/06/2005,25,0,0,0,12,4,0,41
Iraq,10/06/2005,26,0,0,0,19,8,0,53
Iraq,11/06/2005,25,0,0,0,19,2,0,46
Iraq,12/06/2005,27,0,0,0,10,3,0,40
Iraq,13/06/2005,44,0,0,0,-6,0,0,38
Iraq,14/06/2005,19,4,0,0,10,2,0,35
Iraq,15/06/2005,72,0,0,0,-6,5,0,71
Iraq,16/06/2005,68,0,0,0,36,8,0,112
Iraq,17/06/2005,27,0,0,0,16,5,0,48
Iraq,18/06/2005,44,0,-2,0,6,2,0,50
Iraq,19/06/2005,25,0,0,0,8,1,0,34
Iraq,20/06/2005,30,4,-4,0,-10,5,0,25
Iraq,21/06/2005,60,2,0,0,6,6,0,74
Iraq,22/06/2005,34,2,0,0,22,4,0,62
Iraq,23/06/2005,65,2,0,0,11,13,0,91
Iraq,24/06/2005,37,0,0,0,-4,10,0,43
Iraq,25/06/2005,23,0,1,0,3,3,0,30
Iraq,26/06/2005,21,0,0,0,2,11,0,34
Iraq,27/06/2005,26,0,0,0,0,7,0,33
Iraq,28/06/2005,47,0,0,0,11,6,0,64
Iraq,29/06/2005,72,2,0,0,16,9,0,99
Iraq,30/06/2005,28,0,0,0,7,5,0,40
Iraq,01/07/2005,40,0,1,0,8,0,0,49
Iraq,02/07/2005,18,0,2,0,-2,0,0,18
Iraq,03/07/2005,30,0,0,0,-3,14,0,41
Iraq,04/07/2005,43,0,0,0,27,11,0,81
Iraq,05/07/2005,41,0,2,0,16,1,0,60
Iraq,06/07/2005,59,0,2,0,40,11,0,112
Iraq,07/07/2005,85,2,-3,0,20,3,0,107
Iraq,08/07/2005,55,0,1,0,-2,2,0,56
Iraq,09/07/2005,16,0,1,0,15,5,0,37
Iraq,10/07/2005,30,0,0,0,0,9,0,39
Iraq,11/07/2005,74,0,0,0,6,4,0,84
Iraq,12/07/2005,37,0,1,0,40,5,0,83
Iraq,13/07/2005,42,0,-4,0,37,3,0,78
Iraq,14/07/2005,52,2,1,0,0,13,0,68
Iraq,15/07/2005,20,2,0,0,3,5,0,30
Iraq,16/07/2005,11,0,2,0,0,1,0,14
Iraq,17/07/2005,44,0,0,0,6,2,0,52
Iraq,18/07/2005,96,2,0,0,12,2,0,112
Iraq,19/07/2005,95,0,0,0,13,12,0,120
Iraq,20/07/2005,35,0,0,0,-7,3,0,31
Iraq,21/07/2005,15,0,0,0,8,6,0,29
Iraq,22/07/2005,37,0,1,0,3,6,0,47
Iraq,23/07/2005,19,0,-2,0,9,5,0,31
Iraq,24/07/2005,11,0,0,0,0,6,0,17
Iraq,25/07/2005,66,0,0,0,24,5,0,95
Iraq,26/07/2005,44,0,0,0,30,6,0,80
Iraq,27/07/2005,22,0,1,0,20,12,0,55
Iraq,28/07/2005,15,0,0,0,2,16,0,33
Iraq,29/07/2005,39,0,0,0,58,9,0,106
Iraq,30/07/2005,50,0,0,0,19,5,0,74
Iraq,31/07/2005,29,0,0,0,24,1,0,54
Iraq,01/08/2005,14,0,-1,0,24,12,0,49
Iraq,02/08/2005,19,0,2,0,17,4,0,42
Iraq,03/08/2005,53,0,0,0,35,6,0,94
Iraq,04/08/2005,43,0,0,0,9,21,0,73
Iraq,05/08/2005,31,0,0,0,10,5,0,46
Iraq,06/08/2005,15,0,-4,0,1,13,0,25
Iraq,07/08/2005,55,0,0,0,21,12,0,88
Iraq,08/08/2005,10,2,-2,0,16,2,0,28
Iraq,09/08/2005,17,0,0,0,3,0,0,20
Iraq,10/08/2005,43,0,0,0,19,1,0,63
Iraq,11/08/2005,31,0,0,0,3,7,0,41
Iraq,12/08/2005,22,0,-2,0,18,5,0,43
Iraq,13/08/2005,40,0,-3,0,3,8,0,48
Iraq,14/08/2005,39,0,0,0,-1,6,0,44
Iraq,15/08/2005,37,0,0,0,7,7,0,51
Iraq,16/08/2005,17,0,0,0,10,4,0,31
Iraq,17/08/2005,5,0,0,0,6,7,0,18
Iraq,18/08/2005,12,0,0,0,9,3,0,24
Iraq,19/08/2005,54,0,0,0,9,1,0,64
Iraq,20/08/2005,40,0,0,0,7,2,0,49
Iraq,21/08/2005,24,0,0,0,5,5,0,34
Iraq,22/08/2005,23,0,-1,0,7,11,0,40
Iraq,23/08/2005,79,0,-5,0,9,11,0,94
Iraq,24/08/2005,113,0,0,0,5,5,0,123
Iraq,25/08/2005,30,0,0,0,3,8,0,41
Iraq,26/08/2005,39,0,-3,0,4,18,0,58
Iraq,27/08/2005,17,2,0,0,-5,0,0,14
Iraq,28/08/2005,67,0,-1,0,3,15,0,84
Iraq,29/08/2005,46,0,0,0,6,3,0,55
Iraq,30/08/2005,83,0,0,0,13,11,0,107
Iraq,31/08/2005,42,0,1,0,14,2,0,59
Iraq,01/09/2005,27,0,0,0,6,4,0,37
Iraq,02/09/2005,42,0,0,0,5,20,0,67
Iraq,03/09/2005,35,4,0,0,2,6,0,47
Iraq,04/09/2005,33,0,0,0,0,2,0,35
Iraq,05/09/2005,50,0,0,0,32,4,0,86
Iraq,06/09/2005,42,0,0,0,24,6,0,72
Iraq,07/09/2005,35,4,2,0,29,8,0,78
Iraq,08/09/2005,29,0,0,0,17,2,0,48
Iraq,09/09/2005,23,0,-1,0,3,0,0,25
Iraq,10/09/2005,4,0,-4,0,6,17,0,23
Iraq,11/09/2005,29,0,0,0,21,8,0,58
Iraq,12/09/2005,46,0,-3,0,3,3,0,49
Iraq,13/09/2005,10,0,0,0,18,5,0,33
Iraq,14/09/2005,45,0,1,0,13,2,0,61
Iraq,15/09/2005,44,4,0,0,7,22,0,77
Iraq,16/09/2005,13,0,2,0,28,6,0,49
Iraq,17/09/2005,30,0,0,0,0,0,0,30
Iraq,18/09/2005,16,0,-2,0,1,9,0,24
Iraq,19/09/2005,46,2,0,0,27,10,0,85
Iraq,20/09/2005,19,0,0,0,9,19,0,47
Iraq,21/09/2005,65,0,-6,0,26,18,0,103
Iraq,22/09/2005,33,0,4,0,60,9,0,106
Iraq,23/09/2005,36,0,-1,0,26,2,0,63
Iraq,24/09/2005,9,0,0,0,5,9,0,23
Iraq,25/09/2005,39,0,0,0,0,4,0,43
Iraq,26/09/2005,15,0,0,0,-7,3,0,11
Iraq,27/09/2005,16,0,0,0,12,7,0,35
Iraq,28/09/2005,38,0,-4,0,27,14,0,75
Iraq,29/09/2005,46,0,-7,0,2,4,0,45
Iraq,30/09/2005,27,0,2,0,13,3,0,45
Iraq,01/10/2005,17,0,0,0,1,7,0,25
Iraq,02/10/2005,50,0,-1,0,-2,9,0,56
Iraq,03/10/2005,23,0,-2,0,18,7,0,46
Iraq,04/10/2005,59,0,0,0,-1,1,0,59
Iraq,05/10/2005,91,0,-6,0,6,8,0,99
Iraq,06/10/2005,29,0,-1,0,24,7,0,59
Iraq,07/10/2005,38,0,0,0,-4,4,0,38
Iraq,08/10/2005,38,0,0,0,18,1,0,57
Iraq,09/10/2005,50,0,0,0,6,5,0,61
Iraq,10/10/2005,47,0,0,0,0,3,0,50
Iraq,11/10/2005,34,0,-2,0,69,4,0,105
Iraq,12/10/2005,46,0,-1,0,2,13,0,60
Iraq,13/10/2005,70,0,-4,0,12,2,0,80
Iraq,14/10/2005,35,0,0,0,-4,2,0,33
Iraq,15/10/2005,54,0,1,0,9,10,0,74
Iraq,16/10/2005,76,0,-1,0,22,12,0,109
Iraq,17/10/2005,65,0,-2,0,34,8,0,105
Iraq,18/10/2005,43,2,0,0,12,2,0,59
Iraq,19/10/2005,32,0,0,0,24,3,0,59
Iraq,20/10/2005,45,0,0,0,29,5,0,79
Iraq,21/10/2005,8,0,-2,0,-4,5,0,7
Iraq,22/10/2005,18,0,0,0,10,1,0,29
Iraq,23/10/2005,35,0,1,0,6,5,0,47
Iraq,24/10/2005,30,0,0,0,13,8,0,51
Iraq,25/10/2005,47,0,0,0,4,6,0,57
Iraq,26/10/2005,23,0,0,0,20,15,0,58
Iraq,27/10/2005,37,2,-2,0,34,19,0,90
Iraq,28/10/2005,47,0,-10,0,59,11,0,107
Iraq,29/10/2005,28,0,-10,0,36,3,0,57
Iraq,30/10/2005,50,0,0,0,-3,8,0,55
Iraq,31/10/2005,29,0,0,0,14,6,0,49
Iraq,01/11/2005,39,2,1,0,9,4,0,55
Iraq,02/11/2005,45,0,-6,0,11,4,0,54
Iraq,03/11/2005,28,2,5,0,54,2,0,91
Iraq,04/11/2005,15,0,-1,0,26,3,0,43
Iraq,05/11/2005,18,2,-4,0,9,8,0,33
Iraq,06/11/2005,48,0,-6,0,16,4,0,62
Iraq,07/11/2005,-2,0,-5,0,4,10,0,7
Iraq,08/11/2005,14,0,0,0,36,2,0,52
Iraq,09/11/2005,39,0,0,0,33,29,0,101
Iraq,10/11/2005,101,0,-2,0,15,13,0,127
Iraq,11/11/2005,94,2,-2,0,33,29,0,156
Iraq,12/11/2005,58,0,2,0,19,4,0,83
Iraq,13/11/2005,40,2,2,0,27,8,0,79
Iraq,14/11/2005,28,2,0,0,0,9,0,39
Iraq,15/11/2005,61,0,-2,0,38,19,0,116
Iraq,16/11/2005,100,0,5,0,15,12,0,132
Iraq,17/11/2005,77,2,-2,0,21,13,0,111
Iraq,18/11/2005,48,0,-9,0,32,24,0,95
Iraq,19/11/2005,51,0,-4,0,10,7,0,64
Iraq,20/11/2005,64,0,0,0,17,13,0,94
Iraq,21/11/2005,49,0,0,0,21,4,0,74
Iraq,22/11/2005,53,0,1,0,31,6,0,91
Iraq,23/11/2005,48,0,-2,0,4,12,0,62
Iraq,24/11/2005,6,0,-3,0,9,1,0,13
Iraq,25/11/2005,19,0,-2,0,0,0,0,17
Iraq,26/11/2005,10,0,0,0,10,-1,0,19
Iraq,27/11/2005,26,2,0,0,43,9,0,80
Iraq,28/11/2005,38,6,-1,0,12,3,0,58
Iraq,29/11/2005,60,0,0,0,23,0,0,83
Iraq,30/11/2005,88,0,-6,0,17,1,0,100
Iraq,01/12/2005,35,0,0,0,17,3,0,55
Iraq,02/12/2005,50,0,0,0,16,0,0,66
Iraq,03/12/2005,13,0,0,0,-2,0,0,11
Iraq,04/12/2005,42,4,0,0,-4,10,0,52
Iraq,05/12/2005,49,4,-4,0,2,11,0,62
Iraq,06/12/2005,52,2,-17,0,20,6,0,63
Iraq,07/12/2005,44,0,-7,0,30,3,0,70
Iraq,08/12/2005,53,0,0,0,35,2,0,90
Iraq,09/12/2005,26,0,0,0,19,2,0,47
Iraq,10/12/2005,8,2,-1,0,10,4,0,23
Iraq,11/12/2005,40,0,0,0,5,4,0,49
Iraq,12/12/2005,27,0,0,0,13,25,0,65
Iraq,13/12/2005,32,0,0,0,24,23,0,79
Iraq,14/12/2005,30,0,0,0,11,18,0,59
Iraq,15/12/2005,28,0,1,0,19,12,0,60
Iraq,16/12/2005,40,0,0,0,9,16,0,65
Iraq,17/12/2005,8,0,0,0,21,6,0,35
Iraq,18/12/2005,47,0,0,0,17,4,0,68
Iraq,19/12/2005,76,2,-3,0,44,3,0,122
Iraq,20/12/2005,21,4,3,0,15,2,0,45
Iraq,21/12/2005,17,0,0,0,4,0,0,21
Iraq,22/12/2005,29,0,0,0,1,1,0,31
Iraq,23/12/2005,9,0,0,0,-1,3,0,11
Iraq,24/12/2005,21,0,-6,0,17,1,0,33
Iraq,25/12/2005,0,0,0,0,6,4,0,10
Iraq,26/12/2005,9,0,0,0,7,0,0,16
Iraq,27/12/2005,1,2,1,0,-1,0,0,3
Iraq,28/12/2005,47,0,3,0,18,6,0,74
Iraq,29/12/2005,21,0,0,0,9,6,0,36
Iraq,30/12/2005,4,0,0,0,9,6,0,19
Iraq,31/12/2005,19,0,-2,0,-1,2,0,18
Morocco,01/01/2005,3,0,0,0,12,0,0,15
Morocco,02/01/2005,0,0,0,0,0,0,0,0
Morocco,03/01/2005,4,0,0,0,0,0,0,4
Morocco,04/01/2005,0,0,0,0,6,0,0,6
Morocco,05/01/2005,0,0,0,0,3,0,0,3
Morocco,06/01/2005,6,0,0,0,0,0,0,6
Morocco,07/01/2005,1,0,0,0,-2,0,0,-1
Morocco,08/01/2005,0,0,0,0,24,0,0,24
Morocco,09/01/2005,0,0,0,0,3,0,0,3
Morocco,10/01/2005,0,0,0,0,3,0,0,3
Morocco,11/01/2005,0,0,0,0,0,0,0,0
Morocco,12/01/2005,4,0,1,0,-2,0,0,3
Morocco,14/01/2005,0,0,0,0,15,0,0,15
Morocco,15/01/2005,1,0,0,0,0,0,0,1
Morocco,16/01/2005,0,0,0,0,0,0,0,0
Morocco,17/01/2005,2,0,0,0,0,0,0,2
Morocco,18/01/2005,0,0,0,0,0,0,0,0
Morocco,19/01/2005,0,0,0,0,0,0,0,0
Morocco,20/01/2005,1,4,0,0,0,0,0,5
Morocco,22/01/2005,4,0,0,0,-4,0,0,0
Morocco,24/01/2005,2,0,0,0,0,0,0,2
Morocco,25/01/2005,-1,0,0,0,6,0,0,5
Morocco,26/01/2005,0,0,0,0,6,0,0,6
Morocco,27/01/2005,0,0,0,0,0,0,0,0
Morocco,28/01/2005,-1,0,0,0,0,0,0,-1
Morocco,29/01/2005,-3,0,0,0,3,0,0,0
Morocco,30/01/2005,0,0,0,0,0,0,0,0
Morocco,31/01/2005,0,4,0,0,-4,0,0,0
Morocco,01/02/2005,0,0,0,0,6,0,0,6
Morocco,02/02/2005,2,0,0,0,14,0,0,16
Morocco,03/02/2005,0,0,0,0,0,0,0,0
Morocco,04/02/2005,4,0,0,0,16,0,0,20
Morocco,05/02/2005,0,0,0,0,3,0,0,3
Morocco,06/02/2005,-1,0,0,0,0,0,0,-1
Morocco,07/02/2005,0,0,0,0,0,0,0,0
Morocco,08/02/2005,6,0,0,0,0,0,0,6
Morocco,09/02/2005,-1,0,0,0,6,0,0,5
Morocco,10/02/2005,0,0,0,0,0,0,0,0
Morocco,11/02/2005,0,0,0,0,0,0,0,0
Morocco,12/02/2005,3,0,0,0,0,0,0,3
Morocco,14/02/2005,9,0,0,0,3,0,0,12
Morocco,15/02/2005,1,0,0,0,7,0,0,8
Morocco,16/02/2005,1,0,0,0,3,0,0,4
Morocco,17/02/2005,3,0,0,0,0,0,0,3
Morocco,18/02/2005,6,0,0,0,0,0,0,6
Morocco,20/02/2005,0,0,0,0,0,0,0,0
Morocco,21/02/2005,0,0,0,0,0,0,0,0
Morocco,22/02/2005,0,0,0,0,12,0,0,12
Morocco,23/02/2005,0,0,0,0,0,0,0,0
Morocco,24/02/2005,2,0,0,0,0,0,0,2
Morocco,25/02/2005,4,0,0,0,3,4,0,11
Morocco,26/02/2005,0,0,0,0,-2,0,0,-2
Morocco,28/02/2005,2,0,0,0,6,0,0,8
Morocco,01/03/2005,0,0,0,0,0,0,0,0
Morocco,02/03/2005,0,0,0,0,0,0,0,0
Morocco,04/03/2005,3,0,0,0,0,0,0,3
Morocco,05/03/2005,3,0,0,0,3,0,0,6
Morocco,06/03/2005,0,0,0,0,6,3,0,9
Morocco,07/03/2005,0,0,0,0,0,0,0,0
Morocco,08/03/2005,0,0,0,0,6,0,0,6
Morocco,09/03/2005,1,0,0,0,0,0,0,1
Morocco,10/03/2005,0,0,-2,0,0,0,0,-2
Morocco,11/03/2005,15,0,0,0,15,0,0,30
Morocco,12/03/2005,0,0,0,0,0,0,0,0
Morocco,13/03/2005,-2,0,0,0,0,0,0,-2
Morocco,14/03/2005,0,0,0,0,0,0,0,0
Morocco,15/03/2005,0,0,0,0,6,0,0,6
Morocco,16/03/2005,16,0,0,0,0,0,0,16
Morocco,17/03/2005,0,0,0,0,0,0,0,0
Morocco,18/03/2005,1,0,0,0,4,0,0,5
Morocco,19/03/2005,1,0,0,0,6,0,0,7
Morocco,20/03/2005,0,0,0,0,6,2,0,8
Morocco,21/03/2005,9,0,0,0,0,0,0,9
Morocco,22/03/2005,2,0,0,0,9,0,0,11
Morocco,23/03/2005,1,0,0,0,12,0,0,13
Morocco,24/03/2005,3,0,0,0,0,0,0,3
Morocco,25/03/2005,-3,0,0,0,0,0,0,-3
Morocco,27/03/2005,0,0,0,0,0,0,0,0
Morocco,28/03/2005,0,0,0,0,1,0,0,1
Morocco,29/03/2005,0,0,0,0,0,0,0,0
Morocco,30/03/2005,-1,0,0,0,3,0,0,2
Morocco,31/03/2005,2,0,0,0,9,0,0,11
Morocco,01/04/2005,5,0,0,0,11,0,0,16
Morocco,02/04/2005,-2,0,0,0,0,1,0,-1
Morocco,03/04/2005,0,0,0,0,0,0,0,0
Morocco,04/04/2005,5,0,0,0,1,1,0,7
Morocco,05/04/2005,11,0,0,0,3,0,0,14
Morocco,06/04/2005,26,0,0,0,12,0,0,38
Morocco,07/04/2005,14,0,0,0,0,0,0,14
Morocco,08/04/2005,6,0,0,0,0,0,0,6
Morocco,09/04/2005,1,0,0,0,-4,0,0,-3
Morocco,10/04/2005,0,0,0,0,0,0,0,0
Morocco,11/04/2005,0,0,0,0,0,0,0,0
Morocco,12/04/2005,0,0,0,0,12,0,0,12
Morocco,13/04/2005,6,0,0,0,6,0,0,12
Morocco,14/04/2005,-1,0,0,0,25,0,0,24
Morocco,15/04/2005,-2,0,0,0,13,0,0,11
Morocco,18/04/2005,1,0,0,0,4,2,0,7
Morocco,19/04/2005,0,0,0,0,0,0,0,0
Morocco,20/04/2005,0,0,0,0,0,0,0,0
Morocco,21/04/2005,0,0,0,0,0,0,0,0
Morocco,22/04/2005,-3,0,0,0,4,0,0,1
Morocco,23/04/2005,0,0,0,0,3,0,0,3
Morocco,24/04/2005,0,0,0,0,0,0,0,0
Morocco,25/04/2005,2,0,0,0,6,0,0,8
Morocco,26/04/2005,0,0,0,0,0,0,0,0
Morocco,27/04/2005,1,0,0,0,9,0,0,10
Morocco,28/04/2005,9,0,0,0,0,2,0,11
Morocco,29/04/2005,-3,0,0,0,0,1,0,-2
Morocco,30/04/2005,0,0,0,0,0,0,0,0
Morocco,01/05/2005,-3,0,0,0,0,0,0,-3
Morocco,02/05/2005,0,0,0,0,0,1,0,1
Morocco,04/05/2005,0,0,0,0,0,0,0,0
Morocco,05/05/2005,4,0,0,0,3,0,0,7
Morocco,06/05/2005,0,0,0,0,0,0,0,0
Morocco,09/05/2005,0,0,0,0,0,0,0,0
Morocco,10/05/2005,2,0,0,0,0,0,0,2
Morocco,11/05/2005,0,0,0,0,0,0,0,0
Morocco,12/05/2005,-1,0,0,0,12,0,0,11
Morocco,13/05/2005,9,0,0,0,9,0,0,18
Morocco,14/05/2005,0,0,0,0,0,0,0,0
Morocco,16/05/2005,2,0,0,0,0,0,0,2
Morocco,17/05/2005,2,0,0,0,-2,0,0,0
Morocco,18/05/2005,2,0,0,0,0,0,0,2
Morocco,19/05/2005,6,0,0,0,0,0,0,6
Morocco,20/05/2005,-4,0,0,0,0,0,0,-4
Morocco,22/05/2005,0,0,0,0,0,0,0,0
Morocco,23/05/2005,4,0,0,0,7,0,0,11
Morocco,24/05/2005,16,0,0,0,8,0,0,24
Morocco,25/05/2005,1,0,0,0,0,0,0,1
Morocco,26/05/2005,15,0,0,0,10,6,0,31
Morocco,27/05/2005,0,0,0,0,0,0,0,0
Morocco,28/05/2005,0,0,0,0,0,0,0,0
Morocco,29/05/2005,-5,0,0,0,3,0,0,-2
Morocco,30/05/2005,3,0,0,0,3,1,0,7
Morocco,31/05/2005,6,0,0,0,3,0,0,9
Morocco,01/06/2005,19,0,0,0,5,1,0,25
Morocco,02/06/2005,1,0,0,0,0,0,0,1
Morocco,05/06/2005,8,0,0,0,0,0,0,8
Morocco,06/06/2005,0,0,0,0,3,0,0,3
Morocco,07/06/2005,0,0,0,0,0,0,0,0
Morocco,08/06/2005,0,0,1,0,0,0,0,1
Morocco,09/06/2005,26,0,1,0,26,0,0,53
Morocco,10/06/2005,0,0,0,0,6,0,0,6
Morocco,11/06/2005,0,0,0,0,6,0,0,6
Morocco,12/06/2005,5,0,0,0,3,0,0,8
Morocco,14/06/2005,0,0,0,0,9,0,0,9
Morocco,15/06/2005,2,0,0,0,2,0,0,4
Morocco,16/06/2005,6,0,0,0,3,0,0,9
Morocco,17/06/2005,6,0,0,0,3,0,0,9
Morocco,18/06/2005,15,0,0,0,9,0,0,24
Morocco,19/06/2005,0,0,0,0,0,2,0,2
Morocco,20/06/2005,0,0,0,0,0,0,0,0
Morocco,21/06/2005,9,0,1,0,12,0,0,22
Morocco,22/06/2005,-2,0,0,0,6,0,0,4
Morocco,23/06/2005,0,0,0,0,0,0,0,0
Morocco,24/06/2005,-2,0,0,0,9,0,0,7
Morocco,25/06/2005,0,0,0,0,-4,0,0,-4
Morocco,26/06/2005,0,0,0,0,9,0,0,9
Morocco,27/06/2005,8,0,0,0,18,0,0,26
Morocco,28/06/2005,4,0,1,0,15,0,0,20
Morocco,29/06/2005,0,0,0,0,0,0,0,0
Morocco,30/06/2005,1,0,0,0,12,0,0,13
Morocco,01/07/2005,7,0,-1,0,0,0,0,6
Morocco,02/07/2005,-1,0,0,0,0,0,0,-1
Morocco,03/07/2005,10,0,0,0,9,2,0,21
Morocco,04/07/2005,6,0,0,0,0,0,0,6
Morocco,05/07/2005,0,0,0,0,6,0,0,6
Morocco,06/07/2005,-3,0,0,0,0,0,0,-3
Morocco,07/07/2005,3,0,0,0,0,0,0,3
Morocco,08/07/2005,3,0,0,0,3,0,0,6
Morocco,09/07/2005,0,0,0,0,0,0,0,0
Morocco,10/07/2005,1,0,0,0,0,0,0,1
Morocco,11/07/2005,1,0,0,0,0,0,0,1
Morocco,12/07/2005,9,0,0,0,9,0,0,18
Morocco,13/07/2005,3,0,0,0,0,0,0,3
Morocco,14/07/2005,0,0,0,0,0,0,0,0
Morocco,15/07/2005,4,0,0,0,-6,0,0,-2
Morocco,16/07/2005,0,0,0,0,3,0,0,3
Morocco,17/07/2005,0,0,0,0,0,0,0,0
Morocco,18/07/2005,1,0,0,0,8,0,0,9
Morocco,19/07/2005,2,0,0,0,1,0,0,3
Morocco,20/07/2005,1,0,0,0,6,1,0,8
Morocco,21/07/2005,2,0,0,0,3,0,0,5
Morocco,22/07/2005,-3,0,0,0,3,0,0,0
Morocco,23/07/2005,0,0,0,0,3,0,0,3
Morocco,24/07/2005,6,0,0,0,0,0,0,6
Morocco,25/07/2005,15,0,0,0,0,1,0,16
Morocco,26/07/2005,3,0,0,0,-2,0,0,1
Morocco,27/07/2005,14,0,0,0,0,0,0,14
Morocco,28/07/2005,20,0,0,0,-2,0,0,18
Morocco,29/07/2005,0,0,0,0,-4,0,0,-4
Morocco,30/07/2005,4,0,0,0,0,0,0,4
Morocco,31/07/2005,0,0,0,0,0,0,0,0
Morocco,01/08/2005,0,0,0,0,0,0,0,0
Morocco,02/08/2005,0,0,0,0,24,1,0,25
Morocco,03/08/2005,2,0,0,0,0,2,0,4
Morocco,05/08/2005,0,0,0,0,0,0,0,0
Morocco,06/08/2005,0,0,0,0,0,0,0,0
Morocco,07/08/2005,0,0,0,0,0,0,0,0
Morocco,08/08/2005,-2,0,0,0,3,0,0,1
Morocco,09/08/2005,1,0,0,0,6,3,0,10
Morocco,10/08/2005,9,0,-1,0,0,5,0,13
Morocco,11/08/2005,3,0,0,0,0,0,0,3
Morocco,12/08/2005,-1,0,0,0,3,3,0,5
Morocco,14/08/2005,0,0,0,0,0,0,0,0
Morocco,15/08/2005,0,0,0,0,0,0,0,0
Morocco,17/08/2005,3,0,0,0,25,0,0,28
Morocco,18/08/2005,26,0,0,0,3,0,0,29
Morocco,19/08/2005,21,0,0,0,44,0,0,65
Morocco,20/08/2005,9,0,0,0,9,0,0,18
Morocco,21/08/2005,0,0,0,0,0,2,0,2
Morocco,22/08/2005,-13,0,0,0,0,0,0,-13
Morocco,23/08/2005,13,0,0,0,3,0,0,16
Morocco,24/08/2005,0,0,0,0,0,0,0,0
Morocco,25/08/2005,0,0,0,0,15,0,0,15
Morocco,26/08/2005,1,2,-2,0,1,2,0,4
Morocco,27/08/2005,1,0,0,0,7,2,0,10
Morocco,28/08/2005,3,0,0,0,6,0,0,9
Morocco,29/08/2005,4,0,0,0,12,0,0,16
Morocco,30/08/2005,0,0,0,0,0,0,0,0
Morocco,31/08/2005,1,0,0,0,6,0,0,7
Morocco,01/09/2005,2,0,0,0,0,0,0,2
Morocco,02/09/2005,3,0,0,0,3,0,0,6
Morocco,03/09/2005,2,0,0,0,0,0,0,2
Morocco,04/09/2005,1,0,0,0,0,0,0,1
Morocco,05/09/2005,0,0,0,0,0,0,0,0
Morocco,06/09/2005,4,0,0,0,3,2,0,9
Morocco,07/09/2005,0,0,0,0,3,0,0,3
Morocco,08/09/2005,2,0,0,0,15,1,0,18
Morocco,09/09/2005,1,0,2,0,-6,2,0,-1
Morocco,10/09/2005,0,0,0,0,0,0,0,0
Morocco,11/09/2005,0,0,0,0,19,1,0,20
Morocco,12/09/2005,2,0,0,0,0,0,0,2
Morocco,13/09/2005,4,0,0,0,0,0,0,4
Morocco,14/09/2005,0,0,0,0,0,0,0,0
Morocco,15/09/2005,6,0,0,0,0,0,0,6
Morocco,16/09/2005,8,0,0,0,4,0,0,12
Morocco,18/09/2005,0,0,0,0,0,1,0,1
Morocco,19/09/2005,2,0,0,0,0,0,0,2
Morocco,21/09/2005,0,0,0,0,0,0,0,0
Morocco,22/09/2005,2,0,0,0,6,0,0,8
Morocco,23/09/2005,19,0,0,0,3,0,0,22
Morocco,24/09/2005,0,0,0,0,0,0,0,0
Morocco,25/09/2005,0,0,0,0,1,0,0,1
Morocco,26/09/2005,15,0,0,0,12,0,0,27
Morocco,27/09/2005,2,0,0,0,9,0,0,11
Morocco,28/09/2005,12,0,2,0,0,0,0,14
Morocco,29/09/2005,14,0,0,0,0,2,0,16
Morocco,30/09/2005,19,0,0,0,0,2,0,21
Morocco,01/10/2005,0,0,0,0,0,0,0,0
Morocco,02/10/2005,0,0,0,0,0,1,0,1
Morocco,03/10/2005,3,0,0,0,6,0,0,9
Morocco,04/10/2005,0,0,0,0,-2,6,0,4
Morocco,05/10/2005,5,0,0,0,15,2,0,22
Morocco,06/10/2005,-1,0,0,0,6,4,0,9
Morocco,07/10/2005,10,0,0,0,21,0,0,31
Morocco,08/10/2005,0,0,0,0,3,0,0,3
Morocco,09/10/2005,7,0,0,0,0,0,0,7
Morocco,10/10/2005,6,0,0,0,3,0,0,9
Morocco,11/10/2005,1,0,0,0,15,0,0,16
Morocco,12/10/2005,5,0,0,0,9,0,0,14
Morocco,13/10/2005,3,0,0,0,12,0,0,15
Morocco,14/10/2005,10,0,0,0,0,0,0,10
Morocco,15/10/2005,0,0,0,0,0,3,0,3
Morocco,17/10/2005,0,0,0,0,0,0,0,0
Morocco,18/10/2005,0,0,0,0,3,0,0,3
Morocco,19/10/2005,4,0,0,0,12,0,0,16
Morocco,20/10/2005,0,0,0,0,0,0,0,0
Morocco,21/10/2005,1,0,0,0,3,1,0,5
Morocco,22/10/2005,0,0,0,0,9,0,0,9
Morocco,23/10/2005,2,0,0,0,0,0,0,2
Morocco,24/10/2005,4,0,0,0,0,0,0,4
Morocco,26/10/2005,26,0,0,0,12,0,0,38
Morocco,27/10/2005,18,0,0,0,12,0,0,30
Morocco,28/10/2005,7,0,0,0,-1,0,0,6
Morocco,29/10/2005,4,0,0,0,9,0,0,13
Morocco,30/10/2005,4,0,0,0,0,0,0,4
Morocco,31/10/2005,6,0,0,0,-1,0,0,5
Morocco,01/11/2005,5,0,0,0,7,1,0,13
Morocco,02/11/2005,9,0,0,0,4,0,0,13
Morocco,03/11/2005,3,0,0,0,11,2,0,16
Morocco,04/11/2005,1,0,0,0,9,2,0,12
Morocco,05/11/2005,2,0,0,0,8,4,0,14
Morocco,06/11/2005,4,0,0,0,2,0,0,6
Morocco,07/11/2005,14,0,0,0,3,1,0,18
Morocco,08/11/2005,0,0,0,0,0,0,0,0
Morocco,09/11/2005,18,0,0,0,0,0,0,18
Morocco,10/11/2005,0,0,0,0,0,0,0,0
Morocco,11/11/2005,5,0,0,0,6,0,0,11
Morocco,12/11/2005,7,0,0,0,15,6,0,28
Morocco,13/11/2005,0,0,0,0,0,0,0,0
Morocco,14/11/2005,-1,0,0,0,0,2,0,1
Morocco,15/11/2005,0,0,0,0,3,0,0,3
Morocco,16/11/2005,-1,0,1,0,-3,1,0,-2
Morocco,17/11/2005,5,0,0,0,7,0,0,12
Morocco,18/11/2005,0,0,0,0,0,0,0,0
Morocco,19/11/2005,4,0,0,0,3,0,0,7
Morocco,20/11/2005,0,0,0,0,0,0,0,0
Morocco,21/11/2005,-7,0,0,0,3,0,0,-4
Morocco,22/11/2005,0,0,0,0,12,0,0,12
Morocco,23/11/2005,6,0,0,0,3,0,0,9
Morocco,24/11/2005,0,0,0,0,0,0,0,0
Morocco,25/11/2005,4,0,0,0,6,0,0,10
Morocco,26/11/2005,3,0,0,0,0,0,0,3
Morocco,27/11/2005,4,0,0,0,0,0,0,4
Morocco,28/11/2005,6,0,0,0,6,2,0,14
Morocco,29/11/2005,1,0,0,0,7,2,0,10
Morocco,30/11/2005,14,0,0,0,9,0,0,23
Morocco,01/12/2005,18,0,0,0,3,0,0,21
Morocco,02/12/2005,0,0,0,0,0,0,0,0
Morocco,03/12/2005,0,0,0,0,0,2,0,2
Morocco,04/12/2005,0,0,0,0,0,0,0,0
Morocco,05/12/2005,12,0,0,0,3,0,0,15
Morocco,06/12/2005,1,0,0,0,0,0,0,1
Morocco,07/12/2005,15,0,0,0,9,0,0,24
Morocco,08/12/2005,3,0,0,0,0,0,0,3
Morocco,09/12/2005,0,0,0,0,3,0,0,3
Morocco,10/12/2005,0,0,0,0,0,0,0,0
Morocco,11/12/2005,-2,0,0,0,0,0,0,-2
Morocco,12/12/2005,0,0,0,0,6,0,0,6
Morocco,13/12/2005,5,0,0,0,6,0,0,11
Morocco,14/12/2005,4,0,0,0,6,0,0,10
Morocco,15/12/2005,13,0,0,0,-2,0,0,11
Morocco,16/12/2005,1,0,0,0,9,0,0,10
Morocco,17/12/2005,0,0,0,0,0,0,0,0
Morocco,18/12/2005,6,0,0,0,2,0,0,8
Morocco,19/12/2005,0,0,0,0,10,0,0,10
Morocco,20/12/2005,0,0,0,0,0,0,0,0
Morocco,21/12/2005,0,0,0,0,0,0,0,0
Morocco,22/12/2005,0,0,0,0,3,0,0,3
Morocco,25/12/2005,0,0,0,0,0,0,0,0
Morocco,26/12/2005,0,0,0,0,4,0,0,4
Morocco,28/12/2005,0,0,0,0,0,0,0,0
Morocco,29/12/2005,0,0,0,0,3,0,0,3
Morocco,30/12/2005,3,0,0,0,0,0,0,3
Morocco,31/12/2005,9,0,0,0,0,0,0,9
Nigeria,01/01/2005,5,0,0,0,0,0,0,5
Nigeria,02/01/2005,8,0,1,0,-2,4,0,11
Nigeria,03/01/2005,11,2,-1,0,3,0,0,15
Nigeria,04/01/2005,14,0,0,0,0,3,0,17
Nigeria,05/01/2005,1,0,0,0,0,0,0,1
Nigeria,06/01/2005,17,0,0,0,5,1,0,23
Nigeria,07/01/2005,0,0,0,0,0,2,0,2
Nigeria,08/01/2005,0,0,-1,0,9,0,0,8
Nigeria,09/01/2005,9,0,0,0,0,0,0,9
Nigeria,10/01/2005,22,0,0,0,3,10,0,35
Nigeria,11/01/2005,3,0,0,0,-3,1,0,1
Nigeria,12/01/2005,19,0,0,0,9,0,0,28
Nigeria,13/01/2005,36,0,0,0,0,5,0,41
Nigeria,14/01/2005,7,0,0,0,6,0,0,13
Nigeria,15/01/2005,8,0,0,0,0,0,0,8
Nigeria,16/01/2005,11,0,-1,0,0,0,0,10
Nigeria,17/01/2005,23,0,0,0,3,3,0,29
Nigeria,18/01/2005,18,0,0,0,-2,2,0,18
Nigeria,19/01/2005,18,0,0,0,13,0,0,31
Nigeria,20/01/2005,6,0,0,0,0,0,0,6
Nigeria,21/01/2005,5,0,0,0,8,1,0,14
Nigeria,22/01/2005,5,0,0,0,3,1,0,9
Nigeria,23/01/2005,12,0,1,0,0,2,0,15
Nigeria,24/01/2005,12,0,0,0,4,2,0,18
Nigeria,25/01/2005,17,0,0,0,0,1,0,18
Nigeria,26/01/2005,15,0,0,0,3,0,0,18
Nigeria,27/01/2005,14,0,0,0,8,1,0,23
Nigeria,28/01/2005,15,0,0,0,0,1,0,16
Nigeria,29/01/2005,4,0,0,0,0,0,0,4
Nigeria,30/01/2005,13,0,0,0,9,3,0,25
Nigeria,31/01/2005,18,0,0,0,-2,4,0,20
Nigeria,01/02/2005,6,0,0,0,0,2,0,8
Nigeria,02/02/2005,6,0,1,0,-2,0,0,5
Nigeria,03/02/2005,7,0,-2,0,2,2,0,9
Nigeria,04/02/2005,11,0,0,0,0,2,0,13
Nigeria,05/02/2005,6,0,0,0,0,2,0,8
Nigeria,06/02/2005,22,0,2,0,-2,0,0,22
Nigeria,07/02/2005,21,0,1,0,4,1,0,27
Nigeria,08/02/2005,12,0,0,0,-2,0,0,10
Nigeria,09/02/2005,6,0,0,0,-4,0,0,2
Nigeria,10/02/2005,0,0,0,0,3,3,0,6
Nigeria,11/02/2005,9,0,-4,0,-6,3,0,2
Nigeria,12/02/2005,8,0,0,0,6,0,0,14
Nigeria,13/02/2005,4,0,0,0,3,0,0,7
Nigeria,14/02/2005,10,0,0,0,7,2,0,19
Nigeria,15/02/2005,4,0,-2,0,-2,1,0,1
Nigeria,16/02/2005,18,0,-4,0,0,27,0,41
Nigeria,17/02/2005,19,0,0,0,9,1,0,29
Nigeria,18/02/2005,8,0,0,0,0,0,0,8
Nigeria,19/02/2005,4,0,1,0,3,1,0,9
Nigeria,20/02/2005,9,0,0,0,3,1,0,13
Nigeria,21/02/2005,17,0,-2,0,0,0,0,15
Nigeria,22/02/2005,22,0,0,0,3,6,0,31
Nigeria,23/02/2005,13,0,0,0,9,1,0,23
Nigeria,24/02/2005,11,2,0,0,9,2,0,24
Nigeria,25/02/2005,1,0,0,0,6,0,0,7
Nigeria,26/02/2005,5,0,-2,0,6,0,0,9
Nigeria,27/02/2005,7,0,-2,0,0,0,0,5
Nigeria,28/02/2005,4,0,0,0,4,0,0,8
Nigeria,01/03/2005,11,0,-6,0,13,2,0,20
Nigeria,02/03/2005,7,0,0,0,9,2,0,18
Nigeria,03/03/2005,8,0,0,0,0,3,0,11
Nigeria,04/03/2005,12,0,0,0,0,0,0,12
Nigeria,05/03/2005,0,0,0,0,3,1,0,4
Nigeria,06/03/2005,11,0,2,0,6,0,0,19
Nigeria,07/03/2005,22,0,0,0,3,6,0,31
Nigeria,08/03/2005,11,0,-2,0,10,2,0,21
Nigeria,09/03/2005,15,0,0,0,0,3,0,18
Nigeria,10/03/2005,4,0,0,0,0,0,0,4
Nigeria,11/03/2005,6,0,0,0,3,0,0,9
Nigeria,12/03/2005,-1,0,0,0,3,0,0,2
Nigeria,13/03/2005,9,0,-4,0,-2,0,0,3
Nigeria,14/03/2005,6,0,0,0,0,0,0,6
Nigeria,15/03/2005,8,0,0,0,3,1,0,12
Nigeria,16/03/2005,8,0,0,0,4,1,0,13
Nigeria,17/03/2005,9,0,0,0,9,1,0,19
Nigeria,18/03/2005,0,0,-1,0,0,0,0,-1
Nigeria,19/03/2005,5,0,0,0,0,0,0,5
Nigeria,20/03/2005,0,0,0,0,9,0,0,9
Nigeria,21/03/2005,15,0,0,0,9,4,0,28
Nigeria,22/03/2005,10,0,0,0,9,5,0,24
Nigeria,23/03/2005,24,0,-4,0,18,2,0,40
Nigeria,24/03/2005,14,0,0,0,14,3,0,31
Nigeria,25/03/2005,1,0,0,0,6,0,0,7
Nigeria,26/03/2005,2,0,0,0,3,0,0,5
Nigeria,27/03/2005,7,0,0,0,3,0,0,10
Nigeria,28/03/2005,13,0,-3,0,15,1,0,26
Nigeria,29/03/2005,22,0,0,0,6,1,0,29
Nigeria,30/03/2005,4,0,-2,0,1,1,0,4
Nigeria,31/03/2005,13,0,0,0,2,3,0,18
Nigeria,01/04/2005,3,0,0,0,15,1,0,19
Nigeria,02/04/2005,8,0,0,0,4,0,0,12
Nigeria,03/04/2005,2,0,0,0,0,0,0,2
Nigeria,04/04/2005,30,0,1,0,3,1,0,35
Nigeria,05/04/2005,9,0,1,0,0,2,0,12
Nigeria,06/04/2005,1,0,0,0,4,7,0,12
Nigeria,07/04/2005,26,0,0,0,1,2,0,29
Nigeria,08/04/2005,1,2,0,0,18,1,0,22
Nigeria,09/04/2005,10,0,0,0,0,1,0,11
Nigeria,10/04/2005,6,0,0,0,3,0,0,9
Nigeria,11/04/2005,15,0,0,0,9,3,0,27
Nigeria,12/04/2005,15,6,0,0,-2,3,0,22
Nigeria,13/04/2005,1,0,0,0,6,1,0,8
Nigeria,14/04/2005,26,0,0,0,1,3,0,30
Nigeria,15/04/2005,17,0,0,0,12,4,0,33
Nigeria,16/04/2005,0,0,0,0,3,0,0,3
Nigeria,17/04/2005,-1,0,0,0,3,0,0,2
Nigeria,18/04/2005,17,0,0,0,6,0,0,23
Nigeria,19/04/2005,15,4,-2,0,7,0,0,24
Nigeria,20/04/2005,3,0,0,0,6,0,0,9
Nigeria,21/04/2005,17,0,0,0,12,0,0,29
Nigeria,22/04/2005,3,0,-2,0,3,1,0,5
Nigeria,23/04/2005,3,0,0,0,9,0,0,12
Nigeria,24/04/2005,2,0,0,0,1,1,0,4
Nigeria,25/04/2005,9,2,0,0,1,2,0,14
Nigeria,26/04/2005,18,0,0,0,0,0,0,18
Nigeria,27/04/2005,7,0,0,0,-2,1,0,6
Nigeria,28/04/2005,13,0,-6,0,4,0,0,11
Nigeria,29/04/2005,19,0,0,0,0,2,0,21
Nigeria,30/04/2005,0,0,0,0,0,0,0,0
Nigeria,01/05/2005,0,0,0,0,0,0,0,0
Nigeria,02/05/2005,3,0,0,0,6,2,0,11
Nigeria,03/05/2005,10,0,0,0,-2,0,0,8
Nigeria,04/05/2005,1,0,0,0,9,0,0,10
Nigeria,05/05/2005,3,0,-4,0,-11,2,0,-10
Nigeria,06/05/2005,2,0,0,0,13,3,0,18
Nigeria,07/05/2005,2,0,0,0,0,0,0,2
Nigeria,08/05/2005,9,2,-4,0,1,1,0,9
Nigeria,09/05/2005,20,0,0,0,3,0,0,23
Nigeria,10/05/2005,0,0,3,0,-2,1,0,2
Nigeria,11/05/2005,-7,0,0,0,6,0,0,-1
Nigeria,12/05/2005,-5,0,2,0,0,4,0,1
Nigeria,13/05/2005,5,0,0,0,0,1,0,6
Nigeria,14/05/2005,15,0,0,0,-2,0,0,13
Nigeria,15/05/2005,27,0,-1,0,0,0,0,26
Nigeria,16/05/2005,16,0,1,0,6,2,0,25
Nigeria,17/05/2005,-7,0,3,0,4,2,0,2
Nigeria,18/05/2005,4,0,-1,0,-4,4,0,3
Nigeria,19/05/2005,26,0,0,0,6,0,0,32
Nigeria,20/05/2005,15,0,0,0,6,0,0,21
Nigeria,21/05/2005,1,0,0,0,0,1,0,2
Nigeria,22/05/2005,9,0,-1,0,0,1,0,9
Nigeria,23/05/2005,1,0,0,0,3,0,0,4
Nigeria,24/05/2005,13,0,0,0,9,0,0,22
Nigeria,25/05/2005,12,0,1,0,11,3,0,27
Nigeria,26/05/2005,7,0,-4,0,-2,1,0,2
Nigeria,27/05/2005,5,0,0,0,3,1,0,9
Nigeria,28/05/2005,6,0,0,0,6,0,0,12
Nigeria,29/05/2005,4,0,0,0,0,0,0,4
Nigeria,30/05/2005,11,0,0,0,0,14,0,25
Nigeria,31/05/2005,21,0,0,0,9,2,0,32
Nigeria,01/06/2005,2,0,0,0,3,2,0,7
Nigeria,02/06/2005,-8,0,0,0,9,0,0,1
Nigeria,03/06/2005,4,0,0,0,12,1,0,17
Nigeria,04/06/2005,4,0,3,0,0,3,0,10
Nigeria,05/06/2005,3,0,0,0,9,4,0,16
Nigeria,06/06/2005,12,0,2,0,9,6,0,29
Nigeria,07/06/2005,19,0,1,0,6,6,0,32
Nigeria,08/06/2005,19,0,0,0,9,0,0,28
Nigeria,09/06/2005,14,0,0,0,0,0,0,14
Nigeria,10/06/2005,7,0,0,0,-4,0,0,3
Nigeria,11/06/2005,9,0,0,0,1,3,0,13
Nigeria,12/06/2005,5,0,0,0,0,1,0,6
Nigeria,13/06/2005,6,0,0,0,0,0,0,6
Nigeria,14/06/2005,12,0,0,0,-2,1,0,11
Nigeria,15/06/2005,8,0,0,0,6,0,0,14
Nigeria,16/06/2005,14,2,0,0,3,2,0,21
Nigeria,17/06/2005,10,0,0,0,-3,1,0,8
Nigeria,18/06/2005,12,0,0,0,-5,0,0,7
Nigeria,19/06/2005,5,0,0,0,0,2,0,7
Nigeria,20/06/2005,34,0,-2,0,1,5,0,38
Nigeria,21/06/2005,8,0,0,0,18,0,0,26
Nigeria,22/06/2005,20,0,0,0,0,2,0,22
Nigeria,23/06/2005,14,0,0,0,6,0,0,20
Nigeria,24/06/2005,13,0,1,0,0,1,0,15
Nigeria,25/06/2005,8,0,0,0,-4,2,0,6
Nigeria,26/06/2005,2,0,0,0,0,0,0,2
Nigeria,27/06/2005,5,0,0,0,6,1,0,12
Nigeria,28/06/2005,10,0,0,0,12,6,0,28
Nigeria,29/06/2005,15,0,0,0,3,1,0,19
Nigeria,30/06/2005,19,0,0,0,0,1,0,20
Nigeria,01/07/2005,6,0,2,0,3,2,0,13
Nigeria,02/07/2005,11,0,0,0,3,0,0,14
Nigeria,03/07/2005,5,0,0,0,-4,2,0,3
Nigeria,04/07/2005,1,0,0,0,0,0,0,1
Nigeria,05/07/2005,7,0,0,0,-4,2,0,5
Nigeria,06/07/2005,-4,0,0,0,0,1,0,-3
Nigeria,07/07/2005,14,0,0,0,9,2,0,25
Nigeria,08/07/2005,5,0,0,0,6,1,0,12
Nigeria,09/07/2005,-6,0,0,0,0,0,0,-6
Nigeria,10/07/2005,-3,0,0,0,0,5,0,2
Nigeria,11/07/2005,14,0,0,0,0,0,0,14
Nigeria,12/07/2005,12,2,0,0,-6,2,0,10
Nigeria,13/07/2005,27,0,1,0,4,0,0,32
Nigeria,14/07/2005,12,0,-2,0,0,2,0,12
Nigeria,15/07/2005,7,0,0,0,15,0,0,22
Nigeria,16/07/2005,-1,0,0,0,1,0,0,0
Nigeria,17/07/2005,3,0,0,0,0,0,0,3
Nigeria,18/07/2005,9,0,0,0,3,1,0,13
Nigeria,19/07/2005,26,0,0,0,0,2,0,28
Nigeria,20/07/2005,8,0,-8,0,0,2,0,2
Nigeria,21/07/2005,9,2,0,0,3,1,0,15
Nigeria,22/07/2005,20,0,0,0,3,1,0,24
Nigeria,23/07/2005,0,0,0,0,0,0,0,0
Nigeria,24/07/2005,4,0,0,0,6,1,0,11
Nigeria,25/07/2005,5,0,-1,0,0,1,0,5
Nigeria,26/07/2005,14,0,0,0,-1,1,0,14
Nigeria,27/07/2005,17,0,0,0,0,2,0,19
Nigeria,28/07/2005,19,0,0,0,12,4,0,35
Nigeria,29/07/2005,2,0,0,0,0,2,0,4
Nigeria,30/07/2005,3,0,0,0,3,0,0,6
Nigeria,31/07/2005,0,0,-2,0,-1,2,0,-1
Nigeria,01/08/2005,9,4,-8,0,1,2,0,8
Nigeria,02/08/2005,15,2,0,0,-2,0,0,15
Nigeria,03/08/2005,9,0,0,0,6,3,0,18
Nigeria,04/08/2005,8,0,0,0,15,3,0,26
Nigeria,05/08/2005,5,0,1,0,-1,0,0,5
Nigeria,06/08/2005,2,2,0,0,0,0,0,4
Nigeria,07/08/2005,-2,0,0,0,0,1,0,-1
Nigeria,08/08/2005,26,0,0,0,3,1,0,30
Nigeria,09/08/2005,1,0,0,0,0,1,0,2
Nigeria,10/08/2005,8,0,0,0,3,0,0,11
Nigeria,11/08/2005,10,0,0,0,6,1,0,17
Nigeria,12/08/2005,5,0,0,0,3,0,0,8
Nigeria,13/08/2005,8,0,0,0,0,1,0,9
Nigeria,14/08/2005,4,0,0,0,0,6,0,10
Nigeria,15/08/2005,17,0,0,0,-1,2,0,18
Nigeria,16/08/2005,8,0,-1,0,-1,2,0,8
Nigeria,17/08/2005,8,0,1,0,24,0,0,33
Nigeria,18/08/2005,8,0,0,0,9,0,0,17
Nigeria,19/08/2005,18,0,-2,0,0,0,0,16
Nigeria,20/08/2005,2,0,0,0,-4,0,0,-2
Nigeria,21/08/2005,12,0,0,0,15,0,0,27
Nigeria,22/08/2005,13,0,0,0,3,4,0,20
Nigeria,23/08/2005,10,0,0,0,3,0,0,13
Nigeria,24/08/2005,8,0,0,0,3,0,0,11
Nigeria,25/08/2005,3,0,0,0,-1,2,0,4
Nigeria,26/08/2005,12,0,0,0,6,1,0,19
Nigeria,27/08/2005,8,0,2,0,9,0,0,19
Nigeria,28/08/2005,14,0,0,0,-2,0,0,12
Nigeria,29/08/2005,0,0,0,0,3,0,0,3
Nigeria,30/08/2005,4,0,0,0,-2,0,0,2
Nigeria,31/08/2005,7,0,1,0,-3,4,0,9
Nigeria,01/09/2005,19,0,0,0,3,0,0,22
Nigeria,02/09/2005,-8,0,0,0,6,3,0,1
Nigeria,03/09/2005,11,0,0,0,0,0,0,11
Nigeria,04/09/2005,0,0,0,0,0,0,0,0
Nigeria,05/09/2005,4,0,0,0,0,0,0,4
Nigeria,06/09/2005,8,0,-2,0,-2,0,0,4
Nigeria,07/09/2005,11,4,1,0,-2,1,0,15
Nigeria,08/09/2005,7,2,2,0,3,0,0,14
Nigeria,09/09/2005,3,2,-2,0,-1,18,0,20
Nigeria,10/09/2005,8,0,-2,0,9,0,0,15
Nigeria,11/09/2005,10,0,1,0,3,1,0,15
Nigeria,12/09/2005,7,0,0,0,0,0,0,7
Nigeria,13/09/2005,7,0,0,0,-2,2,0,7
Nigeria,14/09/2005,9,0,0,0,-2,7,0,14
Nigeria,15/09/2005,7,0,0,0,11,2,0,20
Nigeria,16/09/2005,9,0,0,0,6,0,0,15
Nigeria,17/09/2005,0,0,0,0,11,0,0,11
Nigeria,18/09/2005,1,0,0,0,0,0,0,1
Nigeria,19/09/2005,16,0,0,0,-3,0,0,13
Nigeria,20/09/2005,4,0,2,0,0,0,0,6
Nigeria,21/09/2005,12,0,0,0,3,2,0,17
Nigeria,22/09/2005,4,0,-1,0,3,1,0,7
Nigeria,23/09/2005,-1,0,0,0,0,0,0,-1
Nigeria,24/09/2005,-3,0,0,0,9,0,0,6
Nigeria,25/09/2005,0,0,0,0,12,0,0,12
Nigeria,26/09/2005,0,0,0,0,0,5,0,5
Nigeria,27/09/2005,12,0,0,0,15,3,0,30
Nigeria,28/09/2005,20,0,-2,0,6,0,0,24
Nigeria,29/09/2005,10,0,0,0,6,1,0,17
Nigeria,30/09/2005,10,0,1,0,2,6,0,19
Nigeria,01/10/2005,0,0,0,0,0,0,0,0
Nigeria,02/10/2005,2,0,0,0,0,0,0,2
Nigeria,03/10/2005,8,0,0,0,-1,2,0,9
Nigeria,04/10/2005,32,0,0,0,0,1,0,33
Nigeria,05/10/2005,13,0,0,0,-1,1,0,13
Nigeria,06/10/2005,8,0,0,0,3,7,0,18
Nigeria,07/10/2005,2,0,1,0,-2,0,0,1
Nigeria,08/10/2005,5,0,0,0,0,2,0,7
Nigeria,09/10/2005,7,0,1,0,0,2,0,10
Nigeria,10/10/2005,5,0,-2,0,3,0,0,6
Nigeria,11/10/2005,-2,0,0,0,0,1,0,-1
Nigeria,12/10/2005,9,0,0,0,4,2,0,15
Nigeria,13/10/2005,5,0,0,0,6,3,0,14
Nigeria,14/10/2005,11,0,0,0,0,0,0,11
Nigeria,15/10/2005,0,0,0,0,0,1,0,1
Nigeria,16/10/2005,5,0,0,0,1,0,0,6
Nigeria,17/10/2005,0,0,0,0,-11,0,0,-11
Nigeria,18/10/2005,10,0,0,0,1,5,0,16
Nigeria,19/10/2005,14,0,0,0,12,3,0,29
Nigeria,20/10/2005,0,0,0,0,3,0,0,3
Nigeria,21/10/2005,9,0,0,0,-2,0,0,7
Nigeria,22/10/2005,0,0,0,0,3,0,0,3
Nigeria,23/10/2005,9,0,0,0,6,0,0,15
Nigeria,24/10/2005,11,0,-1,0,0,0,0,10
Nigeria,25/10/2005,-1,0,0,0,1,5,0,5
Nigeria,26/10/2005,7,0,0,0,12,6,0,25
Nigeria,27/10/2005,12,0,0,0,9,2,0,23
Nigeria,28/10/2005,2,0,0,0,6,0,0,8
Nigeria,29/10/2005,6,0,0,0,3,0,0,9
Nigeria,30/10/2005,3,0,0,0,0,0,0,3
Nigeria,31/10/2005,-1,0,4,0,30,2,0,35
Nigeria,01/11/2005,12,0,-2,0,-9,1,0,2
Nigeria,02/11/2005,16,0,0,0,-5,26,0,37
Nigeria,03/11/2005,1,0,-1,0,3,0,0,3
Nigeria,04/11/2005,17,0,0,0,1,0,0,18
Nigeria,05/11/2005,8,0,0,0,0,0,0,8
Nigeria,06/11/2005,2,0,0,0,0,0,0,2
Nigeria,07/11/2005,8,0,0,0,6,1,0,15
Nigeria,08/11/2005,13,0,0,0,0,2,0,15
Nigeria,09/11/2005,9,0,0,0,6,1,0,16
Nigeria,10/11/2005,3,0,0,0,0,0,0,3
Nigeria,11/11/2005,2,0,0,0,1,0,0,3
Nigeria,12/11/2005,0,0,0,0,3,0,0,3
Nigeria,13/11/2005,6,0,1,0,0,0,0,7
Nigeria,14/11/2005,7,0,0,0,9,6,0,22
Nigeria,15/11/2005,10,0,0,0,4,2,0,16
Nigeria,16/11/2005,8,6,0,0,0,1,0,15
Nigeria,17/11/2005,4,0,0,0,3,0,0,7
Nigeria,18/11/2005,11,0,0,0,6,0,0,17
Nigeria,19/11/2005,2,0,0,0,3,0,0,5
Nigeria,20/11/2005,2,0,-2,0,0,0,0,0
Nigeria,21/11/2005,10,0,0,0,0,2,0,12
Nigeria,22/11/2005,17,0,0,0,0,2,0,19
Nigeria,23/11/2005,6,0,0,0,0,0,0,6
Nigeria,24/11/2005,0,0,0,0,9,0,0,9
Nigeria,25/11/2005,11,0,-1,0,14,2,0,26
Nigeria,26/11/2005,-1,0,0,0,6,0,0,5
Nigeria,27/11/2005,7,0,0,0,0,0,0,7
Nigeria,28/11/2005,7,0,0,0,3,0,0,10
Nigeria,29/11/2005,9,0,0,0,7,1,0,17
Nigeria,30/11/2005,16,0,-4,0,15,3,0,30
Nigeria,01/12/2005,13,0,0,0,6,0,0,19
Nigeria,02/12/2005,0,0,0,0,4,1,0,5
Nigeria,03/12/2005,2,0,0,0,6,2,0,10
Nigeria,04/12/2005,-2,0,0,0,4,0,0,2
Nigeria,05/12/2005,9,0,0,0,7,1,0,17
Nigeria,06/12/2005,11,0,0,0,-2,0,0,9
Nigeria,07/12/2005,15,0,0,0,0,0,0,15
Nigeria,08/12/2005,13,0,0,0,0,0,0,13
Nigeria,09/12/2005,6,0,0,0,6,0,0,12
Nigeria,10/12/2005,2,0,0,0,3,0,0,5
Nigeria,11/12/2005,14,0,-1,0,0,0,0,13
Nigeria,12/12/2005,6,0,0,0,0,0,0,6
Nigeria,13/12/2005,6,0,-4,0,7,2,0,11
Nigeria,14/12/2005,6,0,0,0,-6,6,0,6
Nigeria,15/12/2005,4,0,0,0,3,0,0,7
Nigeria,16/12/2005,8,0,-1,0,-2,0,0,5
Nigeria,17/12/2005,-1,0,-2,0,0,0,0,-3
Nigeria,18/12/2005,6,0,0,0,7,0,0,13
Nigeria,19/12/2005,1,0,0,0,0,1,0,2
Nigeria,20/12/2005,14,0,0,0,9,1,0,24
Nigeria,21/12/2005,2,0,3,0,3,0,0,8
Nigeria,22/12/2005,0,0,0,0,0,0,0,0
Nigeria,23/12/2005,0,0,0,0,-4,0,0,-4
Nigeria,24/12/2005,9,0,0,0,0,0,0,9
Nigeria,25/12/2005,6,0,0,0,0,0,0,6
Nigeria,26/12/2005,5,0,0,0,-2,0,0,3
Nigeria,27/12/2005,3,0,1,0,0,0,0,4
Nigeria,28/12/2005,12,0,0,0,-2,0,0,10
Nigeria,29/12/2005,0,0,0,0,0,0,0,0
Nigeria,30/12/2005,11,0,0,0,0,0,0,11
Nigeria,31/12/2005,4,0,0,0,3,0,0,7
Pakistan,01/01/2005,4,0,-2,0,6,1,0,9
Pakistan,02/01/2005,10,0,0,0,3,0,0,13
Pakistan,03/01/2005,2,0,0,0,0,0,0,2
Pakistan,04/01/2005,6,0,0,0,3,0,0,9
Pakistan,05/01/2005,10,0,0,0,6,0,0,16
Pakistan,06/01/2005,17,0,0,0,2,1,0,20
Pakistan,07/01/2005,14,0,0,0,-2,0,0,12
Pakistan,08/01/2005,31,0,0,0,3,2,0,36
Pakistan,09/01/2005,25,0,0,0,0,0,0,25
Pakistan,10/01/2005,4,0,0,0,19,0,0,23
Pakistan,11/01/2005,-2,0,0,0,-4,0,0,-6
Pakistan,12/01/2005,14,0,0,0,3,0,0,17
Pakistan,13/01/2005,8,0,0,0,6,0,0,14
Pakistan,14/01/2005,1,0,0,0,15,0,0,16
Pakistan,15/01/2005,0,0,0,0,6,0,0,6
Pakistan,16/01/2005,3,0,0,0,-9,4,0,-2
Pakistan,17/01/2005,10,0,0,0,0,0,0,10
Pakistan,18/01/2005,19,0,0,0,18,0,0,37
Pakistan,19/01/2005,2,0,0,0,0,0,0,2
Pakistan,20/01/2005,5,0,0,0,0,0,0,5
Pakistan,21/01/2005,3,0,0,0,12,0,0,15
Pakistan,22/01/2005,-1,0,0,0,0,0,0,-1
Pakistan,23/01/2005,9,0,0,0,9,0,0,18
Pakistan,24/01/2005,3,2,0,0,13,0,0,18
Pakistan,25/01/2005,3,0,0,0,15,1,0,19
Pakistan,26/01/2005,0,0,0,0,4,0,0,4
Pakistan,27/01/2005,1,0,0,0,-1,0,0,0
Pakistan,28/01/2005,1,0,0,0,-6,0,0,-5
Pakistan,29/01/2005,8,0,0,0,6,0,0,14
Pakistan,30/01/2005,2,0,0,0,1,0,0,3
Pakistan,31/01/2005,5,0,0,0,15,3,0,23
Pakistan,01/02/2005,5,0,-2,0,6,3,0,12
Pakistan,02/02/2005,9,0,0,0,6,2,0,17
Pakistan,03/02/2005,0,0,0,0,0,0,0,0
Pakistan,04/02/2005,3,2,0,0,1,0,0,6
Pakistan,05/02/2005,7,0,0,0,3,0,0,10
Pakistan,06/02/2005,11,0,0,0,12,1,0,24
Pakistan,07/02/2005,11,0,0,0,3,2,0,16
Pakistan,08/02/2005,4,0,0,0,9,0,0,13
Pakistan,09/02/2005,14,0,0,0,-1,0,0,13
Pakistan,10/02/2005,0,0,0,0,0,1,0,1
Pakistan,11/02/2005,19,0,-2,0,1,0,0,18
Pakistan,12/02/2005,4,0,0,0,7,0,0,11
Pakistan,13/02/2005,3,2,0,0,6,0,0,11
Pakistan,14/02/2005,9,0,0,0,21,0,0,30
Pakistan,15/02/2005,15,0,0,0,15,2,0,32
Pakistan,16/02/2005,15,2,0,0,4,0,0,21
Pakistan,17/02/2005,-1,2,0,0,3,0,0,4
Pakistan,18/02/2005,2,0,0,0,6,3,0,11
Pakistan,19/02/2005,2,0,0,0,0,0,0,2
Pakistan,20/02/2005,-1,0,0,0,0,0,0,-1
Pakistan,21/02/2005,7,0,0,0,6,0,0,13
Pakistan,22/02/2005,0,0,0,0,0,7,0,7
Pakistan,23/02/2005,11,0,0,0,0,0,0,11
Pakistan,24/02/2005,10,0,0,0,3,6,0,19
Pakistan,25/02/2005,4,0,0,0,3,8,0,15
Pakistan,26/02/2005,12,0,0,0,0,0,0,12
Pakistan,27/02/2005,0,0,-2,0,0,0,0,-2
Pakistan,28/02/2005,14,0,-1,0,6,1,0,20
Pakistan,01/03/2005,18,2,0,0,0,0,0,20
Pakistan,02/03/2005,40,0,0,0,3,10,0,53
Pakistan,03/03/2005,15,0,0,0,6,4,0,25
Pakistan,04/03/2005,0,0,0,0,0,1,0,1
Pakistan,05/03/2005,0,0,0,0,0,0,0,0
Pakistan,06/03/2005,3,0,0,0,-13,1,0,-9
Pakistan,07/03/2005,23,0,0,0,8,0,0,31
Pakistan,08/03/2005,3,0,0,0,3,1,0,7
Pakistan,09/03/2005,1,0,-2,0,27,0,0,26
Pakistan,10/03/2005,5,0,0,0,6,0,0,11
Pakistan,11/03/2005,3,2,0,0,-5,0,0,0
Pakistan,12/03/2005,2,0,0,0,0,2,0,4
Pakistan,13/03/2005,7,0,0,0,18,4,0,29
Pakistan,14/03/2005,8,0,0,0,10,0,0,18
Pakistan,15/03/2005,4,0,0,0,3,0,0,7
Pakistan,16/03/2005,11,0,0,0,5,1,0,17
Pakistan,17/03/2005,9,0,0,0,3,0,0,12
Pakistan,18/03/2005,11,0,0,0,3,0,0,14
Pakistan,19/03/2005,1,0,0,0,1,3,0,5
Pakistan,20/03/2005,8,0,0,0,6,0,0,14
Pakistan,21/03/2005,0,0,0,0,0,0,0,0
Pakistan,22/03/2005,-3,0,0,0,23,0,0,20
Pakistan,23/03/2005,24,0,0,0,8,1,0,33
Pakistan,24/03/2005,18,0,0,0,1,0,0,19
Pakistan,25/03/2005,17,0,0,0,2,0,0,19
Pakistan,26/03/2005,5,0,0,0,0,1,0,6
Pakistan,27/03/2005,5,0,0,0,0,2,0,7
Pakistan,28/03/2005,49,0,0,0,0,1,0,50
Pakistan,29/03/2005,-1,0,0,0,0,0,0,-1
Pakistan,30/03/2005,0,0,0,0,-4,0,0,-4
Pakistan,31/03/2005,12,0,0,0,0,0,0,12
Pakistan,01/04/2005,5,0,0,0,6,0,0,11
Pakistan,02/04/2005,20,0,0,0,0,4,0,24
Pakistan,03/04/2005,19,0,0,0,-1,0,0,18
Pakistan,04/04/2005,3,0,0,0,0,0,0,3
Pakistan,05/04/2005,0,0,0,0,6,0,0,6
Pakistan,06/04/2005,25,0,0,0,3,6,0,34
Pakistan,07/04/2005,2,0,0,0,0,0,0,2
Pakistan,08/04/2005,4,0,0,0,0,0,0,4
Pakistan,09/04/2005,5,0,0,0,12,0,0,17
Pakistan,10/04/2005,8,0,0,0,3,0,0,11
Pakistan,11/04/2005,0,0,0,0,0,0,0,0
Pakistan,12/04/2005,10,0,0,0,9,0,0,19
Pakistan,13/04/2005,11,0,0,0,26,2,0,39
Pakistan,14/04/2005,0,0,0,0,8,0,0,8
Pakistan,15/04/2005,8,0,0,0,0,0,0,8
Pakistan,16/04/2005,8,0,0,0,0,0,0,8
Pakistan,17/04/2005,4,0,0,0,9,2,0,15
Pakistan,18/04/2005,4,0,0,0,9,0,0,13
Pakistan,19/04/2005,-4,0,0,0,8,0,0,4
Pakistan,20/04/2005,10,0,0,0,0,0,0,10
Pakistan,21/04/2005,5,0,0,0,-3,3,0,5
Pakistan,22/04/2005,-4,0,0,0,7,0,0,3
Pakistan,23/04/2005,2,0,0,0,6,0,0,8
Pakistan,24/04/2005,0,0,0,0,-1,0,0,-1
Pakistan,25/04/2005,5,0,-1,0,10,3,0,17
Pakistan,26/04/2005,20,0,0,0,12,0,0,32
Pakistan,27/04/2005,5,0,0,0,3,2,0,10
Pakistan,28/04/2005,3,0,0,0,0,0,0,3
Pakistan,29/04/2005,0,0,0,0,0,0,0,0
Pakistan,30/04/2005,4,0,0,0,0,0,0,4
Pakistan,01/05/2005,2,0,0,0,3,1,0,6
Pakistan,02/05/2005,5,0,0,0,0,0,0,5
Pakistan,03/05/2005,4,0,0,0,-1,0,0,3
Pakistan,04/05/2005,1,0,0,0,9,0,0,10
Pakistan,05/05/2005,14,0,0,0,19,12,0,45
Pakistan,06/05/2005,8,0,0,0,3,0,0,11
Pakistan,07/05/2005,-1,0,0,0,-2,1,0,-2
Pakistan,08/05/2005,2,0,0,0,15,2,0,19
Pakistan,09/05/2005,-5,0,0,0,-6,1,0,-10
Pakistan,10/05/2005,19,0,0,0,0,2,0,21
Pakistan,11/05/2005,12,0,0,0,0,3,0,15
Pakistan,12/05/2005,15,0,0,0,-1,7,0,21
Pakistan,13/05/2005,4,0,-2,0,3,3,0,8
Pakistan,14/05/2005,7,0,0,0,3,0,0,10
Pakistan,15/05/2005,3,0,0,0,3,14,0,20
Pakistan,16/05/2005,2,0,0,0,3,15,0,20
Pakistan,17/05/2005,2,0,0,0,6,0,0,8
Pakistan,18/05/2005,13,0,0,0,8,5,0,26
Pakistan,19/05/2005,0,0,0,0,6,1,0,7
Pakistan,20/05/2005,3,0,0,0,4,0,0,7
Pakistan,21/05/2005,6,0,0,0,6,0,0,12
Pakistan,22/05/2005,1,0,0,0,0,2,0,3
Pakistan,23/05/2005,4,0,0,0,9,2,0,15
Pakistan,24/05/2005,0,0,0,0,9,0,0,9
Pakistan,25/05/2005,1,0,0,0,9,6,0,16
Pakistan,26/05/2005,8,0,-1,0,12,2,0,21
Pakistan,27/05/2005,4,0,0,0,-1,0,0,3
Pakistan,28/05/2005,3,0,0,0,0,1,0,4
Pakistan,29/05/2005,7,0,0,0,0,0,0,7
Pakistan,30/05/2005,0,0,0,0,8,0,0,8
Pakistan,31/05/2005,7,0,0,0,21,0,0,28
Pakistan,01/06/2005,7,0,0,0,12,0,0,19
Pakistan,02/06/2005,8,0,0,0,0,0,0,8
Pakistan,03/06/2005,8,0,0,0,0,0,0,8
Pakistan,04/06/2005,5,0,0,0,0,-2,0,3
Pakistan,05/06/2005,13,0,0,0,1,2,0,16
Pakistan,06/06/2005,3,0,0,0,16,0,0,19
Pakistan,07/06/2005,4,0,0,0,-2,0,0,2
Pakistan,08/06/2005,48,0,0,0,9,0,0,57
Pakistan,09/06/2005,19,0,0,0,15,1,0,35
Pakistan,10/06/2005,14,0,0,0,3,0,0,17
Pakistan,11/06/2005,13,0,0,0,19,2,0,34
Pakistan,12/06/2005,8,0,0,0,2,0,0,10
Pakistan,13/06/2005,24,0,2,0,11,6,0,43
Pakistan,14/06/2005,6,0,0,0,0,2,0,8
Pakistan,15/06/2005,33,0,0,0,37,6,0,76
Pakistan,16/06/2005,26,0,0,0,13,5,0,44
Pakistan,17/06/2005,27,0,0,0,7,0,0,34
Pakistan,18/06/2005,2,0,0,0,0,0,0,2
Pakistan,19/06/2005,1,0,0,0,0,0,0,1
Pakistan,20/06/2005,18,0,0,0,0,0,0,18
Pakistan,21/06/2005,14,0,-1,0,6,3,0,22
Pakistan,22/06/2005,23,0,1,0,17,10,0,51
Pakistan,23/06/2005,15,0,0,0,9,0,0,24
Pakistan,24/06/2005,5,0,0,0,0,0,0,5
Pakistan,25/06/2005,12,0,0,0,3,0,0,15
Pakistan,26/06/2005,7,0,0,0,0,0,0,7
Pakistan,27/06/2005,13,0,0,0,0,0,0,13
Pakistan,28/06/2005,15,0,0,0,9,3,0,27
Pakistan,29/06/2005,22,0,0,0,7,0,0,29
Pakistan,30/06/2005,19,0,0,0,0,0,0,19
Pakistan,01/07/2005,12,0,0,0,0,0,0,12
Pakistan,02/07/2005,6,0,0,0,0,0,0,6
Pakistan,03/07/2005,9,0,0,0,7,2,0,18
Pakistan,04/07/2005,11,0,2,0,1,0,0,14
Pakistan,05/07/2005,41,0,0,0,10,0,0,51
Pakistan,06/07/2005,31,0,0,0,10,2,0,43
Pakistan,07/07/2005,36,0,0,0,12,0,0,48
Pakistan,08/07/2005,24,0,0,0,6,6,0,36
Pakistan,09/07/2005,3,0,0,0,6,2,0,11
Pakistan,10/07/2005,14,0,0,0,21,2,0,37
Pakistan,11/07/2005,19,0,-1,0,3,4,0,25
Pakistan,12/07/2005,17,2,1,0,18,6,0,44
Pakistan,13/07/2005,55,0,0,0,9,5,0,69
Pakistan,14/07/2005,13,0,0,0,6,0,0,19
Pakistan,15/07/2005,42,0,0,0,1,0,0,43
Pakistan,16/07/2005,13,0,0,0,9,2,0,24
Pakistan,17/07/2005,25,0,0,0,3,0,0,28
Pakistan,18/07/2005,7,0,0,0,0,6,0,13
Pakistan,19/07/2005,26,2,0,0,6,7,0,41
Pakistan,20/07/2005,3,0,0,0,12,3,0,18
Pakistan,21/07/2005,35,0,0,0,17,2,0,54
Pakistan,22/07/2005,21,0,0,0,24,0,0,45
Pakistan,23/07/2005,19,0,0,0,3,2,0,24
Pakistan,24/07/2005,7,0,0,0,13,0,0,20
Pakistan,25/07/2005,23,0,0,0,12,0,0,35
Pakistan,26/07/2005,15,0,0,0,6,0,0,21
Pakistan,27/07/2005,12,0,0,0,15,3,0,30
Pakistan,28/07/2005,16,0,0,0,6,1,0,23
Pakistan,29/07/2005,10,0,0,0,12,0,0,22
Pakistan,30/07/2005,5,0,0,0,9,4,0,18
Pakistan,31/07/2005,8,0,0,0,3,0,0,11
Pakistan,01/08/2005,12,0,0,0,4,0,0,16
Pakistan,02/08/2005,16,0,0,0,6,3,0,25
Pakistan,03/08/2005,16,2,0,0,6,6,0,30
Pakistan,04/08/2005,12,0,0,0,18,1,0,31
Pakistan,05/08/2005,4,0,0,0,3,3,0,10
Pakistan,06/08/2005,9,0,0,0,-4,0,0,5
Pakistan,07/08/2005,6,0,0,0,6,0,0,12
Pakistan,08/08/2005,11,0,0,0,0,0,0,11
Pakistan,09/08/2005,17,0,0,0,9,3,0,29
Pakistan,10/08/2005,9,0,0,0,12,0,0,21
Pakistan,11/08/2005,17,0,0,0,0,0,0,17
Pakistan,12/08/2005,6,0,0,0,0,0,0,6
Pakistan,13/08/2005,4,0,0,0,0,0,0,4
Pakistan,14/08/2005,11,0,0,0,-2,0,0,9
Pakistan,15/08/2005,7,0,0,0,18,0,0,25
Pakistan,16/08/2005,7,0,0,0,3,0,0,10
Pakistan,17/08/2005,7,0,0,0,-2,0,0,5
Pakistan,18/08/2005,9,0,0,0,6,0,0,15
Pakistan,19/08/2005,-6,0,0,0,0,0,0,-6
Pakistan,20/08/2005,0,0,0,0,3,0,0,3
Pakistan,21/08/2005,2,0,0,0,0,0,0,2
Pakistan,22/08/2005,9,0,0,0,3,1,0,13
Pakistan,23/08/2005,4,0,0,0,2,8,0,14
Pakistan,24/08/2005,7,0,0,0,6,0,0,13
Pakistan,25/08/2005,0,0,0,0,4,0,0,4
Pakistan,26/08/2005,3,0,0,0,-2,0,0,1
Pakistan,27/08/2005,21,0,-2,0,0,0,0,19
Pakistan,28/08/2005,3,0,0,0,3,0,0,6
Pakistan,29/08/2005,3,0,0,0,12,0,0,15
Pakistan,30/08/2005,3,0,0,0,-4,0,0,-1
Pakistan,31/08/2005,2,0,0,0,12,0,0,14
Pakistan,01/09/2005,71,0,6,0,18,16,0,111
Pakistan,02/09/2005,21,0,2,0,6,5,0,34
Pakistan,03/09/2005,5,0,0,0,3,3,0,11
Pakistan,04/09/2005,0,0,0,0,0,0,0,0
Pakistan,05/09/2005,12,0,0,0,3,0,0,15
Pakistan,06/09/2005,3,0,0,0,0,0,0,3
Pakistan,07/09/2005,7,0,0,0,0,0,0,7
Pakistan,08/09/2005,0,0,0,0,0,0,0,0
Pakistan,09/09/2005,7,0,0,0,-12,2,0,-3
Pakistan,10/09/2005,14,0,0,0,18,18,0,50
Pakistan,11/09/2005,10,0,0,0,6,0,0,16
Pakistan,12/09/2005,15,0,1,0,7,1,0,24
Pakistan,13/09/2005,23,0,0,0,-5,0,0,18
Pakistan,14/09/2005,21,0,1,0,0,8,0,30
Pakistan,15/09/2005,19,0,0,0,9,4,0,32
Pakistan,16/09/2005,15,0,0,0,-2,0,0,13
Pakistan,17/09/2005,21,0,0,0,12,0,0,33
Pakistan,18/09/2005,15,0,0,0,9,3,0,27
Pakistan,19/09/2005,22,0,-2,0,8,1,0,29
Pakistan,20/09/2005,18,0,0,0,15,0,0,33
Pakistan,21/09/2005,2,0,0,0,3,0,0,5
Pakistan,22/09/2005,5,0,3,0,9,0,0,17
Pakistan,23/09/2005,1,0,0,0,27,0,0,28
Pakistan,24/09/2005,0,0,0,0,3,0,0,3
Pakistan,25/09/2005,0,0,0,0,-4,1,0,-3
Pakistan,26/09/2005,0,0,0,0,0,0,0,0
Pakistan,27/09/2005,9,0,0,0,6,0,0,15
Pakistan,28/09/2005,2,0,0,0,6,0,0,8
Pakistan,29/09/2005,13,0,0,0,16,0,0,29
Pakistan,30/09/2005,8,0,0,0,4,0,0,12
Pakistan,01/10/2005,3,0,0,0,0,0,0,3
Pakistan,02/10/2005,19,0,0,0,0,0,0,19
Pakistan,03/10/2005,9,0,0,0,0,0,0,9
Pakistan,04/10/2005,7,0,0,0,18,3,0,28
Pakistan,05/10/2005,6,0,0,0,18,6,0,30
Pakistan,06/10/2005,0,0,0,0,3,0,0,3
Pakistan,07/10/2005,7,0,0,0,12,0,0,19
Pakistan,08/10/2005,10,0,0,0,9,0,0,19
Pakistan,09/10/2005,13,6,0,0,19,3,0,41
Pakistan,10/10/2005,13,2,0,0,2,0,0,17
Pakistan,11/10/2005,7,4,0,0,8,8,0,27
Pakistan,12/10/2005,13,0,-1,0,2,0,0,14
Pakistan,13/10/2005,21,0,0,0,0,0,0,21
Pakistan,14/10/2005,10,0,0,0,6,1,0,17
Pakistan,15/10/2005,5,0,0,0,9,0,0,14
Pakistan,16/10/2005,19,2,0,0,0,0,0,21
Pakistan,17/10/2005,12,0,0,0,-6,0,0,6
Pakistan,18/10/2005,9,4,0,0,-5,0,0,8
Pakistan,19/10/2005,5,0,0,0,15,1,0,21
Pakistan,20/10/2005,18,2,0,0,3,3,0,26
Pakistan,21/10/2005,6,2,0,0,0,1,0,9
Pakistan,22/10/2005,8,0,0,0,9,1,0,18
Pakistan,23/10/2005,4,2,0,0,0,0,0,6
Pakistan,24/10/2005,11,0,0,0,5,3,0,19
Pakistan,25/10/2005,14,0,0,0,-6,4,0,12
Pakistan,26/10/2005,9,14,0,0,13,6,0,42
Pakistan,27/10/2005,16,6,0,0,18,2,0,42
Pakistan,28/10/2005,5,0,0,0,15,0,0,20
Pakistan,29/10/2005,23,0,-2,0,5,0,0,26
Pakistan,30/10/2005,13,0,0,0,0,0,0,13
Pakistan,31/10/2005,6,0,0,0,0,0,0,6
Pakistan,01/11/2005,9,2,0,0,33,0,0,44
Pakistan,02/11/2005,22,0,0,0,-6,4,0,20
Pakistan,03/11/2005,0,0,0,0,29,0,0,29
Pakistan,04/11/2005,4,0,0,0,17,0,0,21
Pakistan,05/11/2005,4,0,0,0,1,1,0,6
Pakistan,06/11/2005,4,0,1,0,30,2,0,37
Pakistan,07/11/2005,12,2,0,0,13,6,0,33
Pakistan,08/11/2005,19,0,-2,0,-2,2,0,17
Pakistan,09/11/2005,14,0,0,0,7,0,0,21
Pakistan,10/11/2005,3,0,0,0,10,0,0,13
Pakistan,11/11/2005,11,0,0,0,-4,0,0,7
Pakistan,12/11/2005,9,0,3,0,0,0,0,12
Pakistan,13/11/2005,13,2,0,0,9,0,0,24
Pakistan,14/11/2005,17,0,0,0,12,0,0,29
Pakistan,15/11/2005,1,0,0,0,9,0,0,10
Pakistan,16/11/2005,17,0,-1,0,6,8,0,30
Pakistan,17/11/2005,9,8,0,0,3,5,0,25
Pakistan,18/11/2005,10,0,0,0,0,0,0,10
Pakistan,19/11/2005,28,2,-1,0,0,0,0,29
Pakistan,20/11/2005,-4,0,0,0,0,0,0,-4
Pakistan,21/11/2005,10,0,0,0,0,0,0,10
Pakistan,22/11/2005,5,0,0,0,18,0,0,23
Pakistan,23/11/2005,0,0,0,0,3,0,0,3
Pakistan,24/11/2005,10,0,0,0,3,1,0,14
Pakistan,25/11/2005,2,2,0,0,0,0,0,4
Pakistan,26/11/2005,6,2,0,0,3,0,0,11
Pakistan,27/11/2005,3,0,0,0,3,0,0,6
Pakistan,28/11/2005,31,0,0,0,6,0,0,37
Pakistan,29/11/2005,7,0,0,0,3,0,0,10
Pakistan,30/11/2005,19,0,0,0,-6,0,0,13
Pakistan,01/12/2005,17,0,0,0,0,0,0,17
Pakistan,02/12/2005,13,0,0,0,-2,0,0,11
Pakistan,03/12/2005,12,0,0,0,6,0,0,18
Pakistan,04/12/2005,41,0,1,0,15,2,0,59
Pakistan,05/12/2005,11,0,0,0,3,1,0,15
Pakistan,06/12/2005,6,0,0,0,0,1,0,7
Pakistan,07/12/2005,14,0,0,0,0,0,0,14
Pakistan,08/12/2005,7,0,0,0,1,0,0,8
Pakistan,09/12/2005,18,0,0,0,0,0,0,18
Pakistan,10/12/2005,0,0,0,0,0,0,0,0
Pakistan,11/12/2005,2,0,0,0,15,0,0,17
Pakistan,12/12/2005,16,0,0,0,1,0,0,17
Pakistan,13/12/2005,4,0,0,0,-2,6,0,8
Pakistan,14/12/2005,0,0,0,0,3,9,0,12
Pakistan,15/12/2005,12,0,-4,0,0,0,0,8
Pakistan,16/12/2005,32,0,0,0,37,1,0,70
Pakistan,17/12/2005,7,0,0,0,-2,0,0,5
Pakistan,18/12/2005,37,0,0,0,18,0,0,55
Pakistan,19/12/2005,19,0,0,0,11,6,0,36
Pakistan,20/12/2005,4,0,0,0,0,0,0,4
Pakistan,21/12/2005,8,0,0,0,12,0,0,20
Pakistan,22/12/2005,8,0,0,0,-1,3,0,10
Pakistan,23/12/2005,6,0,0,0,12,0,0,18
Pakistan,24/12/2005,0,0,0,0,0,0,0,0
Pakistan,25/12/2005,0,0,0,0,-3,0,0,-3
Pakistan,26/12/2005,5,0,0,0,4,0,0,9
Pakistan,27/12/2005,-9,0,0,0,3,6,0,0
Pakistan,28/12/2005,21,0,0,0,12,0,0,33
Pakistan,29/12/2005,8,0,0,0,9,0,0,17
Pakistan,30/12/2005,0,0,0,0,6,0,0,6
Pakistan,31/12/2005,-5,0,0,0,9,2,0,6
Sierra Leone,06/01/2005,2,0,0,0,3,1,0,6
Sierra Leone,07/01/2005,6,0,0,0,-4,0,0,2
Sierra Leone,10/01/2005,-6,0,0,0,0,0,0,-6
Sierra Leone,11/01/2005,4,0,0,0,0,1,0,5
Sierra Leone,12/01/2005,0,0,0,0,0,2,0,2
Sierra Leone,13/01/2005,1,2,0,0,0,0,0,3
Sierra Leone,14/01/2005,0,2,0,0,1,0,0,3
Sierra Leone,15/01/2005,0,0,0,0,0,0,0,0
Sierra Leone,16/01/2005,0,0,0,0,0,0,0,0
Sierra Leone,17/01/2005,-1,0,0,0,3,2,0,4
Sierra Leone,18/01/2005,6,0,0,0,0,1,0,7
Sierra Leone,19/01/2005,3,0,0,0,3,0,0,6
Sierra Leone,20/01/2005,0,0,0,0,0,0,0,0
Sierra Leone,21/01/2005,3,0,0,0,1,0,0,4
Sierra Leone,22/01/2005,0,0,0,0,0,0,0,0
Sierra Leone,24/01/2005,0,0,0,0,0,0,0,0
Sierra Leone,25/01/2005,2,0,0,0,0,2,0,4
Sierra Leone,26/01/2005,-1,0,0,0,3,0,0,2
Sierra Leone,27/01/2005,0,0,0,0,3,0,0,3
Sierra Leone,28/01/2005,0,0,0,0,-2,0,0,-2
Sierra Leone,29/01/2005,0,0,0,0,0,0,0,0
Sierra Leone,30/01/2005,0,0,0,0,0,0,0,0
Sierra Leone,31/01/2005,0,0,0,0,3,0,0,3
Sierra Leone,01/02/2005,0,0,0,0,0,0,0,0
Sierra Leone,02/02/2005,7,0,0,0,-4,0,0,3
Sierra Leone,03/02/2005,0,0,0,0,-4,2,0,-2
Sierra Leone,04/02/2005,2,0,0,0,0,0,0,2
Sierra Leone,07/02/2005,8,0,0,0,6,1,0,15
Sierra Leone,08/02/2005,0,0,1,0,3,0,0,4
Sierra Leone,09/02/2005,1,0,0,0,1,0,0,2
Sierra Leone,10/02/2005,3,0,0,0,0,1,0,4
Sierra Leone,11/02/2005,2,0,0,0,0,2,0,4
Sierra Leone,12/02/2005,0,0,0,0,0,1,0,1
Sierra Leone,13/02/2005,3,0,0,0,0,0,0,3
Sierra Leone,14/02/2005,1,0,0,0,3,0,0,4
Sierra Leone,15/02/2005,2,0,0,0,12,0,0,14
Sierra Leone,16/02/2005,2,0,0,0,1,0,0,3
Sierra Leone,17/02/2005,3,0,0,0,0,1,0,4
Sierra Leone,18/02/2005,2,0,0,0,-2,0,0,0
Sierra Leone,19/02/2005,1,0,0,0,0,0,0,1
Sierra Leone,21/02/2005,0,0,0,0,0,0,0,0
Sierra Leone,22/02/2005,8,0,0,0,-2,1,0,7
Sierra Leone,23/02/2005,2,0,0,0,0,0,0,2
Sierra Leone,24/02/2005,7,0,1,0,-6,0,0,2
Sierra Leone,25/02/2005,0,0,0,0,-2,0,0,-2
Sierra Leone,26/02/2005,3,0,0,0,0,1,0,4
Sierra Leone,28/02/2005,1,0,0,0,0,1,0,2
Sierra Leone,01/03/2005,0,0,0,0,-22,1,0,-21
Sierra Leone,02/03/2005,2,0,0,0,1,0,0,3
Sierra Leone,03/03/2005,14,0,0,0,1,0,0,15
Sierra Leone,04/03/2005,2,0,0,0,0,0,0,2
Sierra Leone,05/03/2005,0,0,0,0,0,0,0,0
Sierra Leone,07/03/2005,0,0,0,0,0,0,0,0
Sierra Leone,08/03/2005,0,0,0,0,6,0,0,6
Sierra Leone,09/03/2005,0,0,0,0,3,0,0,3
Sierra Leone,10/03/2005,0,0,0,0,3,1,0,4
Sierra Leone,11/03/2005,9,0,0,0,5,0,0,14
Sierra Leone,12/03/2005,0,0,0,0,0,0,0,0
Sierra Leone,13/03/2005,0,0,0,0,0,0,0,0
Sierra Leone,14/03/2005,11,0,0,0,3,0,0,14
Sierra Leone,15/03/2005,-1,0,0,0,0,0,0,-1
Sierra Leone,16/03/2005,1,0,0,0,3,0,0,4
Sierra Leone,17/03/2005,0,0,0,0,0,0,0,0
Sierra Leone,18/03/2005,0,0,0,0,0,0,0,0
Sierra Leone,21/03/2005,2,0,0,0,3,2,0,7
Sierra Leone,22/03/2005,0,0,0,0,0,0,0,0
Sierra Leone,23/03/2005,8,0,0,0,6,0,0,14
Sierra Leone,24/03/2005,0,0,0,0,0,0,0,0
Sierra Leone,25/03/2005,0,0,0,0,0,0,0,0
Sierra Leone,26/03/2005,0,0,0,0,0,0,0,0
Sierra Leone,27/03/2005,6,0,0,0,0,0,0,6
Sierra Leone,28/03/2005,0,0,0,0,3,0,0,3
Sierra Leone,29/03/2005,0,0,0,0,0,0,0,0
Sierra Leone,30/03/2005,0,0,0,0,6,0,0,6
Sierra Leone,01/04/2005,1,0,0,0,0,0,0,1
Sierra Leone,04/04/2005,1,0,0,0,6,0,0,7
Sierra Leone,05/04/2005,0,0,0,0,-6,0,0,-6
Sierra Leone,06/04/2005,-3,0,0,0,3,0,0,0
Sierra Leone,07/04/2005,-2,0,0,0,0,0,0,-2
Sierra Leone,08/04/2005,4,0,0,0,0,0,0,4
Sierra Leone,11/04/2005,2,0,0,0,0,0,0,2
Sierra Leone,12/04/2005,2,0,0,0,3,0,0,5
Sierra Leone,13/04/2005,2,0,0,0,0,0,0,2
Sierra Leone,14/04/2005,2,0,0,0,3,0,0,5
Sierra Leone,15/04/2005,2,0,0,0,0,0,0,2
Sierra Leone,16/04/2005,0,0,0,0,0,0,0,0
Sierra Leone,17/04/2005,0,0,0,0,0,0,0,0
Sierra Leone,18/04/2005,0,0,0,0,0,0,0,0
Sierra Leone,19/04/2005,-1,0,0,0,6,1,0,6
Sierra Leone,20/04/2005,1,0,0,0,-4,0,0,-3
Sierra Leone,21/04/2005,0,0,0,0,0,0,0,0
Sierra Leone,22/04/2005,0,0,0,0,0,0,0,0
Sierra Leone,24/04/2005,0,0,0,0,0,0,0,0
Sierra Leone,25/04/2005,2,0,0,0,0,2,0,4
Sierra Leone,26/04/2005,0,0,0,0,0,0,0,0
Sierra Leone,27/04/2005,2,0,0,0,0,0,0,2
Sierra Leone,28/04/2005,1,0,0,0,6,0,0,7
Sierra Leone,29/04/2005,1,0,0,0,0,0,0,1
Sierra Leone,02/05/2005,0,0,0,0,0,0,0,0
Sierra Leone,03/05/2005,7,0,0,0,4,0,0,11
Sierra Leone,04/05/2005,0,0,0,0,3,0,0,3
Sierra Leone,05/05/2005,7,0,0,0,3,0,0,10
Sierra Leone,06/05/2005,3,0,0,0,-2,0,0,1
Sierra Leone,07/05/2005,0,0,0,0,0,0,0,0
Sierra Leone,09/05/2005,0,0,0,0,0,0,0,0
Sierra Leone,10/05/2005,1,0,0,0,0,0,0,1
Sierra Leone,11/05/2005,0,0,0,0,0,0,0,0
Sierra Leone,13/05/2005,1,0,0,0,0,1,0,2
Sierra Leone,14/05/2005,0,0,0,0,-4,0,0,-4
Sierra Leone,16/05/2005,2,0,0,0,9,2,0,13
Sierra Leone,17/05/2005,12,0,0,0,0,0,0,12
Sierra Leone,18/05/2005,0,0,-2,0,0,0,0,-2
Sierra Leone,19/05/2005,1,0,0,0,0,0,0,1
Sierra Leone,20/05/2005,-1,0,0,0,3,0,0,2
Sierra Leone,22/05/2005,0,0,0,0,0,0,0,0
Sierra Leone,23/05/2005,5,0,0,0,0,0,0,5
Sierra Leone,24/05/2005,0,0,0,0,4,0,0,4
Sierra Leone,25/05/2005,0,0,0,0,3,1,0,4
Sierra Leone,26/05/2005,0,0,0,0,3,0,0,3
Sierra Leone,27/05/2005,3,0,0,0,-2,0,0,1
Sierra Leone,28/05/2005,0,0,0,0,0,0,0,0
Sierra Leone,30/05/2005,3,0,0,0,3,0,0,6
Sierra Leone,31/05/2005,0,0,0,0,-2,0,0,-2
Sierra Leone,01/06/2005,0,0,0,0,0,0,0,0
Sierra Leone,02/06/2005,0,0,0,0,3,0,0,3
Sierra Leone,03/06/2005,11,0,0,0,3,0,0,14
Sierra Leone,05/06/2005,0,0,0,0,0,0,0,0
Sierra Leone,06/06/2005,0,0,0,0,0,0,0,0
Sierra Leone,07/06/2005,2,0,0,0,0,0,0,2
Sierra Leone,08/06/2005,0,0,0,0,0,0,0,0
Sierra Leone,09/06/2005,2,0,0,0,3,0,0,5
Sierra Leone,10/06/2005,-3,0,0,0,0,0,0,-3
Sierra Leone,12/06/2005,0,0,0,0,0,0,0,0
Sierra Leone,13/06/2005,-3,0,0,0,6,0,0,3
Sierra Leone,14/06/2005,1,0,0,0,0,0,0,1
Sierra Leone,15/06/2005,0,0,0,0,0,1,0,1
Sierra Leone,16/06/2005,0,0,0,0,0,0,0,0
Sierra Leone,17/06/2005,2,0,0,0,-3,0,0,-1
Sierra Leone,18/06/2005,2,0,0,0,0,0,0,2
Sierra Leone,19/06/2005,0,0,0,0,0,0,0,0
Sierra Leone,20/06/2005,3,0,0,0,0,0,0,3
Sierra Leone,21/06/2005,0,0,0,0,0,0,0,0
Sierra Leone,22/06/2005,6,0,0,0,0,1,0,7
Sierra Leone,23/06/2005,3,0,0,0,0,0,0,3
Sierra Leone,24/06/2005,3,0,0,0,-2,0,0,1
Sierra Leone,25/06/2005,0,0,0,0,0,0,0,0
Sierra Leone,26/06/2005,0,0,0,0,0,0,0,0
Sierra Leone,27/06/2005,0,0,0,0,6,0,0,6
Sierra Leone,28/06/2005,2,0,0,0,-2,0,0,0
Sierra Leone,29/06/2005,4,0,0,0,0,0,0,4
Sierra Leone,30/06/2005,0,0,0,0,0,0,0,0
Sierra Leone,01/07/2005,1,0,0,0,6,0,0,7
Sierra Leone,03/07/2005,0,0,0,0,0,0,0,0
Sierra Leone,04/07/2005,0,0,0,0,3,0,0,3
Sierra Leone,05/07/2005,8,0,0,0,0,0,0,8
Sierra Leone,06/07/2005,1,0,0,0,0,2,0,3
Sierra Leone,07/07/2005,3,0,0,0,0,0,0,3
Sierra Leone,08/07/2005,0,0,0,0,0,0,0,0
Sierra Leone,09/07/2005,4,0,0,0,0,0,0,4
Sierra Leone,11/07/2005,0,0,0,0,0,2,0,2
Sierra Leone,12/07/2005,1,0,0,0,-3,1,0,-1
Sierra Leone,13/07/2005,2,0,0,0,12,6,0,20
Sierra Leone,14/07/2005,1,0,0,0,0,0,0,1
Sierra Leone,15/07/2005,0,0,0,0,6,0,0,6
Sierra Leone,16/07/2005,-1,0,-1,0,0,0,0,-2
Sierra Leone,18/07/2005,4,0,0,0,0,0,0,4
Sierra Leone,19/07/2005,5,0,0,0,0,1,0,6
Sierra Leone,20/07/2005,1,0,0,0,3,0,0,4
Sierra Leone,21/07/2005,0,0,0,0,3,0,0,3
Sierra Leone,22/07/2005,20,0,0,0,3,0,0,23
Sierra Leone,25/07/2005,0,0,0,0,0,0,0,0
Sierra Leone,26/07/2005,6,0,0,0,0,1,0,7
Sierra Leone,27/07/2005,11,0,3,0,-3,0,0,11
Sierra Leone,28/07/2005,0,0,0,0,0,0,0,0
Sierra Leone,29/07/2005,8,0,0,0,0,0,0,8
Sierra Leone,30/07/2005,0,0,0,0,0,0,0,0
Sierra Leone,31/07/2005,0,0,0,0,0,0,0,0
Sierra Leone,01/08/2005,2,2,0,0,0,0,0,4
Sierra Leone,02/08/2005,0,0,0,0,0,0,0,0
Sierra Leone,03/08/2005,6,2,0,0,0,0,0,8
Sierra Leone,04/08/2005,3,0,0,0,18,0,0,21
Sierra Leone,05/08/2005,6,0,0,0,15,2,0,23
Sierra Leone,08/08/2005,0,0,0,0,0,0,0,0
Sierra Leone,09/08/2005,0,0,0,0,3,0,0,3
Sierra Leone,11/08/2005,0,0,0,0,0,0,0,0
Sierra Leone,12/08/2005,-2,0,0,0,0,0,0,-2
Sierra Leone,15/08/2005,0,0,0,0,3,0,0,3
Sierra Leone,16/08/2005,3,0,0,0,0,0,0,3
Sierra Leone,17/08/2005,4,0,0,0,0,0,0,4
Sierra Leone,18/08/2005,0,0,0,0,0,4,0,4
Sierra Leone,19/08/2005,0,0,0,0,6,2,0,8
Sierra Leone,21/08/2005,0,0,0,0,0,0,0,0
Sierra Leone,22/08/2005,0,0,0,0,-2,0,0,-2
Sierra Leone,23/08/2005,-3,0,0,0,0,5,0,2
Sierra Leone,24/08/2005,1,0,0,0,0,0,0,1
Sierra Leone,25/08/2005,6,0,0,0,0,0,0,6
Sierra Leone,26/08/2005,0,0,0,0,0,0,0,0
Sierra Leone,28/08/2005,0,0,0,0,0,0,0,0
Sierra Leone,29/08/2005,3,0,0,0,3,0,0,6
Sierra Leone,30/08/2005,1,0,0,0,0,0,0,1
Sierra Leone,31/08/2005,5,0,0,0,7,2,0,14
Sierra Leone,01/09/2005,4,0,0,0,0,0,0,4
Sierra Leone,02/09/2005,1,0,0,0,0,0,0,1
Sierra Leone,03/09/2005,1,0,0,0,0,0,0,1
Sierra Leone,05/09/2005,0,0,0,0,0,0,0,0
Sierra Leone,06/09/2005,0,0,0,0,0,0,0,0
Sierra Leone,07/09/2005,0,0,0,0,0,0,0,0
Sierra Leone,09/09/2005,8,0,0,0,3,1,0,12
Sierra Leone,12/09/2005,2,0,0,0,0,0,0,2
Sierra Leone,14/09/2005,0,0,0,0,3,0,0,3
Sierra Leone,15/09/2005,3,0,0,0,12,2,0,17
Sierra Leone,16/09/2005,1,0,0,0,0,0,0,1
Sierra Leone,17/09/2005,0,0,0,0,0,0,0,0
Sierra Leone,18/09/2005,0,0,0,0,0,0,0,0
Sierra Leone,19/09/2005,0,0,0,0,3,0,0,3
Sierra Leone,20/09/2005,0,0,0,0,3,0,0,3
Sierra Leone,21/09/2005,5,0,0,0,0,2,0,7
Sierra Leone,22/09/2005,0,0,0,0,0,5,0,5
Sierra Leone,23/09/2005,0,0,0,0,0,0,0,0
Sierra Leone,28/09/2005,7,0,0,0,0,0,0,7
Sierra Leone,29/09/2005,0,0,0,0,0,0,0,0
Sierra Leone,30/09/2005,5,0,0,0,6,0,0,11
Sierra Leone,01/10/2005,2,0,0,0,0,0,0,2
Sierra Leone,03/10/2005,0,0,0,0,0,3,0,3
Sierra Leone,04/10/2005,0,0,0,0,3,0,0,3
Sierra Leone,06/10/2005,0,4,0,0,0,0,0,4
Sierra Leone,07/10/2005,0,0,0,0,3,0,0,3
Sierra Leone,10/10/2005,-7,0,0,0,-2,0,0,-9
Sierra Leone,11/10/2005,1,0,0,0,0,0,0,1
Sierra Leone,12/10/2005,3,0,0,0,0,0,0,3
Sierra Leone,13/10/2005,-1,0,0,0,0,0,0,-1
Sierra Leone,14/10/2005,0,0,0,0,0,0,0,0
Sierra Leone,17/10/2005,2,0,0,0,6,0,0,8
Sierra Leone,18/10/2005,1,2,0,0,6,0,0,9
Sierra Leone,19/10/2005,1,2,0,0,0,4,0,7
Sierra Leone,20/10/2005,1,2,0,0,4,0,0,7
Sierra Leone,21/10/2005,1,0,0,0,0,0,0,1
Sierra Leone,24/10/2005,0,0,0,0,0,0,0,0
Sierra Leone,25/10/2005,0,0,0,0,0,0,0,0
Sierra Leone,26/10/2005,0,0,0,0,0,0,0,0
Sierra Leone,27/10/2005,0,0,0,0,0,1,0,1
Sierra Leone,28/10/2005,0,0,0,0,-2,0,0,-2
Sierra Leone,30/10/2005,0,0,0,0,0,0,0,0
Sierra Leone,31/10/2005,6,0,0,0,0,0,0,6
Sierra Leone,01/11/2005,4,0,0,0,-1,1,0,4
Sierra Leone,02/11/2005,1,0,0,0,1,1,0,3
Sierra Leone,04/11/2005,0,0,0,0,0,0,0,0
Sierra Leone,05/11/2005,0,0,0,0,0,0,0,0
Sierra Leone,06/11/2005,0,0,0,0,0,0,0,0
Sierra Leone,07/11/2005,6,0,-1,0,6,0,0,11
Sierra Leone,08/11/2005,6,0,0,0,0,0,0,6
Sierra Leone,09/11/2005,0,0,0,0,0,0,0,0
Sierra Leone,10/11/2005,5,0,0,0,0,0,0,5
Sierra Leone,11/11/2005,1,0,0,0,0,0,0,1
Sierra Leone,14/11/2005,0,0,-2,0,5,0,0,3
Sierra Leone,15/11/2005,0,0,0,0,0,2,0,2
Sierra Leone,16/11/2005,0,0,0,0,6,0,0,6
Sierra Leone,17/11/2005,-1,0,0,0,0,0,0,-1
Sierra Leone,18/11/2005,0,0,0,0,9,0,0,9
Sierra Leone,19/11/2005,0,0,0,0,0,0,0,0
Sierra Leone,21/11/2005,5,0,0,0,10,0,0,15
Sierra Leone,22/11/2005,0,0,0,0,3,0,0,3
Sierra Leone,23/11/2005,2,0,0,0,3,1,0,6
Sierra Leone,24/11/2005,0,0,0,0,0,0,0,0
Sierra Leone,25/11/2005,0,0,0,0,9,0,0,9
Sierra Leone,28/11/2005,-1,0,0,0,0,0,0,-1
Sierra Leone,29/11/2005,-3,0,0,0,-2,0,0,-5
Sierra Leone,30/11/2005,11,0,0,0,-2,0,0,9
Sierra Leone,01/12/2005,2,0,0,0,0,0,0,2
Sierra Leone,02/12/2005,1,0,0,0,0,0,0,1
Sierra Leone,04/12/2005,0,0,0,0,3,0,0,3
Sierra Leone,05/12/2005,0,0,0,0,0,0,0,0
Sierra Leone,06/12/2005,8,0,0,0,4,0,0,12
Sierra Leone,07/12/2005,2,0,0,0,0,0,0,2
Sierra Leone,08/12/2005,2,0,0,0,0,0,0,2
Sierra Leone,09/12/2005,0,0,0,0,0,0,0,0
Sierra Leone,10/12/2005,0,0,0,0,3,0,0,3
Sierra Leone,12/12/2005,0,0,0,0,-2,0,0,-2
Sierra Leone,13/12/2005,2,0,0,0,0,0,0,2
Sierra Leone,14/12/2005,2,0,0,0,-2,0,0,0
Sierra Leone,15/12/2005,4,0,0,0,9,0,0,13
Sierra Leone,16/12/2005,-1,0,0,0,0,0,0,-1
Sierra Leone,18/12/2005,0,0,0,0,0,0,0,0
Sierra Leone,19/12/2005,2,0,0,0,0,0,0,2
Sierra Leone,20/12/2005,0,0,0,0,-10,0,0,-10
Sierra Leone,21/12/2005,-1,0,0,0,3,0,0,2
Sierra Leone,22/12/2005,-3,0,0,0,6,0,0,3
Sierra Leone,23/12/2005,0,0,0,0,0,0,0,0
Sierra Leone,24/12/2005,0,0,0,0,0,0,0,0
Sierra Leone,25/12/2005,0,0,0,0,0,0,0,0
Sierra Leone,28/12/2005,0,0,0,0,0,0,0,0
Sierra Leone,30/12/2005,0,0,0,0,3,0,0,3
Somalia,01/01/2005,8,0,0,0,0,0,0,8
Somalia,02/01/2005,4,0,0,0,0,0,0,4
Somalia,03/01/2005,32,0,0,0,0,0,0,32
Somalia,04/01/2005,2,2,0,0,0,0,0,4
Somalia,05/01/2005,2,0,0,0,0,0,0,2
Somalia,06/01/2005,8,4,0,0,-2,0,0,10
Somalia,07/01/2005,9,0,0,0,0,0,0,9
Somalia,08/01/2005,2,0,0,0,0,0,0,2
Somalia,09/01/2005,0,0,0,0,0,0,0,0
Somalia,10/01/2005,21,2,0,0,5,0,0,28
Somalia,11/01/2005,-1,0,1,0,3,2,0,5
Somalia,12/01/2005,15,0,0,0,0,0,0,15
Somalia,13/01/2005,4,0,0,0,3,0,0,7
Somalia,14/01/2005,0,0,0,0,0,0,0,0
Somalia,15/01/2005,0,0,0,0,0,2,0,2
Somalia,16/01/2005,3,0,0,0,0,0,0,3
Somalia,17/01/2005,4,0,0,0,0,0,0,4
Somalia,18/01/2005,2,0,0,0,3,0,0,5
Somalia,19/01/2005,0,0,0,0,0,0,0,0
Somalia,20/01/2005,0,0,0,0,0,0,0,0
Somalia,21/01/2005,5,0,0,0,0,0,0,5
Somalia,22/01/2005,3,0,0,0,0,3,0,6
Somalia,23/01/2005,0,0,0,0,0,1,0,1
Somalia,24/01/2005,0,0,0,0,0,0,0,0
Somalia,25/01/2005,2,0,0,0,0,0,0,2
Somalia,26/01/2005,2,0,0,0,3,0,0,5
Somalia,27/01/2005,1,0,0,0,0,0,0,1
Somalia,28/01/2005,-3,0,0,0,0,0,0,-3
Somalia,29/01/2005,0,0,0,0,9,0,0,9
Somalia,30/01/2005,0,0,0,0,-2,0,0,-2
Somalia,31/01/2005,4,0,0,0,0,0,0,4
Somalia,01/02/2005,0,0,0,0,0,0,0,0
Somalia,02/02/2005,3,0,0,0,0,0,0,3
Somalia,03/02/2005,2,0,0,0,-4,0,0,-2
Somalia,04/02/2005,2,0,0,0,0,0,0,2
Somalia,05/02/2005,6,0,0,0,0,0,0,6
Somalia,06/02/2005,0,0,0,0,0,0,0,0
Somalia,07/02/2005,0,0,0,0,0,0,0,0
Somalia,08/02/2005,4,0,0,0,1,0,0,5
Somalia,09/02/2005,-1,0,0,0,0,4,0,3
Somalia,10/02/2005,2,0,0,0,0,0,0,2
Somalia,11/02/2005,0,0,0,0,0,0,0,0
Somalia,12/02/2005,0,0,0,0,-2,0,0,-2
Somalia,13/02/2005,0,0,0,0,0,0,0,0
Somalia,14/02/2005,2,0,0,0,0,0,0,2
Somalia,15/02/2005,2,0,0,0,0,0,0,2
Somalia,16/02/2005,-1,0,0,0,0,0,0,-1
Somalia,17/02/2005,3,0,0,0,0,0,0,3
Somalia,18/02/2005,6,0,0,0,0,0,0,6
Somalia,20/02/2005,2,0,0,0,0,4,0,6
Somalia,21/02/2005,1,0,0,0,4,0,0,5
Somalia,22/02/2005,12,0,0,0,3,0,0,15
Somalia,23/02/2005,0,0,0,0,0,0,0,0
Somalia,24/02/2005,7,0,0,0,0,1,0,8
Somalia,25/02/2005,6,0,0,0,0,0,0,6
Somalia,26/02/2005,6,0,0,0,0,0,0,6
Somalia,28/02/2005,2,0,0,0,0,0,0,2
Somalia,01/03/2005,8,0,0,0,0,0,0,8
Somalia,02/03/2005,5,0,0,0,0,0,0,5
Somalia,03/03/2005,4,0,0,0,0,0,0,4
Somalia,04/03/2005,3,0,0,0,3,0,0,6
Somalia,05/03/2005,1,0,0,0,0,0,0,1
Somalia,06/03/2005,0,0,0,0,0,0,0,0
Somalia,07/03/2005,1,0,0,0,0,0,0,1
Somalia,08/03/2005,16,0,0,0,0,0,0,16
Somalia,09/03/2005,8,0,0,0,0,2,0,10
Somalia,10/03/2005,1,0,0,0,0,0,0,1
Somalia,11/03/2005,0,0,0,0,-4,0,0,-4
Somalia,12/03/2005,1,0,0,0,0,0,0,1
Somalia,13/03/2005,2,0,0,0,0,0,0,2
Somalia,14/03/2005,2,0,0,0,-4,0,0,-2
Somalia,15/03/2005,32,0,0,0,0,0,0,32
Somalia,16/03/2005,23,0,0,0,3,5,0,31
Somalia,17/03/2005,9,0,0,0,1,0,0,10
Somalia,18/03/2005,4,4,0,0,3,2,0,13
Somalia,19/03/2005,3,0,0,0,17,2,0,22
Somalia,20/03/2005,4,0,0,0,-4,2,0,2
Somalia,21/03/2005,1,0,0,0,3,1,0,5
Somalia,22/03/2005,6,0,0,0,6,2,0,14
Somalia,23/03/2005,3,0,0,0,0,0,0,3
Somalia,24/03/2005,15,0,0,0,0,0,0,15
Somalia,25/03/2005,3,0,0,0,0,0,0,3
Somalia,26/03/2005,0,0,0,0,0,0,0,0
Somalia,27/03/2005,10,0,0,0,0,3,0,13
Somalia,28/03/2005,3,0,0,0,0,0,0,3
Somalia,29/03/2005,0,0,0,0,0,0,0,0
Somalia,30/03/2005,15,0,0,0,0,0,0,15
Somalia,31/03/2005,-1,0,0,0,0,0,0,-1
Somalia,04/04/2005,0,0,0,0,6,0,0,6
Somalia,05/04/2005,0,0,0,0,0,0,0,0
Somalia,06/04/2005,0,0,0,0,0,0,0,0
Somalia,07/04/2005,6,0,0,0,0,0,0,6
Somalia,08/04/2005,0,0,0,0,0,2,0,2
Somalia,09/04/2005,7,0,0,0,3,0,0,10
Somalia,10/04/2005,2,0,0,0,0,0,0,2
Somalia,11/04/2005,11,0,0,0,3,0,0,14
Somalia,12/04/2005,3,0,1,0,-2,0,0,2
Somalia,13/04/2005,0,0,0,0,0,0,0,0
Somalia,14/04/2005,3,0,0,0,0,2,0,5
Somalia,15/04/2005,0,0,0,0,0,0,0,0
Somalia,16/04/2005,0,0,0,0,0,0,0,0
Somalia,17/04/2005,0,0,0,0,0,0,0,0
Somalia,18/04/2005,-7,0,0,0,0,0,0,-7
Somalia,19/04/2005,1,0,0,0,3,0,0,4
Somalia,20/04/2005,0,0,0,0,0,0,0,0
Somalia,21/04/2005,0,0,0,0,1,0,0,1
Somalia,22/04/2005,1,0,0,0,3,0,0,4
Somalia,23/04/2005,3,0,0,0,-2,0,0,1
Somalia,25/04/2005,3,0,0,0,0,0,0,3
Somalia,26/04/2005,0,0,0,0,0,0,0,0
Somalia,27/04/2005,0,0,1,0,0,0,0,1
Somalia,28/04/2005,9,0,0,0,0,0,0,9
Somalia,29/04/2005,0,0,0,0,0,0,0,0
Somalia,30/04/2005,2,0,0,0,0,0,0,2
Somalia,01/05/2005,3,0,0,0,0,0,0,3
Somalia,02/05/2005,4,0,0,0,0,0,0,4
Somalia,03/05/2005,0,0,0,0,0,0,0,0
Somalia,04/05/2005,0,0,0,0,0,0,0,0
Somalia,05/05/2005,3,0,0,0,0,0,0,3
Somalia,06/05/2005,-1,0,0,0,0,0,0,-1
Somalia,07/05/2005,0,0,0,0,0,0,0,0
Somalia,08/05/2005,0,0,0,0,0,0,0,0
Somalia,09/05/2005,-1,0,0,0,0,0,0,-1
Somalia,10/05/2005,0,0,0,0,0,0,0,0
Somalia,11/05/2005,0,0,0,0,0,0,0,0
Somalia,12/05/2005,0,0,0,0,0,0,0,0
Somalia,14/05/2005,1,0,0,0,0,1,0,2
Somalia,15/05/2005,2,0,0,0,0,2,0,4
Somalia,16/05/2005,1,0,0,0,0,0,0,1
Somalia,17/05/2005,0,0,0,0,0,1,0,1
Somalia,19/05/2005,0,0,0,0,0,2,0,2
Somalia,20/05/2005,-4,0,0,0,0,0,0,-4
Somalia,22/05/2005,0,0,0,0,0,0,0,0
Somalia,23/05/2005,0,0,0,0,0,0,0,0
Somalia,24/05/2005,3,0,0,0,9,0,0,12
Somalia,25/05/2005,2,0,0,0,0,0,0,2
Somalia,26/05/2005,0,0,0,0,0,0,0,0
Somalia,27/05/2005,4,0,0,0,0,0,0,4
Somalia,28/05/2005,2,0,0,0,0,0,0,2
Somalia,29/05/2005,0,0,0,0,0,0,0,0
Somalia,30/05/2005,0,0,0,0,1,0,0,1
Somalia,31/05/2005,0,0,0,0,0,0,0,0
Somalia,01/06/2005,1,0,0,0,0,0,0,1
Somalia,02/06/2005,0,4,0,0,0,0,0,4
Somalia,03/06/2005,0,0,0,0,0,0,0,0
Somalia,06/06/2005,9,0,0,0,0,0,0,9
Somalia,07/06/2005,0,0,0,0,3,0,0,3
Somalia,08/06/2005,-2,2,0,0,-6,0,0,-6
Somalia,09/06/2005,0,0,0,0,3,0,0,3
Somalia,10/06/2005,0,0,0,0,0,0,0,0
Somalia,11/06/2005,-1,0,0,0,0,0,0,-1
Somalia,12/06/2005,-2,0,0,0,0,0,0,-2
Somalia,13/06/2005,0,0,0,0,0,0,0,0
Somalia,14/06/2005,-1,0,0,0,3,0,0,2
Somalia,15/06/2005,0,0,0,0,-2,0,0,-2
Somalia,16/06/2005,1,0,0,0,0,0,0,1
Somalia,18/06/2005,1,0,0,0,0,0,0,1
Somalia,19/06/2005,3,0,0,0,6,0,0,9
Somalia,20/06/2005,0,0,0,0,0,0,0,0
Somalia,21/06/2005,0,0,0,0,0,0,0,0
Somalia,22/06/2005,3,0,0,0,0,0,0,3
Somalia,23/06/2005,0,0,0,0,1,0,0,1
Somalia,24/06/2005,0,0,0,0,4,0,0,4
Somalia,25/06/2005,0,0,0,0,0,0,0,0
Somalia,26/06/2005,-1,0,0,0,0,0,0,-1
Somalia,27/06/2005,0,0,0,0,0,0,0,0
Somalia,28/06/2005,14,0,0,0,0,2,0,16
Somalia,29/06/2005,0,0,0,0,0,0,0,0
Somalia,30/06/2005,0,0,0,0,3,2,0,5
Somalia,02/07/2005,3,0,0,0,6,0,0,9
Somalia,03/07/2005,0,0,0,0,1,0,0,1
Somalia,04/07/2005,0,0,0,0,0,0,0,0
Somalia,05/07/2005,0,0,0,0,3,2,0,5
Somalia,06/07/2005,1,0,0,0,0,0,0,1
Somalia,07/07/2005,6,0,0,0,6,0,0,12
Somalia,08/07/2005,0,0,0,0,2,0,0,2
Somalia,09/07/2005,7,0,0,0,0,0,0,7
Somalia,10/07/2005,0,0,0,0,0,0,0,0
Somalia,11/07/2005,9,0,0,0,0,0,0,9
Somalia,12/07/2005,3,0,0,0,0,0,0,3
Somalia,13/07/2005,8,0,0,0,0,0,0,8
Somalia,14/07/2005,0,0,0,0,3,0,0,3
Somalia,15/07/2005,0,0,0,0,0,0,0,0
Somalia,16/07/2005,3,0,0,0,-2,0,0,1
Somalia,17/07/2005,0,0,0,0,1,0,0,1
Somalia,18/07/2005,0,0,0,0,3,0,0,3
Somalia,19/07/2005,0,0,0,0,0,0,0,0
Somalia,20/07/2005,0,0,0,0,-2,0,0,-2
Somalia,21/07/2005,3,0,0,0,1,6,0,10
Somalia,22/07/2005,0,0,0,0,0,0,0,0
Somalia,23/07/2005,0,0,0,0,3,0,0,3
Somalia,24/07/2005,1,0,0,0,3,0,0,4
Somalia,25/07/2005,23,0,0,0,9,2,0,34
Somalia,26/07/2005,11,0,0,0,3,0,0,14
Somalia,27/07/2005,12,0,0,0,12,0,0,24
Somalia,28/07/2005,12,0,0,0,16,1,0,29
Somalia,29/07/2005,15,0,0,0,18,6,0,39
Somalia,30/07/2005,0,0,0,0,21,0,0,21
Somalia,31/07/2005,1,0,0,0,0,0,0,1
Somalia,01/08/2005,0,0,1,0,0,0,0,1
Somalia,02/08/2005,0,0,0,0,0,0,0,0
Somalia,03/08/2005,6,0,0,0,0,0,0,6
Somalia,04/08/2005,1,0,0,0,0,1,0,2
Somalia,05/08/2005,-3,0,0,0,0,0,0,-3
Somalia,06/08/2005,-2,0,0,0,3,0,0,1
Somalia,07/08/2005,1,0,-2,0,0,0,0,-1
Somalia,08/08/2005,0,0,0,0,0,0,0,0
Somalia,09/08/2005,6,0,0,0,3,4,0,13
Somalia,10/08/2005,6,0,0,0,0,0,0,6
Somalia,11/08/2005,2,0,0,0,0,4,0,6
Somalia,13/08/2005,0,0,0,0,0,0,0,0
Somalia,14/08/2005,0,0,0,0,0,0,0,0
Somalia,15/08/2005,5,0,0,0,0,0,0,5
Somalia,16/08/2005,4,0,0,0,6,2,0,12
Somalia,17/08/2005,1,0,0,0,-8,2,0,-5
Somalia,19/08/2005,11,0,0,0,0,2,0,13
Somalia,20/08/2005,0,0,0,0,0,0,0,0
Somalia,21/08/2005,4,0,0,0,5,0,0,9
Somalia,22/08/2005,6,0,0,0,0,0,0,6
Somalia,23/08/2005,0,0,0,0,0,0,0,0
Somalia,24/08/2005,1,0,0,0,-2,0,0,-1
Somalia,25/08/2005,1,0,0,0,0,0,0,1
Somalia,26/08/2005,21,0,0,0,0,0,0,21
Somalia,27/08/2005,1,0,0,0,0,0,0,1
Somalia,28/08/2005,0,0,0,0,3,1,0,4
Somalia,29/08/2005,3,0,0,0,0,0,0,3
Somalia,30/08/2005,6,2,-2,0,9,0,0,15
Somalia,31/08/2005,6,0,0,0,7,0,0,13
Somalia,01/09/2005,7,0,0,0,-9,0,0,-2
Somalia,02/09/2005,1,0,0,0,-6,0,0,-5
Somalia,04/09/2005,0,0,0,0,0,0,0,0
Somalia,05/09/2005,4,0,0,0,0,0,0,4
Somalia,06/09/2005,4,0,0,0,9,0,0,13
Somalia,07/09/2005,-2,0,0,0,8,0,0,6
Somalia,08/09/2005,0,0,0,0,0,2,0,2
Somalia,09/09/2005,-2,0,0,0,0,0,0,-2
Somalia,10/09/2005,0,0,0,0,0,0,0,0
Somalia,11/09/2005,15,0,0,0,0,0,0,15
Somalia,12/09/2005,3,0,0,0,3,0,0,6
Somalia,13/09/2005,2,0,0,0,3,0,0,5
Somalia,14/09/2005,0,0,0,0,3,0,0,3
Somalia,15/09/2005,2,0,0,0,0,0,0,2
Somalia,16/09/2005,0,0,0,0,0,0,0,0
Somalia,17/09/2005,0,0,0,0,0,0,0,0
Somalia,18/09/2005,0,0,0,0,0,0,0,0
Somalia,19/09/2005,-1,0,0,0,1,0,0,0
Somalia,20/09/2005,0,0,0,0,6,0,0,6
Somalia,21/09/2005,5,2,0,0,2,0,0,9
Somalia,22/09/2005,0,0,0,0,0,0,0,0
Somalia,24/09/2005,0,0,0,0,0,0,0,0
Somalia,27/09/2005,0,0,1,0,13,0,0,14
Somalia,28/09/2005,2,0,0,0,0,0,0,2
Somalia,29/09/2005,0,0,0,0,0,0,0,0
Somalia,30/09/2005,0,0,0,0,0,0,0,0
Somalia,01/10/2005,-1,0,0,0,3,0,0,2
Somalia,03/10/2005,3,0,0,0,0,0,0,3
Somalia,04/10/2005,0,0,0,0,0,0,0,0
Somalia,05/10/2005,0,0,0,0,0,0,0,0
Somalia,06/10/2005,0,0,0,0,-4,0,0,-4
Somalia,07/10/2005,0,0,0,0,0,0,0,0
Somalia,08/10/2005,2,0,0,0,0,0,0,2
Somalia,09/10/2005,0,0,0,0,3,0,0,3
Somalia,10/10/2005,0,0,0,0,9,0,0,9
Somalia,11/10/2005,0,4,1,0,0,0,0,5
Somalia,12/10/2005,0,0,0,0,10,0,0,10
Somalia,13/10/2005,0,4,0,0,12,0,0,16
Somalia,14/10/2005,2,0,0,0,3,0,0,5
Somalia,15/10/2005,0,0,0,0,-6,0,0,-6
Somalia,16/10/2005,0,0,0,0,0,0,0,0
Somalia,17/10/2005,0,0,0,0,3,0,0,3
Somalia,18/10/2005,4,0,0,0,-1,0,0,3
Somalia,19/10/2005,3,0,0,0,0,0,0,3
Somalia,20/10/2005,6,0,0,0,-4,0,0,2
Somalia,21/10/2005,3,0,0,0,0,0,0,3
Somalia,22/10/2005,3,2,0,0,6,0,0,11
Somalia,23/10/2005,0,0,0,0,0,0,0,0
Somalia,24/10/2005,2,0,0,0,4,0,0,6
Somalia,25/10/2005,7,0,0,0,12,0,0,19
Somalia,26/10/2005,7,0,0,0,0,0,0,7
Somalia,27/10/2005,0,0,0,0,-4,0,0,-4
Somalia,28/10/2005,9,0,0,0,-5,0,0,4
Somalia,29/10/2005,2,0,0,0,0,0,0,2
Somalia,30/10/2005,1,0,0,0,0,0,0,1
Somalia,31/10/2005,3,0,0,0,3,0,0,6
Somalia,02/11/2005,0,0,0,0,0,0,0,0
Somalia,04/11/2005,3,0,0,0,-2,0,0,1
Somalia,05/11/2005,12,0,0,0,0,0,0,12
Somalia,06/11/2005,5,0,0,0,0,0,0,5
Somalia,07/11/2005,3,0,0,0,0,0,0,3
Somalia,08/11/2005,5,0,0,0,0,2,0,7
Somalia,09/11/2005,3,0,0,0,0,0,0,3
Somalia,10/11/2005,5,2,0,0,-1,0,0,6
Somalia,11/11/2005,-6,0,0,0,3,0,0,-3
Somalia,13/11/2005,0,0,0,0,0,0,0,0
Somalia,14/11/2005,1,0,0,0,0,0,0,1
Somalia,15/11/2005,0,0,0,0,3,0,0,3
Somalia,16/11/2005,3,0,0,0,0,0,0,3
Somalia,17/11/2005,14,0,0,0,0,0,0,14
Somalia,18/11/2005,3,0,0,0,0,0,0,3
Somalia,19/11/2005,0,0,0,0,-4,1,0,-3
Somalia,20/11/2005,0,0,0,0,-4,0,0,-4
Somalia,21/11/2005,0,0,0,0,0,0,0,0
Somalia,22/11/2005,0,0,0,0,0,0,0,0
Somalia,23/11/2005,0,0,0,0,0,0,0,0
Somalia,24/11/2005,-1,0,0,0,0,0,0,-1
Somalia,25/11/2005,26,0,0,0,0,2,0,28
Somalia,26/11/2005,1,0,0,0,0,0,0,1
Somalia,27/11/2005,4,0,0,0,-9,1,0,-4
Somalia,28/11/2005,2,0,0,0,2,0,0,4
Somalia,29/11/2005,0,0,0,0,3,0,0,3
Somalia,30/11/2005,0,0,0,0,3,0,0,3
Somalia,01/12/2005,0,0,0,0,-8,0,0,-8
Somalia,02/12/2005,0,0,0,0,6,0,0,6
Somalia,03/12/2005,3,0,0,0,0,1,0,4
Somalia,05/12/2005,0,0,0,0,0,0,0,0
Somalia,06/12/2005,3,0,0,0,-6,0,0,-3
Somalia,07/12/2005,0,0,0,0,-4,0,0,-4
Somalia,08/12/2005,0,0,0,0,3,0,0,3
Somalia,09/12/2005,2,2,0,0,0,0,0,4
Somalia,10/12/2005,-1,0,-6,0,14,0,0,7
Somalia,11/12/2005,0,0,0,0,0,0,0,0
Somalia,12/12/2005,0,0,0,0,0,0,0,0
Somalia,13/12/2005,2,0,0,0,0,0,0,2
Somalia,14/12/2005,0,2,0,0,0,0,0,2
Somalia,15/12/2005,1,0,0,0,0,0,0,1
Somalia,16/12/2005,-3,0,0,0,0,0,0,-3
Somalia,18/12/2005,33,0,0,0,6,2,0,41
Somalia,20/12/2005,0,0,0,0,0,0,0,0
Somalia,21/12/2005,0,0,0,0,0,0,0,0
Somalia,22/12/2005,0,0,0,0,0,0,0,0
Somalia,25/12/2005,2,0,0,0,0,0,0,2
Somalia,26/12/2005,0,0,0,0,0,0,0,0
Somalia,27/12/2005,0,0,0,0,-3,0,0,-3
Somalia,28/12/2005,3,0,0,0,0,0,0,3
Somalia,29/12/2005,6,0,0,0,-4,0,0,2
Somalia,30/12/2005,27,0,0,0,0,0,0,27
Somalia,31/12/2005,0,0,-2,0,0,0,0,-2
Syria,01/01/2005,4,0,0,0,0,0,0,4
Syria,02/01/2005,3,0,-8,0,0,0,0,-5
Syria,03/01/2005,6,0,0,0,0,0,0,6
Syria,04/01/2005,2,0,0,0,-3,0,0,-1
Syria,05/01/2005,12,0,0,0,0,0,0,12
Syria,06/01/2005,4,0,-1,0,6,0,0,9
Syria,07/01/2005,8,0,0,0,0,1,0,9
Syria,08/01/2005,-8,0,0,0,0,-4,0,-12
Syria,09/01/2005,12,0,0,0,0,0,0,12
Syria,10/01/2005,13,0,0,0,0,0,0,13
Syria,11/01/2005,13,0,0,0,7,2,0,22
Syria,12/01/2005,-1,0,0,0,24,0,0,23
Syria,13/01/2005,7,0,0,0,0,0,0,7
Syria,14/01/2005,22,0,0,0,0,2,0,24
Syria,15/01/2005,15,0,0,0,0,0,0,15
Syria,16/01/2005,7,0,0,0,6,1,0,14
Syria,17/01/2005,11,0,0,0,9,1,0,21
Syria,18/01/2005,2,0,0,0,-4,0,0,-2
Syria,19/01/2005,0,0,0,0,2,0,0,2
Syria,20/01/2005,7,0,0,0,0,0,0,7
Syria,21/01/2005,2,0,0,0,0,0,0,2
Syria,22/01/2005,6,0,0,0,6,0,0,12
Syria,23/01/2005,1,0,0,0,0,1,0,2
Syria,24/01/2005,7,0,0,0,0,2,0,9
Syria,25/01/2005,0,0,0,0,0,1,0,1
Syria,26/01/2005,2,0,0,0,9,0,0,11
Syria,27/01/2005,4,0,0,0,-2,0,0,2
Syria,28/01/2005,4,0,0,0,0,0,0,4
Syria,29/01/2005,8,0,0,0,0,0,0,8
Syria,30/01/2005,13,0,0,0,6,10,0,29
Syria,31/01/2005,5,0,0,0,3,1,0,9
Syria,01/02/2005,7,0,0,0,12,0,0,19
Syria,02/02/2005,7,0,0,0,0,0,0,7
Syria,03/02/2005,-4,0,0,0,0,0,0,-4
Syria,04/02/2005,-3,0,0,0,0,0,0,-3
Syria,05/02/2005,-6,0,0,0,6,0,0,0
Syria,06/02/2005,4,0,3,0,2,0,0,9
Syria,07/02/2005,2,0,0,0,0,0,0,2
Syria,08/02/2005,4,0,0,0,6,0,0,10
Syria,09/02/2005,8,0,0,0,0,1,0,9
Syria,10/02/2005,0,0,0,0,3,0,0,3
Syria,11/02/2005,1,0,0,0,0,0,0,1
Syria,12/02/2005,-3,0,0,0,0,0,0,-3
Syria,13/02/2005,6,0,0,0,6,3,0,15
Syria,14/02/2005,24,0,0,0,1,6,0,31
Syria,15/02/2005,18,0,-1,0,0,0,0,17
Syria,16/02/2005,10,0,0,0,0,2,0,12
Syria,17/02/2005,11,0,0,0,12,5,0,28
Syria,18/02/2005,27,0,-6,0,15,0,0,36
Syria,19/02/2005,2,0,2,0,21,4,0,29
Syria,20/02/2005,-4,0,3,0,0,0,0,-1
Syria,21/02/2005,-15,0,0,0,2,2,0,-11
Syria,22/02/2005,2,0,0,0,0,3,0,5
Syria,23/02/2005,14,0,0,0,0,2,0,16
Syria,24/02/2005,-7,0,0,0,0,1,0,-6
Syria,25/02/2005,-13,0,0,0,9,0,0,-4
Syria,26/02/2005,-1,0,0,0,0,5,0,4
Syria,27/02/2005,11,0,0,0,1,1,0,13
Syria,28/02/2005,-8,0,-9,0,12,5,0,0
Syria,01/03/2005,25,0,2,0,20,6,0,53
Syria,02/03/2005,-19,0,-2,0,5,0,0,-16
Syria,03/03/2005,-18,0,-8,0,3,0,0,-23
Syria,04/03/2005,0,0,0,0,3,0,0,3
Syria,05/03/2005,-26,0,0,0,3,2,0,-21
Syria,06/03/2005,-5,0,0,0,4,3,0,2
Syria,07/03/2005,-5,0,0,0,4,2,0,1
Syria,08/03/2005,6,0,2,0,3,0,0,11
Syria,09/03/2005,0,0,0,0,0,1,0,1
Syria,10/03/2005,5,0,-10,0,-2,0,0,-7
Syria,11/03/2005,-5,0,-3,0,0,5,0,-3
Syria,12/03/2005,-16,0,-4,0,18,4,0,2
Syria,13/03/2005,1,0,0,0,6,8,0,15
Syria,14/03/2005,-3,0,-2,0,3,13,0,11
Syria,15/03/2005,-4,0,0,0,0,8,0,4
Syria,16/03/2005,-29,0,0,0,9,7,0,-13
Syria,17/03/2005,-41,0,-3,0,0,8,0,-36
Syria,18/03/2005,-2,0,0,0,-2,0,0,-4
Syria,19/03/2005,-16,0,-2,0,12,0,0,-6
Syria,20/03/2005,-8,0,0,0,0,0,0,-8
Syria,21/03/2005,13,0,0,0,3,0,0,16
Syria,22/03/2005,13,0,-6,0,3,0,0,10
Syria,23/03/2005,12,0,1,0,6,0,0,19
Syria,24/03/2005,-26,0,0,0,0,0,0,-26
Syria,25/03/2005,-7,0,0,0,0,0,0,-7
Syria,26/03/2005,-3,0,1,0,0,0,0,-2
Syria,27/03/2005,24,0,0,0,3,0,0,27
Syria,28/03/2005,4,0,0,0,-2,0,0,2
Syria,29/03/2005,-9,0,-2,0,6,1,0,-4
Syria,30/03/2005,20,0,0,0,-4,0,0,16
Syria,31/03/2005,2,0,3,0,9,4,0,18
Syria,01/04/2005,12,0,-1,0,-2,0,0,9
Syria,02/04/2005,0,0,0,0,0,0,0,0
Syria,03/04/2005,3,0,0,0,-2,1,0,2
Syria,04/04/2005,-4,0,0,0,6,2,0,4
Syria,05/04/2005,-5,0,0,0,-6,0,0,-11
Syria,06/04/2005,5,0,1,0,4,0,0,10
Syria,07/04/2005,-9,0,0,0,0,2,0,-7
Syria,08/04/2005,4,0,0,0,0,0,0,4
Syria,09/04/2005,1,0,0,0,0,0,0,1
Syria,10/04/2005,-5,0,0,0,12,0,0,7
Syria,11/04/2005,6,0,0,0,7,5,0,18
Syria,12/04/2005,55,0,1,0,12,6,0,74
Syria,13/04/2005,15,0,0,0,6,0,0,21
Syria,14/04/2005,16,0,2,0,21,0,0,39
Syria,15/04/2005,-5,0,-2,0,0,0,0,-7
Syria,16/04/2005,6,0,0,0,0,2,0,8
Syria,17/04/2005,-6,0,0,0,0,1,0,-5
Syria,18/04/2005,-6,0,0,0,-3,0,0,-9
Syria,19/04/2005,-33,0,0,0,0,1,0,-32
Syria,20/04/2005,-4,0,0,0,0,1,0,-3
Syria,21/04/2005,12,0,0,0,3,4,0,19
Syria,22/04/2005,23,0,-1,0,9,0,0,31
Syria,23/04/2005,-3,0,0,0,0,0,0,-3
Syria,24/04/2005,-5,0,0,0,-2,0,0,-7
Syria,25/04/2005,-22,0,1,0,3,0,0,-18
Syria,26/04/2005,-18,0,0,0,5,2,0,-11
Syria,27/04/2005,-4,0,0,0,6,0,0,2
Syria,28/04/2005,4,0,0,0,7,1,0,12
Syria,29/04/2005,-11,0,-1,0,3,0,0,-9
Syria,30/04/2005,2,2,0,0,-5,0,0,-1
Syria,01/05/2005,15,0,0,0,0,0,0,15
Syria,02/05/2005,13,0,0,0,4,0,0,17
Syria,03/05/2005,23,2,0,0,-6,1,0,20
Syria,04/05/2005,12,0,0,0,8,0,0,20
Syria,05/05/2005,8,2,0,0,0,0,0,10
Syria,06/05/2005,9,0,0,0,7,1,0,17
Syria,07/05/2005,-12,0,-2,0,0,0,0,-14
Syria,08/05/2005,9,0,0,0,3,0,0,12
Syria,09/05/2005,16,0,0,0,1,2,0,19
Syria,10/05/2005,18,4,0,0,15,1,0,38
Syria,11/05/2005,16,0,0,0,0,0,0,16
Syria,12/05/2005,24,0,0,0,15,2,0,41
Syria,13/05/2005,19,0,0,0,0,3,0,22
Syria,14/05/2005,33,0,0,0,3,0,0,36
Syria,15/05/2005,9,0,0,0,-1,0,0,8
Syria,16/05/2005,19,0,0,0,0,0,0,19
Syria,17/05/2005,8,0,0,0,0,0,0,8
Syria,18/05/2005,-10,0,0,0,1,0,0,-9
Syria,19/05/2005,7,0,0,0,9,2,0,18
Syria,20/05/2005,14,0,0,0,0,0,0,14
Syria,21/05/2005,0,0,0,0,1,0,0,1
Syria,22/05/2005,5,0,0,0,9,0,0,14
Syria,23/05/2005,5,0,0,0,0,0,0,5
Syria,24/05/2005,3,0,0,0,17,0,0,20
Syria,25/05/2005,31,0,1,0,2,1,0,35
Syria,26/05/2005,25,0,0,0,1,0,0,26
Syria,27/05/2005,5,0,0,0,11,0,0,16
Syria,28/05/2005,-7,0,-4,0,4,2,0,-5
Syria,29/05/2005,0,0,1,0,8,2,0,11
Syria,30/05/2005,6,0,0,0,19,0,0,25
Syria,31/05/2005,8,0,0,0,0,0,0,8
Syria,01/06/2005,15,0,0,0,13,3,0,31
Syria,02/06/2005,8,0,1,0,0,0,0,9
Syria,03/06/2005,-1,4,0,0,3,14,0,20
Syria,04/06/2005,3,0,0,0,4,0,0,7
Syria,05/06/2005,13,0,0,0,3,0,0,16
Syria,06/06/2005,6,0,-4,0,27,2,0,31
Syria,07/06/2005,-7,0,-2,0,-1,1,0,-9
Syria,08/06/2005,3,0,-3,0,21,0,0,21
Syria,09/06/2005,32,0,1,0,3,2,0,38
Syria,10/06/2005,16,0,0,0,0,0,0,16
Syria,11/06/2005,14,0,0,0,0,0,0,14
Syria,12/06/2005,3,0,0,0,0,5,0,8
Syria,13/06/2005,12,0,0,0,9,0,0,21
Syria,14/06/2005,2,0,0,0,8,0,0,10
Syria,15/06/2005,0,0,0,0,2,0,0,2
Syria,16/06/2005,2,0,0,0,0,10,0,12
Syria,17/06/2005,19,0,0,0,6,0,0,25
Syria,18/06/2005,5,0,-4,0,6,3,0,10
Syria,19/06/2005,27,0,0,0,18,4,0,49
Syria,20/06/2005,5,0,1,0,3,6,0,15
Syria,21/06/2005,55,0,-2,0,-1,19,0,71
Syria,22/06/2005,5,0,0,0,0,2,0,7
Syria,23/06/2005,33,0,1,0,0,0,0,34
Syria,24/06/2005,20,0,1,0,3,0,0,24
Syria,25/06/2005,10,0,0,0,0,0,0,10
Syria,26/06/2005,-1,0,0,0,5,0,0,4
Syria,27/06/2005,8,0,0,0,-1,0,0,7
Syria,28/06/2005,-4,0,0,0,0,1,0,-3
Syria,29/06/2005,15,0,4,0,0,0,0,19
Syria,30/06/2005,7,0,0,0,-4,0,0,3
Syria,01/07/2005,5,0,-2,0,3,6,0,12
Syria,02/07/2005,9,0,0,0,2,0,0,11
Syria,03/07/2005,5,0,0,0,6,0,0,11
Syria,04/07/2005,8,0,0,0,15,0,0,23
Syria,05/07/2005,28,0,0,0,9,0,0,37
Syria,06/07/2005,-4,0,0,0,3,0,0,-1
Syria,07/07/2005,18,0,0,0,3,0,0,21
Syria,08/07/2005,-4,0,0,0,7,0,0,3
Syria,09/07/2005,11,0,0,0,-4,0,0,7
Syria,10/07/2005,5,0,0,0,6,18,0,29
Syria,11/07/2005,13,0,0,0,0,27,0,40
Syria,12/07/2005,16,0,0,0,15,4,0,35
Syria,13/07/2005,13,0,0,0,9,3,0,25
Syria,14/07/2005,4,0,0,0,12,2,0,18
Syria,15/07/2005,2,0,0,0,6,0,0,8
Syria,16/07/2005,9,0,0,0,0,0,0,9
Syria,17/07/2005,3,0,0,0,0,0,0,3
Syria,18/07/2005,0,0,1,0,3,0,0,4
Syria,19/07/2005,16,0,1,0,6,1,0,24
Syria,20/07/2005,12,0,0,0,-1,0,0,11
Syria,21/07/2005,2,0,0,0,3,4,0,9
Syria,22/07/2005,0,0,0,0,-2,0,0,-2
Syria,23/07/2005,1,0,0,0,0,0,0,1
Syria,24/07/2005,0,0,0,0,3,0,0,3
Syria,25/07/2005,7,0,0,0,0,0,0,7
Syria,26/07/2005,17,0,0,0,3,0,0,20
Syria,27/07/2005,0,0,0,0,3,0,0,3
Syria,28/07/2005,9,0,0,0,3,1,0,13
Syria,29/07/2005,24,0,0,0,3,0,0,27
Syria,30/07/2005,9,0,0,0,3,0,0,12
Syria,31/07/2005,10,0,0,0,0,0,0,10
Syria,01/08/2005,0,0,0,0,0,0,0,0
Syria,02/08/2005,5,0,0,0,0,0,0,5
Syria,03/08/2005,13,0,0,0,3,4,0,20
Syria,04/08/2005,3,0,0,0,0,0,0,3
Syria,05/08/2005,39,0,0,0,9,1,0,49
Syria,06/08/2005,-2,0,0,0,0,0,0,-2
Syria,07/08/2005,0,0,0,0,0,2,0,2
Syria,08/08/2005,6,0,-1,0,21,2,0,28
Syria,09/08/2005,14,0,0,0,3,0,0,17
Syria,10/08/2005,33,0,0,0,6,3,0,42
Syria,11/08/2005,11,0,0,0,23,0,0,34
Syria,12/08/2005,9,0,0,0,2,0,0,11
Syria,13/08/2005,5,0,0,0,0,0,0,5
Syria,14/08/2005,-3,0,0,0,0,0,0,-3
Syria,15/08/2005,0,0,0,0,6,0,0,6
Syria,16/08/2005,-1,0,0,0,0,0,0,-1
Syria,17/08/2005,-2,0,0,0,1,0,0,-1
Syria,18/08/2005,0,0,0,0,0,2,0,2
Syria,19/08/2005,0,0,0,0,0,0,0,0
Syria,20/08/2005,9,0,0,0,0,0,0,9
Syria,21/08/2005,0,0,0,0,0,0,0,0
Syria,22/08/2005,5,0,0,0,0,2,0,7
Syria,23/08/2005,20,0,0,0,2,0,0,22
Syria,24/08/2005,3,0,0,0,0,0,0,3
Syria,25/08/2005,10,0,0,0,6,0,0,16
Syria,26/08/2005,6,0,0,0,3,0,0,9
Syria,27/08/2005,6,0,0,0,4,0,0,10
Syria,28/08/2005,0,0,0,0,6,0,0,6
Syria,29/08/2005,1,0,0,0,1,0,0,2
Syria,30/08/2005,33,0,2,0,18,1,0,54
Syria,31/08/2005,18,0,0,0,3,0,0,21
Syria,01/09/2005,25,0,0,0,3,0,0,28
Syria,02/09/2005,-1,0,0,0,0,0,0,-1
Syria,03/09/2005,-1,0,0,0,0,0,0,-1
Syria,04/09/2005,0,0,0,0,3,0,0,3
Syria,05/09/2005,-3,0,0,0,0,0,0,-3
Syria,06/09/2005,5,0,0,0,2,2,0,9
Syria,07/09/2005,4,0,0,0,0,0,0,4
Syria,08/09/2005,30,0,0,0,27,3,0,60
Syria,09/09/2005,6,0,-2,0,3,3,0,10
Syria,10/09/2005,9,0,0,0,12,0,0,21
Syria,11/09/2005,12,0,0,0,12,0,0,24
Syria,12/09/2005,9,0,0,0,3,0,0,12
Syria,13/09/2005,5,0,0,0,-4,0,0,1
Syria,14/09/2005,3,0,0,0,0,2,0,5
Syria,15/09/2005,10,0,0,0,0,0,0,10
Syria,16/09/2005,7,0,0,0,12,0,0,19
Syria,17/09/2005,12,0,0,0,4,0,0,16
Syria,18/09/2005,0,0,0,0,0,0,0,0
Syria,19/09/2005,7,0,0,0,12,0,0,19
Syria,20/09/2005,13,0,0,0,7,0,0,20
Syria,21/09/2005,9,0,0,0,0,0,0,9
Syria,22/09/2005,0,0,0,0,6,0,0,6
Syria,23/09/2005,-3,0,0,0,15,0,0,12
Syria,24/09/2005,6,0,0,0,0,0,0,6
Syria,25/09/2005,-2,0,0,0,0,0,0,-2
Syria,26/09/2005,-3,0,0,0,22,0,0,19
Syria,27/09/2005,-4,0,0,0,3,0,0,-1
Syria,28/09/2005,20,0,0,0,3,0,0,23
Syria,29/09/2005,21,0,0,0,6,0,0,27
Syria,30/09/2005,5,0,0,0,0,0,0,5
Syria,01/10/2005,4,0,0,0,3,6,0,13
Syria,02/10/2005,12,0,0,0,3,0,0,15
Syria,03/10/2005,16,0,0,0,-14,0,0,2
Syria,04/10/2005,16,0,0,0,3,0,0,19
Syria,05/10/2005,4,0,-2,0,6,0,0,8
Syria,06/10/2005,1,0,0,0,6,0,0,7
Syria,07/10/2005,18,0,0,0,3,0,0,21
Syria,08/10/2005,-4,0,0,0,3,0,0,-1
Syria,09/10/2005,10,0,0,0,4,1,0,15
Syria,10/10/2005,6,0,0,0,9,0,0,15
Syria,11/10/2005,10,0,0,0,6,15,0,31
Syria,12/10/2005,33,0,0,0,3,12,0,48
Syria,13/10/2005,21,0,0,0,3,0,0,24
Syria,14/10/2005,-1,0,0,0,0,0,0,-1
Syria,15/10/2005,2,0,0,0,0,6,0,8
Syria,16/10/2005,2,0,0,0,9,0,0,11
Syria,17/10/2005,-4,0,0,0,0,0,0,-4
Syria,18/10/2005,-2,0,1,0,12,0,0,11
Syria,19/10/2005,3,0,0,0,9,0,0,12
Syria,20/10/2005,41,0,0,0,18,0,0,59
Syria,21/10/2005,23,0,1,0,6,7,0,37
Syria,22/10/2005,30,0,1,0,2,1,0,34
Syria,23/10/2005,10,0,0,0,9,0,0,19
Syria,24/10/2005,11,0,2,0,15,0,0,28
Syria,25/10/2005,29,0,-6,0,9,5,0,37
Syria,26/10/2005,42,0,0,0,21,3,0,66
Syria,27/10/2005,6,0,0,0,0,0,0,6
Syria,28/10/2005,2,0,0,0,5,0,0,7
Syria,29/10/2005,25,0,0,0,12,1,0,38
Syria,30/10/2005,16,0,-4,0,9,4,0,25
Syria,31/10/2005,16,0,0,0,0,7,0,23
Syria,01/11/2005,33,0,0,0,18,1,0,52
Syria,02/11/2005,11,2,0,0,2,4,0,19
Syria,03/11/2005,4,0,0,0,12,5,0,21
Syria,04/11/2005,0,0,0,0,0,0,0,0
Syria,05/11/2005,4,0,-6,0,18,2,0,18
Syria,06/11/2005,20,0,0,0,0,2,0,22
Syria,07/11/2005,27,0,0,0,0,0,0,27
Syria,08/11/2005,26,0,0,0,0,0,0,26
Syria,09/11/2005,5,0,0,0,6,0,0,11
Syria,10/11/2005,42,0,1,0,3,6,0,52
Syria,11/11/2005,3,0,0,0,0,1,0,4
Syria,12/11/2005,20,0,0,0,3,0,0,23
Syria,13/11/2005,6,0,1,0,6,0,0,13
Syria,14/11/2005,17,0,0,0,3,0,0,20
Syria,15/11/2005,13,0,0,0,0,6,0,19
Syria,16/11/2005,28,0,0,0,0,0,0,28
Syria,17/11/2005,6,0,0,0,12,0,0,18
Syria,18/11/2005,8,0,0,0,0,0,0,8
Syria,19/11/2005,6,0,1,0,1,0,0,8
Syria,20/11/2005,3,0,0,0,0,0,0,3
Syria,21/11/2005,15,0,0,0,0,0,0,15
Syria,22/11/2005,22,0,-2,0,6,0,0,26
Syria,23/11/2005,7,0,0,0,3,0,0,10
Syria,24/11/2005,12,0,0,0,6,0,0,18
Syria,25/11/2005,16,0,0,0,0,0,0,16
Syria,26/11/2005,17,0,-1,0,9,0,0,25
Syria,27/11/2005,22,0,0,0,0,0,0,22
Syria,28/11/2005,9,0,0,0,0,0,0,9
Syria,29/11/2005,2,0,0,0,3,0,0,5
Syria,30/11/2005,7,0,0,0,15,4,0,26
Syria,01/12/2005,0,0,0,0,-2,0,0,-2
Syria,02/12/2005,9,0,-4,0,3,0,0,8
Syria,03/12/2005,21,0,0,0,3,0,0,24
Syria,04/12/2005,21,0,0,0,0,0,0,21
Syria,05/12/2005,5,0,0,0,1,2,0,8
Syria,06/12/2005,17,4,0,0,12,1,0,34
Syria,07/12/2005,8,0,0,0,7,0,0,15
Syria,08/12/2005,31,0,0,0,0,6,0,37
Syria,09/12/2005,8,0,0,0,3,3,0,14
Syria,10/12/2005,1,0,0,0,0,0,0,1
Syria,11/12/2005,6,0,0,0,3,0,0,9
Syria,12/12/2005,44,0,2,0,4,14,0,64
Syria,13/12/2005,17,0,0,0,0,7,0,24
Syria,14/12/2005,5,0,0,0,9,21,0,35
Syria,15/12/2005,28,0,0,0,3,1,0,32
Syria,16/12/2005,8,0,0,0,6,0,0,14
Syria,17/12/2005,15,0,-6,0,0,6,0,15
Syria,18/12/2005,8,0,0,0,-2,0,0,6
Syria,19/12/2005,3,0,0,0,0,1,0,4
Syria,20/12/2005,39,0,-2,0,9,0,0,46
Syria,21/12/2005,-2,0,-2,0,0,4,0,0
Syria,22/12/2005,15,0,0,0,3,0,0,18
Syria,24/12/2005,0,0,0,0,0,0,0,0
Syria,25/12/2005,0,0,0,0,0,0,0,0
Syria,26/12/2005,2,0,0,0,0,0,0,2
Syria,27/12/2005,2,0,0,0,0,0,0,2
Syria,28/12/2005,38,0,0,0,12,2,0,52
Syria,29/12/2005,38,0,0,0,3,1,0,42
Syria,30/12/2005,-7,0,-3,0,3,0,0,-7
Syria,31/12/2005,25,0,0,0,21,3,0,49
Yemen,01/01/2005,6,0,0,0,0,0,0,6
Yemen,04/01/2005,1,0,0,0,3,0,0,4
Yemen,05/01/2005,6,0,0,0,0,0,0,6
Yemen,06/01/2005,0,0,0,0,3,0,0,3
Yemen,08/01/2005,6,0,0,0,3,0,0,9
Yemen,10/01/2005,10,0,0,0,0,0,0,10
Yemen,11/01/2005,0,0,0,0,4,1,0,5
Yemen,13/01/2005,3,0,0,0,0,0,0,3
Yemen,14/01/2005,0,0,0,0,0,0,0,0
Yemen,15/01/2005,6,0,0,0,12,0,0,18
Yemen,17/01/2005,0,0,0,0,0,0,0,0
Yemen,18/01/2005,9,0,1,0,0,1,0,11
Yemen,19/01/2005,18,0,0,0,3,0,0,21
Yemen,20/01/2005,0,0,0,0,0,0,0,0
Yemen,21/01/2005,0,0,0,0,3,0,0,3
Yemen,22/01/2005,0,0,0,0,0,0,0,0
Yemen,23/01/2005,5,0,0,0,0,0,0,5
Yemen,24/01/2005,0,0,0,0,3,0,0,3
Yemen,25/01/2005,0,0,1,0,6,0,0,7
Yemen,27/01/2005,8,0,0,0,0,0,0,8
Yemen,28/01/2005,0,0,0,0,0,0,0,0
Yemen,29/01/2005,6,0,0,0,0,0,0,6
Yemen,30/01/2005,5,0,0,0,0,2,0,7
Yemen,31/01/2005,2,0,0,0,5,2,0,9
Yemen,01/02/2005,0,0,0,0,0,0,0,0
Yemen,02/02/2005,0,0,0,0,0,0,0,0
Yemen,03/02/2005,0,0,0,0,3,0,0,3
Yemen,04/02/2005,0,0,0,0,0,0,0,0
Yemen,05/02/2005,12,0,1,0,6,0,0,19
Yemen,07/02/2005,3,0,0,0,0,0,0,3
Yemen,08/02/2005,0,0,0,0,0,0,0,0
Yemen,09/02/2005,3,0,0,0,0,0,0,3
Yemen,11/02/2005,-1,0,0,0,0,0,0,-1
Yemen,12/02/2005,2,0,0,0,0,0,0,2
Yemen,13/02/2005,0,0,0,0,0,0,0,0
Yemen,14/02/2005,2,0,0,0,0,0,0,2
Yemen,15/02/2005,0,0,0,0,0,0,0,0
Yemen,16/02/2005,4,0,0,0,0,0,0,4
Yemen,17/02/2005,-2,0,0,0,21,1,0,20
Yemen,18/02/2005,0,0,0,0,0,0,0,0
Yemen,19/02/2005,0,0,0,0,3,3,0,6
Yemen,21/02/2005,9,0,0,0,0,0,0,9
Yemen,22/02/2005,0,0,0,0,0,0,0,0
Yemen,23/02/2005,9,0,0,0,0,0,0,9
Yemen,24/02/2005,0,0,0,0,3,0,0,3
Yemen,26/02/2005,8,0,7,0,6,9,0,30
Yemen,27/02/2005,0,0,0,0,3,0,0,3
Yemen,28/02/2005,4,0,0,0,12,0,0,16
Yemen,01/03/2005,4,0,0,0,0,0,0,4
Yemen,02/03/2005,0,0,0,0,0,0,0,0
Yemen,03/03/2005,7,0,0,0,12,0,0,19
Yemen,04/03/2005,3,0,0,0,0,0,0,3
Yemen,05/03/2005,0,0,0,0,0,0,0,0
Yemen,06/03/2005,0,0,0,0,3,0,0,3
Yemen,07/03/2005,9,0,0,0,0,0,0,9
Yemen,08/03/2005,0,0,0,0,3,0,0,3
Yemen,09/03/2005,0,0,0,0,3,0,0,3
Yemen,10/03/2005,3,0,0,0,4,3,0,10
Yemen,12/03/2005,0,0,0,0,0,0,0,0
Yemen,14/03/2005,0,0,0,0,0,0,0,0
Yemen,16/03/2005,3,0,0,0,0,0,0,3
Yemen,17/03/2005,-4,0,0,0,0,0,0,-4
Yemen,18/03/2005,2,0,0,0,0,0,0,2
Yemen,19/03/2005,18,0,0,0,9,0,0,27
Yemen,21/03/2005,15,0,0,0,39,0,0,54
Yemen,22/03/2005,7,0,0,0,6,0,0,13
Yemen,23/03/2005,7,0,0,0,3,0,0,10
Yemen,28/03/2005,13,0,0,0,0,0,0,13
Yemen,29/03/2005,9,0,0,0,2,0,0,11
Yemen,30/03/2005,0,0,0,0,32,0,0,32
Yemen,01/04/2005,9,0,0,0,0,2,0,11
Yemen,02/04/2005,10,0,0,0,0,0,0,10
Yemen,03/04/2005,12,0,0,0,0,14,0,26
Yemen,04/04/2005,3,0,0,0,0,0,0,3
Yemen,05/04/2005,0,0,0,0,0,0,0,0
Yemen,06/04/2005,-2,0,0,0,0,0,0,-2
Yemen,07/04/2005,2,0,0,0,3,0,0,5
Yemen,08/04/2005,9,0,0,0,3,0,0,12
Yemen,09/04/2005,2,0,0,0,0,3,0,5
Yemen,10/04/2005,1,0,0,0,0,0,0,1
Yemen,11/04/2005,2,0,0,0,0,2,0,4
Yemen,12/04/2005,0,0,0,0,0,3,0,3
Yemen,13/04/2005,6,0,0,0,0,4,0,10
Yemen,14/04/2005,2,0,0,0,-3,0,0,-1
Yemen,15/04/2005,2,0,0,0,-3,0,0,-1
Yemen,16/04/2005,11,0,0,0,6,0,0,17
Yemen,17/04/2005,1,0,0,0,0,0,0,1
Yemen,18/04/2005,0,0,0,0,6,0,0,6
Yemen,19/04/2005,0,0,0,0,0,0,0,0
Yemen,20/04/2005,14,0,0,0,3,0,0,17
Yemen,23/04/2005,0,0,0,0,0,0,0,0
Yemen,25/04/2005,0,0,0,0,0,0,0,0
Yemen,26/04/2005,2,0,0,0,0,0,0,2
Yemen,27/04/2005,1,0,0,0,3,0,0,4
Yemen,28/04/2005,0,0,0,0,0,0,0,0
Yemen,29/04/2005,10,0,0,0,3,3,0,16
Yemen,30/04/2005,0,0,0,0,3,3,0,6
Yemen,02/05/2005,0,0,0,0,3,0,0,3
Yemen,03/05/2005,2,0,0,0,3,0,0,5
Yemen,04/05/2005,1,0,0,0,0,0,0,1
Yemen,05/05/2005,13,0,0,0,0,0,0,13
Yemen,06/05/2005,-1,0,0,0,0,0,0,-1
Yemen,07/05/2005,0,0,0,0,0,0,0,0
Yemen,09/05/2005,0,0,0,0,0,0,0,0
Yemen,10/05/2005,3,0,0,0,0,3,0,6
Yemen,11/05/2005,0,0,0,0,0,0,0,0
Yemen,12/05/2005,8,0,0,0,0,0,0,8
Yemen,13/05/2005,8,0,0,0,6,2,0,16
Yemen,14/05/2005,28,0,-13,0,12,0,0,27
Yemen,15/05/2005,5,0,0,0,0,0,0,5
Yemen,16/05/2005,3,0,0,0,2,1,0,6
Yemen,17/05/2005,15,0,-1,0,0,0,0,14
Yemen,18/05/2005,0,0,0,0,0,0,0,0
Yemen,19/05/2005,0,0,0,0,0,0,0,0
Yemen,21/05/2005,3,0,0,0,0,0,0,3
Yemen,22/05/2005,0,0,0,0,0,0,0,0
Yemen,23/05/2005,0,0,0,0,6,0,0,6
Yemen,24/05/2005,0,0,0,0,0,0,0,0
Yemen,25/05/2005,0,0,0,0,0,0,0,0
Yemen,28/05/2005,0,0,0,0,-2,0,0,-2
Yemen,29/05/2005,0,0,0,0,18,0,0,18
Yemen,30/05/2005,0,0,0,0,0,0,0,0
Yemen,31/05/2005,0,0,0,0,0,6,0,6
Yemen,02/06/2005,9,0,0,0,0,0,0,9
Yemen,04/06/2005,3,0,0,0,0,0,0,3
Yemen,05/06/2005,1,0,0,0,0,0,0,1
Yemen,06/06/2005,0,0,0,0,0,0,0,0
Yemen,07/06/2005,13,0,-2,0,9,2,0,22
Yemen,08/06/2005,2,0,0,0,0,0,0,2
Yemen,09/06/2005,2,0,-1,0,0,0,0,1
Yemen,10/06/2005,6,0,0,0,3,2,0,11
Yemen,11/06/2005,1,0,0,0,9,0,0,10
Yemen,14/06/2005,0,0,0,0,0,0,0,0
Yemen,15/06/2005,0,0,0,0,0,0,0,0
Yemen,16/06/2005,2,0,0,0,3,2,0,7
Yemen,18/06/2005,0,0,0,0,0,0,0,0
Yemen,19/06/2005,0,0,0,0,0,0,0,0
Yemen,20/06/2005,4,0,0,0,0,0,0,4
Yemen,21/06/2005,0,0,0,0,0,0,0,0
Yemen,22/06/2005,12,0,0,0,0,0,0,12
Yemen,23/06/2005,0,0,0,0,0,0,0,0
Yemen,24/06/2005,2,0,0,0,0,0,0,2
Yemen,25/06/2005,0,0,0,0,3,0,0,3
Yemen,26/06/2005,14,0,0,0,3,0,0,17
Yemen,27/06/2005,0,0,0,0,0,0,0,0
Yemen,28/06/2005,-1,0,0,0,0,0,0,-1
Yemen,29/06/2005,15,0,0,0,0,0,0,15
Yemen,30/06/2005,6,0,0,0,0,0,0,6
Yemen,03/07/2005,0,0,0,0,0,0,0,0
Yemen,04/07/2005,0,0,0,0,3,0,0,3
Yemen,05/07/2005,0,0,0,0,3,0,0,3
Yemen,06/07/2005,0,0,0,0,0,0,0,0
Yemen,07/07/2005,3,0,0,0,6,0,0,9
Yemen,09/07/2005,0,0,0,0,0,0,0,0
Yemen,10/07/2005,0,0,0,0,3,0,0,3
Yemen,12/07/2005,0,0,0,0,3,0,0,3
Yemen,13/07/2005,15,0,0,0,0,0,0,15
Yemen,14/07/2005,0,0,0,0,3,0,0,3
Yemen,15/07/2005,0,0,0,0,6,1,0,7
Yemen,16/07/2005,0,0,0,0,0,1,0,1
Yemen,17/07/2005,14,0,-4,0,3,3,0,16
Yemen,18/07/2005,0,0,0,0,6,0,0,6
Yemen,19/07/2005,0,0,-2,0,-2,0,0,-4
Yemen,20/07/2005,2,0,0,0,0,4,0,6
Yemen,21/07/2005,4,0,0,0,0,0,0,4
Yemen,22/07/2005,9,0,0,0,0,0,0,9
Yemen,23/07/2005,3,0,0,0,0,0,0,3
Yemen,24/07/2005,3,0,0,0,0,0,0,3
Yemen,25/07/2005,0,0,0,0,3,0,0,3
Yemen,26/07/2005,6,0,0,0,0,1,0,7
Yemen,27/07/2005,2,0,0,0,0,0,0,2
Yemen,28/07/2005,0,0,0,0,15,5,0,20
Yemen,29/07/2005,0,0,0,0,0,0,0,0
Yemen,31/07/2005,-1,0,0,0,0,0,0,-1
Yemen,01/08/2005,8,0,0,0,3,0,0,11
Yemen,02/08/2005,0,0,2,0,0,0,0,2
Yemen,03/08/2005,4,0,0,0,0,0,0,4
Yemen,04/08/2005,0,0,0,0,-2,0,0,-2
Yemen,05/08/2005,-1,0,0,0,0,0,0,-1
Yemen,07/08/2005,2,0,0,0,0,0,0,2
Yemen,08/08/2005,1,0,0,0,0,8,0,9
Yemen,09/08/2005,8,0,0,0,9,2,0,19
Yemen,10/08/2005,1,0,0,0,0,0,0,1
Yemen,11/08/2005,0,0,0,0,3,0,0,3
Yemen,13/08/2005,0,0,0,0,0,0,0,0
Yemen,14/08/2005,-1,0,0,0,0,0,0,-1
Yemen,15/08/2005,7,0,0,0,0,0,0,7
Yemen,17/08/2005,3,0,0,0,0,6,0,9
Yemen,18/08/2005,0,0,0,0,-1,0,0,-1
Yemen,19/08/2005,22,0,0,0,0,0,0,22
Yemen,20/08/2005,0,0,0,0,3,0,0,3
Yemen,21/08/2005,0,0,0,0,0,3,0,3
Yemen,22/08/2005,0,0,0,0,0,0,0,0
Yemen,23/08/2005,8,0,0,0,0,0,0,8
Yemen,24/08/2005,0,0,0,0,0,0,0,0
Yemen,25/08/2005,0,0,0,0,0,0,0,0
Yemen,26/08/2005,0,0,0,0,0,0,0,0
Yemen,28/08/2005,4,0,0,0,0,0,0,4
Yemen,31/08/2005,0,0,0,0,0,0,0,0
Yemen,01/09/2005,0,2,0,0,3,3,0,8
Yemen,02/09/2005,0,0,0,0,15,0,0,15
Yemen,03/09/2005,0,0,0,0,0,0,0,0
Yemen,05/09/2005,0,0,0,0,0,0,0,0
Yemen,06/09/2005,0,0,0,0,0,0,0,0
Yemen,07/09/2005,2,0,0,0,0,0,0,2
Yemen,08/09/2005,2,0,0,0,6,0,0,8
Yemen,09/09/2005,1,0,0,0,-2,0,0,-1
Yemen,10/09/2005,3,0,0,0,0,0,0,3
Yemen,12/09/2005,0,0,0,0,0,0,0,0
Yemen,13/09/2005,1,0,0,0,0,0,0,1
Yemen,16/09/2005,0,0,0,0,0,0,0,0
Yemen,17/09/2005,27,0,0,0,0,2,0,29
Yemen,18/09/2005,0,0,0,0,0,0,0,0
Yemen,20/09/2005,4,0,0,0,3,0,0,7
Yemen,21/09/2005,0,0,0,0,36,3,0,39
Yemen,22/09/2005,0,0,0,0,0,0,0,0
Yemen,25/09/2005,2,0,0,0,-6,0,0,-4
Yemen,26/09/2005,0,0,0,0,0,0,0,0
Yemen,27/09/2005,0,0,0,0,0,0,0,0
Yemen,03/10/2005,0,0,0,0,0,0,0,0
Yemen,04/10/2005,0,0,0,0,3,2,0,5
Yemen,07/10/2005,0,4,0,0,-6,0,0,-2
Yemen,08/10/2005,0,0,0,0,0,0,0,0
Yemen,11/10/2005,17,0,0,0,-3,2,0,16
Yemen,13/10/2005,0,0,-1,0,0,0,0,-1
Yemen,14/10/2005,1,0,0,0,3,1,0,5
Yemen,15/10/2005,1,0,0,0,0,0,0,1
Yemen,18/10/2005,0,0,0,0,0,0,0,0
Yemen,20/10/2005,1,0,0,0,0,0,0,1
Yemen,21/10/2005,0,0,0,0,3,0,0,3
Yemen,23/10/2005,0,0,0,0,0,0,0,0
Yemen,25/10/2005,0,0,0,0,0,0,0,0
Yemen,27/10/2005,1,0,0,0,0,0,0,1
Yemen,29/10/2005,0,0,0,0,0,0,0,0
Yemen,01/11/2005,0,0,0,0,0,0,0,0
Yemen,02/11/2005,-1,0,0,0,0,0,0,-1
Yemen,04/11/2005,0,0,0,0,3,0,0,3
Yemen,05/11/2005,1,0,0,0,0,0,0,1
Yemen,06/11/2005,27,0,0,0,0,0,0,27
Yemen,07/11/2005,5,0,0,0,12,1,0,18
Yemen,08/11/2005,10,0,0,0,6,0,0,16
Yemen,09/11/2005,6,0,0,0,6,0,0,12
Yemen,10/11/2005,2,0,1,0,9,0,0,12
Yemen,11/11/2005,0,0,0,0,3,0,0,3
Yemen,14/11/2005,0,0,0,0,3,0,0,3
Yemen,15/11/2005,0,0,0,0,3,1,0,4
Yemen,17/11/2005,0,0,0,0,6,0,0,6
Yemen,21/11/2005,0,0,0,0,6,0,0,6
Yemen,22/11/2005,1,0,0,0,-1,0,0,0
Yemen,24/11/2005,0,0,0,0,1,0,0,1
Yemen,26/11/2005,0,0,0,0,0,0,0,0
Yemen,27/11/2005,19,0,-2,0,27,0,0,44
Yemen,28/11/2005,4,0,0,0,15,1,0,20
Yemen,29/11/2005,6,0,0,0,12,0,0,18
Yemen,30/11/2005,22,0,0,0,18,0,0,40
Yemen,01/12/2005,3,0,0,0,0,0,0,3
Yemen,02/12/2005,6,0,0,0,3,0,0,9
Yemen,03/12/2005,0,0,0,0,6,0,0,6
Yemen,04/12/2005,8,0,0,0,0,2,0,10
Yemen,05/12/2005,0,0,0,0,3,2,0,5
Yemen,06/12/2005,0,0,0,0,3,0,0,3
Yemen,07/12/2005,1,0,0,0,-2,0,0,-1
Yemen,08/12/2005,0,0,0,0,0,0,0,0
Yemen,09/12/2005,0,0,0,0,3,2,0,5
Yemen,10/12/2005,2,0,0,0,9,0,0,11
Yemen,11/12/2005,0,0,0,0,0,0,0,0
Yemen,14/12/2005,0,0,0,0,0,0,0,0
Yemen,15/12/2005,0,0,0,0,0,0,0,0
Yemen,16/12/2005,0,0,0,0,0,0,0,0
Yemen,17/12/2005,1,0,0,0,0,0,0,1
Yemen,18/12/2005,18,0,0,0,-4,0,0,14
Yemen,19/12/2005,1,0,0,0,0,0,0,1
Yemen,21/12/2005,2,0,0,0,0,0,0,2
Yemen,24/12/2005,0,0,0,0,-2,0,0,-2
Yemen,25/12/2005,0,0,0,0,-1,0,0,-1
Yemen,28/12/2005,1,0,0,0,0,1,0,2
Yemen,29/12/2005,0,0,0,0,9,1,0,10
Yemen,30/12/2005,1,0,0,0,3,0,0,4
Yemen,31/12/2005,-4,0,0,0,-7,0,0,-11
Afghanistan,01/01/2004,14,0,0,0,-4,2,0,12
Afghanistan,02/01/2004,13,0,0,0,6,3,0,22
Afghanistan,03/01/2004,8,0,-1,0,19,2,0,28
Afghanistan,04/01/2004,16,0,0,0,1,0,0,17
Afghanistan,05/01/2004,10,0,2,0,8,-1,0,19
Afghanistan,06/01/2004,46,2,0,0,2,13,0,63
Afghanistan,07/01/2004,27,0,1,0,7,5,0,40
Afghanistan,08/01/2004,39,0,0,0,34,3,0,76
Afghanistan,09/01/2004,38,0,-1,0,22,6,0,65
Afghanistan,10/01/2004,29,0,0,0,9,0,0,38
Afghanistan,11/01/2004,34,0,0,0,25,0,0,59
Afghanistan,12/01/2004,7,0,0,0,16,7,0,30
Afghanistan,13/01/2004,24,0,0,0,9,1,0,34
Afghanistan,14/01/2004,6,0,0,0,22,4,0,32
Afghanistan,15/01/2004,12,0,0,0,20,16,0,48
Afghanistan,16/01/2004,2,0,0,0,14,21,0,37
Afghanistan,17/01/2004,32,0,0,0,1,2,0,35
Afghanistan,18/01/2004,22,0,0,0,4,0,0,26
Afghanistan,19/01/2004,40,0,-2,0,29,3,0,70
Afghanistan,20/01/2004,17,0,0,0,12,0,0,29
Afghanistan,21/01/2004,40,0,0,0,27,1,0,68
Afghanistan,22/01/2004,40,0,1,0,23,6,0,70
Afghanistan,23/01/2004,20,0,0,0,1,0,0,21
Afghanistan,24/01/2004,10,0,0,0,18,1,0,29
Afghanistan,25/01/2004,39,0,0,0,13,0,0,52
Afghanistan,26/01/2004,35,0,0,0,6,2,0,43
Afghanistan,27/01/2004,-4,0,-2,0,13,8,0,15
Afghanistan,28/01/2004,12,0,0,0,18,0,0,30
Afghanistan,29/01/2004,9,0,0,0,4,0,0,13
Afghanistan,30/01/2004,26,0,0,0,19,0,0,45
Afghanistan,31/01/2004,8,0,0,0,7,0,0,15
Afghanistan,01/02/2004,7,0,0,0,11,0,0,18
Afghanistan,02/02/2004,17,2,-1,0,28,0,0,46
Afghanistan,03/02/2004,13,0,0,0,9,2,0,24
Afghanistan,04/02/2004,16,0,0,0,6,0,0,22
Afghanistan,05/02/2004,31,0,0,0,11,0,0,42
Afghanistan,06/02/2004,16,0,0,0,8,6,0,30
Afghanistan,07/02/2004,19,0,-1,0,-2,1,0,17
Afghanistan,08/02/2004,28,2,0,0,3,4,0,37
Afghanistan,09/02/2004,9,0,0,0,3,1,0,13
Afghanistan,10/02/2004,8,0,0,0,0,0,0,8
Afghanistan,11/02/2004,37,0,0,0,22,0,0,59
Afghanistan,12/02/2004,27,0,1,0,48,1,0,77
Afghanistan,13/02/2004,16,0,0,0,6,2,0,24
Afghanistan,14/02/2004,12,0,0,0,36,0,0,48
Afghanistan,15/02/2004,8,0,0,0,3,1,0,12
Afghanistan,16/02/2004,37,0,0,0,9,1,0,47
Afghanistan,17/02/2004,19,0,-2,0,18,0,0,35
Afghanistan,18/02/2004,13,2,0,0,3,0,0,18
Afghanistan,19/02/2004,18,2,0,0,41,2,0,63
Afghanistan,20/02/2004,43,0,0,0,12,1,0,56
Afghanistan,21/02/2004,41,0,1,0,27,2,0,71
Afghanistan,22/02/2004,25,0,0,0,0,0,0,25
Afghanistan,23/02/2004,50,0,0,0,11,1,0,62
Afghanistan,24/02/2004,51,0,0,0,20,0,0,71
Afghanistan,25/02/2004,29,0,0,0,15,5,0,49
Afghanistan,26/02/2004,1,0,0,0,15,3,0,19
Afghanistan,27/02/2004,26,0,5,0,13,-1,0,43
Afghanistan,28/02/2004,12,6,1,0,12,2,0,33
Afghanistan,29/02/2004,28,0,0,0,8,3,0,39
Afghanistan,01/03/2004,23,0,0,0,30,4,0,57
Afghanistan,02/03/2004,26,0,0,0,20,0,0,46
Afghanistan,03/03/2004,27,2,0,0,15,0,0,44
Afghanistan,04/03/2004,35,0,0,0,15,0,0,50
Afghanistan,05/03/2004,22,0,0,0,8,2,0,32
Afghanistan,06/03/2004,22,0,0,0,-2,6,0,26
Afghanistan,07/03/2004,28,0,0,0,6,0,0,34
Afghanistan,08/03/2004,14,0,-1,0,42,4,0,59
Afghanistan,09/03/2004,42,0,0,0,39,1,0,82
Afghanistan,10/03/2004,25,0,0,0,26,6,0,57
Afghanistan,11/03/2004,50,0,0,0,6,2,0,58
Afghanistan,12/03/2004,38,2,0,0,16,0,0,56
Afghanistan,13/03/2004,24,0,0,0,20,3,0,47
Afghanistan,14/03/2004,42,0,1,0,-2,3,0,44
Afghanistan,15/03/2004,37,0,0,0,-1,3,0,39
Afghanistan,16/03/2004,29,0,0,0,17,0,0,46
Afghanistan,17/03/2004,35,0,0,0,1,12,0,48
Afghanistan,18/03/2004,67,0,1,0,1,19,0,88
Afghanistan,19/03/2004,86,2,0,0,48,4,0,140
Afghanistan,20/03/2004,37,0,0,0,19,3,0,59
Afghanistan,21/03/2004,48,0,0,0,6,0,0,54
Afghanistan,22/03/2004,88,0,0,0,11,6,0,105
Afghanistan,23/03/2004,36,0,0,0,14,2,0,52
Afghanistan,24/03/2004,28,0,0,0,19,13,0,60
Afghanistan,25/03/2004,62,0,2,0,6,0,0,70
Afghanistan,26/03/2004,26,0,-1,0,9,3,0,37
Afghanistan,27/03/2004,46,0,0,0,21,5,0,72
Afghanistan,28/03/2004,16,0,0,0,8,2,0,26
Afghanistan,29/03/2004,96,0,0,0,6,5,0,107
Afghanistan,30/03/2004,28,6,0,0,7,0,0,41
Afghanistan,31/03/2004,48,4,0,0,16,12,0,80
Afghanistan,01/04/2004,37,0,0,0,23,8,0,68
Afghanistan,02/04/2004,62,0,-1,0,39,4,0,104
Afghanistan,03/04/2004,27,0,0,0,14,0,0,41
Afghanistan,04/04/2004,32,0,1,0,4,0,0,37
Afghanistan,05/04/2004,31,8,0,0,4,0,0,43
Afghanistan,06/04/2004,28,0,0,0,-12,3,0,19
Afghanistan,07/04/2004,13,0,1,0,23,7,0,44
Afghanistan,08/04/2004,53,0,0,0,34,2,0,89
Afghanistan,09/04/2004,35,0,0,0,15,0,0,50
Afghanistan,10/04/2004,24,0,0,0,6,3,0,33
Afghanistan,11/04/2004,19,0,1,0,-3,4,0,21
Afghanistan,12/04/2004,14,0,-5,0,-2,0,0,7
Afghanistan,13/04/2004,-2,0,0,0,0,0,0,-2
Afghanistan,14/04/2004,40,0,0,0,15,0,0,55
Afghanistan,15/04/2004,12,0,0,0,0,5,0,17
Afghanistan,16/04/2004,9,4,0,0,36,0,0,49
Afghanistan,17/04/2004,12,0,0,0,9,0,0,21
Afghanistan,18/04/2004,22,0,0,0,6,0,0,28
Afghanistan,19/04/2004,-4,0,0,0,7,6,0,9
Afghanistan,20/04/2004,15,0,-1,0,3,8,0,25
Afghanistan,21/04/2004,27,0,0,0,5,0,0,32
Afghanistan,22/04/2004,32,0,-2,0,7,0,0,37
Afghanistan,23/04/2004,15,0,0,0,10,0,0,25
Afghanistan,24/04/2004,18,0,0,0,15,0,0,33
Afghanistan,25/04/2004,18,0,0,0,9,0,0,27
Afghanistan,26/04/2004,20,0,0,0,25,0,0,45
Afghanistan,27/04/2004,24,0,0,0,1,0,0,25
Afghanistan,28/04/2004,48,0,0,0,25,2,0,75
Afghanistan,29/04/2004,21,0,0,0,14,2,0,37
Afghanistan,30/04/2004,27,0,0,0,-1,6,0,32
Afghanistan,01/05/2004,18,0,0,0,1,5,0,24
Afghanistan,02/05/2004,14,0,0,0,14,0,0,28
Afghanistan,03/05/2004,17,0,0,0,-2,4,0,19
Afghanistan,04/05/2004,16,0,0,0,24,4,0,44
Afghanistan,05/05/2004,40,0,0,0,5,1,0,46
Afghanistan,06/05/2004,39,0,0,0,5,2,0,46
Afghanistan,07/05/2004,16,0,0,0,6,9,0,31
Afghanistan,08/05/2004,9,6,0,0,0,4,0,19
Afghanistan,09/05/2004,23,0,0,0,12,0,0,35
Afghanistan,10/05/2004,12,6,0,0,4,0,0,22
Afghanistan,11/05/2004,47,0,0,0,15,5,0,67
Afghanistan,12/05/2004,6,0,0,0,22,1,0,29
Afghanistan,13/05/2004,28,0,0,0,28,8,0,64
Afghanistan,14/05/2004,23,0,0,0,4,2,0,29
Afghanistan,15/05/2004,8,0,0,0,26,15,0,49
Afghanistan,16/05/2004,22,0,0,0,3,6,0,31
Afghanistan,17/05/2004,41,0,0,0,-2,5,0,44
Afghanistan,18/05/2004,42,2,0,0,12,1,0,57
Afghanistan,19/05/2004,17,0,0,0,60,5,0,82
Afghanistan,20/05/2004,14,0,0,0,32,0,0,46
Afghanistan,21/05/2004,34,0,2,0,32,6,0,74
Afghanistan,22/05/2004,40,0,0,0,15,1,0,56
Afghanistan,23/05/2004,27,0,0,0,18,0,0,45
Afghanistan,24/05/2004,45,0,0,0,21,1,0,67
Afghanistan,25/05/2004,18,0,-1,0,3,1,0,21
Afghanistan,26/05/2004,9,0,0,0,24,2,0,35
Afghanistan,27/05/2004,17,0,0,0,19,4,0,40
Afghanistan,28/05/2004,26,0,0,0,10,1,0,37
Afghanistan,29/05/2004,0,0,0,0,18,0,0,18
Afghanistan,30/05/2004,38,0,0,0,9,3,0,50
Afghanistan,31/05/2004,31,0,0,0,6,-2,0,35
Afghanistan,01/06/2004,25,0,0,0,0,7,0,32
Afghanistan,02/06/2004,49,0,-8,0,26,0,0,67
Afghanistan,03/06/2004,56,0,0,0,7,6,0,69
Afghanistan,04/06/2004,17,0,0,0,21,0,0,38
Afghanistan,05/06/2004,14,0,0,0,15,7,0,36
Afghanistan,06/06/2004,63,0,0,0,-1,14,0,76
Afghanistan,07/06/2004,4,0,0,0,19,5,0,28
Afghanistan,08/06/2004,33,0,2,0,10,4,0,49
Afghanistan,09/06/2004,69,0,1,0,18,5,0,93
Afghanistan,10/06/2004,61,0,0,0,21,6,0,88
Afghanistan,11/06/2004,49,0,0,0,15,9,0,73
Afghanistan,12/06/2004,44,0,0,0,16,0,0,60
Afghanistan,13/06/2004,53,0,0,0,-3,2,0,52
Afghanistan,14/06/2004,71,0,0,0,21,0,0,92
Afghanistan,15/06/2004,35,0,0,0,24,0,0,59
Afghanistan,16/06/2004,37,0,0,0,4,4,0,45
Afghanistan,17/06/2004,21,2,-6,0,-5,1,0,13
Afghanistan,18/06/2004,49,0,0,0,3,14,0,66
Afghanistan,19/06/2004,25,0,0,0,-12,1,0,14
Afghanistan,20/06/2004,6,0,0,0,-3,2,0,5
Afghanistan,21/06/2004,28,0,0,0,7,5,0,40
Afghanistan,22/06/2004,15,0,0,0,5,4,0,24
Afghanistan,23/06/2004,26,0,0,0,20,3,0,49
Afghanistan,24/06/2004,38,0,-4,0,28,0,0,62
Afghanistan,25/06/2004,31,0,0,0,34,0,0,65
Afghanistan,26/06/2004,27,0,0,0,16,0,0,43
Afghanistan,27/06/2004,11,0,0,0,-4,2,0,9
Afghanistan,28/06/2004,12,0,0,0,6,3,0,21
Afghanistan,29/06/2004,82,2,-2,0,48,7,0,137
Afghanistan,30/06/2004,27,0,-2,0,27,6,0,58
Afghanistan,01/07/2004,31,0,0,0,-1,2,0,32
Afghanistan,02/07/2004,16,0,0,0,18,0,0,34
Afghanistan,03/07/2004,12,0,0,0,12,0,0,24
Afghanistan,04/07/2004,13,0,0,0,11,0,0,24
Afghanistan,05/07/2004,1,2,0,0,6,0,0,9
Afghanistan,06/07/2004,12,0,0,0,6,2,0,20
Afghanistan,07/07/2004,25,2,0,0,22,3,0,52
Afghanistan,08/07/2004,11,0,1,0,11,0,0,23
Afghanistan,09/07/2004,7,0,0,0,16,0,0,23
Afghanistan,10/07/2004,6,0,1,0,12,0,0,19
Afghanistan,11/07/2004,26,0,2,0,3,2,0,33
Afghanistan,12/07/2004,3,0,0,0,21,0,0,24
Afghanistan,13/07/2004,21,0,0,0,18,2,0,41
Afghanistan,14/07/2004,17,0,0,0,-2,0,0,15
Afghanistan,15/07/2004,8,0,0,0,21,1,0,30
Afghanistan,16/07/2004,18,0,0,0,-6,0,0,12
Afghanistan,17/07/2004,25,0,0,0,12,0,0,37
Afghanistan,18/07/2004,14,0,0,0,-4,2,0,12
Afghanistan,19/07/2004,18,0,0,0,6,0,0,24
Afghanistan,20/07/2004,8,0,0,0,12,0,0,20
Afghanistan,21/07/2004,19,0,0,0,13,0,0,32
Afghanistan,22/07/2004,14,0,0,0,1,2,0,17
Afghanistan,23/07/2004,35,0,-1,0,-5,0,0,29
Afghanistan,24/07/2004,6,0,0,0,6,0,0,12
Afghanistan,25/07/2004,12,0,0,0,-14,0,0,-2
Afghanistan,26/07/2004,6,0,0,0,3,0,0,9
Afghanistan,27/07/2004,23,0,0,0,14,0,0,37
Afghanistan,28/07/2004,45,0,0,0,-3,12,0,54
Afghanistan,29/07/2004,29,0,0,0,3,0,0,32
Afghanistan,30/07/2004,14,0,0,0,22,0,0,36
Afghanistan,31/07/2004,14,0,-6,0,10,0,0,18
Afghanistan,01/08/2004,17,0,0,0,6,0,0,23
Afghanistan,02/08/2004,8,0,0,0,6,6,0,20
Afghanistan,03/08/2004,16,8,0,0,16,0,0,40
Afghanistan,04/08/2004,40,0,1,0,35,4,0,80
Afghanistan,05/08/2004,20,0,0,0,28,0,0,48
Afghanistan,06/08/2004,38,0,0,0,34,4,0,76
Afghanistan,07/08/2004,37,0,0,0,7,4,0,48
Afghanistan,08/08/2004,47,2,0,0,31,0,0,80
Afghanistan,09/08/2004,27,0,0,0,6,0,0,33
Afghanistan,10/08/2004,43,0,0,0,6,5,0,54
Afghanistan,11/08/2004,30,0,0,0,4,0,0,34
Afghanistan,12/08/2004,27,0,-2,0,24,3,0,52
Afghanistan,13/08/2004,30,0,0,0,-4,5,0,31
Afghanistan,14/08/2004,10,0,0,0,6,0,0,16
Afghanistan,15/08/2004,51,0,0,0,6,2,0,59
Afghanistan,16/08/2004,16,0,0,0,0,2,0,18
Afghanistan,17/08/2004,13,0,-1,0,2,1,0,15
Afghanistan,18/08/2004,5,0,-3,0,12,5,0,19
Afghanistan,19/08/2004,34,0,0,0,-1,2,0,35
Afghanistan,20/08/2004,28,0,0,0,5,5,0,38
Afghanistan,21/08/2004,33,0,-2,0,-3,4,0,32
Afghanistan,22/08/2004,6,0,0,0,15,1,0,22
Afghanistan,23/08/2004,52,6,0,0,21,3,0,82
Afghanistan,24/08/2004,49,0,-4,0,7,1,0,53
Afghanistan,25/08/2004,30,0,0,0,34,2,0,66
Afghanistan,26/08/2004,29,0,1,0,21,0,0,51
Afghanistan,27/08/2004,22,0,0,0,9,0,0,31
Afghanistan,28/08/2004,8,0,-2,0,7,0,0,13
Afghanistan,29/08/2004,16,0,0,0,6,0,0,22
Afghanistan,30/08/2004,30,0,0,0,8,0,0,38
Afghanistan,31/08/2004,25,0,-2,0,27,5,0,55
Afghanistan,01/09/2004,20,0,0,0,12,5,0,37
Afghanistan,02/09/2004,21,2,0,0,-8,0,0,15
Afghanistan,03/09/2004,15,0,0,0,-1,3,0,17
Afghanistan,04/09/2004,18,0,0,0,9,2,0,29
Afghanistan,05/09/2004,9,0,0,0,0,2,0,11
Afghanistan,06/09/2004,19,0,0,0,15,2,0,36
Afghanistan,07/09/2004,25,0,0,0,15,1,0,41
Afghanistan,08/09/2004,9,0,-2,0,3,0,0,10
Afghanistan,09/09/2004,47,0,1,0,6,3,0,57
Afghanistan,10/09/2004,49,0,0,0,-1,0,0,48
Afghanistan,11/09/2004,12,0,0,0,3,0,0,15
Afghanistan,12/09/2004,46,0,0,0,0,5,0,51
Afghanistan,13/09/2004,23,0,1,0,21,3,0,48
Afghanistan,14/09/2004,43,0,0,0,13,0,0,56
Afghanistan,15/09/2004,5,0,0,0,9,0,0,14
Afghanistan,16/09/2004,15,0,-2,0,9,1,0,23
Afghanistan,17/09/2004,10,0,-2,0,30,4,0,42
Afghanistan,18/09/2004,27,0,3,0,-2,3,0,31
Afghanistan,19/09/2004,25,0,0,0,3,3,0,31
Afghanistan,20/09/2004,7,0,0,0,0,0,0,7
Afghanistan,21/09/2004,23,0,3,0,3,9,0,38
Afghanistan,22/09/2004,27,0,4,0,2,6,0,39
Afghanistan,23/09/2004,20,0,0,0,3,3,0,26
Afghanistan,24/09/2004,13,0,0,0,22,4,0,39
Afghanistan,25/09/2004,10,0,0,0,6,7,0,23
Afghanistan,26/09/2004,45,0,-5,0,7,9,0,56
Afghanistan,27/09/2004,46,0,0,0,11,4,0,61
Afghanistan,28/09/2004,16,0,0,0,15,4,0,35
Afghanistan,29/09/2004,31,0,0,0,-2,0,0,29
Afghanistan,30/09/2004,38,2,0,0,10,7,0,57
Afghanistan,01/10/2004,43,0,0,0,19,2,0,64
Afghanistan,02/10/2004,6,0,0,0,3,0,0,9
Afghanistan,03/10/2004,11,0,0,0,0,18,0,29
Afghanistan,04/10/2004,28,0,0,0,8,4,0,40
Afghanistan,05/10/2004,20,0,1,0,3,0,0,24
Afghanistan,06/10/2004,31,0,0,0,6,0,0,37
Afghanistan,07/10/2004,27,0,0,0,18,1,0,46
Afghanistan,08/10/2004,18,0,0,0,13,5,0,36
Afghanistan,09/10/2004,18,0,3,0,9,13,0,43
Afghanistan,10/10/2004,41,0,3,0,10,16,0,70
Afghanistan,11/10/2004,35,0,5,0,12,7,0,59
Afghanistan,12/10/2004,31,0,0,0,17,4,0,52
Afghanistan,13/10/2004,22,0,2,0,18,3,0,45
Afghanistan,14/10/2004,12,2,2,0,17,2,0,35
Afghanistan,15/10/2004,4,0,0,0,13,1,0,18
Afghanistan,16/10/2004,3,0,0,0,2,8,0,13
Afghanistan,17/10/2004,8,0,-2,0,-3,0,0,3
Afghanistan,18/10/2004,22,0,0,0,9,1,0,32
Afghanistan,19/10/2004,38,0,0,0,19,3,0,60
Afghanistan,20/10/2004,8,0,-2,0,3,0,0,9
Afghanistan,21/10/2004,3,0,-2,0,12,2,0,15
Afghanistan,22/10/2004,13,0,0,0,17,1,0,31
Afghanistan,23/10/2004,20,0,0,0,1,1,0,22
Afghanistan,24/10/2004,3,0,0,0,-2,2,0,3
Afghanistan,25/10/2004,31,0,0,0,9,6,0,46
Afghanistan,26/10/2004,17,0,0,0,6,4,0,27
Afghanistan,27/10/2004,62,0,0,0,17,0,0,79
Afghanistan,28/10/2004,15,0,0,0,9,4,0,28
Afghanistan,29/10/2004,0,0,0,0,4,2,0,6
Afghanistan,30/10/2004,59,0,0,0,0,1,0,60
Afghanistan,31/10/2004,9,0,0,0,2,0,0,11
Afghanistan,01/11/2004,20,0,0,0,6,0,0,26
Afghanistan,02/11/2004,18,0,2,0,25,3,0,48
Afghanistan,03/11/2004,14,0,-2,0,23,0,0,35
Afghanistan,04/11/2004,19,0,0,0,13,2,0,34
Afghanistan,05/11/2004,16,2,0,0,9,0,0,27
Afghanistan,06/11/2004,7,0,0,0,3,2,0,12
Afghanistan,07/11/2004,3,0,0,0,-2,0,0,1
Afghanistan,08/11/2004,16,0,0,0,39,7,0,62
Afghanistan,09/11/2004,24,0,0,0,17,3,0,44
Afghanistan,10/11/2004,26,0,0,0,4,2,0,32
Afghanistan,11/11/2004,13,0,0,0,12,2,0,27
Afghanistan,12/11/2004,19,0,0,0,1,1,0,21
Afghanistan,13/11/2004,29,0,0,0,1,0,0,30
Afghanistan,14/11/2004,8,0,0,0,4,1,0,13
Afghanistan,15/11/2004,5,0,-4,0,9,0,0,10
Afghanistan,16/11/2004,12,0,0,0,3,0,0,15
Afghanistan,17/11/2004,17,0,0,0,13,0,0,30
Afghanistan,18/11/2004,3,0,0,0,3,0,0,6
Afghanistan,19/11/2004,11,0,0,0,3,2,0,16
Afghanistan,20/11/2004,10,0,0,0,2,0,0,12
Afghanistan,21/11/2004,21,0,0,0,0,1,0,22
Afghanistan,22/11/2004,30,2,0,0,12,0,0,44
Afghanistan,23/11/2004,7,0,0,0,2,1,0,10
Afghanistan,24/11/2004,13,0,0,0,-8,0,0,5
Afghanistan,25/11/2004,11,2,0,0,4,2,0,19
Afghanistan,26/11/2004,8,0,0,0,12,0,0,20
Afghanistan,27/11/2004,-2,0,0,0,4,0,0,2
Afghanistan,28/11/2004,19,0,0,0,2,1,0,22
Afghanistan,29/11/2004,10,0,0,0,12,2,0,24
Afghanistan,30/11/2004,17,0,0,0,-1,0,0,16
Afghanistan,01/12/2004,22,0,0,0,12,0,0,34
Afghanistan,02/12/2004,1,0,0,0,-6,2,0,-3
Afghanistan,03/12/2004,14,0,0,0,0,2,0,16
Afghanistan,04/12/2004,4,0,0,0,-2,0,0,2
Afghanistan,05/12/2004,14,0,0,0,8,1,0,23
Afghanistan,06/12/2004,22,0,1,0,7,4,0,34
Afghanistan,07/12/2004,18,0,0,0,6,1,0,25
Afghanistan,08/12/2004,19,0,0,0,13,0,0,32
Afghanistan,09/12/2004,17,0,0,0,6,0,0,23
Afghanistan,10/12/2004,23,0,0,0,9,2,0,34
Afghanistan,11/12/2004,10,0,1,0,3,0,0,14
Afghanistan,12/12/2004,-1,0,0,0,18,0,0,17
Afghanistan,13/12/2004,9,0,-4,0,16,2,0,23
Afghanistan,14/12/2004,36,0,-4,0,-2,6,0,36
Afghanistan,15/12/2004,38,0,0,0,20,1,0,59
Afghanistan,16/12/2004,24,0,-2,0,3,3,0,28
Afghanistan,17/12/2004,13,0,0,0,21,0,0,34
Afghanistan,18/12/2004,18,0,0,0,14,2,0,34
Afghanistan,19/12/2004,4,0,0,0,3,0,0,7
Afghanistan,20/12/2004,5,0,0,0,-1,2,0,6
Afghanistan,21/12/2004,17,0,0,0,6,0,0,23
Afghanistan,22/12/2004,15,2,0,0,3,0,0,20
Afghanistan,23/12/2004,5,0,0,0,0,0,0,5
Afghanistan,24/12/2004,7,0,0,0,3,4,0,14
Afghanistan,25/12/2004,19,0,0,0,4,2,0,25
Afghanistan,26/12/2004,12,0,0,0,3,2,0,17
Afghanistan,27/12/2004,15,0,0,0,4,2,0,21
Afghanistan,28/12/2004,21,0,-1,0,3,0,0,23
Afghanistan,29/12/2004,1,0,-9,0,6,3,0,1
Afghanistan,30/12/2004,22,0,-2,0,-2,2,0,20
Afghanistan,31/12/2004,0,0,0,0,0,1,0,1
Albania,02/01/2004,0,0,0,0,0,0,0,0
Albania,05/01/2004,4,0,0,0,0,0,0,4
Albania,06/01/2004,4,0,0,0,9,1,0,14
Albania,07/01/2004,3,0,0,0,0,2,0,5
Albania,08/01/2004,3,0,0,0,3,1,0,7
Albania,09/01/2004,17,0,0,0,4,0,0,21
Albania,10/01/2004,3,0,0,0,3,0,0,6
Albania,11/01/2004,24,0,0,0,0,0,0,24
Albania,12/01/2004,12,0,0,0,0,0,0,12
Albania,13/01/2004,6,0,0,0,2,0,0,8
Albania,14/01/2004,9,0,0,0,0,2,0,11
Albania,15/01/2004,5,0,0,0,0,1,0,6
Albania,16/01/2004,3,0,-2,0,-10,4,0,-5
Albania,17/01/2004,6,0,0,0,0,0,0,6
Albania,18/01/2004,11,0,0,0,0,0,0,11
Albania,19/01/2004,-2,0,0,0,0,1,0,-1
Albania,20/01/2004,1,0,1,0,-2,2,0,2
Albania,21/01/2004,12,0,0,0,0,0,0,12
Albania,22/01/2004,14,0,0,0,12,0,0,26
Albania,23/01/2004,5,0,0,0,0,0,0,5
Albania,24/01/2004,-1,0,0,0,0,0,0,-1
Albania,25/01/2004,0,0,0,0,0,0,0,0
Albania,26/01/2004,12,0,0,0,6,0,0,18
Albania,27/01/2004,1,0,0,0,0,4,0,5
Albania,28/01/2004,-10,0,0,0,0,3,0,-7
Albania,29/01/2004,5,0,0,0,13,1,0,19
Albania,30/01/2004,6,0,0,0,0,0,0,6
Albania,31/01/2004,2,0,1,0,0,1,0,4
Albania,01/02/2004,2,0,0,0,0,0,0,2
Albania,02/02/2004,3,0,0,0,1,6,0,10
Albania,03/02/2004,0,0,0,0,0,0,0,0
Albania,04/02/2004,1,0,0,0,9,0,0,10
Albania,05/02/2004,8,0,0,0,6,0,0,14
Albania,06/02/2004,2,4,0,0,3,0,0,9
Albania,07/02/2004,4,0,0,0,3,5,0,12
Albania,08/02/2004,4,0,0,0,3,1,0,8
Albania,09/02/2004,30,0,0,0,1,4,0,35
Albania,10/02/2004,2,0,0,0,9,0,0,11
Albania,11/02/2004,8,0,-2,0,2,2,0,10
Albania,12/02/2004,10,0,0,0,9,2,0,21
Albania,13/02/2004,-1,0,0,0,4,0,0,3
Albania,14/02/2004,1,0,0,0,0,4,0,5
Albania,15/02/2004,0,0,0,0,9,1,0,10
Albania,16/02/2004,31,0,0,0,21,1,0,53
Albania,17/02/2004,1,0,0,0,0,0,0,1
Albania,18/02/2004,-2,0,0,0,0,2,0,0
Albania,19/02/2004,14,0,0,0,1,0,0,15
Albania,20/02/2004,25,0,0,0,3,6,0,34
Albania,21/02/2004,3,0,0,0,-4,4,0,3
Albania,22/02/2004,6,0,0,0,0,0,0,6
Albania,23/02/2004,10,0,0,0,10,0,0,20
Albania,24/02/2004,-5,0,0,0,0,0,0,-5
Albania,25/02/2004,24,0,0,0,11,2,0,37
Albania,26/02/2004,27,0,0,0,0,0,0,27
Albania,27/02/2004,0,0,0,0,3,0,0,3
Albania,28/02/2004,7,0,0,0,0,0,0,7
Albania,29/02/2004,10,0,0,0,8,1,0,19
Albania,01/03/2004,15,0,0,0,0,1,0,16
Albania,02/03/2004,7,0,1,0,0,0,0,8
Albania,03/03/2004,11,0,0,0,4,3,0,18
Albania,04/03/2004,15,0,-1,0,3,0,0,17
Albania,05/03/2004,11,0,-6,0,6,2,0,13
Albania,06/03/2004,-7,0,0,0,0,0,0,-7
Albania,07/03/2004,-2,0,0,0,0,0,0,-2
Albania,08/03/2004,30,0,0,0,-2,2,0,30
Albania,09/03/2004,8,0,0,0,9,2,0,19
Albania,10/03/2004,0,0,0,0,3,0,0,3
Albania,11/03/2004,5,0,0,0,0,0,0,5
Albania,12/03/2004,1,0,0,0,0,1,0,2
Albania,13/03/2004,-2,0,0,0,0,1,0,-1
Albania,14/03/2004,6,0,0,0,0,2,0,8
Albania,15/03/2004,26,0,0,0,6,2,0,34
Albania,16/03/2004,62,0,0,0,2,2,0,66
Albania,17/03/2004,259,0,-3,0,30,52,0,338
Albania,18/03/2004,174,0,-1,0,52,85,0,310
Albania,19/03/2004,124,0,-1,0,10,32,0,165
Albania,20/03/2004,109,0,-1,0,4,13,0,125
Albania,21/03/2004,50,0,0,0,9,5,0,64
Albania,22/03/2004,70,0,0,0,6,31,0,107
Albania,23/03/2004,42,0,-2,0,3,0,0,43
Albania,24/03/2004,38,0,0,0,5,1,0,44
Albania,25/03/2004,34,0,-3,0,0,7,0,38
Albania,26/03/2004,67,0,-3,0,0,2,0,66
Albania,27/03/2004,2,0,0,0,-2,3,0,3
Albania,28/03/2004,9,0,0,0,3,13,0,25
Albania,29/03/2004,15,0,0,0,12,3,0,30
Albania,30/03/2004,26,0,-1,0,3,3,0,31
Albania,31/03/2004,-4,0,-1,0,3,6,0,4
Albania,01/04/2004,34,0,0,0,5,4,0,43
Albania,02/04/2004,17,0,-2,0,1,2,0,18
Albania,03/04/2004,5,0,-2,0,0,1,0,4
Albania,04/04/2004,1,0,0,0,0,0,0,1
Albania,05/04/2004,17,0,0,0,0,4,0,21
Albania,06/04/2004,10,0,0,0,-4,1,0,7
Albania,07/04/2004,8,0,0,0,0,2,0,10
Albania,08/04/2004,8,0,0,0,3,1,0,12
Albania,09/04/2004,1,0,0,0,0,2,0,3
Albania,10/04/2004,34,0,0,0,12,0,0,46
Albania,11/04/2004,5,0,0,0,2,0,0,7
Albania,12/04/2004,28,0,0,0,7,11,0,46
Albania,13/04/2004,18,0,0,0,0,1,0,19
Albania,14/04/2004,27,0,0,0,-1,7,0,33
Albania,15/04/2004,8,0,-2,0,0,4,0,10
Albania,16/04/2004,9,0,0,0,-3,3,0,9
Albania,17/04/2004,50,0,0,0,12,2,0,64
Albania,18/04/2004,18,0,0,0,13,1,0,32
Albania,19/04/2004,24,0,0,0,3,1,0,28
Albania,20/04/2004,34,0,0,0,7,0,0,41
Albania,21/04/2004,11,0,0,0,9,0,0,20
Albania,22/04/2004,26,0,0,0,6,0,0,32
Albania,23/04/2004,17,0,0,0,1,-1,0,17
Albania,24/04/2004,13,0,0,0,0,0,0,13
Albania,25/04/2004,10,0,0,0,0,0,0,10
Albania,26/04/2004,6,0,0,0,0,2,0,8
Albania,27/04/2004,18,0,0,0,7,2,0,27
Albania,28/04/2004,47,0,-8,0,51,12,0,102
Albania,29/04/2004,17,2,0,0,5,5,0,29
Albania,30/04/2004,6,0,0,0,0,0,0,6
Albania,01/05/2004,29,0,-1,0,-6,4,0,26
Albania,02/05/2004,9,0,-2,0,13,6,0,26
Albania,03/05/2004,13,0,-2,0,0,2,0,13
Albania,04/05/2004,3,0,0,0,9,0,0,12
Albania,05/05/2004,-1,0,0,0,1,0,0,0
Albania,06/05/2004,6,0,0,0,0,0,0,6
Albania,07/05/2004,0,0,0,0,-5,8,0,3
Albania,08/05/2004,23,0,0,0,6,0,0,29
Albania,09/05/2004,0,0,0,0,3,0,0,3
Albania,10/05/2004,11,0,0,0,0,1,0,12
Albania,11/05/2004,20,0,0,0,0,0,0,20
Albania,12/05/2004,7,0,0,0,-2,0,0,5
Albania,13/05/2004,8,0,0,0,0,0,0,8
Albania,14/05/2004,5,0,2,0,6,0,0,13
Albania,15/05/2004,2,0,0,0,9,0,0,11
Albania,16/05/2004,0,0,0,0,6,0,0,6
Albania,17/05/2004,9,0,-4,0,12,2,0,19
Albania,18/05/2004,12,0,0,0,20,0,0,32
Albania,19/05/2004,1,0,0,0,0,2,0,3
Albania,20/05/2004,5,0,0,0,3,0,0,8
Albania,21/05/2004,11,0,0,0,1,1,0,13
Albania,22/05/2004,0,0,0,0,-2,0,0,-2
Albania,23/05/2004,11,0,0,0,0,1,0,12
Albania,24/05/2004,22,2,0,0,3,1,0,28
Albania,25/05/2004,14,0,-8,0,9,1,0,16
Albania,26/05/2004,15,0,0,0,0,1,0,16
Albania,27/05/2004,10,0,0,0,6,0,0,16
Albania,28/05/2004,5,0,0,0,6,0,0,11
Albania,29/05/2004,12,0,0,0,-6,0,0,6
Albania,30/05/2004,1,0,0,0,0,0,0,1
Albania,31/05/2004,5,0,0,0,0,8,0,13
Albania,01/06/2004,0,0,0,0,0,0,0,0
Albania,02/06/2004,3,0,0,0,6,0,0,9
Albania,03/06/2004,15,0,0,0,6,0,0,21
Albania,04/06/2004,2,0,0,0,8,1,0,11
Albania,05/06/2004,16,0,0,0,3,0,0,19
Albania,06/06/2004,7,0,3,0,7,1,0,18
Albania,07/06/2004,22,0,0,0,3,2,0,27
Albania,08/06/2004,17,0,0,0,0,0,0,17
Albania,09/06/2004,14,0,0,0,6,0,0,20
Albania,10/06/2004,17,0,-2,0,3,0,0,18
Albania,11/06/2004,0,0,0,0,7,1,0,8
Albania,12/06/2004,2,0,0,0,-2,0,0,0
Albania,13/06/2004,0,0,0,0,0,9,0,9
Albania,14/06/2004,8,0,0,0,-3,0,0,5
Albania,15/06/2004,3,0,0,0,6,1,0,10
Albania,16/06/2004,4,0,0,0,3,1,0,8
Albania,17/06/2004,0,0,0,0,21,1,0,22
Albania,18/06/2004,9,0,0,0,0,1,0,10
Albania,19/06/2004,13,0,0,0,0,0,0,13
Albania,20/06/2004,0,0,0,0,14,0,0,14
Albania,21/06/2004,1,0,0,0,0,0,0,1
Albania,22/06/2004,1,0,0,0,0,0,0,1
Albania,23/06/2004,10,0,0,0,12,2,0,24
Albania,24/06/2004,17,0,0,0,9,1,0,27
Albania,25/06/2004,6,0,-2,0,18,1,0,23
Albania,26/06/2004,-2,0,3,0,0,1,0,2
Albania,27/06/2004,3,0,0,0,-6,1,0,-2
Albania,28/06/2004,10,0,0,0,0,1,0,11
Albania,29/06/2004,0,0,0,0,-1,0,0,-1
Albania,30/06/2004,6,0,0,0,3,0,0,9
Albania,01/07/2004,8,0,0,0,3,2,0,13
Albania,02/07/2004,4,0,0,0,1,0,0,5
Albania,03/07/2004,0,0,-4,0,0,2,0,-2
Albania,04/07/2004,1,0,0,0,-6,2,0,-3
Albania,05/07/2004,-3,0,0,0,0,0,0,-3
Albania,06/07/2004,0,0,0,0,0,0,0,0
Albania,07/07/2004,1,0,0,0,0,1,0,2
Albania,08/07/2004,19,0,-2,0,0,1,0,18
Albania,09/07/2004,4,0,0,0,6,3,0,13
Albania,10/07/2004,5,0,0,0,3,0,0,8
Albania,11/07/2004,16,0,0,0,-1,0,0,15
Albania,12/07/2004,1,0,0,0,0,0,0,1
Albania,13/07/2004,11,0,0,0,0,2,0,13
Albania,14/07/2004,3,0,0,0,-7,3,0,-1
Albania,15/07/2004,0,0,0,0,0,0,0,0
Albania,16/07/2004,10,0,0,0,0,1,0,11
Albania,18/07/2004,0,0,1,0,0,0,0,1
Albania,19/07/2004,0,0,0,0,0,5,0,5
Albania,20/07/2004,8,0,0,0,-1,0,0,7
Albania,21/07/2004,19,0,0,0,12,0,0,31
Albania,22/07/2004,9,0,0,0,0,0,0,9
Albania,23/07/2004,11,0,0,0,6,2,0,19
Albania,24/07/2004,8,0,0,0,-2,1,0,7
Albania,25/07/2004,0,0,-2,0,0,0,0,-2
Albania,26/07/2004,11,0,0,0,3,8,0,22
Albania,27/07/2004,8,0,0,0,1,0,0,9
Albania,28/07/2004,2,0,-1,0,4,9,0,14
Albania,29/07/2004,3,0,0,0,3,3,0,9
Albania,30/07/2004,3,0,1,0,-2,0,0,2
Albania,31/07/2004,-6,0,0,0,0,0,0,-6
Albania,02/08/2004,0,0,0,0,3,0,0,3
Albania,03/08/2004,2,0,0,0,0,1,0,3
Albania,04/08/2004,8,0,0,0,0,0,0,8
Albania,05/08/2004,13,0,1,0,3,2,0,19
Albania,06/08/2004,4,0,0,0,0,0,0,4
Albania,07/08/2004,1,0,0,0,0,0,0,1
Albania,08/08/2004,2,0,0,0,0,8,0,10
Albania,09/08/2004,0,0,0,0,0,2,0,2
Albania,10/08/2004,15,0,0,0,0,2,0,17
Albania,11/08/2004,6,0,1,0,7,14,0,28
Albania,12/08/2004,1,0,0,0,0,12,0,13
Albania,13/08/2004,6,0,0,0,0,1,0,7
Albania,14/08/2004,3,0,-1,0,0,0,0,2
Albania,15/08/2004,12,0,-6,0,3,3,0,12
Albania,16/08/2004,6,0,0,0,0,1,0,7
Albania,17/08/2004,1,0,0,0,0,0,0,1
Albania,18/08/2004,1,0,0,0,-2,0,0,-1
Albania,19/08/2004,8,0,0,0,3,0,0,11
Albania,20/08/2004,0,0,0,0,0,2,0,2
Albania,21/08/2004,3,0,0,0,0,1,0,4
Albania,23/08/2004,15,0,0,0,-4,3,0,14
Albania,24/08/2004,8,0,1,0,-4,0,0,5
Albania,25/08/2004,6,0,0,0,3,0,0,9
Albania,26/08/2004,21,0,0,0,3,0,0,24
Albania,27/08/2004,2,0,0,0,3,0,0,5
Albania,28/08/2004,0,0,0,0,0,0,0,0
Albania,29/08/2004,0,0,0,0,0,0,0,0
Albania,30/08/2004,16,0,0,0,6,1,0,23
Albania,31/08/2004,5,4,0,0,0,0,0,9
Albania,01/09/2004,16,0,1,0,0,0,0,17
Albania,02/09/2004,4,0,0,0,3,0,0,7
Albania,03/09/2004,0,0,0,0,4,0,0,4
Albania,04/09/2004,0,0,0,0,0,0,0,0
Albania,05/09/2004,6,0,0,0,0,0,0,6
Albania,06/09/2004,12,0,0,0,-3,0,0,9
Albania,07/09/2004,0,0,0,0,3,2,0,5
Albania,08/09/2004,4,0,0,0,0,0,0,4
Albania,09/09/2004,9,0,0,0,0,4,0,13
Albania,10/09/2004,1,0,0,0,0,0,0,1
Albania,11/09/2004,6,0,0,0,0,0,0,6
Albania,12/09/2004,0,0,0,0,0,0,0,0
Albania,13/09/2004,9,0,3,0,3,0,0,15
Albania,14/09/2004,19,0,1,0,9,4,0,33
Albania,15/09/2004,15,0,0,0,6,1,0,22
Albania,16/09/2004,0,0,0,0,0,0,0,0
Albania,17/09/2004,0,0,0,0,0,0,0,0
Albania,18/09/2004,0,0,0,0,0,0,0,0
Albania,19/09/2004,0,0,0,0,0,0,0,0
Albania,21/09/2004,2,0,0,0,3,0,0,5
Albania,22/09/2004,11,0,0,0,9,1,0,21
Albania,23/09/2004,18,0,0,0,6,0,0,24
Albania,24/09/2004,4,0,-4,0,0,0,0,0
Albania,25/09/2004,0,0,0,0,0,0,0,0
Albania,26/09/2004,0,0,0,0,0,0,0,0
Albania,27/09/2004,-3,0,0,0,-2,0,0,-5
Albania,28/09/2004,7,0,0,0,14,2,0,23
Albania,29/09/2004,6,0,0,0,21,2,0,29
Albania,30/09/2004,2,0,0,0,3,0,0,5
Albania,01/10/2004,7,0,0,0,0,0,0,7
Albania,02/10/2004,0,0,0,0,0,2,0,2
Albania,03/10/2004,6,0,-2,0,0,2,0,6
Albania,04/10/2004,3,0,0,0,0,2,0,5
Albania,05/10/2004,2,0,-2,0,6,0,0,6
Albania,06/10/2004,4,0,0,0,3,2,0,9
Albania,07/10/2004,0,0,0,0,0,0,0,0
Albania,08/10/2004,12,0,-4,0,2,7,0,17
Albania,09/10/2004,7,0,0,0,6,0,0,13
Albania,10/10/2004,-2,0,0,0,3,0,0,1
Albania,11/10/2004,0,0,0,0,3,0,0,3
Albania,12/10/2004,25,0,0,0,6,0,0,31
Albania,13/10/2004,5,0,0,0,6,1,0,12
Albania,14/10/2004,9,0,0,0,-2,0,0,7
Albania,15/10/2004,9,0,0,0,0,0,0,9
Albania,16/10/2004,-1,0,0,0,0,0,0,-1
Albania,17/10/2004,0,0,0,0,0,0,0,0
Albania,18/10/2004,6,0,0,0,0,0,0,6
Albania,19/10/2004,20,0,0,0,3,1,0,24
Albania,20/10/2004,1,0,0,0,3,1,0,5
Albania,21/10/2004,5,0,0,0,0,0,0,5
Albania,22/10/2004,0,0,0,0,3,2,0,5
Albania,23/10/2004,4,0,0,0,9,8,0,21
Albania,24/10/2004,21,0,-1,0,0,10,0,30
Albania,25/10/2004,-2,0,0,0,0,2,0,0
Albania,26/10/2004,16,0,0,0,3,5,0,24
Albania,27/10/2004,0,0,0,0,3,0,0,3
Albania,28/10/2004,-2,0,0,0,0,0,0,-2
Albania,29/10/2004,12,4,0,0,-2,1,0,15
Albania,30/10/2004,9,0,0,0,15,0,0,24
Albania,31/10/2004,0,0,-2,0,0,0,0,-2
Albania,01/11/2004,0,0,0,0,3,0,0,3
Albania,02/11/2004,4,0,0,0,3,1,0,8
Albania,03/11/2004,25,0,-1,0,9,2,0,35
Albania,04/11/2004,11,0,1,0,9,0,0,21
Albania,05/11/2004,21,2,0,0,6,2,0,31
Albania,06/11/2004,-1,0,0,0,0,0,0,-1
Albania,07/11/2004,5,0,0,0,0,9,0,14
Albania,08/11/2004,4,0,0,0,12,1,0,17
Albania,09/11/2004,5,0,0,0,3,1,0,9
Albania,10/11/2004,4,0,0,0,0,0,0,4
Albania,11/11/2004,2,0,0,0,0,2,0,4
Albania,12/11/2004,4,0,0,0,0,3,0,7
Albania,13/11/2004,10,0,0,0,8,0,0,18
Albania,14/11/2004,1,0,0,0,3,0,0,4
Albania,15/11/2004,14,0,-9,0,27,6,0,38
Albania,16/11/2004,3,0,0,0,3,3,0,9
Albania,17/11/2004,4,0,0,0,0,0,0,4
Albania,18/11/2004,-2,0,0,0,0,0,0,-2
Albania,19/11/2004,1,0,0,0,0,0,0,1
Albania,20/11/2004,5,0,-6,0,0,0,0,-1
Albania,21/11/2004,3,0,0,0,6,3,0,12
Albania,22/11/2004,24,0,1,0,0,4,0,29
Albania,23/11/2004,4,0,0,0,-2,0,0,2
Albania,24/11/2004,-1,0,0,0,9,1,0,9
Albania,25/11/2004,0,0,0,0,6,0,0,6
Albania,26/11/2004,8,0,-2,0,2,0,0,8
Albania,27/11/2004,2,0,0,0,0,0,0,2
Albania,28/11/2004,10,0,0,0,0,1,0,11
Albania,29/11/2004,14,0,0,0,3,1,0,18
Albania,30/11/2004,8,0,0,0,2,0,0,10
Albania,01/12/2004,18,0,0,0,12,0,0,30
Albania,02/12/2004,0,0,0,0,3,2,0,5
Albania,03/12/2004,11,0,1,0,22,1,0,35
Albania,04/12/2004,6,0,3,0,1,0,0,10
Albania,05/12/2004,3,0,0,0,-4,0,0,-1
Albania,06/12/2004,7,0,0,0,0,0,0,7
Albania,07/12/2004,4,0,0,0,0,0,0,4
Albania,08/12/2004,-1,0,0,0,0,0,0,-1
Albania,09/12/2004,6,0,1,0,15,2,0,24
Albania,10/12/2004,2,0,0,0,3,0,0,5
Albania,11/12/2004,0,0,0,0,0,0,0,0
Albania,12/12/2004,2,0,1,0,3,0,0,6
Albania,13/12/2004,4,0,0,0,0,0,0,4
Albania,14/12/2004,14,0,-2,0,3,1,0,16
Albania,15/12/2004,24,0,0,0,13,2,0,39
Albania,16/12/2004,2,0,0,0,0,1,0,3
Albania,17/12/2004,7,0,0,0,-2,0,0,5
Albania,18/12/2004,0,0,0,0,0,4,0,4
Albania,19/12/2004,0,0,0,0,0,0,0,0
Albania,20/12/2004,11,0,0,0,31,3,0,45
Albania,21/12/2004,4,0,0,0,9,0,0,13
Albania,22/12/2004,34,0,0,0,9,2,0,45
Albania,23/12/2004,8,0,0,0,0,0,0,8
Albania,24/12/2004,3,0,0,0,0,2,0,5
Albania,25/12/2004,2,0,1,0,6,0,0,9
Albania,26/12/2004,12,0,0,0,12,0,0,24
Albania,27/12/2004,4,0,0,0,12,0,0,16
Albania,28/12/2004,4,0,0,0,3,0,0,7
Albania,29/12/2004,1,0,0,0,7,0,0,8
Albania,30/12/2004,2,0,0,0,0,1,0,3
Albania,31/12/2004,0,0,0,0,0,0,0,0
Algeria,01/01/2004,0,0,0,0,0,0,0,0
Algeria,02/01/2004,6,0,0,0,0,0,0,6
Algeria,03/01/2004,2,0,0,0,0,0,0,2
Algeria,04/01/2004,12,0,0,0,0,1,0,13
Algeria,05/01/2004,0,0,0,0,-4,0,0,-4
Algeria,06/01/2004,0,0,0,0,0,0,0,0
Algeria,07/01/2004,7,0,0,0,-4,0,0,3
Algeria,08/01/2004,-1,0,0,0,-4,0,0,-5
Algeria,09/01/2004,6,0,0,0,3,0,0,9
Algeria,10/01/2004,7,0,0,0,1,2,0,10
Algeria,11/01/2004,4,0,0,0,6,0,0,10
Algeria,12/01/2004,2,0,0,0,0,0,0,2
Algeria,13/01/2004,0,0,0,0,0,0,0,0
Algeria,14/01/2004,-1,0,0,0,6,0,0,5
Algeria,15/01/2004,5,0,0,0,9,0,0,14
Algeria,16/01/2004,2,0,0,0,4,1,0,7
Algeria,17/01/2004,10,0,-2,0,2,0,0,10
Algeria,18/01/2004,1,0,1,0,-2,2,0,2
Algeria,19/01/2004,0,0,0,0,0,0,0,0
Algeria,20/01/2004,8,0,0,0,6,0,0,14
Algeria,21/01/2004,1,0,0,0,0,0,0,1
Algeria,22/01/2004,6,0,0,0,9,2,0,17
Algeria,23/01/2004,4,0,2,0,0,0,0,6
Algeria,24/01/2004,2,0,1,0,0,0,0,3
Algeria,25/01/2004,5,0,0,0,0,0,0,5
Algeria,26/01/2004,5,0,0,0,6,0,0,11
Algeria,27/01/2004,2,0,0,0,12,0,0,14
Algeria,28/01/2004,2,0,0,0,0,0,0,2
Algeria,29/01/2004,1,0,0,0,0,3,0,4
Algeria,30/01/2004,-3,0,0,0,0,0,0,-3
Algeria,31/01/2004,-2,0,0,0,0,0,0,-2
Algeria,01/02/2004,3,0,0,0,0,0,0,3
Algeria,02/02/2004,0,0,0,0,21,1,0,22
Algeria,03/02/2004,-2,0,0,0,0,0,0,-2
Algeria,04/02/2004,14,0,0,0,0,1,0,15
Algeria,05/02/2004,1,0,0,0,3,0,0,4
Algeria,06/02/2004,3,0,0,0,3,0,0,6
Algeria,07/02/2004,5,0,0,0,0,0,0,5
Algeria,08/02/2004,3,0,0,0,0,0,0,3
Algeria,09/02/2004,0,0,-4,0,0,0,0,-4
Algeria,10/02/2004,-1,0,0,0,3,0,0,2
Algeria,11/02/2004,0,0,-1,0,3,0,0,2
Algeria,12/02/2004,3,0,0,0,9,0,0,12
Algeria,13/02/2004,10,0,0,0,9,1,0,20
Algeria,14/02/2004,4,0,-1,0,6,0,0,9
Algeria,15/02/2004,0,0,0,0,18,0,0,18
Algeria,16/02/2004,3,0,0,0,0,0,0,3
Algeria,17/02/2004,0,0,0,0,3,0,0,3
Algeria,18/02/2004,2,0,0,0,0,0,0,2
Algeria,19/02/2004,-8,0,0,0,2,0,0,-6
Algeria,20/02/2004,1,0,0,0,0,2,0,3
Algeria,21/02/2004,-1,0,0,0,0,0,0,-1
Algeria,22/02/2004,2,0,0,0,-4,1,0,-1
Algeria,23/02/2004,0,0,0,0,12,1,0,13
Algeria,24/02/2004,4,0,0,0,0,0,0,4
Algeria,25/02/2004,0,0,0,0,-7,0,0,-7
Algeria,26/02/2004,16,0,0,0,-8,1,0,9
Algeria,27/02/2004,3,0,0,0,0,0,0,3
Algeria,28/02/2004,6,0,0,0,0,0,0,6
Algeria,29/02/2004,1,0,0,0,0,1,0,2
Algeria,01/03/2004,2,0,0,0,0,0,0,2
Algeria,02/03/2004,3,0,0,0,1,0,0,4
Algeria,03/03/2004,10,0,0,0,3,0,0,13
Algeria,04/03/2004,4,0,0,0,0,3,0,7
Algeria,05/03/2004,4,0,1,0,-3,0,0,2
Algeria,07/03/2004,9,0,0,0,12,0,0,21
Algeria,08/03/2004,2,0,2,0,-3,0,0,1
Algeria,09/03/2004,42,0,0,0,0,0,0,42
Algeria,10/03/2004,8,0,0,0,15,0,0,23
Algeria,11/03/2004,-2,0,0,0,3,0,0,1
Algeria,12/03/2004,36,0,0,0,0,2,0,38
Algeria,13/03/2004,2,0,0,0,6,1,0,9
Algeria,14/03/2004,3,0,0,0,0,0,0,3
Algeria,15/03/2004,17,0,0,0,1,0,0,18
Algeria,16/03/2004,0,0,0,0,4,0,0,4
Algeria,17/03/2004,4,0,0,0,3,0,0,7
Algeria,18/03/2004,4,0,0,0,6,1,0,11
Algeria,19/03/2004,8,0,4,0,0,0,0,12
Algeria,20/03/2004,0,0,0,0,-2,0,0,-2
Algeria,21/03/2004,0,0,0,0,0,0,0,0
Algeria,22/03/2004,12,0,0,0,0,0,0,12
Algeria,23/03/2004,6,0,0,0,12,0,0,18
Algeria,24/03/2004,6,1,0,0,3,0,0,10
Algeria,25/03/2004,1,0,-2,0,24,0,0,23
Algeria,26/03/2004,8,0,0,0,0,1,0,9
Algeria,27/03/2004,4,0,0,0,0,0,0,4
Algeria,28/03/2004,6,0,0,0,0,0,0,6
Algeria,29/03/2004,-2,0,0,0,0,0,0,-2
Algeria,30/03/2004,5,0,0,0,12,2,0,19
Algeria,31/03/2004,0,0,0,0,9,0,0,9
Algeria,01/04/2004,0,0,0,0,0,0,0,0
Algeria,02/04/2004,0,0,0,0,3,0,0,3
Algeria,03/04/2004,0,0,0,0,3,0,0,3
Algeria,04/04/2004,0,0,0,0,3,0,0,3
Algeria,05/04/2004,1,0,0,0,0,2,0,3
Algeria,06/04/2004,0,0,0,0,0,0,0,0
Algeria,07/04/2004,1,0,0,0,0,1,0,2
Algeria,08/04/2004,8,0,-2,0,9,0,0,15
Algeria,09/04/2004,7,0,1,0,0,-1,0,7
Algeria,10/04/2004,1,0,0,0,10,0,0,11
Algeria,11/04/2004,0,0,0,0,0,0,0,0
Algeria,12/04/2004,2,0,-6,0,12,0,0,8
Algeria,13/04/2004,5,0,0,0,9,0,0,14
Algeria,14/04/2004,10,0,0,0,6,0,0,16
Algeria,15/04/2004,2,0,0,0,0,0,0,2
Algeria,16/04/2004,3,0,0,0,0,0,0,3
Algeria,17/04/2004,6,0,0,0,0,0,0,6
Algeria,18/04/2004,3,0,0,0,0,0,0,3
Algeria,19/04/2004,3,0,0,0,0,0,0,3
Algeria,20/04/2004,10,0,0,0,16,0,0,26
Algeria,21/04/2004,1,0,0,0,6,0,0,7
Algeria,22/04/2004,2,0,0,0,0,1,0,3
Algeria,23/04/2004,4,0,0,0,1,0,0,5
Algeria,24/04/2004,1,0,0,0,0,0,0,1
Algeria,25/04/2004,-1,0,0,0,0,0,0,-1
Algeria,26/04/2004,3,0,-2,0,0,0,0,1
Algeria,27/04/2004,6,0,0,0,0,0,0,6
Algeria,28/04/2004,-2,0,0,0,3,0,0,1
Algeria,29/04/2004,4,0,0,0,3,0,0,7
Algeria,01/05/2004,1,0,0,0,0,0,0,1
Algeria,02/05/2004,-1,0,0,0,0,0,0,-1
Algeria,03/05/2004,0,0,0,0,15,1,0,16
Algeria,04/05/2004,5,0,0,0,-1,0,0,4
Algeria,05/05/2004,0,0,0,0,3,0,0,3
Algeria,06/05/2004,4,0,0,0,9,0,0,13
Algeria,07/05/2004,33,0,0,0,0,1,0,34
Algeria,08/05/2004,1,0,0,0,6,0,0,7
Algeria,09/05/2004,4,0,0,0,3,0,0,7
Algeria,10/05/2004,1,0,0,0,1,0,0,2
Algeria,11/05/2004,0,0,0,0,15,2,0,17
Algeria,12/05/2004,4,0,0,0,0,0,0,4
Algeria,13/05/2004,5,0,0,0,4,0,0,9
Algeria,14/05/2004,12,0,0,0,1,0,0,13
Algeria,15/05/2004,5,0,0,0,6,0,0,11
Algeria,16/05/2004,3,0,0,0,3,0,0,6
Algeria,17/05/2004,1,0,0,0,0,0,0,1
Algeria,18/05/2004,10,0,0,0,27,0,0,37
Algeria,19/05/2004,2,0,0,0,3,0,0,5
Algeria,20/05/2004,5,0,0,0,1,1,0,7
Algeria,21/05/2004,0,0,0,0,-4,0,0,-4
Algeria,22/05/2004,11,0,0,0,0,0,0,11
Algeria,23/05/2004,0,0,0,0,0,0,0,0
Algeria,24/05/2004,3,0,0,0,0,-2,0,1
Algeria,25/05/2004,-1,0,0,0,3,0,0,2
Algeria,26/05/2004,0,0,0,0,21,0,0,21
Algeria,27/05/2004,0,0,0,0,-2,0,0,-2
Algeria,28/05/2004,2,0,0,0,0,0,0,2
Algeria,29/05/2004,0,0,0,0,0,0,0,0
Algeria,30/05/2004,2,0,0,0,0,0,0,2
Algeria,31/05/2004,13,0,0,0,0,0,0,13
Algeria,01/06/2004,0,0,0,0,6,0,0,6
Algeria,02/06/2004,-2,0,0,0,0,0,0,-2
Algeria,03/06/2004,8,0,0,0,0,0,0,8
Algeria,04/06/2004,0,0,0,0,0,0,0,0
Algeria,05/06/2004,0,0,0,0,7,1,0,8
Algeria,06/06/2004,1,0,0,0,0,0,0,1
Algeria,07/06/2004,1,0,0,0,17,0,0,18
Algeria,08/06/2004,0,0,0,0,0,0,0,0
Algeria,09/06/2004,2,0,0,0,18,0,0,20
Algeria,10/06/2004,2,0,0,0,9,0,0,11
Algeria,11/06/2004,8,0,-2,0,0,0,0,6
Algeria,12/06/2004,4,0,-2,0,0,0,0,2
Algeria,13/06/2004,3,0,0,0,0,0,0,3
Algeria,14/06/2004,47,0,0,0,0,0,0,47
Algeria,15/06/2004,1,0,0,0,0,0,0,1
Algeria,16/06/2004,2,0,0,0,3,0,0,5
Algeria,17/06/2004,2,0,0,0,3,2,0,7
Algeria,18/06/2004,6,0,0,0,-2,1,0,5
Algeria,19/06/2004,15,0,0,0,-2,1,0,14
Algeria,20/06/2004,3,0,0,0,24,0,0,27
Algeria,21/06/2004,19,0,0,0,18,0,0,37
Algeria,22/06/2004,4,0,0,0,10,1,0,15
Algeria,23/06/2004,7,0,0,0,0,0,0,7
Algeria,24/06/2004,2,0,0,0,24,0,0,26
Algeria,25/06/2004,-4,0,0,0,-2,0,0,-6
Algeria,26/06/2004,0,0,0,0,0,0,0,0
Algeria,27/06/2004,3,0,0,0,0,0,0,3
Algeria,28/06/2004,8,0,0,0,-2,0,0,6
Algeria,29/06/2004,3,0,0,0,0,0,0,3
Algeria,30/06/2004,1,0,0,0,0,0,0,1
Algeria,01/07/2004,0,0,0,0,0,0,0,0
Algeria,02/07/2004,6,0,0,0,0,0,0,6
Algeria,03/07/2004,3,0,0,0,9,0,0,12
Algeria,04/07/2004,0,0,0,0,0,0,0,0
Algeria,05/07/2004,4,0,0,0,4,0,0,8
Algeria,06/07/2004,2,2,0,0,0,0,0,4
Algeria,07/07/2004,0,0,0,0,0,0,0,0
Algeria,08/07/2004,3,0,0,0,8,0,0,11
Algeria,09/07/2004,0,0,0,0,0,0,0,0
Algeria,10/07/2004,2,0,0,0,0,0,0,2
Algeria,11/07/2004,2,0,0,0,0,0,0,2
Algeria,12/07/2004,3,0,0,0,0,0,0,3
Algeria,13/07/2004,3,0,0,0,9,0,0,12
Algeria,14/07/2004,0,0,0,0,0,0,0,0
Algeria,15/07/2004,-1,0,0,0,0,0,0,-1
Algeria,16/07/2004,0,0,-1,0,0,0,0,-1
Algeria,17/07/2004,0,0,0,0,0,0,0,0
Algeria,18/07/2004,0,0,-4,0,0,0,0,-4
Algeria,19/07/2004,0,0,0,0,6,0,0,6
Algeria,20/07/2004,5,0,0,0,9,0,0,14
Algeria,21/07/2004,0,0,0,0,0,0,0,0
Algeria,22/07/2004,0,0,0,0,0,0,0,0
Algeria,23/07/2004,6,0,0,0,3,0,0,9
Algeria,24/07/2004,-1,0,0,0,0,0,0,-1
Algeria,25/07/2004,-2,0,0,0,0,0,0,-2
Algeria,26/07/2004,12,0,0,0,5,0,0,17
Algeria,27/07/2004,0,0,0,0,6,0,0,6
Algeria,28/07/2004,6,0,0,0,0,0,0,6
Algeria,29/07/2004,5,0,0,0,3,0,0,8
Algeria,30/07/2004,0,0,0,0,0,0,0,0
Algeria,31/07/2004,0,0,0,0,0,0,0,0
Algeria,01/08/2004,0,0,0,0,0,0,0,0
Algeria,02/08/2004,0,0,0,0,0,0,0,0
Algeria,03/08/2004,4,0,0,0,10,0,0,14
Algeria,04/08/2004,0,0,0,0,0,0,0,0
Algeria,05/08/2004,3,0,0,0,-3,0,0,0
Algeria,06/08/2004,4,0,0,0,0,0,0,4
Algeria,07/08/2004,0,0,0,0,0,0,0,0
Algeria,09/08/2004,3,0,0,0,3,0,0,6
Algeria,10/08/2004,0,0,0,0,3,0,0,3
Algeria,11/08/2004,0,0,0,0,0,2,0,2
Algeria,12/08/2004,0,0,0,0,-2,0,0,-2
Algeria,13/08/2004,-1,0,0,0,0,0,0,-1
Algeria,14/08/2004,0,0,0,0,0,0,0,0
Algeria,15/08/2004,3,0,0,0,0,0,0,3
Algeria,16/08/2004,0,0,0,0,0,0,0,0
Algeria,17/08/2004,0,0,0,0,4,0,0,4
Algeria,18/08/2004,7,0,0,0,6,2,0,15
Algeria,19/08/2004,6,0,0,0,6,0,0,12
Algeria,20/08/2004,0,0,0,0,6,0,0,6
Algeria,22/08/2004,2,0,0,0,0,0,0,2
Algeria,23/08/2004,0,0,0,0,-6,0,0,-6
Algeria,24/08/2004,7,0,0,0,0,0,0,7
Algeria,25/08/2004,0,0,0,0,0,0,0,0
Algeria,26/08/2004,8,0,0,0,-2,0,0,6
Algeria,27/08/2004,3,0,0,0,0,0,0,3
Algeria,28/08/2004,0,0,0,0,0,0,0,0
Algeria,30/08/2004,2,0,0,0,0,0,0,2
Algeria,31/08/2004,0,0,0,0,0,0,0,0
Algeria,01/09/2004,3,0,0,0,0,0,0,3
Algeria,02/09/2004,0,0,0,0,3,0,0,3
Algeria,03/09/2004,0,0,0,0,0,2,0,2
Algeria,04/09/2004,0,0,0,0,-2,0,0,-2
Algeria,06/09/2004,0,0,0,0,6,0,0,6
Algeria,07/09/2004,3,0,0,0,0,0,0,3
Algeria,08/09/2004,8,0,0,0,0,0,0,8
Algeria,09/09/2004,3,0,0,0,0,0,0,3
Algeria,10/09/2004,0,0,0,0,0,0,0,0
Algeria,11/09/2004,9,0,0,0,7,0,0,16
Algeria,12/09/2004,0,0,0,0,2,0,0,2
Algeria,13/09/2004,0,0,0,0,-2,0,0,-2
Algeria,14/09/2004,4,0,0,0,3,0,0,7
Algeria,15/09/2004,11,2,0,0,21,0,0,34
Algeria,16/09/2004,6,0,-2,0,9,0,0,13
Algeria,17/09/2004,2,0,0,0,15,1,0,18
Algeria,18/09/2004,0,0,0,0,6,0,0,6
Algeria,19/09/2004,0,0,0,0,0,0,0,0
Algeria,20/09/2004,7,0,0,0,6,0,0,13
Algeria,21/09/2004,2,0,0,0,0,0,0,2
Algeria,22/09/2004,0,0,0,0,3,0,0,3
Algeria,23/09/2004,-1,0,0,0,0,0,0,-1
Algeria,24/09/2004,0,0,0,0,0,0,0,0
Algeria,25/09/2004,0,0,0,0,0,0,0,0
Algeria,26/09/2004,0,0,0,0,0,0,0,0
Algeria,27/09/2004,3,0,0,0,0,0,0,3
Algeria,29/09/2004,13,0,0,0,0,0,0,13
Algeria,30/09/2004,11,0,0,0,0,0,0,11
Algeria,01/10/2004,0,0,0,0,0,1,0,1
Algeria,02/10/2004,0,0,0,0,0,0,0,0
Algeria,03/10/2004,0,0,0,0,0,0,0,0
Algeria,04/10/2004,6,0,0,0,16,0,0,22
Algeria,05/10/2004,7,0,0,0,21,6,0,34
Algeria,06/10/2004,4,0,0,0,3,0,0,7
Algeria,07/10/2004,6,0,0,0,12,0,0,18
Algeria,08/10/2004,10,0,0,0,0,0,0,10
Algeria,09/10/2004,8,0,0,0,0,1,0,9
Algeria,10/10/2004,9,0,0,0,0,0,0,9
Algeria,11/10/2004,2,0,0,0,0,0,0,2
Algeria,12/10/2004,-1,0,0,0,0,0,0,-1
Algeria,13/10/2004,7,0,0,0,0,0,0,7
Algeria,14/10/2004,3,0,-4,0,0,0,0,-1
Algeria,15/10/2004,1,0,0,0,18,0,0,19
Algeria,16/10/2004,5,0,0,0,0,0,0,5
Algeria,17/10/2004,0,0,0,0,3,0,0,3
Algeria,18/10/2004,2,0,0,0,0,1,0,3
Algeria,19/10/2004,2,0,0,0,6,0,0,8
Algeria,20/10/2004,5,0,1,0,15,1,0,22
Algeria,21/10/2004,-2,0,3,0,-3,3,0,1
Algeria,22/10/2004,0,0,-1,0,0,-4,0,-5
Algeria,23/10/2004,0,0,0,0,-1,0,0,-1
Algeria,24/10/2004,3,0,0,0,3,1,0,7
Algeria,25/10/2004,6,0,0,0,0,1,0,7
Algeria,26/10/2004,0,0,0,0,3,1,0,4
Algeria,27/10/2004,2,0,0,0,6,0,0,8
Algeria,28/10/2004,0,0,0,0,2,0,0,2
Algeria,29/10/2004,8,0,0,0,9,0,0,17
Algeria,30/10/2004,-3,0,0,0,0,0,0,-3
Algeria,31/10/2004,0,0,0,0,0,0,0,0
Algeria,01/11/2004,0,0,0,0,3,0,0,3
Algeria,02/11/2004,0,0,0,0,3,0,0,3
Algeria,03/11/2004,7,0,0,0,0,0,0,7
Algeria,04/11/2004,0,0,0,0,0,0,0,0
Algeria,05/11/2004,0,0,0,0,0,0,0,0
Algeria,06/11/2004,0,0,0,0,0,1,0,1
Algeria,07/11/2004,0,0,0,0,0,0,0,0
Algeria,08/11/2004,4,0,0,0,0,0,0,4
Algeria,09/11/2004,2,0,0,0,6,0,0,8
Algeria,10/11/2004,0,0,0,0,9,0,0,9
Algeria,11/11/2004,1,0,0,0,6,4,0,11
Algeria,12/11/2004,0,0,0,0,0,0,0,0
Algeria,13/11/2004,1,0,0,0,0,0,0,1
Algeria,14/11/2004,0,0,0,0,0,0,0,0
Algeria,15/11/2004,0,0,0,0,0,0,0,0
Algeria,16/11/2004,0,0,0,0,0,0,0,0
Algeria,17/11/2004,0,0,0,0,9,0,0,9
Algeria,18/11/2004,0,0,0,0,0,0,0,0
Algeria,19/11/2004,0,0,0,0,0,0,0,0
Algeria,20/11/2004,0,0,0,0,3,0,0,3
Algeria,21/11/2004,0,0,0,0,1,3,0,4
Algeria,22/11/2004,0,0,0,0,0,0,0,0
Algeria,23/11/2004,0,0,0,0,0,0,0,0
Algeria,24/11/2004,2,0,0,0,0,0,0,2
Algeria,25/11/2004,3,0,0,0,5,3,0,11
Algeria,26/11/2004,0,0,0,0,0,0,0,0
Algeria,27/11/2004,0,0,0,0,0,0,0,0
Algeria,28/11/2004,0,0,0,0,0,0,0,0
Algeria,29/11/2004,-1,0,0,0,0,0,0,-1
Algeria,30/11/2004,-3,0,0,0,0,0,0,-3
Algeria,01/12/2004,3,0,0,0,0,0,0,3
Algeria,02/12/2004,6,0,0,0,0,4,0,10
Algeria,03/12/2004,4,0,0,0,0,4,0,8
Algeria,04/12/2004,0,0,0,0,0,0,0,0
Algeria,05/12/2004,2,0,0,0,0,0,0,2
Algeria,06/12/2004,3,0,0,0,3,0,0,6
Algeria,07/12/2004,9,0,0,0,15,0,0,24
Algeria,08/12/2004,0,0,0,0,0,0,0,0
Algeria,09/12/2004,4,0,0,0,-1,0,0,3
Algeria,10/12/2004,6,0,0,0,6,3,0,15
Algeria,11/12/2004,0,0,0,0,9,0,0,9
Algeria,12/12/2004,3,0,0,0,0,0,0,3
Algeria,13/12/2004,0,0,0,0,3,0,0,3
Algeria,14/12/2004,9,0,0,0,21,0,0,30
Algeria,15/12/2004,0,0,0,0,9,0,0,9
Algeria,16/12/2004,-1,0,0,0,3,0,0,2
Algeria,17/12/2004,0,0,0,0,0,0,0,0
Algeria,19/12/2004,0,0,0,0,0,0,0,0
Algeria,20/12/2004,4,0,0,0,3,0,0,7
Algeria,21/12/2004,-1,0,0,0,0,0,0,-1
Algeria,22/12/2004,0,0,0,0,0,0,0,0
Algeria,24/12/2004,3,0,0,0,0,0,0,3
Algeria,25/12/2004,0,0,0,0,0,0,0,0
Algeria,26/12/2004,6,0,0,0,-2,0,0,4
Algeria,27/12/2004,0,0,0,0,0,0,0,0
Algeria,28/12/2004,0,0,0,0,0,0,0,0
Algeria,29/12/2004,2,0,0,0,0,0,0,2
Algeria,30/12/2004,3,0,0,0,0,0,0,3
Algeria,31/12/2004,0,0,0,0,0,0,0,0
Bangladesh,01/01/2004,3,0,0,0,1,0,0,4
Bangladesh,02/01/2004,5,0,0,0,0,0,0,5
Bangladesh,03/01/2004,1,0,0,0,3,0,0,4
Bangladesh,04/01/2004,14,0,0,0,0,0,0,14
Bangladesh,05/01/2004,2,0,0,0,0,0,0,2
Bangladesh,06/01/2004,-1,0,0,0,0,0,0,-1
Bangladesh,07/01/2004,0,0,0,0,0,0,0,0
Bangladesh,08/01/2004,0,0,0,0,0,0,0,0
Bangladesh,09/01/2004,-9,0,0,0,0,0,0,-9
Bangladesh,10/01/2004,3,0,0,0,0,0,0,3
Bangladesh,13/01/2004,0,0,0,0,0,0,0,0
Bangladesh,14/01/2004,0,0,0,0,0,0,0,0
Bangladesh,16/01/2004,5,0,0,0,6,3,0,14
Bangladesh,17/01/2004,0,0,0,0,0,0,0,0
Bangladesh,18/01/2004,2,0,0,0,0,0,0,2
Bangladesh,19/01/2004,2,0,0,0,12,1,0,15
Bangladesh,20/01/2004,9,0,0,0,3,3,0,15
Bangladesh,21/01/2004,0,0,0,0,0,0,0,0
Bangladesh,22/01/2004,0,0,0,0,0,0,0,0
Bangladesh,23/01/2004,-1,0,0,0,0,0,0,-1
Bangladesh,24/01/2004,-3,0,0,0,0,2,0,-1
Bangladesh,26/01/2004,0,0,0,0,0,0,0,0
Bangladesh,27/01/2004,5,0,0,0,10,3,0,18
Bangladesh,28/01/2004,0,0,0,0,6,0,0,6
Bangladesh,30/01/2004,-1,0,0,0,-2,0,0,-3
Bangladesh,01/02/2004,0,0,0,0,6,0,0,6
Bangladesh,02/02/2004,0,0,0,0,3,0,0,3
Bangladesh,03/02/2004,0,0,0,0,0,0,0,0
Bangladesh,04/02/2004,4,0,0,0,0,0,0,4
Bangladesh,05/02/2004,4,0,0,0,0,0,0,4
Bangladesh,07/02/2004,-10,0,0,0,0,0,0,-10
Bangladesh,08/02/2004,1,0,0,0,0,0,0,1
Bangladesh,09/02/2004,0,0,0,0,0,0,0,0
Bangladesh,11/02/2004,-2,0,0,0,0,0,0,-2
Bangladesh,12/02/2004,1,0,0,0,0,1,0,2
Bangladesh,14/02/2004,0,0,0,0,0,0,0,0
Bangladesh,15/02/2004,0,0,0,0,3,0,0,3
Bangladesh,16/02/2004,-10,0,0,0,0,0,0,-10
Bangladesh,17/02/2004,4,0,0,0,3,1,0,8
Bangladesh,18/02/2004,0,0,0,0,0,1,0,1
Bangladesh,19/02/2004,1,0,0,0,3,0,0,4
Bangladesh,20/02/2004,3,0,0,0,0,0,0,3
Bangladesh,21/02/2004,3,0,0,0,3,0,0,6
Bangladesh,22/02/2004,3,0,0,0,6,0,0,9
Bangladesh,23/02/2004,0,0,0,0,0,0,0,0
Bangladesh,24/02/2004,4,0,-2,0,0,0,0,2
Bangladesh,25/02/2004,2,0,0,0,0,2,0,4
Bangladesh,26/02/2004,0,0,0,0,0,0,0,0
Bangladesh,27/02/2004,5,0,0,0,9,0,0,14
Bangladesh,28/02/2004,0,0,0,0,15,0,0,15
Bangladesh,29/02/2004,0,0,0,0,3,0,0,3
Bangladesh,01/03/2004,1,0,0,0,0,0,0,1
Bangladesh,02/03/2004,0,0,0,0,6,0,0,6
Bangladesh,03/03/2004,1,0,0,0,0,0,0,1
Bangladesh,04/03/2004,-2,0,0,0,0,0,0,-2
Bangladesh,05/03/2004,0,0,0,0,0,0,0,0
Bangladesh,07/03/2004,0,0,0,0,0,0,0,0
Bangladesh,08/03/2004,0,0,0,0,0,0,0,0
Bangladesh,09/03/2004,0,0,0,0,0,0,0,0
Bangladesh,10/03/2004,0,0,0,0,0,2,0,2
Bangladesh,11/03/2004,4,0,0,0,0,3,0,7
Bangladesh,12/03/2004,4,0,0,0,0,0,0,4
Bangladesh,13/03/2004,0,0,0,0,3,3,0,6
Bangladesh,14/03/2004,2,0,0,0,0,0,0,2
Bangladesh,15/03/2004,0,0,0,0,0,0,0,0
Bangladesh,16/03/2004,0,0,0,0,-2,0,0,-2
Bangladesh,17/03/2004,0,0,0,0,-2,0,0,-2
Bangladesh,18/03/2004,2,0,0,0,0,0,0,2
Bangladesh,19/03/2004,-1,0,0,0,3,0,0,2
Bangladesh,21/03/2004,1,0,2,0,0,6,0,9
Bangladesh,22/03/2004,9,0,0,0,18,0,0,27
Bangladesh,23/03/2004,2,0,0,0,0,0,0,2
Bangladesh,24/03/2004,-20,0,-2,0,0,0,0,-22
Bangladesh,25/03/2004,17,0,0,0,4,0,0,21
Bangladesh,26/03/2004,0,0,0,0,0,0,0,0
Bangladesh,27/03/2004,-3,0,0,0,0,0,0,-3
Bangladesh,28/03/2004,3,0,0,0,0,0,0,3
Bangladesh,30/03/2004,12,0,0,0,6,0,0,18
Bangladesh,31/03/2004,0,0,0,0,6,0,0,6
Bangladesh,01/04/2004,5,0,0,0,-2,0,0,3
Bangladesh,03/04/2004,0,0,0,0,3,0,0,3
Bangladesh,04/04/2004,0,0,0,0,0,0,0,0
Bangladesh,05/04/2004,3,0,0,0,3,0,0,6
Bangladesh,06/04/2004,0,0,0,0,0,0,0,0
Bangladesh,07/04/2004,1,0,0,0,0,2,0,3
Bangladesh,08/04/2004,10,0,0,0,9,0,0,19
Bangladesh,09/04/2004,3,0,0,0,6,0,0,9
Bangladesh,10/04/2004,0,0,0,0,0,0,0,0
Bangladesh,11/04/2004,2,0,0,0,0,0,0,2
Bangladesh,12/04/2004,0,0,0,0,0,1,0,1
Bangladesh,13/04/2004,0,0,0,0,0,0,0,0
Bangladesh,14/04/2004,0,0,0,0,0,0,0,0
Bangladesh,15/04/2004,0,0,0,0,6,0,0,6
Bangladesh,17/04/2004,6,0,0,0,6,0,0,12
Bangladesh,19/04/2004,0,0,0,0,0,0,0,0
Bangladesh,20/04/2004,0,0,0,0,3,0,0,3
Bangladesh,21/04/2004,4,0,1,0,0,0,0,5
Bangladesh,22/04/2004,1,0,0,0,0,1,0,2
Bangladesh,24/04/2004,0,0,0,0,4,0,0,4
Bangladesh,25/04/2004,0,0,0,0,0,0,0,0
Bangladesh,26/04/2004,0,0,-2,0,0,1,0,-1
Bangladesh,27/04/2004,3,0,0,0,3,1,0,7
Bangladesh,28/04/2004,0,0,0,0,0,0,0,0
Bangladesh,30/04/2004,0,0,0,0,0,0,0,0
Bangladesh,01/05/2004,2,0,0,0,0,2,0,4
Bangladesh,03/05/2004,-1,0,0,0,0,0,0,-1
Bangladesh,04/05/2004,3,0,0,0,0,0,0,3
Bangladesh,05/05/2004,0,0,0,0,-2,0,0,-2
Bangladesh,06/05/2004,2,0,0,0,0,0,0,2
Bangladesh,07/05/2004,0,0,0,0,0,0,0,0
Bangladesh,09/05/2004,-4,0,0,0,0,0,0,-4
Bangladesh,10/05/2004,15,0,0,0,0,0,0,15
Bangladesh,11/05/2004,2,0,0,0,-2,0,0,0
Bangladesh,12/05/2004,0,0,0,0,0,0,0,0
Bangladesh,13/05/2004,7,0,-4,0,6,2,0,11
Bangladesh,14/05/2004,0,0,0,0,0,0,0,0
Bangladesh,16/05/2004,2,0,0,0,0,0,0,2
Bangladesh,17/05/2004,8,0,0,0,0,3,0,11
Bangladesh,18/05/2004,0,0,0,0,0,0,0,0
Bangladesh,19/05/2004,4,0,0,0,0,0,0,4
Bangladesh,20/05/2004,4,0,0,0,0,0,0,4
Bangladesh,21/05/2004,12,0,0,0,0,3,0,15
Bangladesh,22/05/2004,12,0,0,0,0,5,0,17
Bangladesh,23/05/2004,0,0,0,0,3,0,0,3
Bangladesh,24/05/2004,3,0,0,0,6,2,0,11
Bangladesh,25/05/2004,16,0,0,0,24,2,0,42
Bangladesh,26/05/2004,0,0,0,0,12,0,0,12
Bangladesh,27/05/2004,6,0,0,0,12,2,0,20
Bangladesh,28/05/2004,0,2,0,0,3,0,0,5
Bangladesh,30/05/2004,0,0,0,0,0,0,0,0
Bangladesh,31/05/2004,5,0,0,0,0,0,0,5
Bangladesh,01/06/2004,3,0,0,0,0,0,0,3
Bangladesh,02/06/2004,2,0,0,0,0,0,0,2
Bangladesh,03/06/2004,2,0,0,0,9,1,0,12
Bangladesh,04/06/2004,3,0,0,0,0,0,0,3
Bangladesh,05/06/2004,0,0,0,0,0,2,0,2
Bangladesh,06/06/2004,0,0,0,0,0,0,0,0
Bangladesh,07/06/2004,2,0,0,0,0,0,0,2
Bangladesh,08/06/2004,0,0,0,0,0,0,0,0
Bangladesh,09/06/2004,1,0,0,0,0,0,0,1
Bangladesh,10/06/2004,1,0,0,0,0,0,0,1
Bangladesh,11/06/2004,1,0,0,0,0,0,0,1
Bangladesh,12/06/2004,3,0,0,0,-1,0,0,2
Bangladesh,13/06/2004,0,0,0,0,3,0,0,3
Bangladesh,14/06/2004,0,0,0,0,0,0,0,0
Bangladesh,15/06/2004,0,0,0,0,0,0,0,0
Bangladesh,16/06/2004,5,0,0,0,3,0,0,8
Bangladesh,17/06/2004,1,0,0,0,6,0,0,7
Bangladesh,18/06/2004,2,0,0,0,6,0,0,8
Bangladesh,19/06/2004,4,0,0,0,0,0,0,4
Bangladesh,20/06/2004,1,0,-2,0,0,0,0,-1
Bangladesh,21/06/2004,5,0,0,0,0,2,0,7
Bangladesh,22/06/2004,1,0,0,0,0,0,0,1
Bangladesh,23/06/2004,0,0,0,0,0,0,0,0
Bangladesh,24/06/2004,0,0,0,0,0,0,0,0
Bangladesh,25/06/2004,1,0,0,0,1,0,0,2
Bangladesh,26/06/2004,0,0,0,0,0,0,0,0
Bangladesh,28/06/2004,4,0,0,0,6,0,0,10
Bangladesh,29/06/2004,6,0,0,0,0,0,0,6
Bangladesh,30/06/2004,1,0,0,0,3,0,0,4
Bangladesh,01/07/2004,0,0,0,0,-2,0,0,-2
Bangladesh,02/07/2004,0,0,0,0,-2,0,0,-2
Bangladesh,04/07/2004,0,0,0,0,0,0,0,0
Bangladesh,05/07/2004,0,0,0,0,0,0,0,0
Bangladesh,06/07/2004,0,0,0,0,0,0,0,0
Bangladesh,07/07/2004,0,0,0,0,0,0,0,0
Bangladesh,08/07/2004,0,0,0,0,0,0,0,0
Bangladesh,09/07/2004,9,0,0,0,6,4,0,19
Bangladesh,12/07/2004,3,0,0,0,0,0,0,3
Bangladesh,13/07/2004,2,0,0,0,0,0,0,2
Bangladesh,15/07/2004,-1,0,0,0,3,0,0,2
Bangladesh,16/07/2004,0,0,0,0,0,0,0,0
Bangladesh,17/07/2004,2,0,0,0,0,2,0,4
Bangladesh,18/07/2004,0,0,0,0,0,0,0,0
Bangladesh,19/07/2004,0,0,0,0,9,0,0,9
Bangladesh,20/07/2004,3,0,0,0,9,0,0,12
Bangladesh,21/07/2004,0,0,0,0,0,2,0,2
Bangladesh,22/07/2004,6,0,0,0,0,0,0,6
Bangladesh,23/07/2004,3,0,0,0,-2,0,0,1
Bangladesh,24/07/2004,-2,0,0,0,0,0,0,-2
Bangladesh,26/07/2004,1,0,0,0,0,0,0,1
Bangladesh,27/07/2004,7,0,0,0,0,0,0,7
Bangladesh,28/07/2004,26,0,0,0,12,0,0,38
Bangladesh,29/07/2004,2,0,0,0,0,0,0,2
Bangladesh,30/07/2004,0,0,0,0,0,0,0,0
Bangladesh,31/07/2004,5,0,0,0,0,0,0,5
Bangladesh,01/08/2004,10,0,0,0,0,0,0,10
Bangladesh,02/08/2004,0,0,0,0,0,0,0,0
Bangladesh,03/08/2004,11,0,0,0,0,0,0,11
Bangladesh,04/08/2004,2,0,0,0,0,0,0,2
Bangladesh,05/08/2004,0,0,0,0,0,0,0,0
Bangladesh,06/08/2004,2,0,0,0,0,0,0,2
Bangladesh,07/08/2004,0,0,0,0,0,0,0,0
Bangladesh,09/08/2004,4,0,0,0,0,0,0,4
Bangladesh,11/08/2004,1,0,0,0,0,0,0,1
Bangladesh,12/08/2004,1,0,0,0,0,0,0,1
Bangladesh,13/08/2004,-1,0,0,0,0,0,0,-1
Bangladesh,15/08/2004,0,0,0,0,0,0,0,0
Bangladesh,17/08/2004,0,0,0,0,-1,0,0,-1
Bangladesh,18/08/2004,0,0,0,0,-1,0,0,-1
Bangladesh,19/08/2004,4,0,0,0,0,0,0,4
Bangladesh,20/08/2004,0,0,0,0,3,0,0,3
Bangladesh,22/08/2004,0,0,0,0,0,0,0,0
Bangladesh,23/08/2004,0,0,0,0,6,4,0,10
Bangladesh,24/08/2004,0,0,0,0,6,0,0,6
Bangladesh,25/08/2004,11,0,0,0,0,0,0,11
Bangladesh,26/08/2004,3,0,0,0,0,2,0,5
Bangladesh,27/08/2004,5,0,0,0,0,0,0,5
Bangladesh,29/08/2004,-2,0,0,0,0,0,0,-2
Bangladesh,30/08/2004,7,2,0,0,-4,1,0,6
Bangladesh,31/08/2004,0,6,0,0,0,1,0,7
Bangladesh,02/09/2004,3,0,0,0,0,0,0,3
Bangladesh,03/09/2004,8,0,0,0,0,0,0,8
Bangladesh,04/09/2004,-1,0,0,0,0,0,0,-1
Bangladesh,05/09/2004,0,0,0,0,3,0,0,3
Bangladesh,06/09/2004,9,2,0,0,-3,2,0,10
Bangladesh,07/09/2004,4,0,0,0,0,0,0,4
Bangladesh,08/09/2004,0,0,0,0,3,0,0,3
Bangladesh,09/09/2004,0,0,0,0,3,0,0,3
Bangladesh,10/09/2004,-2,0,0,0,3,6,0,7
Bangladesh,11/09/2004,0,0,0,0,0,0,0,0
Bangladesh,12/09/2004,0,0,0,0,2,1,0,3
Bangladesh,13/09/2004,0,0,0,0,-2,0,0,-2
Bangladesh,14/09/2004,2,0,0,0,0,0,0,2
Bangladesh,16/09/2004,0,0,0,0,0,3,0,3
Bangladesh,17/09/2004,1,0,0,0,-6,0,0,-5
Bangladesh,21/09/2004,4,0,0,0,6,0,0,10
Bangladesh,22/09/2004,1,0,0,0,0,1,0,2
Bangladesh,23/09/2004,0,0,0,0,0,0,0,0
Bangladesh,24/09/2004,0,0,0,0,9,0,0,9
Bangladesh,25/09/2004,1,0,0,0,0,0,0,1
Bangladesh,26/09/2004,4,0,0,0,6,0,0,10
Bangladesh,27/09/2004,4,0,0,0,3,0,0,7
Bangladesh,28/09/2004,4,0,0,0,0,0,0,4
Bangladesh,29/09/2004,0,0,0,0,0,0,0,0
Bangladesh,30/09/2004,14,0,0,0,15,2,0,31
Bangladesh,01/10/2004,0,0,0,0,0,0,0,0
Bangladesh,02/10/2004,6,0,0,0,0,0,0,6
Bangladesh,03/10/2004,33,0,0,0,0,6,0,39
Bangladesh,04/10/2004,33,0,0,0,0,6,0,39
Bangladesh,05/10/2004,3,0,0,0,4,0,0,7
Bangladesh,06/10/2004,6,0,0,0,-4,0,0,2
Bangladesh,07/10/2004,1,0,0,0,0,0,0,1
Bangladesh,08/10/2004,9,0,0,0,0,2,0,11
Bangladesh,09/10/2004,2,0,0,0,0,0,0,2
Bangladesh,10/10/2004,0,0,0,0,0,0,0,0
Bangladesh,12/10/2004,5,0,0,0,0,0,0,5
Bangladesh,13/10/2004,7,0,0,0,3,0,0,10
Bangladesh,14/10/2004,0,0,0,0,13,0,0,13
Bangladesh,16/10/2004,0,0,0,0,0,0,0,0
Bangladesh,17/10/2004,0,4,0,0,0,0,0,4
Bangladesh,18/10/2004,0,0,0,0,-4,0,0,-4
Bangladesh,19/10/2004,0,0,0,0,0,0,0,0
Bangladesh,20/10/2004,0,0,0,0,0,1,0,1
Bangladesh,21/10/2004,1,0,0,0,0,1,0,2
Bangladesh,22/10/2004,6,0,0,0,6,2,0,14
Bangladesh,23/10/2004,6,0,0,0,0,0,0,6
Bangladesh,25/10/2004,0,0,0,0,0,0,0,0
Bangladesh,27/10/2004,0,0,0,0,0,0,0,0
Bangladesh,28/10/2004,9,0,0,0,3,4,0,16
Bangladesh,29/10/2004,0,0,0,0,0,0,0,0
Bangladesh,30/10/2004,3,0,0,0,18,1,0,22
Bangladesh,31/10/2004,0,0,0,0,4,0,0,4
Bangladesh,01/11/2004,2,0,0,0,3,0,0,5
Bangladesh,02/11/2004,4,0,0,0,0,0,0,4
Bangladesh,03/11/2004,0,0,0,0,2,1,0,3
Bangladesh,04/11/2004,-1,0,0,0,-2,0,0,-3
Bangladesh,05/11/2004,3,0,0,0,3,0,0,6
Bangladesh,06/11/2004,3,0,0,0,-2,1,0,2
Bangladesh,07/11/2004,3,0,1,0,0,0,0,4
Bangladesh,08/11/2004,9,0,0,0,0,0,0,9
Bangladesh,09/11/2004,0,0,0,0,0,0,0,0
Bangladesh,11/11/2004,1,0,0,0,1,0,0,2
Bangladesh,12/11/2004,0,0,0,0,3,0,0,3
Bangladesh,13/11/2004,0,0,0,0,3,0,0,3
Bangladesh,14/11/2004,0,0,0,0,0,0,0,0
Bangladesh,16/11/2004,5,0,0,0,0,0,0,5
Bangladesh,18/11/2004,11,0,0,0,0,0,0,11
Bangladesh,19/11/2004,0,0,0,0,0,0,0,0
Bangladesh,20/11/2004,0,0,0,0,0,0,0,0
Bangladesh,21/11/2004,0,0,0,0,0,0,0,0
Bangladesh,22/11/2004,3,0,0,0,0,1,0,4
Bangladesh,23/11/2004,2,0,0,0,0,0,0,2
Bangladesh,24/11/2004,0,0,0,0,0,0,0,0
Bangladesh,25/11/2004,2,0,0,0,0,0,0,2
Bangladesh,26/11/2004,0,0,0,0,4,0,0,4
Bangladesh,28/11/2004,5,0,-4,0,0,0,0,1
Bangladesh,29/11/2004,2,0,0,0,0,0,0,2
Bangladesh,30/11/2004,1,0,0,0,0,0,0,1
Bangladesh,02/12/2004,0,0,0,0,0,0,0,0
Bangladesh,03/12/2004,0,0,0,0,3,0,0,3
Bangladesh,05/12/2004,12,0,0,0,0,0,0,12
Bangladesh,06/12/2004,0,0,1,0,0,0,0,1
Bangladesh,07/12/2004,1,0,0,0,6,0,0,7
Bangladesh,08/12/2004,0,0,0,0,6,0,0,6
Bangladesh,09/12/2004,0,0,0,0,9,0,0,9
Bangladesh,10/12/2004,4,0,0,0,-5,2,0,1
Bangladesh,11/12/2004,0,0,0,0,0,0,0,0
Bangladesh,12/12/2004,-3,0,0,0,4,0,0,1
Bangladesh,13/12/2004,2,0,0,0,0,0,0,2
Bangladesh,14/12/2004,0,0,0,0,9,0,0,9
Bangladesh,15/12/2004,3,0,0,0,0,0,0,3
Bangladesh,16/12/2004,4,0,0,0,0,0,0,4
Bangladesh,17/12/2004,0,0,0,0,3,0,0,3
Bangladesh,19/12/2004,0,0,0,0,7,0,0,7
Bangladesh,20/12/2004,0,0,0,0,3,0,0,3
Bangladesh,21/12/2004,2,0,0,0,6,0,0,8
Bangladesh,25/12/2004,5,0,0,0,0,0,0,5
Bangladesh,26/12/2004,9,0,-1,0,2,0,0,10
Bangladesh,27/12/2004,10,0,-1,0,0,0,0,9
Bangladesh,28/12/2004,4,0,0,0,0,0,0,4
Bangladesh,29/12/2004,30,0,0,0,0,0,0,30
Bangladesh,30/12/2004,26,0,0,0,1,0,0,27
Bangladesh,31/12/2004,23,0,0,0,0,1,0,24
Cameroon,01/01/2004,0,0,0,0,-2,0,0,-2
Cameroon,02/01/2004,0,0,0,0,0,0,0,0
Cameroon,05/01/2004,0,0,0,0,0,0,0,0
Cameroon,06/01/2004,2,0,0,0,0,0,0,2
Cameroon,07/01/2004,3,0,0,0,0,0,0,3
Cameroon,08/01/2004,0,0,0,0,-2,0,0,-2
Cameroon,09/01/2004,1,0,0,0,0,0,0,1
Cameroon,14/01/2004,0,0,0,0,0,0,0,0
Cameroon,15/01/2004,0,0,0,0,0,0,0,0
Cameroon,19/01/2004,0,0,0,0,3,0,0,3
Cameroon,20/01/2004,2,0,0,0,0,0,0,2
Cameroon,22/01/2004,1,0,0,0,0,0,0,1
Cameroon,23/01/2004,0,0,0,0,0,0,0,0
Cameroon,27/01/2004,3,0,0,0,0,0,0,3
Cameroon,28/01/2004,0,0,0,0,0,0,0,0
Cameroon,29/01/2004,0,0,0,0,0,0,0,0
Cameroon,01/02/2004,0,0,0,0,0,0,0,0
Cameroon,02/02/2004,0,0,0,0,0,0,0,0
Cameroon,03/02/2004,0,0,0,0,0,0,0,0
Cameroon,04/02/2004,0,0,0,0,0,0,0,0
Cameroon,06/02/2004,0,0,0,0,0,0,0,0
Cameroon,09/02/2004,0,0,0,0,3,0,0,3
Cameroon,10/02/2004,0,0,0,0,0,0,0,0
Cameroon,12/02/2004,2,0,0,0,0,0,0,2
Cameroon,13/02/2004,6,0,0,0,0,0,0,6
Cameroon,18/02/2004,0,0,0,0,0,0,0,0
Cameroon,19/02/2004,0,0,0,0,0,0,0,0
Cameroon,20/02/2004,0,0,0,0,0,0,0,0
Cameroon,23/02/2004,2,0,0,0,9,0,0,11
Cameroon,24/02/2004,1,0,0,0,0,0,0,1
Cameroon,25/02/2004,6,0,0,0,6,0,0,12
Cameroon,26/02/2004,-3,0,0,0,0,0,0,-3
Cameroon,27/02/2004,0,0,0,0,0,0,0,0
Cameroon,29/02/2004,0,0,0,0,0,0,0,0
Cameroon,01/03/2004,5,0,0,0,9,0,0,14
Cameroon,02/03/2004,1,0,0,0,0,0,0,1
Cameroon,03/03/2004,5,0,0,0,3,0,0,8
Cameroon,04/03/2004,0,0,0,0,0,0,0,0
Cameroon,07/03/2004,0,0,0,0,0,0,0,0
Cameroon,08/03/2004,2,0,0,0,0,0,0,2
Cameroon,09/03/2004,2,0,0,0,0,0,0,2
Cameroon,10/03/2004,8,0,0,0,0,0,0,8
Cameroon,11/03/2004,0,0,0,0,8,0,0,8
Cameroon,12/03/2004,0,0,0,0,-6,1,0,-5
Cameroon,14/03/2004,2,0,0,0,0,0,0,2
Cameroon,15/03/2004,2,0,0,0,0,2,0,4
Cameroon,16/03/2004,1,0,0,0,0,0,0,1
Cameroon,17/03/2004,1,0,0,0,0,0,0,1
Cameroon,18/03/2004,0,0,0,0,0,0,0,0
Cameroon,19/03/2004,1,0,0,0,0,0,0,1
Cameroon,22/03/2004,1,0,0,0,12,0,0,13
Cameroon,23/03/2004,2,0,0,0,0,0,0,2
Cameroon,24/03/2004,2,0,0,0,0,0,0,2
Cameroon,25/03/2004,1,0,0,0,0,0,0,1
Cameroon,26/03/2004,3,0,0,0,0,-2,0,1
Cameroon,27/03/2004,0,0,0,0,0,0,0,0
Cameroon,29/03/2004,0,0,0,0,0,0,0,0
Cameroon,30/03/2004,8,0,0,0,3,0,0,11
Cameroon,31/03/2004,4,0,0,0,0,0,0,4
Cameroon,01/04/2004,7,0,0,0,0,0,0,7
Cameroon,02/04/2004,0,0,0,0,0,0,0,0
Cameroon,03/04/2004,0,0,0,0,0,0,0,0
Cameroon,05/04/2004,6,0,0,0,0,0,0,6
Cameroon,08/04/2004,0,0,0,0,0,0,0,0
Cameroon,12/04/2004,0,0,0,0,0,0,0,0
Cameroon,13/04/2004,0,0,0,0,0,0,0,0
Cameroon,14/04/2004,0,0,0,0,6,1,0,7
Cameroon,15/04/2004,1,0,1,0,6,1,0,9
Cameroon,16/04/2004,0,0,0,0,0,0,0,0
Cameroon,19/04/2004,0,0,0,0,0,0,0,0
Cameroon,21/04/2004,0,0,0,0,0,0,0,0
Cameroon,22/04/2004,0,0,0,0,0,0,0,0
Cameroon,25/04/2004,8,0,0,0,0,0,0,8
Cameroon,26/04/2004,2,0,0,0,0,0,0,2
Cameroon,27/04/2004,0,0,0,0,0,0,0,0
Cameroon,28/04/2004,0,0,0,0,0,0,0,0
Cameroon,29/04/2004,0,0,0,0,0,0,0,0
Cameroon,30/04/2004,3,0,0,0,0,0,0,3
Cameroon,01/05/2004,3,0,0,0,0,0,0,3
Cameroon,02/05/2004,0,0,0,0,0,0,0,0
Cameroon,03/05/2004,0,0,0,0,2,0,0,2
Cameroon,05/05/2004,0,0,0,0,0,0,0,0
Cameroon,06/05/2004,0,0,0,0,3,0,0,3
Cameroon,07/05/2004,2,0,0,0,0,0,0,2
Cameroon,10/05/2004,0,0,0,0,0,0,0,0
Cameroon,17/05/2004,0,0,0,0,0,0,0,0
Cameroon,18/05/2004,0,0,0,0,0,0,0,0
Cameroon,19/05/2004,6,0,0,0,0,0,0,6
Cameroon,20/05/2004,0,0,0,0,0,0,0,0
Cameroon,21/05/2004,0,4,0,0,0,0,0,4
Cameroon,25/05/2004,3,0,0,0,0,0,0,3
Cameroon,27/05/2004,0,0,0,0,0,0,0,0
Cameroon,28/05/2004,0,2,0,0,0,0,0,2
Cameroon,01/06/2004,0,0,0,0,0,0,0,0
Cameroon,02/06/2004,0,0,0,0,3,0,0,3
Cameroon,03/06/2004,0,0,0,0,0,0,0,0
Cameroon,04/06/2004,6,0,0,0,0,0,0,6
Cameroon,06/06/2004,0,0,0,0,0,0,0,0
Cameroon,07/06/2004,2,0,0,0,0,0,0,2
Cameroon,08/06/2004,0,0,0,0,0,0,0,0
Cameroon,10/06/2004,0,0,0,0,3,0,0,3
Cameroon,14/06/2004,0,0,0,0,0,0,0,0
Cameroon,15/06/2004,0,0,0,0,0,0,0,0
Cameroon,16/06/2004,0,0,0,0,0,0,0,0
Cameroon,17/06/2004,0,0,0,0,0,0,0,0
Cameroon,18/06/2004,0,0,0,0,0,0,0,0
Cameroon,21/06/2004,5,0,0,0,0,0,0,5
Cameroon,22/06/2004,0,0,0,0,0,0,0,0
Cameroon,23/06/2004,0,0,0,0,0,0,0,0
Cameroon,24/06/2004,0,0,0,0,0,0,0,0
Cameroon,25/06/2004,0,0,0,0,0,0,0,0
Cameroon,26/06/2004,0,0,0,0,0,0,0,0
Cameroon,29/06/2004,1,0,0,0,0,0,0,1
Cameroon,30/06/2004,0,0,-3,0,0,0,0,-3
Cameroon,01/07/2004,0,0,0,0,6,0,0,6
Cameroon,02/07/2004,-1,0,0,0,0,0,0,-1
Cameroon,06/07/2004,0,0,0,0,0,0,0,0
Cameroon,08/07/2004,0,0,0,0,-2,0,0,-2
Cameroon,12/07/2004,0,0,0,0,0,0,0,0
Cameroon,13/07/2004,0,0,0,0,0,0,0,0
Cameroon,14/07/2004,3,0,0,0,0,0,0,3
Cameroon,22/07/2004,0,0,0,0,0,0,0,0
Cameroon,24/07/2004,0,0,0,0,0,0,0,0
Cameroon,26/07/2004,0,0,0,0,0,0,0,0
Cameroon,01/08/2004,0,0,0,0,0,0,0,0
Cameroon,02/08/2004,3,0,0,0,3,1,0,7
Cameroon,03/08/2004,2,0,0,0,0,0,0,2
Cameroon,04/08/2004,0,0,0,0,0,0,0,0
Cameroon,05/08/2004,0,0,0,0,0,0,0,0
Cameroon,09/08/2004,0,0,0,0,0,0,0,0
Cameroon,11/08/2004,0,0,0,0,0,0,0,0
Cameroon,15/08/2004,0,0,0,0,0,0,0,0
Cameroon,16/08/2004,0,0,0,0,0,0,0,0
Cameroon,18/08/2004,3,0,0,0,0,0,0,3
Cameroon,23/08/2004,3,0,0,0,0,0,0,3
Cameroon,24/08/2004,2,0,0,0,0,0,0,2
Cameroon,27/08/2004,0,0,0,0,3,0,0,3
Cameroon,30/08/2004,0,0,0,0,0,0,0,0
Cameroon,31/08/2004,2,0,0,0,3,0,0,5
Cameroon,01/09/2004,0,0,0,0,0,0,0,0
Cameroon,02/09/2004,0,0,0,0,0,0,0,0
Cameroon,03/09/2004,0,0,0,0,0,0,0,0
Cameroon,06/09/2004,2,0,0,0,0,0,0,2
Cameroon,07/09/2004,9,0,0,0,0,0,0,9
Cameroon,08/09/2004,1,0,0,0,0,0,0,1
Cameroon,09/09/2004,7,0,0,0,0,0,0,7
Cameroon,10/09/2004,2,0,1,0,0,0,0,3
Cameroon,11/09/2004,5,0,0,0,0,0,0,5
Cameroon,12/09/2004,-2,0,0,0,0,0,0,-2
Cameroon,13/09/2004,3,0,0,0,0,1,0,4
Cameroon,14/09/2004,2,0,0,0,0,0,0,2
Cameroon,15/09/2004,0,0,0,0,0,0,0,0
Cameroon,17/09/2004,0,0,0,0,9,0,0,9
Cameroon,18/09/2004,0,0,0,0,0,0,0,0
Cameroon,19/09/2004,0,0,0,0,3,0,0,3
Cameroon,20/09/2004,0,0,0,0,0,0,0,0
Cameroon,21/09/2004,2,0,0,0,0,0,0,2
Cameroon,22/09/2004,6,0,0,0,9,0,0,15
Cameroon,23/09/2004,-1,0,0,0,4,0,0,3
Cameroon,24/09/2004,24,0,0,0,15,4,0,43
Cameroon,25/09/2004,0,0,-6,0,0,0,0,-6
Cameroon,27/09/2004,2,0,0,0,3,0,0,5
Cameroon,28/09/2004,0,0,0,0,6,0,0,6
Cameroon,29/09/2004,4,0,0,0,9,0,0,13
Cameroon,30/09/2004,0,0,0,0,0,2,0,2
Cameroon,01/10/2004,0,0,0,0,0,0,0,0
Cameroon,04/10/2004,2,0,0,0,0,0,0,2
Cameroon,05/10/2004,0,0,0,0,0,0,0,0
Cameroon,06/10/2004,0,0,0,0,0,4,0,4
Cameroon,07/10/2004,0,0,0,0,0,0,0,0
Cameroon,08/10/2004,0,0,0,0,0,0,0,0
Cameroon,09/10/2004,-3,0,-1,0,3,0,0,-1
Cameroon,10/10/2004,0,0,-2,0,0,0,0,-2
Cameroon,11/10/2004,0,0,0,0,3,0,0,3
Cameroon,12/10/2004,2,0,0,0,3,1,0,6
Cameroon,13/10/2004,0,0,-1,0,0,0,0,-1
Cameroon,14/10/2004,0,0,0,0,0,1,0,1
Cameroon,15/10/2004,1,0,0,0,0,0,0,1
Cameroon,18/10/2004,1,0,0,0,0,0,0,1
Cameroon,19/10/2004,2,0,0,0,-2,0,0,0
Cameroon,20/10/2004,0,0,0,0,0,0,0,0
Cameroon,21/10/2004,1,0,0,0,0,0,0,1
Cameroon,22/10/2004,2,0,0,0,3,0,0,5
Cameroon,23/10/2004,0,0,0,0,0,0,0,0
Cameroon,25/10/2004,4,0,0,0,0,1,0,5
Cameroon,26/10/2004,0,0,0,0,0,0,0,0
Cameroon,27/10/2004,0,0,0,0,0,0,0,0
Cameroon,28/10/2004,1,0,0,0,0,0,0,1
Cameroon,29/10/2004,3,0,2,0,0,0,0,5
Cameroon,03/11/2004,0,0,0,0,0,0,0,0
Cameroon,04/11/2004,0,0,0,0,0,0,0,0
Cameroon,05/11/2004,1,0,0,0,0,0,0,1
Cameroon,06/11/2004,0,0,0,0,6,0,0,6
Cameroon,07/11/2004,0,0,0,0,0,0,0,0
Cameroon,08/11/2004,0,0,0,0,0,0,0,0
Cameroon,10/11/2004,3,0,0,0,0,0,0,3
Cameroon,14/11/2004,1,0,0,0,0,0,0,1
Cameroon,15/11/2004,0,0,0,0,0,0,0,0
Cameroon,19/11/2004,4,0,0,0,0,0,0,4
Cameroon,22/11/2004,0,0,0,0,0,0,0,0
Cameroon,24/11/2004,0,0,0,0,0,0,0,0
Cameroon,25/11/2004,2,0,0,0,0,0,0,2
Cameroon,26/11/2004,4,0,0,0,0,0,0,4
Cameroon,02/12/2004,5,0,0,0,3,0,0,8
Cameroon,03/12/2004,3,0,0,0,0,0,0,3
Cameroon,06/12/2004,0,0,0,0,0,0,0,0
Cameroon,07/12/2004,0,0,0,0,0,2,0,2
Cameroon,08/12/2004,0,0,0,0,0,0,0,0
Cameroon,09/12/2004,0,0,0,0,0,0,0,0
Cameroon,10/12/2004,0,0,0,0,0,0,0,0
Cameroon,12/12/2004,2,0,0,0,0,0,0,2
Cameroon,13/12/2004,7,0,0,0,0,0,0,7
Cameroon,14/12/2004,-1,0,0,0,0,0,0,-1
Cameroon,16/12/2004,0,0,0,0,3,2,0,5
Cameroon,17/12/2004,0,0,0,0,0,0,0,0
Cameroon,18/12/2004,0,0,0,0,0,0,0,0
Cameroon,20/12/2004,1,0,0,0,0,0,0,1
Cameroon,21/12/2004,2,0,0,0,0,0,0,2
Cameroon,23/12/2004,2,0,0,0,0,0,0,2
Cameroon,31/12/2004,2,0,0,0,0,0,0,2
China,01/01/2004,2,0,0,0,0,3,0,5
China,02/01/2004,13,0,0,0,3,3,0,19
China,03/01/2004,6,0,0,0,0,0,0,6
China,04/01/2004,5,0,0,0,0,1,0,6
China,05/01/2004,14,0,0,0,4,0,0,18
China,06/01/2004,15,0,0,0,4,0,0,19
China,07/01/2004,21,0,0,0,8,2,0,31
China,08/01/2004,26,0,0,0,13,6,0,45
China,09/01/2004,19,0,1,0,6,1,0,27
China,10/01/2004,11,0,0,0,6,2,0,19
China,11/01/2004,8,0,0,0,-4,0,0,4
China,12/01/2004,9,0,0,0,10,0,0,19
China,13/01/2004,18,0,0,0,1,0,0,19
China,14/01/2004,27,0,0,0,-4,3,0,26
China,15/01/2004,18,0,4,0,15,1,0,38
China,16/01/2004,14,2,0,0,6,1,0,23
China,17/01/2004,4,0,0,0,0,2,0,6
China,18/01/2004,-1,0,-3,0,3,0,0,-1
China,19/01/2004,6,0,0,0,8,6,0,20
China,20/01/2004,20,0,0,0,-1,5,0,24
China,21/01/2004,2,0,0,0,15,0,0,17
China,22/01/2004,4,0,0,0,15,2,0,21
China,23/01/2004,7,0,-1,0,-10,2,0,-2
China,24/01/2004,5,0,0,0,19,0,0,24
China,25/01/2004,11,0,1,0,0,0,0,12
China,26/01/2004,7,0,0,0,25,2,0,34
China,27/01/2004,32,0,0,0,9,1,0,42
China,28/01/2004,21,0,0,0,4,3,0,28
China,29/01/2004,2,0,0,0,3,2,0,7
China,30/01/2004,45,0,0,0,0,1,0,46
China,31/01/2004,2,0,0,0,0,0,0,2
China,01/02/2004,1,0,0,0,4,1,0,6
China,02/02/2004,17,0,0,0,9,2,0,28
China,03/02/2004,12,0,0,0,3,2,0,17
China,04/02/2004,6,0,0,0,3,2,0,11
China,05/02/2004,11,0,0,0,3,0,0,14
China,06/02/2004,25,0,0,0,13,3,0,41
China,07/02/2004,22,0,1,0,9,0,0,32
China,08/02/2004,4,0,0,0,-2,0,0,2
China,09/02/2004,12,0,0,0,16,0,0,28
China,10/02/2004,59,0,0,0,-3,1,0,57
China,11/02/2004,5,0,0,0,10,0,0,15
China,12/02/2004,33,0,-1,0,10,10,0,52
China,13/02/2004,14,0,0,0,3,1,0,18
China,14/02/2004,0,0,0,0,9,0,0,9
China,15/02/2004,5,0,2,0,0,0,0,7
China,16/02/2004,12,0,0,0,6,0,0,18
China,17/02/2004,9,0,0,0,4,0,0,13
China,18/02/2004,3,0,0,0,18,1,0,22
China,19/02/2004,0,0,0,0,0,0,0,0
China,20/02/2004,12,0,0,0,-2,2,0,12
China,21/02/2004,2,0,-1,0,3,0,0,4
China,22/02/2004,12,2,0,0,0,0,0,14
China,23/02/2004,2,0,0,0,3,3,0,8
China,24/02/2004,4,0,0,0,6,1,0,11
China,25/02/2004,1,0,0,0,3,0,0,4
China,26/02/2004,4,0,1,0,18,0,0,23
China,27/02/2004,6,0,0,0,9,0,0,15
China,28/02/2004,5,0,0,0,0,0,0,5
China,29/02/2004,3,0,0,0,3,2,0,8
China,01/03/2004,25,0,0,0,6,1,0,32
China,02/03/2004,20,0,1,0,21,0,0,42
China,03/03/2004,29,0,1,0,13,2,0,45
China,04/03/2004,7,0,0,0,20,2,0,29
China,05/03/2004,25,0,0,0,0,3,0,28
China,06/03/2004,3,0,1,0,0,0,0,4
China,07/03/2004,17,0,0,0,0,0,0,17
China,08/03/2004,7,0,0,0,0,2,0,9
China,09/03/2004,8,0,-1,0,21,2,0,30
China,10/03/2004,26,0,0,0,3,2,0,31
China,11/03/2004,3,0,0,0,6,8,0,17
China,12/03/2004,12,0,0,0,3,1,0,16
China,13/03/2004,4,0,0,0,3,1,0,8
China,14/03/2004,12,0,0,0,5,1,0,18
China,15/03/2004,38,0,-3,0,16,2,0,53
China,16/03/2004,18,0,0,0,8,9,0,35
China,17/03/2004,13,0,0,0,3,1,0,17
China,18/03/2004,13,0,0,0,11,2,0,26
China,19/03/2004,11,0,-3,0,7,0,0,15
China,20/03/2004,28,0,0,0,16,10,0,54
China,21/03/2004,14,0,0,0,9,8,0,31
China,22/03/2004,13,0,0,0,16,0,0,29
China,23/03/2004,4,0,0,0,22,4,0,30
China,24/03/2004,32,0,1,0,12,0,0,45
China,25/03/2004,16,0,-1,0,37,4,0,56
China,26/03/2004,15,0,-1,0,25,0,0,39
China,27/03/2004,11,0,0,0,6,0,0,17
China,28/03/2004,21,0,0,0,13,0,0,34
China,29/03/2004,6,0,1,0,6,0,0,13
China,30/03/2004,-1,0,0,0,8,0,0,7
China,31/03/2004,19,0,0,0,0,2,0,21
China,01/04/2004,44,0,1,0,9,6,0,60
China,02/04/2004,6,0,0,0,-1,8,0,13
China,03/04/2004,5,0,0,0,4,1,0,10
China,04/04/2004,8,0,0,0,12,5,0,25
China,05/04/2004,9,0,0,0,9,4,0,22
China,06/04/2004,19,0,1,0,-1,2,0,21
China,07/04/2004,31,0,0,0,4,3,0,38
China,08/04/2004,6,0,-12,0,12,2,0,8
China,09/04/2004,3,0,-2,0,24,0,0,25
China,10/04/2004,10,0,0,0,3,1,0,14
China,11/04/2004,5,0,2,0,9,0,0,16
China,12/04/2004,10,0,2,0,7,3,0,22
China,13/04/2004,20,4,0,0,-3,3,0,24
China,14/04/2004,11,0,0,0,3,1,0,15
China,15/04/2004,0,0,0,0,4,0,0,4
China,16/04/2004,7,0,0,0,1,1,0,9
China,17/04/2004,9,0,0,0,0,1,0,10
China,18/04/2004,12,0,0,0,3,2,0,17
China,19/04/2004,12,0,0,0,1,1,0,14
China,20/04/2004,25,0,0,0,3,0,0,28
China,21/04/2004,24,0,0,0,6,-2,0,28
China,22/04/2004,22,0,0,0,3,0,0,25
China,23/04/2004,35,0,-1,0,3,11,0,48
China,24/04/2004,27,0,1,0,12,10,0,50
China,25/04/2004,5,0,1,0,0,0,0,6
China,26/04/2004,20,0,1,0,4,4,0,29
China,27/04/2004,9,2,0,0,-6,9,0,14
China,28/04/2004,16,2,0,0,3,1,0,22
China,29/04/2004,6,0,0,0,0,0,0,6
China,30/04/2004,14,0,0,0,8,3,0,25
China,01/05/2004,5,0,0,0,0,2,0,7
China,02/05/2004,2,0,-2,0,0,0,0,0
China,03/05/2004,26,0,0,0,12,5,0,43
China,04/05/2004,2,0,0,0,13,12,0,27
China,05/05/2004,23,0,0,0,27,5,0,55
China,06/05/2004,3,4,0,0,16,1,0,24
China,07/05/2004,9,0,0,0,0,8,0,17
China,08/05/2004,10,0,-4,0,0,0,0,6
China,09/05/2004,8,0,0,0,15,2,0,25
China,10/05/2004,15,0,1,0,20,3,0,39
China,11/05/2004,21,0,0,0,9,0,0,30
China,12/05/2004,27,0,1,0,2,0,0,30
China,13/05/2004,23,0,-2,0,2,2,0,25
China,14/05/2004,8,0,-2,0,7,0,0,13
China,15/05/2004,8,0,0,0,0,1,0,9
China,16/05/2004,2,2,0,0,0,1,0,5
China,17/05/2004,7,0,0,0,-2,2,0,7
China,18/05/2004,21,0,0,0,1,1,0,23
China,19/05/2004,25,0,-6,0,3,4,0,26
China,20/05/2004,27,0,-1,0,20,10,0,56
China,21/05/2004,13,0,0,0,9,2,0,24
China,22/05/2004,8,0,0,0,-2,1,0,7
China,23/05/2004,8,0,0,0,6,5,0,19
China,24/05/2004,8,0,2,0,6,3,0,19
China,25/05/2004,10,0,0,0,6,2,0,18
China,26/05/2004,16,0,-5,0,-2,3,0,12
China,27/05/2004,23,0,0,0,7,2,0,32
China,28/05/2004,6,0,-2,0,6,0,0,10
China,29/05/2004,4,2,-1,0,2,0,0,7
China,30/05/2004,12,0,0,0,-2,0,0,10
China,31/05/2004,7,2,0,0,-2,2,0,9
China,01/06/2004,8,2,0,0,3,2,0,15
China,02/06/2004,15,0,0,0,5,1,0,21
China,03/06/2004,30,0,0,0,6,6,0,42
China,04/06/2004,14,0,1,0,15,0,0,30
China,05/06/2004,19,0,0,0,6,0,0,25
China,06/06/2004,13,0,0,0,4,1,0,18
China,07/06/2004,-1,0,3,0,7,2,0,11
China,08/06/2004,18,0,1,0,42,6,0,67
China,09/06/2004,26,0,0,0,24,1,0,51
China,10/06/2004,99,0,-1,0,18,5,0,121
China,11/06/2004,94,0,1,0,28,2,0,125
China,12/06/2004,56,0,0,0,7,6,0,69
China,13/06/2004,15,0,0,0,15,2,0,32
China,14/06/2004,29,0,0,0,4,4,0,37
China,15/06/2004,4,0,0,0,6,0,0,10
China,16/06/2004,66,0,-5,0,0,6,0,67
China,17/06/2004,14,0,0,0,6,4,0,24
China,18/06/2004,16,2,0,0,3,2,0,23
China,19/06/2004,26,0,0,0,6,4,0,36
China,20/06/2004,28,0,-2,0,3,4,0,33
China,21/06/2004,14,0,-4,0,-1,1,0,10
China,22/06/2004,55,0,-4,0,-20,8,0,39
China,23/06/2004,49,4,0,0,6,0,0,59
China,24/06/2004,38,0,0,0,6,8,0,52
China,25/06/2004,40,0,1,0,13,0,0,54
China,26/06/2004,11,0,0,0,0,0,0,11
China,27/06/2004,5,0,0,0,6,0,0,11
China,28/06/2004,7,0,0,0,-1,0,0,6
China,29/06/2004,12,0,0,0,-4,1,0,9
China,30/06/2004,20,0,0,0,2,2,0,24
China,01/07/2004,0,0,0,0,3,5,0,8
China,02/07/2004,19,0,0,0,3,2,0,24
China,03/07/2004,1,0,0,0,3,0,0,4
China,04/07/2004,0,0,0,0,3,0,0,3
China,05/07/2004,15,0,0,0,0,2,0,17
China,06/07/2004,4,0,0,0,3,3,0,10
China,07/07/2004,4,0,0,0,6,0,0,10
China,08/07/2004,8,0,0,0,9,5,0,22
China,09/07/2004,2,0,2,0,-4,2,0,2
China,10/07/2004,15,0,0,0,0,0,0,15
China,11/07/2004,2,0,0,0,0,0,0,2
China,12/07/2004,4,0,0,0,0,0,0,4
China,13/07/2004,10,6,0,0,6,0,0,22
China,14/07/2004,-5,0,0,0,3,0,0,-2
China,15/07/2004,4,0,0,0,10,0,0,14
China,16/07/2004,4,0,-5,0,-1,0,0,-2
China,17/07/2004,7,0,0,0,3,0,0,10
China,18/07/2004,5,0,0,0,12,4,0,21
China,19/07/2004,0,0,0,0,0,0,0,0
China,20/07/2004,3,0,0,0,-10,0,0,-7
China,21/07/2004,5,0,0,0,0,0,0,5
China,22/07/2004,-1,0,0,0,1,0,0,0
China,23/07/2004,-3,0,0,0,3,2,0,2
China,24/07/2004,0,0,0,0,6,0,0,6
China,25/07/2004,3,0,0,0,0,2,0,5
China,26/07/2004,24,0,0,0,0,0,0,24
China,27/07/2004,17,0,0,0,3,2,0,22
China,28/07/2004,18,0,0,0,3,0,0,21
China,29/07/2004,14,0,0,0,4,1,0,19
China,30/07/2004,6,0,0,0,-2,0,0,4
China,31/07/2004,4,0,0,0,2,12,0,18
China,01/08/2004,14,0,0,0,0,3,0,17
China,02/08/2004,1,0,0,0,0,0,0,1
China,03/08/2004,5,4,0,0,15,0,0,24
China,04/08/2004,10,0,0,0,-4,0,0,6
China,05/08/2004,3,0,0,0,2,1,0,6
China,06/08/2004,44,0,0,0,0,2,0,46
China,07/08/2004,-1,0,2,0,6,5,0,12
China,08/08/2004,0,0,0,0,8,6,0,14
China,09/08/2004,3,0,0,0,9,0,0,12
China,10/08/2004,25,0,0,0,3,0,0,28
China,11/08/2004,7,0,0,0,9,0,0,16
China,12/08/2004,4,0,-1,0,3,0,0,6
China,13/08/2004,4,0,0,0,-6,3,0,1
China,14/08/2004,8,0,0,0,0,2,0,10
China,15/08/2004,3,0,0,0,6,1,0,10
China,16/08/2004,36,0,0,0,6,2,0,44
China,17/08/2004,18,0,0,0,0,0,0,18
China,18/08/2004,23,0,0,0,3,0,0,26
China,19/08/2004,14,0,0,0,3,0,0,17
China,20/08/2004,28,0,0,0,3,2,0,33
China,21/08/2004,13,0,0,0,3,0,0,16
China,22/08/2004,12,0,0,0,9,0,0,21
China,23/08/2004,9,0,0,0,6,0,0,15
China,24/08/2004,19,0,0,0,6,4,0,29
China,25/08/2004,-1,0,0,0,9,2,0,10
China,26/08/2004,13,0,0,0,0,0,0,13
China,27/08/2004,4,0,0,0,6,12,0,22
China,28/08/2004,27,0,0,0,0,12,0,39
China,29/08/2004,6,0,0,0,6,0,0,12
China,30/08/2004,8,0,0,0,0,0,0,8
China,31/08/2004,7,0,0,0,3,0,0,10
China,01/09/2004,2,0,1,0,-2,3,0,4
China,02/09/2004,3,0,0,0,12,2,0,17
China,03/09/2004,7,0,0,0,1,0,0,8
China,04/09/2004,4,0,0,0,-2,0,0,2
China,05/09/2004,4,0,0,0,2,0,0,6
China,06/09/2004,2,0,0,0,6,0,0,8
China,07/09/2004,-3,0,0,0,3,0,0,0
China,08/09/2004,4,0,0,0,3,2,0,9
China,09/09/2004,35,0,0,0,6,6,0,47
China,10/09/2004,20,0,0,0,9,0,0,29
China,11/09/2004,20,0,0,0,0,0,0,20
China,12/09/2004,0,0,0,0,6,0,0,6
China,13/09/2004,17,0,1,0,0,15,0,33
China,14/09/2004,6,0,0,0,8,1,0,15
China,15/09/2004,60,0,0,0,3,0,0,63
China,16/09/2004,4,0,1,0,3,0,0,8
China,17/09/2004,7,0,-4,0,6,0,0,9
China,18/09/2004,7,0,0,0,6,3,0,16
China,19/09/2004,3,0,0,0,0,0,0,3
China,20/09/2004,6,0,2,0,3,0,0,11
China,21/09/2004,5,0,0,0,-3,0,0,2
China,22/09/2004,9,0,0,0,4,0,0,13
China,23/09/2004,10,0,3,0,-5,4,0,12
China,24/09/2004,4,0,2,0,12,1,0,19
China,25/09/2004,2,0,0,0,0,0,0,2
China,26/09/2004,8,0,0,0,0,2,0,10
China,27/09/2004,3,0,-1,0,0,2,0,4
China,28/09/2004,7,0,0,0,12,1,0,20
China,29/09/2004,3,0,0,0,1,0,0,4
China,30/09/2004,9,0,0,0,3,1,0,13
China,01/10/2004,13,0,0,0,-11,0,0,2
China,02/10/2004,6,0,0,0,-2,0,0,4
China,03/10/2004,10,0,0,0,0,0,0,10
China,04/10/2004,10,0,0,0,3,0,0,13
China,05/10/2004,17,2,0,0,0,1,0,20
China,06/10/2004,-1,0,0,0,6,1,0,6
China,07/10/2004,9,0,0,0,0,0,0,9
China,08/10/2004,14,0,0,0,0,1,0,15
China,09/10/2004,21,0,0,0,9,2,0,32
China,10/10/2004,5,0,0,0,9,3,0,17
China,11/10/2004,22,0,0,0,18,1,0,41
China,12/10/2004,12,0,0,0,-1,0,0,11
China,13/10/2004,24,0,1,0,-1,0,0,24
China,14/10/2004,42,0,0,0,20,3,0,65
China,15/10/2004,6,0,0,0,3,0,0,9
China,16/10/2004,10,0,0,0,6,9,0,25
China,17/10/2004,3,0,0,0,-2,0,0,1
China,18/10/2004,40,0,0,0,1,0,0,41
China,19/10/2004,6,0,0,0,15,0,0,21
China,20/10/2004,19,2,0,0,-1,7,0,27
China,21/10/2004,24,0,0,0,10,2,0,36
China,22/10/2004,20,0,-2,0,-6,0,0,12
China,23/10/2004,23,0,0,0,6,0,0,29
China,24/10/2004,12,0,0,0,5,2,0,19
China,25/10/2004,4,0,0,0,0,0,0,4
China,26/10/2004,14,0,0,0,0,1,0,15
China,27/10/2004,11,0,0,0,3,4,0,18
China,28/10/2004,6,0,0,0,8,1,0,15
China,29/10/2004,11,0,0,0,4,0,0,15
China,30/10/2004,6,0,0,0,6,0,0,12
China,31/10/2004,10,0,0,0,0,0,0,10
China,01/11/2004,4,0,0,0,6,0,0,10
China,02/11/2004,10,0,0,0,0,1,0,11
China,03/11/2004,5,0,0,0,-4,0,0,1
China,04/11/2004,9,0,0,0,3,2,0,14
China,05/11/2004,12,0,0,0,21,2,0,35
China,06/11/2004,7,0,1,0,6,0,0,14
China,07/11/2004,12,6,-1,0,1,0,0,18
China,08/11/2004,21,0,0,0,0,0,0,21
China,09/11/2004,22,0,0,0,15,7,0,44
China,10/11/2004,11,0,0,0,9,2,0,22
China,11/11/2004,4,0,0,0,7,1,0,12
China,12/11/2004,38,0,0,0,1,3,0,42
China,13/11/2004,22,0,0,0,3,0,0,25
China,14/11/2004,3,0,0,0,6,3,0,12
China,15/11/2004,10,0,-4,0,-1,0,0,5
China,16/11/2004,1,0,0,0,3,4,0,8
China,17/11/2004,23,0,0,0,1,4,0,28
China,18/11/2004,5,0,0,0,21,0,0,26
China,19/11/2004,30,0,0,0,42,5,0,77
China,20/11/2004,12,0,0,0,3,2,0,17
China,21/11/2004,15,0,0,0,7,0,0,22
China,22/11/2004,2,0,0,0,25,0,0,27
China,23/11/2004,36,0,0,0,7,4,0,47
China,24/11/2004,2,0,0,0,39,0,0,41
China,25/11/2004,5,0,0,0,3,0,0,8
China,26/11/2004,16,0,0,0,0,1,0,17
China,27/11/2004,5,0,0,0,-6,2,0,1
China,28/11/2004,10,0,0,0,0,0,0,10
China,29/11/2004,-4,0,0,0,0,6,0,2
China,30/11/2004,23,0,0,0,6,2,0,31
China,01/12/2004,11,0,0,0,8,4,0,23
China,02/12/2004,8,0,1,0,1,2,0,12
China,03/12/2004,5,0,0,0,12,0,0,17
China,04/12/2004,4,0,1,0,12,0,0,17
China,05/12/2004,11,0,1,0,0,0,0,12
China,06/12/2004,4,0,0,0,3,0,0,7
China,07/12/2004,12,2,0,0,9,0,0,23
China,08/12/2004,13,0,0,0,15,1,0,29
China,09/12/2004,25,0,-2,0,18,0,0,41
China,10/12/2004,1,0,0,0,3,5,0,9
China,11/12/2004,11,0,-1,0,4,4,0,18
China,12/12/2004,4,0,0,0,0,1,0,5
China,13/12/2004,0,0,0,0,7,0,0,7
China,14/12/2004,2,0,1,0,-2,0,0,1
China,15/12/2004,8,0,0,0,0,0,0,8
China,16/12/2004,10,0,0,0,1,5,0,16
China,17/12/2004,6,0,0,0,32,0,0,38
China,18/12/2004,9,0,0,0,1,0,0,10
China,19/12/2004,6,0,0,0,-1,4,0,9
China,20/12/2004,12,0,-4,0,0,3,0,11
China,21/12/2004,9,0,0,0,-2,2,0,9
China,22/12/2004,-7,0,0,0,0,2,0,-5
China,23/12/2004,2,0,0,0,0,0,0,2
China,24/12/2004,10,0,0,0,6,0,0,16
China,25/12/2004,3,0,0,0,0,1,0,4
China,26/12/2004,9,0,1,0,0,0,0,10
China,27/12/2004,15,0,0,0,3,0,0,18
China,28/12/2004,9,0,0,0,18,0,0,27
China,29/12/2004,10,0,0,0,9,0,0,19
China,30/12/2004,22,2,0,0,9,0,0,33
China,31/12/2004,10,0,0,0,4,0,0,14
Egypt,01/01/2004,-3,0,-1,0,7,0,0,3
Egypt,02/01/2004,3,0,0,0,0,4,0,7
Egypt,03/01/2004,10,0,0,0,0,0,0,10
Egypt,04/01/2004,14,0,0,0,3,0,0,17
Egypt,05/01/2004,1,0,0,0,3,0,0,4
Egypt,06/01/2004,16,0,0,0,-2,0,0,14
Egypt,07/01/2004,6,0,0,0,6,0,0,12
Egypt,08/01/2004,12,0,0,0,2,0,0,14
Egypt,09/01/2004,0,0,0,0,7,0,0,7
Egypt,10/01/2004,3,0,0,0,1,1,0,5
Egypt,11/01/2004,12,0,0,0,-2,0,0,10
Egypt,12/01/2004,-8,0,0,0,0,0,0,-8
Egypt,13/01/2004,18,0,0,0,16,0,0,34
Egypt,14/01/2004,3,0,0,0,9,0,0,12
Egypt,15/01/2004,6,0,0,0,7,0,0,13
Egypt,16/01/2004,0,0,0,0,9,0,0,9
Egypt,17/01/2004,7,0,0,0,0,0,0,7
Egypt,18/01/2004,6,0,0,0,3,0,0,9
Egypt,19/01/2004,0,0,0,0,3,0,0,3
Egypt,20/01/2004,3,0,0,0,0,0,0,3
Egypt,21/01/2004,58,0,0,0,9,2,0,69
Egypt,22/01/2004,16,0,0,0,4,0,0,20
Egypt,23/01/2004,1,0,0,0,0,0,0,1
Egypt,24/01/2004,20,0,0,0,3,2,0,25
Egypt,25/01/2004,8,0,0,0,0,0,0,8
Egypt,26/01/2004,4,0,0,0,6,4,0,14
Egypt,27/01/2004,13,0,0,0,12,0,0,25
Egypt,28/01/2004,29,0,0,0,1,1,0,31
Egypt,29/01/2004,-3,0,0,0,3,0,0,0
Egypt,30/01/2004,9,0,0,0,6,0,0,15
Egypt,31/01/2004,15,0,0,0,2,0,0,17
Egypt,01/02/2004,9,0,0,0,6,3,0,18
Egypt,02/02/2004,9,0,0,0,3,0,0,12
Egypt,03/02/2004,-1,0,0,0,0,0,0,-1
Egypt,04/02/2004,2,0,0,0,0,2,0,4
Egypt,05/02/2004,7,0,0,0,1,1,0,9
Egypt,06/02/2004,26,0,0,0,3,0,0,29
Egypt,07/02/2004,14,0,0,0,0,0,0,14
Egypt,08/02/2004,5,0,0,0,0,0,0,5
Egypt,09/02/2004,8,0,0,0,18,0,0,26
Egypt,10/02/2004,13,0,0,0,0,0,0,13
Egypt,11/02/2004,45,0,-1,0,0,4,0,48
Egypt,12/02/2004,28,0,0,0,6,3,0,37
Egypt,13/02/2004,3,0,0,0,-1,0,0,2
Egypt,14/02/2004,10,0,0,0,3,4,0,17
Egypt,15/02/2004,5,0,0,0,0,0,0,5
Egypt,16/02/2004,-1,0,0,0,0,0,0,-1
Egypt,17/02/2004,3,0,-1,0,0,0,0,2
Egypt,18/02/2004,16,0,0,0,0,0,0,16
Egypt,19/02/2004,0,0,0,0,-2,0,0,-2
Egypt,20/02/2004,12,0,0,0,9,2,0,23
Egypt,21/02/2004,-2,0,0,0,0,0,0,-2
Egypt,22/02/2004,7,0,0,0,9,1,0,17
Egypt,23/02/2004,0,0,0,0,9,1,0,10
Egypt,24/02/2004,4,0,0,0,4,1,0,9
Egypt,25/02/2004,7,0,0,0,3,0,0,10
Egypt,26/02/2004,5,0,0,0,36,2,0,43
Egypt,27/02/2004,14,0,-1,0,3,0,0,16
Egypt,28/02/2004,2,0,0,0,3,0,0,5
Egypt,29/02/2004,8,0,0,0,1,0,0,9
Egypt,01/03/2004,12,0,0,0,21,0,0,33
Egypt,02/03/2004,6,0,0,0,0,0,0,6
Egypt,03/03/2004,1,0,0,0,0,3,0,4
Egypt,04/03/2004,22,0,0,0,18,2,0,42
Egypt,05/03/2004,14,0,0,0,9,0,0,23
Egypt,06/03/2004,0,0,0,0,6,0,0,6
Egypt,07/03/2004,12,0,0,0,0,3,0,15
Egypt,08/03/2004,7,0,0,0,0,0,0,7
Egypt,09/03/2004,1,0,-1,0,-2,0,0,-2
Egypt,10/03/2004,13,0,0,0,3,0,0,16
Egypt,11/03/2004,6,2,0,0,6,2,0,16
Egypt,12/03/2004,5,0,0,0,12,2,0,19
Egypt,13/03/2004,-3,0,-1,0,-2,1,0,-5
Egypt,14/03/2004,6,0,0,0,6,0,0,12
Egypt,15/03/2004,14,0,0,0,6,0,0,20
Egypt,16/03/2004,5,0,-2,0,12,0,0,15
Egypt,17/03/2004,51,0,0,0,15,3,0,69
Egypt,18/03/2004,33,0,0,0,3,4,0,40
Egypt,19/03/2004,16,0,0,0,0,0,0,16
Egypt,20/03/2004,1,0,0,0,3,0,0,4
Egypt,21/03/2004,1,0,0,0,3,0,0,4
Egypt,22/03/2004,-23,0,0,0,9,0,0,-14
Egypt,23/03/2004,-13,0,0,0,6,3,0,-4
Egypt,24/03/2004,22,0,0,0,12,1,0,35
Egypt,25/03/2004,-2,0,0,0,13,0,0,11
Egypt,26/03/2004,3,0,0,0,0,0,0,3
Egypt,27/03/2004,0,0,0,0,-2,0,0,-2
Egypt,28/03/2004,3,0,0,0,12,0,0,15
Egypt,29/03/2004,2,0,0,0,9,0,0,11
Egypt,30/03/2004,13,0,0,0,6,7,0,26
Egypt,31/03/2004,1,0,0,0,1,0,0,2
Egypt,01/04/2004,13,0,0,0,6,0,0,19
Egypt,02/04/2004,7,0,0,0,-2,0,0,5
Egypt,03/04/2004,2,0,0,0,3,0,0,5
Egypt,04/04/2004,11,0,0,0,0,0,0,11
Egypt,05/04/2004,9,0,0,0,-1,0,0,8
Egypt,06/04/2004,0,0,0,0,0,2,0,2
Egypt,07/04/2004,7,0,0,0,6,0,0,13
Egypt,08/04/2004,-1,0,0,0,0,3,0,2
Egypt,09/04/2004,9,0,0,0,0,0,0,9
Egypt,10/04/2004,2,0,0,0,0,0,0,2
Egypt,11/04/2004,3,0,0,0,0,0,0,3
Egypt,12/04/2004,-11,0,0,0,3,0,0,-8
Egypt,13/04/2004,10,0,0,0,3,0,0,13
Egypt,14/04/2004,-1,0,0,0,3,0,0,2
Egypt,15/04/2004,15,0,0,0,6,1,0,22
Egypt,16/04/2004,18,0,0,0,-6,0,0,12
Egypt,17/04/2004,6,0,-2,0,9,0,0,13
Egypt,18/04/2004,-6,0,0,0,0,1,0,-5
Egypt,19/04/2004,-21,0,0,0,4,0,0,-17
Egypt,20/04/2004,42,0,0,0,0,0,0,42
Egypt,21/04/2004,11,0,0,0,9,2,0,22
Egypt,22/04/2004,16,0,0,0,6,0,0,22
Egypt,23/04/2004,4,0,0,0,3,2,0,9
Egypt,24/04/2004,0,0,0,0,0,0,0,0
Egypt,25/04/2004,3,0,0,0,0,0,0,3
Egypt,26/04/2004,2,0,0,0,-2,0,0,0
Egypt,27/04/2004,22,0,0,0,0,0,0,22
Egypt,28/04/2004,12,0,0,0,-2,0,0,10
Egypt,29/04/2004,2,0,1,0,0,0,0,3
Egypt,30/04/2004,4,0,0,0,0,0,0,4
Egypt,01/05/2004,2,0,0,0,-3,3,0,2
Egypt,02/05/2004,2,0,0,0,0,0,0,2
Egypt,03/05/2004,3,0,0,0,0,0,0,3
Egypt,04/05/2004,21,0,0,0,12,3,0,36
Egypt,05/05/2004,21,0,0,0,10,1,0,32
Egypt,06/05/2004,6,0,2,0,-4,1,0,5
Egypt,07/05/2004,0,0,0,0,3,2,0,5
Egypt,08/05/2004,8,0,0,0,4,1,0,13
Egypt,09/05/2004,23,0,0,0,3,0,0,26
Egypt,10/05/2004,9,0,0,0,0,0,0,9
Egypt,11/05/2004,3,0,0,0,9,0,0,12
Egypt,12/05/2004,10,0,0,0,-8,2,0,4
Egypt,13/05/2004,24,0,0,0,-6,8,0,26
Egypt,14/05/2004,26,0,0,0,-2,2,0,26
Egypt,15/05/2004,-5,0,0,0,0,2,0,-3
Egypt,16/05/2004,24,0,-1,0,3,3,0,29
Egypt,17/05/2004,39,0,4,0,2,4,0,49
Egypt,18/05/2004,34,0,-2,0,6,8,0,46
Egypt,19/05/2004,27,0,1,0,10,6,0,44
Egypt,20/05/2004,13,0,2,0,10,3,0,28
Egypt,21/05/2004,-1,0,0,0,9,5,0,13
Egypt,22/05/2004,0,0,1,0,0,0,0,1
Egypt,23/05/2004,11,0,0,0,0,4,0,15
Egypt,24/05/2004,11,0,0,0,0,9,0,20
Egypt,25/05/2004,9,0,0,0,3,2,0,14
Egypt,26/05/2004,7,0,0,0,-2,1,0,6
Egypt,27/05/2004,3,0,0,0,18,1,0,22
Egypt,28/05/2004,25,0,0,0,6,0,0,31
Egypt,29/05/2004,16,0,0,0,6,0,0,22
Egypt,30/05/2004,20,0,0,0,6,0,0,26
Egypt,31/05/2004,-1,0,0,0,17,5,0,21
Egypt,01/06/2004,19,0,0,0,1,3,0,23
Egypt,02/06/2004,19,0,0,0,4,3,0,26
Egypt,03/06/2004,17,0,0,0,23,4,0,44
Egypt,04/06/2004,6,0,0,0,0,2,0,8
Egypt,05/06/2004,-4,0,0,0,0,1,0,-3
Egypt,06/06/2004,34,0,2,0,18,4,0,58
Egypt,07/06/2004,-1,0,0,0,3,0,0,2
Egypt,08/06/2004,33,0,0,0,33,2,0,68
Egypt,09/06/2004,27,0,0,0,45,0,0,72
Egypt,10/06/2004,-4,0,0,0,31,0,0,27
Egypt,11/06/2004,15,0,0,0,29,2,0,46
Egypt,12/06/2004,5,0,0,0,18,6,0,29
Egypt,13/06/2004,7,2,-2,0,-1,0,0,6
Egypt,14/06/2004,37,0,2,0,19,0,0,58
Egypt,15/06/2004,15,0,0,0,15,3,0,33
Egypt,16/06/2004,17,0,0,0,6,2,0,25
Egypt,17/06/2004,34,0,1,0,30,0,0,65
Egypt,18/06/2004,12,0,0,0,13,2,0,27
Egypt,19/06/2004,1,0,0,0,-6,0,0,-5
Egypt,20/06/2004,2,0,0,0,4,0,0,6
Egypt,21/06/2004,27,0,0,0,0,2,0,29
Egypt,22/06/2004,19,0,0,0,6,5,0,30
Egypt,23/06/2004,-19,2,1,0,0,0,0,-16
Egypt,24/06/2004,-5,0,0,0,3,2,0,0
Egypt,25/06/2004,19,0,0,0,0,3,0,22
Egypt,26/06/2004,3,0,0,0,12,-2,0,13
Egypt,27/06/2004,10,0,0,0,0,0,0,10
Egypt,28/06/2004,4,0,2,0,1,0,0,7
Egypt,29/06/2004,13,0,0,0,-1,0,0,12
Egypt,30/06/2004,9,0,0,0,0,1,0,10
Egypt,01/07/2004,3,0,0,0,0,3,0,6
Egypt,02/07/2004,-1,0,1,0,9,2,0,11
Egypt,03/07/2004,13,0,0,0,0,0,0,13
Egypt,04/07/2004,27,0,0,0,0,0,0,27
Egypt,05/07/2004,8,2,0,0,3,1,0,14
Egypt,06/07/2004,6,0,-1,0,-4,0,0,1
Egypt,07/07/2004,11,0,0,0,30,0,0,41
Egypt,08/07/2004,17,0,0,0,9,0,0,26
Egypt,09/07/2004,9,0,-2,0,15,1,0,23
Egypt,10/07/2004,18,0,-4,0,7,0,0,21
Egypt,11/07/2004,-1,0,0,0,0,0,0,-1
Egypt,12/07/2004,3,0,0,0,12,1,0,16
Egypt,13/07/2004,-4,2,-1,0,-6,1,0,-8
Egypt,14/07/2004,0,0,0,0,12,0,0,12
Egypt,15/07/2004,21,0,0,0,6,0,0,27
Egypt,16/07/2004,9,0,0,0,8,1,0,18
Egypt,17/07/2004,2,0,0,0,4,2,0,8
Egypt,18/07/2004,8,0,2,0,6,16,0,32
Egypt,19/07/2004,24,0,1,0,17,5,0,47
Egypt,20/07/2004,24,0,0,0,-4,2,0,22
Egypt,21/07/2004,3,0,0,0,-2,0,0,1
Egypt,22/07/2004,-2,0,0,0,-6,0,0,-8
Egypt,23/07/2004,12,0,0,0,42,2,0,56
Egypt,24/07/2004,3,0,0,0,16,6,0,25
Egypt,25/07/2004,13,0,0,0,17,3,0,33
Egypt,26/07/2004,4,0,0,0,10,13,0,27
Egypt,27/07/2004,5,0,0,0,3,6,0,14
Egypt,28/07/2004,8,0,-4,0,3,3,0,10
Egypt,29/07/2004,5,2,0,0,7,0,0,14
Egypt,30/07/2004,7,0,0,0,6,0,0,13
Egypt,31/07/2004,15,0,0,0,-3,3,0,15
Egypt,01/08/2004,11,0,0,0,4,8,0,23
Egypt,02/08/2004,3,0,0,0,2,1,0,6
Egypt,03/08/2004,19,0,0,0,6,0,0,25
Egypt,04/08/2004,13,0,1,0,0,0,0,14
Egypt,05/08/2004,1,0,0,0,12,1,0,14
Egypt,06/08/2004,17,0,0,0,3,2,0,22
Egypt,07/08/2004,7,0,0,0,-2,0,0,5
Egypt,08/08/2004,2,0,0,0,33,0,0,35
Egypt,09/08/2004,-17,0,0,0,12,0,0,-5
Egypt,10/08/2004,7,0,0,0,0,2,0,9
Egypt,11/08/2004,7,0,0,0,6,2,0,15
Egypt,12/08/2004,7,0,0,0,0,2,0,9
Egypt,13/08/2004,16,0,0,0,-4,1,0,13
Egypt,14/08/2004,14,0,0,0,3,0,0,17
Egypt,15/08/2004,2,0,0,0,0,0,0,2
Egypt,16/08/2004,10,0,0,0,9,0,0,19
Egypt,17/08/2004,3,0,0,0,0,0,0,3
Egypt,18/08/2004,-4,0,0,0,0,0,0,-4
Egypt,19/08/2004,14,0,0,0,6,0,0,20
Egypt,20/08/2004,11,0,0,0,3,1,0,15
Egypt,21/08/2004,3,0,0,0,3,0,0,6
Egypt,22/08/2004,3,0,0,0,15,0,0,18
Egypt,23/08/2004,11,0,0,0,-10,1,0,2
Egypt,24/08/2004,0,0,0,0,3,0,0,3
Egypt,25/08/2004,7,0,0,0,3,3,0,13
Egypt,26/08/2004,10,0,0,0,24,1,0,35
Egypt,27/08/2004,2,0,0,0,6,2,0,10
Egypt,28/08/2004,2,0,0,0,3,0,0,5
Egypt,29/08/2004,0,0,0,0,1,1,0,2
Egypt,30/08/2004,15,0,0,0,3,0,0,18
Egypt,31/08/2004,27,0,0,0,0,6,0,33
Egypt,01/09/2004,48,6,0,0,11,13,0,78
Egypt,02/09/2004,9,0,0,0,6,0,0,15
Egypt,03/09/2004,12,0,0,0,8,0,0,20
Egypt,04/09/2004,9,0,0,0,0,0,0,9
Egypt,05/09/2004,39,0,0,0,15,2,0,56
Egypt,06/09/2004,6,0,-2,0,4,0,0,8
Egypt,07/09/2004,23,0,0,0,0,2,0,25
Egypt,08/09/2004,13,0,-2,0,6,0,0,17
Egypt,09/09/2004,18,2,2,0,12,0,0,34
Egypt,10/09/2004,5,0,0,0,0,0,0,5
Egypt,11/09/2004,24,0,0,0,2,0,0,26
Egypt,12/09/2004,-4,0,0,0,3,0,0,-1
Egypt,13/09/2004,15,0,0,0,2,0,0,17
Egypt,14/09/2004,-1,0,0,0,6,0,0,5
Egypt,15/09/2004,26,0,0,0,-10,2,0,18
Egypt,16/09/2004,9,0,0,0,27,0,0,36
Egypt,17/09/2004,6,0,0,0,9,0,0,15
Egypt,18/09/2004,6,0,0,0,0,0,0,6
Egypt,19/09/2004,7,0,0,0,17,0,0,24
Egypt,20/09/2004,5,0,0,0,3,0,0,8
Egypt,21/09/2004,-1,0,0,0,-4,0,0,-5
Egypt,22/09/2004,0,0,-2,0,3,1,0,2
Egypt,23/09/2004,8,0,0,0,0,0,0,8
Egypt,24/09/2004,9,0,0,0,26,9,0,44
Egypt,25/09/2004,5,0,0,0,18,1,0,24
Egypt,26/09/2004,9,0,0,0,47,2,0,58
Egypt,27/09/2004,0,0,0,0,-7,2,0,-5
Egypt,28/09/2004,3,0,0,0,-24,3,0,-18
Egypt,29/09/2004,4,0,0,0,-1,0,0,3
Egypt,30/09/2004,40,0,0,0,4,10,0,54
Egypt,01/10/2004,-1,0,0,0,3,0,0,2
Egypt,02/10/2004,5,6,0,0,1,2,0,14
Egypt,03/10/2004,18,0,0,0,3,0,0,21
Egypt,04/10/2004,17,0,0,0,3,10,0,30
Egypt,05/10/2004,20,0,0,0,12,0,0,32
Egypt,06/10/2004,6,0,0,0,6,0,0,12
Egypt,07/10/2004,53,0,0,0,18,13,0,84
Egypt,08/10/2004,136,0,0,0,0,18,0,154
Egypt,09/10/2004,35,0,0,0,6,10,0,51
Egypt,10/10/2004,30,0,0,0,-2,2,0,30
Egypt,11/10/2004,7,0,0,0,-1,6,0,12
Egypt,12/10/2004,18,0,0,0,0,0,0,18
Egypt,13/10/2004,8,0,0,0,4,0,0,12
Egypt,14/10/2004,9,0,0,0,0,0,0,9
Egypt,15/10/2004,5,0,0,0,3,0,0,8
Egypt,16/10/2004,8,0,0,0,0,2,0,10
Egypt,17/10/2004,-1,0,0,0,0,0,0,-1
Egypt,18/10/2004,33,0,0,0,30,4,0,67
Egypt,19/10/2004,3,0,0,0,2,2,0,7
Egypt,20/10/2004,17,0,0,0,-8,3,0,12
Egypt,21/10/2004,28,0,0,0,0,0,0,28
Egypt,22/10/2004,7,0,0,0,0,0,0,7
Egypt,23/10/2004,0,0,0,0,0,0,0,0
Egypt,24/10/2004,-1,0,-2,0,3,1,0,1
Egypt,25/10/2004,13,0,0,0,3,3,0,19
Egypt,26/10/2004,10,0,1,0,-1,0,0,10
Egypt,27/10/2004,-3,0,0,0,4,0,0,1
Egypt,28/10/2004,9,0,-4,0,6,3,0,14
Egypt,29/10/2004,8,0,0,0,3,0,0,11
Egypt,30/10/2004,0,0,0,0,0,0,0,0
Egypt,31/10/2004,3,0,0,0,12,1,0,16
Egypt,01/11/2004,8,0,0,0,0,0,0,8
Egypt,02/11/2004,2,0,0,0,0,1,0,3
Egypt,03/11/2004,16,0,6,0,3,2,0,27
Egypt,04/11/2004,10,0,2,0,3,0,0,15
Egypt,05/11/2004,0,0,1,0,0,0,0,1
Egypt,06/11/2004,0,0,0,0,0,0,0,0
Egypt,07/11/2004,2,0,0,0,-2,0,0,0
Egypt,08/11/2004,2,0,0,0,3,0,0,5
Egypt,09/11/2004,3,0,0,0,9,0,0,12
Egypt,10/11/2004,1,0,0,0,12,0,0,13
Egypt,11/11/2004,-2,0,0,0,12,0,0,10
Egypt,12/11/2004,3,0,0,0,0,1,0,4
Egypt,13/11/2004,3,0,0,0,0,0,0,3
Egypt,14/11/2004,5,0,0,0,2,0,0,7
Egypt,15/11/2004,7,0,0,0,10,1,0,18
Egypt,16/11/2004,-1,0,0,0,0,0,0,-1
Egypt,17/11/2004,5,0,0,0,0,0,0,5
Egypt,18/11/2004,59,0,0,0,-2,5,0,62
Egypt,19/11/2004,14,0,0,0,3,2,0,19
Egypt,20/11/2004,13,0,0,0,4,0,0,17
Egypt,21/11/2004,3,0,0,0,3,0,0,6
Egypt,22/11/2004,30,0,0,0,17,0,0,47
Egypt,23/11/2004,-2,0,1,0,0,2,0,1
Egypt,24/11/2004,4,0,0,0,0,0,0,4
Egypt,25/11/2004,6,0,0,0,6,3,0,15
Egypt,26/11/2004,3,0,1,0,0,0,0,4
Egypt,27/11/2004,5,0,1,0,0,0,0,6
Egypt,28/11/2004,6,0,-2,0,0,0,0,4
Egypt,29/11/2004,17,0,-4,0,0,2,0,15
Egypt,30/11/2004,19,0,1,0,0,11,0,31
Egypt,01/12/2004,26,0,-2,0,0,1,0,25
Egypt,02/12/2004,10,0,0,0,-1,0,0,9
Egypt,03/12/2004,-3,0,0,0,-2,0,0,-5
Egypt,04/12/2004,3,0,3,0,0,0,0,6
Egypt,05/12/2004,5,0,0,0,2,4,0,11
Egypt,06/12/2004,14,0,0,0,4,0,0,18
Egypt,07/12/2004,13,0,0,0,6,0,0,19
Egypt,08/12/2004,7,0,0,0,0,1,0,8
Egypt,09/12/2004,15,0,0,0,58,3,0,76
Egypt,10/12/2004,12,0,0,0,3,1,0,16
Egypt,11/12/2004,2,0,0,0,-1,0,0,1
Egypt,12/12/2004,35,0,0,0,-13,13,0,35
Egypt,13/12/2004,52,0,0,0,1,0,0,53
Egypt,14/12/2004,29,0,0,0,0,2,0,31
Egypt,15/12/2004,6,0,0,0,2,0,0,8
Egypt,16/12/2004,16,0,0,0,0,1,0,17
Egypt,17/12/2004,20,0,0,0,15,0,0,35
Egypt,18/12/2004,21,0,0,0,0,6,0,27
Egypt,19/12/2004,8,0,0,0,6,1,0,15
Egypt,20/12/2004,6,0,0,0,2,0,0,8
Egypt,21/12/2004,0,0,0,0,3,0,0,3
Egypt,22/12/2004,9,0,0,0,0,0,0,9
Egypt,23/12/2004,6,0,0,0,3,0,0,9
Egypt,24/12/2004,2,0,0,0,0,0,0,2
Egypt,25/12/2004,0,0,0,0,0,0,0,0
Egypt,26/12/2004,16,0,0,0,0,0,0,16
Egypt,27/12/2004,7,0,0,0,-18,0,0,-11
Egypt,28/12/2004,-3,0,0,0,3,0,0,0
Egypt,29/12/2004,5,0,0,0,24,0,0,29
Egypt,30/12/2004,6,0,0,0,0,0,0,6
Egypt,31/12/2004,14,0,0,0,10,0,0,24
Eritrea,01/01/2004,0,0,0,0,0,0,0,0
Eritrea,02/01/2004,0,0,0,0,0,0,0,0
Eritrea,04/01/2004,2,0,0,0,0,0,0,2
Eritrea,05/01/2004,0,0,0,0,3,0,0,3
Eritrea,06/01/2004,4,0,0,0,0,0,0,4
Eritrea,07/01/2004,3,0,0,0,0,0,0,3
Eritrea,08/01/2004,2,0,0,0,9,0,0,11
Eritrea,09/01/2004,6,0,0,0,0,1,0,7
Eritrea,11/01/2004,-1,0,0,0,0,0,0,-1
Eritrea,13/01/2004,0,0,0,0,0,0,0,0
Eritrea,15/01/2004,0,0,0,0,3,0,0,3
Eritrea,16/01/2004,0,0,0,0,3,0,0,3
Eritrea,19/01/2004,5,0,0,0,0,0,0,5
Eritrea,20/01/2004,0,0,0,0,0,2,0,2
Eritrea,21/01/2004,2,0,0,0,0,0,0,2
Eritrea,22/01/2004,16,0,0,0,3,1,0,20
Eritrea,23/01/2004,2,0,0,0,0,0,0,2
Eritrea,25/01/2004,-6,0,0,0,0,0,0,-6
Eritrea,26/01/2004,1,0,0,0,0,0,0,1
Eritrea,27/01/2004,0,0,1,0,0,0,0,1
Eritrea,28/01/2004,0,0,0,0,0,0,0,0
Eritrea,29/01/2004,0,0,0,0,0,0,0,0
Eritrea,30/01/2004,6,0,0,0,3,0,0,9
Eritrea,01/02/2004,9,0,0,0,0,0,0,9
Eritrea,02/02/2004,2,0,0,0,0,0,0,2
Eritrea,03/02/2004,0,0,0,0,0,0,0,0
Eritrea,04/02/2004,2,0,0,0,0,0,0,2
Eritrea,05/02/2004,0,0,0,0,0,0,0,0
Eritrea,06/02/2004,2,0,0,0,0,0,0,2
Eritrea,08/02/2004,0,0,0,0,0,0,0,0
Eritrea,09/02/2004,-2,0,0,0,0,0,0,-2
Eritrea,10/02/2004,2,4,0,0,0,0,0,6
Eritrea,11/02/2004,2,0,0,0,0,0,0,2
Eritrea,12/02/2004,-5,0,0,0,0,0,0,-5
Eritrea,13/02/2004,3,0,0,0,0,0,0,3
Eritrea,14/02/2004,4,0,0,0,0,0,0,4
Eritrea,16/02/2004,0,0,0,0,0,0,0,0
Eritrea,17/02/2004,2,0,0,0,0,0,0,2
Eritrea,18/02/2004,0,0,0,0,0,0,0,0
Eritrea,19/02/2004,2,0,0,0,0,0,0,2
Eritrea,20/02/2004,0,0,0,0,0,0,0,0
Eritrea,21/02/2004,1,2,0,0,0,0,0,3
Eritrea,22/02/2004,0,0,0,0,0,0,0,0
Eritrea,24/02/2004,0,0,0,0,0,0,0,0
Eritrea,25/02/2004,0,0,0,0,0,0,0,0
Eritrea,26/02/2004,-2,0,0,0,0,0,0,-2
Eritrea,27/02/2004,0,0,0,0,-8,0,0,-8
Eritrea,02/03/2004,6,0,0,0,-4,0,0,2
Eritrea,03/03/2004,5,2,0,0,0,0,0,7
Eritrea,04/03/2004,0,0,0,0,0,0,0,0
Eritrea,05/03/2004,-1,4,0,0,0,0,0,3
Eritrea,06/03/2004,0,0,0,0,0,0,0,0
Eritrea,07/03/2004,0,0,0,0,0,0,0,0
Eritrea,08/03/2004,0,0,0,0,0,0,0,0
Eritrea,09/03/2004,0,0,0,0,0,0,0,0
Eritrea,10/03/2004,3,0,0,0,0,0,0,3
Eritrea,11/03/2004,2,0,0,0,0,0,0,2
Eritrea,12/03/2004,3,0,0,0,-4,0,0,-1
Eritrea,15/03/2004,0,0,0,0,0,0,0,0
Eritrea,16/03/2004,0,0,0,0,0,0,0,0
Eritrea,18/03/2004,0,0,0,0,0,0,0,0
Eritrea,19/03/2004,-1,0,0,0,0,0,0,-1
Eritrea,20/03/2004,0,0,0,0,0,0,0,0
Eritrea,21/03/2004,0,0,0,0,0,0,0,0
Eritrea,22/03/2004,0,0,0,0,0,0,0,0
Eritrea,23/03/2004,4,0,0,0,0,0,0,4
Eritrea,24/03/2004,0,0,0,0,0,0,0,0
Eritrea,25/03/2004,0,0,0,0,0,0,0,0
Eritrea,26/03/2004,0,0,0,0,0,0,0,0
Eritrea,29/03/2004,2,0,0,0,0,0,0,2
Eritrea,30/03/2004,0,0,0,0,0,0,0,0
Eritrea,31/03/2004,3,0,0,0,0,0,0,3
Eritrea,01/04/2004,0,0,0,0,3,0,0,3
Eritrea,02/04/2004,0,0,0,0,12,0,0,12
Eritrea,03/04/2004,0,0,0,0,0,0,0,0
Eritrea,04/04/2004,0,0,0,0,0,0,0,0
Eritrea,05/04/2004,0,0,0,0,0,1,0,1
Eritrea,06/04/2004,1,0,0,0,0,0,0,1
Eritrea,07/04/2004,0,0,0,0,0,0,0,0
Eritrea,13/04/2004,15,0,0,0,0,0,0,15
Eritrea,14/04/2004,0,0,0,0,0,0,0,0
Eritrea,15/04/2004,2,0,0,0,3,0,0,5
Eritrea,16/04/2004,0,0,0,0,0,0,0,0
Eritrea,17/04/2004,-2,0,0,0,0,0,0,-2
Eritrea,19/04/2004,2,0,0,0,0,0,0,2
Eritrea,20/04/2004,4,0,0,0,0,0,0,4
Eritrea,24/04/2004,0,0,0,0,0,0,0,0
Eritrea,25/04/2004,0,0,0,0,-2,0,0,-2
Eritrea,27/04/2004,0,0,0,0,0,0,0,0
Eritrea,28/04/2004,2,0,0,0,0,0,0,2
Eritrea,29/04/2004,4,0,0,0,0,0,0,4
Eritrea,02/05/2004,0,0,0,0,3,0,0,3
Eritrea,03/05/2004,0,0,0,0,0,0,0,0
Eritrea,05/05/2004,0,0,0,0,0,0,0,0
Eritrea,06/05/2004,2,0,0,0,3,2,0,7
Eritrea,07/05/2004,2,0,0,0,3,0,0,5
Eritrea,08/05/2004,4,0,0,0,0,0,0,4
Eritrea,09/05/2004,6,0,0,0,0,0,0,6
Eritrea,10/05/2004,4,0,0,0,0,2,0,6
Eritrea,11/05/2004,7,0,0,0,0,7,0,14
Eritrea,12/05/2004,0,0,0,0,0,0,0,0
Eritrea,13/05/2004,6,0,0,0,0,0,0,6
Eritrea,14/05/2004,6,0,0,0,0,2,0,8
Eritrea,15/05/2004,-2,0,0,0,0,0,0,-2
Eritrea,16/05/2004,0,0,0,0,0,0,0,0
Eritrea,19/05/2004,0,0,0,0,6,0,0,6
Eritrea,20/05/2004,-1,0,0,0,9,1,0,9
Eritrea,21/05/2004,2,0,0,0,3,0,0,5
Eritrea,22/05/2004,0,0,0,0,3,0,0,3
Eritrea,23/05/2004,0,0,0,0,0,0,0,0
Eritrea,24/05/2004,2,0,0,0,0,0,0,2
Eritrea,25/05/2004,6,0,0,0,0,0,0,6
Eritrea,27/05/2004,0,0,0,0,0,0,0,0
Eritrea,28/05/2004,2,0,0,0,6,0,0,8
Eritrea,29/05/2004,0,0,0,0,3,0,0,3
Eritrea,31/05/2004,0,0,0,0,0,0,0,0
Eritrea,01/06/2004,0,0,0,0,0,0,0,0
Eritrea,03/06/2004,0,0,0,0,0,0,0,0
Eritrea,04/06/2004,1,0,0,0,0,0,0,1
Eritrea,06/06/2004,-1,0,0,0,0,0,0,-1
Eritrea,07/06/2004,0,0,0,0,0,0,0,0
Eritrea,09/06/2004,-3,0,0,0,0,0,0,-3
Eritrea,14/06/2004,0,0,0,0,0,0,0,0
Eritrea,17/06/2004,0,2,0,0,0,0,0,2
Eritrea,18/06/2004,0,0,0,0,0,0,0,0
Eritrea,19/06/2004,0,0,0,0,0,0,0,0
Eritrea,21/06/2004,0,0,0,0,3,0,0,3
Eritrea,22/06/2004,0,0,0,0,0,0,0,0
Eritrea,23/06/2004,1,0,0,0,0,0,0,1
Eritrea,24/06/2004,-1,0,0,0,0,0,0,-1
Eritrea,25/06/2004,2,0,0,0,3,0,0,5
Eritrea,26/06/2004,0,0,0,0,0,0,0,0
Eritrea,27/06/2004,0,0,0,0,0,0,0,0
Eritrea,28/06/2004,0,0,0,0,0,0,0,0
Eritrea,29/06/2004,0,0,0,0,0,0,0,0
Eritrea,30/06/2004,0,0,0,0,0,0,0,0
Eritrea,01/07/2004,0,0,0,0,0,0,0,0
Eritrea,02/07/2004,-3,0,0,0,0,0,0,-3
Eritrea,03/07/2004,4,0,0,0,0,0,0,4
Eritrea,04/07/2004,0,0,0,0,0,0,0,0
Eritrea,05/07/2004,0,0,0,0,0,0,0,0
Eritrea,06/07/2004,2,0,0,0,0,0,0,2
Eritrea,07/07/2004,-2,0,0,0,0,0,0,-2
Eritrea,08/07/2004,-3,0,0,0,0,0,0,-3
Eritrea,09/07/2004,2,0,0,0,0,0,0,2
Eritrea,11/07/2004,0,0,0,0,0,1,0,1
Eritrea,13/07/2004,0,0,0,0,0,0,0,0
Eritrea,14/07/2004,0,0,0,0,0,0,0,0
Eritrea,18/07/2004,0,0,0,0,0,0,0,0
Eritrea,19/07/2004,0,0,0,0,0,0,0,0
Eritrea,20/07/2004,0,0,0,0,6,0,0,6
Eritrea,21/07/2004,1,0,0,0,0,0,0,1
Eritrea,22/07/2004,2,0,0,0,6,0,0,8
Eritrea,23/07/2004,0,0,0,0,6,0,0,6
Eritrea,26/07/2004,0,0,0,0,6,0,0,6
Eritrea,28/07/2004,0,0,0,0,0,0,0,0
Eritrea,29/07/2004,9,0,0,0,0,0,0,9
Eritrea,30/07/2004,0,0,0,0,0,0,0,0
Eritrea,31/07/2004,0,0,0,0,0,0,0,0
Eritrea,01/08/2004,0,0,0,0,0,0,0,0
Eritrea,02/08/2004,9,0,0,0,-4,0,0,5
Eritrea,03/08/2004,3,4,0,0,0,0,0,7
Eritrea,08/08/2004,14,0,0,0,0,0,0,14
Eritrea,09/08/2004,6,0,0,0,0,0,0,6
Eritrea,10/08/2004,0,0,0,0,0,0,0,0
Eritrea,11/08/2004,0,0,0,0,0,0,0,0
Eritrea,12/08/2004,0,0,0,0,0,0,0,0
Eritrea,13/08/2004,3,0,0,0,0,0,0,3
Eritrea,14/08/2004,0,0,0,0,0,0,0,0
Eritrea,15/08/2004,0,0,0,0,0,0,0,0
Eritrea,16/08/2004,1,0,0,0,0,0,0,1
Eritrea,17/08/2004,36,0,0,0,0,0,0,36
Eritrea,18/08/2004,0,0,0,0,0,0,0,0
Eritrea,19/08/2004,0,0,0,0,0,2,0,2
Eritrea,20/08/2004,0,0,0,0,0,0,0,0
Eritrea,21/08/2004,0,0,0,0,0,0,0,0
Eritrea,22/08/2004,6,0,0,0,6,0,0,12
Eritrea,23/08/2004,0,0,0,0,0,0,0,0
Eritrea,25/08/2004,-2,0,0,0,0,0,0,-2
Eritrea,26/08/2004,0,0,0,0,0,0,0,0
Eritrea,27/08/2004,2,0,0,0,9,0,0,11
Eritrea,28/08/2004,3,0,0,0,6,0,0,9
Eritrea,29/08/2004,0,0,0,0,3,0,0,3
Eritrea,30/08/2004,3,0,0,0,0,0,0,3
Eritrea,31/08/2004,1,0,0,0,0,0,0,1
Eritrea,01/09/2004,0,0,0,0,6,0,0,6
Eritrea,02/09/2004,0,0,0,0,0,0,0,0
Eritrea,03/09/2004,3,0,0,0,3,0,0,6
Eritrea,05/09/2004,2,0,0,0,3,0,0,5
Eritrea,06/09/2004,2,0,0,0,0,0,0,2
Eritrea,07/09/2004,0,0,0,0,-4,0,0,-4
Eritrea,08/09/2004,4,0,0,0,6,0,0,10
Eritrea,09/09/2004,14,0,0,0,0,0,0,14
Eritrea,10/09/2004,4,0,0,0,9,0,0,13
Eritrea,11/09/2004,1,0,0,0,0,0,0,1
Eritrea,12/09/2004,-18,0,0,0,0,0,0,-18
Eritrea,14/09/2004,0,0,0,0,0,0,0,0
Eritrea,15/09/2004,1,0,0,0,0,0,0,1
Eritrea,16/09/2004,0,0,0,0,-2,1,0,-1
Eritrea,17/09/2004,0,0,0,0,12,0,0,12
Eritrea,19/09/2004,3,0,0,0,0,0,0,3
Eritrea,20/09/2004,0,0,0,0,1,0,0,1
Eritrea,21/09/2004,0,0,0,0,18,0,0,18
Eritrea,22/09/2004,10,0,0,0,11,0,0,21
Eritrea,23/09/2004,4,0,0,0,9,0,0,13
Eritrea,24/09/2004,2,0,0,0,0,0,0,2
Eritrea,25/09/2004,2,0,0,0,6,0,0,8
Eritrea,26/09/2004,0,0,0,0,0,0,0,0
Eritrea,27/09/2004,0,0,0,0,0,0,0,0
Eritrea,28/09/2004,0,0,0,0,0,2,0,2
Eritrea,29/09/2004,1,0,0,0,0,3,0,4
Eritrea,30/09/2004,0,0,0,0,0,0,0,0
Eritrea,01/10/2004,0,0,0,0,0,0,0,0
Eritrea,02/10/2004,2,0,0,0,0,0,0,2
Eritrea,03/10/2004,0,0,0,0,0,0,0,0
Eritrea,04/10/2004,4,0,0,0,-10,0,0,-6
Eritrea,05/10/2004,6,0,0,0,0,0,0,6
Eritrea,06/10/2004,1,0,0,0,9,0,0,10
Eritrea,07/10/2004,0,0,0,0,6,0,0,6
Eritrea,08/10/2004,-2,0,0,0,0,2,0,0
Eritrea,09/10/2004,0,0,0,0,6,0,0,6
Eritrea,10/10/2004,0,0,0,0,0,0,0,0
Eritrea,12/10/2004,3,0,0,0,0,0,0,3
Eritrea,13/10/2004,0,0,0,0,0,0,0,0
Eritrea,15/10/2004,1,0,0,0,-4,0,0,-3
Eritrea,16/10/2004,0,0,0,0,0,0,0,0
Eritrea,17/10/2004,0,0,0,0,0,0,0,0
Eritrea,18/10/2004,-3,0,0,0,0,0,0,-3
Eritrea,19/10/2004,0,0,0,0,0,0,0,0
Eritrea,20/10/2004,10,0,0,0,0,0,0,10
Eritrea,21/10/2004,0,0,0,0,0,0,0,0
Eritrea,23/10/2004,0,0,0,0,0,0,0,0
Eritrea,24/10/2004,0,0,0,0,0,0,0,0
Eritrea,26/10/2004,0,0,0,0,0,0,0,0
Eritrea,27/10/2004,0,0,0,0,0,2,0,2
Eritrea,29/10/2004,0,0,0,0,3,0,0,3
Eritrea,30/10/2004,0,0,0,0,0,0,0,0
Eritrea,31/10/2004,0,0,0,0,0,0,0,0
Eritrea,01/11/2004,-1,0,0,0,0,0,0,-1
Eritrea,03/11/2004,0,0,0,0,0,0,0,0
Eritrea,04/11/2004,0,0,0,0,0,0,0,0
Eritrea,05/11/2004,20,0,0,0,12,1,0,33
Eritrea,06/11/2004,-1,0,0,0,0,0,0,-1
Eritrea,07/11/2004,3,0,0,0,3,0,0,6
Eritrea,08/11/2004,0,0,0,0,0,0,0,0
Eritrea,09/11/2004,3,0,0,0,0,0,0,3
Eritrea,10/11/2004,0,0,0,0,0,0,0,0
Eritrea,11/11/2004,0,0,0,0,3,0,0,3
Eritrea,12/11/2004,2,0,0,0,0,0,0,2
Eritrea,14/11/2004,0,0,0,0,0,0,0,0
Eritrea,15/11/2004,3,0,0,0,0,0,0,3
Eritrea,16/11/2004,0,0,0,0,0,0,0,0
Eritrea,17/11/2004,0,0,0,0,0,0,0,0
Eritrea,21/11/2004,3,0,0,0,0,0,0,3
Eritrea,22/11/2004,2,0,0,0,-2,0,0,0
Eritrea,23/11/2004,0,0,0,0,0,0,0,0
Eritrea,24/11/2004,0,0,0,0,3,1,0,4
Eritrea,25/11/2004,19,0,0,0,0,0,0,19
Eritrea,26/11/2004,4,0,0,0,0,0,0,4
Eritrea,28/11/2004,8,0,0,0,0,0,0,8
Eritrea,29/11/2004,3,0,0,0,0,0,0,3
Eritrea,30/11/2004,11,0,0,0,3,0,0,14
Eritrea,01/12/2004,0,0,0,0,0,0,0,0
Eritrea,02/12/2004,9,0,0,0,0,0,0,9
Eritrea,03/12/2004,3,0,0,0,0,1,0,4
Eritrea,04/12/2004,0,0,0,0,0,0,0,0
Eritrea,05/12/2004,0,0,0,0,0,0,0,0
Eritrea,06/12/2004,1,0,0,0,0,0,0,1
Eritrea,07/12/2004,16,0,0,0,9,1,0,26
Eritrea,08/12/2004,0,0,0,0,0,0,0,0
Eritrea,09/12/2004,2,0,0,0,0,0,0,2
Eritrea,10/12/2004,2,0,0,0,12,0,0,14
Eritrea,11/12/2004,0,0,0,0,0,0,0,0
Eritrea,12/12/2004,4,0,0,0,0,0,0,4
Eritrea,13/12/2004,-1,0,0,0,0,0,0,-1
Eritrea,14/12/2004,1,0,0,0,0,0,0,1
Eritrea,16/12/2004,1,0,0,0,0,3,0,4
Eritrea,17/12/2004,6,0,0,0,0,0,0,6
Eritrea,18/12/2004,0,0,0,0,0,0,0,0
Eritrea,19/12/2004,6,0,0,0,0,0,0,6
Eritrea,20/12/2004,2,0,0,0,0,0,0,2
Eritrea,21/12/2004,0,0,1,0,0,0,0,1
Eritrea,22/12/2004,-1,0,1,0,0,0,0,0
Eritrea,23/12/2004,0,2,0,0,-2,0,0,0
Eritrea,24/12/2004,0,0,0,0,0,0,0,0
Eritrea,25/12/2004,0,0,0,0,-2,0,0,-2
Eritrea,26/12/2004,0,0,0,0,0,1,0,1
Eritrea,27/12/2004,6,0,0,0,0,0,0,6
Eritrea,28/12/2004,8,0,0,0,0,0,0,8
Eritrea,29/12/2004,0,0,0,0,0,0,0,0
Eritrea,31/12/2004,8,0,0,0,-2,0,0,6
Georgia,02/01/2004,0,0,0,0,0,3,0,3
Georgia,03/01/2004,3,0,0,0,0,0,0,3
Georgia,04/01/2004,2,0,0,0,0,1,0,3
Georgia,05/01/2004,2,0,-4,0,0,0,0,-2
Georgia,06/01/2004,8,0,0,0,0,0,0,8
Georgia,07/01/2004,0,0,0,0,2,0,0,2
Georgia,08/01/2004,1,0,1,0,0,4,0,6
Georgia,09/01/2004,12,0,-2,0,3,1,0,14
Georgia,10/01/2004,2,0,0,0,0,0,0,2
Georgia,12/01/2004,4,0,0,0,0,0,0,4
Georgia,13/01/2004,3,0,-1,0,0,0,0,2
Georgia,15/01/2004,1,0,0,0,0,0,0,1
Georgia,16/01/2004,2,0,0,0,0,0,0,2
Georgia,17/01/2004,0,0,0,0,0,0,0,0
Georgia,18/01/2004,0,0,0,0,0,0,0,0
Georgia,19/01/2004,2,0,0,0,0,0,0,2
Georgia,20/01/2004,-4,0,0,0,0,0,0,-4
Georgia,21/01/2004,-3,0,0,0,0,0,0,-3
Georgia,22/01/2004,2,0,-2,0,0,0,0,0
Georgia,23/01/2004,0,0,0,0,3,0,0,3
Georgia,24/01/2004,-2,0,0,0,0,0,0,-2
Georgia,25/01/2004,3,0,0,0,0,0,0,3
Georgia,26/01/2004,-3,0,2,0,3,0,0,2
Georgia,27/01/2004,0,0,0,0,3,0,0,3
Georgia,28/01/2004,5,0,0,0,0,0,0,5
Georgia,29/01/2004,2,0,0,0,0,0,0,2
Georgia,30/01/2004,-1,0,0,0,0,0,0,-1
Georgia,31/01/2004,4,0,0,0,0,0,0,4
Georgia,01/02/2004,1,0,0,0,0,0,0,1
Georgia,02/02/2004,3,0,0,0,3,0,0,6
Georgia,03/02/2004,4,0,0,0,0,0,0,4
Georgia,04/02/2004,-1,0,0,0,0,0,0,-1
Georgia,05/02/2004,0,0,0,0,0,0,0,0
Georgia,06/02/2004,3,0,0,0,1,0,0,4
Georgia,07/02/2004,2,0,-2,0,0,1,0,1
Georgia,09/02/2004,-1,0,-6,0,0,0,0,-7
Georgia,10/02/2004,1,0,0,0,0,0,0,1
Georgia,11/02/2004,2,0,0,0,0,0,0,2
Georgia,12/02/2004,-1,0,0,0,3,0,0,2
Georgia,13/02/2004,0,0,0,0,0,1,0,1
Georgia,14/02/2004,0,0,0,0,0,0,0,0
Georgia,15/02/2004,0,0,0,0,0,0,0,0
Georgia,16/02/2004,0,0,0,0,0,0,0,0
Georgia,17/02/2004,5,0,0,0,0,1,0,6
Georgia,18/02/2004,0,0,-2,0,12,0,0,10
Georgia,19/02/2004,3,0,-2,0,0,2,0,3
Georgia,20/02/2004,2,0,0,0,1,0,0,3
Georgia,21/02/2004,3,0,0,0,0,1,0,4
Georgia,22/02/2004,0,0,0,0,0,0,0,0
Georgia,23/02/2004,0,0,0,0,0,0,0,0
Georgia,24/02/2004,-1,0,0,0,0,0,0,-1
Georgia,25/02/2004,-1,0,0,0,0,0,0,-1
Georgia,26/02/2004,7,0,0,0,0,0,0,7
Georgia,27/02/2004,6,0,0,0,0,0,0,6
Georgia,28/02/2004,1,0,0,0,3,0,0,4
Georgia,01/03/2004,1,0,0,0,0,0,0,1
Georgia,02/03/2004,6,0,0,0,0,1,0,7
Georgia,03/03/2004,8,0,0,0,0,0,0,8
Georgia,04/03/2004,7,0,0,0,0,0,0,7
Georgia,05/03/2004,2,0,0,0,0,0,0,2
Georgia,06/03/2004,2,0,0,0,0,0,0,2
Georgia,07/03/2004,0,0,0,0,0,0,0,0
Georgia,08/03/2004,-1,0,0,0,0,0,0,-1
Georgia,09/03/2004,3,0,0,0,0,2,0,5
Georgia,10/03/2004,0,0,1,0,0,0,0,1
Georgia,11/03/2004,2,0,0,0,0,0,0,2
Georgia,12/03/2004,2,0,0,0,3,1,0,6
Georgia,13/03/2004,2,0,0,0,0,0,0,2
Georgia,14/03/2004,-1,0,0,0,0,0,0,-1
Georgia,15/03/2004,9,0,0,0,0,1,0,10
Georgia,16/03/2004,3,0,0,0,3,0,0,6
Georgia,17/03/2004,1,0,0,0,0,0,0,1
Georgia,18/03/2004,2,0,0,0,-2,0,0,0
Georgia,19/03/2004,4,0,1,0,0,0,0,5
Georgia,20/03/2004,0,0,-2,0,0,0,0,-2
Georgia,21/03/2004,0,0,0,0,0,0,0,0
Georgia,22/03/2004,3,0,0,0,0,0,0,3
Georgia,23/03/2004,0,0,0,0,0,0,0,0
Georgia,24/03/2004,0,0,0,0,0,0,0,0
Georgia,25/03/2004,2,0,0,0,1,1,0,4
Georgia,26/03/2004,8,0,0,0,0,0,0,8
Georgia,27/03/2004,0,0,0,0,3,0,0,3
Georgia,28/03/2004,3,0,0,0,0,1,0,4
Georgia,29/03/2004,5,0,0,0,0,3,0,8
Georgia,30/03/2004,-1,0,0,0,0,0,0,-1
Georgia,31/03/2004,4,0,0,0,6,1,0,11
Georgia,01/04/2004,4,0,0,0,3,0,0,7
Georgia,02/04/2004,1,0,0,0,0,1,0,2
Georgia,03/04/2004,2,0,0,0,0,0,0,2
Georgia,04/04/2004,0,0,0,0,0,0,0,0
Georgia,05/04/2004,2,2,1,0,6,0,0,11
Georgia,06/04/2004,14,0,0,0,0,0,0,14
Georgia,07/04/2004,0,0,0,0,3,0,0,3
Georgia,08/04/2004,2,0,2,0,-2,2,0,4
Georgia,09/04/2004,4,0,0,0,0,0,0,4
Georgia,10/04/2004,4,0,2,0,0,0,0,6
Georgia,12/04/2004,2,0,0,0,0,1,0,3
Georgia,13/04/2004,6,0,0,0,0,0,0,6
Georgia,14/04/2004,0,0,1,0,3,0,0,4
Georgia,15/04/2004,0,0,0,0,0,0,0,0
Georgia,16/04/2004,0,0,0,0,0,0,0,0
Georgia,17/04/2004,2,0,0,0,0,1,0,3
Georgia,18/04/2004,0,0,0,0,0,0,0,0
Georgia,19/04/2004,3,0,0,0,5,0,0,8
Georgia,20/04/2004,3,0,1,0,3,0,0,7
Georgia,21/04/2004,5,0,0,0,0,3,0,8
Georgia,22/04/2004,7,0,0,0,0,0,0,7
Georgia,23/04/2004,2,0,-4,0,0,0,0,-2
Georgia,24/04/2004,14,0,0,0,3,0,0,17
Georgia,25/04/2004,0,0,0,0,0,0,0,0
Georgia,26/04/2004,2,0,0,0,0,0,0,2
Georgia,27/04/2004,0,0,0,0,3,0,0,3
Georgia,28/04/2004,1,0,0,0,0,0,0,1
Georgia,29/04/2004,1,0,0,0,0,0,0,1
Georgia,30/04/2004,0,0,0,0,0,0,0,0
Georgia,01/05/2004,0,0,0,0,0,0,0,0
Georgia,02/05/2004,5,0,0,0,0,0,0,5
Georgia,03/05/2004,0,0,0,0,0,0,0,0
Georgia,04/05/2004,9,0,-2,0,6,6,0,19
Georgia,05/05/2004,6,0,-6,0,0,2,0,2
Georgia,06/05/2004,11,0,0,0,0,0,0,11
Georgia,07/05/2004,1,0,0,0,0,0,0,1
Georgia,08/05/2004,0,0,0,0,0,1,0,1
Georgia,09/05/2004,0,0,0,0,0,0,0,0
Georgia,10/05/2004,6,0,0,0,0,0,0,6
Georgia,11/05/2004,1,0,0,0,9,0,0,10
Georgia,12/05/2004,8,0,1,0,3,0,0,12
Georgia,13/05/2004,3,0,0,0,0,0,0,3
Georgia,14/05/2004,3,0,0,0,0,0,0,3
Georgia,15/05/2004,2,0,0,0,0,0,0,2
Georgia,16/05/2004,0,0,0,0,0,0,0,0
Georgia,17/05/2004,3,0,0,0,3,0,0,6
Georgia,18/05/2004,2,0,0,0,0,0,0,2
Georgia,19/05/2004,0,0,0,0,0,0,0,0
Georgia,20/05/2004,0,0,0,0,0,0,0,0
Georgia,21/05/2004,-2,0,0,0,0,0,0,-2
Georgia,22/05/2004,0,0,0,0,0,0,0,0
Georgia,24/05/2004,1,0,0,0,9,2,0,12
Georgia,25/05/2004,2,0,0,0,0,1,0,3
Georgia,26/05/2004,3,0,0,0,0,0,0,3
Georgia,27/05/2004,0,0,0,0,0,0,0,0
Georgia,28/05/2004,0,0,0,0,0,0,0,0
Georgia,29/05/2004,0,0,0,0,0,0,0,0
Georgia,30/05/2004,6,0,0,0,0,1,0,7
Georgia,31/05/2004,0,0,0,0,0,0,0,0
Georgia,01/06/2004,0,0,0,0,0,0,0,0
Georgia,02/06/2004,2,0,0,0,0,0,0,2
Georgia,03/06/2004,0,0,0,0,0,0,0,0
Georgia,04/06/2004,4,0,0,0,0,0,0,4
Georgia,05/06/2004,0,0,0,0,0,0,0,0
Georgia,06/06/2004,0,0,0,0,0,0,0,0
Georgia,07/06/2004,6,0,0,0,0,0,0,6
Georgia,08/06/2004,6,0,0,0,0,0,0,6
Georgia,09/06/2004,7,0,0,0,6,0,0,13
Georgia,10/06/2004,17,0,0,0,0,0,0,17
Georgia,11/06/2004,0,0,0,0,0,0,0,0
Georgia,14/06/2004,0,0,0,0,0,1,0,1
Georgia,15/06/2004,2,0,0,0,0,1,0,3
Georgia,16/06/2004,3,0,0,0,0,0,0,3
Georgia,17/06/2004,0,0,0,0,0,0,0,0
Georgia,18/06/2004,6,0,0,0,9,0,0,15
Georgia,19/06/2004,0,0,0,0,0,0,0,0
Georgia,20/06/2004,0,0,0,0,0,0,0,0
Georgia,21/06/2004,2,0,0,0,0,0,0,2
Georgia,22/06/2004,-2,0,0,0,0,0,0,-2
Georgia,23/06/2004,0,0,0,0,0,0,0,0
Georgia,24/06/2004,9,0,0,0,0,0,0,9
Georgia,25/06/2004,0,0,0,0,0,0,0,0
Georgia,26/06/2004,6,0,0,0,0,0,0,6
Georgia,27/06/2004,0,0,0,0,0,0,0,0
Georgia,28/06/2004,0,0,0,0,0,0,0,0
Georgia,29/06/2004,0,0,0,0,0,1,0,1
Georgia,01/07/2004,2,0,0,0,0,0,0,2
Georgia,02/07/2004,2,0,0,0,0,0,0,2
Georgia,05/07/2004,0,0,0,0,0,0,0,0
Georgia,07/07/2004,1,0,0,0,0,0,0,1
Georgia,08/07/2004,0,0,0,0,-2,0,0,-2
Georgia,09/07/2004,2,0,0,0,0,0,0,2
Georgia,10/07/2004,0,0,0,0,0,0,0,0
Georgia,11/07/2004,0,0,0,0,0,0,0,0
Georgia,12/07/2004,3,0,0,0,0,0,0,3
Georgia,13/07/2004,2,0,0,0,0,0,0,2
Georgia,14/07/2004,-1,0,0,0,0,0,0,-1
Georgia,15/07/2004,0,0,0,0,0,0,0,0
Georgia,16/07/2004,-3,0,0,0,0,1,0,-2
Georgia,17/07/2004,-2,0,0,0,0,0,0,-2
Georgia,18/07/2004,0,0,0,0,0,0,0,0
Georgia,19/07/2004,-2,0,0,0,0,0,0,-2
Georgia,20/07/2004,2,0,0,0,3,0,0,5
Georgia,21/07/2004,1,0,0,0,-2,1,0,0
Georgia,26/07/2004,1,0,0,0,0,0,0,1
Georgia,27/07/2004,0,0,0,0,0,0,0,0
Georgia,28/07/2004,4,0,0,0,0,0,0,4
Georgia,29/07/2004,4,0,0,0,0,0,0,4
Georgia,30/07/2004,0,0,0,0,-4,0,0,-4
Georgia,31/07/2004,0,0,0,0,0,0,0,0
Georgia,01/08/2004,0,0,0,0,0,0,0,0
Georgia,02/08/2004,0,0,0,0,0,0,0,0
Georgia,03/08/2004,0,0,0,0,3,0,0,3
Georgia,04/08/2004,0,0,0,0,3,0,0,3
Georgia,05/08/2004,0,0,0,0,0,0,0,0
Georgia,06/08/2004,0,2,0,0,0,0,0,2
Georgia,08/08/2004,0,0,0,0,0,0,0,0
Georgia,09/08/2004,0,0,0,0,0,0,0,0
Georgia,10/08/2004,-2,0,0,0,0,0,0,-2
Georgia,11/08/2004,0,0,0,0,0,0,0,0
Georgia,12/08/2004,0,0,0,0,0,0,0,0
Georgia,13/08/2004,0,0,0,0,0,0,0,0
Georgia,14/08/2004,4,0,0,0,0,0,0,4
Georgia,15/08/2004,0,0,0,0,1,0,0,1
Georgia,16/08/2004,2,0,0,0,0,0,0,2
Georgia,17/08/2004,1,0,0,0,0,0,0,1
Georgia,18/08/2004,0,0,0,0,0,0,0,0
Georgia,19/08/2004,3,0,0,0,0,0,0,3
Georgia,20/08/2004,1,0,0,0,0,0,0,1
Georgia,21/08/2004,0,0,0,0,0,0,0,0
Georgia,23/08/2004,0,0,0,0,0,0,0,0
Georgia,24/08/2004,4,0,0,0,0,0,0,4
Georgia,25/08/2004,2,0,0,0,0,0,0,2
Georgia,26/08/2004,2,0,0,0,0,4,0,6
Georgia,27/08/2004,4,0,0,0,0,0,0,4
Georgia,28/08/2004,0,0,0,0,0,0,0,0
Georgia,31/08/2004,0,0,0,0,3,2,0,5
Georgia,01/09/2004,2,0,-2,0,0,0,0,0
Georgia,02/09/2004,2,0,0,0,0,0,0,2
Georgia,03/09/2004,1,0,0,0,0,0,0,1
Georgia,04/09/2004,0,0,0,0,-1,0,0,-1
Georgia,06/09/2004,4,0,0,0,1,0,0,5
Georgia,07/09/2004,0,0,0,0,0,0,0,0
Georgia,08/09/2004,0,0,1,0,-2,0,0,-1
Georgia,09/09/2004,0,0,0,0,0,0,0,0
Georgia,10/09/2004,0,0,0,0,0,0,0,0
Georgia,11/09/2004,0,0,0,0,0,0,0,0
Georgia,12/09/2004,0,0,0,0,0,0,0,0
Georgia,14/09/2004,0,0,0,0,6,0,0,6
Georgia,15/09/2004,0,0,0,0,0,0,0,0
Georgia,16/09/2004,0,0,0,0,-2,0,0,-2
Georgia,17/09/2004,-1,0,0,0,0,0,0,-1
Georgia,18/09/2004,0,0,0,0,0,0,0,0
Georgia,19/09/2004,0,0,0,0,0,0,0,0
Georgia,20/09/2004,6,0,0,0,0,0,0,6
Georgia,21/09/2004,4,0,0,0,0,0,0,4
Georgia,22/09/2004,0,0,0,0,0,0,0,0
Georgia,23/09/2004,0,0,0,0,0,0,0,0
Georgia,24/09/2004,0,0,0,0,0,0,0,0
Georgia,25/09/2004,0,0,0,0,0,0,0,0
Georgia,26/09/2004,0,0,0,0,0,0,0,0
Georgia,27/09/2004,1,0,0,0,0,0,0,1
Georgia,28/09/2004,2,0,0,0,0,0,0,2
Georgia,29/09/2004,0,0,0,0,-2,0,0,-2
Georgia,30/09/2004,0,0,0,0,0,0,0,0
Georgia,01/10/2004,0,0,0,0,0,0,0,0
Georgia,02/10/2004,0,0,0,0,0,0,0,0
Georgia,03/10/2004,2,0,0,0,0,0,0,2
Georgia,04/10/2004,3,0,0,0,0,0,0,3
Georgia,05/10/2004,0,0,0,0,0,0,0,0
Georgia,06/10/2004,-1,0,0,0,0,0,0,-1
Georgia,07/10/2004,2,0,0,0,0,0,0,2
Georgia,08/10/2004,0,0,-1,0,0,0,0,-1
Georgia,11/10/2004,0,0,0,0,0,0,0,0
Georgia,12/10/2004,4,0,0,0,0,0,0,4
Georgia,13/10/2004,0,0,0,0,6,3,0,9
Georgia,14/10/2004,0,0,-2,0,0,0,0,-2
Georgia,16/10/2004,2,0,0,0,0,0,0,2
Georgia,18/10/2004,2,0,0,0,3,0,0,5
Georgia,19/10/2004,6,0,0,0,-2,0,0,4
Georgia,20/10/2004,0,0,0,0,3,0,0,3
Georgia,21/10/2004,0,0,0,0,0,0,0,0
Georgia,22/10/2004,0,0,0,0,0,0,0,0
Georgia,24/10/2004,0,0,0,0,0,0,0,0
Georgia,25/10/2004,3,0,0,0,3,0,0,6
Georgia,26/10/2004,0,0,0,0,18,0,0,18
Georgia,27/10/2004,0,0,0,0,0,0,0,0
Georgia,28/10/2004,0,2,0,0,0,0,0,2
Georgia,29/10/2004,5,0,0,0,6,1,0,12
Georgia,30/10/2004,3,0,0,0,0,1,0,4
Georgia,31/10/2004,0,0,0,0,0,0,0,0
Georgia,01/11/2004,3,0,0,0,0,0,0,3
Georgia,02/11/2004,2,0,0,0,0,0,0,2
Georgia,03/11/2004,2,0,0,0,3,0,0,5
Georgia,04/11/2004,8,0,-2,0,0,0,0,6
Georgia,08/11/2004,1,0,0,0,0,0,0,1
Georgia,09/11/2004,3,0,0,0,0,0,0,3
Georgia,10/11/2004,8,0,0,0,0,0,0,8
Georgia,11/11/2004,2,0,0,0,12,2,0,16
Georgia,12/11/2004,6,0,0,0,0,0,0,6
Georgia,13/11/2004,3,0,0,0,3,0,0,6
Georgia,14/11/2004,0,0,0,0,0,0,0,0
Georgia,15/11/2004,6,0,0,0,0,0,0,6
Georgia,16/11/2004,0,0,0,0,0,0,0,0
Georgia,17/11/2004,3,0,0,0,0,0,0,3
Georgia,18/11/2004,2,0,0,0,0,0,0,2
Georgia,19/11/2004,0,0,0,0,-2,0,0,-2
Georgia,20/11/2004,0,0,0,0,0,0,0,0
Georgia,22/11/2004,4,0,0,0,0,1,0,5
Georgia,23/11/2004,0,0,0,0,-2,0,0,-2
Georgia,25/11/2004,1,0,0,0,0,0,0,1
Georgia,26/11/2004,0,0,0,0,3,0,0,3
Georgia,30/11/2004,0,0,0,0,0,0,0,0
Georgia,01/12/2004,0,0,0,0,0,0,0,0
Georgia,03/12/2004,2,0,0,0,0,0,0,2
Georgia,05/12/2004,0,0,0,0,0,0,0,0
Georgia,07/12/2004,2,0,0,0,0,0,0,2
Georgia,08/12/2004,0,0,0,0,0,1,0,1
Georgia,09/12/2004,0,0,0,0,0,0,0,0
Georgia,10/12/2004,3,0,0,0,0,3,0,6
Georgia,11/12/2004,0,0,0,0,0,0,0,0
Georgia,12/12/2004,0,0,0,0,0,0,0,0
Georgia,13/12/2004,0,0,0,0,0,0,0,0
Georgia,14/12/2004,0,0,0,0,0,0,0,0
Georgia,15/12/2004,0,0,-1,0,-2,0,0,-3
Georgia,16/12/2004,0,0,0,0,0,0,0,0
Georgia,19/12/2004,0,0,0,0,0,0,0,0
Georgia,20/12/2004,0,0,0,0,0,0,0,0
Georgia,21/12/2004,0,0,0,0,3,0,0,3
Georgia,23/12/2004,0,0,0,0,0,0,0,0
Georgia,24/12/2004,1,0,0,0,3,0,0,4
Georgia,25/12/2004,0,0,0,0,0,0,0,0
Georgia,27/12/2004,0,0,0,0,0,0,0,0
Georgia,29/12/2004,2,0,-2,0,0,0,0,0
Georgia,30/12/2004,0,0,0,0,0,0,0,0
Georgia,31/12/2004,0,0,0,0,0,0,0,0
India,01/01/2004,4,0,0,0,0,0,0,4
India,02/01/2004,2,0,0,0,0,0,0,2
India,03/01/2004,0,0,0,0,-2,4,0,2
India,04/01/2004,9,0,0,0,3,0,0,12
India,05/01/2004,1,0,0,0,6,0,0,7
India,06/01/2004,1,0,0,0,0,0,0,1
India,07/01/2004,8,0,0,0,-2,0,0,6
India,08/01/2004,13,0,0,0,0,0,0,13
India,09/01/2004,8,0,0,0,3,2,0,13
India,10/01/2004,2,0,0,0,0,0,0,2
India,11/01/2004,11,0,0,0,0,0,0,11
India,12/01/2004,2,0,0,0,9,2,0,13
India,13/01/2004,1,0,1,0,0,0,0,2
India,14/01/2004,3,0,2,0,0,0,0,5
India,15/01/2004,18,0,0,0,3,6,0,27
India,16/01/2004,11,0,0,0,0,0,0,11
India,17/01/2004,2,0,1,0,0,0,0,3
India,18/01/2004,4,0,0,0,0,0,0,4
India,19/01/2004,-3,0,0,0,6,0,0,3
India,20/01/2004,0,0,0,0,1,0,0,1
India,21/01/2004,-1,0,0,0,4,1,0,4
India,22/01/2004,4,0,0,0,0,0,0,4
India,23/01/2004,-2,0,0,0,0,0,0,-2
India,24/01/2004,1,0,0,0,3,0,0,4
India,25/01/2004,6,0,0,0,3,1,0,10
India,26/01/2004,4,0,0,0,3,0,0,7
India,27/01/2004,0,0,0,0,0,0,0,0
India,28/01/2004,3,0,0,0,0,1,0,4
India,29/01/2004,11,0,0,0,0,0,0,11
India,30/01/2004,2,0,0,0,1,0,0,3
India,31/01/2004,4,0,0,0,7,0,0,11
India,01/02/2004,0,0,0,0,0,0,0,0
India,02/02/2004,4,0,0,0,3,1,0,8
India,03/02/2004,5,0,0,0,-2,1,0,4
India,04/02/2004,8,0,0,0,4,0,0,12
India,05/02/2004,0,0,0,0,0,0,0,0
India,06/02/2004,5,0,0,0,6,0,0,11
India,07/02/2004,5,0,0,0,3,0,0,8
India,08/02/2004,-3,0,0,0,0,1,0,-2
India,09/02/2004,15,0,0,0,0,1,0,16
India,10/02/2004,0,0,0,0,-2,0,0,-2
India,11/02/2004,4,0,0,0,3,0,0,7
India,12/02/2004,10,0,0,0,3,0,0,13
India,13/02/2004,3,0,0,0,0,0,0,3
India,14/02/2004,3,0,0,0,0,0,0,3
India,15/02/2004,3,0,0,0,0,0,0,3
India,16/02/2004,2,0,0,0,0,0,0,2
India,17/02/2004,5,0,1,0,0,2,0,8
India,18/02/2004,6,0,0,0,0,0,0,6
India,19/02/2004,12,0,0,0,0,4,0,16
India,20/02/2004,2,0,0,0,0,0,0,2
India,21/02/2004,1,0,0,0,0,0,0,1
India,22/02/2004,0,0,0,0,0,1,0,1
India,23/02/2004,0,0,0,0,0,0,0,0
India,24/02/2004,3,0,0,0,0,0,0,3
India,25/02/2004,1,0,0,0,0,0,0,1
India,26/02/2004,6,0,0,0,0,0,0,6
India,27/02/2004,4,0,0,0,1,0,0,5
India,28/02/2004,0,0,0,0,0,0,0,0
India,29/02/2004,2,0,0,0,-4,1,0,-1
India,01/03/2004,10,0,0,0,-10,0,0,0
India,02/03/2004,5,4,0,0,3,1,0,13
India,03/03/2004,29,0,1,0,-4,6,0,32
India,04/03/2004,0,0,0,0,3,0,0,3
India,05/03/2004,9,4,0,0,0,10,0,23
India,06/03/2004,1,0,0,0,9,1,0,11
India,07/03/2004,1,0,0,0,0,0,0,1
India,08/03/2004,-2,0,0,0,0,0,0,-2
India,09/03/2004,25,0,0,0,0,4,0,29
India,10/03/2004,6,0,0,0,0,0,0,6
India,11/03/2004,7,0,0,0,0,0,0,7
India,12/03/2004,0,0,0,0,-2,0,0,-2
India,13/03/2004,0,0,0,0,0,0,0,0
India,14/03/2004,0,0,0,0,0,0,0,0
India,15/03/2004,4,0,0,0,0,0,0,4
India,16/03/2004,3,0,0,0,0,0,0,3
India,17/03/2004,2,0,0,0,0,0,0,2
India,18/03/2004,6,0,0,0,0,0,0,6
India,19/03/2004,5,0,1,0,-2,0,0,4
India,20/03/2004,-2,0,0,0,0,2,0,0
India,21/03/2004,3,0,0,0,1,0,0,4
India,22/03/2004,0,0,0,0,0,2,0,2
India,23/03/2004,19,0,0,0,0,0,0,19
India,24/03/2004,13,0,0,0,3,0,0,16
India,25/03/2004,2,0,0,0,0,0,0,2
India,27/03/2004,8,0,0,0,3,0,0,11
India,28/03/2004,0,0,0,0,0,0,0,0
India,29/03/2004,2,0,1,0,3,0,0,6
India,30/03/2004,2,0,0,0,-2,0,0,0
India,31/03/2004,3,0,0,0,3,0,0,6
India,01/04/2004,4,0,-2,0,0,0,0,2
India,02/04/2004,1,0,0,0,0,0,0,1
India,03/04/2004,2,0,0,0,0,1,0,3
India,04/04/2004,12,0,0,0,6,6,0,24
India,05/04/2004,1,0,0,0,0,3,0,4
India,06/04/2004,1,0,0,0,0,0,0,1
India,07/04/2004,9,0,0,0,0,0,0,9
India,08/04/2004,13,0,0,0,7,4,0,24
India,09/04/2004,0,0,0,0,3,0,0,3
India,10/04/2004,0,0,0,0,0,2,0,2
India,11/04/2004,16,0,0,0,6,0,0,22
India,12/04/2004,4,0,0,0,3,1,0,8
India,13/04/2004,7,0,0,0,0,0,0,7
India,14/04/2004,0,0,0,0,0,3,0,3
India,15/04/2004,8,0,0,0,-4,0,0,4
India,16/04/2004,2,0,0,0,6,4,0,12
India,17/04/2004,4,0,0,0,0,0,0,4
India,18/04/2004,20,0,0,0,0,0,0,20
India,19/04/2004,3,0,0,0,-6,0,0,-3
India,20/04/2004,11,0,0,0,3,1,0,15
India,21/04/2004,2,0,0,0,0,0,0,2
India,22/04/2004,4,0,0,0,0,0,0,4
India,23/04/2004,9,0,0,0,0,2,0,11
India,24/04/2004,4,0,0,0,0,0,0,4
India,25/04/2004,0,0,0,0,0,2,0,2
India,26/04/2004,3,0,0,0,0,1,0,4
India,27/04/2004,17,0,0,0,6,0,0,23
India,28/04/2004,-1,0,-2,0,0,0,0,-3
India,29/04/2004,16,0,0,0,1,5,0,22
India,30/04/2004,0,0,0,0,1,0,0,1
India,01/05/2004,0,0,0,0,0,0,0,0
India,02/05/2004,2,0,0,0,0,1,0,3
India,03/05/2004,1,0,0,0,3,1,0,5
India,04/05/2004,10,0,0,0,0,0,0,10
India,05/05/2004,2,0,0,0,4,6,0,12
India,06/05/2004,9,2,0,0,0,0,0,11
India,07/05/2004,1,0,0,0,3,0,0,4
India,08/05/2004,-1,0,0,0,0,0,0,-1
India,09/05/2004,0,0,0,0,0,0,0,0
India,10/05/2004,-1,0,0,0,0,5,0,4
India,11/05/2004,9,0,0,0,11,1,0,21
India,12/05/2004,7,0,0,0,-2,1,0,6
India,13/05/2004,11,0,-2,0,3,0,0,12
India,14/05/2004,3,0,-6,0,-2,0,0,-5
India,15/05/2004,9,0,0,0,-2,0,0,7
India,16/05/2004,4,0,-2,0,0,0,0,2
India,17/05/2004,8,2,0,0,0,0,0,10
India,18/05/2004,10,0,0,0,0,0,0,10
India,19/05/2004,18,0,-4,0,3,1,0,18
India,20/05/2004,6,0,-1,0,3,3,0,11
India,21/05/2004,9,0,-2,0,3,0,0,10
India,22/05/2004,5,0,0,0,0,0,0,5
India,23/05/2004,5,0,-1,0,0,0,0,4
India,24/05/2004,4,0,-2,0,0,0,0,2
India,25/05/2004,0,0,0,0,0,0,0,0
India,26/05/2004,3,0,0,0,-6,0,0,-3
India,27/05/2004,6,0,0,0,-4,0,0,2
India,28/05/2004,1,0,0,0,0,0,0,1
India,29/05/2004,17,0,0,0,0,0,0,17
India,30/05/2004,3,0,0,0,-2,0,0,1
India,31/05/2004,3,0,0,0,2,0,0,5
India,01/06/2004,7,0,0,0,-2,0,0,5
India,02/06/2004,9,0,0,0,0,0,0,9
India,03/06/2004,3,0,0,0,0,0,0,3
India,04/06/2004,4,8,0,0,1,0,0,13
India,05/06/2004,1,0,0,0,0,1,0,2
India,06/06/2004,2,0,0,0,1,0,0,3
India,07/06/2004,1,0,0,0,2,0,0,3
India,08/06/2004,5,0,0,0,0,1,0,6
India,09/06/2004,6,0,0,0,-2,0,0,4
India,10/06/2004,37,0,0,0,-4,0,0,33
India,11/06/2004,0,0,0,0,0,0,0,0
India,12/06/2004,4,0,0,0,12,0,0,16
India,13/06/2004,7,0,0,0,6,0,0,13
India,14/06/2004,10,0,0,0,0,0,0,10
India,15/06/2004,7,0,0,0,0,1,0,8
India,16/06/2004,8,0,0,0,7,2,0,17
India,17/06/2004,6,0,0,0,3,1,0,10
India,18/06/2004,-1,0,0,0,0,0,0,-1
India,19/06/2004,1,0,0,0,4,0,0,5
India,20/06/2004,3,0,0,0,0,0,0,3
India,21/06/2004,-1,0,0,0,6,0,0,5
India,22/06/2004,7,0,0,0,3,-2,0,8
India,23/06/2004,12,0,0,0,0,0,0,12
India,24/06/2004,20,0,0,0,0,1,0,21
India,25/06/2004,2,0,0,0,0,2,0,4
India,26/06/2004,17,0,-8,0,0,0,0,9
India,27/06/2004,9,0,0,0,0,0,0,9
India,28/06/2004,2,0,0,0,0,1,0,3
India,29/06/2004,7,0,0,0,-2,4,0,9
India,30/06/2004,5,0,0,0,1,0,0,6
India,01/07/2004,-1,0,0,0,0,0,0,-1
India,02/07/2004,-1,0,0,0,0,3,0,2
India,03/07/2004,0,0,0,0,0,0,0,0
India,04/07/2004,-3,0,0,0,0,0,0,-3
India,05/07/2004,10,0,0,0,0,0,0,10
India,06/07/2004,5,0,0,0,0,0,0,5
India,07/07/2004,0,0,0,0,0,6,0,6
India,08/07/2004,0,0,0,0,0,2,0,2
India,09/07/2004,2,0,0,0,0,0,0,2
India,10/07/2004,5,0,0,0,0,0,0,5
India,11/07/2004,0,0,0,0,0,2,0,2
India,12/07/2004,4,0,0,0,-4,0,0,0
India,13/07/2004,6,0,0,0,0,0,0,6
India,14/07/2004,2,0,0,0,0,0,0,2
India,15/07/2004,0,0,0,0,0,1,0,1
India,16/07/2004,9,0,0,0,0,3,0,12
India,17/07/2004,3,0,0,0,1,0,0,4
India,18/07/2004,0,0,0,0,0,0,0,0
India,19/07/2004,5,0,0,0,3,0,0,8
India,20/07/2004,12,0,0,0,0,0,0,12
India,21/07/2004,5,4,0,0,0,0,0,9
India,22/07/2004,3,0,0,0,1,0,0,4
India,23/07/2004,-5,0,0,0,2,0,0,-3
India,24/07/2004,0,0,0,0,6,1,0,7
India,25/07/2004,4,0,0,0,0,0,0,4
India,26/07/2004,1,0,0,0,8,0,0,9
India,27/07/2004,0,0,0,0,0,0,0,0
India,28/07/2004,7,0,0,0,4,2,0,13
India,29/07/2004,0,0,0,0,-1,0,0,-1
India,30/07/2004,1,0,0,0,1,1,0,3
India,31/07/2004,0,0,0,0,-1,0,0,-1
India,01/08/2004,1,0,0,0,2,0,0,3
India,02/08/2004,2,0,0,0,0,0,0,2
India,03/08/2004,2,0,0,0,0,0,0,2
India,04/08/2004,1,0,0,0,3,0,0,4
India,05/08/2004,6,0,0,0,0,0,0,6
India,07/08/2004,2,0,0,0,0,2,0,4
India,08/08/2004,0,0,0,0,0,0,0,0
India,09/08/2004,1,0,0,0,31,0,0,32
India,10/08/2004,2,0,0,0,0,0,0,2
India,11/08/2004,1,0,0,0,0,0,0,1
India,12/08/2004,0,0,0,0,9,0,0,9
India,13/08/2004,3,0,-2,0,-2,0,0,-1
India,14/08/2004,7,0,0,0,-1,0,0,6
India,15/08/2004,0,0,0,0,0,0,0,0
India,16/08/2004,0,0,0,0,-2,0,0,-2
India,17/08/2004,0,0,0,0,-2,1,0,-1
India,18/08/2004,6,0,0,0,0,2,0,8
India,19/08/2004,4,0,0,0,0,0,0,4
India,20/08/2004,4,0,0,0,0,0,0,4
India,21/08/2004,0,0,0,0,0,0,0,0
India,22/08/2004,6,0,0,0,0,0,0,6
India,23/08/2004,-2,0,0,0,0,2,0,0
India,24/08/2004,10,0,0,0,0,0,0,10
India,25/08/2004,2,0,0,0,0,0,0,2
India,26/08/2004,-2,0,0,0,0,0,0,-2
India,27/08/2004,4,0,0,0,1,0,0,5
India,28/08/2004,-2,0,0,0,0,3,0,1
India,29/08/2004,0,0,0,0,0,0,0,0
India,30/08/2004,8,0,0,0,3,0,0,11
India,31/08/2004,2,0,0,0,-1,2,0,3
India,01/09/2004,3,0,0,0,-3,0,0,0
India,02/09/2004,5,0,0,0,-4,2,0,3
India,03/09/2004,4,0,2,0,-2,0,0,4
India,04/09/2004,0,0,0,0,-2,0,0,-2
India,05/09/2004,4,0,0,0,-2,0,0,2
India,06/09/2004,1,0,0,0,3,0,0,4
India,07/09/2004,5,0,0,0,0,0,0,5
India,08/09/2004,1,0,0,0,0,0,0,1
India,09/09/2004,11,0,0,0,0,0,0,11
India,10/09/2004,4,2,1,0,0,3,0,10
India,11/09/2004,0,0,0,0,0,0,0,0
India,12/09/2004,14,0,0,0,0,1,0,15
India,13/09/2004,12,0,0,0,0,2,0,14
India,14/09/2004,4,0,0,0,-2,0,0,2
India,15/09/2004,-2,0,0,0,3,0,0,1
India,16/09/2004,10,0,0,0,0,0,0,10
India,17/09/2004,1,0,0,0,0,0,0,1
India,18/09/2004,3,0,0,0,6,0,0,9
India,19/09/2004,4,0,-1,0,0,0,0,3
India,20/09/2004,8,0,0,0,0,0,0,8
India,21/09/2004,0,0,-2,0,0,0,0,-2
India,22/09/2004,0,0,0,0,4,0,0,4
India,23/09/2004,-3,0,0,0,-1,0,0,-4
India,24/09/2004,0,0,-2,0,1,0,0,-1
India,25/09/2004,2,0,0,0,15,1,0,18
India,26/09/2004,1,0,0,0,0,0,0,1
India,27/09/2004,8,0,0,0,0,0,0,8
India,28/09/2004,3,0,0,0,0,0,0,3
India,29/09/2004,-1,0,0,0,0,0,0,-1
India,30/09/2004,7,0,0,0,3,0,0,10
India,01/10/2004,0,0,0,0,0,4,0,4
India,02/10/2004,0,0,0,0,0,0,0,0
India,03/10/2004,1,0,0,0,0,0,0,1
India,04/10/2004,8,0,0,0,0,0,0,8
India,05/10/2004,0,0,0,0,0,0,0,0
India,06/10/2004,2,0,0,0,6,0,0,8
India,07/10/2004,7,0,0,0,0,0,0,7
India,08/10/2004,2,0,0,0,0,0,0,2
India,09/10/2004,2,0,0,0,1,0,0,3
India,10/10/2004,1,0,0,0,-2,0,0,-1
India,11/10/2004,5,0,0,0,0,0,0,5
India,12/10/2004,1,0,0,0,0,0,0,1
India,13/10/2004,2,0,0,0,0,0,0,2
India,14/10/2004,5,0,0,0,3,0,0,8
India,15/10/2004,0,0,0,0,0,0,0,0
India,16/10/2004,0,0,0,0,0,2,0,2
India,17/10/2004,0,2,0,0,0,0,0,2
India,18/10/2004,0,0,0,0,0,0,0,0
India,19/10/2004,7,0,-4,0,-1,0,0,2
India,20/10/2004,10,0,0,0,0,0,0,10
India,21/10/2004,6,0,0,0,3,2,0,11
India,22/10/2004,12,0,0,0,0,0,0,12
India,23/10/2004,-1,0,0,0,0,0,0,-1
India,24/10/2004,24,0,0,0,-2,0,0,22
India,25/10/2004,7,0,0,0,0,0,0,7
India,26/10/2004,7,0,0,0,0,0,0,7
India,27/10/2004,2,0,0,0,0,0,0,2
India,28/10/2004,9,0,0,0,5,0,0,14
India,29/10/2004,0,0,0,0,9,0,0,9
India,30/10/2004,2,0,0,0,6,0,0,8
India,31/10/2004,4,0,0,0,0,0,0,4
India,01/11/2004,3,0,0,0,6,1,0,10
India,02/11/2004,9,0,0,0,-4,1,0,6
India,03/11/2004,2,0,0,0,0,0,0,2
India,04/11/2004,18,0,0,0,4,0,0,22
India,05/11/2004,2,0,0,0,-2,1,0,1
India,06/11/2004,0,0,0,0,3,0,0,3
India,07/11/2004,8,0,0,0,0,4,0,12
India,08/11/2004,4,0,0,0,6,3,0,13
India,09/11/2004,5,0,0,0,3,4,0,12
India,10/11/2004,-2,0,0,0,0,1,0,-1
India,11/11/2004,11,0,-1,0,0,6,0,16
India,12/11/2004,8,0,0,0,-1,0,0,7
India,13/11/2004,1,0,0,0,0,0,0,1
India,14/11/2004,0,0,0,0,0,0,0,0
India,15/11/2004,8,0,-8,0,0,0,0,0
India,16/11/2004,7,0,0,0,0,0,0,7
India,17/11/2004,7,2,0,0,0,0,0,9
India,18/11/2004,8,0,0,0,0,0,0,8
India,19/11/2004,2,0,0,0,6,0,0,8
India,20/11/2004,3,0,0,0,0,0,0,3
India,21/11/2004,18,0,0,0,3,0,0,21
India,22/11/2004,3,0,0,0,6,0,0,9
India,23/11/2004,0,0,0,0,0,0,0,0
India,24/11/2004,0,0,0,0,0,0,0,0
India,25/11/2004,16,0,0,0,0,1,0,17
India,26/11/2004,2,0,0,0,-2,3,0,3
India,27/11/2004,10,0,0,0,-4,0,0,6
India,28/11/2004,14,0,1,0,0,1,0,16
India,29/11/2004,14,0,0,0,-3,3,0,14
India,30/11/2004,21,0,0,0,3,0,0,24
India,01/12/2004,3,0,0,0,6,0,0,9
India,02/12/2004,1,0,0,0,0,1,0,2
India,03/12/2004,1,0,0,0,6,0,0,7
India,04/12/2004,7,0,0,0,-2,0,0,5
India,05/12/2004,1,0,-1,0,0,0,0,0
India,06/12/2004,5,0,0,0,0,0,0,5
India,07/12/2004,12,0,0,0,1,1,0,14
India,08/12/2004,10,0,0,0,0,0,0,10
India,09/12/2004,15,0,0,0,0,0,0,15
India,10/12/2004,17,0,0,0,3,2,0,22
India,11/12/2004,8,0,0,0,0,1,0,9
India,12/12/2004,0,0,0,0,0,0,0,0
India,13/12/2004,1,2,0,0,0,0,0,3
India,14/12/2004,9,0,0,0,0,0,0,9
India,15/12/2004,4,0,1,0,3,2,0,10
India,16/12/2004,9,0,0,0,7,0,0,16
India,17/12/2004,4,0,0,0,3,0,0,7
India,18/12/2004,0,0,0,0,0,-2,0,-2
India,19/12/2004,1,0,0,0,0,1,0,2
India,20/12/2004,6,0,0,0,3,0,0,9
India,21/12/2004,4,2,-4,0,0,0,0,2
India,22/12/2004,0,0,0,0,0,0,0,0
India,23/12/2004,5,0,0,0,0,0,0,5
India,24/12/2004,-3,0,0,0,0,0,0,-3
India,25/12/2004,8,0,0,0,0,0,0,8
India,26/12/2004,7,0,0,0,3,0,0,10
India,27/12/2004,3,2,0,0,0,0,0,5
India,28/12/2004,19,4,0,0,0,3,0,26
India,29/12/2004,4,0,0,0,-2,1,0,3
India,30/12/2004,1,0,0,0,1,0,0,2
India,31/12/2004,32,0,0,0,0,3,0,35
Iran,01/01/2004,3,0,0,0,0,0,0,3
Iran,02/01/2004,6,0,0,0,7,0,0,13
Iran,03/01/2004,21,0,0,0,13,0,0,34
Iran,04/01/2004,4,0,0,0,1,0,0,5
Iran,05/01/2004,20,2,-1,0,30,5,0,56
Iran,06/01/2004,10,4,0,0,-4,5,0,15
Iran,07/01/2004,19,0,0,0,25,5,0,49
Iran,08/01/2004,7,6,-2,0,0,0,0,11
Iran,09/01/2004,17,0,1,0,15,1,0,34
Iran,10/01/2004,19,0,0,0,6,0,0,25
Iran,11/01/2004,17,0,1,0,-1,1,0,18
Iran,12/01/2004,11,0,0,0,0,1,0,12
Iran,13/01/2004,28,4,2,0,-5,2,0,31
Iran,14/01/2004,16,2,-2,0,21,4,0,41
Iran,15/01/2004,27,0,0,0,15,5,0,47
Iran,16/01/2004,4,0,0,0,3,0,0,7
Iran,17/01/2004,11,0,-4,0,13,3,0,23
Iran,18/01/2004,13,0,0,0,3,0,0,16
Iran,19/01/2004,6,0,0,0,13,2,0,21
Iran,20/01/2004,15,0,0,0,28,5,0,48
Iran,21/01/2004,51,0,-1,0,3,2,0,55
Iran,22/01/2004,42,0,1,0,12,2,0,57
Iran,23/01/2004,16,4,1,0,13,7,0,41
Iran,24/01/2004,5,0,-3,0,3,3,0,8
Iran,25/01/2004,11,0,0,0,11,0,0,22
Iran,26/01/2004,12,0,0,0,26,4,0,42
Iran,27/01/2004,65,0,0,0,-2,20,0,83
Iran,28/01/2004,20,0,-2,0,16,4,0,38
Iran,29/01/2004,22,0,1,0,4,3,0,30
Iran,30/01/2004,5,0,0,0,-1,0,0,4
Iran,31/01/2004,20,0,-3,0,9,5,0,31
Iran,01/02/2004,52,0,-2,0,3,3,0,56
Iran,02/02/2004,8,0,0,0,9,2,0,19
Iran,03/02/2004,21,2,0,0,24,2,0,49
Iran,04/02/2004,22,0,-4,0,9,1,0,28
Iran,05/02/2004,13,0,0,0,25,0,0,38
Iran,06/02/2004,2,0,0,0,3,4,0,9
Iran,07/02/2004,15,0,0,0,2,1,0,18
Iran,08/02/2004,27,0,-2,0,1,0,0,26
Iran,09/02/2004,3,0,0,0,1,3,0,7
Iran,10/02/2004,13,0,0,0,0,0,0,13
Iran,11/02/2004,8,2,0,0,7,0,0,17
Iran,12/02/2004,13,0,-1,0,2,0,0,14
Iran,13/02/2004,27,0,2,0,-2,2,0,29
Iran,14/02/2004,21,0,3,0,15,4,0,43
Iran,15/02/2004,27,0,0,0,2,0,0,29
Iran,16/02/2004,15,0,3,0,10,0,0,28
Iran,17/02/2004,23,0,-4,0,-1,1,0,19
Iran,18/02/2004,13,0,0,0,15,0,0,28
Iran,19/02/2004,23,0,-1,0,4,4,0,30
Iran,20/02/2004,2,0,0,0,6,2,0,10
Iran,21/02/2004,8,0,0,0,0,2,0,10
Iran,22/02/2004,3,0,-3,0,3,10,0,13
Iran,23/02/2004,19,2,-1,0,1,5,0,26
Iran,24/02/2004,18,0,0,0,-1,1,0,18
Iran,25/02/2004,30,0,0,0,-4,1,0,27
Iran,26/02/2004,14,0,0,0,1,8,0,23
Iran,27/02/2004,-1,0,-4,0,24,0,0,19
Iran,28/02/2004,12,0,0,0,12,0,0,24
Iran,29/02/2004,0,0,1,0,-1,1,0,1
Iran,01/03/2004,10,0,0,0,0,0,0,10
Iran,02/03/2004,65,0,0,0,13,24,0,102
Iran,03/03/2004,59,0,0,0,12,7,0,78
Iran,04/03/2004,14,0,0,0,12,3,0,29
Iran,05/03/2004,4,0,0,0,0,0,0,4
Iran,06/03/2004,6,0,0,0,0,2,0,8
Iran,07/03/2004,17,0,0,0,9,3,0,29
Iran,08/03/2004,22,0,0,0,4,1,0,27
Iran,09/03/2004,1,0,-1,0,6,1,0,7
Iran,10/03/2004,28,0,-9,0,1,0,0,20
Iran,11/03/2004,25,0,0,0,8,0,0,33
Iran,12/03/2004,-1,0,0,0,-1,4,0,2
Iran,13/03/2004,17,0,-2,0,0,0,0,15
Iran,14/03/2004,7,0,0,0,4,1,0,12
Iran,15/03/2004,10,2,0,0,4,0,0,16
Iran,16/03/2004,13,0,0,0,3,0,0,16
Iran,17/03/2004,11,0,0,0,3,3,0,17
Iran,18/03/2004,17,0,0,0,1,0,0,18
Iran,19/03/2004,7,0,0,0,0,2,0,9
Iran,20/03/2004,-1,0,0,0,4,1,0,4
Iran,21/03/2004,9,0,0,0,6,1,0,16
Iran,22/03/2004,15,0,0,0,-8,3,0,10
Iran,23/03/2004,8,0,0,0,-1,0,0,7
Iran,24/03/2004,6,0,0,0,0,8,0,14
Iran,25/03/2004,12,0,0,0,0,0,0,12
Iran,26/03/2004,-2,0,0,0,-4,2,0,-4
Iran,27/03/2004,15,0,0,0,0,0,0,15
Iran,28/03/2004,-3,0,0,0,0,0,0,-3
Iran,29/03/2004,-1,0,0,0,0,4,0,3
Iran,30/03/2004,6,0,0,0,0,0,0,6
Iran,31/03/2004,3,0,0,0,0,0,0,3
Iran,01/04/2004,13,0,-1,0,12,1,0,25
Iran,02/04/2004,0,0,0,0,6,0,0,6
Iran,03/04/2004,10,0,0,0,8,1,0,19
Iran,04/04/2004,4,0,0,0,9,2,0,15
Iran,05/04/2004,16,0,0,0,-4,0,0,12
Iran,06/04/2004,12,0,0,0,18,0,0,30
Iran,07/04/2004,59,0,-2,0,13,0,0,70
Iran,08/04/2004,12,0,-6,0,-2,0,0,4
Iran,09/04/2004,38,0,0,0,6,4,0,48
Iran,10/04/2004,17,0,-2,0,18,1,0,34
Iran,11/04/2004,-4,0,0,0,-3,0,0,-7
Iran,12/04/2004,11,0,-4,0,1,0,0,8
Iran,13/04/2004,0,0,0,0,3,0,0,3
Iran,14/04/2004,4,0,0,0,-5,1,0,0
Iran,15/04/2004,45,2,-4,0,3,0,0,46
Iran,16/04/2004,17,0,0,0,6,0,0,23
Iran,17/04/2004,10,0,0,0,-2,0,0,8
Iran,18/04/2004,16,0,-2,0,2,0,0,16
Iran,19/04/2004,15,0,-4,0,0,0,0,11
Iran,20/04/2004,6,0,0,0,18,2,0,26
Iran,21/04/2004,3,2,0,0,0,3,0,8
Iran,22/04/2004,44,0,0,0,14,0,0,58
Iran,23/04/2004,5,0,0,0,-4,2,0,3
Iran,24/04/2004,6,0,0,0,9,2,0,17
Iran,25/04/2004,15,0,1,0,-2,1,0,15
Iran,26/04/2004,14,0,0,0,3,0,0,17
Iran,27/04/2004,33,0,0,0,4,2,0,39
Iran,28/04/2004,13,0,0,0,7,2,0,22
Iran,29/04/2004,16,0,0,0,0,0,0,16
Iran,30/04/2004,8,0,0,0,1,3,0,12
Iran,01/05/2004,0,0,0,0,0,0,0,0
Iran,02/05/2004,11,0,0,0,-2,0,0,9
Iran,03/05/2004,11,0,0,0,0,2,0,13
Iran,04/05/2004,6,0,0,0,6,2,0,14
Iran,05/05/2004,31,0,0,0,6,0,0,37
Iran,06/05/2004,19,0,0,0,13,2,0,34
Iran,07/05/2004,3,0,0,0,-1,0,0,2
Iran,08/05/2004,13,0,0,0,-16,1,0,-2
Iran,09/05/2004,5,0,0,0,-2,0,0,3
Iran,10/05/2004,10,0,1,0,6,0,0,17
Iran,11/05/2004,14,0,0,0,0,0,0,14
Iran,12/05/2004,26,0,0,0,-1,7,0,32
Iran,13/05/2004,4,0,3,0,10,0,0,17
Iran,14/05/2004,30,0,0,0,0,4,0,34
Iran,15/05/2004,3,0,1,0,0,3,0,7
Iran,16/05/2004,9,2,0,0,3,0,0,14
Iran,17/05/2004,8,0,0,0,1,2,0,11
Iran,18/05/2004,12,0,2,0,15,0,0,29
Iran,19/05/2004,6,0,0,0,6,0,0,12
Iran,20/05/2004,5,0,1,0,10,0,0,16
Iran,21/05/2004,30,0,0,0,6,8,0,44
Iran,22/05/2004,14,0,0,0,-2,9,0,21
Iran,23/05/2004,4,0,0,0,0,2,0,6
Iran,24/05/2004,3,0,0,0,0,0,0,3
Iran,25/05/2004,11,0,1,0,-8,0,0,4
Iran,26/05/2004,12,0,0,0,0,0,0,12
Iran,27/05/2004,31,0,1,0,1,2,0,35
Iran,28/05/2004,9,0,0,0,12,1,0,22
Iran,29/05/2004,16,0,0,0,0,0,0,16
Iran,30/05/2004,12,0,0,0,13,0,0,25
Iran,31/05/2004,17,0,0,0,0,4,0,21
Iran,01/06/2004,16,0,0,0,3,0,0,19
Iran,02/06/2004,14,0,0,0,0,4,0,18
Iran,03/06/2004,3,0,0,0,1,1,0,5
Iran,04/06/2004,-2,0,0,0,-2,0,0,-4
Iran,05/06/2004,0,0,0,0,0,0,0,0
Iran,06/06/2004,6,0,0,0,3,1,0,10
Iran,07/06/2004,6,0,0,0,15,2,0,23
Iran,08/06/2004,6,0,0,0,-4,2,0,4
Iran,09/06/2004,4,0,0,0,-2,0,0,2
Iran,10/06/2004,6,0,2,0,3,0,0,11
Iran,11/06/2004,5,0,0,0,0,0,0,5
Iran,12/06/2004,8,0,0,0,0,0,0,8
Iran,13/06/2004,11,0,0,0,3,0,0,14
Iran,14/06/2004,18,0,0,0,-10,0,0,8
Iran,15/06/2004,19,0,1,0,-5,0,0,15
Iran,16/06/2004,20,0,0,0,5,7,0,32
Iran,17/06/2004,7,0,0,0,4,3,0,14
Iran,18/06/2004,6,0,0,0,0,4,0,10
Iran,19/06/2004,8,0,0,0,18,4,0,30
Iran,20/06/2004,12,0,-4,0,3,3,0,14
Iran,21/06/2004,10,0,0,0,3,0,0,13
Iran,22/06/2004,9,0,0,0,28,0,0,37
Iran,23/06/2004,14,0,1,0,6,4,0,25
Iran,24/06/2004,19,0,0,0,-2,0,0,17
Iran,25/06/2004,8,2,0,0,0,0,0,10
Iran,26/06/2004,8,0,0,0,6,0,0,14
Iran,27/06/2004,20,0,0,0,6,2,0,28
Iran,28/06/2004,29,0,0,0,12,0,0,41
Iran,29/06/2004,13,0,0,0,-3,0,0,10
Iran,30/06/2004,6,0,1,0,1,2,0,10
Iran,01/07/2004,14,0,0,0,6,1,0,21
Iran,02/07/2004,15,0,0,0,3,0,0,18
Iran,03/07/2004,9,0,0,0,2,0,0,11
Iran,04/07/2004,5,0,0,0,0,0,0,5
Iran,05/07/2004,14,0,0,0,15,5,0,34
Iran,06/07/2004,8,0,0,0,3,1,0,12
Iran,07/07/2004,6,0,0,0,1,3,0,10
Iran,08/07/2004,15,0,0,0,7,0,0,22
Iran,09/07/2004,12,0,0,0,12,0,0,24
Iran,10/07/2004,1,0,0,0,3,0,0,4
Iran,11/07/2004,5,0,1,0,3,2,0,11
Iran,12/07/2004,7,0,0,0,0,4,0,11
Iran,13/07/2004,2,0,0,0,0,2,0,4
Iran,14/07/2004,25,0,0,0,0,0,0,25
Iran,15/07/2004,0,0,0,0,15,0,0,15
Iran,16/07/2004,2,0,0,0,0,0,0,2
Iran,17/07/2004,19,0,0,0,3,4,0,26
Iran,18/07/2004,8,0,0,0,5,1,0,14
Iran,19/07/2004,17,0,0,0,12,2,0,31
Iran,20/07/2004,17,0,0,0,3,2,0,22
Iran,21/07/2004,13,0,0,0,12,0,0,25
Iran,22/07/2004,14,0,0,0,5,0,0,19
Iran,23/07/2004,8,0,0,0,1,0,0,9
Iran,24/07/2004,4,0,0,0,9,0,0,13
Iran,25/07/2004,12,0,0,0,0,0,0,12
Iran,26/07/2004,18,0,0,0,-2,0,0,16
Iran,27/07/2004,3,0,3,0,6,0,0,12
Iran,28/07/2004,18,0,0,0,4,0,0,22
Iran,29/07/2004,14,0,0,0,9,4,0,27
Iran,30/07/2004,0,0,0,0,3,0,0,3
Iran,31/07/2004,6,0,0,0,0,1,0,7
Iran,01/08/2004,-3,0,0,0,0,2,0,-1
Iran,02/08/2004,0,0,0,0,0,0,0,0
Iran,03/08/2004,9,0,0,0,0,0,0,9
Iran,04/08/2004,9,0,0,0,12,0,0,21
Iran,05/08/2004,-3,0,0,0,3,0,0,0
Iran,06/08/2004,18,0,0,0,0,4,0,22
Iran,07/08/2004,8,0,0,0,6,6,0,20
Iran,08/08/2004,4,0,0,0,15,0,0,19
Iran,09/08/2004,17,0,0,0,-4,0,0,13
Iran,10/08/2004,14,0,0,0,3,2,0,19
Iran,11/08/2004,6,0,0,0,15,0,0,21
Iran,12/08/2004,14,0,0,0,0,0,0,14
Iran,13/08/2004,1,0,0,0,0,1,0,2
Iran,14/08/2004,4,0,0,0,3,0,0,7
Iran,15/08/2004,12,0,0,0,-4,0,0,8
Iran,16/08/2004,5,0,0,0,1,4,0,10
Iran,17/08/2004,10,0,0,0,6,0,0,16
Iran,18/08/2004,4,0,0,0,3,1,0,8
Iran,19/08/2004,18,0,0,0,3,0,0,21
Iran,20/08/2004,27,0,0,0,-6,0,0,21
Iran,21/08/2004,13,0,0,0,9,0,0,22
Iran,22/08/2004,0,0,0,0,0,0,0,0
Iran,23/08/2004,2,0,0,0,0,0,0,2
Iran,24/08/2004,10,0,0,0,9,0,0,19
Iran,25/08/2004,5,0,0,0,0,0,0,5
Iran,26/08/2004,9,0,0,0,6,0,0,15
Iran,27/08/2004,4,0,0,0,0,0,0,4
Iran,28/08/2004,10,0,0,0,0,1,0,11
Iran,29/08/2004,2,0,0,0,17,0,0,19
Iran,30/08/2004,4,0,0,0,3,0,0,7
Iran,31/08/2004,23,0,0,0,27,0,0,50
Iran,01/09/2004,9,0,0,0,24,3,0,36
Iran,02/09/2004,0,0,0,0,-6,0,0,-6
Iran,03/09/2004,19,0,0,0,6,0,0,25
Iran,04/09/2004,12,0,0,0,12,1,0,25
Iran,05/09/2004,10,0,0,0,12,0,0,22
Iran,06/09/2004,0,0,0,0,0,0,0,0
Iran,07/09/2004,7,0,0,0,7,0,0,14
Iran,08/09/2004,10,0,0,0,7,0,0,17
Iran,09/09/2004,6,0,0,0,0,0,0,6
Iran,10/09/2004,26,0,0,0,0,5,0,31
Iran,11/09/2004,5,0,0,0,0,3,0,8
Iran,12/09/2004,6,0,0,0,0,0,0,6
Iran,13/09/2004,-1,0,0,0,1,0,0,0
Iran,14/09/2004,29,0,0,0,8,8,0,45
Iran,15/09/2004,12,0,0,0,4,0,0,16
Iran,16/09/2004,7,0,0,0,8,0,0,15
Iran,17/09/2004,28,0,0,0,1,0,0,29
Iran,18/09/2004,19,0,0,0,6,0,0,25
Iran,19/09/2004,3,0,0,0,9,0,0,12
Iran,20/09/2004,9,0,0,0,-1,1,0,9
Iran,21/09/2004,10,0,1,0,4,0,0,15
Iran,22/09/2004,15,0,2,0,10,5,0,32
Iran,23/09/2004,5,0,0,0,12,3,0,20
Iran,24/09/2004,5,0,-2,0,8,0,0,11
Iran,25/09/2004,4,0,1,0,5,1,0,11
Iran,26/09/2004,6,0,0,0,-10,0,0,-4
Iran,27/09/2004,7,0,2,0,-15,0,0,-6
Iran,28/09/2004,-6,0,0,0,-18,2,0,-22
Iran,29/09/2004,3,0,0,0,7,0,0,10
Iran,30/09/2004,6,0,0,0,6,0,0,12
Iran,01/10/2004,9,0,0,0,4,1,0,14
Iran,02/10/2004,4,0,0,0,0,0,0,4
Iran,03/10/2004,11,0,0,0,7,3,0,21
Iran,04/10/2004,21,0,-10,0,-1,1,0,11
Iran,05/10/2004,16,0,-1,0,6,2,0,23
Iran,06/10/2004,1,0,0,0,0,3,0,4
Iran,07/10/2004,16,0,0,0,-6,1,0,11
Iran,08/10/2004,3,2,0,0,0,1,0,6
Iran,09/10/2004,19,0,2,0,6,2,0,29
Iran,10/10/2004,7,0,1,0,4,0,0,12
Iran,11/10/2004,9,0,0,0,12,0,0,21
Iran,12/10/2004,12,0,-2,0,15,0,0,25
Iran,13/10/2004,13,0,0,0,30,0,0,43
Iran,14/10/2004,6,0,1,0,0,0,0,7
Iran,15/10/2004,-2,0,0,0,9,0,0,7
Iran,16/10/2004,12,0,0,0,9,3,0,24
Iran,17/10/2004,1,0,0,0,1,0,0,2
Iran,18/10/2004,23,0,0,0,9,2,0,34
Iran,19/10/2004,16,0,0,0,18,2,0,36
Iran,20/10/2004,-1,0,1,0,10,0,0,10
Iran,21/10/2004,13,0,0,0,0,6,0,19
Iran,22/10/2004,-2,0,0,0,1,1,0,0
Iran,23/10/2004,0,0,0,0,0,2,0,2
Iran,24/10/2004,20,0,0,0,0,1,0,21
Iran,25/10/2004,4,0,0,0,8,0,0,12
Iran,26/10/2004,5,0,0,0,6,0,0,11
Iran,27/10/2004,-2,0,1,0,4,1,0,4
Iran,28/10/2004,6,0,0,0,8,1,0,15
Iran,29/10/2004,-1,0,0,0,0,0,0,-1
Iran,30/10/2004,15,0,0,0,5,4,0,24
Iran,31/10/2004,18,0,0,0,7,0,0,25
Iran,01/11/2004,11,0,0,0,13,1,0,25
Iran,02/11/2004,18,0,0,0,0,2,0,20
Iran,03/11/2004,7,0,1,0,0,0,0,8
Iran,04/11/2004,9,0,0,0,6,0,0,15
Iran,05/11/2004,10,0,0,0,0,0,0,10
Iran,06/11/2004,3,0,-4,0,0,0,0,-1
Iran,07/11/2004,1,0,0,0,0,0,0,1
Iran,08/11/2004,1,0,1,0,6,0,0,8
Iran,09/11/2004,14,0,0,0,9,0,0,23
Iran,10/11/2004,11,0,0,0,23,2,0,36
Iran,11/11/2004,3,0,0,0,0,0,0,3
Iran,12/11/2004,1,0,0,0,11,0,0,12
Iran,13/11/2004,0,0,0,0,0,0,0,0
Iran,14/11/2004,5,0,0,0,18,0,0,23
Iran,15/11/2004,9,0,7,0,36,1,0,53
Iran,16/11/2004,2,0,0,0,4,0,0,6
Iran,17/11/2004,7,0,0,0,13,0,0,20
Iran,18/11/2004,15,0,0,0,0,1,0,16
Iran,19/11/2004,0,2,0,0,3,2,0,7
Iran,20/11/2004,3,0,0,0,9,0,0,12
Iran,21/11/2004,9,0,-2,0,3,2,0,12
Iran,22/11/2004,14,0,-2,0,1,0,0,13
Iran,23/11/2004,-7,0,0,0,2,0,0,-5
Iran,24/11/2004,11,0,0,0,0,2,0,13
Iran,25/11/2004,7,0,0,0,3,5,0,15
Iran,26/11/2004,-2,0,0,0,-10,0,0,-12
Iran,27/11/2004,8,0,0,0,5,0,0,13
Iran,28/11/2004,4,0,0,0,0,2,0,6
Iran,29/11/2004,18,0,0,0,0,0,0,18
Iran,30/11/2004,-1,0,0,0,9,1,0,9
Iran,01/12/2004,17,0,0,0,15,0,0,32
Iran,02/12/2004,-1,0,0,0,3,1,0,3
Iran,03/12/2004,13,0,0,0,9,0,0,22
Iran,04/12/2004,6,0,0,0,0,0,0,6
Iran,05/12/2004,12,0,0,0,11,0,0,23
Iran,06/12/2004,-2,0,0,0,0,0,0,-2
Iran,07/12/2004,12,0,0,0,36,4,0,52
Iran,08/12/2004,5,0,0,0,3,0,0,8
Iran,09/12/2004,4,0,-2,0,3,0,0,5
Iran,10/12/2004,9,0,0,0,-10,0,0,-1
Iran,11/12/2004,12,0,0,0,7,3,0,22
Iran,12/12/2004,25,0,0,0,6,3,0,34
Iran,13/12/2004,8,0,0,0,6,2,0,16
Iran,14/12/2004,7,0,0,0,1,0,0,8
Iran,15/12/2004,16,0,-2,0,13,0,0,27
Iran,16/12/2004,18,0,0,0,0,1,0,19
Iran,17/12/2004,1,0,1,0,0,0,0,2
Iran,18/12/2004,3,0,0,0,0,0,0,3
Iran,19/12/2004,21,0,0,0,3,0,0,24
Iran,20/12/2004,35,0,0,0,3,1,0,39
Iran,21/12/2004,0,0,0,0,3,2,0,5
Iran,22/12/2004,7,0,2,0,9,0,0,18
Iran,23/12/2004,23,0,1,0,9,5,0,38
Iran,24/12/2004,-2,0,0,0,0,0,0,-2
Iran,25/12/2004,21,0,0,0,18,2,0,41
Iran,26/12/2004,4,0,0,0,0,0,0,4
Iran,27/12/2004,29,0,0,0,3,6,0,38
Iran,28/12/2004,1,0,1,0,0,3,0,5
Iran,29/12/2004,-1,0,-2,0,3,0,0,0
Iran,30/12/2004,4,0,0,0,6,0,0,10
Iran,31/12/2004,2,0,0,0,12,2,0,16
Iraq,01/01/2004,41,0,1,0,12,1,0,55
Iraq,02/01/2004,39,0,2,0,16,1,0,58
Iraq,03/01/2004,28,0,0,0,-4,3,0,27
Iraq,04/01/2004,67,0,1,0,31,7,0,106
Iraq,05/01/2004,60,0,2,0,26,8,0,96
Iraq,06/01/2004,86,0,-10,0,-8,10,0,78
Iraq,07/01/2004,56,2,-1,0,25,10,0,92
Iraq,08/01/2004,53,6,0,0,17,3,0,79
Iraq,09/01/2004,38,0,-2,0,25,7,0,68
Iraq,10/01/2004,36,0,0,0,13,10,0,59
Iraq,11/01/2004,62,0,5,0,6,6,0,79
Iraq,12/01/2004,99,2,0,0,4,1,0,106
Iraq,13/01/2004,71,2,-2,0,8,9,0,88
Iraq,14/01/2004,38,0,-1,0,26,5,0,68
Iraq,15/01/2004,75,2,-1,0,6,3,0,85
Iraq,16/01/2004,50,0,0,0,3,7,0,60
Iraq,17/01/2004,35,0,0,0,-1,9,0,43
Iraq,18/01/2004,32,0,1,0,3,4,0,40
Iraq,19/01/2004,84,0,3,0,12,2,0,101
Iraq,20/01/2004,46,2,-6,0,19,5,0,66
Iraq,21/01/2004,101,0,-9,0,5,4,0,101
Iraq,22/01/2004,72,0,2,0,17,19,0,110
Iraq,23/01/2004,56,4,-3,0,16,12,0,85
Iraq,24/01/2004,41,0,-1,0,18,4,0,62
Iraq,25/01/2004,53,0,-7,0,24,5,0,75
Iraq,26/01/2004,78,0,-4,0,33,7,0,114
Iraq,27/01/2004,92,0,-8,0,32,9,0,125
Iraq,28/01/2004,61,0,0,0,12,14,0,87
Iraq,29/01/2004,118,6,-7,0,9,17,0,143
Iraq,30/01/2004,126,0,-6,0,39,6,0,165
Iraq,31/01/2004,60,0,-4,0,10,13,0,79
Iraq,01/02/2004,107,0,0,0,-1,9,0,115
Iraq,02/02/2004,71,0,-2,0,17,6,0,92
Iraq,03/02/2004,134,0,-1,0,18,16,0,167
Iraq,04/02/2004,175,2,1,0,15,18,0,211
Iraq,05/02/2004,102,0,-9,0,10,16,0,119
Iraq,06/02/2004,78,0,-4,0,32,11,0,117
Iraq,07/02/2004,43,6,-8,0,1,5,0,47
Iraq,08/02/2004,47,0,-3,0,2,10,0,56
Iraq,09/02/2004,56,0,1,0,20,33,0,110
Iraq,10/02/2004,89,0,0,0,5,7,0,101
Iraq,11/02/2004,37,0,1,0,8,4,0,50
Iraq,12/02/2004,47,2,0,0,-1,6,0,54
Iraq,13/02/2004,87,0,0,0,3,5,0,95
Iraq,14/02/2004,88,0,1,0,18,10,0,117
Iraq,15/02/2004,64,2,3,0,25,11,0,105
Iraq,16/02/2004,61,0,-5,0,-9,6,0,53
Iraq,17/02/2004,81,2,-3,0,1,4,0,85
Iraq,18/02/2004,63,2,1,0,2,13,0,81
Iraq,19/02/2004,67,2,4,0,5,9,0,87
Iraq,20/02/2004,52,0,2,0,5,5,0,64
Iraq,21/02/2004,41,0,1,0,27,3,0,72
Iraq,22/02/2004,60,0,-2,0,3,6,0,67
Iraq,23/02/2004,49,4,1,0,-2,10,0,62
Iraq,24/02/2004,82,0,3,0,27,9,0,121
Iraq,25/02/2004,63,0,1,0,25,11,0,100
Iraq,26/02/2004,31,0,1,0,12,0,0,44
Iraq,27/02/2004,59,2,0,0,12,9,0,82
Iraq,28/02/2004,34,2,1,0,0,4,0,41
Iraq,29/02/2004,97,0,-3,0,4,2,0,100
Iraq,01/03/2004,58,0,-3,0,4,3,0,62
Iraq,02/03/2004,101,0,0,0,17,39,0,157
Iraq,03/03/2004,79,0,0,0,17,9,0,105
Iraq,04/03/2004,84,0,-9,0,26,26,0,127
Iraq,05/03/2004,47,0,-4,0,43,4,0,90
Iraq,06/03/2004,40,2,0,0,10,6,0,58
Iraq,07/03/2004,34,0,2,0,-4,15,0,47
Iraq,08/03/2004,59,0,0,0,-15,13,0,57
Iraq,09/03/2004,51,0,-1,0,23,10,0,83
Iraq,10/03/2004,57,0,3,0,5,4,0,69
Iraq,11/03/2004,70,0,-4,0,0,6,0,72
Iraq,12/03/2004,70,0,-2,0,22,4,0,94
Iraq,13/03/2004,26,0,0,0,12,8,0,46
Iraq,14/03/2004,54,0,-2,0,22,10,0,84
Iraq,15/03/2004,139,0,-2,0,7,20,0,164
Iraq,16/03/2004,97,2,5,0,0,8,0,112
Iraq,17/03/2004,121,2,0,0,-1,15,0,137
Iraq,18/03/2004,65,0,-3,0,24,32,0,118
Iraq,19/03/2004,79,0,1,0,4,32,0,116
Iraq,20/03/2004,115,0,-1,0,19,43,0,176
Iraq,21/03/2004,53,0,0,0,28,21,0,102
Iraq,22/03/2004,91,4,-2,0,2,18,0,113
Iraq,23/03/2004,86,0,0,0,-5,6,0,87
Iraq,24/03/2004,64,0,2,0,-1,11,0,76
Iraq,25/03/2004,56,0,-4,0,14,15,0,81
Iraq,26/03/2004,45,0,-4,0,-4,17,0,54
Iraq,27/03/2004,65,2,1,0,-3,5,0,70
Iraq,28/03/2004,109,0,-2,0,2,10,0,119
Iraq,29/03/2004,32,0,-2,0,-1,3,0,32
Iraq,30/03/2004,43,0,-2,0,6,2,0,49
Iraq,31/03/2004,40,4,-2,0,0,11,0,53
Iraq,01/04/2004,117,0,1,0,35,12,0,165
Iraq,02/04/2004,84,4,-2,0,-3,10,0,93
Iraq,03/04/2004,32,0,-1,0,-6,6,0,31
Iraq,04/04/2004,57,0,0,0,20,10,0,87
Iraq,05/04/2004,116,0,0,0,-3,12,0,125
Iraq,06/04/2004,142,4,0,0,31,10,0,187
Iraq,07/04/2004,205,0,1,0,53,2,0,261
Iraq,08/04/2004,207,0,-18,0,76,26,0,291
Iraq,09/04/2004,186,6,10,0,54,29,0,285
Iraq,10/04/2004,84,6,-4,0,21,20,0,127
Iraq,11/04/2004,96,2,1,0,6,5,0,110
Iraq,12/04/2004,117,0,-1,0,31,11,0,158
Iraq,13/04/2004,162,0,2,0,45,13,0,222
Iraq,14/04/2004,170,8,-7,0,59,24,0,254
Iraq,15/04/2004,130,0,-10,0,71,13,0,204
Iraq,16/04/2004,109,0,1,0,53,12,0,175
Iraq,17/04/2004,119,4,-2,0,16,8,0,145
Iraq,18/04/2004,107,6,-2,0,77,11,0,199
Iraq,19/04/2004,143,0,8,0,41,8,0,200
Iraq,20/04/2004,45,0,-1,0,24,8,0,76
Iraq,21/04/2004,189,2,-7,0,22,16,0,222
Iraq,22/04/2004,99,0,5,0,31,12,0,147
Iraq,23/04/2004,194,0,-5,0,2,13,0,204
Iraq,24/04/2004,91,2,-2,0,13,10,0,114
Iraq,25/04/2004,156,2,-2,0,3,4,0,163
Iraq,26/04/2004,110,4,-3,0,42,6,0,159
Iraq,27/04/2004,85,0,0,0,34,11,0,130
Iraq,28/04/2004,143,4,-2,0,24,12,0,181
Iraq,29/04/2004,197,0,-14,0,13,16,0,212
Iraq,30/04/2004,139,1,0,0,10,3,0,153
Iraq,01/05/2004,88,2,0,0,19,11,0,120
Iraq,02/05/2004,88,0,-4,0,36,17,0,137
Iraq,03/05/2004,96,0,0,0,47,26,0,169
Iraq,04/05/2004,66,0,-2,0,68,32,0,164
Iraq,05/05/2004,86,2,0,0,67,50,0,205
Iraq,06/05/2004,97,0,-8,0,46,18,0,153
Iraq,07/05/2004,105,2,-9,0,97,32,0,227
Iraq,08/05/2004,78,4,-5,0,53,21,0,151
Iraq,09/05/2004,71,0,0,0,47,37,0,155
Iraq,10/05/2004,148,2,-6,0,65,48,0,257
Iraq,11/05/2004,143,0,-5,0,89,42,0,269
Iraq,12/05/2004,159,2,-3,0,145,49,0,352
Iraq,13/05/2004,111,0,4,0,155,43,0,313
Iraq,14/05/2004,116,0,-11,0,98,24,0,227
Iraq,15/05/2004,93,0,-5,0,52,15,0,155
Iraq,16/05/2004,112,0,-1,0,20,30,0,161
Iraq,17/05/2004,142,0,-8,0,21,23,0,178
Iraq,18/05/2004,143,0,-4,0,50,27,0,216
Iraq,19/05/2004,120,0,-2,0,57,41,0,216
Iraq,20/05/2004,134,0,1,0,53,32,0,220
Iraq,21/05/2004,146,0,1,0,34,35,0,216
Iraq,22/05/2004,51,0,1,0,41,19,0,112
Iraq,23/05/2004,133,0,0,0,47,2,0,182
Iraq,24/05/2004,118,0,-1,0,45,20,0,182
Iraq,25/05/2004,81,16,-8,0,29,38,0,156
Iraq,26/05/2004,73,6,3,0,20,12,0,114
Iraq,27/05/2004,105,2,-1,0,46,19,0,171
Iraq,28/05/2004,101,0,-2,0,56,5,0,160
Iraq,29/05/2004,49,0,0,0,19,10,0,78
Iraq,30/05/2004,93,0,-2,0,19,6,0,116
Iraq,31/05/2004,77,0,-6,0,7,17,0,95
Iraq,01/06/2004,107,8,3,0,37,17,0,172
Iraq,02/06/2004,58,8,2,0,8,17,0,93
Iraq,03/06/2004,141,0,-15,0,59,20,0,205
Iraq,04/06/2004,100,0,-2,0,28,28,0,154
Iraq,05/06/2004,67,0,-1,0,22,21,0,109
Iraq,06/06/2004,81,0,-5,0,8,6,0,90
Iraq,07/06/2004,83,0,-11,0,12,13,0,97
Iraq,08/06/2004,74,0,0,0,19,22,0,115
Iraq,09/06/2004,126,2,-2,0,7,22,0,155
Iraq,10/06/2004,72,2,-9,0,9,18,0,92
Iraq,11/06/2004,90,0,-1,0,5,14,0,108
Iraq,12/06/2004,37,0,-2,0,17,5,0,57
Iraq,13/06/2004,61,0,-1,0,12,7,0,79
Iraq,14/06/2004,68,0,-6,0,4,9,0,75
Iraq,15/06/2004,69,0,-6,0,14,14,0,91
Iraq,16/06/2004,52,0,1,0,38,8,0,99
Iraq,17/06/2004,101,0,1,0,55,16,0,173
Iraq,18/06/2004,42,0,-5,0,14,7,0,58
Iraq,19/06/2004,54,2,-1,0,20,3,0,78
Iraq,20/06/2004,66,0,0,0,15,17,0,98
Iraq,21/06/2004,104,2,1,0,79,6,0,192
Iraq,22/06/2004,83,0,6,0,38,6,0,133
Iraq,23/06/2004,132,2,-4,0,32,15,0,177
Iraq,24/06/2004,87,0,-3,0,35,13,0,132
Iraq,25/06/2004,164,14,1,0,57,26,0,262
Iraq,26/06/2004,103,2,1,0,28,15,0,149
Iraq,27/06/2004,93,4,0,0,52,13,0,162
Iraq,28/06/2004,129,2,-20,0,25,41,0,177
Iraq,29/06/2004,122,4,-4,0,105,18,0,245
Iraq,30/06/2004,133,2,-10,0,34,6,0,165
Iraq,01/07/2004,48,0,-6,0,11,19,0,72
Iraq,02/07/2004,118,0,-3,0,41,5,0,161
Iraq,03/07/2004,14,0,1,0,11,2,0,28
Iraq,04/07/2004,24,0,1,0,38,2,0,65
Iraq,05/07/2004,28,2,-1,0,15,7,0,51
Iraq,06/07/2004,85,0,-1,0,27,6,0,117
Iraq,07/07/2004,56,4,2,0,54,9,0,125
Iraq,08/07/2004,31,0,-6,0,44,6,0,75
Iraq,09/07/2004,42,0,-4,0,13,5,0,56
Iraq,10/07/2004,113,0,-2,0,32,11,0,154
Iraq,11/07/2004,44,0,-1,0,43,10,0,96
Iraq,12/07/2004,39,0,1,0,15,5,0,60
Iraq,13/07/2004,19,2,2,0,34,0,0,57
Iraq,14/07/2004,53,0,-2,0,38,17,0,106
Iraq,15/07/2004,57,0,-2,0,28,15,0,98
Iraq,16/07/2004,18,0,3,0,6,8,0,35
Iraq,17/07/2004,-4,0,-2,0,8,5,0,7
Iraq,18/07/2004,4,0,0,0,13,8,0,25
Iraq,19/07/2004,29,0,-1,0,36,7,0,71
Iraq,20/07/2004,52,0,0,0,45,11,0,108
Iraq,21/07/2004,32,2,2,0,14,1,0,51
Iraq,22/07/2004,69,4,-2,0,10,7,0,88
Iraq,23/07/2004,41,0,-2,0,53,6,0,98
Iraq,24/07/2004,32,0,-2,0,53,4,0,87
Iraq,25/07/2004,28,0,2,0,23,8,0,61
Iraq,26/07/2004,37,4,1,0,55,7,0,104
Iraq,27/07/2004,57,0,1,0,29,6,0,93
Iraq,28/07/2004,98,0,1,0,25,16,0,140
Iraq,29/07/2004,164,6,-2,0,46,8,0,222
Iraq,30/07/2004,62,0,1,0,48,9,0,120
Iraq,31/07/2004,65,0,0,0,-16,16,0,65
Iraq,01/08/2004,66,0,-8,0,-4,12,0,66
Iraq,02/08/2004,140,0,-1,0,5,3,0,147
Iraq,03/08/2004,43,4,0,0,14,5,0,66
Iraq,04/08/2004,62,2,-2,0,16,11,0,89
Iraq,05/08/2004,92,2,-2,0,20,1,0,113
Iraq,06/08/2004,73,0,0,0,31,1,0,105
Iraq,07/08/2004,42,0,-1,0,27,6,0,74
Iraq,08/08/2004,26,0,0,0,12,6,0,44
Iraq,09/08/2004,114,0,2,0,27,7,0,150
Iraq,10/08/2004,75,0,-3,0,43,6,0,121
Iraq,11/08/2004,67,0,-1,0,47,13,0,126
Iraq,12/08/2004,48,0,0,0,29,14,0,91
Iraq,13/08/2004,63,2,-8,0,31,5,0,93
Iraq,14/08/2004,49,4,0,0,38,3,0,94
Iraq,15/08/2004,78,0,0,0,43,8,0,129
Iraq,16/08/2004,86,0,3,0,22,19,0,130
Iraq,17/08/2004,106,0,1,0,40,5,0,152
Iraq,18/08/2004,160,0,0,0,13,10,0,183
Iraq,19/08/2004,101,0,0,0,43,16,0,160
Iraq,20/08/2004,53,0,1,0,10,17,0,81
Iraq,21/08/2004,33,0,1,0,28,10,0,72
Iraq,22/08/2004,58,0,1,0,17,8,0,84
Iraq,23/08/2004,91,0,0,0,59,12,0,162
Iraq,24/08/2004,83,0,0,0,30,8,0,121
Iraq,25/08/2004,79,4,-1,0,107,15,0,204
Iraq,26/08/2004,32,0,0,0,46,13,0,91
Iraq,27/08/2004,48,4,0,0,34,11,0,97
Iraq,28/08/2004,64,0,-1,0,16,1,0,80
Iraq,29/08/2004,32,0,1,0,46,2,0,81
Iraq,30/08/2004,82,2,1,0,84,8,0,177
Iraq,31/08/2004,142,0,0,0,74,14,0,230
Iraq,01/09/2004,109,2,0,0,164,23,0,298
Iraq,02/09/2004,68,0,2,0,69,9,0,148
Iraq,03/09/2004,70,0,1,0,41,9,0,121
Iraq,04/09/2004,70,0,0,0,33,10,0,113
Iraq,05/09/2004,61,0,0,0,53,9,0,123
Iraq,06/09/2004,67,0,2,0,94,23,0,186
Iraq,07/09/2004,62,0,0,0,36,5,0,103
Iraq,08/09/2004,64,0,-4,0,45,6,0,111
Iraq,09/09/2004,53,0,-4,0,31,18,0,98
Iraq,10/09/2004,55,0,0,0,28,4,0,87
Iraq,11/09/2004,46,0,-5,0,32,3,0,76
Iraq,12/09/2004,100,0,-2,0,9,15,0,122
Iraq,13/09/2004,80,0,-4,0,35,9,0,120
Iraq,14/09/2004,70,4,-3,0,18,3,0,92
Iraq,15/09/2004,52,0,4,0,19,9,0,84
Iraq,16/09/2004,91,0,0,0,49,11,0,151
Iraq,17/09/2004,155,0,3,0,9,20,0,187
Iraq,18/09/2004,76,0,4,0,30,11,0,121
Iraq,19/09/2004,42,0,0,0,33,6,0,81
Iraq,20/09/2004,81,4,2,0,5,2,0,94
Iraq,21/09/2004,48,2,-1,0,36,11,0,96
Iraq,22/09/2004,77,2,0,0,6,8,0,93
Iraq,23/09/2004,102,6,-3,0,13,5,0,123
Iraq,24/09/2004,28,2,8,0,20,13,0,71
Iraq,25/09/2004,57,2,0,0,49,5,0,113
Iraq,26/09/2004,67,0,5,0,28,4,0,104
Iraq,27/09/2004,52,0,-1,0,44,16,0,111
Iraq,28/09/2004,68,2,1,0,-24,14,0,61
Iraq,29/09/2004,44,0,4,0,40,9,0,97
Iraq,30/09/2004,107,10,2,0,49,11,0,179
Iraq,01/10/2004,149,0,1,0,62,9,0,221
Iraq,02/10/2004,40,0,0,0,73,13,0,126
Iraq,03/10/2004,37,0,0,0,21,0,0,58
Iraq,04/10/2004,41,4,0,0,46,15,0,106
Iraq,05/10/2004,79,0,0,0,48,4,0,131
Iraq,06/10/2004,78,0,5,0,38,5,0,126
Iraq,07/10/2004,68,0,-4,0,39,4,0,107
Iraq,08/10/2004,154,0,0,0,89,12,0,255
Iraq,09/10/2004,78,2,0,0,23,11,0,114
Iraq,10/10/2004,46,0,1,0,2,5,0,54
Iraq,11/10/2004,62,0,-1,0,15,16,0,92
Iraq,12/10/2004,130,0,3,0,43,7,0,183
Iraq,13/10/2004,65,8,-1,0,22,8,0,102
Iraq,14/10/2004,83,0,0,0,16,5,0,104
Iraq,15/10/2004,27,0,1,0,57,6,0,91
Iraq,16/10/2004,47,2,0,0,17,1,0,67
Iraq,17/10/2004,83,2,1,0,32,13,0,131
Iraq,18/10/2004,107,0,2,0,46,12,0,167
Iraq,19/10/2004,59,0,0,0,13,9,0,81
Iraq,20/10/2004,81,0,-1,0,31,11,0,122
Iraq,21/10/2004,84,0,1,0,22,7,0,114
Iraq,22/10/2004,115,0,1,0,10,16,0,142
Iraq,23/10/2004,36,0,0,0,31,-2,0,65
Iraq,24/10/2004,88,0,0,0,23,8,0,119
Iraq,25/10/2004,114,0,0,0,12,16,0,142
Iraq,26/10/2004,67,6,0,0,73,14,0,160
Iraq,27/10/2004,47,0,0,0,40,5,0,92
Iraq,28/10/2004,32,2,0,0,77,4,0,115
Iraq,29/10/2004,69,2,0,0,63,7,0,141
Iraq,30/10/2004,43,0,1,0,92,9,0,145
Iraq,31/10/2004,61,8,4,0,92,13,0,178
Iraq,01/11/2004,110,0,0,0,58,19,0,187
Iraq,02/11/2004,75,0,-1,0,36,16,0,126
Iraq,03/11/2004,87,2,-2,0,42,12,0,141
Iraq,04/11/2004,23,0,2,0,37,16,0,78
Iraq,05/11/2004,41,2,1,0,14,3,0,61
Iraq,06/11/2004,49,0,2,0,-7,7,0,51
Iraq,07/11/2004,42,0,0,0,8,13,0,63
Iraq,08/11/2004,88,0,-4,0,29,22,0,135
Iraq,09/11/2004,177,0,-3,0,-7,28,0,195
Iraq,10/11/2004,116,0,0,0,24,19,0,159
Iraq,11/11/2004,85,0,2,0,25,12,0,124
Iraq,12/11/2004,105,0,0,0,12,7,0,124
Iraq,13/11/2004,68,0,0,0,46,21,0,135
Iraq,14/11/2004,40,0,-4,0,31,12,0,79
Iraq,15/11/2004,97,0,0,0,19,12,0,128
Iraq,16/11/2004,179,2,-22,0,32,6,0,197
Iraq,17/11/2004,108,0,2,0,8,4,0,122
Iraq,18/11/2004,95,4,1,0,85,8,0,193
Iraq,19/11/2004,41,0,-4,0,0,12,0,49
Iraq,20/11/2004,27,0,0,0,5,7,0,39
Iraq,21/11/2004,64,2,0,0,11,19,0,96
Iraq,22/11/2004,49,0,3,0,20,19,0,91
Iraq,23/11/2004,55,0,-7,0,31,14,0,93
Iraq,24/11/2004,80,4,-2,0,26,24,0,132
Iraq,25/11/2004,49,0,-3,0,28,2,0,76
Iraq,26/11/2004,44,0,6,0,9,9,0,68
Iraq,27/11/2004,22,0,4,0,-3,4,0,27
Iraq,28/11/2004,38,0,-3,0,2,10,0,47
Iraq,29/11/2004,83,6,-4,0,17,11,0,113
Iraq,30/11/2004,54,0,-7,0,18,1,0,66
Iraq,01/12/2004,51,0,-3,0,13,7,0,68
Iraq,02/12/2004,40,4,-11,0,-4,11,0,40
Iraq,03/12/2004,41,2,-3,0,42,16,0,98
Iraq,04/12/2004,42,0,2,0,12,3,0,59
Iraq,05/12/2004,24,0,2,0,6,0,0,32
Iraq,06/12/2004,26,4,-3,0,18,13,0,58
Iraq,07/12/2004,84,0,2,0,33,8,0,127
Iraq,08/12/2004,76,2,-1,0,7,2,0,86
Iraq,09/12/2004,70,6,1,0,18,5,0,100
Iraq,10/12/2004,27,0,2,0,16,3,0,48
Iraq,11/12/2004,57,0,-1,0,13,0,0,69
Iraq,12/12/2004,65,0,0,0,29,9,0,103
Iraq,13/12/2004,59,0,-2,0,10,5,0,72
Iraq,14/12/2004,62,6,0,0,30,6,0,104
Iraq,15/12/2004,72,0,0,0,34,2,0,108
Iraq,16/12/2004,88,2,-1,0,11,6,0,106
Iraq,17/12/2004,38,0,-3,0,22,4,0,61
Iraq,18/12/2004,21,0,1,0,8,11,0,41
Iraq,19/12/2004,55,0,0,0,23,19,0,97
Iraq,20/12/2004,36,0,1,0,10,6,0,53
Iraq,21/12/2004,77,4,0,0,12,7,0,100
Iraq,22/12/2004,95,0,1,0,46,10,0,152
Iraq,23/12/2004,79,2,-2,0,4,10,0,93
Iraq,24/12/2004,50,0,2,0,5,5,0,62
Iraq,25/12/2004,76,0,0,0,20,3,0,99
Iraq,26/12/2004,32,0,0,0,-2,5,0,35
Iraq,27/12/2004,42,0,1,0,45,17,0,105
Iraq,28/12/2004,50,4,1,0,2,4,0,61
Iraq,29/12/2004,74,2,-6,0,2,21,0,93
Iraq,30/12/2004,18,0,-1,0,0,1,0,18
Iraq,31/12/2004,44,2,-2,0,32,12,0,88
Morocco,02/01/2004,0,0,0,0,0,0,0,0
Morocco,03/01/2004,3,0,0,0,6,0,0,9
Morocco,04/01/2004,0,0,0,0,3,0,0,3
Morocco,05/01/2004,0,0,0,0,18,0,0,18
Morocco,06/01/2004,4,0,0,0,12,2,0,18
Morocco,07/01/2004,1,0,0,0,0,0,0,1
Morocco,08/01/2004,3,0,0,0,-1,0,0,2
Morocco,09/01/2004,6,0,0,0,0,0,0,6
Morocco,10/01/2004,0,0,0,0,0,0,0,0
Morocco,11/01/2004,6,0,0,0,9,0,0,15
Morocco,12/01/2004,6,0,0,0,0,0,0,6
Morocco,13/01/2004,0,0,0,0,-2,0,0,-2
Morocco,14/01/2004,3,0,0,0,-2,0,0,1
Morocco,15/01/2004,6,0,0,0,15,0,0,21
Morocco,16/01/2004,0,0,0,0,0,0,0,0
Morocco,17/01/2004,0,0,0,0,9,0,0,9
Morocco,18/01/2004,3,0,0,0,6,0,0,9
Morocco,19/01/2004,0,0,0,0,3,0,0,3
Morocco,20/01/2004,10,0,0,0,10,2,0,22
Morocco,21/01/2004,0,0,-1,0,18,0,0,17
Morocco,22/01/2004,4,0,0,0,12,3,0,19
Morocco,23/01/2004,0,0,0,0,0,0,0,0
Morocco,24/01/2004,0,0,0,0,0,0,0,0
Morocco,25/01/2004,0,0,0,0,0,0,0,0
Morocco,26/01/2004,2,0,0,0,12,1,0,15
Morocco,27/01/2004,0,0,-1,0,2,0,0,1
Morocco,28/01/2004,6,0,0,0,4,1,0,11
Morocco,29/01/2004,4,0,0,0,10,0,0,14
Morocco,30/01/2004,4,0,-1,0,3,0,0,6
Morocco,31/01/2004,0,0,0,0,0,0,0,0
Morocco,01/02/2004,0,0,0,0,1,4,0,5
Morocco,02/02/2004,3,0,0,0,3,0,0,6
Morocco,03/02/2004,2,0,0,0,12,0,0,14
Morocco,04/02/2004,0,0,0,0,0,0,0,0
Morocco,05/02/2004,13,0,0,0,24,0,0,37
Morocco,06/02/2004,8,0,0,0,3,0,0,11
Morocco,07/02/2004,2,0,0,0,1,0,0,3
Morocco,08/02/2004,-1,0,0,0,0,0,0,-1
Morocco,09/02/2004,-1,0,0,0,-2,0,0,-3
Morocco,10/02/2004,0,0,0,0,0,0,0,0
Morocco,11/02/2004,0,0,0,0,3,1,0,4
Morocco,12/02/2004,8,0,0,0,3,0,0,11
Morocco,13/02/2004,-8,0,-2,0,-6,0,0,-16
Morocco,14/02/2004,1,0,0,0,0,0,0,1
Morocco,16/02/2004,0,0,0,0,0,0,0,0
Morocco,17/02/2004,3,0,2,0,0,0,0,5
Morocco,18/02/2004,0,0,0,0,0,0,0,0
Morocco,19/02/2004,0,0,0,0,0,0,0,0
Morocco,20/02/2004,2,0,0,0,0,0,0,2
Morocco,21/02/2004,0,0,0,0,3,0,0,3
Morocco,22/02/2004,0,0,0,0,0,2,0,2
Morocco,23/02/2004,9,0,0,0,-4,0,0,5
Morocco,24/02/2004,-1,0,0,0,5,1,0,5
Morocco,25/02/2004,11,0,-2,0,9,1,0,19
Morocco,26/02/2004,4,0,0,0,3,0,0,7
Morocco,27/02/2004,13,0,0,0,3,0,0,16
Morocco,28/02/2004,2,0,0,0,3,0,0,5
Morocco,29/02/2004,4,0,0,0,0,0,0,4
Morocco,01/03/2004,33,0,0,0,0,0,0,33
Morocco,02/03/2004,8,0,0,0,3,0,0,11
Morocco,03/03/2004,4,0,0,0,4,0,0,8
Morocco,04/03/2004,4,0,0,0,10,0,0,14
Morocco,05/03/2004,7,0,0,0,1,0,0,8
Morocco,06/03/2004,0,0,0,0,0,0,0,0
Morocco,08/03/2004,0,0,0,0,6,3,0,9
Morocco,09/03/2004,2,0,0,0,6,0,0,8
Morocco,10/03/2004,3,0,0,0,10,0,0,13
Morocco,11/03/2004,3,0,0,0,-4,3,0,2
Morocco,12/03/2004,13,0,0,0,12,0,0,25
Morocco,13/03/2004,7,0,0,0,12,0,0,19
Morocco,14/03/2004,21,0,0,0,12,1,0,34
Morocco,15/03/2004,21,0,0,0,16,0,0,37
Morocco,16/03/2004,0,0,0,0,4,1,0,5
Morocco,17/03/2004,0,0,0,0,6,1,0,7
Morocco,18/03/2004,7,0,0,0,17,0,0,24
Morocco,19/03/2004,15,0,0,0,21,3,0,39
Morocco,20/03/2004,17,0,0,0,6,0,0,23
Morocco,21/03/2004,13,0,0,0,3,0,0,16
Morocco,22/03/2004,-1,0,0,0,9,4,0,12
Morocco,23/03/2004,4,0,0,0,28,0,0,32
Morocco,24/03/2004,8,0,0,0,3,2,0,13
Morocco,25/03/2004,5,0,0,0,42,0,0,47
Morocco,26/03/2004,16,0,0,0,39,2,0,57
Morocco,27/03/2004,2,0,0,0,0,0,0,2
Morocco,28/03/2004,3,0,0,0,21,0,0,24
Morocco,29/03/2004,9,0,0,0,6,0,0,15
Morocco,30/03/2004,2,0,0,0,9,0,0,11
Morocco,31/03/2004,2,0,0,0,0,0,0,2
Morocco,01/04/2004,5,0,0,0,-2,0,0,3
Morocco,02/04/2004,12,0,0,0,9,2,0,23
Morocco,03/04/2004,13,0,0,0,6,0,0,19
Morocco,04/04/2004,2,0,0,0,0,0,0,2
Morocco,05/04/2004,10,0,0,0,17,0,0,27
Morocco,06/04/2004,16,0,0,0,0,0,0,16
Morocco,07/04/2004,14,0,0,0,40,0,0,54
Morocco,08/04/2004,0,0,0,0,13,1,0,14
Morocco,09/04/2004,7,0,0,0,18,0,0,25
Morocco,10/04/2004,5,0,0,0,0,0,0,5
Morocco,11/04/2004,0,0,0,0,0,0,0,0
Morocco,12/04/2004,3,0,0,0,1,0,0,4
Morocco,13/04/2004,0,0,0,0,3,0,0,3
Morocco,14/04/2004,4,0,-1,0,1,0,0,4
Morocco,15/04/2004,8,0,-2,0,0,0,0,6
Morocco,16/04/2004,5,0,0,0,12,0,0,17
Morocco,17/04/2004,9,2,0,0,6,0,0,17
Morocco,18/04/2004,0,0,0,0,0,0,0,0
Morocco,19/04/2004,2,0,0,0,0,0,0,2
Morocco,20/04/2004,0,0,0,0,-2,1,0,-1
Morocco,21/04/2004,8,0,0,0,2,0,0,10
Morocco,22/04/2004,4,0,0,0,0,0,0,4
Morocco,23/04/2004,5,0,0,0,1,0,0,6
Morocco,24/04/2004,2,0,0,0,6,2,0,10
Morocco,25/04/2004,0,0,0,0,-6,0,0,-6
Morocco,26/04/2004,4,0,0,0,18,0,0,22
Morocco,27/04/2004,3,0,0,0,8,0,0,11
Morocco,28/04/2004,12,0,0,0,21,0,0,33
Morocco,29/04/2004,-3,0,-2,0,13,0,0,8
Morocco,30/04/2004,0,0,0,0,4,2,0,6
Morocco,01/05/2004,6,0,0,0,2,0,0,8
Morocco,02/05/2004,-2,0,0,0,0,0,0,-2
Morocco,03/05/2004,0,0,0,0,0,0,0,0
Morocco,04/05/2004,-3,0,0,0,0,0,0,-3
Morocco,05/05/2004,5,0,0,0,0,1,0,6
Morocco,06/05/2004,0,0,0,0,-2,0,0,-2
Morocco,07/05/2004,7,0,0,0,9,2,0,18
Morocco,08/05/2004,3,0,0,0,9,0,0,12
Morocco,09/05/2004,6,0,0,0,4,0,0,10
Morocco,10/05/2004,0,0,0,0,-4,0,0,-4
Morocco,11/05/2004,0,0,0,0,0,0,0,0
Morocco,12/05/2004,0,0,0,0,3,0,0,3
Morocco,13/05/2004,3,0,0,0,0,0,0,3
Morocco,14/05/2004,0,0,0,0,6,0,0,6
Morocco,15/05/2004,0,0,0,0,3,0,0,3
Morocco,16/05/2004,-1,0,0,0,0,0,0,-1
Morocco,17/05/2004,1,0,0,0,0,0,0,1
Morocco,18/05/2004,0,0,0,0,0,0,0,0
Morocco,19/05/2004,0,0,0,0,0,0,0,0
Morocco,20/05/2004,0,0,0,0,0,0,0,0
Morocco,21/05/2004,1,0,0,0,6,5,0,12
Morocco,22/05/2004,4,0,0,0,0,0,0,4
Morocco,23/05/2004,0,0,0,0,0,0,0,0
Morocco,24/05/2004,0,0,0,0,0,0,0,0
Morocco,25/05/2004,0,0,0,0,0,0,0,0
Morocco,26/05/2004,7,0,0,0,21,0,0,28
Morocco,27/05/2004,0,0,0,0,0,0,0,0
Morocco,28/05/2004,0,0,0,0,9,0,0,9
Morocco,29/05/2004,2,0,0,0,0,0,0,2
Morocco,30/05/2004,2,0,0,0,3,0,0,5
Morocco,31/05/2004,0,0,0,0,0,0,0,0
Morocco,01/06/2004,0,0,0,0,3,0,0,3
Morocco,02/06/2004,6,0,0,0,0,0,0,6
Morocco,03/06/2004,0,0,0,0,0,0,0,0
Morocco,04/06/2004,0,0,0,0,0,0,0,0
Morocco,05/06/2004,0,0,0,0,0,0,0,0
Morocco,06/06/2004,3,0,0,0,0,1,0,4
Morocco,07/06/2004,15,0,0,0,6,0,0,21
Morocco,08/06/2004,12,0,0,0,15,0,0,27
Morocco,09/06/2004,8,0,0,0,4,1,0,13
Morocco,10/06/2004,0,0,0,0,0,0,0,0
Morocco,11/06/2004,-1,0,-2,0,0,0,0,-3
Morocco,12/06/2004,-7,0,-2,0,3,0,0,-6
Morocco,14/06/2004,70,0,-3,0,0,0,0,67
Morocco,15/06/2004,4,0,0,0,9,0,0,13
Morocco,16/06/2004,-2,0,0,0,0,0,0,-2
Morocco,17/06/2004,1,0,-2,0,5,0,0,4
Morocco,18/06/2004,0,0,0,0,7,0,0,7
Morocco,20/06/2004,0,0,0,0,0,0,0,0
Morocco,21/06/2004,0,0,0,0,0,0,0,0
Morocco,22/06/2004,-3,0,-1,0,-9,0,0,-13
Morocco,23/06/2004,1,0,0,0,-4,0,0,-3
Morocco,24/06/2004,-8,0,0,0,3,0,0,-5
Morocco,25/06/2004,0,0,0,0,0,0,0,0
Morocco,26/06/2004,0,0,0,0,6,0,0,6
Morocco,27/06/2004,0,0,0,0,0,0,0,0
Morocco,28/06/2004,0,0,0,0,1,0,0,1
Morocco,29/06/2004,8,0,0,0,9,0,0,17
Morocco,30/06/2004,1,0,0,0,0,0,0,1
Morocco,01/07/2004,0,0,0,0,0,0,0,0
Morocco,02/07/2004,9,0,0,0,0,3,0,12
Morocco,03/07/2004,7,0,0,0,0,0,0,7
Morocco,04/07/2004,0,0,0,0,0,0,0,0
Morocco,05/07/2004,0,0,0,0,3,0,0,3
Morocco,06/07/2004,3,0,0,0,6,0,0,9
Morocco,07/07/2004,5,0,0,0,9,1,0,15
Morocco,08/07/2004,0,0,0,0,1,0,0,1
Morocco,09/07/2004,6,0,0,0,0,0,0,6
Morocco,10/07/2004,2,0,0,0,0,0,0,2
Morocco,12/07/2004,2,0,0,0,0,1,0,3
Morocco,13/07/2004,6,0,0,0,6,0,0,12
Morocco,14/07/2004,4,0,0,0,6,1,0,11
Morocco,15/07/2004,16,0,0,0,-2,3,0,17
Morocco,16/07/2004,9,0,0,0,3,0,0,12
Morocco,18/07/2004,15,0,0,0,12,0,0,27
Morocco,19/07/2004,0,0,0,0,0,0,0,0
Morocco,20/07/2004,5,0,0,0,3,0,0,8
Morocco,21/07/2004,0,0,0,0,3,0,0,3
Morocco,22/07/2004,7,0,0,0,0,0,0,7
Morocco,23/07/2004,3,0,0,0,0,1,0,4
Morocco,24/07/2004,0,0,0,0,0,0,0,0
Morocco,25/07/2004,0,0,0,0,0,0,0,0
Morocco,26/07/2004,0,0,0,0,3,0,0,3
Morocco,27/07/2004,-2,0,0,0,0,2,0,0
Morocco,28/07/2004,0,0,0,0,0,0,0,0
Morocco,29/07/2004,1,0,0,0,-2,0,0,-1
Morocco,30/07/2004,0,0,0,0,6,0,0,6
Morocco,31/07/2004,0,0,0,0,3,0,0,3
Morocco,01/08/2004,0,0,0,0,9,0,0,9
Morocco,02/08/2004,0,0,0,0,0,0,0,0
Morocco,03/08/2004,11,0,0,0,13,0,0,24
Morocco,04/08/2004,0,0,0,0,-6,0,0,-6
Morocco,05/08/2004,0,0,0,0,0,0,0,0
Morocco,06/08/2004,2,0,0,0,0,0,0,2
Morocco,07/08/2004,0,0,0,0,0,0,0,0
Morocco,08/08/2004,7,0,0,0,0,0,0,7
Morocco,09/08/2004,1,0,0,0,0,0,0,1
Morocco,10/08/2004,23,0,0,0,0,1,0,24
Morocco,11/08/2004,13,0,0,0,18,0,0,31
Morocco,13/08/2004,3,0,0,0,0,0,0,3
Morocco,14/08/2004,6,0,0,0,0,1,0,7
Morocco,15/08/2004,0,0,0,0,0,0,0,0
Morocco,16/08/2004,0,0,0,0,0,0,0,0
Morocco,17/08/2004,2,0,0,0,-4,0,0,-2
Morocco,18/08/2004,10,0,0,0,0,0,0,10
Morocco,19/08/2004,2,0,0,0,0,0,0,2
Morocco,20/08/2004,0,0,0,0,3,1,0,4
Morocco,21/08/2004,0,0,0,0,3,0,0,3
Morocco,22/08/2004,0,0,0,0,0,0,0,0
Morocco,23/08/2004,0,0,0,0,0,0,0,0
Morocco,24/08/2004,0,0,0,0,0,0,0,0
Morocco,25/08/2004,4,0,0,0,1,0,0,5
Morocco,26/08/2004,6,0,0,0,0,0,0,6
Morocco,27/08/2004,1,0,0,0,0,0,0,1
Morocco,28/08/2004,0,0,0,0,0,1,0,1
Morocco,30/08/2004,3,0,0,0,-4,0,0,-1
Morocco,31/08/2004,0,0,0,0,0,0,0,0
Morocco,01/09/2004,0,0,0,0,3,0,0,3
Morocco,02/09/2004,-1,0,0,0,17,0,0,16
Morocco,03/09/2004,-2,0,0,0,18,2,0,18
Morocco,04/09/2004,1,0,0,0,7,0,0,8
Morocco,05/09/2004,0,0,0,0,15,0,0,15
Morocco,06/09/2004,3,0,0,0,0,0,0,3
Morocco,07/09/2004,0,0,0,0,6,0,0,6
Morocco,08/09/2004,0,0,0,0,0,0,0,0
Morocco,09/09/2004,4,0,0,0,0,0,0,4
Morocco,10/09/2004,0,0,0,0,9,0,0,9
Morocco,12/09/2004,7,0,0,0,6,0,0,13
Morocco,13/09/2004,0,0,0,0,0,0,0,0
Morocco,14/09/2004,0,0,0,0,3,0,0,3
Morocco,15/09/2004,3,0,0,0,6,0,0,9
Morocco,17/09/2004,6,0,0,0,-4,0,0,2
Morocco,18/09/2004,0,0,0,0,6,0,0,6
Morocco,19/09/2004,0,0,0,0,0,0,0,0
Morocco,20/09/2004,-1,0,0,0,0,0,0,-1
Morocco,21/09/2004,0,0,0,0,0,0,0,0
Morocco,22/09/2004,3,0,0,0,-2,0,0,1
Morocco,23/09/2004,0,0,0,0,3,0,0,3
Morocco,24/09/2004,7,0,0,0,-1,0,0,6
Morocco,25/09/2004,8,0,0,0,0,0,0,8
Morocco,26/09/2004,0,0,0,0,0,0,0,0
Morocco,27/09/2004,1,0,0,0,6,0,0,7
Morocco,28/09/2004,0,0,0,0,3,0,0,3
Morocco,29/09/2004,0,0,0,0,6,0,0,6
Morocco,30/09/2004,4,0,0,0,0,0,0,4
Morocco,01/10/2004,2,0,0,0,0,0,0,2
Morocco,02/10/2004,-1,0,0,0,0,0,0,-1
Morocco,04/10/2004,5,0,0,0,0,0,0,5
Morocco,05/10/2004,0,0,0,0,0,0,0,0
Morocco,07/10/2004,0,0,0,0,0,0,0,0
Morocco,08/10/2004,2,0,0,0,0,0,0,2
Morocco,10/10/2004,1,0,0,0,6,0,0,7
Morocco,11/10/2004,0,0,0,0,3,2,0,5
Morocco,12/10/2004,0,0,0,0,0,0,0,0
Morocco,13/10/2004,4,0,0,0,0,0,0,4
Morocco,14/10/2004,6,0,0,0,3,0,0,9
Morocco,15/10/2004,6,0,1,0,0,0,0,7
Morocco,16/10/2004,2,0,0,0,0,0,0,2
Morocco,17/10/2004,2,0,0,0,8,1,0,11
Morocco,18/10/2004,3,0,0,0,0,1,0,4
Morocco,19/10/2004,-6,0,0,0,6,0,0,0
Morocco,20/10/2004,0,0,0,0,0,1,0,1
Morocco,21/10/2004,-3,0,0,0,0,0,0,-3
Morocco,22/10/2004,-7,0,-1,0,2,0,0,-6
Morocco,23/10/2004,0,0,0,0,6,0,0,6
Morocco,24/10/2004,0,0,0,0,6,0,0,6
Morocco,25/10/2004,0,0,0,0,0,0,0,0
Morocco,26/10/2004,0,0,0,0,0,0,0,0
Morocco,28/10/2004,-6,0,-2,0,0,1,0,-7
Morocco,29/10/2004,4,0,0,0,9,0,0,13
Morocco,30/10/2004,0,0,-2,0,0,0,0,-2
Morocco,31/10/2004,-8,0,0,0,6,0,0,-2
Morocco,01/11/2004,1,0,0,0,0,0,0,1
Morocco,02/11/2004,19,0,0,0,0,0,0,19
Morocco,03/11/2004,6,0,0,0,0,0,0,6
Morocco,04/11/2004,12,0,0,0,9,0,0,21
Morocco,05/11/2004,0,0,0,0,6,0,0,6
Morocco,06/11/2004,12,0,0,0,7,6,0,25
Morocco,07/11/2004,0,0,0,0,0,2,0,2
Morocco,08/11/2004,20,0,0,0,0,0,0,20
Morocco,09/11/2004,10,0,0,0,9,0,0,19
Morocco,10/11/2004,19,0,1,0,2,0,0,22
Morocco,11/11/2004,1,0,0,0,9,0,0,10
Morocco,12/11/2004,0,0,0,0,-2,2,0,0
Morocco,13/11/2004,1,0,0,0,0,2,0,3
Morocco,14/11/2004,0,0,0,0,0,0,0,0
Morocco,15/11/2004,0,0,0,0,0,0,0,0
Morocco,16/11/2004,18,0,0,0,15,0,0,33
Morocco,17/11/2004,3,0,0,0,6,0,0,9
Morocco,18/11/2004,5,0,0,0,0,0,0,5
Morocco,19/11/2004,3,0,0,0,6,0,0,9
Morocco,20/11/2004,0,0,0,0,0,0,0,0
Morocco,21/11/2004,0,0,0,0,0,0,0,0
Morocco,22/11/2004,0,0,0,0,0,0,0,0
Morocco,23/11/2004,0,0,0,0,3,0,0,3
Morocco,24/11/2004,0,0,0,0,0,0,0,0
Morocco,25/11/2004,6,0,0,0,3,1,0,10
Morocco,26/11/2004,3,0,0,0,3,0,0,6
Morocco,27/11/2004,-1,0,0,0,0,0,0,-1
Morocco,28/11/2004,8,0,0,0,3,0,0,11
Morocco,29/11/2004,7,0,-4,0,3,0,0,6
Morocco,30/11/2004,6,0,0,0,9,0,0,15
Morocco,01/12/2004,0,0,0,0,1,0,0,1
Morocco,02/12/2004,0,0,0,0,0,0,0,0
Morocco,03/12/2004,-1,0,0,0,0,0,0,-1
Morocco,04/12/2004,0,0,0,0,0,0,0,0
Morocco,05/12/2004,-3,0,0,0,0,0,0,-3
Morocco,06/12/2004,-3,0,0,0,3,0,0,0
Morocco,07/12/2004,0,0,0,0,0,0,0,0
Morocco,08/12/2004,0,0,0,0,0,0,0,0
Morocco,09/12/2004,6,0,0,0,0,0,0,6
Morocco,10/12/2004,4,0,0,0,0,0,0,4
Morocco,11/12/2004,0,0,0,0,0,0,0,0
Morocco,12/12/2004,0,0,0,0,0,0,0,0
Morocco,13/12/2004,6,0,0,0,0,0,0,6
Morocco,14/12/2004,0,0,0,0,9,0,0,9
Morocco,15/12/2004,5,0,0,0,7,0,0,12
Morocco,16/12/2004,-1,0,0,0,15,0,0,14
Morocco,17/12/2004,0,0,0,0,0,0,0,0
Morocco,18/12/2004,0,0,0,0,0,1,0,1
Morocco,20/12/2004,-2,0,0,0,3,0,0,1
Morocco,21/12/2004,0,0,0,0,-4,0,0,-4
Morocco,22/12/2004,4,0,0,0,0,0,0,4
Morocco,23/12/2004,0,0,0,0,-4,2,0,-2
Morocco,25/12/2004,1,0,0,0,12,0,0,13
Morocco,26/12/2004,0,0,-1,0,6,0,0,5
Morocco,27/12/2004,0,0,0,0,-4,0,0,-4
Morocco,28/12/2004,0,0,0,0,0,1,0,1
Morocco,29/12/2004,0,0,0,0,6,0,0,6
Morocco,30/12/2004,5,0,0,0,0,0,0,5
Nigeria,01/01/2004,6,0,0,0,0,1,0,7
Nigeria,02/01/2004,8,0,0,0,8,4,0,20
Nigeria,03/01/2004,1,0,2,0,5,1,0,9
Nigeria,04/01/2004,1,0,0,0,3,0,0,4
Nigeria,05/01/2004,6,0,1,0,1,0,0,8
Nigeria,06/01/2004,9,0,0,0,6,1,0,16
Nigeria,07/01/2004,4,0,0,0,15,2,0,21
Nigeria,08/01/2004,6,0,0,0,3,2,0,11
Nigeria,09/01/2004,5,0,0,0,1,0,0,6
Nigeria,10/01/2004,5,0,0,0,-2,2,0,5
Nigeria,11/01/2004,2,0,0,0,0,0,0,2
Nigeria,12/01/2004,11,2,0,0,13,2,0,28
Nigeria,13/01/2004,23,0,0,0,3,1,0,27
Nigeria,14/01/2004,22,0,0,0,13,7,0,42
Nigeria,15/01/2004,17,0,-4,0,12,3,0,28
Nigeria,16/01/2004,16,0,0,0,1,2,0,19
Nigeria,17/01/2004,0,0,-2,0,0,0,0,-2
Nigeria,18/01/2004,9,0,0,0,4,1,0,14
Nigeria,19/01/2004,25,0,0,0,6,3,0,34
Nigeria,20/01/2004,21,0,0,0,4,0,0,25
Nigeria,21/01/2004,5,0,0,0,0,0,0,5
Nigeria,22/01/2004,7,0,0,0,15,1,0,23
Nigeria,23/01/2004,6,0,0,0,3,2,0,11
Nigeria,24/01/2004,0,0,0,0,0,1,0,1
Nigeria,25/01/2004,0,0,0,0,0,0,0,0
Nigeria,26/01/2004,20,0,0,0,5,0,0,25
Nigeria,27/01/2004,11,0,0,0,-2,0,0,9
Nigeria,28/01/2004,17,0,-1,0,12,4,0,32
Nigeria,29/01/2004,17,0,0,0,0,0,0,17
Nigeria,30/01/2004,7,2,2,0,14,0,0,25
Nigeria,31/01/2004,1,0,0,0,4,1,0,6
Nigeria,01/02/2004,-1,0,0,0,0,0,0,-1
Nigeria,02/02/2004,7,0,0,0,9,4,0,20
Nigeria,03/02/2004,2,0,0,0,0,2,0,4
Nigeria,04/02/2004,12,0,0,0,0,2,0,14
Nigeria,05/02/2004,18,0,0,0,4,1,0,23
Nigeria,06/02/2004,11,0,0,0,9,0,0,20
Nigeria,07/02/2004,1,0,0,0,9,0,0,10
Nigeria,08/02/2004,5,0,0,0,9,0,0,14
Nigeria,09/02/2004,12,0,0,0,0,5,0,17
Nigeria,10/02/2004,22,4,1,0,5,0,0,32
Nigeria,11/02/2004,11,4,0,0,2,12,0,29
Nigeria,12/02/2004,4,0,0,0,6,8,0,18
Nigeria,13/02/2004,40,0,0,0,3,10,0,53
Nigeria,14/02/2004,-1,0,0,0,0,5,0,4
Nigeria,15/02/2004,0,0,0,0,0,0,0,0
Nigeria,16/02/2004,5,0,1,0,0,3,0,9
Nigeria,17/02/2004,2,0,0,0,0,6,0,8
Nigeria,18/02/2004,13,0,0,0,9,6,0,28
Nigeria,19/02/2004,12,0,0,0,5,2,0,19
Nigeria,20/02/2004,15,0,0,0,4,0,0,19
Nigeria,21/02/2004,4,0,-1,0,0,1,0,4
Nigeria,22/02/2004,8,0,1,0,2,1,0,12
Nigeria,23/02/2004,13,0,0,0,21,1,0,35
Nigeria,24/02/2004,9,0,0,0,-1,3,0,11
Nigeria,25/02/2004,20,0,0,0,6,2,0,28
Nigeria,26/02/2004,11,0,0,0,-1,2,0,12
Nigeria,27/02/2004,12,0,0,0,1,2,0,15
Nigeria,28/02/2004,2,0,0,0,1,0,0,3
Nigeria,29/02/2004,1,0,0,0,0,1,0,2
Nigeria,01/03/2004,5,0,0,0,0,3,0,8
Nigeria,02/03/2004,38,0,0,0,21,1,0,60
Nigeria,03/03/2004,8,0,-6,0,6,6,0,14
Nigeria,04/03/2004,17,0,0,0,4,2,0,23
Nigeria,05/03/2004,9,0,4,0,3,3,0,19
Nigeria,06/03/2004,7,0,0,0,12,0,0,19
Nigeria,07/03/2004,14,0,0,0,0,0,0,14
Nigeria,08/03/2004,56,0,0,0,-1,3,0,58
Nigeria,09/03/2004,5,0,1,0,5,0,0,11
Nigeria,10/03/2004,19,0,0,0,12,1,0,32
Nigeria,11/03/2004,13,0,0,0,6,7,0,26
Nigeria,12/03/2004,8,0,-4,0,12,1,0,17
Nigeria,13/03/2004,6,0,0,0,0,0,0,6
Nigeria,14/03/2004,0,0,0,0,3,0,0,3
Nigeria,15/03/2004,10,0,1,0,6,3,0,20
Nigeria,16/03/2004,18,0,2,0,6,2,0,28
Nigeria,17/03/2004,13,0,-2,0,1,1,0,13
Nigeria,18/03/2004,7,2,0,0,-1,0,0,8
Nigeria,19/03/2004,11,0,0,0,9,0,0,20
Nigeria,20/03/2004,0,0,0,0,-2,2,0,0
Nigeria,21/03/2004,4,0,0,0,0,0,0,4
Nigeria,22/03/2004,7,0,0,0,21,3,0,31
Nigeria,23/03/2004,7,0,0,0,0,0,0,7
Nigeria,24/03/2004,12,0,0,0,-1,1,0,12
Nigeria,25/03/2004,6,0,0,0,-4,0,0,2
Nigeria,26/03/2004,17,0,0,0,0,6,0,23
Nigeria,27/03/2004,0,0,0,0,0,0,0,0
Nigeria,28/03/2004,0,0,0,0,0,0,0,0
Nigeria,29/03/2004,16,0,0,0,0,0,0,16
Nigeria,30/03/2004,0,0,1,0,-3,0,0,-2
Nigeria,31/03/2004,8,0,0,0,3,6,0,17
Nigeria,01/04/2004,7,0,-3,0,3,0,0,7
Nigeria,02/04/2004,7,0,0,0,16,2,0,25
Nigeria,03/04/2004,17,0,0,0,0,0,0,17
Nigeria,04/04/2004,14,0,0,0,-2,0,0,12
Nigeria,05/04/2004,-1,0,0,0,7,1,0,7
Nigeria,06/04/2004,0,0,0,0,12,2,0,14
Nigeria,07/04/2004,3,0,0,0,0,0,0,3
Nigeria,08/04/2004,6,0,0,0,3,1,0,10
Nigeria,09/04/2004,2,0,0,0,12,0,0,14
Nigeria,10/04/2004,2,0,0,0,0,0,0,2
Nigeria,11/04/2004,4,0,0,0,0,0,0,4
Nigeria,12/04/2004,23,0,0,0,3,2,0,28
Nigeria,13/04/2004,2,0,1,0,0,0,0,3
Nigeria,14/04/2004,1,0,3,0,18,4,0,26
Nigeria,15/04/2004,14,0,1,0,0,1,0,16
Nigeria,16/04/2004,11,0,0,0,0,0,0,11
Nigeria,17/04/2004,0,0,0,0,-2,0,0,-2
Nigeria,18/04/2004,-1,0,0,0,0,0,0,-1
Nigeria,19/04/2004,6,0,0,0,4,0,0,10
Nigeria,20/04/2004,2,2,0,0,0,3,0,7
Nigeria,21/04/2004,12,0,0,0,3,0,0,15
Nigeria,22/04/2004,8,0,0,0,-2,0,0,6
Nigeria,23/04/2004,6,0,0,0,4,0,0,10
Nigeria,24/04/2004,4,0,0,0,8,0,0,12
Nigeria,25/04/2004,2,0,2,0,3,4,0,11
Nigeria,26/04/2004,6,0,0,0,1,1,0,8
Nigeria,27/04/2004,9,0,0,0,3,0,0,12
Nigeria,28/04/2004,20,2,0,0,-4,0,0,18
Nigeria,29/04/2004,3,0,0,0,1,1,0,5
Nigeria,30/04/2004,2,0,0,0,3,0,0,5
Nigeria,01/05/2004,-1,0,0,0,0,2,0,1
Nigeria,02/05/2004,20,0,0,0,0,2,0,22
Nigeria,03/05/2004,32,0,0,0,-2,1,0,31
Nigeria,04/05/2004,27,0,0,0,0,3,0,30
Nigeria,05/05/2004,7,0,0,0,9,0,0,16
Nigeria,06/05/2004,4,0,0,0,-5,7,0,6
Nigeria,07/05/2004,2,0,-3,0,-4,1,0,-4
Nigeria,08/05/2004,14,0,0,0,0,0,0,14
Nigeria,09/05/2004,0,0,0,0,3,1,0,4
Nigeria,10/05/2004,20,0,0,0,5,4,0,29
Nigeria,11/05/2004,7,0,0,0,6,2,0,15
Nigeria,12/05/2004,2,0,0,0,9,0,0,11
Nigeria,13/05/2004,10,0,1,0,2,3,0,16
Nigeria,14/05/2004,7,0,0,0,0,1,0,8
Nigeria,15/05/2004,1,0,0,0,0,0,0,1
Nigeria,16/05/2004,2,0,0,0,0,0,0,2
Nigeria,17/05/2004,-3,4,0,0,0,2,0,3
Nigeria,18/05/2004,7,0,0,0,3,0,0,10
Nigeria,19/05/2004,1,0,0,0,1,0,0,2
Nigeria,20/05/2004,18,0,0,0,-2,-4,0,12
Nigeria,21/05/2004,7,4,0,0,-8,0,0,3
Nigeria,22/05/2004,0,0,0,0,-2,0,0,-2
Nigeria,23/05/2004,14,0,0,0,0,0,0,14
Nigeria,24/05/2004,0,0,0,0,0,0,0,0
Nigeria,25/05/2004,2,0,0,0,-2,0,0,0
Nigeria,26/05/2004,2,0,0,0,0,1,0,3
Nigeria,27/05/2004,16,0,0,0,-2,5,0,19
Nigeria,28/05/2004,16,2,3,0,3,3,0,27
Nigeria,29/05/2004,0,0,0,0,0,0,0,0
Nigeria,30/05/2004,2,0,1,0,0,0,0,3
Nigeria,31/05/2004,-3,0,-2,0,11,0,0,6
Nigeria,01/06/2004,7,0,4,0,9,2,0,22
Nigeria,02/06/2004,21,4,1,0,5,2,0,33
Nigeria,03/06/2004,3,0,0,0,9,0,0,12
Nigeria,04/06/2004,5,0,0,0,9,0,0,14
Nigeria,05/06/2004,3,0,0,0,0,0,0,3
Nigeria,06/06/2004,7,0,0,0,0,0,0,7
Nigeria,07/06/2004,8,0,2,0,0,3,0,13
Nigeria,08/06/2004,7,0,0,0,8,1,0,16
Nigeria,09/06/2004,2,0,0,0,15,3,0,20
Nigeria,10/06/2004,2,0,-6,0,12,1,0,9
Nigeria,11/06/2004,9,0,0,0,0,0,0,9
Nigeria,12/06/2004,0,0,0,0,9,0,0,9
Nigeria,13/06/2004,2,0,0,0,0,0,0,2
Nigeria,14/06/2004,3,0,0,0,-1,0,0,2
Nigeria,15/06/2004,3,0,0,0,0,1,0,4
Nigeria,16/06/2004,19,0,3,0,6,1,0,29
Nigeria,17/06/2004,14,0,0,0,7,1,0,22
Nigeria,18/06/2004,0,0,0,0,0,1,0,1
Nigeria,19/06/2004,8,0,0,0,0,0,0,8
Nigeria,20/06/2004,17,0,0,0,0,0,0,17
Nigeria,21/06/2004,24,0,0,0,0,1,0,25
Nigeria,22/06/2004,8,0,0,0,0,0,0,8
Nigeria,23/06/2004,17,0,0,0,2,0,0,19
Nigeria,24/06/2004,14,0,1,0,3,1,0,19
Nigeria,25/06/2004,21,0,0,0,7,2,0,30
Nigeria,26/06/2004,4,0,0,0,3,4,0,11
Nigeria,27/06/2004,0,0,0,0,0,0,0,0
Nigeria,28/06/2004,-1,0,0,0,2,0,0,1
Nigeria,29/06/2004,12,0,2,0,8,1,0,23
Nigeria,30/06/2004,12,0,0,0,-1,2,0,13
Nigeria,01/07/2004,8,0,0,0,0,3,0,11
Nigeria,02/07/2004,3,0,0,0,0,0,0,3
Nigeria,03/07/2004,3,0,0,0,0,0,0,3
Nigeria,04/07/2004,2,0,0,0,0,0,0,2
Nigeria,05/07/2004,10,0,1,0,4,1,0,16
Nigeria,06/07/2004,14,2,-2,0,1,0,0,15
Nigeria,07/07/2004,16,0,-2,0,-1,2,0,15
Nigeria,08/07/2004,11,0,0,0,17,0,0,28
Nigeria,09/07/2004,6,0,0,0,-2,2,0,6
Nigeria,10/07/2004,7,0,0,0,0,0,0,7
Nigeria,11/07/2004,0,0,0,0,0,0,0,0
Nigeria,12/07/2004,1,0,0,0,4,0,0,5
Nigeria,13/07/2004,10,0,0,0,18,0,0,28
Nigeria,14/07/2004,-3,0,0,0,7,2,0,6
Nigeria,15/07/2004,17,0,-2,0,1,2,0,18
Nigeria,16/07/2004,16,0,0,0,-2,0,0,14
Nigeria,17/07/2004,4,0,0,0,-4,1,0,1
Nigeria,18/07/2004,1,0,0,0,0,0,0,1
Nigeria,19/07/2004,15,0,0,0,6,1,0,22
Nigeria,20/07/2004,13,0,0,0,6,0,0,19
Nigeria,21/07/2004,11,2,1,0,18,1,0,33
Nigeria,22/07/2004,18,0,0,0,6,2,0,26
Nigeria,23/07/2004,5,0,2,0,0,2,0,9
Nigeria,24/07/2004,9,0,0,0,-2,0,0,7
Nigeria,25/07/2004,7,0,0,0,0,0,0,7
Nigeria,26/07/2004,11,0,-2,0,-2,3,0,10
Nigeria,27/07/2004,12,0,-1,0,6,4,0,21
Nigeria,28/07/2004,9,0,0,0,0,5,0,14
Nigeria,29/07/2004,-4,0,0,0,0,2,0,-2
Nigeria,30/07/2004,11,0,0,0,3,1,0,15
Nigeria,31/07/2004,2,0,0,0,0,0,0,2
Nigeria,01/08/2004,0,0,0,0,0,0,0,0
Nigeria,02/08/2004,3,0,0,0,0,0,0,3
Nigeria,03/08/2004,31,2,0,0,3,1,0,37
Nigeria,04/08/2004,17,0,-2,0,11,4,0,30
Nigeria,05/08/2004,26,0,-3,0,7,4,0,34
Nigeria,06/08/2004,27,2,0,0,-3,2,0,28
Nigeria,07/08/2004,9,0,0,0,6,0,0,15
Nigeria,08/08/2004,7,0,0,0,0,0,0,7
Nigeria,09/08/2004,10,0,-4,0,3,1,0,10
Nigeria,10/08/2004,12,0,1,0,7,1,0,21
Nigeria,11/08/2004,16,4,0,0,-6,3,0,17
Nigeria,12/08/2004,8,0,0,0,6,0,0,14
Nigeria,13/08/2004,24,0,0,0,6,1,0,31
Nigeria,14/08/2004,-3,0,1,0,0,0,0,-2
Nigeria,15/08/2004,8,0,0,0,0,8,0,16
Nigeria,16/08/2004,14,0,0,0,6,0,0,20
Nigeria,17/08/2004,15,0,0,0,-2,2,0,15
Nigeria,18/08/2004,26,2,0,0,6,5,0,39
Nigeria,19/08/2004,19,0,0,0,10,1,0,30
Nigeria,20/08/2004,31,2,0,0,7,0,0,40
Nigeria,21/08/2004,24,0,0,0,3,5,0,32
Nigeria,22/08/2004,12,0,0,0,3,3,0,18
Nigeria,23/08/2004,7,0,0,0,6,4,0,17
Nigeria,24/08/2004,11,0,1,0,0,0,0,12
Nigeria,25/08/2004,9,0,0,0,3,3,0,15
Nigeria,26/08/2004,18,0,0,0,7,0,0,25
Nigeria,27/08/2004,12,0,1,0,6,3,0,22
Nigeria,28/08/2004,9,0,0,0,6,2,0,17
Nigeria,29/08/2004,13,0,-1,0,-2,0,0,10
Nigeria,30/08/2004,28,0,0,0,3,4,0,35
Nigeria,31/08/2004,13,0,0,0,7,3,0,23
Nigeria,01/09/2004,20,0,-1,0,13,2,0,34
Nigeria,02/09/2004,6,0,0,0,10,0,0,16
Nigeria,03/09/2004,6,0,0,0,3,1,0,10
Nigeria,04/09/2004,3,0,0,0,2,2,0,7
Nigeria,05/09/2004,4,0,0,0,4,1,0,9
Nigeria,06/09/2004,8,0,0,0,9,8,0,25
Nigeria,07/09/2004,8,0,0,0,6,0,0,14
Nigeria,08/09/2004,6,0,0,0,6,0,0,12
Nigeria,09/09/2004,6,0,0,0,12,1,0,19
Nigeria,10/09/2004,13,0,0,0,1,2,0,16
Nigeria,11/09/2004,1,0,-4,0,6,0,0,3
Nigeria,12/09/2004,3,0,-1,0,3,0,0,5
Nigeria,13/09/2004,23,2,1,0,9,2,0,37
Nigeria,14/09/2004,19,0,0,0,4,0,0,23
Nigeria,15/09/2004,33,0,0,0,0,0,0,33
Nigeria,16/09/2004,8,0,0,0,1,0,0,9
Nigeria,17/09/2004,10,0,0,0,7,4,0,21
Nigeria,18/09/2004,8,0,0,0,0,0,0,8
Nigeria,19/09/2004,2,0,0,0,3,0,0,5
Nigeria,20/09/2004,16,4,0,0,12,0,0,32
Nigeria,21/09/2004,22,0,0,0,8,3,0,33
Nigeria,22/09/2004,10,0,0,0,-1,1,0,10
Nigeria,23/09/2004,17,2,0,0,12,1,0,32
Nigeria,24/09/2004,8,2,0,0,3,3,0,16
Nigeria,25/09/2004,13,4,-2,0,-4,0,0,11
Nigeria,26/09/2004,9,0,0,0,9,1,0,19
Nigeria,27/09/2004,16,0,0,0,-4,2,0,14
Nigeria,28/09/2004,18,4,1,0,8,1,0,32
Nigeria,29/09/2004,19,6,0,0,3,6,0,34
Nigeria,30/09/2004,24,0,0,0,6,2,0,32
Nigeria,01/10/2004,24,0,0,0,-2,0,0,22
Nigeria,02/10/2004,3,0,0,0,3,0,0,6
Nigeria,03/10/2004,0,0,0,0,0,0,0,0
Nigeria,04/10/2004,4,0,-2,0,2,0,0,4
Nigeria,05/10/2004,25,0,0,0,0,1,0,26
Nigeria,06/10/2004,4,0,0,0,0,0,0,4
Nigeria,07/10/2004,16,0,0,0,4,3,0,23
Nigeria,08/10/2004,28,0,0,0,-2,3,0,29
Nigeria,09/10/2004,3,0,0,0,9,0,0,12
Nigeria,10/10/2004,0,0,0,0,0,0,0,0
Nigeria,11/10/2004,15,0,0,0,1,1,0,17
Nigeria,12/10/2004,6,0,0,0,1,0,0,7
Nigeria,13/10/2004,11,0,0,0,3,0,0,14
Nigeria,14/10/2004,4,0,0,0,0,0,0,4
Nigeria,15/10/2004,11,0,0,0,0,3,0,14
Nigeria,16/10/2004,3,0,0,0,0,2,0,5
Nigeria,17/10/2004,2,0,0,0,0,0,0,2
Nigeria,18/10/2004,25,0,0,0,0,1,0,26
Nigeria,19/10/2004,14,0,0,0,9,1,0,24
Nigeria,20/10/2004,22,0,0,0,6,12,0,40
Nigeria,21/10/2004,9,0,0,0,6,5,0,20
Nigeria,22/10/2004,17,0,0,0,3,1,0,21
Nigeria,23/10/2004,10,0,0,0,0,0,0,10
Nigeria,24/10/2004,10,0,0,0,0,2,0,12
Nigeria,25/10/2004,18,0,0,0,4,4,0,26
Nigeria,26/10/2004,18,0,0,0,3,1,0,22
Nigeria,27/10/2004,21,0,0,0,-2,3,0,22
Nigeria,28/10/2004,10,0,0,0,-4,0,0,6
Nigeria,29/10/2004,38,0,0,0,15,2,0,55
Nigeria,30/10/2004,4,0,0,0,-2,0,0,2
Nigeria,31/10/2004,3,0,-2,0,1,5,0,7
Nigeria,01/11/2004,13,4,-4,0,0,3,0,16
Nigeria,02/11/2004,7,2,0,0,-3,1,0,7
Nigeria,03/11/2004,14,0,0,0,3,0,0,17
Nigeria,04/11/2004,12,0,0,0,15,10,0,37
Nigeria,05/11/2004,4,0,0,0,1,0,0,5
Nigeria,06/11/2004,8,0,0,0,0,2,0,10
Nigeria,07/11/2004,9,0,0,0,0,3,0,12
Nigeria,08/11/2004,9,0,0,0,15,0,0,24
Nigeria,09/11/2004,7,0,0,0,0,3,0,10
Nigeria,10/11/2004,1,2,0,0,2,7,0,12
Nigeria,11/11/2004,12,0,0,0,3,0,0,15
Nigeria,12/11/2004,9,0,0,0,0,0,0,9
Nigeria,13/11/2004,1,0,0,0,0,1,0,2
Nigeria,14/11/2004,8,0,0,0,3,1,0,12
Nigeria,15/11/2004,5,2,0,0,0,2,0,9
Nigeria,16/11/2004,8,0,0,0,0,2,0,10
Nigeria,17/11/2004,3,0,0,0,3,0,0,6
Nigeria,18/11/2004,15,0,-1,0,1,0,0,15
Nigeria,19/11/2004,7,0,2,0,-3,2,0,8
Nigeria,20/11/2004,3,0,0,0,0,1,0,4
Nigeria,21/11/2004,9,2,0,0,0,0,0,11
Nigeria,22/11/2004,17,0,0,0,-2,2,0,17
Nigeria,23/11/2004,12,0,-2,0,0,3,0,13
Nigeria,24/11/2004,30,0,0,0,0,0,0,30
Nigeria,25/11/2004,1,0,1,0,12,1,0,15
Nigeria,26/11/2004,0,0,0,0,0,0,0,0
Nigeria,27/11/2004,5,0,0,0,1,1,0,7
Nigeria,28/11/2004,9,0,-2,0,6,1,0,14
Nigeria,29/11/2004,7,0,0,0,7,0,0,14
Nigeria,30/11/2004,6,0,0,0,6,1,0,13
Nigeria,01/12/2004,5,2,0,0,3,2,0,12
Nigeria,02/12/2004,1,0,0,0,6,0,0,7
Nigeria,03/12/2004,14,0,0,0,15,1,0,30
Nigeria,04/12/2004,9,0,0,0,0,0,0,9
Nigeria,05/12/2004,4,0,-1,0,4,0,0,7
Nigeria,06/12/2004,7,0,0,0,9,2,0,18
Nigeria,07/12/2004,15,0,0,0,12,8,0,35
Nigeria,08/12/2004,9,2,-1,0,1,0,0,11
Nigeria,09/12/2004,9,0,0,0,8,5,0,22
Nigeria,10/12/2004,5,0,0,0,0,0,0,5
Nigeria,11/12/2004,14,0,0,0,12,2,0,28
Nigeria,12/12/2004,19,0,1,0,1,1,0,22
Nigeria,13/12/2004,2,0,-1,0,0,0,0,1
Nigeria,14/12/2004,4,0,0,0,-2,2,0,4
Nigeria,15/12/2004,-3,0,1,0,1,0,0,-1
Nigeria,16/12/2004,12,2,0,0,0,1,0,15
Nigeria,17/12/2004,2,0,0,0,-6,1,0,-3
Nigeria,18/12/2004,-1,0,0,0,0,2,0,1
Nigeria,19/12/2004,7,0,0,0,9,1,0,17
Nigeria,20/12/2004,4,0,0,0,1,1,0,6
Nigeria,21/12/2004,8,0,0,0,-2,0,0,6
Nigeria,22/12/2004,4,6,0,0,1,3,0,14
Nigeria,23/12/2004,13,0,0,0,4,2,0,19
Nigeria,24/12/2004,12,0,0,0,0,0,0,12
Nigeria,25/12/2004,1,2,0,0,0,0,0,3
Nigeria,26/12/2004,0,0,0,0,-2,0,0,-2
Nigeria,27/12/2004,5,0,0,0,3,0,0,8
Nigeria,28/12/2004,11,0,0,0,0,4,0,15
Nigeria,29/12/2004,11,0,0,0,7,1,0,19
Nigeria,30/12/2004,16,0,0,0,15,5,0,36
Nigeria,31/12/2004,6,0,0,0,0,2,0,8
Pakistan,01/01/2004,44,0,0,0,0,0,0,44
Pakistan,02/01/2004,0,0,0,0,0,0,0,0
Pakistan,03/01/2004,2,0,0,0,0,0,0,2
Pakistan,04/01/2004,6,0,0,0,0,0,0,6
Pakistan,05/01/2004,11,0,0,0,12,0,0,23
Pakistan,06/01/2004,3,0,0,0,0,0,0,3
Pakistan,07/01/2004,4,0,0,0,-2,1,0,3
Pakistan,08/01/2004,10,0,0,0,30,0,0,40
Pakistan,09/01/2004,6,0,0,0,0,0,0,6
Pakistan,10/01/2004,9,0,0,0,3,0,0,12
Pakistan,11/01/2004,15,0,0,0,-6,1,0,10
Pakistan,12/01/2004,34,0,1,0,-6,5,0,34
Pakistan,13/01/2004,9,0,0,0,7,1,0,17
Pakistan,14/01/2004,2,0,0,0,8,0,0,10
Pakistan,15/01/2004,21,0,0,0,-24,6,0,3
Pakistan,16/01/2004,58,0,0,0,0,1,0,59
Pakistan,17/01/2004,15,0,0,0,6,7,0,28
Pakistan,18/01/2004,12,0,0,0,1,0,0,13
Pakistan,19/01/2004,6,0,0,0,-11,2,0,-3
Pakistan,20/01/2004,33,0,3,0,12,8,0,56
Pakistan,21/01/2004,2,0,0,0,22,0,0,24
Pakistan,22/01/2004,9,0,1,0,28,0,0,38
Pakistan,23/01/2004,13,0,0,0,15,0,0,28
Pakistan,24/01/2004,19,0,0,0,26,0,0,45
Pakistan,25/01/2004,5,0,0,0,3,0,0,8
Pakistan,26/01/2004,20,0,0,0,1,0,0,21
Pakistan,27/01/2004,38,0,0,0,15,2,0,55
Pakistan,28/01/2004,15,0,1,0,3,3,0,22
Pakistan,29/01/2004,47,0,0,0,19,0,0,66
Pakistan,30/01/2004,23,0,0,0,1,0,0,24
Pakistan,31/01/2004,25,0,0,0,10,1,0,36
Pakistan,01/02/2004,0,0,0,0,3,0,0,3
Pakistan,02/02/2004,48,0,0,0,-12,1,0,37
Pakistan,03/02/2004,62,0,1,0,9,2,0,74
Pakistan,04/02/2004,65,0,0,0,23,0,0,88
Pakistan,05/02/2004,54,0,0,0,26,2,0,82
Pakistan,06/02/2004,47,0,1,0,37,5,0,90
Pakistan,07/02/2004,37,0,0,0,1,1,0,39
Pakistan,08/02/2004,29,0,0,0,3,4,0,36
Pakistan,09/02/2004,46,0,0,0,18,1,0,65
Pakistan,10/02/2004,71,0,0,0,0,2,0,73
Pakistan,11/02/2004,25,0,0,0,15,0,0,40
Pakistan,12/02/2004,11,0,0,0,7,1,0,19
Pakistan,13/02/2004,31,4,0,0,0,4,0,39
Pakistan,14/02/2004,12,0,0,0,3,2,0,17
Pakistan,15/02/2004,17,0,0,0,6,0,0,23
Pakistan,16/02/2004,19,0,3,0,12,4,0,38
Pakistan,17/02/2004,13,0,0,0,6,2,0,21
Pakistan,18/02/2004,15,0,0,0,3,0,0,18
Pakistan,19/02/2004,1,0,0,0,6,0,0,7
Pakistan,20/02/2004,12,0,0,0,13,4,0,29
Pakistan,21/02/2004,10,0,0,0,25,2,0,37
Pakistan,22/02/2004,7,0,0,0,6,1,0,14
Pakistan,23/02/2004,20,0,0,0,1,2,0,23
Pakistan,24/02/2004,53,0,1,0,6,7,0,67
Pakistan,25/02/2004,13,0,0,0,6,0,0,19
Pakistan,26/02/2004,13,0,-2,0,20,0,0,31
Pakistan,27/02/2004,17,0,0,0,1,-2,0,16
Pakistan,28/02/2004,16,0,0,0,30,0,0,46
Pakistan,29/02/2004,22,0,0,0,9,4,0,35
Pakistan,01/03/2004,16,0,-1,0,12,2,0,29
Pakistan,02/03/2004,96,0,0,0,36,10,0,142
Pakistan,03/03/2004,42,0,0,0,14,10,0,66
Pakistan,04/03/2004,31,0,0,0,33,2,0,66
Pakistan,05/03/2004,3,0,1,0,21,7,0,32
Pakistan,06/03/2004,9,0,0,0,0,0,0,9
Pakistan,07/03/2004,18,0,0,0,0,0,0,18
Pakistan,08/03/2004,17,0,0,0,8,2,0,27
Pakistan,09/03/2004,16,0,-1,0,-2,2,0,15
Pakistan,10/03/2004,11,0,0,0,-2,0,0,9
Pakistan,11/03/2004,12,0,1,0,12,3,0,28
Pakistan,12/03/2004,25,0,1,0,15,2,0,43
Pakistan,13/03/2004,11,0,0,0,12,2,0,25
Pakistan,14/03/2004,17,0,0,0,15,0,0,32
Pakistan,15/03/2004,17,0,0,0,1,0,0,18
Pakistan,16/03/2004,14,0,-1,0,12,0,0,25
Pakistan,17/03/2004,37,0,0,0,5,1,0,43
Pakistan,18/03/2004,10,0,1,0,7,5,0,23
Pakistan,19/03/2004,61,0,0,0,0,0,0,61
Pakistan,20/03/2004,12,0,0,0,12,3,0,27
Pakistan,21/03/2004,26,0,0,0,15,4,0,45
Pakistan,22/03/2004,9,0,0,0,37,8,0,54
Pakistan,23/03/2004,19,0,0,0,8,6,0,33
Pakistan,24/03/2004,50,0,0,0,0,0,0,50
Pakistan,25/03/2004,13,0,0,0,9,2,0,24
Pakistan,26/03/2004,17,0,0,0,12,0,0,29
Pakistan,27/03/2004,6,0,0,0,6,4,0,16
Pakistan,28/03/2004,24,0,0,0,3,0,0,27
Pakistan,29/03/2004,26,0,0,0,0,1,0,27
Pakistan,30/03/2004,24,0,0,0,4,0,0,28
Pakistan,31/03/2004,-3,0,0,0,12,11,0,20
Pakistan,01/04/2004,4,0,-1,0,12,0,0,15
Pakistan,02/04/2004,12,0,0,0,15,0,0,27
Pakistan,03/04/2004,0,0,0,0,12,0,0,12
Pakistan,04/04/2004,30,0,0,0,1,0,0,31
Pakistan,05/04/2004,2,0,0,0,4,0,0,6
Pakistan,06/04/2004,18,0,0,0,6,0,0,24
Pakistan,07/04/2004,27,0,0,0,12,1,0,40
Pakistan,08/04/2004,34,0,0,0,24,3,0,61
Pakistan,09/04/2004,16,0,-2,0,13,4,0,31
Pakistan,10/04/2004,0,0,0,0,10,0,0,10
Pakistan,11/04/2004,3,0,0,0,0,0,0,3
Pakistan,12/04/2004,11,6,0,0,-8,0,0,9
Pakistan,13/04/2004,32,0,0,0,3,0,0,35
Pakistan,14/04/2004,6,0,0,0,27,9,0,42
Pakistan,15/04/2004,13,0,0,0,3,2,0,18
Pakistan,16/04/2004,6,0,0,0,3,2,0,11
Pakistan,17/04/2004,19,0,-1,0,3,2,0,23
Pakistan,18/04/2004,9,4,0,0,6,1,0,20
Pakistan,19/04/2004,15,0,0,0,8,5,0,28
Pakistan,20/04/2004,0,0,0,0,41,2,0,43
Pakistan,21/04/2004,27,0,0,0,4,8,0,39
Pakistan,22/04/2004,13,0,0,0,9,4,0,26
Pakistan,23/04/2004,12,0,0,0,-2,0,0,10
Pakistan,24/04/2004,4,0,0,0,6,1,0,11
Pakistan,25/04/2004,14,0,-2,0,6,0,0,18
Pakistan,26/04/2004,9,0,0,0,-1,5,0,13
Pakistan,27/04/2004,14,0,0,0,3,2,0,19
Pakistan,28/04/2004,10,0,0,0,3,0,0,13
Pakistan,29/04/2004,8,0,0,0,-2,0,0,6
Pakistan,30/04/2004,36,0,0,0,5,8,0,49
Pakistan,01/05/2004,21,0,0,0,3,10,0,34
Pakistan,02/05/2004,12,0,0,0,9,1,0,22
Pakistan,03/05/2004,19,0,0,0,14,0,0,33
Pakistan,04/05/2004,51,0,0,0,7,0,0,58
Pakistan,05/05/2004,19,0,0,0,-6,8,0,21
Pakistan,06/05/2004,12,0,0,0,15,0,0,27
Pakistan,07/05/2004,4,0,0,0,21,0,0,25
Pakistan,08/05/2004,18,0,0,0,9,0,0,27
Pakistan,09/05/2004,8,0,0,0,-8,0,0,0
Pakistan,10/05/2004,8,0,0,0,6,3,0,17
Pakistan,11/05/2004,24,0,-1,0,6,5,0,34
Pakistan,12/05/2004,32,0,0,0,15,10,0,57
Pakistan,13/05/2004,22,0,-3,0,13,0,0,32
Pakistan,14/05/2004,6,0,0,0,0,3,0,9
Pakistan,15/05/2004,11,0,0,0,-3,0,0,8
Pakistan,16/05/2004,0,0,0,0,3,0,0,3
Pakistan,17/05/2004,5,4,0,0,-4,0,0,5
Pakistan,18/05/2004,15,0,-1,0,1,1,0,16
Pakistan,19/05/2004,46,0,0,0,6,7,0,59
Pakistan,20/05/2004,50,0,0,0,2,3,0,55
Pakistan,21/05/2004,11,0,0,0,6,-2,0,15
Pakistan,22/05/2004,14,0,2,0,6,1,0,23
Pakistan,23/05/2004,2,0,0,0,0,1,0,3
Pakistan,24/05/2004,12,0,0,0,10,0,0,22
Pakistan,25/05/2004,5,0,0,0,9,0,0,14
Pakistan,26/05/2004,18,0,0,0,18,0,0,36
Pakistan,27/05/2004,31,0,0,0,6,2,0,39
Pakistan,28/05/2004,0,0,0,0,30,1,0,31
Pakistan,29/05/2004,34,0,0,0,24,3,0,61
Pakistan,30/05/2004,3,0,0,0,0,0,0,3
Pakistan,31/05/2004,22,0,0,0,3,4,0,29
Pakistan,01/06/2004,15,0,0,0,6,0,0,21
Pakistan,02/06/2004,8,0,0,0,4,1,0,13
Pakistan,03/06/2004,43,0,-3,0,6,1,0,47
Pakistan,04/06/2004,3,0,0,0,21,0,0,24
Pakistan,05/06/2004,28,0,0,0,-2,0,0,26
Pakistan,06/06/2004,32,0,0,0,3,0,0,35
Pakistan,07/06/2004,30,0,-1,0,6,2,0,37
Pakistan,08/06/2004,14,0,0,0,3,0,0,17
Pakistan,09/06/2004,18,0,0,0,3,0,0,21
Pakistan,10/06/2004,52,0,0,0,0,3,0,55
Pakistan,11/06/2004,46,0,0,0,12,0,0,58
Pakistan,12/06/2004,68,0,0,0,5,4,0,77
Pakistan,13/06/2004,9,0,0,0,27,0,0,36
Pakistan,14/06/2004,22,0,-4,0,39,0,0,57
Pakistan,15/06/2004,37,0,0,0,18,3,0,58
Pakistan,16/06/2004,13,0,0,0,10,0,0,23
Pakistan,17/06/2004,15,0,2,0,20,0,0,37
Pakistan,18/06/2004,33,0,0,0,3,0,0,36
Pakistan,19/06/2004,26,0,0,0,12,2,0,40
Pakistan,20/06/2004,19,0,0,0,6,0,0,25
Pakistan,21/06/2004,9,0,0,0,3,0,0,12
Pakistan,22/06/2004,11,2,0,0,6,-1,0,18
Pakistan,23/06/2004,24,0,0,0,6,1,0,31
Pakistan,24/06/2004,6,0,0,0,0,0,0,6
Pakistan,25/06/2004,8,8,1,0,-2,0,0,15
Pakistan,26/06/2004,15,0,-6,0,0,4,0,13
Pakistan,27/06/2004,2,0,1,0,0,3,0,6
Pakistan,28/06/2004,35,0,0,0,17,4,0,56
Pakistan,29/06/2004,6,0,-2,0,22,0,0,26
Pakistan,30/06/2004,12,0,0,0,5,3,0,20
Pakistan,01/07/2004,22,0,0,0,12,11,0,45
Pakistan,02/07/2004,19,0,0,0,1,0,0,20
Pakistan,03/07/2004,18,0,0,0,1,0,0,19
Pakistan,04/07/2004,0,0,0,0,6,0,0,6
Pakistan,05/07/2004,6,0,0,0,4,1,0,11
Pakistan,06/07/2004,15,0,0,0,19,0,0,34
Pakistan,07/07/2004,12,0,-3,0,23,0,0,32
Pakistan,08/07/2004,11,0,-8,0,33,1,0,37
Pakistan,09/07/2004,-1,0,0,0,30,1,0,30
Pakistan,10/07/2004,16,0,0,0,3,1,0,20
Pakistan,11/07/2004,11,0,0,0,-1,0,0,10
Pakistan,12/07/2004,25,0,0,0,1,0,0,26
Pakistan,13/07/2004,16,0,0,0,21,0,0,37
Pakistan,14/07/2004,7,0,0,0,33,0,0,40
Pakistan,15/07/2004,0,0,1,0,23,0,0,24
Pakistan,16/07/2004,1,0,1,0,13,0,0,15
Pakistan,17/07/2004,2,0,0,0,-4,0,0,-2
Pakistan,18/07/2004,6,0,0,0,9,2,0,17
Pakistan,19/07/2004,12,0,0,0,4,0,0,16
Pakistan,20/07/2004,4,0,0,0,-4,1,0,1
Pakistan,21/07/2004,0,0,0,0,-1,6,0,5
Pakistan,22/07/2004,2,0,0,0,3,0,0,5
Pakistan,23/07/2004,1,0,0,0,0,2,0,3
Pakistan,24/07/2004,23,0,0,0,3,0,0,26
Pakistan,25/07/2004,8,0,0,0,1,2,0,11
Pakistan,26/07/2004,18,0,0,0,16,4,0,38
Pakistan,27/07/2004,37,0,1,0,9,1,0,48
Pakistan,28/07/2004,35,0,0,0,-4,1,0,32
Pakistan,29/07/2004,14,0,0,0,13,6,0,33
Pakistan,30/07/2004,13,0,0,0,9,24,0,46
Pakistan,31/07/2004,3,0,0,0,7,1,0,11
Pakistan,01/08/2004,18,0,0,0,6,1,0,25
Pakistan,02/08/2004,22,0,0,0,30,1,0,53
Pakistan,03/08/2004,41,0,0,0,15,1,0,57
Pakistan,04/08/2004,19,4,0,0,21,3,0,47
Pakistan,05/08/2004,16,0,0,0,31,2,0,49
Pakistan,06/08/2004,57,0,0,0,37,6,0,100
Pakistan,07/08/2004,37,0,0,0,25,0,0,62
Pakistan,08/08/2004,17,2,0,0,36,0,0,55
Pakistan,09/08/2004,24,0,0,0,16,0,0,40
Pakistan,10/08/2004,21,0,0,0,10,6,0,37
Pakistan,11/08/2004,17,0,0,0,5,0,0,22
Pakistan,12/08/2004,11,0,0,0,15,0,0,26
Pakistan,13/08/2004,12,4,0,0,2,0,0,18
Pakistan,14/08/2004,0,0,0,0,18,0,0,18
Pakistan,15/08/2004,29,0,0,0,-2,0,0,27
Pakistan,16/08/2004,5,0,0,0,5,0,0,10
Pakistan,17/08/2004,5,0,0,0,30,0,0,35
Pakistan,18/08/2004,8,0,0,0,3,0,0,11
Pakistan,19/08/2004,-2,0,-1,0,3,0,0,0
Pakistan,20/08/2004,12,0,0,0,6,0,0,18
Pakistan,21/08/2004,17,0,0,0,12,0,0,29
Pakistan,22/08/2004,6,0,0,0,4,0,0,10
Pakistan,23/08/2004,11,0,0,0,0,0,0,11
Pakistan,24/08/2004,11,0,0,0,16,1,0,28
Pakistan,25/08/2004,17,0,-2,0,1,0,0,16
Pakistan,26/08/2004,4,0,-6,0,9,0,0,7
Pakistan,27/08/2004,5,0,0,0,6,3,0,14
Pakistan,28/08/2004,6,0,0,0,9,0,0,15
Pakistan,29/08/2004,1,0,0,0,12,1,0,14
Pakistan,30/08/2004,21,0,0,0,21,0,0,42
Pakistan,31/08/2004,13,0,0,0,0,0,0,13
Pakistan,01/09/2004,8,0,0,0,8,0,0,16
Pakistan,02/09/2004,37,0,-2,0,12,0,0,47
Pakistan,03/09/2004,5,0,0,0,8,0,0,13
Pakistan,04/09/2004,15,0,1,0,6,0,0,22
Pakistan,05/09/2004,13,0,0,0,3,4,0,20
Pakistan,06/09/2004,5,0,0,0,3,0,0,8
Pakistan,07/09/2004,6,0,0,0,6,0,0,12
Pakistan,08/09/2004,1,0,0,0,2,0,0,3
Pakistan,09/09/2004,18,0,0,0,6,6,0,30
Pakistan,10/09/2004,28,0,0,0,2,2,0,32
Pakistan,11/09/2004,21,0,1,0,6,0,0,28
Pakistan,12/09/2004,18,0,0,0,-20,0,0,-2
Pakistan,13/09/2004,-3,0,1,0,-1,2,0,-1
Pakistan,14/09/2004,7,0,-1,0,10,2,0,18
Pakistan,15/09/2004,24,0,-4,0,27,1,0,48
Pakistan,16/09/2004,11,0,-3,0,2,-1,0,9
Pakistan,17/09/2004,14,0,0,0,0,4,0,18
Pakistan,18/09/2004,26,0,0,0,-6,0,0,20
Pakistan,19/09/2004,2,0,0,0,-6,0,0,-4
Pakistan,20/09/2004,5,0,-2,0,-6,1,0,-2
Pakistan,21/09/2004,8,0,0,0,10,0,0,18
Pakistan,22/09/2004,20,0,1,0,-12,3,0,12
Pakistan,23/09/2004,27,0,-2,0,12,0,0,37
Pakistan,24/09/2004,23,0,-2,0,3,-4,0,20
Pakistan,25/09/2004,26,0,0,0,9,4,0,39
Pakistan,26/09/2004,2,0,0,0,4,0,0,6
Pakistan,27/09/2004,2,0,0,0,-2,1,0,1
Pakistan,28/09/2004,13,0,0,0,0,3,0,16
Pakistan,29/09/2004,9,0,0,0,1,0,0,10
Pakistan,30/09/2004,23,0,3,0,-2,1,0,25
Pakistan,01/10/2004,4,0,0,0,12,0,0,16
Pakistan,02/10/2004,9,0,0,0,0,1,0,10
Pakistan,03/10/2004,0,0,0,0,0,0,0,0
Pakistan,04/10/2004,24,0,0,0,-4,0,0,20
Pakistan,05/10/2004,12,0,0,0,10,0,0,22
Pakistan,06/10/2004,6,2,0,0,12,0,0,20
Pakistan,07/10/2004,23,0,0,0,17,5,0,45
Pakistan,08/10/2004,55,0,0,0,6,1,0,62
Pakistan,09/10/2004,10,0,0,0,6,4,0,20
Pakistan,10/10/2004,1,0,0,0,10,1,0,12
Pakistan,11/10/2004,25,0,0,0,15,2,0,42
Pakistan,12/10/2004,2,0,-4,0,2,0,0,0
Pakistan,13/10/2004,14,0,1,0,-2,1,0,14
Pakistan,14/10/2004,10,0,0,0,1,0,0,11
Pakistan,15/10/2004,8,0,0,0,4,1,0,13
Pakistan,16/10/2004,0,0,0,0,9,0,0,9
Pakistan,17/10/2004,0,0,0,0,0,0,0,0
Pakistan,18/10/2004,17,0,0,0,3,1,0,21
Pakistan,19/10/2004,20,0,0,0,30,6,0,56
Pakistan,20/10/2004,12,0,0,0,2,0,0,14
Pakistan,21/10/2004,0,0,-2,0,5,2,0,5
Pakistan,22/10/2004,12,0,0,0,9,1,0,22
Pakistan,23/10/2004,15,0,0,0,-14,0,0,1
Pakistan,24/10/2004,0,0,0,0,-1,0,0,-1
Pakistan,25/10/2004,12,0,0,0,-5,1,0,8
Pakistan,26/10/2004,20,0,0,0,0,1,0,21
Pakistan,27/10/2004,32,0,0,0,6,5,0,43
Pakistan,28/10/2004,4,0,0,0,9,0,0,13
Pakistan,29/10/2004,5,0,0,0,29,2,0,36
Pakistan,30/10/2004,11,0,0,0,3,2,0,16
Pakistan,31/10/2004,2,0,0,0,-2,0,0,0
Pakistan,01/11/2004,7,0,0,0,6,2,0,15
Pakistan,02/11/2004,4,0,0,0,3,1,0,8
Pakistan,03/11/2004,7,0,0,0,6,0,0,13
Pakistan,04/11/2004,17,0,0,0,0,0,0,17
Pakistan,05/11/2004,0,0,0,0,6,1,0,7
Pakistan,06/11/2004,46,0,0,0,9,0,0,55
Pakistan,07/11/2004,12,0,0,0,18,0,0,30
Pakistan,08/11/2004,21,0,0,0,0,3,0,24
Pakistan,09/11/2004,3,0,0,0,0,0,0,3
Pakistan,10/11/2004,6,0,0,0,15,0,0,21
Pakistan,11/11/2004,10,0,0,0,12,0,0,22
Pakistan,12/11/2004,20,0,0,0,0,0,0,20
Pakistan,13/11/2004,9,0,0,0,7,4,0,20
Pakistan,14/11/2004,1,0,0,0,0,0,0,1
Pakistan,15/11/2004,22,0,0,0,7,0,0,29
Pakistan,16/11/2004,28,0,-1,0,2,0,0,29
Pakistan,17/11/2004,-1,0,0,0,4,0,0,3
Pakistan,18/11/2004,2,0,0,0,4,0,0,6
Pakistan,19/11/2004,10,0,-6,0,3,0,0,7
Pakistan,20/11/2004,11,0,0,0,-1,0,0,10
Pakistan,21/11/2004,5,0,0,0,3,2,0,10
Pakistan,22/11/2004,2,0,0,0,6,0,0,8
Pakistan,23/11/2004,4,0,0,0,4,0,0,8
Pakistan,24/11/2004,1,0,0,0,9,3,0,13
Pakistan,25/11/2004,12,0,0,0,6,2,0,20
Pakistan,26/11/2004,3,0,0,0,3,0,0,6
Pakistan,27/11/2004,3,0,0,0,5,1,0,9
Pakistan,28/11/2004,14,0,0,0,3,3,0,20
Pakistan,29/11/2004,15,0,0,0,3,0,0,18
Pakistan,30/11/2004,15,0,0,0,-10,0,0,5
Pakistan,01/12/2004,26,0,0,0,7,0,0,33
Pakistan,02/12/2004,4,0,0,0,1,0,0,5
Pakistan,03/12/2004,13,0,0,0,6,3,0,22
Pakistan,04/12/2004,17,0,0,0,3,0,0,20
Pakistan,05/12/2004,24,0,0,0,3,0,0,27
Pakistan,06/12/2004,0,0,-2,0,-2,0,0,-4
Pakistan,07/12/2004,28,0,0,0,0,3,0,31
Pakistan,08/12/2004,18,0,1,0,4,1,0,24
Pakistan,09/12/2004,18,0,0,0,3,0,0,21
Pakistan,10/12/2004,12,0,0,0,0,0,0,12
Pakistan,11/12/2004,1,0,0,0,7,0,0,8
Pakistan,12/12/2004,16,0,0,0,9,0,0,25
Pakistan,13/12/2004,8,0,1,0,9,0,0,18
Pakistan,14/12/2004,15,0,0,0,9,2,0,26
Pakistan,15/12/2004,19,0,0,0,1,0,0,20
Pakistan,16/12/2004,10,0,0,0,12,4,0,26
Pakistan,17/12/2004,14,0,0,0,4,0,0,18
Pakistan,18/12/2004,12,0,0,0,12,2,0,26
Pakistan,19/12/2004,6,0,0,0,0,0,0,6
Pakistan,20/12/2004,5,0,-2,0,-2,0,0,1
Pakistan,21/12/2004,29,0,0,0,4,1,0,34
Pakistan,22/12/2004,11,0,1,0,9,3,0,24
Pakistan,23/12/2004,-2,0,0,0,0,0,0,-2
Pakistan,24/12/2004,6,0,0,0,3,0,0,9
Pakistan,25/12/2004,1,0,0,0,6,0,0,7
Pakistan,26/12/2004,11,0,0,0,4,0,0,15
Pakistan,27/12/2004,8,0,0,0,9,3,0,20
Pakistan,28/12/2004,17,0,2,0,15,0,0,34
Pakistan,29/12/2004,7,0,0,0,0,0,0,7
Pakistan,30/12/2004,9,0,0,0,-2,0,0,7
Pakistan,31/12/2004,-7,0,0,0,18,0,0,11
Sierra Leone,02/01/2004,2,0,0,0,0,0,0,2
Sierra Leone,04/01/2004,2,0,0,0,0,2,0,4
Sierra Leone,05/01/2004,2,0,0,0,0,0,0,2
Sierra Leone,06/01/2004,6,0,0,0,0,0,0,6
Sierra Leone,07/01/2004,0,0,0,0,0,0,0,0
Sierra Leone,08/01/2004,2,0,0,0,0,0,0,2
Sierra Leone,09/01/2004,0,0,0,0,0,0,0,0
Sierra Leone,10/01/2004,0,0,0,0,0,0,0,0
Sierra Leone,12/01/2004,0,0,0,0,-4,0,0,-4
Sierra Leone,13/01/2004,2,0,0,0,0,0,0,2
Sierra Leone,14/01/2004,0,0,0,0,0,4,0,4
Sierra Leone,15/01/2004,-1,0,0,0,6,0,0,5
Sierra Leone,16/01/2004,0,0,0,0,0,1,0,1
Sierra Leone,17/01/2004,0,0,0,0,0,0,0,0
Sierra Leone,19/01/2004,0,0,0,0,0,1,0,1
Sierra Leone,20/01/2004,-1,0,0,0,0,0,0,-1
Sierra Leone,21/01/2004,2,0,0,0,3,0,0,5
Sierra Leone,22/01/2004,0,0,0,0,0,0,0,0
Sierra Leone,23/01/2004,1,0,0,0,0,0,0,1
Sierra Leone,24/01/2004,0,0,0,0,0,0,0,0
Sierra Leone,26/01/2004,2,0,0,0,0,0,0,2
Sierra Leone,27/01/2004,2,0,0,0,-4,0,0,-2
Sierra Leone,28/01/2004,0,0,0,0,0,0,0,0
Sierra Leone,29/01/2004,0,6,0,0,0,0,0,6
Sierra Leone,30/01/2004,0,0,0,0,0,0,0,0
Sierra Leone,01/02/2004,0,0,0,0,3,0,0,3
Sierra Leone,02/02/2004,0,0,0,0,0,0,0,0
Sierra Leone,03/02/2004,4,0,0,0,0,0,0,4
Sierra Leone,04/02/2004,0,0,0,0,9,1,0,10
Sierra Leone,05/02/2004,2,0,0,0,3,0,0,5
Sierra Leone,06/02/2004,0,4,0,0,0,0,0,4
Sierra Leone,07/02/2004,1,0,0,0,0,0,0,1
Sierra Leone,08/02/2004,0,0,0,0,0,0,0,0
Sierra Leone,09/02/2004,0,0,0,0,0,1,0,1
Sierra Leone,10/02/2004,0,0,0,0,0,0,0,0
Sierra Leone,11/02/2004,3,0,0,0,6,0,0,9
Sierra Leone,12/02/2004,0,0,0,0,3,1,0,4
Sierra Leone,13/02/2004,3,0,0,0,0,0,0,3
Sierra Leone,14/02/2004,1,0,0,0,0,0,0,1
Sierra Leone,16/02/2004,1,0,0,0,3,-4,0,0
Sierra Leone,17/02/2004,2,0,0,0,6,0,0,8
Sierra Leone,18/02/2004,2,0,0,0,0,0,0,2
Sierra Leone,19/02/2004,6,0,0,0,-4,2,0,4
Sierra Leone,20/02/2004,7,0,0,0,0,0,0,7
Sierra Leone,23/02/2004,2,0,0,0,3,0,0,5
Sierra Leone,24/02/2004,3,0,0,0,6,0,0,9
Sierra Leone,25/02/2004,-3,0,0,0,7,0,0,4
Sierra Leone,26/02/2004,0,0,0,0,0,0,0,0
Sierra Leone,27/02/2004,2,0,0,0,0,0,0,2
Sierra Leone,28/02/2004,0,0,0,0,0,0,0,0
Sierra Leone,01/03/2004,0,0,0,0,-5,0,0,-5
Sierra Leone,02/03/2004,6,0,0,0,-2,0,0,4
Sierra Leone,03/03/2004,0,0,0,0,0,0,0,0
Sierra Leone,04/03/2004,0,0,0,0,0,0,0,0
Sierra Leone,07/03/2004,0,0,0,0,0,0,0,0
Sierra Leone,08/03/2004,1,0,0,0,0,0,0,1
Sierra Leone,09/03/2004,12,0,0,0,6,0,0,18
Sierra Leone,10/03/2004,0,0,0,0,0,0,0,0
Sierra Leone,11/03/2004,3,0,0,0,6,1,0,10
Sierra Leone,12/03/2004,4,0,0,0,0,1,0,5
Sierra Leone,13/03/2004,2,0,0,0,6,2,0,10
Sierra Leone,15/03/2004,0,0,0,0,9,0,0,9
Sierra Leone,16/03/2004,-1,0,0,0,3,0,0,2
Sierra Leone,17/03/2004,2,0,0,0,0,0,0,2
Sierra Leone,18/03/2004,8,0,0,0,6,0,0,14
Sierra Leone,19/03/2004,-2,0,0,0,12,0,0,10
Sierra Leone,20/03/2004,0,0,0,0,-16,0,0,-16
Sierra Leone,21/03/2004,-8,0,0,0,3,0,0,-5
Sierra Leone,22/03/2004,8,0,-1,0,3,1,0,11
Sierra Leone,23/03/2004,-17,0,0,0,0,0,0,-17
Sierra Leone,24/03/2004,4,0,0,0,3,2,0,9
Sierra Leone,25/03/2004,2,0,0,0,0,0,0,2
Sierra Leone,26/03/2004,10,0,0,0,0,0,0,10
Sierra Leone,27/03/2004,3,0,0,0,0,0,0,3
Sierra Leone,29/03/2004,2,0,0,0,0,2,0,4
Sierra Leone,30/03/2004,2,0,0,0,0,0,0,2
Sierra Leone,31/03/2004,1,0,0,0,0,0,0,1
Sierra Leone,02/04/2004,6,0,0,0,0,0,0,6
Sierra Leone,04/04/2004,0,0,0,0,-2,0,0,-2
Sierra Leone,05/04/2004,0,0,0,0,0,0,0,0
Sierra Leone,06/04/2004,4,0,0,0,-4,0,0,0
Sierra Leone,07/04/2004,1,0,0,0,0,2,0,3
Sierra Leone,08/04/2004,-1,0,0,0,6,0,0,5
Sierra Leone,09/04/2004,0,0,0,0,0,0,0,0
Sierra Leone,12/04/2004,0,0,0,0,0,0,0,0
Sierra Leone,13/04/2004,-3,0,0,0,6,0,0,3
Sierra Leone,14/04/2004,2,0,0,0,3,0,0,5
Sierra Leone,15/04/2004,0,0,0,0,3,0,0,3
Sierra Leone,16/04/2004,2,0,0,0,0,0,0,2
Sierra Leone,17/04/2004,0,0,0,0,0,0,0,0
Sierra Leone,19/04/2004,5,0,2,0,0,1,0,8
Sierra Leone,20/04/2004,4,0,0,0,3,0,0,7
Sierra Leone,21/04/2004,1,0,0,0,0,0,0,1
Sierra Leone,22/04/2004,1,0,0,0,0,1,0,2
Sierra Leone,23/04/2004,0,0,0,0,0,0,0,0
Sierra Leone,25/04/2004,0,0,0,0,0,0,0,0
Sierra Leone,26/04/2004,9,0,0,0,0,0,0,9
Sierra Leone,27/04/2004,0,0,0,0,0,0,0,0
Sierra Leone,28/04/2004,1,0,0,0,9,0,0,10
Sierra Leone,29/04/2004,-4,0,0,0,-8,0,0,-12
Sierra Leone,30/04/2004,0,0,0,0,0,0,0,0
Sierra Leone,01/05/2004,0,0,0,0,0,0,0,0
Sierra Leone,03/05/2004,0,0,0,0,3,0,0,3
Sierra Leone,04/05/2004,4,0,0,0,3,0,0,7
Sierra Leone,05/05/2004,0,0,0,0,-2,1,0,-1
Sierra Leone,06/05/2004,1,0,0,0,0,0,0,1
Sierra Leone,07/05/2004,2,0,0,0,0,1,0,3
Sierra Leone,09/05/2004,-1,0,0,0,0,0,0,-1
Sierra Leone,10/05/2004,0,0,0,0,0,0,0,0
Sierra Leone,11/05/2004,0,0,0,0,3,0,0,3
Sierra Leone,12/05/2004,0,2,0,0,0,0,0,2
Sierra Leone,13/05/2004,0,0,0,0,0,0,0,0
Sierra Leone,14/05/2004,2,0,0,0,0,0,0,2
Sierra Leone,16/05/2004,0,0,0,0,0,0,0,0
Sierra Leone,17/05/2004,-1,0,0,0,0,1,0,0
Sierra Leone,18/05/2004,9,0,0,0,0,0,0,9
Sierra Leone,19/05/2004,2,2,0,0,1,0,0,5
Sierra Leone,20/05/2004,4,0,0,0,0,0,0,4
Sierra Leone,21/05/2004,0,0,0,0,0,0,0,0
Sierra Leone,22/05/2004,0,0,0,0,0,0,0,0
Sierra Leone,23/05/2004,0,2,0,0,0,0,0,2
Sierra Leone,24/05/2004,0,0,0,0,0,0,0,0
Sierra Leone,25/05/2004,-6,0,0,0,0,0,0,-6
Sierra Leone,28/05/2004,0,0,0,0,0,0,0,0
Sierra Leone,01/06/2004,5,0,0,0,3,0,0,8
Sierra Leone,02/06/2004,0,0,0,0,0,0,0,0
Sierra Leone,03/06/2004,2,0,0,0,0,0,0,2
Sierra Leone,04/06/2004,1,0,0,0,6,0,0,7
Sierra Leone,05/06/2004,4,0,0,0,0,0,0,4
Sierra Leone,06/06/2004,0,0,0,0,3,0,0,3
Sierra Leone,07/06/2004,1,0,0,0,0,0,0,1
Sierra Leone,08/06/2004,6,0,0,0,0,0,0,6
Sierra Leone,09/06/2004,0,0,0,0,0,0,0,0
Sierra Leone,10/06/2004,3,0,0,0,3,0,0,6
Sierra Leone,11/06/2004,0,0,0,0,6,1,0,7
Sierra Leone,13/06/2004,0,0,0,0,0,0,0,0
Sierra Leone,14/06/2004,3,0,0,0,0,0,0,3
Sierra Leone,15/06/2004,7,0,0,0,6,0,0,13
Sierra Leone,16/06/2004,9,0,0,0,6,0,0,15
Sierra Leone,17/06/2004,1,0,0,0,0,0,0,1
Sierra Leone,18/06/2004,0,0,0,0,0,0,0,0
Sierra Leone,20/06/2004,2,0,0,0,0,5,0,7
Sierra Leone,21/06/2004,0,0,0,0,0,5,0,5
Sierra Leone,22/06/2004,10,0,0,0,0,1,0,11
Sierra Leone,23/06/2004,1,0,0,0,0,2,0,3
Sierra Leone,24/06/2004,2,0,0,0,0,0,0,2
Sierra Leone,25/06/2004,0,0,0,0,0,0,0,0
Sierra Leone,28/06/2004,3,0,0,0,0,0,0,3
Sierra Leone,29/06/2004,6,0,0,0,0,0,0,6
Sierra Leone,30/06/2004,2,0,0,0,-4,0,0,-2
Sierra Leone,01/07/2004,8,0,0,0,9,0,0,17
Sierra Leone,02/07/2004,2,0,0,0,6,0,0,8
Sierra Leone,03/07/2004,0,0,0,0,6,0,0,6
Sierra Leone,05/07/2004,16,0,0,0,0,0,0,16
Sierra Leone,06/07/2004,0,0,0,0,3,0,0,3
Sierra Leone,07/07/2004,6,0,0,0,0,0,0,6
Sierra Leone,08/07/2004,0,0,0,0,0,0,0,0
Sierra Leone,09/07/2004,1,2,0,0,0,0,0,3
Sierra Leone,10/07/2004,0,0,0,0,6,0,0,6
Sierra Leone,11/07/2004,0,0,0,0,0,0,0,0
Sierra Leone,12/07/2004,4,0,0,0,0,0,0,4
Sierra Leone,13/07/2004,3,0,0,0,21,2,0,26
Sierra Leone,14/07/2004,0,0,0,0,-2,0,0,-2
Sierra Leone,15/07/2004,5,0,0,0,6,0,0,11
Sierra Leone,16/07/2004,8,0,0,0,-2,0,0,6
Sierra Leone,17/07/2004,0,0,0,0,0,1,0,1
Sierra Leone,19/07/2004,3,0,0,0,0,1,0,4
Sierra Leone,21/07/2004,10,0,0,0,-2,1,0,9
Sierra Leone,22/07/2004,2,0,0,0,6,0,0,8
Sierra Leone,23/07/2004,14,0,-2,0,0,0,0,12
Sierra Leone,24/07/2004,9,0,0,0,-4,0,0,5
Sierra Leone,26/07/2004,1,0,0,0,6,0,0,7
Sierra Leone,27/07/2004,2,0,0,0,0,0,0,2
Sierra Leone,28/07/2004,4,0,0,0,3,0,0,7
Sierra Leone,29/07/2004,7,0,0,0,6,0,0,13
Sierra Leone,30/07/2004,3,0,0,0,4,0,0,7
Sierra Leone,31/07/2004,0,0,0,0,0,0,0,0
Sierra Leone,01/08/2004,0,0,0,0,0,0,0,0
Sierra Leone,02/08/2004,3,0,0,0,0,0,0,3
Sierra Leone,03/08/2004,1,0,0,0,0,0,0,1
Sierra Leone,04/08/2004,2,0,0,0,-1,0,0,1
Sierra Leone,05/08/2004,0,0,0,0,12,0,0,12
Sierra Leone,06/08/2004,0,0,0,0,0,2,0,2
Sierra Leone,07/08/2004,0,0,0,0,3,0,0,3
Sierra Leone,08/08/2004,0,0,0,0,3,0,0,3
Sierra Leone,09/08/2004,0,0,0,0,6,0,0,6
Sierra Leone,10/08/2004,-1,0,0,0,0,1,0,0
Sierra Leone,11/08/2004,0,0,0,0,0,1,0,1
Sierra Leone,12/08/2004,1,0,0,0,0,0,0,1
Sierra Leone,13/08/2004,1,0,0,0,0,2,0,3
Sierra Leone,16/08/2004,6,0,0,0,0,1,0,7
Sierra Leone,17/08/2004,0,0,0,0,-2,0,0,-2
Sierra Leone,18/08/2004,0,0,0,0,12,0,0,12
Sierra Leone,19/08/2004,6,0,0,0,3,2,0,11
Sierra Leone,20/08/2004,0,0,0,0,0,0,0,0
Sierra Leone,21/08/2004,0,0,0,0,0,0,0,0
Sierra Leone,22/08/2004,0,0,0,0,0,0,0,0
Sierra Leone,23/08/2004,3,0,0,0,0,0,0,3
Sierra Leone,24/08/2004,2,0,0,0,0,0,0,2
Sierra Leone,25/08/2004,-1,0,-2,0,0,0,0,-3
Sierra Leone,26/08/2004,0,0,0,0,0,0,0,0
Sierra Leone,27/08/2004,1,0,0,0,0,0,0,1
Sierra Leone,29/08/2004,0,0,0,0,6,0,0,6
Sierra Leone,30/08/2004,0,0,0,0,-2,0,0,-2
Sierra Leone,31/08/2004,0,0,0,0,9,0,0,9
Sierra Leone,01/09/2004,4,0,0,0,0,0,0,4
Sierra Leone,02/09/2004,0,0,0,0,-6,0,0,-6
Sierra Leone,03/09/2004,9,0,-2,0,0,0,0,7
Sierra Leone,06/09/2004,4,0,0,0,0,0,0,4
Sierra Leone,07/09/2004,2,0,0,0,0,0,0,2
Sierra Leone,08/09/2004,0,0,0,0,-4,1,0,-3
Sierra Leone,10/09/2004,0,0,0,0,0,1,0,1
Sierra Leone,13/09/2004,2,0,0,0,3,0,0,5
Sierra Leone,14/09/2004,0,0,0,0,0,0,0,0
Sierra Leone,15/09/2004,0,0,0,0,0,0,0,0
Sierra Leone,16/09/2004,0,0,0,0,0,0,0,0
Sierra Leone,17/09/2004,7,0,0,0,-6,0,0,1
Sierra Leone,20/09/2004,3,0,0,0,6,0,0,9
Sierra Leone,21/09/2004,6,0,0,0,0,0,0,6
Sierra Leone,22/09/2004,0,0,0,0,1,0,0,1
Sierra Leone,23/09/2004,-1,0,0,0,6,0,0,5
Sierra Leone,24/09/2004,0,0,1,0,3,0,0,4
Sierra Leone,27/09/2004,-8,0,0,0,3,0,0,-5
Sierra Leone,28/09/2004,2,0,0,0,1,3,0,6
Sierra Leone,29/09/2004,7,0,0,0,1,0,0,8
Sierra Leone,30/09/2004,3,0,0,0,9,0,0,12
Sierra Leone,01/10/2004,-4,0,0,0,0,2,0,-2
Sierra Leone,04/10/2004,1,0,0,0,-2,0,0,-1
Sierra Leone,05/10/2004,9,0,0,0,0,0,0,9
Sierra Leone,06/10/2004,8,0,0,0,3,0,0,11
Sierra Leone,07/10/2004,2,0,-1,0,0,1,0,2
Sierra Leone,08/10/2004,0,0,0,0,0,0,0,0
Sierra Leone,10/10/2004,0,0,0,0,0,0,0,0
Sierra Leone,11/10/2004,2,0,0,0,6,0,0,8
Sierra Leone,12/10/2004,1,0,0,0,0,1,0,2
Sierra Leone,13/10/2004,3,0,0,0,9,0,0,12
Sierra Leone,14/10/2004,-1,0,0,0,0,0,0,-1
Sierra Leone,15/10/2004,0,0,0,0,0,0,0,0
Sierra Leone,17/10/2004,0,0,0,0,0,0,0,0
Sierra Leone,18/10/2004,4,0,0,0,-6,0,0,-2
Sierra Leone,19/10/2004,0,0,0,0,0,0,0,0
Sierra Leone,20/10/2004,1,0,0,0,0,0,0,1
Sierra Leone,21/10/2004,6,0,0,0,-1,0,0,5
Sierra Leone,22/10/2004,3,0,0,0,3,1,0,7
Sierra Leone,23/10/2004,0,0,0,0,0,0,0,0
Sierra Leone,24/10/2004,0,0,0,0,0,0,0,0
Sierra Leone,25/10/2004,10,0,0,0,-2,0,0,8
Sierra Leone,26/10/2004,1,0,0,0,6,0,0,7
Sierra Leone,27/10/2004,6,0,0,0,3,0,0,9
Sierra Leone,28/10/2004,4,0,0,0,12,0,0,16
Sierra Leone,29/10/2004,0,0,0,0,0,0,0,0
Sierra Leone,30/10/2004,2,0,0,0,0,0,0,2
Sierra Leone,31/10/2004,2,0,0,0,0,0,0,2
Sierra Leone,01/11/2004,0,0,0,0,0,0,0,0
Sierra Leone,02/11/2004,0,0,0,0,0,0,0,0
Sierra Leone,03/11/2004,4,0,0,0,-2,0,0,2
Sierra Leone,04/11/2004,3,0,0,0,1,0,0,4
Sierra Leone,05/11/2004,2,0,0,0,0,0,0,2
Sierra Leone,08/11/2004,0,0,0,0,0,0,0,0
Sierra Leone,09/11/2004,0,0,0,0,0,0,0,0
Sierra Leone,11/11/2004,0,0,0,0,0,0,0,0
Sierra Leone,12/11/2004,4,0,0,0,0,0,0,4
Sierra Leone,14/11/2004,7,0,0,0,0,0,0,7
Sierra Leone,15/11/2004,0,0,0,0,0,0,0,0
Sierra Leone,16/11/2004,-1,2,0,0,0,0,0,1
Sierra Leone,17/11/2004,2,0,0,0,3,0,0,5
Sierra Leone,18/11/2004,10,0,0,0,9,0,0,19
Sierra Leone,19/11/2004,2,0,0,0,0,0,0,2
Sierra Leone,22/11/2004,1,0,0,0,0,0,0,1
Sierra Leone,23/11/2004,0,0,0,0,3,0,0,3
Sierra Leone,24/11/2004,4,0,-1,0,-2,0,0,1
Sierra Leone,25/11/2004,2,0,0,0,0,0,0,2
Sierra Leone,26/11/2004,4,0,0,0,0,0,0,4
Sierra Leone,27/11/2004,0,0,0,0,0,0,0,0
Sierra Leone,29/11/2004,0,0,0,0,0,0,0,0
Sierra Leone,30/11/2004,0,0,0,0,0,0,0,0
Sierra Leone,01/12/2004,2,0,0,0,0,2,0,4
Sierra Leone,02/12/2004,0,0,0,0,0,1,0,1
Sierra Leone,03/12/2004,2,0,1,0,0,2,0,5
Sierra Leone,06/12/2004,-1,0,0,0,0,0,0,-1
Sierra Leone,07/12/2004,3,0,0,0,-2,0,0,1
Sierra Leone,08/12/2004,4,0,0,0,0,0,0,4
Sierra Leone,09/12/2004,0,0,0,0,-1,3,0,2
Sierra Leone,10/12/2004,0,0,0,0,0,1,0,1
Sierra Leone,13/12/2004,0,0,0,0,0,0,0,0
Sierra Leone,14/12/2004,1,0,0,0,0,0,0,1
Sierra Leone,15/12/2004,0,0,-2,0,0,0,0,-2
Sierra Leone,16/12/2004,0,0,0,0,0,0,0,0
Sierra Leone,17/12/2004,3,0,0,0,0,0,0,3
Sierra Leone,18/12/2004,0,0,0,0,0,0,0,0
Sierra Leone,21/12/2004,-2,0,0,0,12,0,0,10
Sierra Leone,22/12/2004,-1,0,0,0,0,0,0,-1
Sierra Leone,23/12/2004,0,0,0,0,0,7,0,7
Sierra Leone,27/12/2004,0,0,0,0,0,0,0,0
Sierra Leone,30/12/2004,2,0,0,0,3,0,0,5
Sierra Leone,31/12/2004,0,0,0,0,0,0,0,0
Somalia,01/01/2004,0,0,0,0,0,1,0,1
Somalia,02/01/2004,1,0,0,0,3,0,0,4
Somalia,04/01/2004,0,0,0,0,0,0,0,0
Somalia,05/01/2004,3,0,0,0,0,0,0,3
Somalia,06/01/2004,0,0,0,0,0,0,0,0
Somalia,07/01/2004,1,0,0,0,6,0,0,7
Somalia,08/01/2004,4,0,0,0,-2,0,0,2
Somalia,09/01/2004,-1,0,1,0,0,0,0,0
Somalia,10/01/2004,5,0,0,0,0,0,0,5
Somalia,11/01/2004,0,0,0,0,3,0,0,3
Somalia,12/01/2004,7,0,0,0,0,0,0,7
Somalia,13/01/2004,2,0,0,0,0,0,0,2
Somalia,14/01/2004,0,0,0,0,0,1,0,1
Somalia,15/01/2004,0,0,0,0,0,1,0,1
Somalia,16/01/2004,2,0,0,0,0,0,0,2
Somalia,17/01/2004,0,0,0,0,0,0,0,0
Somalia,18/01/2004,2,0,0,0,-2,1,0,1
Somalia,19/01/2004,12,0,0,0,0,0,0,12
Somalia,20/01/2004,2,0,0,0,0,0,0,2
Somalia,21/01/2004,4,0,0,0,0,0,0,4
Somalia,22/01/2004,4,0,0,0,0,0,0,4
Somalia,24/01/2004,1,0,0,0,0,2,0,3
Somalia,26/01/2004,-8,0,0,0,0,0,0,-8
Somalia,27/01/2004,9,0,-3,0,6,0,0,12
Somalia,28/01/2004,16,0,0,0,3,0,0,19
Somalia,29/01/2004,0,0,0,0,0,0,0,0
Somalia,30/01/2004,6,0,0,0,0,2,0,8
Somalia,31/01/2004,3,0,0,0,0,0,0,3
Somalia,01/02/2004,0,0,0,0,0,0,0,0
Somalia,02/02/2004,0,0,0,0,0,0,0,0
Somalia,03/02/2004,0,0,0,0,0,0,0,0
Somalia,04/02/2004,10,0,0,0,0,0,0,10
Somalia,05/02/2004,4,0,0,0,6,0,0,10
Somalia,06/02/2004,19,0,0,0,3,0,0,22
Somalia,07/02/2004,-1,0,0,0,0,0,0,-1
Somalia,08/02/2004,0,0,0,0,0,0,0,0
Somalia,09/02/2004,0,0,0,0,0,0,0,0
Somalia,10/02/2004,3,0,0,0,0,0,0,3
Somalia,11/02/2004,0,0,0,0,0,0,0,0
Somalia,12/02/2004,0,0,0,0,0,0,0,0
Somalia,13/02/2004,7,0,0,0,0,0,0,7
Somalia,14/02/2004,4,0,0,0,0,0,0,4
Somalia,15/02/2004,0,0,0,0,0,0,0,0
Somalia,16/02/2004,3,0,0,0,3,0,0,6
Somalia,17/02/2004,-2,0,0,0,0,0,0,-2
Somalia,18/02/2004,1,0,0,0,0,0,0,1
Somalia,19/02/2004,5,0,0,0,0,0,0,5
Somalia,20/02/2004,0,0,0,0,0,0,0,0
Somalia,22/02/2004,-1,0,0,0,0,0,0,-1
Somalia,23/02/2004,2,0,0,0,3,0,0,5
Somalia,24/02/2004,2,0,1,0,0,0,0,3
Somalia,25/02/2004,-2,0,0,0,0,0,0,-2
Somalia,26/02/2004,0,0,0,0,0,0,0,0
Somalia,27/02/2004,0,2,0,0,0,0,0,2
Somalia,28/02/2004,2,0,0,0,0,1,0,3
Somalia,29/02/2004,0,0,0,0,0,0,0,0
Somalia,01/03/2004,0,0,0,0,0,0,0,0
Somalia,02/03/2004,1,0,0,0,3,0,0,4
Somalia,03/03/2004,4,0,0,0,1,1,0,6
Somalia,04/03/2004,0,0,0,0,0,0,0,0
Somalia,05/03/2004,2,0,0,0,0,0,0,2
Somalia,06/03/2004,6,0,-1,0,0,0,0,5
Somalia,08/03/2004,7,0,0,0,1,0,0,8
Somalia,09/03/2004,10,0,0,0,6,0,0,16
Somalia,10/03/2004,3,0,0,0,0,0,0,3
Somalia,11/03/2004,2,0,0,0,0,0,0,2
Somalia,12/03/2004,2,0,0,0,3,0,0,5
Somalia,13/03/2004,2,0,0,0,0,0,0,2
Somalia,14/03/2004,5,0,0,0,0,0,0,5
Somalia,15/03/2004,2,0,0,0,0,0,0,2
Somalia,16/03/2004,7,0,0,0,0,0,0,7
Somalia,17/03/2004,0,0,0,0,6,0,0,6
Somalia,18/03/2004,0,0,0,0,0,0,0,0
Somalia,19/03/2004,0,0,0,0,0,0,0,0
Somalia,20/03/2004,-1,0,0,0,-2,0,0,-3
Somalia,22/03/2004,6,0,1,0,3,1,0,11
Somalia,23/03/2004,1,0,0,0,0,0,0,1
Somalia,24/03/2004,0,0,0,0,0,0,0,0
Somalia,25/03/2004,0,0,0,0,0,0,0,0
Somalia,26/03/2004,2,0,0,0,0,0,0,2
Somalia,27/03/2004,11,0,0,0,0,0,0,11
Somalia,28/03/2004,0,0,0,0,0,0,0,0
Somalia,29/03/2004,1,0,0,0,0,0,0,1
Somalia,30/03/2004,0,0,0,0,0,0,0,0
Somalia,31/03/2004,0,0,0,0,0,0,0,0
Somalia,01/04/2004,5,0,0,0,0,0,0,5
Somalia,03/04/2004,6,0,0,0,0,0,0,6
Somalia,04/04/2004,0,0,0,0,0,0,0,0
Somalia,05/04/2004,0,0,0,0,3,0,0,3
Somalia,06/04/2004,9,0,0,0,0,0,0,9
Somalia,07/04/2004,-3,0,0,0,0,1,0,-2
Somalia,08/04/2004,2,0,0,0,0,0,0,2
Somalia,09/04/2004,0,0,0,0,0,0,0,0
Somalia,10/04/2004,-3,0,0,0,3,0,0,0
Somalia,11/04/2004,0,0,0,0,0,0,0,0
Somalia,15/04/2004,0,0,0,0,0,0,0,0
Somalia,16/04/2004,0,0,0,0,3,0,0,3
Somalia,18/04/2004,0,0,0,0,3,0,0,3
Somalia,19/04/2004,0,0,0,0,0,0,0,0
Somalia,20/04/2004,-3,0,0,0,0,0,0,-3
Somalia,21/04/2004,2,0,0,0,0,0,0,2
Somalia,22/04/2004,0,0,0,0,0,0,0,0
Somalia,26/04/2004,4,0,0,0,0,0,0,4
Somalia,27/04/2004,3,0,0,0,0,0,0,3
Somalia,28/04/2004,1,0,0,0,0,0,0,1
Somalia,29/04/2004,4,0,0,0,3,0,0,7
Somalia,30/04/2004,11,0,0,0,3,0,0,14
Somalia,01/05/2004,13,0,0,0,3,0,0,16
Somalia,02/05/2004,0,0,0,0,0,0,0,0
Somalia,04/05/2004,3,0,0,0,0,0,0,3
Somalia,05/05/2004,0,0,0,0,3,0,0,3
Somalia,06/05/2004,0,0,0,0,3,0,0,3
Somalia,07/05/2004,3,0,0,0,0,0,0,3
Somalia,08/05/2004,0,0,0,0,6,0,0,6
Somalia,09/05/2004,0,0,0,0,6,0,0,6
Somalia,10/05/2004,0,0,0,0,6,1,0,7
Somalia,11/05/2004,3,0,0,0,9,1,0,13
Somalia,12/05/2004,5,0,0,0,18,0,0,23
Somalia,13/05/2004,-1,0,0,0,6,2,0,7
Somalia,14/05/2004,0,0,0,0,3,0,0,3
Somalia,15/05/2004,0,0,0,0,0,0,0,0
Somalia,16/05/2004,0,0,0,0,6,0,0,6
Somalia,17/05/2004,0,0,0,0,3,3,0,6
Somalia,18/05/2004,6,0,0,0,9,0,0,15
Somalia,19/05/2004,8,0,0,0,15,0,0,23
Somalia,20/05/2004,1,0,0,0,3,0,0,4
Somalia,21/05/2004,0,0,1,0,3,0,0,4
Somalia,22/05/2004,-2,0,0,0,0,0,0,-2
Somalia,23/05/2004,6,0,0,0,0,0,0,6
Somalia,24/05/2004,21,0,0,0,0,2,0,23
Somalia,25/05/2004,2,0,0,0,7,0,0,9
Somalia,26/05/2004,0,0,0,0,0,0,0,0
Somalia,27/05/2004,0,0,0,0,3,0,0,3
Somalia,28/05/2004,1,0,0,0,-2,0,0,-1
Somalia,29/05/2004,1,0,0,0,-2,0,0,-1
Somalia,30/05/2004,4,0,0,0,6,0,0,10
Somalia,31/05/2004,8,0,0,0,9,0,0,17
Somalia,01/06/2004,6,0,0,0,3,0,0,9
Somalia,02/06/2004,16,0,0,0,0,0,0,16
Somalia,03/06/2004,15,0,0,0,0,0,0,15
Somalia,04/06/2004,5,0,0,0,6,0,0,11
Somalia,05/06/2004,5,0,0,0,3,0,0,8
Somalia,06/06/2004,1,0,0,0,12,0,0,13
Somalia,08/06/2004,2,2,0,0,0,1,0,5
Somalia,09/06/2004,2,0,0,0,3,0,0,5
Somalia,10/06/2004,0,0,0,0,1,0,0,1
Somalia,11/06/2004,0,0,0,0,3,0,0,3
Somalia,12/06/2004,0,0,0,0,0,0,0,0
Somalia,14/06/2004,10,0,0,0,3,0,0,13
Somalia,15/06/2004,7,0,0,0,-1,0,0,6
Somalia,16/06/2004,2,0,0,0,6,0,0,8
Somalia,17/06/2004,2,0,0,0,15,0,0,17
Somalia,18/06/2004,2,0,0,0,3,1,0,6
Somalia,19/06/2004,2,0,0,0,-1,1,0,2
Somalia,21/06/2004,3,0,0,0,0,0,0,3
Somalia,22/06/2004,0,0,0,0,0,0,0,0
Somalia,23/06/2004,0,0,0,0,9,0,0,9
Somalia,24/06/2004,1,0,0,0,15,0,0,16
Somalia,25/06/2004,3,0,0,0,0,0,0,3
Somalia,26/06/2004,1,0,0,0,0,0,0,1
Somalia,27/06/2004,3,0,0,0,-1,0,0,2
Somalia,28/06/2004,2,0,0,0,0,3,0,5
Somalia,29/06/2004,0,0,0,0,0,0,0,0
Somalia,30/06/2004,0,0,0,0,-4,0,0,-4
Somalia,01/07/2004,3,0,0,0,0,0,0,3
Somalia,02/07/2004,0,0,0,0,6,0,0,6
Somalia,04/07/2004,2,0,0,0,6,1,0,9
Somalia,05/07/2004,1,0,0,0,-2,0,0,-1
Somalia,06/07/2004,0,0,0,0,0,0,0,0
Somalia,07/07/2004,1,0,0,0,0,0,0,1
Somalia,08/07/2004,3,0,0,0,0,0,0,3
Somalia,09/07/2004,1,0,0,0,0,0,0,1
Somalia,10/07/2004,10,0,0,0,0,0,0,10
Somalia,11/07/2004,0,0,0,0,0,0,0,0
Somalia,12/07/2004,2,0,0,0,0,0,0,2
Somalia,13/07/2004,-3,0,0,0,0,0,0,-3
Somalia,14/07/2004,1,0,0,0,0,0,0,1
Somalia,15/07/2004,1,0,0,0,0,0,0,1
Somalia,16/07/2004,1,0,0,0,0,0,0,1
Somalia,17/07/2004,0,0,0,0,0,0,0,0
Somalia,18/07/2004,1,0,0,0,6,0,0,7
Somalia,19/07/2004,2,0,0,0,0,0,0,2
Somalia,20/07/2004,1,0,0,0,0,0,0,1
Somalia,22/07/2004,0,0,0,0,0,0,0,0
Somalia,23/07/2004,0,0,0,0,0,0,0,0
Somalia,24/07/2004,0,0,0,0,0,0,0,0
Somalia,26/07/2004,4,0,0,0,0,0,0,4
Somalia,28/07/2004,5,0,0,0,3,6,0,14
Somalia,29/07/2004,12,0,0,0,2,0,0,14
Somalia,30/07/2004,7,0,0,0,7,0,0,14
Somalia,31/07/2004,4,0,0,0,10,0,0,14
Somalia,02/08/2004,-1,0,0,0,0,0,0,-1
Somalia,03/08/2004,10,0,0,0,0,0,0,10
Somalia,05/08/2004,0,0,0,0,0,0,0,0
Somalia,06/08/2004,2,0,0,0,0,0,0,2
Somalia,09/08/2004,0,0,0,0,0,0,0,0
Somalia,11/08/2004,0,0,0,0,0,0,0,0
Somalia,12/08/2004,0,0,-4,0,-2,0,0,-6
Somalia,13/08/2004,3,0,0,0,0,0,0,3
Somalia,14/08/2004,0,0,0,0,0,0,0,0
Somalia,16/08/2004,1,0,0,0,0,1,0,2
Somalia,17/08/2004,9,0,0,0,0,0,0,9
Somalia,18/08/2004,0,0,0,0,0,0,0,0
Somalia,19/08/2004,0,0,0,0,3,0,0,3
Somalia,20/08/2004,1,0,0,0,0,1,0,2
Somalia,21/08/2004,0,0,0,0,0,0,0,0
Somalia,22/08/2004,9,0,0,0,-2,0,0,7
Somalia,23/08/2004,1,0,0,0,0,0,0,1
Somalia,24/08/2004,7,0,0,0,0,0,0,7
Somalia,26/08/2004,0,0,0,0,3,0,0,3
Somalia,27/08/2004,1,0,0,0,0,0,0,1
Somalia,28/08/2004,-2,0,0,0,2,0,0,0
Somalia,29/08/2004,1,0,0,0,0,0,0,1
Somalia,30/08/2004,4,0,0,0,0,0,0,4
Somalia,31/08/2004,1,0,0,0,0,1,0,2
Somalia,01/09/2004,2,0,0,0,0,0,0,2
Somalia,02/09/2004,5,0,0,0,0,-4,0,1
Somalia,03/09/2004,12,2,1,0,0,0,0,15
Somalia,04/09/2004,3,0,0,0,3,0,0,6
Somalia,05/09/2004,6,0,0,0,0,0,0,6
Somalia,06/09/2004,1,0,0,0,0,0,0,1
Somalia,07/09/2004,2,0,0,0,0,0,0,2
Somalia,08/09/2004,6,2,0,0,6,0,0,14
Somalia,09/09/2004,4,0,0,0,6,0,0,10
Somalia,11/09/2004,0,0,0,0,0,0,0,0
Somalia,12/09/2004,5,0,0,0,0,0,0,5
Somalia,13/09/2004,7,0,0,0,6,0,0,13
Somalia,14/09/2004,3,0,0,0,0,0,0,3
Somalia,15/09/2004,1,0,0,0,0,0,0,1
Somalia,16/09/2004,3,0,0,0,0,0,0,3
Somalia,17/09/2004,0,0,0,0,0,1,0,1
Somalia,18/09/2004,-1,0,0,0,0,0,0,-1
Somalia,19/09/2004,-6,0,0,0,0,0,0,-6
Somalia,20/09/2004,0,0,0,0,3,2,0,5
Somalia,21/09/2004,2,0,5,0,6,2,0,15
Somalia,22/09/2004,0,2,0,0,0,0,0,2
Somalia,24/09/2004,0,0,0,0,0,0,0,0
Somalia,25/09/2004,0,0,0,0,0,0,0,0
Somalia,26/09/2004,0,0,0,0,0,0,0,0
Somalia,27/09/2004,8,0,0,0,0,0,0,8
Somalia,28/09/2004,3,0,0,0,0,0,0,3
Somalia,29/09/2004,4,0,0,0,15,0,0,19
Somalia,30/09/2004,0,0,0,0,9,0,0,9
Somalia,01/10/2004,2,0,0,0,0,0,0,2
Somalia,02/10/2004,-2,0,0,0,3,0,0,1
Somalia,03/10/2004,0,0,2,0,0,0,0,2
Somalia,04/10/2004,0,0,0,0,-6,0,0,-6
Somalia,05/10/2004,0,0,0,0,12,0,0,12
Somalia,06/10/2004,12,0,0,0,1,0,0,13
Somalia,07/10/2004,2,0,0,0,3,0,0,5
Somalia,08/10/2004,11,0,0,0,0,0,0,11
Somalia,09/10/2004,1,0,0,0,0,0,0,1
Somalia,10/10/2004,3,0,0,0,0,3,0,6
Somalia,11/10/2004,5,0,0,0,24,0,0,29
Somalia,12/10/2004,6,0,0,0,3,0,0,9
Somalia,13/10/2004,3,0,0,0,-6,0,0,-3
Somalia,14/10/2004,11,0,0,0,0,0,0,11
Somalia,15/10/2004,10,0,0,0,0,0,0,10
Somalia,16/10/2004,11,0,0,0,0,0,0,11
Somalia,17/10/2004,0,0,0,0,0,0,0,0
Somalia,18/10/2004,3,0,0,0,0,2,0,5
Somalia,19/10/2004,8,2,0,0,3,0,0,13
Somalia,20/10/2004,5,0,0,0,3,0,0,8
Somalia,21/10/2004,0,2,0,0,0,0,0,2
Somalia,22/10/2004,0,0,0,0,0,0,0,0
Somalia,23/10/2004,8,2,0,0,0,0,0,10
Somalia,24/10/2004,0,0,0,0,0,0,0,0
Somalia,25/10/2004,10,0,0,0,0,0,0,10
Somalia,26/10/2004,6,0,0,0,6,0,0,12
Somalia,27/10/2004,0,0,0,0,3,0,0,3
Somalia,28/10/2004,0,0,0,0,0,0,0,0
Somalia,29/10/2004,15,0,0,0,9,1,0,25
Somalia,30/10/2004,33,0,0,0,0,1,0,34
Somalia,31/10/2004,0,0,0,0,0,0,0,0
Somalia,01/11/2004,18,0,0,0,0,1,0,19
Somalia,02/11/2004,0,0,0,0,0,1,0,1
Somalia,03/11/2004,1,0,0,0,0,0,0,1
Somalia,04/11/2004,5,6,0,0,9,0,0,20
Somalia,05/11/2004,3,0,0,0,0,0,0,3
Somalia,06/11/2004,7,0,0,0,6,2,0,15
Somalia,07/11/2004,10,0,0,0,0,4,0,14
Somalia,08/11/2004,8,0,-2,0,-2,0,0,4
Somalia,09/11/2004,0,0,0,0,0,3,0,3
Somalia,10/11/2004,-1,0,0,0,0,0,0,-1
Somalia,11/11/2004,0,2,0,0,0,0,0,2
Somalia,12/11/2004,0,0,0,0,0,0,0,0
Somalia,13/11/2004,6,0,0,0,3,0,0,9
Somalia,14/11/2004,0,0,0,0,0,0,0,0
Somalia,15/11/2004,0,0,0,0,3,0,0,3
Somalia,16/11/2004,3,0,0,0,0,0,0,3
Somalia,17/11/2004,28,0,0,0,1,0,0,29
Somalia,18/11/2004,1,0,0,0,1,0,0,2
Somalia,19/11/2004,4,0,0,0,0,1,0,5
Somalia,20/11/2004,0,0,0,0,6,0,0,6
Somalia,21/11/2004,0,0,0,0,0,4,0,4
Somalia,22/11/2004,0,0,0,0,0,0,0,0
Somalia,23/11/2004,2,0,0,0,-2,0,0,0
Somalia,24/11/2004,0,0,0,0,0,0,0,0
Somalia,25/11/2004,0,0,0,0,0,0,0,0
Somalia,26/11/2004,0,2,0,0,0,0,0,2
Somalia,27/11/2004,0,0,0,0,0,0,0,0
Somalia,28/11/2004,0,0,0,0,0,0,0,0
Somalia,29/11/2004,5,0,0,0,0,0,0,5
Somalia,30/11/2004,11,0,0,0,0,0,0,11
Somalia,01/12/2004,0,0,0,0,0,0,0,0
Somalia,02/12/2004,11,0,0,0,0,0,0,11
Somalia,03/12/2004,0,0,0,0,0,1,0,1
Somalia,04/12/2004,1,0,0,0,6,0,0,7
Somalia,06/12/2004,2,4,0,0,0,0,0,6
Somalia,07/12/2004,3,0,-2,0,0,0,0,1
Somalia,08/12/2004,3,0,0,0,0,0,0,3
Somalia,09/12/2004,5,0,0,0,0,0,0,5
Somalia,10/12/2004,0,0,0,0,0,0,0,0
Somalia,11/12/2004,4,0,0,0,0,0,0,4
Somalia,12/12/2004,0,0,0,0,6,0,0,6
Somalia,13/12/2004,5,0,0,0,6,0,0,11
Somalia,14/12/2004,1,0,0,0,0,0,0,1
Somalia,15/12/2004,0,0,0,0,6,0,0,6
Somalia,16/12/2004,1,0,0,0,9,0,0,10
Somalia,20/12/2004,-2,0,0,0,0,0,0,-2
Somalia,21/12/2004,0,0,0,0,0,0,0,0
Somalia,22/12/2004,3,0,0,0,0,0,0,3
Somalia,23/12/2004,5,0,0,0,0,0,0,5
Somalia,24/12/2004,2,0,0,0,0,0,0,2
Somalia,25/12/2004,0,0,0,0,0,0,0,0
Somalia,26/12/2004,2,0,0,0,0,0,0,2
Somalia,27/12/2004,66,2,0,0,-4,0,0,64
Somalia,28/12/2004,11,4,0,0,0,2,0,17
Somalia,29/12/2004,25,0,0,0,0,0,0,25
Somalia,30/12/2004,27,0,0,0,0,0,0,27
Somalia,31/12/2004,14,0,0,0,0,0,0,14
Syria,01/01/2004,-1,0,0,0,0,0,0,-1
Syria,02/01/2004,12,0,0,0,0,0,0,12
Syria,03/01/2004,0,0,0,0,9,0,0,9
Syria,04/01/2004,-1,0,0,0,4,0,0,3
Syria,05/01/2004,9,0,0,0,15,0,0,24
Syria,06/01/2004,0,0,0,0,2,1,0,3
Syria,07/01/2004,6,0,0,0,0,0,0,6
Syria,08/01/2004,5,0,-4,0,7,0,0,8
Syria,09/01/2004,8,0,0,0,0,0,0,8
Syria,10/01/2004,2,0,0,0,0,8,0,10
Syria,11/01/2004,14,2,-1,0,0,1,0,16
Syria,12/01/2004,-2,0,1,0,6,0,0,5
Syria,13/01/2004,11,0,0,0,-2,0,0,9
Syria,14/01/2004,7,0,0,0,0,0,0,7
Syria,15/01/2004,6,0,0,0,0,1,0,7
Syria,16/01/2004,2,0,0,0,3,0,0,5
Syria,17/01/2004,11,0,0,0,3,0,0,14
Syria,18/01/2004,4,0,-2,0,1,0,0,3
Syria,19/01/2004,8,0,0,0,3,0,0,11
Syria,20/01/2004,30,0,0,0,3,1,0,34
Syria,21/01/2004,11,0,0,0,9,1,0,21
Syria,22/01/2004,15,0,1,0,10,0,0,26
Syria,23/01/2004,6,0,1,0,9,0,0,16
Syria,24/01/2004,9,0,0,0,-11,0,0,-2
Syria,25/01/2004,-4,0,0,0,1,0,0,-3
Syria,26/01/2004,-1,0,0,0,-1,0,0,-2
Syria,27/01/2004,3,0,0,0,3,0,0,6
Syria,28/01/2004,1,0,0,0,-2,0,0,-1
Syria,29/01/2004,8,0,0,0,15,0,0,23
Syria,30/01/2004,0,0,0,0,0,0,0,0
Syria,31/01/2004,0,0,1,0,0,0,0,1
Syria,01/02/2004,9,0,0,0,3,1,0,13
Syria,02/02/2004,12,0,0,0,6,0,0,18
Syria,03/02/2004,4,0,-2,0,-4,0,0,-2
Syria,04/02/2004,0,0,0,0,-6,0,0,-6
Syria,05/02/2004,0,0,0,0,3,0,0,3
Syria,06/02/2004,5,0,0,0,-1,0,0,4
Syria,07/02/2004,2,0,0,0,-4,0,0,-2
Syria,08/02/2004,0,0,0,0,0,0,0,0
Syria,09/02/2004,6,0,0,0,3,0,0,9
Syria,10/02/2004,11,0,0,0,0,0,0,11
Syria,11/02/2004,-1,0,0,0,0,0,0,-1
Syria,12/02/2004,-3,0,0,0,5,1,0,3
Syria,13/02/2004,3,0,0,0,0,6,0,9
Syria,14/02/2004,2,0,0,0,3,0,0,5
Syria,15/02/2004,50,0,0,0,1,0,0,51
Syria,16/02/2004,20,0,0,0,6,0,0,26
Syria,17/02/2004,8,0,0,0,6,0,0,14
Syria,18/02/2004,0,0,0,0,0,0,0,0
Syria,19/02/2004,5,0,0,0,0,0,0,5
Syria,20/02/2004,0,0,0,0,-4,0,0,-4
Syria,21/02/2004,0,0,0,0,0,0,0,0
Syria,22/02/2004,0,0,0,0,-6,1,0,-5
Syria,23/02/2004,3,0,0,0,0,0,0,3
Syria,24/02/2004,3,0,0,0,3,0,0,6
Syria,25/02/2004,12,0,0,0,-1,2,0,13
Syria,26/02/2004,0,0,0,0,17,0,0,17
Syria,27/02/2004,8,0,0,0,3,0,0,11
Syria,28/02/2004,0,0,0,0,0,0,0,0
Syria,29/02/2004,9,0,0,0,0,0,0,9
Syria,01/03/2004,8,0,0,0,6,0,0,14
Syria,02/03/2004,8,0,0,0,18,6,0,32
Syria,03/03/2004,0,0,0,0,3,3,0,6
Syria,04/03/2004,3,0,0,0,3,0,0,6
Syria,05/03/2004,10,0,0,0,-2,1,0,9
Syria,06/03/2004,0,0,0,0,0,0,0,0
Syria,07/03/2004,2,0,0,0,0,0,0,2
Syria,08/03/2004,0,0,0,0,6,1,0,7
Syria,09/03/2004,11,0,0,0,-2,0,0,9
Syria,10/03/2004,14,0,0,0,17,3,0,34
Syria,11/03/2004,4,0,0,0,2,0,0,6
Syria,12/03/2004,6,0,0,0,7,2,0,15
Syria,13/03/2004,13,0,0,0,0,0,0,13
Syria,14/03/2004,1,0,0,0,3,0,0,4
Syria,15/03/2004,-3,0,0,0,-2,0,0,-5
Syria,16/03/2004,6,0,0,0,0,4,0,10
Syria,17/03/2004,9,0,0,0,0,2,0,11
Syria,18/03/2004,4,0,0,0,0,9,0,13
Syria,19/03/2004,8,0,0,0,0,0,0,8
Syria,20/03/2004,2,0,0,0,-1,0,0,1
Syria,21/03/2004,0,0,0,0,3,0,0,3
Syria,22/03/2004,2,0,0,0,0,1,0,3
Syria,23/03/2004,16,0,0,0,14,3,0,33
Syria,24/03/2004,2,0,0,0,0,0,0,2
Syria,25/03/2004,8,2,0,0,6,0,0,16
Syria,26/03/2004,6,0,1,0,0,2,0,9
Syria,27/03/2004,8,0,-2,0,0,0,0,6
Syria,28/03/2004,9,0,0,0,0,3,0,12
Syria,29/03/2004,17,0,0,0,4,0,0,21
Syria,30/03/2004,20,0,0,0,24,0,0,44
Syria,31/03/2004,5,0,0,0,10,0,0,15
Syria,01/04/2004,19,0,0,0,18,0,0,37
Syria,02/04/2004,5,0,0,0,-8,0,0,-3
Syria,03/04/2004,0,0,0,0,0,0,0,0
Syria,04/04/2004,12,0,0,0,0,0,0,12
Syria,05/04/2004,0,0,0,0,0,0,0,0
Syria,06/04/2004,6,0,0,0,2,0,0,8
Syria,07/04/2004,14,0,0,0,1,0,0,15
Syria,08/04/2004,9,0,-2,0,3,0,0,10
Syria,09/04/2004,4,0,0,0,3,0,0,7
Syria,10/04/2004,0,0,0,0,7,7,0,14
Syria,11/04/2004,-3,0,0,0,18,1,0,16
Syria,12/04/2004,8,0,0,0,6,0,0,14
Syria,13/04/2004,3,0,0,0,12,0,0,15
Syria,14/04/2004,8,0,0,0,10,3,0,21
Syria,15/04/2004,3,0,0,0,3,1,0,7
Syria,16/04/2004,4,0,0,0,4,0,0,8
Syria,17/04/2004,1,0,0,0,-4,0,0,-3
Syria,18/04/2004,29,0,0,0,-2,4,0,31
Syria,19/04/2004,15,0,0,0,0,8,0,23
Syria,20/04/2004,24,0,0,0,2,1,0,27
Syria,21/04/2004,37,0,0,0,15,0,0,52
Syria,22/04/2004,17,0,0,0,20,0,0,37
Syria,23/04/2004,-3,0,0,0,6,0,0,3
Syria,24/04/2004,1,0,0,0,3,1,0,5
Syria,25/04/2004,0,0,0,0,0,0,0,0
Syria,26/04/2004,17,0,0,0,0,0,0,17
Syria,27/04/2004,1,0,-6,0,6,0,0,1
Syria,28/04/2004,0,0,-6,0,3,0,0,-3
Syria,29/04/2004,3,0,0,0,0,2,0,5
Syria,30/04/2004,4,0,0,0,6,0,0,10
Syria,01/05/2004,11,0,0,0,-6,0,0,5
Syria,02/05/2004,3,0,0,0,9,0,0,12
Syria,03/05/2004,0,0,0,0,0,0,0,0
Syria,04/05/2004,2,0,0,0,0,0,0,2
Syria,05/05/2004,6,0,0,0,0,0,0,6
Syria,06/05/2004,22,0,0,0,9,0,0,31
Syria,07/05/2004,18,0,0,0,0,0,0,18
Syria,08/05/2004,3,0,0,0,0,2,0,5
Syria,09/05/2004,7,0,0,0,0,0,0,7
Syria,10/05/2004,-1,0,0,0,0,0,0,-1
Syria,11/05/2004,2,0,1,0,6,0,0,9
Syria,12/05/2004,6,0,0,0,9,3,0,18
Syria,13/05/2004,11,0,0,0,0,0,0,11
Syria,14/05/2004,-3,0,0,0,-3,0,0,-6
Syria,15/05/2004,3,0,0,0,3,0,0,6
Syria,16/05/2004,2,0,0,0,0,0,0,2
Syria,17/05/2004,3,0,0,0,3,0,0,6
Syria,18/05/2004,4,0,0,0,0,0,0,4
Syria,19/05/2004,14,0,0,0,-4,6,0,16
Syria,20/05/2004,16,0,0,0,0,0,0,16
Syria,21/05/2004,9,0,0,0,0,0,0,9
Syria,22/05/2004,0,0,0,0,0,2,0,2
Syria,23/05/2004,1,0,0,0,3,2,0,6
Syria,24/05/2004,22,0,0,0,0,1,0,23
Syria,25/05/2004,17,0,0,0,6,1,0,24
Syria,26/05/2004,9,0,0,0,2,0,0,11
Syria,27/05/2004,5,0,0,0,8,3,0,16
Syria,28/05/2004,3,0,0,0,0,2,0,5
Syria,29/05/2004,-1,0,0,0,3,0,0,2
Syria,30/05/2004,0,0,0,0,0,0,0,0
Syria,31/05/2004,6,0,0,0,6,0,0,12
Syria,01/06/2004,1,0,0,0,6,2,0,9
Syria,02/06/2004,-7,0,0,0,0,0,0,-7
Syria,03/06/2004,1,0,0,0,3,0,0,4
Syria,04/06/2004,2,0,0,0,0,0,0,2
Syria,05/06/2004,3,0,0,0,0,0,0,3
Syria,06/06/2004,12,0,0,0,6,1,0,19
Syria,07/06/2004,1,0,0,0,0,0,0,1
Syria,08/06/2004,7,0,0,0,0,0,0,7
Syria,09/06/2004,0,0,0,0,0,0,0,0
Syria,10/06/2004,3,0,0,0,12,0,0,15
Syria,11/06/2004,15,0,0,0,0,2,0,17
Syria,12/06/2004,12,0,0,0,0,2,0,14
Syria,13/06/2004,25,0,0,0,0,3,0,28
Syria,14/06/2004,5,0,0,0,0,0,0,5
Syria,15/06/2004,10,0,0,0,8,1,0,19
Syria,16/06/2004,0,0,0,0,3,6,0,9
Syria,17/06/2004,6,0,1,0,18,0,0,25
Syria,18/06/2004,0,0,0,0,-4,0,0,-4
Syria,19/06/2004,4,0,0,0,6,0,0,10
Syria,20/06/2004,0,0,0,0,0,0,0,0
Syria,21/06/2004,3,0,0,0,2,2,0,7
Syria,22/06/2004,0,0,0,0,0,0,0,0
Syria,23/06/2004,6,0,0,0,3,0,0,9
Syria,24/06/2004,0,0,1,0,7,0,0,8
Syria,25/06/2004,14,2,0,0,0,0,0,16
Syria,26/06/2004,12,0,0,0,6,0,0,18
Syria,27/06/2004,0,0,0,0,0,0,0,0
Syria,28/06/2004,3,0,0,0,3,0,0,6
Syria,29/06/2004,11,0,0,0,6,0,0,17
Syria,30/06/2004,0,0,0,0,0,0,0,0
Syria,01/07/2004,1,0,0,0,0,0,0,1
Syria,02/07/2004,0,0,0,0,0,0,0,0
Syria,03/07/2004,-3,0,0,0,6,0,0,3
Syria,04/07/2004,7,0,0,0,0,3,0,10
Syria,05/07/2004,2,0,0,0,0,0,0,2
Syria,06/07/2004,6,0,0,0,0,0,0,6
Syria,07/07/2004,4,0,0,0,3,0,0,7
Syria,08/07/2004,0,0,0,0,0,0,0,0
Syria,09/07/2004,0,0,0,0,0,0,0,0
Syria,10/07/2004,1,0,0,0,0,0,0,1
Syria,11/07/2004,0,0,0,0,0,0,0,0
Syria,12/07/2004,12,2,0,0,0,0,0,14
Syria,13/07/2004,-1,0,0,0,-2,0,0,-3
Syria,14/07/2004,0,0,0,0,12,0,0,12
Syria,15/07/2004,-3,0,0,0,0,0,0,-3
Syria,16/07/2004,2,0,0,0,-4,6,0,4
Syria,17/07/2004,0,0,0,0,0,0,0,0
Syria,18/07/2004,0,0,0,0,3,0,0,3
Syria,19/07/2004,1,0,0,0,0,0,0,1
Syria,20/07/2004,12,0,0,0,1,0,0,13
Syria,21/07/2004,23,0,0,0,3,0,0,26
Syria,22/07/2004,7,0,0,0,3,0,0,10
Syria,23/07/2004,0,0,0,0,0,0,0,0
Syria,24/07/2004,0,0,0,0,-4,0,0,-4
Syria,25/07/2004,0,0,0,0,-4,1,0,-3
Syria,26/07/2004,0,0,0,0,9,0,0,9
Syria,27/07/2004,-3,0,3,0,2,0,0,2
Syria,28/07/2004,0,0,0,0,0,0,0,0
Syria,29/07/2004,3,0,0,0,0,0,0,3
Syria,30/07/2004,0,0,0,0,9,0,0,9
Syria,31/07/2004,2,0,0,0,15,0,0,17
Syria,01/08/2004,21,0,0,0,0,0,0,21
Syria,02/08/2004,15,0,0,0,0,3,0,18
Syria,03/08/2004,9,0,0,0,18,0,0,27
Syria,04/08/2004,0,0,0,0,4,0,0,4
Syria,05/08/2004,2,0,2,0,0,0,0,4
Syria,06/08/2004,9,0,1,0,10,0,0,20
Syria,07/08/2004,0,0,0,0,0,0,0,0
Syria,08/08/2004,3,0,0,0,-2,0,0,1
Syria,09/08/2004,2,0,0,0,0,0,0,2
Syria,10/08/2004,0,0,0,0,0,0,0,0
Syria,11/08/2004,0,0,0,0,0,1,0,1
Syria,12/08/2004,1,0,0,0,19,3,0,23
Syria,13/08/2004,4,0,0,0,0,1,0,5
Syria,14/08/2004,2,0,0,0,9,2,0,13
Syria,15/08/2004,0,0,0,0,9,0,0,9
Syria,16/08/2004,7,0,0,0,-2,0,0,5
Syria,17/08/2004,8,0,0,0,15,0,0,23
Syria,18/08/2004,4,0,0,0,0,0,0,4
Syria,19/08/2004,2,0,0,0,0,0,0,2
Syria,20/08/2004,0,0,0,0,6,0,0,6
Syria,21/08/2004,3,0,0,0,3,0,0,6
Syria,22/08/2004,0,0,0,0,0,0,0,0
Syria,23/08/2004,0,0,0,0,-2,0,0,-2
Syria,24/08/2004,0,0,0,0,-4,0,0,-4
Syria,25/08/2004,0,0,0,0,9,0,0,9
Syria,26/08/2004,3,0,0,0,7,0,0,10
Syria,27/08/2004,0,0,0,0,-1,0,0,-1
Syria,28/08/2004,3,0,-2,0,0,0,0,1
Syria,29/08/2004,0,0,0,0,0,0,0,0
Syria,30/08/2004,5,0,0,0,0,0,0,5
Syria,31/08/2004,11,0,0,0,-6,0,0,5
Syria,01/09/2004,0,0,-2,0,0,2,0,0
Syria,02/09/2004,6,0,0,0,-1,0,0,5
Syria,03/09/2004,15,0,0,0,-1,0,0,14
Syria,04/09/2004,4,0,0,0,3,0,0,7
Syria,05/09/2004,11,0,0,0,0,0,0,11
Syria,06/09/2004,10,0,0,0,0,0,0,10
Syria,07/09/2004,4,0,0,0,0,3,0,7
Syria,08/09/2004,3,0,0,0,0,0,0,3
Syria,09/09/2004,21,4,-2,0,30,8,0,61
Syria,10/09/2004,6,0,0,0,3,2,0,11
Syria,11/09/2004,6,0,0,0,0,0,0,6
Syria,12/09/2004,0,0,0,0,9,0,0,9
Syria,13/09/2004,11,0,-4,0,0,8,0,15
Syria,14/09/2004,3,0,0,0,15,1,0,19
Syria,15/09/2004,-3,0,0,0,0,0,0,-3
Syria,16/09/2004,0,0,0,0,7,0,0,7
Syria,17/09/2004,6,0,0,0,4,2,0,12
Syria,18/09/2004,1,0,0,0,-3,0,0,-2
Syria,19/09/2004,2,0,0,0,6,0,0,8
Syria,20/09/2004,1,0,0,0,9,1,0,11
Syria,21/09/2004,0,0,0,0,0,0,0,0
Syria,22/09/2004,-4,0,0,0,18,0,0,14
Syria,23/09/2004,-4,0,0,0,0,1,0,-3
Syria,24/09/2004,0,0,0,0,-2,0,0,-2
Syria,25/09/2004,5,2,0,0,0,0,0,7
Syria,26/09/2004,6,0,0,0,6,1,0,13
Syria,27/09/2004,2,6,0,0,12,0,0,20
Syria,28/09/2004,12,0,0,0,12,2,0,26
Syria,29/09/2004,-2,0,0,0,12,0,0,10
Syria,30/09/2004,0,0,0,0,9,1,0,10
Syria,01/10/2004,-3,0,2,0,9,6,0,14
Syria,02/10/2004,0,0,0,0,15,0,0,15
Syria,03/10/2004,-7,0,0,0,0,3,0,-4
Syria,04/10/2004,4,0,0,0,6,0,0,10
Syria,05/10/2004,0,0,0,0,6,0,0,6
Syria,06/10/2004,6,0,0,0,9,1,0,16
Syria,07/10/2004,2,0,0,0,-2,0,0,0
Syria,08/10/2004,0,0,0,0,3,0,0,3
Syria,09/10/2004,6,0,2,0,0,0,0,8
Syria,10/10/2004,6,0,0,0,9,2,0,17
Syria,11/10/2004,0,0,0,0,5,0,0,5
Syria,12/10/2004,4,0,0,0,0,0,0,4
Syria,13/10/2004,11,0,0,0,6,0,0,17
Syria,14/10/2004,50,0,0,0,6,0,0,56
Syria,15/10/2004,11,0,0,0,6,6,0,23
Syria,16/10/2004,3,0,0,0,0,6,0,9
Syria,17/10/2004,1,0,0,0,12,0,0,13
Syria,18/10/2004,2,0,-4,0,3,0,0,1
Syria,19/10/2004,7,0,0,0,3,0,0,10
Syria,20/10/2004,9,0,-8,0,-8,1,0,-6
Syria,21/10/2004,-2,0,-2,0,0,0,0,-4
Syria,22/10/2004,3,0,0,0,0,0,0,3
Syria,23/10/2004,3,0,0,0,3,0,0,6
Syria,24/10/2004,3,0,0,0,6,0,0,9
Syria,25/10/2004,6,0,0,0,0,0,0,6
Syria,26/10/2004,7,0,-8,0,6,0,0,5
Syria,27/10/2004,19,0,0,0,0,0,0,19
Syria,28/10/2004,2,0,0,0,3,-4,0,1
Syria,29/10/2004,0,0,0,0,0,0,0,0
Syria,30/10/2004,0,0,0,0,0,0,0,0
Syria,31/10/2004,-1,0,0,0,-1,0,0,-2
Syria,01/11/2004,3,0,0,0,0,0,0,3
Syria,02/11/2004,4,0,0,0,-2,0,0,2
Syria,03/11/2004,2,0,0,0,3,0,0,5
Syria,04/11/2004,4,0,0,0,0,0,0,4
Syria,05/11/2004,3,0,0,0,12,0,0,15
Syria,06/11/2004,0,0,0,0,0,0,0,0
Syria,07/11/2004,14,0,0,0,2,0,0,16
Syria,08/11/2004,14,2,0,0,9,0,0,25
Syria,09/11/2004,11,0,0,0,2,6,0,19
Syria,10/11/2004,11,0,0,0,0,0,0,11
Syria,11/11/2004,26,0,0,0,3,2,0,31
Syria,12/11/2004,17,0,0,0,-2,0,0,15
Syria,13/11/2004,7,0,0,0,6,0,0,13
Syria,14/11/2004,4,0,0,0,3,0,0,7
Syria,15/11/2004,6,0,0,0,0,0,0,6
Syria,16/11/2004,3,0,-2,0,0,0,0,1
Syria,17/11/2004,1,0,0,0,0,0,0,1
Syria,18/11/2004,8,0,0,0,0,1,0,9
Syria,19/11/2004,14,0,0,0,1,1,0,16
Syria,20/11/2004,0,0,0,0,0,0,0,0
Syria,21/11/2004,19,2,0,0,-2,0,0,19
Syria,22/11/2004,2,0,0,0,3,0,0,5
Syria,23/11/2004,4,0,0,0,9,1,0,14
Syria,24/11/2004,2,0,0,0,6,2,0,10
Syria,25/11/2004,0,0,0,0,0,0,0,0
Syria,26/11/2004,15,0,0,0,18,0,0,33
Syria,27/11/2004,-3,0,0,0,0,0,0,-3
Syria,28/11/2004,7,0,0,0,3,0,0,10
Syria,29/11/2004,-1,0,0,0,-3,0,0,-4
Syria,30/11/2004,11,0,0,0,0,0,0,11
Syria,01/12/2004,5,0,0,0,0,0,0,5
Syria,02/12/2004,7,0,0,0,0,0,0,7
Syria,03/12/2004,18,0,0,0,3,0,0,21
Syria,04/12/2004,-3,0,0,0,12,1,0,10
Syria,05/12/2004,0,0,0,0,6,0,0,6
Syria,06/12/2004,-1,0,0,0,0,0,0,-1
Syria,07/12/2004,9,0,0,0,1,4,0,14
Syria,08/12/2004,3,0,0,0,6,0,0,9
Syria,09/12/2004,1,0,0,0,-1,0,0,0
Syria,10/12/2004,1,0,0,0,10,2,0,13
Syria,11/12/2004,15,0,0,0,0,0,0,15
Syria,12/12/2004,0,0,0,0,0,2,0,2
Syria,13/12/2004,0,0,0,0,0,0,0,0
Syria,14/12/2004,0,0,0,0,0,0,0,0
Syria,15/12/2004,6,0,0,0,19,0,0,25
Syria,16/12/2004,-1,0,0,0,0,0,0,-1
Syria,17/12/2004,1,0,0,0,0,2,0,3
Syria,18/12/2004,-6,0,0,0,0,0,0,-6
Syria,19/12/2004,3,0,0,0,6,0,0,9
Syria,20/12/2004,1,0,0,0,0,0,0,1
Syria,21/12/2004,13,0,0,0,30,0,0,43
Syria,22/12/2004,7,0,0,0,2,0,0,9
Syria,23/12/2004,3,0,0,0,3,0,0,6
Syria,24/12/2004,0,0,0,0,6,0,0,6
Syria,25/12/2004,9,0,0,0,0,0,0,9
Syria,26/12/2004,10,0,0,0,6,0,0,16
Syria,27/12/2004,21,0,0,0,3,1,0,25
Syria,28/12/2004,0,0,0,0,3,1,0,4
Syria,29/12/2004,0,0,0,0,0,0,0,0
Syria,30/12/2004,7,0,0,0,3,1,0,11
Syria,31/12/2004,0,0,0,0,3,0,0,3
Yemen,02/01/2004,0,0,0,0,0,1,0,1
Yemen,03/01/2004,2,0,0,0,0,0,0,2
Yemen,04/01/2004,0,0,0,0,0,0,0,0
Yemen,05/01/2004,4,0,0,0,6,0,0,10
Yemen,06/01/2004,0,0,0,0,0,0,0,0
Yemen,07/01/2004,0,0,0,0,6,0,0,6
Yemen,08/01/2004,0,0,0,0,0,0,0,0
Yemen,09/01/2004,2,0,0,0,0,0,0,2
Yemen,10/01/2004,2,0,0,0,0,0,0,2
Yemen,11/01/2004,0,0,0,0,0,0,0,0
Yemen,12/01/2004,-1,0,0,0,0,0,0,-1
Yemen,15/01/2004,0,0,0,0,-6,0,0,-6
Yemen,16/01/2004,0,0,0,0,0,0,0,0
Yemen,17/01/2004,0,0,0,0,0,2,0,2
Yemen,18/01/2004,3,0,0,0,0,0,0,3
Yemen,19/01/2004,3,0,0,0,0,0,0,3
Yemen,20/01/2004,0,0,0,0,0,0,0,0
Yemen,22/01/2004,3,0,0,0,0,0,0,3
Yemen,23/01/2004,8,0,0,0,3,0,0,11
Yemen,24/01/2004,0,0,0,0,0,0,0,0
Yemen,25/01/2004,-1,0,0,0,3,4,0,6
Yemen,26/01/2004,2,0,0,0,0,0,0,2
Yemen,27/01/2004,0,0,0,0,3,0,0,3
Yemen,28/01/2004,0,0,0,0,0,0,0,0
Yemen,29/01/2004,15,0,0,0,3,0,0,18
Yemen,31/01/2004,0,0,0,0,0,0,0,0
Yemen,01/02/2004,0,0,0,0,0,0,0,0
Yemen,03/02/2004,0,0,0,0,0,0,0,0
Yemen,04/02/2004,5,0,0,0,15,0,0,20
Yemen,05/02/2004,5,0,0,0,9,0,0,14
Yemen,06/02/2004,1,0,0,0,0,0,0,1
Yemen,07/02/2004,3,0,0,0,6,0,0,9
Yemen,08/02/2004,0,0,0,0,0,0,0,0
Yemen,09/02/2004,8,0,0,0,3,0,0,11
Yemen,10/02/2004,2,0,0,0,0,0,0,2
Yemen,11/02/2004,10,0,0,0,36,0,0,46
Yemen,12/02/2004,0,2,0,0,6,1,0,9
Yemen,13/02/2004,2,0,0,0,0,0,0,2
Yemen,16/02/2004,0,0,0,0,0,0,0,0
Yemen,17/02/2004,13,0,0,0,0,0,0,13
Yemen,18/02/2004,6,0,0,0,3,0,0,9
Yemen,19/02/2004,2,0,0,0,0,0,0,2
Yemen,20/02/2004,7,0,0,0,0,0,0,7
Yemen,21/02/2004,1,0,0,0,0,1,0,2
Yemen,22/02/2004,0,0,0,0,0,0,0,0
Yemen,23/02/2004,0,0,0,0,3,0,0,3
Yemen,24/02/2004,2,0,0,0,6,1,0,9
Yemen,25/02/2004,0,0,0,0,0,0,0,0
Yemen,26/02/2004,1,0,0,0,12,0,0,13
Yemen,27/02/2004,0,0,0,0,0,0,0,0
Yemen,28/02/2004,4,0,0,0,0,0,0,4
Yemen,01/03/2004,0,0,0,0,0,0,0,0
Yemen,02/03/2004,0,0,0,0,0,0,0,0
Yemen,03/03/2004,2,0,0,0,9,0,0,11
Yemen,04/03/2004,9,0,0,0,3,0,0,12
Yemen,05/03/2004,1,0,0,0,6,0,0,7
Yemen,06/03/2004,9,0,2,0,38,0,0,49
Yemen,07/03/2004,8,0,0,0,8,6,0,22
Yemen,08/03/2004,2,0,0,0,25,1,0,28
Yemen,09/03/2004,4,0,0,0,0,0,0,4
Yemen,10/03/2004,-1,0,0,0,-2,0,0,-3
Yemen,11/03/2004,1,0,0,0,0,0,0,1
Yemen,12/03/2004,4,0,0,0,0,0,0,4
Yemen,13/03/2004,-2,0,0,0,6,0,0,4
Yemen,14/03/2004,0,0,0,0,0,0,0,0
Yemen,15/03/2004,10,0,0,0,3,0,0,13
Yemen,16/03/2004,13,0,0,0,2,0,0,15
Yemen,17/03/2004,0,0,0,0,3,0,0,3
Yemen,18/03/2004,8,0,0,0,6,0,0,14
Yemen,19/03/2004,12,0,0,0,12,1,0,25
Yemen,20/03/2004,0,0,0,0,3,1,0,4
Yemen,21/03/2004,0,0,0,0,15,0,0,15
Yemen,22/03/2004,1,0,0,0,3,0,0,4
Yemen,23/03/2004,4,0,1,0,3,2,0,10
Yemen,24/03/2004,3,0,0,0,0,0,0,3
Yemen,25/03/2004,5,0,0,0,0,0,0,5
Yemen,26/03/2004,1,0,0,0,0,0,0,1
Yemen,27/03/2004,3,0,0,0,0,0,0,3
Yemen,28/03/2004,0,0,0,0,-4,0,0,-4
Yemen,29/03/2004,8,0,0,0,0,0,0,8
Yemen,30/03/2004,0,0,0,0,-6,0,0,-6
Yemen,31/03/2004,29,0,0,0,2,0,0,31
Yemen,01/04/2004,-1,0,0,0,6,0,0,5
Yemen,02/04/2004,13,0,0,0,3,0,0,16
Yemen,04/04/2004,0,0,0,0,0,0,0,0
Yemen,05/04/2004,8,0,0,0,0,0,0,8
Yemen,06/04/2004,7,0,0,0,0,0,0,7
Yemen,07/04/2004,2,0,0,0,13,0,0,15
Yemen,08/04/2004,12,0,0,0,0,0,0,12
Yemen,10/04/2004,4,0,0,0,9,0,0,13
Yemen,11/04/2004,0,0,0,0,0,0,0,0
Yemen,12/04/2004,3,0,0,0,0,0,0,3
Yemen,13/04/2004,3,0,0,0,3,0,0,6
Yemen,14/04/2004,2,0,0,0,0,0,0,2
Yemen,15/04/2004,0,0,0,0,0,0,0,0
Yemen,16/04/2004,0,0,0,0,0,0,0,0
Yemen,17/04/2004,0,0,0,0,0,0,0,0
Yemen,18/04/2004,9,0,0,0,0,10,0,19
Yemen,19/04/2004,3,0,0,0,0,1,0,4
Yemen,20/04/2004,0,0,0,0,0,0,0,0
Yemen,21/04/2004,0,0,0,0,0,0,0,0
Yemen,22/04/2004,12,0,0,0,0,0,0,12
Yemen,23/04/2004,0,0,0,0,0,0,0,0
Yemen,24/04/2004,9,0,0,0,0,0,0,9
Yemen,25/04/2004,3,0,0,0,0,0,0,3
Yemen,26/04/2004,4,0,0,0,0,0,0,4
Yemen,27/04/2004,7,0,0,0,6,0,0,13
Yemen,28/04/2004,8,0,0,0,3,0,0,11
Yemen,29/04/2004,5,0,0,0,6,0,0,11
Yemen,30/04/2004,6,0,0,0,6,6,0,18
Yemen,01/05/2004,3,0,0,0,0,0,0,3
Yemen,02/05/2004,0,0,0,0,0,0,0,0
Yemen,03/05/2004,0,0,0,0,1,0,0,1
Yemen,04/05/2004,5,0,0,0,0,0,0,5
Yemen,05/05/2004,9,4,0,0,3,0,0,16
Yemen,06/05/2004,8,0,0,0,0,0,0,8
Yemen,07/05/2004,-2,0,0,0,-1,0,0,-3
Yemen,08/05/2004,0,0,0,0,-2,0,0,-2
Yemen,09/05/2004,0,0,0,0,0,0,0,0
Yemen,10/05/2004,0,0,0,0,0,0,0,0
Yemen,11/05/2004,5,0,0,0,0,0,0,5
Yemen,12/05/2004,4,0,0,0,3,0,0,7
Yemen,13/05/2004,3,0,0,0,0,0,0,3
Yemen,14/05/2004,3,0,0,0,0,0,0,3
Yemen,15/05/2004,0,0,0,0,0,0,0,0
Yemen,16/05/2004,0,0,0,0,0,0,0,0
Yemen,17/05/2004,9,0,0,0,0,0,0,9
Yemen,18/05/2004,0,0,0,0,0,0,0,0
Yemen,19/05/2004,0,0,0,0,0,0,0,0
Yemen,20/05/2004,-6,0,0,0,0,0,0,-6
Yemen,21/05/2004,-1,0,0,0,0,0,0,-1
Yemen,22/05/2004,9,0,0,0,0,0,0,9
Yemen,23/05/2004,3,0,0,0,0,3,0,6
Yemen,24/05/2004,5,0,0,0,9,0,0,14
Yemen,25/05/2004,2,0,0,0,3,0,0,5
Yemen,26/05/2004,19,0,0,0,0,0,0,19
Yemen,27/05/2004,21,0,0,0,23,0,0,44
Yemen,28/05/2004,16,0,0,0,1,1,0,18
Yemen,29/05/2004,5,0,0,0,3,0,0,8
Yemen,30/05/2004,10,0,0,0,0,0,0,10
Yemen,31/05/2004,2,0,0,0,3,0,0,5
Yemen,01/06/2004,0,0,0,0,9,0,0,9
Yemen,02/06/2004,0,0,0,0,0,0,0,0
Yemen,03/06/2004,5,0,0,0,12,0,0,17
Yemen,06/06/2004,0,0,0,0,0,0,0,0
Yemen,07/06/2004,0,0,0,0,0,1,0,1
Yemen,08/06/2004,2,0,0,0,3,0,0,5
Yemen,09/06/2004,4,0,0,0,3,0,0,7
Yemen,10/06/2004,3,0,0,0,3,1,0,7
Yemen,11/06/2004,0,0,0,0,0,0,0,0
Yemen,12/06/2004,12,0,0,0,0,0,0,12
Yemen,13/06/2004,0,0,0,0,0,0,0,0
Yemen,14/06/2004,0,0,0,0,6,0,0,6
Yemen,16/06/2004,0,0,0,0,0,0,0,0
Yemen,17/06/2004,0,0,0,0,0,0,0,0
Yemen,18/06/2004,21,0,0,0,6,0,0,27
Yemen,19/06/2004,30,0,0,0,10,0,0,40
Yemen,20/06/2004,12,0,0,0,0,0,0,12
Yemen,21/06/2004,28,0,0,0,0,1,0,29
Yemen,22/06/2004,3,0,0,0,0,0,0,3
Yemen,23/06/2004,0,0,0,0,0,0,0,0
Yemen,24/06/2004,0,0,-1,0,0,0,0,-1
Yemen,25/06/2004,0,0,0,0,3,0,0,3
Yemen,26/06/2004,0,0,0,0,0,0,0,0
Yemen,27/06/2004,2,0,0,0,0,6,0,8
Yemen,28/06/2004,6,0,0,0,3,6,0,15
Yemen,29/06/2004,30,0,0,0,0,0,0,30
Yemen,30/06/2004,15,0,0,0,0,3,0,18
Yemen,01/07/2004,17,0,0,0,3,0,0,20
Yemen,02/07/2004,7,0,0,0,0,2,0,9
Yemen,03/07/2004,0,0,0,0,0,0,0,0
Yemen,05/07/2004,3,0,0,0,0,0,0,3
Yemen,06/07/2004,3,0,0,0,0,0,0,3
Yemen,07/07/2004,23,0,0,0,9,0,0,32
Yemen,08/07/2004,2,0,0,0,0,6,0,8
Yemen,09/07/2004,1,0,0,0,3,0,0,4
Yemen,10/07/2004,8,0,0,0,0,0,0,8
Yemen,11/07/2004,0,0,0,0,0,0,0,0
Yemen,12/07/2004,0,0,0,0,0,0,0,0
Yemen,13/07/2004,4,0,0,0,0,0,0,4
Yemen,14/07/2004,1,0,0,0,12,0,0,13
Yemen,15/07/2004,2,0,0,0,0,0,0,2
Yemen,16/07/2004,0,0,0,0,0,0,0,0
Yemen,17/07/2004,3,0,0,0,0,0,0,3
Yemen,19/07/2004,0,0,0,0,0,0,0,0
Yemen,20/07/2004,0,0,0,0,0,0,0,0
Yemen,21/07/2004,0,0,0,0,9,0,0,9
Yemen,22/07/2004,0,0,0,0,3,0,0,3
Yemen,23/07/2004,22,0,0,0,6,0,0,28
Yemen,24/07/2004,1,0,0,0,0,0,0,1
Yemen,26/07/2004,0,0,0,0,0,0,0,0
Yemen,28/07/2004,2,0,0,0,2,0,0,4
Yemen,29/07/2004,5,0,0,0,0,0,0,5
Yemen,30/07/2004,15,0,0,0,0,0,0,15
Yemen,31/07/2004,0,0,0,0,6,0,0,6
Yemen,02/08/2004,0,0,0,0,0,0,0,0
Yemen,03/08/2004,5,0,0,0,12,-6,0,11
Yemen,04/08/2004,15,0,0,0,0,0,0,15
Yemen,05/08/2004,5,0,0,0,3,2,0,10
Yemen,06/08/2004,0,0,0,0,3,0,0,3
Yemen,07/08/2004,6,0,0,0,0,0,0,6
Yemen,08/08/2004,0,0,0,0,0,4,0,4
Yemen,10/08/2004,2,0,0,0,0,0,0,2
Yemen,11/08/2004,1,0,0,0,0,0,0,1
Yemen,12/08/2004,3,0,0,0,0,0,0,3
Yemen,13/08/2004,3,0,0,0,6,3,0,12
Yemen,14/08/2004,3,0,0,0,6,3,0,12
Yemen,16/08/2004,7,0,0,0,0,0,0,7
Yemen,17/08/2004,10,0,0,0,6,0,0,16
Yemen,18/08/2004,9,0,0,0,0,6,0,15
Yemen,19/08/2004,2,0,0,0,0,4,0,6
Yemen,20/08/2004,19,0,0,0,0,0,0,19
Yemen,21/08/2004,16,0,0,0,3,0,0,19
Yemen,22/08/2004,25,0,0,0,6,0,0,31
Yemen,23/08/2004,25,0,0,0,9,2,0,36
Yemen,24/08/2004,33,0,0,0,21,0,0,54
Yemen,25/08/2004,17,0,0,0,10,3,0,30
Yemen,26/08/2004,17,0,-2,0,9,3,0,27
Yemen,27/08/2004,8,0,0,0,3,0,0,11
Yemen,28/08/2004,6,0,0,0,36,12,0,54
Yemen,29/08/2004,6,0,0,0,6,12,0,24
Yemen,30/08/2004,1,0,0,0,0,0,0,1
Yemen,31/08/2004,0,0,0,0,9,0,0,9
Yemen,01/09/2004,7,0,0,0,6,0,0,13
Yemen,02/09/2004,2,0,0,0,-2,0,0,0
Yemen,03/09/2004,8,0,0,0,3,0,0,11
Yemen,04/09/2004,0,0,0,0,2,0,0,2
Yemen,05/09/2004,3,0,0,0,9,0,0,12
Yemen,06/09/2004,2,0,0,0,0,0,0,2
Yemen,07/09/2004,9,0,0,0,0,0,0,9
Yemen,08/09/2004,6,0,0,0,0,0,0,6
Yemen,09/09/2004,9,4,0,0,0,0,0,13
Yemen,10/09/2004,58,0,0,0,3,0,0,61
Yemen,11/09/2004,4,2,0,0,0,0,0,6
Yemen,12/09/2004,0,0,0,0,0,0,0,0
Yemen,13/09/2004,2,0,0,0,0,0,0,2
Yemen,14/09/2004,7,0,0,0,0,6,0,13
Yemen,15/09/2004,4,0,0,0,3,0,0,7
Yemen,16/09/2004,9,0,0,0,5,1,0,15
Yemen,18/09/2004,3,0,0,0,0,0,0,3
Yemen,19/09/2004,0,0,0,0,0,0,0,0
Yemen,20/09/2004,7,0,0,0,9,0,0,16
Yemen,21/09/2004,0,0,0,0,12,0,0,12
Yemen,22/09/2004,0,0,0,0,0,0,0,0
Yemen,23/09/2004,0,0,0,0,-1,0,0,-1
Yemen,24/09/2004,2,0,0,0,0,0,0,2
Yemen,25/09/2004,0,0,0,0,3,0,0,3
Yemen,27/09/2004,0,0,0,0,-6,2,0,-4
Yemen,28/09/2004,3,0,0,0,0,0,0,3
Yemen,29/09/2004,25,0,0,0,48,0,0,73
Yemen,30/09/2004,8,0,0,0,3,0,0,11
Yemen,02/10/2004,0,0,0,0,12,0,0,12
Yemen,04/10/2004,0,0,0,0,0,0,0,0
Yemen,06/10/2004,2,0,0,0,3,0,0,5
Yemen,07/10/2004,2,0,0,0,0,0,0,2
Yemen,08/10/2004,2,0,0,0,0,0,0,2
Yemen,09/10/2004,0,0,0,0,0,0,0,0
Yemen,10/10/2004,3,0,0,0,9,0,0,12
Yemen,11/10/2004,0,0,0,0,3,0,0,3
Yemen,12/10/2004,9,0,0,0,0,0,0,9
Yemen,14/10/2004,4,0,0,0,6,0,0,10
Yemen,15/10/2004,2,0,0,0,0,0,0,2
Yemen,19/10/2004,0,0,0,0,9,0,0,9
Yemen,20/10/2004,6,0,0,0,18,0,0,24
Yemen,21/10/2004,0,0,0,0,0,0,0,0
Yemen,23/10/2004,0,0,0,0,0,0,0,0
Yemen,24/10/2004,0,0,0,0,0,0,0,0
Yemen,26/10/2004,0,0,0,0,-5,0,0,-5
Yemen,27/10/2004,-1,0,0,0,3,0,0,2
Yemen,28/10/2004,-2,0,0,0,15,0,0,13
Yemen,29/10/2004,-3,0,0,0,0,0,0,-3
Yemen,30/10/2004,12,0,0,0,0,0,0,12
Yemen,31/10/2004,6,0,0,0,2,0,0,8
Yemen,01/11/2004,0,0,0,0,0,0,0,0
Yemen,02/11/2004,0,0,0,0,0,0,0,0
Yemen,04/11/2004,0,0,0,0,9,0,0,9
Yemen,05/11/2004,0,0,0,0,0,0,0,0
Yemen,06/11/2004,0,0,0,0,0,0,0,0
Yemen,07/11/2004,4,0,0,0,6,0,0,10
Yemen,08/11/2004,5,0,0,0,21,2,0,28
Yemen,09/11/2004,11,0,0,0,9,2,0,22
Yemen,10/11/2004,0,0,0,0,0,0,0,0
Yemen,11/11/2004,3,0,0,0,0,0,0,3
Yemen,12/11/2004,-1,0,0,0,0,0,0,-1
Yemen,13/11/2004,3,0,0,0,3,0,0,6
Yemen,16/11/2004,0,0,0,0,0,1,0,1
Yemen,17/11/2004,5,0,1,0,3,9,0,18
Yemen,18/11/2004,2,0,0,0,0,0,0,2
Yemen,19/11/2004,6,0,0,0,0,1,0,7
Yemen,21/11/2004,3,0,0,0,3,0,0,6
Yemen,23/11/2004,7,0,0,0,0,0,0,7
Yemen,24/11/2004,2,0,0,0,0,0,0,2
Yemen,25/11/2004,9,0,0,0,7,0,0,16
Yemen,26/11/2004,3,0,0,0,-2,0,0,1
Yemen,27/11/2004,-1,0,0,0,3,0,0,2
Yemen,28/11/2004,6,0,0,0,0,0,0,6
Yemen,30/11/2004,12,0,0,0,0,2,0,14
Yemen,01/12/2004,0,0,0,0,0,0,0,0
Yemen,02/12/2004,0,0,0,0,0,0,0,0
Yemen,04/12/2004,0,0,0,0,0,0,0,0
Yemen,05/12/2004,7,0,0,0,0,0,0,7
Yemen,06/12/2004,6,0,0,0,6,0,0,12
Yemen,07/12/2004,54,0,-2,0,0,2,0,54
Yemen,08/12/2004,6,0,0,0,15,0,0,21
Yemen,09/12/2004,8,0,0,0,0,0,0,8
Yemen,10/12/2004,5,0,0,0,0,0,0,5
Yemen,11/12/2004,0,0,0,0,0,0,0,0
Yemen,12/12/2004,0,0,0,0,6,0,0,6
Yemen,13/12/2004,2,0,0,0,3,0,0,5
Yemen,14/12/2004,2,4,0,0,0,0,0,6
Yemen,15/12/2004,1,0,0,0,6,0,0,7
Yemen,19/12/2004,0,0,0,0,0,0,0,0
Yemen,20/12/2004,0,0,0,0,0,0,0,0
Yemen,21/12/2004,0,0,0,0,0,0,0,0
Yemen,23/12/2004,0,0,0,0,0,0,0,0
Yemen,24/12/2004,0,0,0,0,0,0,0,0
Yemen,27/12/2004,11,0,0,0,0,0,0,11
Yemen,28/12/2004,1,0,0,0,0,0,0,1
Yemen,29/12/2004,12,0,0,0,0,0,0,12
Yemen,30/12/2004,17,0,0,0,0,6,0,23
Yemen,31/12/2004,6,0,0,0,-2,0,0,4
Afghanistan,01/03/2006,83,0,0,0,41,5,0,129
Afghanistan,02/03/2006,63,0,0,0,11,10,0,84
Afghanistan,03/03/2006,49,0,0,0,23,7,0,79
Afghanistan,04/03/2006,98,0,0,0,13,2,0,113
Afghanistan,05/03/2006,72,0,0,0,1,6,0,79
Afghanistan,06/03/2006,78,0,0,0,21,10,0,109
Afghanistan,07/03/2006,18,0,0,0,15,8,0,41
Afghanistan,08/03/2006,41,0,0,0,16,7,0,64
Afghanistan,09/03/2006,26,0,0,0,12,0,0,38
Afghanistan,10/03/2006,48,0,0,0,19,0,0,67
Afghanistan,11/03/2006,12,0,0,0,12,3,0,27
Afghanistan,12/03/2006,15,0,0,0,0,6,0,21
Afghanistan,13/03/2006,27,0,0,0,6,0,0,33
Afghanistan,14/03/2006,21,0,0,0,6,4,0,31
Afghanistan,15/03/2006,42,0,0,0,7,0,0,49
Afghanistan,16/03/2006,60,0,0,0,34,0,0,94
Afghanistan,17/03/2006,45,0,0,0,11,0,0,56
Afghanistan,18/03/2006,29,0,0,0,6,11,0,46
Afghanistan,19/03/2006,32,0,0,0,27,0,0,59
Afghanistan,20/03/2006,52,0,1,0,37,10,0,100
Afghanistan,21/03/2006,70,0,0,0,6,7,0,83
Afghanistan,22/03/2006,34,0,0,0,34,0,0,68
Afghanistan,23/03/2006,23,0,0,0,37,0,0,60
Afghanistan,24/03/2006,5,0,0,0,0,1,0,6
Afghanistan,25/03/2006,61,0,0,0,6,2,0,69
Afghanistan,26/03/2006,10,0,1,0,12,5,0,28
Afghanistan,27/03/2006,31,0,0,0,14,5,0,50
Afghanistan,28/03/2006,46,0,0,0,29,9,0,84
Afghanistan,29/03/2006,113,2,0,0,16,8,0,139
Afghanistan,30/03/2006,51,0,0,0,4,20,0,75
Afghanistan,31/03/2006,12,0,0,0,12,6,0,30
Albania,01/03/2006,21,0,-6,0,24,0,0,39
Albania,02/03/2006,39,0,-4,0,18,2,0,55
Albania,03/03/2006,2,0,-3,0,6,0,0,5
Albania,04/03/2006,1,0,0,0,0,0,0,1
Albania,06/03/2006,0,0,0,0,0,0,0,0
Albania,07/03/2006,0,0,0,0,-4,0,0,-4
Albania,08/03/2006,0,0,0,0,0,1,0,1
Albania,09/03/2006,5,0,0,0,0,0,0,5
Albania,10/03/2006,9,0,0,0,13,1,0,23
Albania,11/03/2006,28,0,0,0,20,20,0,68
Albania,12/03/2006,6,0,-4,0,21,10,0,33
Albania,13/03/2006,20,0,0,0,41,12,0,73
Albania,14/03/2006,2,0,0,0,7,3,0,12
Albania,15/03/2006,2,0,0,0,-2,1,0,1
Albania,16/03/2006,9,0,0,0,3,0,0,12
Albania,17/03/2006,17,0,-6,0,6,17,0,34
Albania,18/03/2006,9,0,0,0,3,0,0,12
Albania,19/03/2006,7,0,0,0,0,2,0,9
Albania,20/03/2006,2,0,0,0,0,2,0,4
Albania,21/03/2006,9,0,0,0,-2,0,0,7
Albania,22/03/2006,0,0,-1,0,-2,1,0,-2
Albania,23/03/2006,2,0,0,0,0,0,0,2
Albania,24/03/2006,2,0,0,0,0,0,0,2
Albania,25/03/2006,5,0,0,0,0,0,0,5
Albania,26/03/2006,2,0,0,0,12,0,0,14
Albania,27/03/2006,4,0,0,0,0,0,0,4
Albania,28/03/2006,7,0,0,0,3,2,0,12
Albania,29/03/2006,10,0,1,0,-2,1,0,10
Albania,30/03/2006,3,0,-1,0,6,1,0,9
Albania,31/03/2006,4,0,0,0,0,0,0,4
Algeria,01/03/2006,-1,0,0,0,3,1,0,3
Algeria,02/03/2006,12,0,0,0,21,0,0,33
Algeria,03/03/2006,4,0,0,0,3,0,0,7
Algeria,05/03/2006,0,0,0,0,0,0,0,0
Algeria,06/03/2006,1,0,0,0,0,0,0,1
Algeria,07/03/2006,4,0,0,0,-2,0,0,2
Algeria,08/03/2006,2,0,0,0,0,0,0,2
Algeria,09/03/2006,0,0,0,0,-3,2,0,-1
Algeria,10/03/2006,0,0,0,0,3,2,0,5
Algeria,11/03/2006,-3,0,0,0,0,0,0,-3
Algeria,12/03/2006,0,0,0,0,-2,0,0,-2
Algeria,13/03/2006,2,0,0,0,20,0,0,22
Algeria,14/03/2006,2,0,0,0,0,0,0,2
Algeria,15/03/2006,2,0,0,0,3,0,0,5
Algeria,16/03/2006,-2,0,0,0,-2,0,0,-4
Algeria,17/03/2006,3,0,0,0,3,0,0,6
Algeria,18/03/2006,1,0,0,0,12,0,0,13
Algeria,19/03/2006,2,0,0,0,18,0,0,20
Algeria,20/03/2006,11,0,0,0,21,3,0,35
Algeria,21/03/2006,-1,0,0,0,6,0,0,5
Algeria,22/03/2006,5,0,0,0,0,6,0,11
Algeria,23/03/2006,9,0,0,0,0,0,0,9
Algeria,24/03/2006,1,0,0,0,0,0,0,1
Algeria,25/03/2006,5,0,0,0,0,8,0,13
Algeria,26/03/2006,14,0,0,0,1,0,0,15
Algeria,27/03/2006,1,0,0,0,0,0,0,1
Algeria,28/03/2006,5,0,0,0,0,0,0,5
Algeria,29/03/2006,8,0,0,0,33,0,0,41
Algeria,30/03/2006,1,0,-1,0,0,0,0,0
Algeria,31/03/2006,0,0,0,0,0,0,0,0
Bangladesh,02/03/2006,0,0,0,0,3,0,0,3
Bangladesh,03/03/2006,0,0,0,0,0,0,0,0
Bangladesh,04/03/2006,0,0,0,0,0,0,0,0
Bangladesh,05/03/2006,0,0,0,0,-2,1,0,-1
Bangladesh,07/03/2006,0,0,0,0,0,2,0,2
Bangladesh,08/03/2006,0,0,0,0,3,0,0,3
Bangladesh,09/03/2006,0,0,0,0,0,0,0,0
Bangladesh,10/03/2006,0,0,0,0,0,0,0,0
Bangladesh,11/03/2006,0,0,0,0,9,0,0,9
Bangladesh,12/03/2006,2,0,0,0,0,3,0,5
Bangladesh,13/03/2006,9,0,0,0,0,1,0,10
Bangladesh,14/03/2006,0,0,0,0,0,0,0,0
Bangladesh,15/03/2006,-1,0,0,0,6,0,0,5
Bangladesh,16/03/2006,0,0,0,0,0,0,0,0
Bangladesh,17/03/2006,0,0,0,0,18,2,0,20
Bangladesh,18/03/2006,0,0,0,0,0,0,0,0
Bangladesh,20/03/2006,4,0,0,0,3,1,0,8
Bangladesh,21/03/2006,3,0,0,0,6,1,0,10
Bangladesh,22/03/2006,14,0,-2,0,15,0,0,27
Bangladesh,23/03/2006,2,0,0,0,0,0,0,2
Bangladesh,24/03/2006,0,0,0,0,0,2,0,2
Bangladesh,25/03/2006,21,0,0,0,0,0,0,21
Bangladesh,26/03/2006,2,0,0,0,0,0,0,2
Bangladesh,27/03/2006,9,0,0,0,0,4,0,13
Bangladesh,28/03/2006,8,0,0,0,0,0,0,8
Bangladesh,29/03/2006,12,0,0,0,0,4,0,16
Bangladesh,30/03/2006,15,0,0,0,-4,1,0,12
Bangladesh,31/03/2006,2,0,0,0,0,1,0,3
Cameroon,01/03/2006,0,0,0,0,0,0,0,0
Cameroon,02/03/2006,0,0,0,0,0,0,0,0
Cameroon,03/03/2006,2,0,0,0,0,0,0,2
Cameroon,06/03/2006,-1,0,0,0,0,0,0,-1
Cameroon,07/03/2006,0,0,0,0,0,0,0,0
Cameroon,08/03/2006,0,0,0,0,0,0,0,0
Cameroon,10/03/2006,0,0,0,0,0,0,0,0
Cameroon,11/03/2006,3,0,0,0,0,0,0,3
Cameroon,13/03/2006,12,0,0,0,9,0,0,21
Cameroon,14/03/2006,1,0,0,0,0,0,0,1
Cameroon,15/03/2006,1,0,1,0,6,0,0,8
Cameroon,16/03/2006,1,0,0,0,0,2,0,3
Cameroon,17/03/2006,2,0,-2,0,3,0,0,3
Cameroon,20/03/2006,-2,0,1,0,3,0,0,2
Cameroon,21/03/2006,0,0,0,0,9,0,0,9
Cameroon,22/03/2006,0,0,0,0,0,0,0,0
Cameroon,23/03/2006,0,0,1,0,0,0,0,1
Cameroon,24/03/2006,0,0,0,0,0,0,0,0
Cameroon,26/03/2006,1,0,0,0,0,0,0,1
Cameroon,27/03/2006,0,0,0,0,24,0,0,24
Cameroon,28/03/2006,2,0,0,0,0,1,0,3
Cameroon,29/03/2006,28,0,0,0,45,0,0,73
Cameroon,30/03/2006,13,0,0,0,27,0,0,40
Cameroon,31/03/2006,0,0,-2,0,7,1,0,6
China,01/03/2006,33,0,0,0,-7,0,0,26
China,02/03/2006,26,0,-6,0,4,5,0,29
China,03/03/2006,14,0,0,0,3,0,0,17
China,04/03/2006,19,0,0,0,6,1,0,26
China,05/03/2006,12,0,0,0,1,1,0,14
China,06/03/2006,28,2,0,0,6,1,0,37
China,07/03/2006,35,4,0,0,5,3,0,47
China,08/03/2006,14,4,0,0,7,3,0,28
China,09/03/2006,27,0,0,0,1,4,0,32
China,10/03/2006,26,0,0,0,-17,1,0,10
China,11/03/2006,-2,0,0,0,10,1,0,9
China,12/03/2006,29,0,0,0,24,2,0,55
China,13/03/2006,37,0,0,0,2,2,0,41
China,14/03/2006,41,0,1,0,29,5,0,76
China,15/03/2006,46,0,1,0,5,1,0,53
China,16/03/2006,35,0,0,0,24,3,0,62
China,17/03/2006,36,0,0,0,16,3,0,55
China,18/03/2006,25,2,0,0,-2,2,0,27
China,19/03/2006,25,0,-1,0,0,3,0,27
China,20/03/2006,60,0,0,0,30,10,0,100
China,21/03/2006,60,0,1,0,11,13,0,85
China,22/03/2006,46,0,-9,0,7,0,0,44
China,23/03/2006,18,0,-1,0,12,0,0,29
China,24/03/2006,13,0,0,0,5,0,0,18
China,25/03/2006,11,0,0,0,-2,0,0,9
China,26/03/2006,27,0,0,0,21,7,0,55
China,27/03/2006,8,0,0,0,4,5,0,17
China,28/03/2006,28,0,1,0,46,11,0,86
China,29/03/2006,22,0,2,0,16,1,0,41
China,30/03/2006,45,0,-1,0,28,3,0,75
China,31/03/2006,21,0,-2,0,12,3,0,34
Egypt,01/03/2006,5,0,0,0,-4,1,0,2
Egypt,02/03/2006,2,0,0,0,3,1,0,6
Egypt,03/03/2006,11,0,0,0,37,0,0,48
Egypt,04/03/2006,0,0,0,0,-2,6,0,4
Egypt,05/03/2006,2,0,0,0,3,0,0,5
Egypt,06/03/2006,8,0,0,0,3,0,0,11
Egypt,07/03/2006,5,0,0,0,3,0,0,8
Egypt,08/03/2006,0,0,0,0,0,0,0,0
Egypt,09/03/2006,7,0,0,0,0,0,0,7
Egypt,10/03/2006,8,0,0,0,0,0,0,8
Egypt,11/03/2006,0,0,0,0,0,0,0,0
Egypt,12/03/2006,1,0,-2,0,3,2,0,4
Egypt,13/03/2006,3,0,0,0,3,0,0,6
Egypt,14/03/2006,15,0,0,0,0,0,0,15
Egypt,15/03/2006,0,0,0,0,0,0,0,0
Egypt,16/03/2006,10,0,0,0,12,2,0,24
Egypt,17/03/2006,0,0,0,0,0,1,0,1
Egypt,18/03/2006,10,0,0,0,0,0,0,10
Egypt,19/03/2006,6,0,0,0,0,1,0,7
Egypt,20/03/2006,28,0,0,0,13,9,0,50
Egypt,21/03/2006,13,0,0,0,3,1,0,17
Egypt,22/03/2006,10,0,0,0,0,3,0,13
Egypt,23/03/2006,11,0,0,0,0,0,0,11
Egypt,24/03/2006,1,0,0,0,0,0,0,1
Egypt,25/03/2006,11,0,0,0,0,0,0,11
Egypt,26/03/2006,10,0,0,0,9,0,0,19
Egypt,27/03/2006,0,0,0,0,3,0,0,3
Egypt,28/03/2006,1,0,0,0,26,2,0,29
Egypt,29/03/2006,13,0,0,0,-8,0,0,5
Egypt,30/03/2006,12,0,0,0,9,0,0,21
Egypt,31/03/2006,6,0,0,0,-2,0,0,4
Eritrea,01/03/2006,0,0,0,0,0,0,0,0
Eritrea,02/03/2006,0,0,0,0,0,0,0,0
Eritrea,03/03/2006,3,0,0,0,7,0,0,10
Eritrea,04/03/2006,0,0,0,0,6,0,0,6
Eritrea,06/03/2006,0,0,0,0,0,0,0,0
Eritrea,08/03/2006,0,0,0,0,0,0,0,0
Eritrea,10/03/2006,-2,0,0,0,3,0,0,1
Eritrea,11/03/2006,0,0,0,0,0,0,0,0
Eritrea,12/03/2006,0,0,0,0,0,0,0,0
Eritrea,13/03/2006,-2,0,0,0,3,0,0,1
Eritrea,14/03/2006,3,0,0,0,0,1,0,4
Eritrea,15/03/2006,9,0,0,0,0,0,0,9
Eritrea,16/03/2006,0,0,0,0,0,0,0,0
Eritrea,18/03/2006,0,0,0,0,0,0,0,0
Eritrea,19/03/2006,1,0,0,0,0,0,0,1
Eritrea,20/03/2006,15,2,0,0,6,0,0,23
Eritrea,21/03/2006,5,2,0,0,3,0,0,10
Eritrea,22/03/2006,3,0,0,0,0,0,0,3
Eritrea,23/03/2006,7,0,0,0,0,0,0,7
Eritrea,25/03/2006,0,0,0,0,0,1,0,1
Eritrea,26/03/2006,0,0,0,0,3,0,0,3
Eritrea,27/03/2006,6,0,0,0,0,0,0,6
Eritrea,28/03/2006,5,0,0,0,0,0,0,5
Eritrea,29/03/2006,1,0,0,0,0,0,0,1
Eritrea,30/03/2006,0,0,0,0,0,0,0,0
Eritrea,31/03/2006,0,0,0,0,0,0,0,0
Georgia,01/03/2006,0,0,0,0,0,1,0,1
Georgia,02/03/2006,10,0,0,0,3,0,0,13
Georgia,03/03/2006,2,0,0,0,0,0,0,2
Georgia,06/03/2006,0,0,0,0,0,1,0,1
Georgia,07/03/2006,2,0,0,0,0,0,0,2
Georgia,08/03/2006,3,0,0,0,3,0,0,6
Georgia,09/03/2006,6,0,0,0,0,2,0,8
Georgia,10/03/2006,3,0,0,0,3,0,0,6
Georgia,11/03/2006,7,0,0,0,12,0,0,19
Georgia,12/03/2006,4,0,0,0,9,0,0,13
Georgia,13/03/2006,16,0,0,0,6,0,0,22
Georgia,14/03/2006,3,0,0,0,0,0,0,3
Georgia,15/03/2006,6,0,0,0,3,0,0,9
Georgia,16/03/2006,4,0,-2,0,0,0,0,2
Georgia,17/03/2006,0,0,0,0,8,1,0,9
Georgia,18/03/2006,0,0,0,0,6,3,0,9
Georgia,19/03/2006,0,0,0,0,-2,2,0,0
Georgia,20/03/2006,2,0,0,0,0,1,0,3
Georgia,21/03/2006,1,0,0,0,7,0,0,8
Georgia,22/03/2006,0,0,0,0,3,1,0,4
Georgia,23/03/2006,-3,0,0,0,3,0,0,0
Georgia,24/03/2006,0,0,0,0,-2,0,0,-2
Georgia,26/03/2006,1,0,0,0,0,2,0,3
Georgia,27/03/2006,0,0,0,0,0,0,0,0
Georgia,28/03/2006,-1,0,0,0,6,5,0,10
Georgia,29/03/2006,1,0,0,0,0,0,0,1
Georgia,30/03/2006,0,0,0,0,0,2,0,2
Georgia,31/03/2006,0,0,0,0,0,0,0,0
India,01/03/2006,6,2,0,0,6,0,0,14
India,02/03/2006,0,0,0,0,3,5,0,8
India,03/03/2006,7,0,1,0,6,4,0,18
India,04/03/2006,0,0,0,0,0,1,0,1
India,05/03/2006,0,0,0,0,3,1,0,4
India,06/03/2006,9,0,0,0,-4,1,0,6
India,07/03/2006,6,0,0,0,0,1,0,7
India,08/03/2006,2,0,0,0,0,6,0,8
India,09/03/2006,7,0,0,0,3,1,0,11
India,10/03/2006,0,0,-6,0,6,0,0,0
India,11/03/2006,2,0,0,0,0,0,0,2
India,12/03/2006,23,0,-2,0,4,0,0,25
India,13/03/2006,4,0,0,0,3,0,0,7
India,14/03/2006,0,0,0,0,0,3,0,3
India,15/03/2006,5,0,0,0,3,1,0,9
India,16/03/2006,8,0,-2,0,3,0,0,9
India,17/03/2006,11,0,0,0,0,0,0,11
India,18/03/2006,0,0,0,0,0,0,0,0
India,19/03/2006,2,0,0,0,0,0,0,2
India,20/03/2006,14,0,0,0,1,0,0,15
India,21/03/2006,20,0,1,0,0,5,0,26
India,22/03/2006,13,0,0,0,0,0,0,13
India,23/03/2006,2,0,0,0,3,0,0,5
India,24/03/2006,8,0,-4,0,3,0,0,7
India,25/03/2006,7,0,0,0,-2,0,0,5
India,26/03/2006,11,0,-2,0,0,1,0,10
India,27/03/2006,5,0,0,0,8,2,0,15
India,28/03/2006,15,2,0,0,15,1,0,33
India,29/03/2006,2,0,1,0,10,3,0,16
India,30/03/2006,5,0,0,0,0,1,0,6
India,31/03/2006,18,0,0,0,3,2,0,23
Iran,01/03/2006,8,0,0,0,3,3,0,14
Iran,02/03/2006,19,0,0,0,0,3,0,22
Iran,03/03/2006,-2,0,0,0,13,6,0,17
Iran,04/03/2006,23,0,-1,0,-5,0,0,17
Iran,05/03/2006,2,0,0,0,7,5,0,14
Iran,06/03/2006,15,0,0,0,4,0,0,19
Iran,07/03/2006,11,0,3,0,18,4,0,36
Iran,08/03/2006,38,0,0,0,-1,2,0,39
Iran,09/03/2006,18,0,2,0,0,4,0,24
Iran,10/03/2006,29,0,-1,0,3,0,0,31
Iran,11/03/2006,25,0,0,0,3,3,0,31
Iran,12/03/2006,15,0,0,0,-4,3,0,14
Iran,13/03/2006,31,0,1,0,6,4,0,42
Iran,14/03/2006,17,0,1,0,0,2,0,20
Iran,15/03/2006,14,0,1,0,4,2,0,21
Iran,16/03/2006,25,0,1,0,33,6,0,65
Iran,17/03/2006,34,0,0,0,21,8,0,63
Iran,18/03/2006,17,0,-2,0,10,9,0,34
Iran,19/03/2006,8,0,0,0,1,1,0,10
Iran,20/03/2006,51,8,0,0,9,9,0,77
Iran,21/03/2006,52,6,3,0,-1,1,0,61
Iran,22/03/2006,17,2,0,0,8,0,0,27
Iran,23/03/2006,10,0,1,0,4,0,0,15
Iran,24/03/2006,4,0,0,0,-1,0,0,3
Iran,25/03/2006,16,0,0,0,12,4,0,32
Iran,26/03/2006,22,0,1,0,6,0,0,29
Iran,27/03/2006,27,0,0,0,3,0,0,30
Iran,28/03/2006,21,0,0,0,35,8,0,64
Iran,29/03/2006,3,0,0,0,-4,1,0,0
Iran,30/03/2006,41,0,3,0,-6,1,0,39
Iran,31/03/2006,9,0,0,0,-5,0,0,4
Iraq,01/03/2006,49,0,0,0,35,7,0,91
Iraq,02/03/2006,35,0,0,0,3,4,0,42
Iraq,03/03/2006,32,0,0,0,27,4,0,63
Iraq,04/03/2006,35,0,0,0,4,5,0,44
Iraq,05/03/2006,10,0,0,0,27,0,0,37
Iraq,06/03/2006,49,0,0,0,48,3,0,100
Iraq,07/03/2006,84,0,4,0,27,3,0,118
Iraq,08/03/2006,40,0,0,0,19,2,0,61
Iraq,09/03/2006,59,2,0,0,-6,5,0,60
Iraq,10/03/2006,39,0,0,0,21,1,0,61
Iraq,11/03/2006,35,0,1,0,40,5,0,81
Iraq,12/03/2006,96,0,4,0,19,6,0,125
Iraq,13/03/2006,24,0,0,0,16,4,0,44
Iraq,14/03/2006,88,0,2,0,96,23,0,209
Iraq,15/03/2006,85,0,1,0,28,7,0,121
Iraq,16/03/2006,38,0,-1,0,25,9,0,71
Iraq,17/03/2006,82,0,0,0,5,17,0,104
Iraq,18/03/2006,41,0,1,0,9,30,0,81
Iraq,19/03/2006,73,0,1,0,-10,24,0,88
Iraq,20/03/2006,196,6,2,0,68,36,0,308
Iraq,21/03/2006,86,0,0,0,63,20,0,169
Iraq,22/03/2006,92,0,1,0,50,16,0,159
Iraq,23/03/2006,35,0,-5,0,18,2,0,50
Iraq,24/03/2006,31,0,-2,0,18,2,0,49
Iraq,25/03/2006,38,2,0,0,13,2,0,55
Iraq,26/03/2006,46,0,-2,0,13,14,0,71
Iraq,27/03/2006,46,0,4,0,24,12,0,86
Iraq,28/03/2006,63,0,0,0,2,2,0,67
Iraq,29/03/2006,43,0,-13,0,16,21,0,67
Iraq,30/03/2006,113,0,3,0,27,5,0,148
Iraq,31/03/2006,31,2,2,0,23,5,0,63
Morocco,01/03/2006,-1,0,0,0,0,0,0,-1
Morocco,02/03/2006,0,0,0,0,5,0,0,5
Morocco,03/03/2006,9,0,0,0,0,0,0,9
Morocco,04/03/2006,0,0,0,0,0,0,0,0
Morocco,06/03/2006,3,0,0,0,0,0,0,3
Morocco,07/03/2006,0,0,0,0,-4,0,0,-4
Morocco,08/03/2006,-5,0,0,0,0,1,0,-4
Morocco,09/03/2006,1,0,0,0,0,0,0,1
Morocco,10/03/2006,1,0,0,0,0,0,0,1
Morocco,11/03/2006,6,0,0,0,0,0,0,6
Morocco,12/03/2006,3,0,0,0,6,0,0,9
Morocco,14/03/2006,0,0,0,0,0,1,0,1
Morocco,15/03/2006,0,0,0,0,0,0,0,0
Morocco,16/03/2006,4,0,0,0,0,0,0,4
Morocco,17/03/2006,15,0,1,0,12,1,0,29
Morocco,18/03/2006,0,0,0,0,0,0,0,0
Morocco,19/03/2006,0,0,0,0,3,0,0,3
Morocco,20/03/2006,8,0,0,0,16,3,0,27
Morocco,21/03/2006,1,0,0,0,7,1,0,9
Morocco,22/03/2006,4,0,0,0,0,0,0,4
Morocco,23/03/2006,14,0,0,0,3,1,0,18
Morocco,24/03/2006,2,0,0,0,0,0,0,2
Morocco,25/03/2006,7,0,0,0,0,0,0,7
Morocco,26/03/2006,16,0,0,0,0,0,0,16
Morocco,27/03/2006,6,0,0,0,0,0,0,6
Morocco,28/03/2006,2,0,0,0,0,0,0,2
Morocco,30/03/2006,0,0,0,0,0,0,0,0
Morocco,31/03/2006,0,0,0,0,0,0,0,0
Nigeria,01/03/2006,16,0,0,0,-4,1,0,13
Nigeria,02/03/2006,4,0,1,0,6,2,0,13
Nigeria,03/03/2006,12,0,0,0,-4,2,0,10
Nigeria,04/03/2006,0,0,0,0,-4,0,0,-4
Nigeria,05/03/2006,6,0,0,0,3,0,0,9
Nigeria,06/03/2006,14,0,0,0,12,1,0,27
Nigeria,07/03/2006,7,0,-4,0,3,3,0,9
Nigeria,08/03/2006,25,0,0,0,3,2,0,30
Nigeria,09/03/2006,26,0,0,0,2,0,0,28
Nigeria,10/03/2006,5,0,0,0,-1,4,0,8
Nigeria,11/03/2006,3,0,0,0,0,0,0,3
Nigeria,12/03/2006,1,0,0,0,0,1,0,2
Nigeria,13/03/2006,13,0,0,0,-4,0,0,9
Nigeria,14/03/2006,5,0,0,0,15,0,0,20
Nigeria,15/03/2006,14,2,-2,0,0,2,0,16
Nigeria,16/03/2006,14,0,0,0,2,0,0,16
Nigeria,17/03/2006,5,0,0,0,2,5,0,12
Nigeria,18/03/2006,0,0,0,0,0,3,0,3
Nigeria,19/03/2006,5,0,0,0,9,2,0,16
Nigeria,20/03/2006,21,0,0,0,4,5,0,30
Nigeria,21/03/2006,12,0,0,0,-12,1,0,1
Nigeria,22/03/2006,26,0,2,0,-2,3,0,29
Nigeria,23/03/2006,32,0,1,0,-8,3,0,28
Nigeria,24/03/2006,4,0,0,0,-2,0,0,2
Nigeria,25/03/2006,5,0,0,0,17,0,0,22
Nigeria,26/03/2006,16,0,0,0,16,2,0,34
Nigeria,27/03/2006,16,0,0,0,-8,0,0,8
Nigeria,28/03/2006,26,2,-10,0,26,5,0,49
Nigeria,29/03/2006,29,0,-2,0,75,1,0,103
Nigeria,30/03/2006,25,0,0,0,19,1,0,45
Nigeria,31/03/2006,7,0,0,0,8,0,0,15
Pakistan,01/03/2006,31,0,0,0,-5,3,0,29
Pakistan,02/03/2006,13,0,0,0,9,4,0,26
Pakistan,03/03/2006,1,0,0,0,9,1,0,11
Pakistan,04/03/2006,5,0,0,0,0,0,0,5
Pakistan,05/03/2006,16,0,0,0,3,1,0,20
Pakistan,06/03/2006,18,0,0,0,15,0,0,33
Pakistan,07/03/2006,29,0,1,0,2,8,0,40
Pakistan,08/03/2006,24,0,0,0,12,3,0,39
Pakistan,09/03/2006,8,0,0,0,0,0,0,8
Pakistan,10/03/2006,20,0,0,0,9,0,0,29
Pakistan,11/03/2006,5,0,0,0,12,3,0,20
Pakistan,12/03/2006,23,0,0,0,4,0,0,27
Pakistan,13/03/2006,72,0,0,0,24,2,0,98
Pakistan,14/03/2006,17,0,0,0,21,0,0,38
Pakistan,15/03/2006,9,0,0,0,18,1,0,28
Pakistan,16/03/2006,37,0,0,0,37,2,0,76
Pakistan,17/03/2006,23,0,-1,0,22,2,0,46
Pakistan,18/03/2006,36,0,0,0,18,4,0,58
Pakistan,19/03/2006,5,0,0,0,12,3,0,20
Pakistan,20/03/2006,25,0,-2,0,10,5,0,38
Pakistan,21/03/2006,45,0,0,0,5,5,0,55
Pakistan,22/03/2006,47,0,0,0,34,0,0,81
Pakistan,23/03/2006,9,0,0,0,24,5,0,38
Pakistan,24/03/2006,0,0,0,0,0,2,0,2
Pakistan,25/03/2006,20,0,0,0,1,0,0,21
Pakistan,26/03/2006,25,0,0,0,4,3,0,32
Pakistan,27/03/2006,8,0,1,0,23,1,0,33
Pakistan,28/03/2006,38,0,0,0,0,5,0,43
Pakistan,29/03/2006,17,2,0,0,1,0,0,20
Pakistan,30/03/2006,22,0,0,0,40,8,0,70
Pakistan,31/03/2006,13,0,0,0,28,0,0,41
Sierra Leone,01/03/2006,14,0,0,0,0,0,0,14
Sierra Leone,02/03/2006,2,0,-2,0,0,0,0,0
Sierra Leone,03/03/2006,-5,0,0,0,0,0,0,-5
Sierra Leone,04/03/2006,0,0,0,0,3,1,0,4
Sierra Leone,06/03/2006,1,0,0,0,0,1,0,2
Sierra Leone,07/03/2006,4,0,0,0,3,0,0,7
Sierra Leone,08/03/2006,4,0,0,0,4,0,0,8
Sierra Leone,09/03/2006,2,0,0,0,0,0,0,2
Sierra Leone,10/03/2006,0,0,0,0,3,0,0,3
Sierra Leone,13/03/2006,1,0,0,0,0,0,0,1
Sierra Leone,14/03/2006,0,0,0,0,0,0,0,0
Sierra Leone,15/03/2006,-1,0,0,0,9,0,0,8
Sierra Leone,16/03/2006,2,0,0,0,3,0,0,5
Sierra Leone,17/03/2006,6,0,0,0,12,0,0,18
Sierra Leone,18/03/2006,0,0,0,0,0,2,0,2
Sierra Leone,19/03/2006,0,0,0,0,0,0,0,0
Sierra Leone,20/03/2006,1,0,0,0,2,2,0,5
Sierra Leone,21/03/2006,-2,0,0,0,22,0,0,20
Sierra Leone,22/03/2006,1,0,0,0,25,4,0,30
Sierra Leone,23/03/2006,0,0,0,0,3,0,0,3
Sierra Leone,24/03/2006,2,0,0,0,-4,0,0,-2
Sierra Leone,25/03/2006,5,0,-2,0,16,1,0,20
Sierra Leone,26/03/2006,5,0,0,0,7,3,0,15
Sierra Leone,27/03/2006,2,0,1,0,9,0,0,12
Sierra Leone,28/03/2006,23,0,-2,0,26,8,0,55
Sierra Leone,29/03/2006,38,0,0,0,56,14,0,108
Sierra Leone,30/03/2006,2,0,0,0,21,4,0,27
Sierra Leone,31/03/2006,6,0,0,0,36,3,0,45
Somalia,01/03/2006,0,0,0,0,0,0,0,0
Somalia,02/03/2006,5,0,-1,0,0,1,0,5
Somalia,03/03/2006,0,0,0,0,0,0,0,0
Somalia,04/03/2006,0,0,0,0,0,0,0,0
Somalia,05/03/2006,0,0,0,0,0,0,0,0
Somalia,06/03/2006,2,0,0,0,3,0,0,5
Somalia,07/03/2006,2,0,0,0,13,0,0,15
Somalia,08/03/2006,0,0,0,0,24,0,0,24
Somalia,09/03/2006,3,0,0,0,6,0,0,9
Somalia,10/03/2006,7,0,0,0,0,0,0,7
Somalia,11/03/2006,0,0,0,0,0,0,0,0
Somalia,12/03/2006,5,0,0,0,0,0,0,5
Somalia,13/03/2006,-1,0,0,0,0,0,0,-1
Somalia,14/03/2006,0,0,0,0,-2,0,0,-2
Somalia,15/03/2006,7,0,0,0,3,0,0,10
Somalia,16/03/2006,0,0,0,0,0,5,0,5
Somalia,17/03/2006,2,2,0,0,3,2,0,9
Somalia,18/03/2006,42,2,0,0,9,0,0,53
Somalia,19/03/2006,23,0,0,0,0,0,0,23
Somalia,20/03/2006,25,4,0,0,2,0,0,31
Somalia,21/03/2006,14,10,0,0,-2,1,0,23
Somalia,22/03/2006,2,0,0,0,0,0,0,2
Somalia,23/03/2006,4,2,0,0,0,0,0,6
Somalia,24/03/2006,0,0,0,0,0,0,0,0
Somalia,25/03/2006,1,0,0,0,3,0,0,4
Somalia,26/03/2006,3,0,0,0,0,0,0,3
Somalia,27/03/2006,2,0,0,0,0,0,0,2
Somalia,28/03/2006,0,0,0,0,0,0,0,0
Somalia,29/03/2006,1,0,0,0,9,2,0,12
Somalia,30/03/2006,2,0,0,0,3,1,0,6
Somalia,31/03/2006,0,0,0,0,0,0,0,0
Syria,01/03/2006,0,0,-2,0,0,0,0,-2
Syria,02/03/2006,18,0,0,0,0,0,0,18
Syria,03/03/2006,5,0,0,0,0,0,0,5
Syria,04/03/2006,2,0,0,0,0,0,0,2
Syria,05/03/2006,4,0,0,0,0,0,0,4
Syria,06/03/2006,28,0,0,0,2,5,0,35
Syria,07/03/2006,8,0,0,0,0,0,0,8
Syria,08/03/2006,20,0,0,0,15,1,0,36
Syria,09/03/2006,-2,0,0,0,1,0,0,-1
Syria,10/03/2006,1,0,0,0,6,0,0,7
Syria,11/03/2006,-3,0,0,0,0,1,0,-2
Syria,12/03/2006,7,0,0,0,0,0,0,7
Syria,13/03/2006,12,0,0,0,0,0,0,12
Syria,14/03/2006,39,2,0,0,17,2,0,60
Syria,15/03/2006,15,0,0,0,9,0,0,24
Syria,16/03/2006,25,0,0,0,3,3,0,31
Syria,17/03/2006,6,0,0,0,6,0,0,12
Syria,18/03/2006,3,0,-1,0,0,1,0,3
Syria,19/03/2006,9,0,0,0,3,0,0,12
Syria,20/03/2006,24,0,0,0,66,0,0,90
Syria,21/03/2006,12,0,0,0,1,0,0,13
Syria,22/03/2006,13,0,1,0,7,1,0,22
Syria,23/03/2006,17,0,-1,0,27,0,0,43
Syria,24/03/2006,0,0,0,0,0,0,0,0
Syria,25/03/2006,3,0,0,0,0,0,0,3
Syria,26/03/2006,22,0,0,0,0,0,0,22
Syria,27/03/2006,4,0,0,0,0,0,0,4
Syria,28/03/2006,-2,0,0,0,0,0,0,-2
Syria,29/03/2006,10,0,0,0,3,0,0,13
Syria,30/03/2006,2,0,-2,0,0,1,0,1
Syria,31/03/2006,-4,0,0,0,12,0,0,8
Yemen,01/03/2006,8,0,0,0,60,3,0,71
Yemen,02/03/2006,22,0,0,0,39,1,0,62
Yemen,03/03/2006,0,0,0,0,-1,0,0,-1
Yemen,04/03/2006,0,0,0,0,-4,0,0,-4
Yemen,05/03/2006,1,0,0,0,3,0,0,4
Yemen,06/03/2006,3,0,0,0,6,0,0,9
Yemen,07/03/2006,2,0,0,0,1,0,0,3
Yemen,09/03/2006,6,0,0,0,12,0,0,18
Yemen,10/03/2006,6,0,0,0,6,0,0,12
Yemen,12/03/2006,2,0,0,0,0,0,0,2
Yemen,14/03/2006,5,0,0,0,0,0,0,5
Yemen,15/03/2006,1,0,0,0,0,0,0,1
Yemen,16/03/2006,0,0,0,0,0,0,0,0
Yemen,18/03/2006,16,0,0,0,-2,0,0,14
Yemen,19/03/2006,0,0,0,0,3,0,0,3
Yemen,20/03/2006,5,0,0,0,6,0,0,11
Yemen,21/03/2006,-1,0,0,0,-2,0,0,-3
Yemen,22/03/2006,2,0,0,0,3,0,0,5
Yemen,23/03/2006,-1,0,0,0,3,0,0,2
Yemen,25/03/2006,0,0,0,0,0,0,0,0
Yemen,26/03/2006,0,0,0,0,0,0,0,0
Yemen,27/03/2006,0,0,0,0,0,2,0,2
Yemen,28/03/2006,24,0,0,0,9,1,0,34
Yemen,29/03/2006,6,0,0,0,0,0,0,6
Yemen,30/03/2006,2,0,0,0,0,0,0,2
Yemen,31/03/2006,2,0,0,0,0,0,0,2
Afghanistan,01/08/2008,84,0,0,0,47,11,0,142
Afghanistan,02/08/2008,85,10,0,0,10,20,0,125
Afghanistan,03/08/2008,89,0,0,0,39,5,0,133
Afghanistan,04/08/2008,142,0,0,0,49,12,0,203
Afghanistan,05/08/2008,135,0,1,0,86,8,0,230
Afghanistan,06/08/2008,67,0,2,0,51,8,0,128
Afghanistan,07/08/2008,51,0,0,0,55,5,0,111
Afghanistan,08/08/2008,174,0,0,0,82,30,0,286
Afghanistan,09/08/2008,66,0,0,0,0,13,0,79
Afghanistan,10/08/2008,17,0,0,0,0,10,0,27
Afghanistan,11/08/2008,35,2,0,0,4,5,0,46
Afghanistan,12/08/2008,473,0,-6,0,124,32,0,623
Afghanistan,13/08/2008,103,2,0,0,11,8,0,124
Afghanistan,14/08/2008,20,0,-4,0,0,7,0,23
Afghanistan,15/08/2008,39,0,0,0,9,0,0,48
Afghanistan,16/08/2008,33,0,0,0,12,2,0,47
Afghanistan,17/08/2008,40,0,-6,0,4,6,0,44
Afghanistan,18/08/2008,165,0,-9,0,21,26,0,203
Afghanistan,19/08/2008,133,4,-8,0,5,35,0,169
Afghanistan,20/08/2008,149,2,-1,0,43,13,0,206
Afghanistan,21/08/2008,176,4,-7,0,4,56,0,233
Afghanistan,22/08/2008,341,0,-1,0,49,39,0,428
Afghanistan,23/08/2008,200,0,2,0,14,38,0,254
Afghanistan,24/08/2008,150,0,0,0,1,13,0,164
Afghanistan,25/08/2008,224,2,-1,0,72,15,0,312
Afghanistan,26/08/2008,137,0,-1,0,41,15,0,192
Afghanistan,27/08/2008,195,0,2,0,66,7,0,270
Afghanistan,28/08/2008,210,0,-1,0,47,11,0,267
Afghanistan,29/08/2008,135,2,-1,0,35,36,0,207
Afghanistan,30/08/2008,73,2,0,0,17,22,0,114
Afghanistan,31/08/2008,133,0,1,0,27,30,0,191
Albania,01/08/2008,-1,0,-2,0,1,2,0,0
Albania,02/08/2008,-1,0,-2,0,3,0,0,0
Albania,03/08/2008,4,0,0,0,0,0,0,4
Albania,04/08/2008,4,0,1,0,0,0,0,5
Albania,05/08/2008,43,0,0,0,55,8,0,106
Albania,06/08/2008,2,0,0,0,-2,2,0,2
Albania,07/08/2008,1,0,0,0,0,0,0,1
Albania,08/08/2008,22,0,0,0,29,0,0,51
Albania,09/08/2008,2,0,0,0,0,0,0,2
Albania,10/08/2008,1,0,0,0,0,0,0,1
Albania,11/08/2008,2,0,0,0,0,0,0,2
Albania,12/08/2008,4,0,-1,0,0,0,0,3
Albania,13/08/2008,1,0,0,0,0,0,0,1
Albania,15/08/2008,7,0,0,0,0,0,0,7
Albania,16/08/2008,2,0,-1,0,0,0,0,1
Albania,17/08/2008,0,0,0,0,0,0,0,0
Albania,18/08/2008,16,0,0,0,4,0,0,20
Albania,19/08/2008,-1,0,0,0,0,0,0,-1
Albania,20/08/2008,16,0,0,0,0,4,0,20
Albania,21/08/2008,8,0,0,0,-2,0,0,6
Albania,22/08/2008,8,0,0,0,4,0,0,12
Albania,23/08/2008,6,0,-1,0,6,2,0,13
Albania,24/08/2008,15,0,0,0,0,0,0,15
Albania,25/08/2008,12,0,0,0,0,0,0,12
Albania,26/08/2008,8,0,-3,0,0,0,0,5
Albania,27/08/2008,6,0,0,0,0,0,0,6
Albania,28/08/2008,45,0,-1,0,0,10,0,54
Albania,29/08/2008,12,0,0,0,0,0,0,12
Albania,30/08/2008,6,0,0,0,0,8,0,14
Albania,31/08/2008,2,0,0,0,0,1,0,3
Algeria,01/08/2008,0,0,0,0,0,0,0,0
Algeria,02/08/2008,0,0,0,0,0,0,0,0
Algeria,03/08/2008,0,0,0,0,0,0,0,0
Algeria,04/08/2008,0,0,0,0,6,0,0,6
Algeria,05/08/2008,35,0,0,0,0,0,0,35
Algeria,06/08/2008,0,0,0,0,0,0,0,0
Algeria,07/08/2008,4,0,0,0,15,2,0,21
Algeria,08/08/2008,1,0,0,0,30,0,0,31
Algeria,09/08/2008,2,0,1,0,3,0,0,6
Algeria,10/08/2008,4,0,0,0,0,0,0,4
Algeria,11/08/2008,1,0,0,0,0,0,0,1
Algeria,12/08/2008,0,0,0,0,5,0,0,5
Algeria,13/08/2008,1,0,0,0,0,0,0,1
Algeria,14/08/2008,0,0,0,0,0,0,0,0
Algeria,16/08/2008,0,0,0,0,0,0,0,0
Algeria,17/08/2008,0,0,0,0,0,0,0,0
Algeria,18/08/2008,7,0,0,0,0,0,0,7
Algeria,19/08/2008,9,0,0,0,3,0,0,12
Algeria,20/08/2008,42,0,0,0,0,16,0,58
Algeria,21/08/2008,5,0,0,0,3,0,0,8
Algeria,22/08/2008,19,0,0,0,6,9,0,34
Algeria,23/08/2008,3,0,0,0,3,3,0,9
Algeria,24/08/2008,22,0,0,0,0,8,0,30
Algeria,25/08/2008,6,0,0,0,0,0,0,6
Algeria,26/08/2008,0,0,0,0,0,0,0,0
Algeria,27/08/2008,0,0,0,0,3,0,0,3
Algeria,28/08/2008,0,0,0,0,0,0,0,0
Algeria,29/08/2008,1,0,0,0,0,0,0,1
Algeria,31/08/2008,3,0,0,0,0,0,0,3
Bangladesh,01/08/2008,18,0,-2,0,3,0,0,19
Bangladesh,02/08/2008,15,0,-2,0,10,0,0,23
Bangladesh,03/08/2008,2,0,0,0,-2,1,0,1
Bangladesh,04/08/2008,17,0,0,0,14,1,0,32
Bangladesh,05/08/2008,7,0,-2,0,33,2,0,40
Bangladesh,06/08/2008,5,0,-6,0,6,1,0,6
Bangladesh,07/08/2008,0,0,1,0,1,2,0,4
Bangladesh,08/08/2008,42,0,-1,0,4,12,0,57
Bangladesh,09/08/2008,5,0,0,0,2,1,0,8
Bangladesh,10/08/2008,1,0,0,0,-6,0,0,-5
Bangladesh,11/08/2008,-1,0,0,0,0,0,0,-1
Bangladesh,12/08/2008,10,2,0,0,2,0,0,14
Bangladesh,13/08/2008,2,0,0,0,-2,0,0,0
Bangladesh,14/08/2008,0,0,0,0,12,0,0,12
Bangladesh,15/08/2008,11,0,0,0,0,0,0,11
Bangladesh,16/08/2008,0,0,0,0,0,0,0,0
Bangladesh,17/08/2008,0,0,0,0,0,0,0,0
Bangladesh,18/08/2008,13,0,-1,0,-3,0,0,9
Bangladesh,19/08/2008,13,0,0,0,15,0,0,28
Bangladesh,20/08/2008,9,2,1,0,19,0,0,31
Bangladesh,21/08/2008,6,0,0,0,2,0,0,8
Bangladesh,22/08/2008,6,0,0,0,0,0,0,6
Bangladesh,23/08/2008,0,0,0,0,9,0,0,9
Bangladesh,24/08/2008,28,0,0,0,7,1,0,36
Bangladesh,25/08/2008,12,0,0,0,9,7,0,28
Bangladesh,26/08/2008,31,0,1,0,30,2,0,64
Bangladesh,27/08/2008,4,0,0,0,4,3,0,11
Bangladesh,28/08/2008,7,2,0,0,6,3,0,18
Bangladesh,29/08/2008,1,0,0,0,3,1,0,5
Bangladesh,30/08/2008,2,0,0,0,-2,0,0,0
Bangladesh,31/08/2008,6,0,0,0,6,0,0,12
Cameroon,01/08/2008,0,0,0,0,-1,0,0,-1
Cameroon,04/08/2008,0,0,0,0,9,0,0,9
Cameroon,05/08/2008,0,0,0,0,0,0,0,0
Cameroon,06/08/2008,0,0,0,0,0,0,0,0
Cameroon,08/08/2008,1,0,0,0,0,0,0,1
Cameroon,11/08/2008,-1,0,0,0,0,0,0,-1
Cameroon,12/08/2008,13,0,0,0,9,4,0,26
Cameroon,13/08/2008,0,0,0,0,0,0,0,0
Cameroon,14/08/2008,6,0,0,0,0,0,0,6
Cameroon,18/08/2008,0,0,0,0,0,0,0,0
Cameroon,19/08/2008,16,0,0,0,0,0,0,16
Cameroon,20/08/2008,0,0,0,0,0,0,0,0
Cameroon,22/08/2008,0,0,0,0,-2,0,0,-2
Cameroon,25/08/2008,0,0,0,0,0,0,0,0
Cameroon,26/08/2008,0,0,0,0,0,0,0,0
Cameroon,27/08/2008,0,0,0,0,0,0,0,0
Cameroon,28/08/2008,0,0,0,0,0,0,0,0
Cameroon,29/08/2008,0,0,0,0,0,0,0,0
Cameroon,30/08/2008,0,0,0,0,0,0,0,0
Cameroon,31/08/2008,0,0,-2,0,0,0,0,-2
China,01/08/2008,53,2,0,0,107,14,0,176
China,02/08/2008,29,0,-2,0,8,4,0,39
China,03/08/2008,49,2,3,0,32,9,0,95
China,04/08/2008,45,0,0,0,7,12,0,64
China,05/08/2008,77,0,-1,0,130,12,0,218
China,06/08/2008,35,2,1,0,34,7,0,79
China,07/08/2008,-14,0,0,0,15,2,0,3
China,08/08/2008,119,0,-2,0,125,37,0,279
China,09/08/2008,14,0,0,0,30,0,0,44
China,10/08/2008,14,0,0,0,-2,2,0,14
China,11/08/2008,8,2,0,0,6,2,0,18
China,12/08/2008,145,2,0,0,41,18,0,206
China,13/08/2008,23,0,0,0,9,0,0,32
China,14/08/2008,30,0,0,0,21,12,0,63
China,15/08/2008,27,0,-1,0,-7,11,0,30
China,16/08/2008,11,0,-2,0,6,1,0,16
China,17/08/2008,10,0,-2,0,21,7,0,36
China,18/08/2008,108,2,-3,0,64,27,0,198
China,19/08/2008,4,0,1,0,11,0,0,16
China,20/08/2008,145,0,-5,0,41,6,0,187
China,21/08/2008,199,0,2,0,43,13,0,257
China,22/08/2008,118,0,-7,0,33,13,0,157
China,23/08/2008,38,0,0,0,2,8,0,48
China,24/08/2008,58,0,-1,0,18,16,0,91
China,25/08/2008,58,0,0,0,13,13,0,84
China,26/08/2008,46,0,0,0,27,4,0,77
China,27/08/2008,49,0,2,0,12,6,0,69
China,28/08/2008,90,2,0,0,63,8,0,163
China,29/08/2008,53,0,-1,0,15,3,0,70
China,30/08/2008,37,0,0,0,6,9,0,52
China,31/08/2008,25,2,1,0,17,9,0,54
Egypt,01/08/2008,15,0,0,0,21,2,0,38
Egypt,02/08/2008,81,0,1,0,34,0,0,116
Egypt,03/08/2008,31,0,1,0,20,5,0,57
Egypt,04/08/2008,47,0,0,0,27,8,0,82
Egypt,05/08/2008,25,0,0,0,7,0,0,32
Egypt,06/08/2008,10,0,0,0,1,2,0,13
Egypt,07/08/2008,6,0,0,0,3,0,0,9
Egypt,08/08/2008,30,0,0,0,34,2,0,66
Egypt,09/08/2008,14,0,0,0,-4,1,0,11
Egypt,10/08/2008,12,0,0,0,0,0,0,12
Egypt,11/08/2008,3,0,0,0,-1,2,0,4
Egypt,12/08/2008,89,0,3,0,22,4,0,118
Egypt,13/08/2008,21,0,0,0,0,0,0,21
Egypt,14/08/2008,0,0,0,0,0,0,0,0
Egypt,15/08/2008,0,0,0,0,0,0,0,0
Egypt,16/08/2008,1,0,0,0,0,0,0,1
Egypt,17/08/2008,2,0,0,0,-4,0,0,-2
Egypt,18/08/2008,23,0,0,0,15,2,0,40
Egypt,19/08/2008,6,0,0,0,0,5,0,11
Egypt,20/08/2008,27,0,0,0,3,1,0,31
Egypt,21/08/2008,19,0,0,0,15,0,0,34
Egypt,22/08/2008,8,0,0,0,0,0,0,8
Egypt,23/08/2008,21,0,-2,0,13,0,0,32
Egypt,24/08/2008,31,0,0,0,9,0,0,40
Egypt,25/08/2008,18,0,0,0,14,0,0,32
Egypt,26/08/2008,10,0,0,0,3,3,0,16
Egypt,27/08/2008,57,0,0,0,35,0,0,92
Egypt,28/08/2008,9,0,0,0,0,0,0,9
Egypt,29/08/2008,3,0,0,0,40,2,0,45
Egypt,30/08/2008,35,0,2,0,-14,0,0,23
Egypt,31/08/2008,39,0,1,0,2,0,0,42
Eritrea,01/08/2008,18,0,0,0,0,0,0,18
Eritrea,02/08/2008,3,0,0,0,0,1,0,4
Eritrea,05/08/2008,0,0,0,0,0,0,0,0
Eritrea,08/08/2008,9,0,0,0,0,0,0,9
Eritrea,09/08/2008,-2,0,0,0,0,0,0,-2
Eritrea,12/08/2008,6,0,0,0,3,5,0,14
Eritrea,13/08/2008,0,0,0,0,0,0,0,0
Eritrea,15/08/2008,7,0,1,0,0,1,0,9
Eritrea,16/08/2008,0,0,0,0,0,0,0,0
Eritrea,18/08/2008,2,0,0,0,-1,0,0,1
Eritrea,20/08/2008,2,0,0,0,12,0,0,14
Eritrea,21/08/2008,2,0,0,0,0,0,0,2
Eritrea,22/08/2008,2,0,0,0,6,0,0,8
Eritrea,24/08/2008,-2,0,0,0,0,0,0,-2
Eritrea,26/08/2008,5,0,0,0,0,0,0,5
Eritrea,29/08/2008,2,0,0,0,0,1,0,3
Eritrea,31/08/2008,22,0,0,0,3,0,0,25
Georgia,01/08/2008,0,0,0,0,3,0,0,3
Georgia,02/08/2008,0,0,0,0,0,0,0,0
Georgia,03/08/2008,0,0,0,0,0,0,0,0
Georgia,04/08/2008,10,0,0,0,0,0,0,10
Georgia,05/08/2008,4,0,0,0,6,0,0,10
Georgia,06/08/2008,5,0,0,0,0,1,0,6
Georgia,07/08/2008,0,0,0,0,0,0,0,0
Georgia,08/08/2008,38,4,0,0,1,0,0,43
Georgia,09/08/2008,15,0,0,0,3,0,0,18
Georgia,10/08/2008,3,0,0,0,3,0,0,6
Georgia,11/08/2008,3,0,0,0,0,2,0,5
Georgia,12/08/2008,77,2,0,0,4,9,0,92
Georgia,13/08/2008,14,0,0,0,3,1,0,18
Georgia,14/08/2008,40,0,0,0,6,1,0,47
Georgia,15/08/2008,16,0,0,0,3,0,0,19
Georgia,16/08/2008,4,0,0,0,0,1,0,5
Georgia,17/08/2008,1,0,0,0,3,0,0,4
Georgia,18/08/2008,34,0,-2,0,14,13,0,59
Georgia,19/08/2008,16,0,0,0,3,1,0,20
Georgia,20/08/2008,51,0,1,0,2,7,0,61
Georgia,21/08/2008,31,0,0,0,-1,9,0,39
Georgia,22/08/2008,37,0,1,0,5,6,0,49
Georgia,23/08/2008,0,0,0,0,3,2,0,5
Georgia,24/08/2008,0,0,0,0,3,2,0,5
Georgia,25/08/2008,34,0,0,0,0,0,0,34
Georgia,26/08/2008,12,0,0,0,-3,0,0,9
Georgia,27/08/2008,9,0,0,0,1,0,0,10
Georgia,28/08/2008,36,0,0,0,19,6,0,61
Georgia,29/08/2008,9,2,0,0,-1,2,0,12
Georgia,30/08/2008,-5,0,0,0,12,0,0,7
Georgia,31/08/2008,16,0,0,0,0,3,0,19
India,01/08/2008,67,2,1,0,9,1,0,80
India,02/08/2008,42,2,-4,0,-2,0,0,38
India,03/08/2008,67,0,0,0,6,8,0,81
India,04/08/2008,54,0,-1,0,7,16,0,76
India,05/08/2008,16,0,-4,0,37,1,0,50
India,06/08/2008,3,4,0,0,4,0,0,11
India,07/08/2008,3,0,0,0,0,6,0,9
India,08/08/2008,54,0,-1,0,4,4,0,61
India,09/08/2008,24,0,-1,0,12,3,0,38
India,11/08/2008,1,0,0,0,3,0,0,4
India,12/08/2008,10,0,-1,0,6,0,0,15
India,13/08/2008,14,0,0,0,-1,1,0,14
India,14/08/2008,20,0,1,0,3,4,0,28
India,15/08/2008,1,2,0,0,0,0,0,3
India,16/08/2008,0,0,0,0,0,0,0,0
India,17/08/2008,0,0,0,0,0,0,0,0
India,18/08/2008,36,0,-15,0,33,4,0,58
India,19/08/2008,17,0,0,0,10,2,0,29
India,20/08/2008,30,2,0,0,11,10,0,53
India,21/08/2008,47,0,-1,0,13,7,0,66
India,22/08/2008,18,0,-1,0,-7,4,0,14
India,23/08/2008,24,0,0,0,13,2,0,39
India,24/08/2008,33,0,1,0,17,1,0,52
India,25/08/2008,31,2,-2,0,5,12,0,48
India,26/08/2008,55,0,0,0,10,14,0,79
India,27/08/2008,54,0,2,0,3,8,0,67
India,28/08/2008,98,2,0,0,8,20,0,128
India,29/08/2008,79,0,3,0,8,19,0,109
India,30/08/2008,41,0,-6,0,17,9,0,61
India,31/08/2008,35,0,0,0,8,4,0,47
Iran,01/08/2008,27,0,1,0,16,1,0,45
Iran,02/08/2008,27,0,1,0,21,6,0,55
Iran,03/08/2008,9,0,0,0,16,9,0,34
Iran,04/08/2008,52,0,0,0,16,6,0,74
Iran,05/08/2008,6,0,0,0,-2,3,0,7
Iran,06/08/2008,5,0,0,0,10,4,0,19
Iran,07/08/2008,3,0,0,0,0,0,0,3
Iran,08/08/2008,52,0,1,0,13,4,0,70
Iran,09/08/2008,9,0,0,0,3,1,0,13
Iran,10/08/2008,16,0,0,0,3,0,0,19
Iran,11/08/2008,6,0,0,0,3,0,0,9
Iran,12/08/2008,20,0,1,0,22,4,0,47
Iran,13/08/2008,0,0,1,0,3,0,0,4
Iran,14/08/2008,6,0,0,0,0,0,0,6
Iran,15/08/2008,9,0,0,0,3,0,0,12
Iran,16/08/2008,9,0,0,0,3,0,0,12
Iran,17/08/2008,19,0,0,0,0,6,0,25
Iran,18/08/2008,89,0,2,0,62,15,0,168
Iran,19/08/2008,22,0,0,0,3,1,0,26
Iran,20/08/2008,39,0,0,0,16,14,0,69
Iran,21/08/2008,39,0,0,0,47,0,0,86
Iran,22/08/2008,47,2,0,0,5,1,0,55
Iran,23/08/2008,31,4,1,0,27,0,0,63
Iran,24/08/2008,26,0,2,0,43,3,0,74
Iran,25/08/2008,32,0,0,0,9,10,0,51
Iran,26/08/2008,35,2,2,0,45,7,0,91
Iran,27/08/2008,33,2,0,0,-7,7,0,35
Iran,28/08/2008,44,0,0,0,14,7,0,65
Iran,29/08/2008,32,0,1,0,6,11,0,50
Iran,30/08/2008,26,0,0,0,-2,16,0,40
Iran,31/08/2008,12,0,0,0,-2,7,0,17
Iraq,01/08/2008,109,2,1,0,14,22,0,148
Iraq,02/08/2008,64,2,2,0,14,0,0,82
Iraq,03/08/2008,77,2,1,0,13,5,0,98
Iraq,04/08/2008,101,0,-1,0,32,12,0,144
Iraq,05/08/2008,106,2,1,0,1,8,0,118
Iraq,06/08/2008,76,0,-1,0,17,14,0,106
Iraq,07/08/2008,10,0,0,0,-2,4,0,12
Iraq,08/08/2008,110,6,0,0,16,5,0,137
Iraq,09/08/2008,39,0,0,0,3,1,0,43
Iraq,10/08/2008,-8,0,0,0,0,2,0,-6
Iraq,11/08/2008,29,0,0,0,15,0,0,44
Iraq,12/08/2008,191,2,1,0,37,8,0,239
Iraq,13/08/2008,32,2,0,0,5,10,0,49
Iraq,14/08/2008,29,0,0,0,3,4,0,36
Iraq,15/08/2008,9,0,0,0,-1,0,0,8
Iraq,16/08/2008,3,0,0,0,0,0,0,3
Iraq,17/08/2008,27,0,1,0,1,4,0,33
Iraq,18/08/2008,89,0,5,0,-1,20,0,113
Iraq,19/08/2008,33,0,0,0,9,1,0,43
Iraq,20/08/2008,117,0,0,0,16,10,0,143
Iraq,21/08/2008,100,0,0,0,34,15,0,149
Iraq,22/08/2008,53,0,9,0,58,9,0,129
Iraq,23/08/2008,23,0,8,0,12,10,0,53
Iraq,24/08/2008,54,4,3,0,8,11,0,80
Iraq,25/08/2008,60,0,-2,0,14,7,0,79
Iraq,26/08/2008,135,6,12,0,63,11,0,227
Iraq,27/08/2008,58,0,8,0,5,9,0,80
Iraq,28/08/2008,126,0,4,0,40,2,0,172
Iraq,29/08/2008,41,2,6,0,34,13,0,96
Iraq,30/08/2008,56,0,-2,0,0,6,0,60
Iraq,31/08/2008,29,0,0,0,5,13,0,47
Morocco,01/08/2008,1,0,0,0,3,0,0,4
Morocco,02/08/2008,0,0,0,0,6,0,0,6
Morocco,03/08/2008,5,0,0,0,0,0,0,5
Morocco,04/08/2008,2,0,0,0,0,0,0,2
Morocco,05/08/2008,0,0,0,0,0,0,0,0
Morocco,06/08/2008,0,0,0,0,0,0,0,0
Morocco,07/08/2008,0,0,0,0,0,3,0,3
Morocco,09/08/2008,0,0,0,0,15,0,0,15
Morocco,11/08/2008,3,0,0,0,18,0,0,21
Morocco,12/08/2008,2,0,0,0,0,0,0,2
Morocco,13/08/2008,0,0,0,0,0,0,0,0
Morocco,14/08/2008,0,0,0,0,0,0,0,0
Morocco,18/08/2008,3,0,0,0,3,0,0,6
Morocco,19/08/2008,6,0,0,0,5,0,0,11
Morocco,20/08/2008,0,0,0,0,3,1,0,4
Morocco,21/08/2008,5,0,0,0,24,1,0,30
Morocco,22/08/2008,5,0,0,0,3,1,0,9
Morocco,23/08/2008,0,0,0,0,0,0,0,0
Morocco,25/08/2008,-1,0,0,0,0,0,0,-1
Morocco,26/08/2008,0,0,0,0,0,0,0,0
Morocco,27/08/2008,0,0,0,0,13,0,0,13
Morocco,28/08/2008,0,0,0,0,6,0,0,6
Morocco,29/08/2008,4,0,0,0,18,0,0,22
Morocco,30/08/2008,0,0,0,0,9,0,0,9
Morocco,31/08/2008,0,0,0,0,0,0,0,0
Nigeria,01/08/2008,10,0,0,0,3,6,0,19
Nigeria,02/08/2008,6,0,0,0,9,0,0,15
Nigeria,03/08/2008,5,0,0,0,3,0,0,8
Nigeria,04/08/2008,6,0,0,0,13,1,0,20
Nigeria,05/08/2008,12,0,0,0,0,3,0,15
Nigeria,06/08/2008,10,0,0,0,3,0,0,13
Nigeria,07/08/2008,0,0,0,0,3,0,0,3
Nigeria,08/08/2008,173,0,-1,0,71,12,0,255
Nigeria,09/08/2008,1,0,0,0,0,0,0,1
Nigeria,11/08/2008,0,0,0,0,0,0,0,0
Nigeria,12/08/2008,16,0,0,0,8,1,0,25
Nigeria,13/08/2008,7,0,0,0,0,0,0,7
Nigeria,14/08/2008,10,0,0,0,0,0,0,10
Nigeria,15/08/2008,0,0,0,0,3,0,0,3
Nigeria,17/08/2008,0,0,0,0,0,0,0,0
Nigeria,18/08/2008,7,0,-2,0,9,1,0,15
Nigeria,19/08/2008,9,0,0,0,3,2,0,14
Nigeria,20/08/2008,3,2,0,0,15,3,0,23
Nigeria,21/08/2008,31,2,-2,0,18,6,0,55
Nigeria,22/08/2008,21,0,0,0,35,0,0,56
Nigeria,23/08/2008,17,0,0,0,0,1,0,18
Nigeria,24/08/2008,11,0,0,0,18,0,0,29
Nigeria,25/08/2008,11,0,1,0,9,0,0,21
Nigeria,26/08/2008,8,0,0,0,15,0,0,23
Nigeria,27/08/2008,9,0,0,0,-4,0,0,5
Nigeria,28/08/2008,5,0,0,0,3,0,0,8
Nigeria,29/08/2008,10,0,0,0,4,3,0,17
Nigeria,30/08/2008,3,0,0,0,0,0,0,3
Nigeria,31/08/2008,19,0,0,0,0,1,0,20
Pakistan,01/08/2008,130,0,0,0,19,64,0,213
Pakistan,02/08/2008,156,0,1,0,17,7,0,181
Pakistan,03/08/2008,83,0,0,0,36,9,0,128
Pakistan,04/08/2008,123,0,1,0,6,17,0,147
Pakistan,05/08/2008,73,0,0,0,16,10,0,99
Pakistan,06/08/2008,21,0,0,0,12,3,0,36
Pakistan,07/08/2008,15,0,0,0,6,0,0,21
Pakistan,08/08/2008,97,0,-8,0,57,14,0,160
Pakistan,09/08/2008,38,0,0,0,18,4,0,60
Pakistan,10/08/2008,22,0,0,0,3,0,0,25
Pakistan,11/08/2008,20,0,0,0,0,2,0,22
Pakistan,12/08/2008,190,0,-1,0,28,23,0,240
Pakistan,13/08/2008,25,0,-2,0,2,13,0,38
Pakistan,14/08/2008,45,0,-6,0,-2,2,0,39
Pakistan,15/08/2008,3,0,-1,0,0,0,0,2
Pakistan,16/08/2008,7,0,0,0,3,1,0,11
Pakistan,17/08/2008,39,0,-11,0,20,2,0,50
Pakistan,18/08/2008,195,2,-73,0,30,20,0,174
Pakistan,19/08/2008,95,0,-35,0,24,22,0,106
Pakistan,20/08/2008,69,0,-9,0,22,26,0,108
Pakistan,21/08/2008,66,0,-7,0,82,20,0,161
Pakistan,22/08/2008,161,0,-8,0,13,9,0,175
Pakistan,23/08/2008,73,0,-14,0,10,21,0,90
Pakistan,24/08/2008,24,0,-3,0,13,4,0,38
Pakistan,25/08/2008,87,2,-2,0,35,12,0,134
Pakistan,26/08/2008,46,0,4,0,1,14,0,65
Pakistan,27/08/2008,73,0,3,0,44,7,0,127
Pakistan,28/08/2008,64,0,-2,0,13,4,0,79
Pakistan,29/08/2008,77,0,0,0,39,2,0,118
Pakistan,30/08/2008,74,0,0,0,10,0,0,84
Pakistan,31/08/2008,18,0,-2,0,5,4,0,25
Sierra Leone,01/08/2008,4,0,-2,0,0,0,0,2
Sierra Leone,04/08/2008,-1,0,0,0,0,0,0,-1
Sierra Leone,05/08/2008,4,0,0,0,0,0,0,4
Sierra Leone,08/08/2008,4,0,0,0,3,2,0,9
Sierra Leone,12/08/2008,0,0,0,0,0,0,0,0
Sierra Leone,18/08/2008,10,0,0,0,0,0,0,10
Sierra Leone,19/08/2008,0,0,0,0,0,0,0,0
Sierra Leone,20/08/2008,6,0,0,0,0,0,0,6
Sierra Leone,21/08/2008,0,0,0,0,0,0,0,0
Sierra Leone,22/08/2008,0,0,0,0,0,0,0,0
Sierra Leone,23/08/2008,0,0,0,0,0,0,0,0
Sierra Leone,26/08/2008,4,0,0,0,0,0,0,4
Sierra Leone,27/08/2008,3,0,0,0,0,0,0,3
Sierra Leone,30/08/2008,0,0,0,0,0,0,0,0
Somalia,01/08/2008,0,0,0,0,18,0,0,18
Somalia,02/08/2008,8,0,-4,0,0,0,0,4
Somalia,03/08/2008,22,0,-4,0,0,7,0,25
Somalia,04/08/2008,11,0,0,0,6,0,0,17
Somalia,05/08/2008,9,0,0,0,2,1,0,12
Somalia,06/08/2008,5,0,-4,0,4,0,0,5
Somalia,07/08/2008,8,0,0,0,0,0,0,8
Somalia,08/08/2008,17,0,0,0,3,0,0,20
Somalia,09/08/2008,3,0,0,0,-15,0,0,-12
Somalia,10/08/2008,0,0,0,0,0,0,0,0
Somalia,11/08/2008,7,0,0,0,0,0,0,7
Somalia,12/08/2008,15,4,0,0,1,0,0,20
Somalia,14/08/2008,3,0,0,0,0,2,0,5
Somalia,15/08/2008,3,0,0,0,0,0,0,3
Somalia,16/08/2008,2,0,0,0,0,0,0,2
Somalia,17/08/2008,2,0,0,0,0,0,0,2
Somalia,18/08/2008,11,0,0,0,-1,2,0,12
Somalia,19/08/2008,1,0,0,0,0,0,0,1
Somalia,20/08/2008,46,0,0,0,22,3,0,71
Somalia,21/08/2008,99,0,0,0,18,0,0,117
Somalia,22/08/2008,84,0,0,0,15,0,0,99
Somalia,23/08/2008,73,2,0,0,16,2,0,93
Somalia,24/08/2008,3,0,0,0,0,0,0,3
Somalia,25/08/2008,9,0,0,0,0,0,0,9
Somalia,26/08/2008,30,0,0,0,28,0,0,58
Somalia,27/08/2008,2,2,0,0,0,0,0,4
Somalia,28/08/2008,33,0,0,0,-6,0,0,27
Somalia,29/08/2008,38,0,0,0,0,2,0,40
Somalia,30/08/2008,20,0,0,0,0,0,0,20
Somalia,31/08/2008,0,0,0,0,0,0,0,0
Syria,01/08/2008,38,0,2,0,0,1,0,41
Syria,02/08/2008,12,0,0,0,6,4,0,22
Syria,03/08/2008,18,0,0,0,6,4,0,28
Syria,04/08/2008,3,0,0,0,9,5,0,17
Syria,05/08/2008,3,0,0,0,7,0,0,10
Syria,06/08/2008,14,0,1,0,0,0,0,15
Syria,07/08/2008,4,0,0,0,0,0,0,4
Syria,08/08/2008,8,0,-12,0,-2,1,0,-5
Syria,09/08/2008,0,0,0,0,0,0,0,0
Syria,10/08/2008,3,0,0,0,0,0,0,3
Syria,11/08/2008,7,0,0,0,0,0,0,7
Syria,12/08/2008,4,0,0,0,0,0,0,4
Syria,13/08/2008,29,0,0,0,-2,3,0,30
Syria,14/08/2008,3,0,0,0,15,2,0,20
Syria,15/08/2008,3,0,0,0,5,0,0,8
Syria,16/08/2008,-1,0,0,0,3,0,0,2
Syria,17/08/2008,9,0,0,0,0,0,0,9
Syria,18/08/2008,3,0,0,0,1,8,0,12
Syria,19/08/2008,0,0,0,0,0,0,0,0
Syria,20/08/2008,12,0,0,0,3,4,0,19
Syria,21/08/2008,14,0,3,0,3,4,0,24
Syria,22/08/2008,20,0,3,0,9,0,0,32
Syria,23/08/2008,0,0,0,0,0,0,0,0
Syria,24/08/2008,6,0,0,0,1,0,0,7
Syria,25/08/2008,9,0,0,0,6,6,0,21
Syria,26/08/2008,1,0,0,0,0,0,0,1
Syria,27/08/2008,3,0,0,0,0,0,0,3
Syria,28/08/2008,3,0,0,0,0,0,0,3
Syria,29/08/2008,17,0,0,0,6,0,0,23
Syria,30/08/2008,3,0,4,0,60,0,0,67
Syria,31/08/2008,19,0,0,0,0,0,0,19
Yemen,01/08/2008,4,0,0,0,32,3,0,39
Yemen,02/08/2008,15,0,0,0,29,9,0,53
Yemen,03/08/2008,7,0,0,0,7,1,0,15
Yemen,04/08/2008,33,0,0,0,32,8,0,73
Yemen,05/08/2008,22,0,0,0,21,4,0,47
Yemen,06/08/2008,11,0,1,0,9,3,0,24
Yemen,07/08/2008,2,0,0,0,27,4,0,33
Yemen,08/08/2008,29,0,0,0,72,1,0,102
Yemen,09/08/2008,2,0,0,0,4,3,0,9
Yemen,10/08/2008,1,0,0,0,0,3,0,4
Yemen,11/08/2008,0,0,0,0,0,0,0,0
Yemen,12/08/2008,27,0,0,0,31,1,0,59
Yemen,13/08/2008,0,0,0,0,0,0,0,0
Yemen,14/08/2008,12,0,0,0,0,0,0,12
Yemen,15/08/2008,6,0,0,0,6,0,0,12
Yemen,17/08/2008,1,0,0,0,6,2,0,9
Yemen,18/08/2008,12,0,0,0,17,0,0,29
Yemen,19/08/2008,8,0,0,0,3,0,0,11
Yemen,20/08/2008,2,0,0,0,0,0,0,2
Yemen,21/08/2008,1,0,0,0,-2,0,0,-1
Yemen,22/08/2008,11,0,0,0,0,2,0,13
Yemen,23/08/2008,9,0,0,0,0,0,0,9
Yemen,24/08/2008,0,0,0,0,12,0,0,12
Yemen,25/08/2008,7,0,0,0,0,1,0,8
Yemen,26/08/2008,19,0,0,0,3,0,0,22
Yemen,27/08/2008,1,0,0,0,6,0,0,7
Yemen,28/08/2008,16,0,0,0,6,0,0,22
Yemen,29/08/2008,2,0,0,0,0,0,0,2
Yemen,30/08/2008,15,0,0,0,0,0,0,15
Yemen,31/08/2008,2,0,0,0,-2,0,0,0
Afghanistan,01/07/2006,34,0,0,0,15,2,0,51
Afghanistan,02/07/2006,48,4,-2,0,11,7,0,68
Afghanistan,03/07/2006,60,0,-1,0,-2,2,0,59
Afghanistan,04/07/2006,34,2,0,0,13,4,0,53
Afghanistan,05/07/2006,27,0,0,0,3,4,0,34
Afghanistan,06/07/2006,39,0,0,0,6,3,0,48
Afghanistan,07/07/2006,32,0,-1,0,6,3,0,40
Afghanistan,08/07/2006,23,0,-2,0,13,0,0,34
Afghanistan,09/07/2006,26,0,0,0,0,0,0,26
Afghanistan,10/07/2006,51,0,0,0,-8,0,0,43
Afghanistan,11/07/2006,36,0,0,0,16,7,0,59
Afghanistan,12/07/2006,33,0,0,0,12,1,0,46
Afghanistan,13/07/2006,37,0,-2,0,7,10,0,52
Afghanistan,14/07/2006,10,0,0,0,12,0,0,22
Afghanistan,15/07/2006,20,0,-2,0,0,1,0,19
Afghanistan,16/07/2006,29,0,0,0,6,1,0,36
Afghanistan,17/07/2006,35,0,0,0,18,0,0,53
Afghanistan,18/07/2006,17,0,0,0,37,0,0,54
Afghanistan,19/07/2006,12,0,0,0,18,0,0,30
Afghanistan,20/07/2006,29,0,0,0,16,2,0,47
Afghanistan,21/07/2006,12,0,0,0,21,0,0,33
Afghanistan,22/07/2006,36,2,0,0,0,9,0,47
Afghanistan,23/07/2006,41,0,0,0,3,7,0,51
Afghanistan,24/07/2006,27,0,0,0,18,1,0,46
Afghanistan,25/07/2006,24,0,0,0,-8,2,0,18
Afghanistan,26/07/2006,49,0,1,0,27,0,0,77
Afghanistan,27/07/2006,64,0,0,0,18,7,0,89
Afghanistan,28/07/2006,19,0,0,0,14,12,0,45
Afghanistan,29/07/2006,10,0,0,0,6,1,0,17
Afghanistan,30/07/2006,26,0,0,0,3,0,0,29
Afghanistan,31/07/2006,59,0,0,0,0,0,0,59
Albania,01/07/2006,9,0,0,0,0,0,0,9
Albania,02/07/2006,1,0,1,0,0,1,0,3
Albania,03/07/2006,8,0,1,0,-6,2,0,5
Albania,04/07/2006,8,0,1,0,0,0,0,9
Albania,05/07/2006,4,0,-1,0,0,0,0,3
Albania,06/07/2006,17,0,0,0,6,0,0,23
Albania,07/07/2006,11,0,0,0,0,5,0,16
Albania,08/07/2006,0,0,0,0,0,0,0,0
Albania,09/07/2006,14,0,0,0,12,2,0,28
Albania,10/07/2006,20,0,0,0,15,2,0,37
Albania,11/07/2006,10,0,2,0,0,1,0,13
Albania,12/07/2006,0,0,0,0,0,0,0,0
Albania,13/07/2006,0,0,0,0,0,0,0,0
Albania,14/07/2006,3,0,0,0,0,0,0,3
Albania,15/07/2006,0,0,0,0,0,0,0,0
Albania,16/07/2006,3,0,0,0,0,0,0,3
Albania,17/07/2006,0,0,0,0,3,0,0,3
Albania,18/07/2006,1,0,0,0,0,0,0,1
Albania,19/07/2006,13,0,0,0,-1,0,0,12
Albania,20/07/2006,3,0,0,0,3,0,0,6
Albania,21/07/2006,3,0,0,0,0,1,0,4
Albania,22/07/2006,1,0,0,0,0,1,0,2
Albania,23/07/2006,1,0,-1,0,3,0,0,3
Albania,24/07/2006,9,0,-1,0,0,1,0,9
Albania,25/07/2006,0,0,0,0,3,2,0,5
Albania,26/07/2006,7,0,0,0,-8,0,0,-1
Albania,27/07/2006,3,0,0,0,-2,0,0,1
Albania,28/07/2006,-2,0,0,0,0,1,0,-1
Albania,29/07/2006,3,0,0,0,-3,0,0,0
Albania,30/07/2006,4,0,0,0,0,0,0,4
Albania,31/07/2006,21,0,0,0,12,0,0,33
Algeria,01/07/2006,0,0,0,0,0,0,0,0
Algeria,02/07/2006,4,0,0,0,3,0,0,7
Algeria,03/07/2006,4,0,1,0,3,0,0,8
Algeria,04/07/2006,4,0,0,0,1,0,0,5
Algeria,05/07/2006,2,0,-1,0,0,0,0,1
Algeria,06/07/2006,4,0,0,0,-1,0,0,3
Algeria,07/07/2006,0,0,0,0,0,0,0,0
Algeria,08/07/2006,0,0,0,0,0,0,0,0
Algeria,09/07/2006,0,0,0,0,0,0,0,0
Algeria,10/07/2006,11,0,0,0,19,0,0,30
Algeria,11/07/2006,-2,0,0,0,0,0,0,-2
Algeria,12/07/2006,7,0,0,0,0,0,0,7
Algeria,13/07/2006,17,0,0,0,0,0,0,17
Algeria,14/07/2006,0,0,0,0,0,0,0,0
Algeria,15/07/2006,-3,0,0,0,-4,0,0,-7
Algeria,16/07/2006,-2,0,0,0,0,0,0,-2
Algeria,17/07/2006,-1,0,0,0,0,0,0,-1
Algeria,18/07/2006,3,0,0,0,0,0,0,3
Algeria,19/07/2006,0,0,0,0,0,0,0,0
Algeria,20/07/2006,6,0,0,0,9,0,0,15
Algeria,21/07/2006,2,0,0,0,2,0,0,4
Algeria,22/07/2006,12,0,0,0,0,2,0,14
Algeria,23/07/2006,4,0,0,0,6,0,0,10
Algeria,24/07/2006,0,0,-1,0,0,6,0,5
Algeria,25/07/2006,0,0,0,0,0,0,0,0
Algeria,26/07/2006,0,0,0,0,0,0,0,0
Algeria,27/07/2006,0,0,0,0,0,0,0,0
Algeria,28/07/2006,12,0,0,0,0,0,0,12
Algeria,29/07/2006,24,0,0,0,0,0,0,24
Algeria,30/07/2006,0,0,1,0,0,0,0,1
Algeria,31/07/2006,1,0,0,0,0,0,0,1
Bangladesh,01/07/2006,0,0,0,0,0,0,0,0
Bangladesh,02/07/2006,2,0,0,0,0,0,0,2
Bangladesh,03/07/2006,0,0,0,0,0,0,0,0
Bangladesh,04/07/2006,-1,0,0,0,0,2,0,1
Bangladesh,05/07/2006,0,0,0,0,-2,0,0,-2
Bangladesh,06/07/2006,23,0,1,0,18,0,0,42
Bangladesh,07/07/2006,3,0,0,0,0,0,0,3
Bangladesh,08/07/2006,2,0,0,0,0,0,0,2
Bangladesh,09/07/2006,4,0,0,0,0,0,0,4
Bangladesh,10/07/2006,9,0,0,0,0,4,0,13
Bangladesh,11/07/2006,5,0,0,0,0,0,0,5
Bangladesh,12/07/2006,3,0,0,0,0,3,0,6
Bangladesh,13/07/2006,0,0,0,0,3,0,0,3
Bangladesh,14/07/2006,5,0,0,0,0,0,0,5
Bangladesh,15/07/2006,6,0,0,0,0,0,0,6
Bangladesh,16/07/2006,6,0,0,0,3,0,0,9
Bangladesh,17/07/2006,3,0,0,0,-2,0,0,1
Bangladesh,18/07/2006,-6,0,0,0,0,0,0,-6
Bangladesh,19/07/2006,4,0,0,0,3,0,0,7
Bangladesh,20/07/2006,0,0,0,0,0,0,0,0
Bangladesh,21/07/2006,25,6,0,0,9,2,0,42
Bangladesh,22/07/2006,1,0,0,0,3,0,0,4
Bangladesh,23/07/2006,0,0,0,0,0,0,0,0
Bangladesh,24/07/2006,0,0,0,0,3,3,0,6
Bangladesh,25/07/2006,8,0,0,0,0,3,0,11
Bangladesh,26/07/2006,3,0,0,0,0,0,0,3
Bangladesh,27/07/2006,3,0,0,0,3,0,0,6
Bangladesh,28/07/2006,2,0,0,0,0,6,0,8
Bangladesh,29/07/2006,-1,0,1,0,2,0,0,2
Bangladesh,30/07/2006,13,0,1,0,-2,0,0,12
Bangladesh,31/07/2006,3,0,0,0,0,0,0,3
Cameroon,01/07/2006,0,0,0,0,0,0,0,0
Cameroon,03/07/2006,2,0,0,0,3,0,0,5
Cameroon,04/07/2006,0,0,0,0,0,0,0,0
Cameroon,05/07/2006,0,0,0,0,0,0,0,0
Cameroon,06/07/2006,2,0,0,0,0,0,0,2
Cameroon,07/07/2006,3,0,0,0,3,0,0,6
Cameroon,09/07/2006,0,0,0,0,0,0,0,0
Cameroon,10/07/2006,4,0,0,0,0,0,0,4
Cameroon,11/07/2006,0,0,0,0,0,0,0,0
Cameroon,12/07/2006,0,0,0,0,0,0,0,0
Cameroon,13/07/2006,0,0,0,0,3,0,0,3
Cameroon,14/07/2006,3,0,0,0,0,0,0,3
Cameroon,16/07/2006,0,0,0,0,3,0,0,3
Cameroon,17/07/2006,-1,0,0,0,0,0,0,-1
Cameroon,18/07/2006,0,0,0,0,0,0,0,0
Cameroon,19/07/2006,3,0,0,0,0,1,0,4
Cameroon,20/07/2006,0,0,0,0,0,0,0,0
Cameroon,21/07/2006,0,0,0,0,0,0,0,0
Cameroon,22/07/2006,2,0,0,0,0,0,0,2
Cameroon,24/07/2006,4,0,0,0,0,0,0,4
Cameroon,25/07/2006,0,0,0,0,0,0,0,0
Cameroon,26/07/2006,0,0,0,0,0,0,0,0
Cameroon,27/07/2006,3,0,0,0,0,0,0,3
Cameroon,28/07/2006,2,0,0,0,0,0,0,2
Cameroon,31/07/2006,1,0,0,0,0,0,0,1
China,01/07/2006,12,0,0,0,4,6,0,22
China,02/07/2006,15,0,0,0,6,0,0,21
China,03/07/2006,18,0,-1,0,6,7,0,30
China,04/07/2006,45,0,-1,0,15,5,0,64
China,05/07/2006,45,6,0,0,10,3,0,64
China,06/07/2006,16,0,0,0,12,0,0,28
China,07/07/2006,16,0,0,0,12,7,0,35
China,08/07/2006,12,0,0,0,0,3,0,15
China,09/07/2006,20,0,0,0,4,0,0,24
China,10/07/2006,25,0,0,0,0,2,0,27
China,11/07/2006,15,2,0,0,3,22,0,42
China,12/07/2006,41,0,-1,0,18,0,0,58
China,13/07/2006,27,0,0,0,9,22,0,58
China,14/07/2006,18,0,0,0,-1,1,0,18
China,15/07/2006,20,2,-4,0,15,0,0,33
China,16/07/2006,22,0,0,0,5,0,0,27
China,17/07/2006,36,2,-7,0,-4,2,0,29
China,18/07/2006,28,2,0,0,18,0,0,48
China,19/07/2006,51,0,2,0,12,1,0,66
China,20/07/2006,33,0,1,0,16,2,0,52
China,21/07/2006,38,0,2,0,21,2,0,63
China,22/07/2006,25,2,-1,0,3,0,0,29
China,23/07/2006,26,0,1,0,9,1,0,37
China,24/07/2006,53,2,-2,0,7,7,0,67
China,25/07/2006,39,0,-2,0,2,1,0,40
China,26/07/2006,124,0,0,0,5,5,0,134
China,27/07/2006,59,0,0,0,10,8,0,77
China,28/07/2006,34,0,1,0,7,2,0,44
China,29/07/2006,-6,0,2,0,-7,0,0,-11
China,30/07/2006,16,0,0,0,21,7,0,44
China,31/07/2006,0,0,0,0,5,3,0,8
Egypt,01/07/2006,48,0,0,0,-19,0,0,29
Egypt,02/07/2006,39,0,1,0,6,2,0,48
Egypt,03/07/2006,30,0,0,0,6,0,0,36
Egypt,04/07/2006,17,0,0,0,-2,0,0,15
Egypt,05/07/2006,24,0,0,0,16,1,0,41
Egypt,06/07/2006,22,0,1,0,9,0,0,32
Egypt,07/07/2006,4,0,0,0,-1,0,0,3
Egypt,08/07/2006,2,0,0,0,0,0,0,2
Egypt,09/07/2006,5,0,0,0,-7,0,0,-2
Egypt,10/07/2006,-1,0,0,0,6,2,0,7
Egypt,11/07/2006,2,0,0,0,0,0,0,2
Egypt,12/07/2006,3,0,0,0,-10,1,0,-6
Egypt,13/07/2006,13,0,0,0,2,0,0,15
Egypt,14/07/2006,14,0,0,0,-4,6,0,16
Egypt,15/07/2006,56,0,0,0,6,11,0,73
Egypt,16/07/2006,-1,0,-2,0,0,0,0,-3
Egypt,17/07/2006,12,0,1,0,-2,0,0,11
Egypt,18/07/2006,10,0,0,0,0,1,0,11
Egypt,19/07/2006,25,0,0,0,0,0,0,25
Egypt,20/07/2006,19,2,0,0,10,0,0,31
Egypt,21/07/2006,1,0,0,0,3,14,0,18
Egypt,22/07/2006,0,0,0,0,0,0,0,0
Egypt,23/07/2006,8,0,0,0,0,2,0,10
Egypt,24/07/2006,7,0,0,0,3,0,0,10
Egypt,25/07/2006,0,0,0,0,-5,0,0,-5
Egypt,26/07/2006,5,0,1,0,3,0,0,9
Egypt,27/07/2006,10,0,0,0,3,1,0,14
Egypt,28/07/2006,0,0,0,0,-4,4,0,0
Egypt,29/07/2006,4,0,0,0,6,1,0,11
Egypt,30/07/2006,28,0,5,0,0,0,0,33
Egypt,31/07/2006,7,0,0,0,0,1,0,8
Eritrea,01/07/2006,0,0,0,0,0,2,0,2
Eritrea,03/07/2006,0,0,0,0,0,0,0,0
Eritrea,04/07/2006,0,0,0,0,3,0,0,3
Eritrea,05/07/2006,1,0,0,0,0,0,0,1
Eritrea,06/07/2006,2,0,0,0,0,0,0,2
Eritrea,08/07/2006,0,0,0,0,0,0,0,0
Eritrea,09/07/2006,0,0,0,0,0,0,0,0
Eritrea,10/07/2006,0,0,0,0,0,0,0,0
Eritrea,12/07/2006,0,0,0,0,0,0,0,0
Eritrea,13/07/2006,2,0,0,0,0,0,0,2
Eritrea,14/07/2006,5,0,0,0,0,0,0,5
Eritrea,15/07/2006,-3,0,0,0,0,0,0,-3
Eritrea,17/07/2006,6,0,0,0,0,0,0,6
Eritrea,18/07/2006,0,0,0,0,0,0,0,0
Eritrea,19/07/2006,-5,0,0,0,0,0,0,-5
Eritrea,20/07/2006,0,0,0,0,0,2,0,2
Eritrea,21/07/2006,14,0,0,0,0,0,0,14
Eritrea,22/07/2006,0,0,0,0,6,0,0,6
Eritrea,23/07/2006,0,0,0,0,0,0,0,0
Eritrea,24/07/2006,1,0,0,0,0,0,0,1
Eritrea,25/07/2006,-1,0,-4,0,0,0,0,-5
Eritrea,26/07/2006,14,0,0,0,0,0,0,14
Eritrea,27/07/2006,10,0,-6,0,0,0,0,4
Eritrea,28/07/2006,1,0,0,0,3,0,0,4
Eritrea,29/07/2006,26,0,0,0,3,3,0,32
Eritrea,30/07/2006,11,0,0,0,0,2,0,13
Eritrea,31/07/2006,4,0,0,0,0,0,0,4
Georgia,01/07/2006,6,0,0,0,0,0,0,6
Georgia,03/07/2006,0,0,0,0,3,0,0,3
Georgia,04/07/2006,6,0,0,0,0,1,0,7
Georgia,05/07/2006,2,0,0,0,1,0,0,3
Georgia,06/07/2006,3,0,0,0,18,0,0,21
Georgia,07/07/2006,3,0,0,0,3,0,0,6
Georgia,08/07/2006,0,0,0,0,0,0,0,0
Georgia,09/07/2006,0,0,0,0,0,0,0,0
Georgia,10/07/2006,0,0,0,0,0,0,0,0
Georgia,12/07/2006,-2,0,0,0,0,3,0,1
Georgia,13/07/2006,6,0,0,0,0,0,0,6
Georgia,14/07/2006,5,0,0,0,0,0,0,5
Georgia,15/07/2006,2,0,0,0,0,2,0,4
Georgia,16/07/2006,-3,0,0,0,0,0,0,-3
Georgia,17/07/2006,-1,0,0,0,0,1,0,0
Georgia,18/07/2006,2,0,0,0,-1,0,0,1
Georgia,19/07/2006,3,0,0,0,3,1,0,7
Georgia,20/07/2006,-1,0,0,0,0,0,0,-1
Georgia,21/07/2006,1,0,0,0,0,1,0,2
Georgia,22/07/2006,1,0,0,0,0,0,0,1
Georgia,23/07/2006,0,0,0,0,0,0,0,0
Georgia,24/07/2006,0,0,0,0,0,1,0,1
Georgia,25/07/2006,0,0,0,0,0,1,0,1
Georgia,26/07/2006,3,0,0,0,-1,0,0,2
Georgia,27/07/2006,0,0,0,0,12,0,0,12
Georgia,28/07/2006,0,0,0,0,9,0,0,9
Georgia,29/07/2006,0,0,0,0,0,0,0,0
Georgia,30/07/2006,0,0,0,0,0,0,0,0
Georgia,31/07/2006,2,0,0,0,0,0,0,2
India,01/07/2006,25,0,0,0,-2,2,0,25
India,02/07/2006,17,0,0,0,0,0,0,17
India,03/07/2006,36,2,0,0,13,1,0,52
India,04/07/2006,13,0,-2,0,-4,2,0,9
India,05/07/2006,5,0,0,0,0,2,0,7
India,06/07/2006,26,0,0,0,2,0,0,28
India,07/07/2006,0,2,0,0,0,0,0,2
India,08/07/2006,0,0,0,0,0,0,0,0
India,09/07/2006,2,0,0,0,1,0,0,3
India,10/07/2006,1,0,0,0,0,0,0,1
India,11/07/2006,9,0,-4,0,0,2,0,7
India,12/07/2006,2,0,-1,0,1,0,0,2
India,13/07/2006,15,0,0,0,1,2,0,18
India,14/07/2006,5,0,0,0,0,0,0,5
India,15/07/2006,25,0,0,0,1,0,0,26
India,16/07/2006,4,0,0,0,3,0,0,7
India,17/07/2006,21,0,0,0,0,0,0,21
India,18/07/2006,16,0,-1,0,9,0,0,24
India,19/07/2006,1,0,0,0,6,1,0,8
India,20/07/2006,16,0,0,0,0,0,0,16
India,21/07/2006,4,0,-2,0,0,1,0,3
India,22/07/2006,3,0,0,0,1,1,0,5
India,23/07/2006,8,0,0,0,0,3,0,11
India,24/07/2006,19,0,0,0,3,1,0,23
India,25/07/2006,5,0,-2,0,0,1,0,4
India,26/07/2006,11,0,0,0,-5,0,0,6
India,27/07/2006,5,0,1,0,-4,0,0,2
India,28/07/2006,7,0,1,0,0,4,0,12
India,29/07/2006,6,0,-1,0,6,0,0,11
India,30/07/2006,16,0,1,0,-6,1,0,12
India,31/07/2006,2,0,0,0,3,0,0,5
Iran,01/07/2006,14,0,0,0,0,1,0,15
Iran,02/07/2006,11,0,0,0,10,0,0,21
Iran,03/07/2006,14,0,0,0,0,2,0,16
Iran,04/07/2006,13,0,0,0,10,1,0,24
Iran,05/07/2006,12,0,0,0,7,1,0,20
Iran,06/07/2006,30,0,0,0,12,40,0,82
Iran,07/07/2006,30,0,0,0,3,22,0,55
Iran,08/07/2006,16,0,0,0,-1,9,0,24
Iran,09/07/2006,11,0,1,0,-3,0,0,9
Iran,10/07/2006,14,0,1,0,16,0,0,31
Iran,11/07/2006,8,0,0,0,18,1,0,27
Iran,12/07/2006,27,4,0,0,-2,4,0,33
Iran,13/07/2006,40,0,2,0,8,3,0,53
Iran,14/07/2006,55,0,0,0,3,0,0,58
Iran,15/07/2006,82,0,0,0,2,1,0,85
Iran,16/07/2006,57,0,0,0,-1,6,0,62
Iran,17/07/2006,36,0,-2,0,-5,22,0,51
Iran,18/07/2006,51,0,0,0,-5,16,0,62
Iran,19/07/2006,47,0,0,0,14,6,0,67
Iran,20/07/2006,56,0,0,0,5,11,0,72
Iran,21/07/2006,45,2,0,0,6,2,0,55
Iran,22/07/2006,22,2,0,0,3,18,0,45
Iran,23/07/2006,41,2,0,0,-2,9,0,50
Iran,24/07/2006,92,0,0,0,-2,2,0,92
Iran,25/07/2006,32,0,0,0,7,5,0,44
Iran,26/07/2006,36,0,0,0,0,0,0,36
Iran,27/07/2006,52,0,0,0,6,2,0,60
Iran,28/07/2006,48,0,0,0,0,4,0,52
Iran,29/07/2006,43,0,-1,0,0,6,0,48
Iran,30/07/2006,37,0,0,0,10,10,0,57
Iran,31/07/2006,113,0,1,0,12,1,0,127
Iraq,01/07/2006,70,0,0,0,-4,0,0,66
Iraq,02/07/2006,36,0,0,0,14,3,0,53
Iraq,03/07/2006,87,6,-3,0,7,9,0,106
Iraq,04/07/2006,74,4,0,0,18,8,0,104
Iraq,05/07/2006,32,0,-1,0,9,13,0,53
Iraq,06/07/2006,33,0,-1,0,27,14,0,73
Iraq,07/07/2006,10,4,0,0,21,8,0,43
Iraq,08/07/2006,28,0,0,0,22,0,0,50
Iraq,09/07/2006,43,0,0,0,19,12,0,74
Iraq,10/07/2006,35,0,-2,0,6,0,0,39
Iraq,11/07/2006,36,0,0,0,17,7,0,60
Iraq,12/07/2006,52,0,2,0,6,6,0,66
Iraq,13/07/2006,26,0,3,0,14,1,0,44
Iraq,14/07/2006,30,0,-3,0,2,2,0,31
Iraq,15/07/2006,41,0,0,0,5,1,0,47
Iraq,16/07/2006,26,0,0,0,15,11,0,52
Iraq,17/07/2006,70,0,0,0,-2,10,0,78
Iraq,18/07/2006,77,0,3,0,18,9,0,107
Iraq,19/07/2006,62,0,0,0,6,2,0,70
Iraq,20/07/2006,14,0,-2,0,-5,11,0,18
Iraq,21/07/2006,32,4,0,0,-5,6,0,37
Iraq,22/07/2006,37,0,0,0,3,1,0,41
Iraq,23/07/2006,27,0,0,0,4,9,0,40
Iraq,24/07/2006,67,0,1,0,4,6,0,78
Iraq,25/07/2006,54,0,2,0,15,6,0,77
Iraq,26/07/2006,60,0,-3,0,-1,23,0,79
Iraq,27/07/2006,65,0,-2,0,16,3,0,82
Iraq,28/07/2006,40,0,0,0,11,7,0,58
Iraq,29/07/2006,19,0,0,0,8,0,0,27
Iraq,30/07/2006,37,0,0,0,4,3,0,44
Iraq,31/07/2006,26,0,0,0,12,2,0,40
Morocco,01/07/2006,2,0,0,0,7,0,0,9
Morocco,03/07/2006,-2,0,0,0,0,0,0,-2
Morocco,05/07/2006,2,0,0,0,0,0,0,2
Morocco,06/07/2006,1,0,0,0,0,0,0,1
Morocco,07/07/2006,0,0,0,0,0,0,0,0
Morocco,08/07/2006,2,0,0,0,0,0,0,2
Morocco,10/07/2006,0,0,0,0,0,0,0,0
Morocco,11/07/2006,0,0,0,0,0,0,0,0
Morocco,12/07/2006,0,0,0,0,0,0,0,0
Morocco,13/07/2006,2,0,0,0,0,0,0,2
Morocco,14/07/2006,0,0,0,0,0,0,0,0
Morocco,15/07/2006,0,0,0,0,0,0,0,0
Morocco,16/07/2006,6,0,0,0,3,0,0,9
Morocco,17/07/2006,6,0,0,0,0,1,0,7
Morocco,18/07/2006,0,2,0,0,0,0,0,2
Morocco,19/07/2006,3,0,0,0,0,0,0,3
Morocco,20/07/2006,0,0,0,0,0,0,0,0
Morocco,21/07/2006,0,0,0,0,-2,0,0,-2
Morocco,22/07/2006,-1,0,0,0,0,0,0,-1
Morocco,23/07/2006,3,0,0,0,3,0,0,6
Morocco,24/07/2006,6,0,0,0,0,2,0,8
Morocco,25/07/2006,9,0,0,0,0,0,0,9
Morocco,26/07/2006,0,0,0,0,0,0,0,0
Morocco,27/07/2006,3,0,0,0,3,2,0,8
Morocco,28/07/2006,0,0,0,0,0,2,0,2
Morocco,30/07/2006,-1,0,0,0,0,0,0,-1
Morocco,31/07/2006,7,0,0,0,-2,0,0,5
Nigeria,01/07/2006,19,0,3,0,14,2,0,38
Nigeria,02/07/2006,0,0,-1,0,4,0,0,3
Nigeria,03/07/2006,16,0,1,0,1,1,0,19
Nigeria,04/07/2006,14,0,0,0,0,0,0,14
Nigeria,05/07/2006,20,0,-2,0,3,0,0,21
Nigeria,06/07/2006,8,0,0,0,15,0,0,23
Nigeria,07/07/2006,1,0,0,0,9,2,0,12
Nigeria,08/07/2006,1,0,0,0,4,0,0,5
Nigeria,09/07/2006,3,0,0,0,0,0,0,3
Nigeria,10/07/2006,5,0,0,0,0,3,0,8
Nigeria,11/07/2006,3,0,0,0,0,0,0,3
Nigeria,12/07/2006,11,0,0,0,6,1,0,18
Nigeria,13/07/2006,13,0,1,0,15,0,0,29
Nigeria,14/07/2006,2,0,0,0,6,0,0,8
Nigeria,15/07/2006,7,4,1,0,0,1,0,13
Nigeria,16/07/2006,1,0,0,0,0,0,0,1
Nigeria,17/07/2006,16,2,0,0,1,1,0,20
Nigeria,18/07/2006,1,0,0,0,21,4,0,26
Nigeria,19/07/2006,15,0,0,0,3,0,0,18
Nigeria,20/07/2006,22,0,0,0,6,3,0,31
Nigeria,21/07/2006,23,0,0,0,0,1,0,24
Nigeria,22/07/2006,18,0,0,0,0,1,0,19
Nigeria,23/07/2006,5,0,0,0,0,2,0,7
Nigeria,24/07/2006,14,0,1,0,-2,0,0,13
Nigeria,25/07/2006,15,0,0,0,0,3,0,18
Nigeria,26/07/2006,32,0,0,0,0,2,0,34
Nigeria,27/07/2006,29,0,1,0,19,1,0,50
Nigeria,28/07/2006,45,0,0,0,6,0,0,51
Nigeria,29/07/2006,20,0,0,0,0,0,0,20
Nigeria,30/07/2006,11,0,0,0,6,0,0,17
Nigeria,31/07/2006,20,0,-3,0,-3,1,0,15
Pakistan,01/07/2006,2,0,0,0,0,0,0,2
Pakistan,02/07/2006,11,0,0,0,1,0,0,12
Pakistan,03/07/2006,14,0,0,0,10,0,0,24
Pakistan,04/07/2006,28,0,0,0,-2,1,0,27
Pakistan,05/07/2006,9,0,0,0,3,0,0,12
Pakistan,06/07/2006,2,0,0,0,0,3,0,5
Pakistan,07/07/2006,0,0,0,0,9,1,0,10
Pakistan,08/07/2006,2,0,0,0,9,0,0,11
Pakistan,09/07/2006,5,0,0,0,9,0,0,14
Pakistan,10/07/2006,21,0,0,0,0,0,0,21
Pakistan,11/07/2006,38,0,0,0,0,16,0,54
Pakistan,12/07/2006,39,0,0,0,3,5,0,47
Pakistan,13/07/2006,78,0,0,0,4,10,0,92
Pakistan,14/07/2006,19,0,0,0,12,8,0,39
Pakistan,15/07/2006,38,0,0,0,3,0,0,41
Pakistan,16/07/2006,9,2,1,0,0,2,0,14
Pakistan,17/07/2006,33,0,0,0,18,0,0,51
Pakistan,18/07/2006,53,0,1,0,30,7,0,91
Pakistan,19/07/2006,41,0,0,0,12,2,0,55
Pakistan,20/07/2006,34,0,0,0,13,5,0,52
Pakistan,21/07/2006,23,0,0,0,21,2,0,46
Pakistan,22/07/2006,5,0,0,0,0,20,0,25
Pakistan,23/07/2006,8,0,0,0,16,2,0,26
Pakistan,24/07/2006,32,0,0,0,33,6,0,71
Pakistan,25/07/2006,34,0,0,0,3,6,0,43
Pakistan,26/07/2006,44,0,0,0,36,2,0,82
Pakistan,27/07/2006,26,0,0,0,12,2,0,40
Pakistan,28/07/2006,16,0,0,0,18,2,0,36
Pakistan,29/07/2006,14,0,0,0,10,3,0,27
Pakistan,30/07/2006,39,0,0,0,1,4,0,44
Pakistan,31/07/2006,51,0,0,0,9,1,0,61
Sierra Leone,01/07/2006,0,0,0,0,0,0,0,0
Sierra Leone,02/07/2006,2,0,0,0,0,0,0,2
Sierra Leone,03/07/2006,-1,0,0,0,0,-3,0,-4
Sierra Leone,04/07/2006,9,0,0,0,6,4,0,19
Sierra Leone,05/07/2006,0,0,0,0,6,2,0,8
Sierra Leone,06/07/2006,6,0,0,0,0,0,0,6
Sierra Leone,07/07/2006,0,0,0,0,0,0,0,0
Sierra Leone,10/07/2006,2,0,0,0,0,0,0,2
Sierra Leone,11/07/2006,6,0,0,0,0,3,0,9
Sierra Leone,12/07/2006,0,0,0,0,0,0,0,0
Sierra Leone,13/07/2006,0,0,0,0,0,2,0,2
Sierra Leone,14/07/2006,0,0,0,0,0,2,0,2
Sierra Leone,16/07/2006,0,0,0,0,0,0,0,0
Sierra Leone,17/07/2006,1,0,0,0,1,0,0,2
Sierra Leone,18/07/2006,9,0,0,0,6,0,0,15
Sierra Leone,19/07/2006,8,0,0,0,6,0,0,14
Sierra Leone,20/07/2006,2,0,0,0,0,2,0,4
Sierra Leone,21/07/2006,3,0,-2,0,18,0,0,19
Sierra Leone,23/07/2006,0,0,0,0,0,0,0,0
Sierra Leone,24/07/2006,3,0,0,0,6,0,0,9
Sierra Leone,25/07/2006,17,0,0,0,7,0,0,24
Sierra Leone,26/07/2006,3,0,0,0,0,1,0,4
Sierra Leone,27/07/2006,0,0,0,0,6,0,0,6
Sierra Leone,28/07/2006,-1,0,0,0,0,0,0,-1
Sierra Leone,31/07/2006,4,0,0,0,0,0,0,4
Somalia,01/07/2006,16,0,-1,0,-2,0,0,13
Somalia,02/07/2006,5,2,1,0,0,0,0,8
Somalia,03/07/2006,4,0,0,0,6,2,0,12
Somalia,04/07/2006,0,0,0,0,4,0,0,4
Somalia,05/07/2006,5,0,0,0,0,0,0,5
Somalia,06/07/2006,10,0,0,0,6,0,0,16
Somalia,07/07/2006,4,0,-2,0,0,0,0,2
Somalia,08/07/2006,5,0,0,0,0,0,0,5
Somalia,09/07/2006,-1,0,0,0,0,0,0,-1
Somalia,10/07/2006,11,0,1,0,6,1,0,19
Somalia,11/07/2006,-1,0,0,0,3,0,0,2
Somalia,12/07/2006,-4,0,0,0,0,0,0,-4
Somalia,13/07/2006,13,0,0,0,0,0,0,13
Somalia,14/07/2006,1,0,0,0,0,2,0,3
Somalia,15/07/2006,1,0,0,0,0,0,0,1
Somalia,16/07/2006,0,0,0,0,0,0,0,0
Somalia,17/07/2006,0,2,0,0,-19,0,0,-17
Somalia,18/07/2006,24,0,0,0,1,0,0,25
Somalia,19/07/2006,5,0,0,0,0,1,0,6
Somalia,20/07/2006,1,0,0,0,9,0,0,10
Somalia,21/07/2006,2,0,2,0,0,0,0,4
Somalia,22/07/2006,4,0,0,0,0,0,0,4
Somalia,23/07/2006,6,0,0,0,0,0,0,6
Somalia,24/07/2006,3,0,0,0,0,4,0,7
Somalia,25/07/2006,4,0,0,0,3,4,0,11
Somalia,26/07/2006,-3,0,0,0,0,5,0,2
Somalia,27/07/2006,1,0,-6,0,3,0,0,-2
Somalia,28/07/2006,8,0,0,0,12,1,0,21
Somalia,29/07/2006,16,0,-4,0,11,0,0,23
Somalia,30/07/2006,5,2,-8,0,1,2,0,2
Somalia,31/07/2006,-6,0,0,0,1,1,0,-4
Syria,01/07/2006,14,0,0,0,7,3,0,24
Syria,02/07/2006,10,0,0,0,5,1,0,16
Syria,03/07/2006,3,0,0,0,9,0,0,12
Syria,04/07/2006,16,0,0,0,3,0,0,19
Syria,05/07/2006,2,0,0,0,7,0,0,9
Syria,06/07/2006,18,0,0,0,7,2,0,27
Syria,07/07/2006,14,0,0,0,13,0,0,27
Syria,08/07/2006,3,0,0,0,0,0,0,3
Syria,09/07/2006,6,0,0,0,0,0,0,6
Syria,10/07/2006,0,0,0,0,0,1,0,1
Syria,11/07/2006,18,0,0,0,6,3,0,27
Syria,12/07/2006,28,0,0,0,9,0,0,37
Syria,13/07/2006,85,0,1,0,4,1,0,91
Syria,14/07/2006,47,0,0,0,6,5,0,58
Syria,15/07/2006,78,0,0,0,3,2,0,83
Syria,16/07/2006,58,0,0,0,0,0,0,58
Syria,17/07/2006,64,6,0,0,3,3,0,76
Syria,18/07/2006,62,0,0,0,4,10,0,76
Syria,19/07/2006,47,0,0,0,6,1,0,54
Syria,20/07/2006,75,4,0,0,5,5,0,89
Syria,21/07/2006,25,0,0,0,0,10,0,35
Syria,22/07/2006,21,0,0,0,0,4,0,25
Syria,23/07/2006,28,0,0,0,-2,0,0,26
Syria,24/07/2006,36,0,0,0,1,2,0,39
Syria,25/07/2006,50,0,0,0,5,3,0,58
Syria,26/07/2006,23,0,-1,0,-3,8,0,27
Syria,27/07/2006,31,2,0,0,0,1,0,34
Syria,28/07/2006,27,0,0,0,9,0,0,36
Syria,29/07/2006,39,0,0,0,-2,0,0,37
Syria,30/07/2006,33,0,-4,0,0,4,0,33
Syria,31/07/2006,68,0,0,0,15,5,0,88
Yemen,01/07/2006,1,0,0,0,0,0,0,1
Yemen,02/07/2006,2,0,0,0,0,0,0,2
Yemen,03/07/2006,2,0,0,0,3,4,0,9
Yemen,04/07/2006,2,0,0,0,3,0,0,5
Yemen,05/07/2006,0,0,0,0,0,0,0,0
Yemen,06/07/2006,6,0,0,0,0,0,0,6
Yemen,08/07/2006,1,0,0,0,3,0,0,4
Yemen,09/07/2006,-2,0,0,0,0,0,0,-2
Yemen,10/07/2006,0,0,0,0,3,0,0,3
Yemen,11/07/2006,0,0,0,0,3,0,0,3
Yemen,12/07/2006,2,0,0,0,3,0,0,5
Yemen,13/07/2006,0,0,0,0,0,0,0,0
Yemen,14/07/2006,0,0,0,0,12,0,0,12
Yemen,15/07/2006,-1,0,0,0,0,0,0,-1
Yemen,16/07/2006,5,0,0,0,0,0,0,5
Yemen,18/07/2006,0,0,0,0,0,0,0,0
Yemen,19/07/2006,0,0,0,0,0,0,0,0
Yemen,20/07/2006,0,0,0,0,0,0,0,0
Yemen,21/07/2006,0,0,0,0,0,0,0,0
Yemen,22/07/2006,0,0,0,0,0,0,0,0
Yemen,23/07/2006,0,0,0,0,0,0,0,0
Yemen,24/07/2006,0,0,0,0,6,0,0,6
Yemen,25/07/2006,3,0,0,0,0,0,0,3
Yemen,26/07/2006,1,0,0,0,0,0,0,1
Yemen,27/07/2006,-1,0,0,0,0,0,0,-1
Yemen,28/07/2006,0,0,0,0,0,0,0,0
Yemen,29/07/2006,0,0,0,0,0,0,0,0
Yemen,30/07/2006,0,0,0,0,0,0,0,0
Yemen,31/07/2006,2,0,0,0,0,0,0,2
Afghanistan,01/09/2011,253,0,1,0,29,10,0,293
Afghanistan,02/09/2011,197,0,-1,0,139,9,0,344
Afghanistan,03/09/2011,172,0,0,0,134,3,0,309
Afghanistan,04/09/2011,116,0,0,0,54,3,0,173
Afghanistan,05/09/2011,191,0,-2,0,72,19,0,280
Afghanistan,06/09/2011,196,4,0,0,47,27,0,274
Afghanistan,07/09/2011,256,4,0,0,113,58,0,431
Afghanistan,08/09/2011,361,2,2,0,100,25,0,490
Afghanistan,09/09/2011,418,12,-2,0,113,23,0,564
Afghanistan,10/09/2011,234,8,-1,0,67,9,0,317
Afghanistan,11/09/2011,515,2,0,0,60,103,0,680
Afghanistan,12/09/2011,308,0,2,0,14,45,0,369
Afghanistan,13/09/2011,204,2,1,0,37,8,0,252
Afghanistan,14/09/2011,178,8,2,0,30,20,0,238
Afghanistan,15/09/2011,248,2,2,0,36,46,0,334
Afghanistan,16/09/2011,183,0,1,0,28,20,0,232
Afghanistan,17/09/2011,165,0,0,0,8,14,0,187
Afghanistan,18/09/2011,205,0,0,0,-8,8,0,205
Afghanistan,19/09/2011,296,4,-7,0,46,47,0,386
Afghanistan,20/09/2011,252,8,-8,0,6,40,0,298
Afghanistan,21/09/2011,267,4,-2,0,23,23,0,315
Afghanistan,22/09/2011,339,0,2,0,75,27,0,443
Afghanistan,23/09/2011,335,0,-2,0,78,14,0,425
Afghanistan,24/09/2011,184,0,-3,0,55,14,0,250
Afghanistan,25/09/2011,89,8,0,0,3,14,0,114
Afghanistan,26/09/2011,173,2,0,0,25,11,0,211
Afghanistan,27/09/2011,171,0,0,0,1,20,0,192
Afghanistan,28/09/2011,203,2,-2,0,30,24,0,257
Afghanistan,29/09/2011,92,4,0,0,34,15,0,145
Afghanistan,30/09/2011,23,0,0,0,5,0,0,28
Albania,01/09/2011,16,0,-2,0,0,0,0,14
Albania,02/09/2011,21,0,-1,0,12,0,0,32
Albania,03/09/2011,15,0,-1,0,3,4,0,21
Albania,04/09/2011,10,0,-2,0,7,2,0,17
Albania,05/09/2011,13,0,-3,0,16,0,0,26
Albania,06/09/2011,10,0,-1,0,22,10,0,41
Albania,07/09/2011,14,0,-2,0,1,0,0,13
Albania,08/09/2011,22,0,-2,0,10,10,0,40
Albania,09/09/2011,21,0,-1,0,6,4,0,30
Albania,10/09/2011,17,0,-1,0,9,2,0,27
Albania,11/09/2011,3,0,-1,0,0,1,0,3
Albania,12/09/2011,28,0,-1,0,3,0,0,30
Albania,13/09/2011,21,0,-8,0,18,4,0,35
Albania,14/09/2011,39,0,-2,0,11,8,0,56
Albania,15/09/2011,74,0,-3,0,6,1,0,78
Albania,16/09/2011,56,0,-3,0,15,7,0,75
Albania,17/09/2011,13,0,0,0,15,14,0,42
Albania,18/09/2011,14,0,0,0,0,2,0,16
Albania,19/09/2011,6,0,0,0,9,0,0,15
Albania,20/09/2011,2,0,0,0,-2,3,0,3
Albania,21/09/2011,5,0,-1,0,9,4,0,17
Albania,22/09/2011,3,0,0,0,4,2,0,9
Albania,23/09/2011,4,0,-1,0,0,0,0,3
Albania,24/09/2011,5,0,0,0,0,2,0,7
Albania,25/09/2011,3,0,-4,0,0,0,0,-1
Albania,26/09/2011,6,0,0,0,12,3,0,21
Albania,27/09/2011,24,0,-1,0,24,13,0,60
Albania,28/09/2011,82,0,0,0,48,7,0,137
Albania,29/09/2011,10,0,0,0,-2,2,0,10
Albania,30/09/2011,4,0,0,0,0,0,0,4
Algeria,01/09/2011,127,0,3,0,-16,1,0,115
Algeria,02/09/2011,24,0,0,0,1,1,0,26
Algeria,03/09/2011,18,0,0,0,12,0,0,30
Algeria,04/09/2011,35,0,0,0,22,3,0,60
Algeria,05/09/2011,47,0,0,0,29,2,0,78
Algeria,06/09/2011,57,0,-2,0,13,0,0,68
Algeria,07/09/2011,48,0,-4,0,10,0,0,54
Algeria,08/09/2011,35,0,-4,0,9,9,0,49
Algeria,09/09/2011,5,0,-2,0,1,8,0,12
Algeria,10/09/2011,11,0,0,0,11,2,0,24
Algeria,11/09/2011,4,0,0,0,9,6,0,19
Algeria,12/09/2011,27,0,0,0,-5,2,0,24
Algeria,13/09/2011,51,0,-2,0,-10,1,0,40
Algeria,14/09/2011,45,0,-4,0,-2,9,0,48
Algeria,15/09/2011,5,0,0,0,1,2,0,8
Algeria,16/09/2011,17,0,-2,0,4,5,0,24
Algeria,17/09/2011,63,0,0,0,3,6,0,72
Algeria,18/09/2011,28,0,0,0,9,6,0,43
Algeria,19/09/2011,4,0,0,0,0,4,0,8
Algeria,20/09/2011,4,0,0,0,7,6,0,17
Algeria,21/09/2011,132,0,1,0,16,0,0,149
Algeria,22/09/2011,65,0,0,0,77,0,0,142
Algeria,23/09/2011,40,0,0,0,29,3,0,72
Algeria,24/09/2011,21,0,0,0,3,6,0,30
Algeria,25/09/2011,108,0,0,0,3,2,0,113
Algeria,26/09/2011,68,0,1,0,30,0,0,99
Algeria,27/09/2011,62,0,0,0,173,4,0,239
Algeria,28/09/2011,70,0,0,0,36,2,0,108
Algeria,29/09/2011,39,0,0,0,74,0,0,113
Algeria,30/09/2011,4,0,0,0,9,0,0,13
Bangladesh,01/09/2011,7,0,0,0,0,2,0,9
Bangladesh,02/09/2011,19,0,0,0,-2,5,0,22
Bangladesh,03/09/2011,26,0,0,0,-2,3,0,27
Bangladesh,04/09/2011,16,0,0,0,9,3,0,28
Bangladesh,05/09/2011,10,0,0,0,6,3,0,19
Bangladesh,06/09/2011,21,0,0,0,-3,0,0,18
Bangladesh,07/09/2011,40,0,0,0,16,10,0,66
Bangladesh,08/09/2011,20,0,0,0,12,7,0,39
Bangladesh,09/09/2011,22,0,1,0,-1,4,0,26
Bangladesh,10/09/2011,36,0,1,0,3,0,0,40
Bangladesh,11/09/2011,16,0,0,0,17,4,0,37
Bangladesh,12/09/2011,24,0,0,0,10,0,0,34
Bangladesh,13/09/2011,26,2,0,0,5,5,0,38
Bangladesh,14/09/2011,27,0,0,0,4,3,0,34
Bangladesh,15/09/2011,1,0,0,0,5,2,0,8
Bangladesh,16/09/2011,21,0,2,0,3,2,0,28
Bangladesh,17/09/2011,31,0,-1,0,15,10,0,55
Bangladesh,18/09/2011,23,2,1,0,-4,7,0,29
Bangladesh,19/09/2011,14,2,0,0,-2,1,0,15
Bangladesh,20/09/2011,10,2,0,0,18,0,0,30
Bangladesh,21/09/2011,24,0,0,0,-2,1,0,23
Bangladesh,22/09/2011,25,0,0,0,-1,2,0,26
Bangladesh,23/09/2011,20,0,0,0,18,1,0,39
Bangladesh,24/09/2011,23,0,-4,0,6,3,0,28
Bangladesh,25/09/2011,15,0,0,0,12,1,0,28
Bangladesh,26/09/2011,41,2,-4,0,28,4,0,71
Bangladesh,27/09/2011,12,0,0,0,9,2,0,23
Bangladesh,28/09/2011,10,10,1,0,3,6,0,30
Bangladesh,29/09/2011,16,0,0,0,8,5,0,29
Bangladesh,30/09/2011,5,0,0,0,0,10,0,15
Cameroon,01/09/2011,4,0,0,0,-2,0,0,2
Cameroon,02/09/2011,3,0,0,0,0,0,0,3
Cameroon,03/09/2011,2,0,0,0,6,4,0,12
Cameroon,04/09/2011,6,0,-4,0,0,0,0,2
Cameroon,05/09/2011,2,0,0,0,0,0,0,2
Cameroon,06/09/2011,4,0,0,0,0,0,0,4
Cameroon,07/09/2011,4,0,0,0,0,0,0,4
Cameroon,08/09/2011,4,0,0,0,0,0,0,4
Cameroon,09/09/2011,1,0,0,0,21,0,0,22
Cameroon,10/09/2011,11,0,0,0,0,0,0,11
Cameroon,11/09/2011,5,0,0,0,0,0,0,5
Cameroon,12/09/2011,14,0,0,0,0,0,0,14
Cameroon,13/09/2011,1,0,0,0,0,0,0,1
Cameroon,14/09/2011,0,0,0,0,3,0,0,3
Cameroon,15/09/2011,2,0,0,0,-2,0,0,0
Cameroon,16/09/2011,0,0,0,0,0,0,0,0
Cameroon,17/09/2011,4,0,0,0,-2,0,0,2
Cameroon,19/09/2011,0,0,0,0,0,0,0,0
Cameroon,20/09/2011,0,0,0,0,0,0,0,0
Cameroon,21/09/2011,0,0,0,0,0,0,0,0
Cameroon,22/09/2011,0,0,0,0,-6,0,0,-6
Cameroon,23/09/2011,0,0,0,0,3,0,0,3
Cameroon,24/09/2011,2,0,0,0,3,0,0,5
Cameroon,26/09/2011,0,0,0,0,3,0,0,3
Cameroon,27/09/2011,-1,0,0,0,0,0,0,-1
Cameroon,28/09/2011,0,0,0,0,0,0,0,0
Cameroon,29/09/2011,6,0,0,0,0,0,0,6
China,01/09/2011,195,4,-2,0,59,40,0,296
China,02/09/2011,123,4,-4,0,32,27,0,182
China,03/09/2011,83,0,-4,0,16,20,0,115
China,04/09/2011,116,0,-3,0,61,14,0,188
China,05/09/2011,175,2,-3,0,84,26,0,284
China,06/09/2011,220,0,0,0,143,21,0,384
China,07/09/2011,207,2,0,0,135,31,0,375
China,08/09/2011,201,6,-3,0,43,24,0,271
China,09/09/2011,110,0,1,0,126,19,0,256
China,10/09/2011,97,0,0,0,19,8,0,124
China,11/09/2011,118,0,-1,0,26,9,0,152
China,12/09/2011,203,6,-3,0,28,26,0,260
China,13/09/2011,157,2,-2,0,58,22,0,237
China,14/09/2011,116,8,-2,0,34,12,0,168
China,15/09/2011,176,2,6,0,32,12,0,228
China,16/09/2011,142,0,-2,0,31,17,0,188
China,17/09/2011,65,0,2,0,10,24,0,101
China,18/09/2011,125,4,0,0,53,5,0,187
China,19/09/2011,236,12,-1,0,81,18,0,346
China,20/09/2011,181,10,-1,0,22,22,0,234
China,21/09/2011,153,8,1,0,72,11,0,245
China,22/09/2011,191,16,-1,0,36,28,0,270
China,23/09/2011,148,6,-5,0,-4,19,0,164
China,24/09/2011,101,4,-2,0,0,4,0,107
China,25/09/2011,85,0,0,0,2,8,0,95
China,26/09/2011,173,2,-4,0,52,34,0,257
China,27/09/2011,146,2,1,0,71,20,0,240
China,28/09/2011,176,0,1,0,68,18,0,263
China,29/09/2011,44,0,2,0,80,2,0,128
China,30/09/2011,6,0,-2,0,0,1,0,5
Egypt,01/09/2011,29,0,0,0,30,7,0,66
Egypt,02/09/2011,27,0,0,0,34,4,0,65
Egypt,03/09/2011,22,0,0,0,23,10,0,55
Egypt,04/09/2011,32,0,0,0,60,12,0,104
Egypt,05/09/2011,90,0,2,0,74,27,0,193
Egypt,06/09/2011,90,0,0,0,34,18,0,142
Egypt,07/09/2011,69,2,-2,0,95,30,0,194
Egypt,08/09/2011,86,4,-2,0,60,29,0,177
Egypt,09/09/2011,55,4,1,0,42,13,0,115
Egypt,10/09/2011,110,0,-1,0,29,24,0,162
Egypt,11/09/2011,59,2,-4,0,55,5,0,117
Egypt,12/09/2011,64,0,-1,0,30,14,0,107
Egypt,13/09/2011,152,0,-8,0,40,18,0,202
Egypt,14/09/2011,51,0,-4,0,34,11,0,92
Egypt,15/09/2011,109,0,0,0,111,14,0,234
Egypt,16/09/2011,96,0,0,0,27,9,0,132
Egypt,17/09/2011,32,0,-4,0,17,7,0,52
Egypt,18/09/2011,49,8,-1,0,30,3,0,89
Egypt,19/09/2011,50,2,0,0,39,15,0,106
Egypt,20/09/2011,78,0,-1,0,49,18,0,144
Egypt,21/09/2011,49,0,-1,0,16,23,0,87
Egypt,22/09/2011,45,0,0,0,-4,21,0,62
Egypt,23/09/2011,91,0,5,0,13,21,0,130
Egypt,24/09/2011,71,0,1,0,21,8,0,101
Egypt,25/09/2011,103,0,-3,0,45,12,0,157
Egypt,26/09/2011,52,0,2,0,27,23,0,104
Egypt,27/09/2011,74,2,0,0,15,22,0,113
Egypt,28/09/2011,76,0,-3,0,75,10,0,158
Egypt,29/09/2011,47,0,1,0,52,8,0,108
Egypt,30/09/2011,0,0,0,0,0,0,0,0
Eritrea,01/09/2011,2,0,0,0,3,0,0,5
Eritrea,04/09/2011,0,0,0,0,0,0,0,0
Eritrea,05/09/2011,4,0,0,0,0,0,0,4
Eritrea,06/09/2011,6,0,2,0,3,0,0,11
Eritrea,07/09/2011,7,0,0,0,-2,2,0,7
Eritrea,08/09/2011,2,0,0,0,1,0,0,3
Eritrea,09/09/2011,0,0,0,0,0,0,0,0
Eritrea,10/09/2011,1,0,0,0,0,0,0,1
Eritrea,11/09/2011,0,0,0,0,0,0,0,0
Eritrea,12/09/2011,5,0,0,0,0,0,0,5
Eritrea,13/09/2011,0,0,0,0,-3,0,0,-3
Eritrea,14/09/2011,0,0,0,0,3,0,0,3
Eritrea,15/09/2011,4,0,0,0,6,0,0,10
Eritrea,16/09/2011,8,0,1,0,-1,0,0,8
Eritrea,17/09/2011,10,0,1,0,-2,0,0,9
Eritrea,18/09/2011,19,0,0,0,-1,1,0,19
Eritrea,19/09/2011,5,0,0,0,0,1,0,6
Eritrea,20/09/2011,0,0,0,0,0,0,0,0
Eritrea,21/09/2011,6,0,0,0,0,0,0,6
Eritrea,22/09/2011,13,0,0,0,-4,4,0,13
Eritrea,23/09/2011,13,0,0,0,7,0,0,20
Eritrea,24/09/2011,8,0,0,0,24,0,0,32
Eritrea,25/09/2011,2,0,3,0,0,4,0,9
Eritrea,26/09/2011,3,0,2,0,3,0,0,8
Eritrea,27/09/2011,0,0,0,0,15,0,0,15
Eritrea,28/09/2011,2,0,0,0,13,0,0,15
Eritrea,29/09/2011,1,0,0,0,-2,0,0,-1
Georgia,01/09/2011,19,0,-12,0,28,3,0,38
Georgia,02/09/2011,8,0,0,0,9,2,0,19
Georgia,03/09/2011,7,2,0,0,15,0,0,24
Georgia,04/09/2011,19,0,1,0,3,1,0,24
Georgia,05/09/2011,12,0,0,0,6,3,0,21
Georgia,06/09/2011,47,0,-2,0,9,3,0,57
Georgia,07/09/2011,21,6,0,0,13,1,0,41
Georgia,08/09/2011,10,4,0,0,16,3,0,33
Georgia,09/09/2011,15,4,0,0,6,0,0,25
Georgia,10/09/2011,12,4,0,0,1,0,0,17
Georgia,11/09/2011,22,0,0,0,1,0,0,23
Georgia,12/09/2011,11,0,1,0,15,6,0,33
Georgia,13/09/2011,48,0,0,0,27,6,0,81
Georgia,14/09/2011,41,0,0,0,13,7,0,61
Georgia,15/09/2011,14,0,0,0,0,1,0,15
Georgia,16/09/2011,55,0,0,0,44,3,0,102
Georgia,17/09/2011,43,0,0,0,28,4,0,75
Georgia,18/09/2011,39,2,0,0,18,4,0,63
Georgia,19/09/2011,34,2,1,0,52,16,0,105
Georgia,20/09/2011,97,0,2,0,64,12,0,175
Georgia,21/09/2011,28,0,1,0,12,8,0,49
Georgia,22/09/2011,147,6,15,0,46,7,0,221
Georgia,23/09/2011,60,2,0,0,45,8,0,115
Georgia,24/09/2011,43,0,0,0,9,9,0,61
Georgia,25/09/2011,20,0,0,0,24,5,0,49
Georgia,26/09/2011,29,0,1,0,31,8,0,69
Georgia,27/09/2011,19,0,0,0,33,3,0,55
Georgia,28/09/2011,35,0,-1,0,19,6,0,59
Georgia,29/09/2011,27,0,-5,0,22,5,0,49
India,01/09/2011,58,0,0,0,18,10,0,86
India,02/09/2011,28,0,-2,0,9,7,0,42
India,03/09/2011,29,0,0,0,-4,7,0,32
India,04/09/2011,32,0,1,0,12,7,0,52
India,05/09/2011,78,0,-3,0,17,10,0,102
India,06/09/2011,69,2,-3,0,20,3,0,91
India,07/09/2011,64,2,1,0,-10,6,0,63
India,08/09/2011,83,2,-1,0,27,9,0,120
India,09/09/2011,49,0,-7,0,34,4,0,80
India,10/09/2011,59,0,1,0,3,0,0,63
India,11/09/2011,58,0,-2,0,12,2,0,70
India,12/09/2011,74,0,0,0,10,1,0,85
India,13/09/2011,61,0,0,0,10,15,0,86
India,14/09/2011,78,2,0,0,32,5,0,117
India,15/09/2011,70,0,-2,0,18,7,0,93
India,16/09/2011,61,2,-2,0,26,11,0,98
India,17/09/2011,56,0,0,0,3,2,0,61
India,18/09/2011,50,0,0,0,6,11,0,67
India,19/09/2011,44,2,0,0,25,11,0,82
India,20/09/2011,60,0,-1,0,-2,12,0,69
India,21/09/2011,47,2,0,0,4,4,0,57
India,22/09/2011,52,4,-1,0,10,13,0,78
India,23/09/2011,87,2,0,0,16,3,0,108
India,24/09/2011,68,6,0,0,0,4,0,78
India,25/09/2011,45,2,2,0,10,3,0,62
India,26/09/2011,46,4,-2,0,13,19,0,80
India,27/09/2011,73,4,0,0,1,3,0,81
India,28/09/2011,40,2,0,0,4,5,0,51
India,29/09/2011,14,0,-2,0,-4,2,0,10
India,30/09/2011,0,0,0,0,0,0,0,0
Iran,01/09/2011,57,0,0,0,5,5,0,67
Iran,02/09/2011,64,0,7,0,21,4,0,96
Iran,03/09/2011,37,0,6,0,19,6,0,68
Iran,04/09/2011,35,0,0,0,7,7,0,49
Iran,05/09/2011,78,0,-3,0,77,9,0,161
Iran,06/09/2011,32,0,9,0,32,13,0,86
Iran,07/09/2011,103,0,1,0,-2,4,0,106
Iran,08/09/2011,73,0,3,0,25,10,0,111
Iran,09/09/2011,127,0,-3,0,4,12,0,140
Iran,10/09/2011,78,4,-6,0,13,7,0,96
Iran,11/09/2011,93,0,-7,0,8,6,0,100
Iran,12/09/2011,101,0,1,0,63,8,0,173
Iran,13/09/2011,85,0,1,0,28,16,0,130
Iran,14/09/2011,132,0,1,0,-9,11,0,135
Iran,15/09/2011,63,0,1,0,31,7,0,102
Iran,16/09/2011,103,0,0,0,36,0,0,139
Iran,17/09/2011,66,0,0,0,18,8,0,92
Iran,18/09/2011,65,0,1,0,-29,6,0,43
Iran,19/09/2011,112,0,1,0,22,9,0,144
Iran,20/09/2011,154,2,0,0,30,12,0,198
Iran,21/09/2011,161,0,-2,0,13,3,0,175
Iran,22/09/2011,214,0,-8,0,61,38,0,305
Iran,23/09/2011,106,0,2,0,50,5,0,163
Iran,24/09/2011,55,0,-1,0,16,5,0,75
Iran,25/09/2011,76,0,0,0,56,4,0,136
Iran,26/09/2011,93,6,3,0,45,7,0,154
Iran,27/09/2011,61,0,2,0,21,9,0,93
Iran,28/09/2011,130,2,2,0,76,21,0,231
Iran,29/09/2011,68,0,0,0,124,8,0,200
Iran,30/09/2011,4,0,0,0,5,2,0,11
Iraq,01/09/2011,176,4,0,0,36,18,0,234
Iraq,02/09/2011,179,0,0,0,21,12,0,212
Iraq,03/09/2011,107,0,1,0,38,11,0,157
Iraq,04/09/2011,191,0,0,0,15,6,0,212
Iraq,05/09/2011,139,2,-2,0,27,5,0,171
Iraq,06/09/2011,144,8,-8,0,27,14,0,185
Iraq,07/09/2011,213,6,0,0,26,21,0,266
Iraq,08/09/2011,251,2,11,0,119,31,0,414
Iraq,09/09/2011,239,0,-5,0,110,87,0,431
Iraq,10/09/2011,284,4,-1,0,30,53,0,370
Iraq,11/09/2011,495,4,-18,0,93,14,0,588
Iraq,12/09/2011,277,2,-10,0,-1,28,0,296
Iraq,13/09/2011,262,8,0,0,74,17,0,361
Iraq,14/09/2011,139,0,-4,0,23,15,0,173
Iraq,15/09/2011,215,2,-6,0,57,23,0,291
Iraq,16/09/2011,215,2,-2,0,52,21,0,288
Iraq,17/09/2011,38,2,0,0,-25,12,0,27
Iraq,18/09/2011,119,0,0,0,-14,15,0,120
Iraq,19/09/2011,97,0,-2,0,30,20,0,145
Iraq,20/09/2011,209,0,-2,0,32,15,0,254
Iraq,21/09/2011,192,0,-10,0,48,17,0,247
Iraq,22/09/2011,130,0,-3,0,48,9,0,184
Iraq,23/09/2011,182,0,0,0,41,6,0,229
Iraq,24/09/2011,109,0,-5,0,45,6,0,155
Iraq,25/09/2011,82,0,1,0,50,6,0,139
Iraq,26/09/2011,115,0,-5,0,24,12,0,146
Iraq,27/09/2011,126,0,1,0,5,5,0,137
Iraq,28/09/2011,72,0,0,0,63,4,0,139
Iraq,29/09/2011,67,0,0,0,59,5,0,131
Iraq,30/09/2011,-1,0,0,0,0,0,0,-1
Morocco,01/09/2011,0,0,0,0,31,2,0,33
Morocco,02/09/2011,5,0,1,0,22,5,0,33
Morocco,03/09/2011,0,0,1,0,6,0,0,7
Morocco,04/09/2011,3,0,0,0,3,0,0,6
Morocco,05/09/2011,10,0,0,0,9,0,0,19
Morocco,06/09/2011,0,0,0,0,0,0,0,0
Morocco,07/09/2011,8,0,0,0,0,1,0,9
Morocco,08/09/2011,2,0,-2,0,4,0,0,4
Morocco,09/09/2011,6,0,0,0,5,0,0,11
Morocco,10/09/2011,13,0,0,0,4,0,0,17
Morocco,11/09/2011,9,0,0,0,6,3,0,18
Morocco,12/09/2011,2,0,0,0,0,1,0,3
Morocco,13/09/2011,6,0,0,0,6,2,0,14
Morocco,14/09/2011,16,0,0,0,9,0,0,25
Morocco,15/09/2011,6,0,-2,0,6,0,0,10
Morocco,16/09/2011,9,0,0,0,3,0,0,12
Morocco,17/09/2011,1,0,0,0,0,3,0,4
Morocco,18/09/2011,9,0,-1,0,2,3,0,13
Morocco,19/09/2011,11,0,0,0,0,8,0,19
Morocco,20/09/2011,12,0,0,0,0,0,0,12
Morocco,21/09/2011,10,0,-1,0,0,7,0,16
Morocco,22/09/2011,35,0,0,0,6,0,0,41
Morocco,23/09/2011,2,0,0,0,0,0,0,2
Morocco,24/09/2011,0,0,0,0,0,0,0,0
Morocco,25/09/2011,4,0,2,0,0,0,0,6
Morocco,26/09/2011,15,0,0,0,6,0,0,21
Morocco,27/09/2011,6,0,0,0,14,2,0,22
Morocco,28/09/2011,1,0,0,0,18,0,0,19
Morocco,29/09/2011,-1,0,0,0,0,0,0,-1
Morocco,30/09/2011,0,0,0,0,0,0,0,0
Nigeria,01/09/2011,16,0,0,0,8,6,0,30
Nigeria,02/09/2011,61,0,0,0,-4,7,0,64
Nigeria,03/09/2011,77,0,0,0,10,10,0,97
Nigeria,04/09/2011,27,0,2,0,31,13,0,73
Nigeria,05/09/2011,69,0,0,0,15,8,0,92
Nigeria,06/09/2011,48,0,0,0,15,3,0,66
Nigeria,07/09/2011,43,0,3,0,25,8,0,79
Nigeria,08/09/2011,46,0,4,0,25,2,0,77
Nigeria,09/09/2011,68,0,0,0,10,2,0,80
Nigeria,10/09/2011,50,0,0,0,9,6,0,65
Nigeria,11/09/2011,84,0,0,0,12,9,0,105
Nigeria,12/09/2011,47,2,0,0,24,12,0,85
Nigeria,13/09/2011,25,0,0,0,22,1,0,48
Nigeria,14/09/2011,44,0,0,0,8,3,0,55
Nigeria,15/09/2011,33,0,1,0,32,1,0,67
Nigeria,16/09/2011,15,0,0,0,6,1,0,22
Nigeria,17/09/2011,41,0,0,0,37,2,0,80
Nigeria,18/09/2011,14,0,0,0,6,2,0,22
Nigeria,19/09/2011,14,0,-4,0,11,4,0,25
Nigeria,20/09/2011,22,0,-3,0,16,4,0,39
Nigeria,21/09/2011,21,0,1,0,32,9,0,63
Nigeria,22/09/2011,46,0,0,0,21,9,0,76
Nigeria,23/09/2011,13,0,0,0,7,12,0,32
Nigeria,24/09/2011,18,0,0,0,28,24,0,70
Nigeria,25/09/2011,24,0,-3,0,20,7,0,48
Nigeria,26/09/2011,60,0,0,0,11,2,0,73
Nigeria,27/09/2011,41,0,0,0,9,4,0,54
Nigeria,28/09/2011,37,0,0,0,36,4,0,77
Nigeria,29/09/2011,3,0,0,0,-3,2,0,2
Nigeria,30/09/2011,3,0,0,0,0,0,0,3
Pakistan,01/09/2011,134,0,1,0,20,3,0,158
Pakistan,02/09/2011,150,0,-4,0,89,8,0,243
Pakistan,03/09/2011,52,0,0,0,71,9,0,132
Pakistan,04/09/2011,46,0,0,0,61,13,0,120
Pakistan,05/09/2011,109,4,0,0,74,9,0,196
Pakistan,06/09/2011,121,0,-2,0,103,19,0,241
Pakistan,07/09/2011,398,0,0,0,101,133,0,632
Pakistan,08/09/2011,175,2,-1,0,58,9,0,243
Pakistan,09/09/2011,283,0,-1,0,52,9,0,343
Pakistan,10/09/2011,159,2,1,0,22,20,0,204
Pakistan,11/09/2011,270,10,3,0,82,25,0,390
Pakistan,12/09/2011,124,10,2,0,34,6,0,176
Pakistan,13/09/2011,104,4,0,0,11,8,0,127
Pakistan,14/09/2011,151,2,-1,0,52,0,0,204
Pakistan,15/09/2011,147,2,0,0,40,22,0,211
Pakistan,16/09/2011,176,2,-2,0,-10,9,0,175
Pakistan,17/09/2011,72,2,0,0,4,4,0,82
Pakistan,18/09/2011,112,6,0,0,17,5,0,140
Pakistan,19/09/2011,93,12,4,0,27,10,0,146
Pakistan,20/09/2011,207,2,-2,0,23,33,0,263
Pakistan,21/09/2011,108,0,-3,0,25,11,0,141
Pakistan,22/09/2011,151,14,-10,0,19,4,0,178
Pakistan,23/09/2011,202,2,-2,0,17,12,0,231
Pakistan,24/09/2011,91,0,-6,0,0,13,0,98
Pakistan,25/09/2011,210,0,0,0,53,12,0,275
Pakistan,26/09/2011,218,4,-2,0,54,16,0,290
Pakistan,27/09/2011,148,0,-5,0,66,40,0,249
Pakistan,28/09/2011,154,2,0,0,40,9,0,205
Pakistan,29/09/2011,91,0,0,0,31,7,0,129
Pakistan,30/09/2011,30,0,0,0,0,2,0,32
Sierra Leone,01/09/2011,4,0,0,0,0,2,0,6
Sierra Leone,02/09/2011,14,0,0,0,0,0,0,14
Sierra Leone,03/09/2011,10,0,0,0,-2,0,0,8
Sierra Leone,04/09/2011,2,0,0,0,0,0,0,2
Sierra Leone,05/09/2011,-6,0,0,0,6,0,0,0
Sierra Leone,06/09/2011,11,0,0,0,3,0,0,14
Sierra Leone,07/09/2011,3,0,0,0,6,3,0,12
Sierra Leone,08/09/2011,5,0,0,0,0,2,0,7
Sierra Leone,09/09/2011,2,0,1,0,3,4,0,10
Sierra Leone,10/09/2011,2,0,0,0,0,0,0,2
Sierra Leone,11/09/2011,1,0,0,0,-1,0,0,0
Sierra Leone,12/09/2011,15,0,0,0,0,1,0,16
Sierra Leone,13/09/2011,1,0,0,0,-6,0,0,-5
Sierra Leone,14/09/2011,8,0,0,0,0,0,0,8
Sierra Leone,15/09/2011,2,0,0,0,0,0,0,2
Sierra Leone,16/09/2011,7,0,0,0,-4,0,0,3
Sierra Leone,17/09/2011,0,0,0,0,1,0,0,1
Sierra Leone,18/09/2011,21,0,0,0,3,0,0,24
Sierra Leone,19/09/2011,3,0,0,0,0,0,0,3
Sierra Leone,20/09/2011,4,0,0,0,6,6,0,16
Sierra Leone,21/09/2011,0,0,0,0,0,2,0,2
Sierra Leone,22/09/2011,3,0,0,0,3,0,0,6
Sierra Leone,23/09/2011,2,0,0,0,0,2,0,4
Sierra Leone,24/09/2011,2,2,0,0,3,0,0,7
Sierra Leone,25/09/2011,6,0,0,0,0,0,0,6
Sierra Leone,26/09/2011,16,0,0,0,3,0,0,19
Sierra Leone,27/09/2011,3,0,0,0,0,0,0,3
Sierra Leone,28/09/2011,7,0,-2,0,9,0,0,14
Sierra Leone,29/09/2011,3,0,0,0,0,0,0,3
Somalia,01/09/2011,17,0,0,0,11,0,0,28
Somalia,02/09/2011,11,4,-1,0,4,2,0,20
Somalia,03/09/2011,40,0,0,0,7,0,0,47
Somalia,04/09/2011,55,8,0,0,0,0,0,63
Somalia,05/09/2011,71,0,0,0,35,0,0,106
Somalia,06/09/2011,37,0,0,0,14,3,0,54
Somalia,07/09/2011,49,0,-6,0,11,10,0,64
Somalia,08/09/2011,64,0,-1,0,70,6,0,139
Somalia,09/09/2011,88,14,-1,0,26,7,0,134
Somalia,10/09/2011,46,0,0,0,33,0,0,79
Somalia,11/09/2011,163,0,0,0,112,9,0,284
Somalia,12/09/2011,167,0,0,0,76,11,0,254
Somalia,13/09/2011,74,2,0,0,83,4,0,163
Somalia,14/09/2011,84,0,1,0,23,1,0,109
Somalia,15/09/2011,52,0,0,0,-1,1,0,52
Somalia,16/09/2011,46,0,0,0,13,11,0,70
Somalia,17/09/2011,80,0,0,0,36,3,0,119
Somalia,18/09/2011,91,0,2,0,34,6,0,133
Somalia,19/09/2011,66,0,1,0,58,1,0,126
Somalia,20/09/2011,37,4,0,0,18,6,0,65
Somalia,21/09/2011,48,0,2,0,54,7,0,111
Somalia,22/09/2011,48,2,0,0,27,1,0,78
Somalia,23/09/2011,51,2,0,0,19,4,0,76
Somalia,24/09/2011,28,4,0,0,-1,4,0,35
Somalia,25/09/2011,29,2,0,0,-1,1,0,31
Somalia,26/09/2011,15,0,0,0,17,8,0,40
Somalia,27/09/2011,38,0,0,0,4,8,0,50
Somalia,28/09/2011,19,0,0,0,-19,1,0,1
Somalia,29/09/2011,31,0,0,0,24,0,0,55
Somalia,30/09/2011,3,0,0,0,0,0,0,3
Syria,01/09/2011,209,0,-16,0,72,37,0,302
Syria,02/09/2011,103,0,-1,0,32,29,0,163
Syria,03/09/2011,84,0,-2,0,5,10,0,97
Syria,04/09/2011,198,0,-2,0,1,28,0,225
Syria,05/09/2011,129,0,0,0,27,25,0,181
Syria,06/09/2011,126,0,2,0,21,28,0,177
Syria,07/09/2011,138,0,-20,0,62,17,0,197
Syria,08/09/2011,174,14,1,0,32,26,0,247
Syria,09/09/2011,248,4,-2,0,22,26,0,298
Syria,10/09/2011,109,2,0,0,31,8,0,150
Syria,11/09/2011,79,0,-4,0,23,8,0,106
Syria,12/09/2011,240,14,-4,0,24,8,0,282
Syria,13/09/2011,128,2,0,0,17,27,0,174
Syria,14/09/2011,137,4,-2,0,33,20,0,192
Syria,15/09/2011,176,0,-5,0,24,22,0,217
Syria,16/09/2011,144,2,-4,0,16,14,0,172
Syria,17/09/2011,102,0,-6,0,-1,14,0,109
Syria,18/09/2011,66,0,0,0,16,17,0,99
Syria,19/09/2011,85,0,0,0,21,19,0,125
Syria,20/09/2011,163,8,-9,0,6,5,0,173
Syria,21/09/2011,116,0,-7,0,38,14,0,161
Syria,22/09/2011,43,0,0,0,23,25,0,91
Syria,23/09/2011,71,0,-8,0,56,8,0,127
Syria,24/09/2011,122,0,0,0,45,8,0,175
Syria,25/09/2011,56,0,-4,0,4,13,0,69
Syria,26/09/2011,93,0,-7,0,35,15,0,136
Syria,27/09/2011,158,2,-9,0,42,11,0,204
Syria,28/09/2011,170,0,-11,0,38,12,0,209
Syria,29/09/2011,65,0,-5,0,9,9,0,78
Syria,30/09/2011,47,0,1,0,0,4,0,52
Yemen,01/09/2011,21,0,0,0,-2,3,0,22
Yemen,02/09/2011,18,0,-2,0,6,6,0,28
Yemen,03/09/2011,15,0,-4,0,5,4,0,20
Yemen,04/09/2011,30,0,0,0,4,5,0,39
Yemen,05/09/2011,69,0,-4,0,3,7,0,75
Yemen,06/09/2011,17,0,-4,0,4,0,0,17
Yemen,07/09/2011,42,0,-3,0,7,13,0,59
Yemen,08/09/2011,17,0,-2,0,15,7,0,37
Yemen,09/09/2011,38,0,0,0,3,1,0,42
Yemen,10/09/2011,15,0,0,0,28,2,0,45
Yemen,11/09/2011,54,2,0,0,8,1,0,65
Yemen,12/09/2011,16,0,0,0,0,9,0,25
Yemen,13/09/2011,20,0,-2,0,17,5,0,40
Yemen,14/09/2011,32,0,0,0,7,2,0,41
Yemen,15/09/2011,29,0,-4,0,0,11,0,36
Yemen,16/09/2011,41,0,-2,0,5,4,0,48
Yemen,17/09/2011,72,0,2,0,0,9,0,83
Yemen,18/09/2011,60,0,0,0,0,9,0,69
Yemen,19/09/2011,97,0,-4,0,1,8,0,102
Yemen,20/09/2011,95,0,0,0,12,11,0,118
Yemen,21/09/2011,45,0,1,0,0,7,0,53
Yemen,22/09/2011,50,0,0,0,-1,6,0,55
Yemen,23/09/2011,81,0,-2,0,6,25,0,110
Yemen,24/09/2011,53,0,2,0,3,11,0,69
Yemen,25/09/2011,49,0,-5,0,0,13,0,57
Yemen,26/09/2011,68,0,1,0,4,6,0,79
Yemen,27/09/2011,20,0,-3,0,6,13,0,36
Yemen,28/09/2011,67,0,-2,0,32,17,0,114
Yemen,29/09/2011,43,0,0,0,6,2,0,51
Yemen,30/09/2011,64,0,-2,0,-2,6,0,66
Afghanistan,01/08/2011,160,0,-3,0,0,18,0,175
Afghanistan,02/08/2011,240,0,0,0,15,15,0,270
Afghanistan,03/08/2011,247,2,-2,0,56,41,0,344
Afghanistan,04/08/2011,223,2,-4,0,3,13,0,237
Afghanistan,05/08/2011,331,2,0,0,58,21,0,412
Afghanistan,06/08/2011,645,0,-1,0,76,16,0,736
Afghanistan,07/08/2011,724,4,0,0,30,26,0,784
Afghanistan,08/08/2011,798,10,1,0,16,10,0,835
Afghanistan,09/08/2011,727,2,-1,0,11,7,0,746
Afghanistan,10/08/2011,809,0,3,0,26,32,0,870
Afghanistan,11/08/2011,811,4,0,0,9,38,0,862
Afghanistan,12/08/2011,309,0,-4,0,8,19,0,332
Afghanistan,13/08/2011,141,4,0,0,34,12,0,191
Afghanistan,14/08/2011,325,0,3,0,39,33,0,400
Afghanistan,15/08/2011,288,0,-4,0,32,37,0,353
Afghanistan,16/08/2011,396,0,1,0,13,28,0,438
Afghanistan,17/08/2011,249,8,-4,0,27,10,0,290
Afghanistan,18/08/2011,259,0,-4,0,1,23,0,279
Afghanistan,19/08/2011,283,6,0,0,29,36,0,354
Afghanistan,20/08/2011,200,0,1,0,90,44,0,335
Afghanistan,21/08/2011,180,2,0,0,37,15,0,234
Afghanistan,22/08/2011,224,0,0,0,11,21,0,256
Afghanistan,23/08/2011,117,0,-4,0,32,8,0,153
Afghanistan,24/08/2011,210,2,0,0,-9,13,0,216
Afghanistan,25/08/2011,222,0,0,0,36,8,0,266
Afghanistan,26/08/2011,182,0,0,0,5,12,0,199
Afghanistan,27/08/2011,306,2,1,0,19,17,0,345
Afghanistan,28/08/2011,224,0,0,0,27,11,0,262
Afghanistan,29/08/2011,226,0,0,0,31,21,0,278
Afghanistan,30/08/2011,172,0,-4,0,26,14,0,208
Afghanistan,31/08/2011,200,4,7,0,47,29,0,287
Albania,01/08/2011,29,0,0,0,6,1,0,36
Albania,02/08/2011,30,0,0,0,-2,3,0,31
Albania,03/08/2011,5,0,0,0,13,7,0,25
Albania,04/08/2011,5,0,0,0,0,2,0,7
Albania,05/08/2011,1,0,0,0,-4,3,0,0
Albania,06/08/2011,4,0,0,0,0,0,0,4
Albania,07/08/2011,1,0,0,0,0,0,0,1
Albania,08/08/2011,14,0,1,0,19,1,0,35
Albania,09/08/2011,10,0,0,0,0,9,0,19
Albania,10/08/2011,15,0,0,0,6,6,0,27
Albania,11/08/2011,2,0,0,0,0,6,0,8
Albania,12/08/2011,11,0,0,0,0,0,0,11
Albania,13/08/2011,1,0,0,0,0,0,0,1
Albania,14/08/2011,0,0,-1,0,0,0,0,-1
Albania,15/08/2011,1,0,0,0,0,2,0,3
Albania,16/08/2011,1,0,0,0,9,4,0,14
Albania,17/08/2011,6,0,-2,0,10,0,0,14
Albania,18/08/2011,35,0,0,0,29,2,0,66
Albania,19/08/2011,3,0,-1,0,2,2,0,6
Albania,20/08/2011,6,0,0,0,0,6,0,12
Albania,21/08/2011,0,0,0,0,-2,0,0,-2
Albania,22/08/2011,3,0,0,0,3,2,0,8
Albania,23/08/2011,10,0,0,0,3,11,0,24
Albania,24/08/2011,8,0,0,0,0,4,0,12
Albania,25/08/2011,5,0,-2,0,0,7,0,10
Albania,26/08/2011,4,0,0,0,0,4,0,8
Albania,27/08/2011,8,0,0,0,-2,2,0,8
Albania,28/08/2011,0,0,0,0,6,0,0,6
Albania,29/08/2011,34,0,-5,0,0,9,0,38
Albania,30/08/2011,25,0,-1,0,4,6,0,34
Albania,31/08/2011,44,0,-1,0,6,0,0,49
Algeria,01/08/2011,8,0,1,0,3,1,0,13
Algeria,02/08/2011,2,0,0,0,0,0,0,2
Algeria,03/08/2011,3,0,0,0,0,0,0,3
Algeria,04/08/2011,9,0,-2,0,0,0,0,7
Algeria,05/08/2011,2,0,0,0,0,0,0,2
Algeria,06/08/2011,-1,0,0,0,0,0,0,-1
Algeria,07/08/2011,3,0,0,0,0,0,0,3
Algeria,08/08/2011,9,0,0,0,0,0,0,9
Algeria,09/08/2011,0,0,0,0,0,0,0,0
Algeria,10/08/2011,-2,0,0,0,3,2,0,3
Algeria,11/08/2011,4,0,0,0,4,0,0,8
Algeria,12/08/2011,2,0,0,0,-2,0,0,0
Algeria,13/08/2011,0,0,0,0,1,0,0,1
Algeria,14/08/2011,7,0,0,0,3,2,0,12
Algeria,15/08/2011,9,0,0,0,1,4,0,14
Algeria,16/08/2011,2,0,0,0,0,0,0,2
Algeria,17/08/2011,13,0,0,0,0,0,0,13
Algeria,18/08/2011,21,0,0,0,3,7,0,31
Algeria,19/08/2011,-1,0,0,0,0,0,0,-1
Algeria,20/08/2011,29,0,0,0,21,0,0,50
Algeria,21/08/2011,5,0,0,0,6,0,0,11
Algeria,22/08/2011,17,0,1,0,16,0,0,34
Algeria,23/08/2011,61,0,0,0,6,10,0,77
Algeria,24/08/2011,22,0,0,0,0,10,0,32
Algeria,25/08/2011,3,4,1,0,-2,6,0,12
Algeria,26/08/2011,64,0,0,0,-1,4,0,67
Algeria,27/08/2011,335,0,0,0,4,4,0,343
Algeria,28/08/2011,78,0,0,0,6,1,0,85
Algeria,29/08/2011,262,0,1,0,5,4,0,272
Algeria,30/08/2011,373,0,-2,0,33,24,0,428
Algeria,31/08/2011,73,0,-1,0,-2,14,0,84
Bangladesh,01/08/2011,24,0,0,0,-4,4,0,24
Bangladesh,02/08/2011,7,0,0,0,18,1,0,26
Bangladesh,03/08/2011,31,0,0,0,8,2,0,41
Bangladesh,04/08/2011,23,2,0,0,8,3,0,36
Bangladesh,05/08/2011,28,0,0,0,6,2,0,36
Bangladesh,06/08/2011,18,0,0,0,9,1,0,28
Bangladesh,07/08/2011,2,0,0,0,4,2,0,8
Bangladesh,08/08/2011,20,0,-4,0,20,1,0,37
Bangladesh,09/08/2011,24,0,-4,0,9,0,0,29
Bangladesh,10/08/2011,31,0,0,0,13,3,0,47
Bangladesh,11/08/2011,24,0,0,0,4,4,0,32
Bangladesh,12/08/2011,15,0,0,0,5,1,0,21
Bangladesh,13/08/2011,36,0,1,0,15,6,0,58
Bangladesh,14/08/2011,12,0,0,0,1,0,0,13
Bangladesh,15/08/2011,13,0,2,0,1,3,0,19
Bangladesh,16/08/2011,13,0,0,0,2,5,0,20
Bangladesh,17/08/2011,20,0,0,0,22,2,0,44
Bangladesh,18/08/2011,7,0,-2,0,15,5,0,25
Bangladesh,19/08/2011,14,0,0,0,10,6,0,30
Bangladesh,20/08/2011,13,0,0,0,3,0,0,16
Bangladesh,21/08/2011,10,0,0,0,3,2,0,15
Bangladesh,22/08/2011,38,0,-10,0,6,3,0,37
Bangladesh,23/08/2011,41,0,0,0,-3,3,0,41
Bangladesh,24/08/2011,29,0,-7,0,19,4,0,45
Bangladesh,25/08/2011,37,0,-1,0,5,2,0,43
Bangladesh,26/08/2011,99,0,0,0,13,5,0,117
Bangladesh,27/08/2011,-6,0,0,0,9,1,0,4
Bangladesh,28/08/2011,13,0,0,0,9,0,0,22
Bangladesh,29/08/2011,5,0,0,0,21,3,0,29
Bangladesh,30/08/2011,18,0,0,0,4,1,0,23
Bangladesh,31/08/2011,0,0,-6,0,3,6,0,3
Cameroon,01/08/2011,0,0,0,0,0,0,0,0
Cameroon,02/08/2011,0,0,0,0,0,0,0,0
Cameroon,03/08/2011,1,0,2,0,0,1,0,4
Cameroon,04/08/2011,-2,0,0,0,0,0,0,-2
Cameroon,05/08/2011,0,0,0,0,0,0,0,0
Cameroon,06/08/2011,0,0,0,0,0,0,0,0
Cameroon,09/08/2011,0,0,0,0,0,0,0,0
Cameroon,10/08/2011,0,0,0,0,6,0,0,6
Cameroon,11/08/2011,0,0,0,0,0,0,0,0
Cameroon,12/08/2011,1,0,0,0,0,0,0,1
Cameroon,13/08/2011,0,0,0,0,0,0,0,0
Cameroon,14/08/2011,0,0,0,0,0,0,0,0
Cameroon,15/08/2011,2,0,0,0,18,0,0,20
Cameroon,16/08/2011,2,0,0,0,0,0,0,2
Cameroon,17/08/2011,4,0,0,0,4,0,0,8
Cameroon,18/08/2011,0,0,0,0,6,0,0,6
Cameroon,19/08/2011,-2,0,0,0,0,0,0,-2
Cameroon,20/08/2011,-4,0,0,0,0,0,0,-4
Cameroon,21/08/2011,0,0,0,0,0,0,0,0
Cameroon,22/08/2011,-2,0,0,0,0,2,0,0
Cameroon,23/08/2011,-1,0,0,0,1,0,0,0
Cameroon,24/08/2011,5,0,0,0,12,0,0,17
Cameroon,25/08/2011,15,0,0,0,-6,0,0,9
Cameroon,26/08/2011,3,0,0,0,0,0,0,3
Cameroon,27/08/2011,0,0,0,0,0,0,0,0
Cameroon,28/08/2011,0,0,0,0,0,0,0,0
Cameroon,29/08/2011,-3,0,0,0,-12,0,0,-15
Cameroon,30/08/2011,6,0,-2,0,0,0,0,4
Cameroon,31/08/2011,0,0,0,0,0,0,0,0
China,01/08/2011,292,0,2,0,62,18,0,374
China,02/08/2011,234,0,-6,0,72,13,0,313
China,03/08/2011,191,0,3,0,78,10,0,282
China,04/08/2011,208,0,2,0,104,16,0,330
China,05/08/2011,148,0,2,0,34,52,0,236
China,06/08/2011,79,4,0,0,28,10,0,121
China,07/08/2011,80,6,0,0,13,22,0,121
China,08/08/2011,151,2,-17,0,42,20,0,198
China,09/08/2011,173,0,0,0,33,37,0,243
China,10/08/2011,163,4,-2,0,33,11,0,209
China,11/08/2011,110,0,2,0,62,14,0,188
China,12/08/2011,144,0,1,0,81,33,0,259
China,13/08/2011,93,2,2,0,10,13,0,120
China,14/08/2011,100,2,0,0,78,6,0,186
China,15/08/2011,123,2,0,0,61,15,0,201
China,16/08/2011,198,6,-8,0,44,17,0,257
China,17/08/2011,163,2,-6,0,20,14,0,193
China,18/08/2011,143,4,-1,0,54,23,0,223
China,19/08/2011,156,0,-5,0,41,24,0,216
China,20/08/2011,78,2,-2,0,51,9,0,138
China,21/08/2011,75,0,0,0,14,5,0,94
China,22/08/2011,137,0,-3,0,62,37,0,233
China,23/08/2011,170,2,-10,0,115,15,0,292
China,24/08/2011,120,6,-17,0,38,17,0,164
China,25/08/2011,136,0,-1,0,92,15,0,242
China,26/08/2011,133,0,-2,0,52,13,0,196
China,27/08/2011,56,2,-4,0,23,4,0,81
China,28/08/2011,82,2,-2,0,18,32,0,132
China,29/08/2011,120,2,-8,0,59,19,0,192
China,30/08/2011,125,0,-5,0,73,15,0,208
China,31/08/2011,92,0,1,0,53,19,0,165
Egypt,01/08/2011,98,0,-3,0,42,18,0,155
Egypt,02/08/2011,46,0,-1,0,45,10,0,100
Egypt,03/08/2011,95,0,-2,0,56,9,0,158
Egypt,04/08/2011,599,14,-35,0,238,79,0,895
Egypt,05/08/2011,353,8,-7,0,160,46,0,560
Egypt,06/08/2011,16,0,-2,0,13,14,0,41
Egypt,07/08/2011,47,2,2,0,51,17,0,119
Egypt,08/08/2011,25,0,0,0,40,12,0,77
Egypt,09/08/2011,64,0,-2,0,21,18,0,101
Egypt,10/08/2011,57,0,0,0,20,7,0,84
Egypt,11/08/2011,95,0,-1,0,51,10,0,155
Egypt,12/08/2011,81,2,-10,0,23,11,0,107
Egypt,13/08/2011,27,0,5,0,1,2,0,35
Egypt,14/08/2011,77,0,4,0,80,15,0,176
Egypt,15/08/2011,186,0,0,0,72,15,0,273
Egypt,16/08/2011,39,0,2,0,15,14,0,70
Egypt,17/08/2011,141,0,-14,0,68,14,0,209
Egypt,18/08/2011,560,0,-3,0,103,67,0,727
Egypt,19/08/2011,371,0,6,0,47,71,0,495
Egypt,20/08/2011,327,0,7,0,2,30,0,366
Egypt,21/08/2011,141,2,0,0,16,17,0,176
Egypt,22/08/2011,211,4,-14,0,21,28,0,250
Egypt,23/08/2011,81,0,-6,0,39,22,0,136
Egypt,24/08/2011,195,0,4,0,33,14,0,246
Egypt,25/08/2011,116,2,-1,0,30,11,0,158
Egypt,26/08/2011,120,0,-3,0,29,16,0,162
Egypt,27/08/2011,122,0,0,0,21,6,0,149
Egypt,28/08/2011,110,0,-8,0,46,13,0,161
Egypt,29/08/2011,155,0,-1,0,67,11,0,232
Egypt,30/08/2011,137,0,-4,0,40,12,0,185
Egypt,31/08/2011,71,0,1,0,36,12,0,120
Eritrea,01/08/2011,8,4,0,0,0,0,0,12
Eritrea,02/08/2011,10,2,0,0,0,0,0,12
Eritrea,03/08/2011,0,0,0,0,0,0,0,0
Eritrea,04/08/2011,10,0,0,0,-3,0,0,7
Eritrea,05/08/2011,5,0,0,0,0,0,0,5
Eritrea,07/08/2011,11,0,0,0,0,0,0,11
Eritrea,08/08/2011,-1,0,0,0,0,0,0,-1
Eritrea,09/08/2011,1,0,0,0,3,0,0,4
Eritrea,10/08/2011,7,0,0,0,6,0,0,13
Eritrea,11/08/2011,2,0,0,0,-1,0,0,1
Eritrea,12/08/2011,3,0,0,0,21,0,0,24
Eritrea,13/08/2011,0,0,-1,0,12,0,0,11
Eritrea,14/08/2011,0,0,-1,0,0,0,0,-1
Eritrea,15/08/2011,9,0,0,0,3,0,0,12
Eritrea,16/08/2011,2,0,0,0,-4,0,0,-2
Eritrea,17/08/2011,4,0,0,0,-4,0,0,0
Eritrea,18/08/2011,-1,0,0,0,-2,0,0,-3
Eritrea,19/08/2011,4,0,0,0,0,0,0,4
Eritrea,20/08/2011,3,0,0,0,0,0,0,3
Eritrea,21/08/2011,5,0,0,0,0,0,0,5
Eritrea,22/08/2011,9,0,0,0,6,0,0,15
Eritrea,23/08/2011,3,6,0,0,10,0,0,19
Eritrea,24/08/2011,33,0,0,0,0,0,0,33
Eritrea,25/08/2011,2,0,0,0,0,0,0,2
Eritrea,26/08/2011,0,0,0,0,9,0,0,9
Eritrea,27/08/2011,2,0,0,0,1,0,0,3
Eritrea,28/08/2011,0,0,0,0,0,0,0,0
Eritrea,29/08/2011,0,0,0,0,0,0,0,0
Eritrea,30/08/2011,2,0,0,0,0,0,0,2
Eritrea,31/08/2011,0,0,0,0,0,0,0,0
Georgia,01/08/2011,61,0,1,0,33,6,0,101
Georgia,02/08/2011,12,0,0,0,19,2,0,33
Georgia,03/08/2011,70,2,0,0,12,5,0,89
Georgia,04/08/2011,55,0,-2,0,17,2,0,72
Georgia,05/08/2011,59,2,0,0,21,2,0,84
Georgia,06/08/2011,23,0,0,0,12,0,0,35
Georgia,07/08/2011,26,0,0,0,0,4,0,30
Georgia,08/08/2011,38,0,-2,0,15,3,0,54
Georgia,09/08/2011,87,0,-4,0,2,10,0,95
Georgia,10/08/2011,18,0,0,0,-4,2,0,16
Georgia,11/08/2011,54,2,1,0,28,12,0,97
Georgia,12/08/2011,54,0,-6,0,8,16,0,72
Georgia,13/08/2011,23,0,0,0,7,3,0,33
Georgia,14/08/2011,10,2,0,0,1,1,0,14
Georgia,15/08/2011,53,0,0,0,13,8,0,74
Georgia,16/08/2011,10,0,2,0,12,0,0,24
Georgia,17/08/2011,37,2,0,0,34,10,0,83
Georgia,18/08/2011,56,0,0,0,31,23,0,110
Georgia,19/08/2011,49,2,-2,0,35,10,0,94
Georgia,20/08/2011,23,2,-5,0,13,0,0,33
Georgia,21/08/2011,11,0,0,0,15,1,0,27
Georgia,22/08/2011,43,0,2,0,33,2,0,80
Georgia,23/08/2011,28,0,-2,0,34,10,0,70
Georgia,24/08/2011,43,4,2,0,19,2,0,70
Georgia,25/08/2011,33,4,0,0,43,2,0,82
Georgia,26/08/2011,31,0,0,0,15,5,0,51
Georgia,27/08/2011,35,2,1,0,21,0,0,59
Georgia,28/08/2011,17,0,1,0,9,-2,0,25
Georgia,29/08/2011,37,0,-6,0,20,0,0,51
Georgia,30/08/2011,0,0,0,0,13,0,0,13
Georgia,31/08/2011,23,0,0,0,6,4,0,33
India,01/08/2011,97,0,-1,0,20,18,0,134
India,02/08/2011,87,0,0,0,25,13,0,125
India,03/08/2011,70,0,-4,0,13,15,0,94
India,04/08/2011,91,0,0,0,16,3,0,110
India,05/08/2011,37,0,-2,0,8,4,0,47
India,06/08/2011,40,0,1,0,7,12,0,60
India,07/08/2011,48,0,-2,0,12,3,0,61
India,08/08/2011,72,0,-7,0,10,2,0,77
India,09/08/2011,96,0,7,0,2,13,0,118
India,10/08/2011,130,2,2,0,24,6,0,164
India,11/08/2011,68,2,0,0,19,5,0,94
India,12/08/2011,70,0,-4,0,26,10,0,102
India,13/08/2011,41,0,1,0,6,5,0,53
India,14/08/2011,38,0,1,0,4,10,0,53
India,15/08/2011,66,0,-14,0,20,4,0,76
India,16/08/2011,64,0,-2,0,-4,22,0,80
India,17/08/2011,248,4,2,0,129,145,0,528
India,18/08/2011,57,0,-3,0,4,16,0,74
India,19/08/2011,50,4,-3,0,14,18,0,83
India,20/08/2011,65,0,0,0,23,18,0,106
India,21/08/2011,40,0,-4,0,6,18,0,60
India,22/08/2011,53,0,-7,0,16,14,0,76
India,23/08/2011,60,6,-3,0,-8,20,0,75
India,24/08/2011,76,0,2,0,16,20,0,114
India,25/08/2011,54,0,-2,0,2,11,0,65
India,26/08/2011,70,2,-1,0,23,16,0,110
India,27/08/2011,57,0,-4,0,4,7,0,64
India,28/08/2011,40,0,-2,0,28,13,0,79
India,29/08/2011,52,0,-3,0,8,11,0,68
India,30/08/2011,67,2,1,0,16,7,0,93
India,31/08/2011,42,0,1,0,12,20,0,75
Iran,01/08/2011,45,2,1,0,34,7,0,89
Iran,02/08/2011,67,0,3,0,27,8,0,105
Iran,03/08/2011,88,4,-2,0,11,8,0,109
Iran,04/08/2011,62,0,0,0,2,12,0,76
Iran,05/08/2011,57,0,0,0,15,4,0,76
Iran,06/08/2011,31,0,-2,0,-16,4,0,17
Iran,07/08/2011,59,0,0,0,5,12,0,76
Iran,08/08/2011,64,0,0,0,12,9,0,85
Iran,09/08/2011,58,4,-1,0,40,12,0,113
Iran,10/08/2011,71,2,0,0,57,9,0,139
Iran,11/08/2011,75,0,0,0,93,18,0,186
Iran,12/08/2011,50,0,0,0,26,11,0,87
Iran,13/08/2011,29,0,0,0,33,14,0,76
Iran,14/08/2011,47,0,0,0,30,5,0,82
Iran,15/08/2011,73,2,0,0,57,4,0,136
Iran,16/08/2011,59,2,2,0,31,3,0,97
Iran,17/08/2011,66,0,1,0,56,2,0,125
Iran,18/08/2011,42,0,0,0,50,5,0,97
Iran,19/08/2011,40,0,2,0,13,8,0,63
Iran,20/08/2011,91,0,0,0,186,8,0,285
Iran,21/08/2011,91,0,2,0,57,8,0,158
Iran,22/08/2011,48,0,0,0,68,4,0,120
Iran,23/08/2011,49,0,-3,0,16,7,0,69
Iran,24/08/2011,68,0,-1,0,41,16,0,124
Iran,25/08/2011,67,0,0,0,64,17,0,148
Iran,26/08/2011,25,6,-1,0,3,8,0,41
Iran,27/08/2011,42,0,-3,0,35,9,0,83
Iran,28/08/2011,108,0,-4,0,60,7,0,171
Iran,29/08/2011,77,0,-2,0,8,9,0,92
Iran,30/08/2011,75,0,1,0,29,4,0,109
Iran,31/08/2011,100,0,1,0,10,4,0,115
Iraq,01/08/2011,90,2,1,0,39,13,0,145
Iraq,02/08/2011,217,2,0,0,96,17,0,332
Iraq,03/08/2011,89,0,0,0,38,5,0,132
Iraq,04/08/2011,77,0,0,0,30,10,0,117
Iraq,05/08/2011,74,0,0,0,53,3,0,130
Iraq,06/08/2011,81,0,0,0,-25,17,0,73
Iraq,07/08/2011,136,0,-4,0,17,19,0,168
Iraq,08/08/2011,140,2,-4,0,24,18,0,180
Iraq,09/08/2011,141,2,8,0,86,15,0,252
Iraq,10/08/2011,173,0,-2,0,37,15,0,223
Iraq,11/08/2011,158,2,0,0,26,14,0,200
Iraq,12/08/2011,129,0,-2,0,19,7,0,153
Iraq,13/08/2011,21,0,0,0,11,2,0,34
Iraq,14/08/2011,48,2,0,0,12,16,0,78
Iraq,15/08/2011,188,0,0,0,44,15,0,247
Iraq,16/08/2011,86,0,0,0,59,9,0,154
Iraq,17/08/2011,152,0,0,0,54,19,0,225
Iraq,18/08/2011,302,2,-8,0,36,27,0,359
Iraq,19/08/2011,247,0,0,0,39,19,0,305
Iraq,20/08/2011,171,0,2,0,127,15,0,315
Iraq,21/08/2011,327,0,1,0,43,18,0,389
Iraq,22/08/2011,123,0,-3,0,60,9,0,189
Iraq,23/08/2011,263,16,-4,0,60,21,0,356
Iraq,24/08/2011,202,2,0,0,45,21,0,270
Iraq,25/08/2011,172,2,1,0,67,19,0,261
Iraq,26/08/2011,198,0,-2,0,13,22,0,231
Iraq,27/08/2011,58,2,0,0,18,1,0,79
Iraq,28/08/2011,170,0,0,0,82,17,0,269
Iraq,29/08/2011,276,10,-2,0,32,32,0,348
Iraq,30/08/2011,248,6,-6,0,9,32,0,289
Iraq,31/08/2011,112,4,0,0,58,17,0,191
Morocco,01/08/2011,13,0,0,0,0,1,0,14
Morocco,02/08/2011,12,2,-4,0,29,5,0,44
Morocco,03/08/2011,10,0,0,0,27,0,0,37
Morocco,04/08/2011,-10,0,1,0,0,4,0,-5
Morocco,05/08/2011,8,0,-1,0,9,10,0,26
Morocco,06/08/2011,6,0,0,0,0,0,0,6
Morocco,07/08/2011,0,0,0,0,3,0,0,3
Morocco,08/08/2011,2,0,0,0,3,0,0,5
Morocco,09/08/2011,0,0,0,0,0,1,0,1
Morocco,10/08/2011,4,0,0,0,-2,0,0,2
Morocco,11/08/2011,8,6,0,0,0,0,0,14
Morocco,12/08/2011,4,0,-1,0,0,0,0,3
Morocco,13/08/2011,0,0,0,0,0,2,0,2
Morocco,14/08/2011,1,0,2,0,0,2,0,5
Morocco,15/08/2011,12,0,-3,0,0,0,0,9
Morocco,16/08/2011,1,0,-5,0,-7,5,0,-6
Morocco,17/08/2011,6,0,-2,0,24,1,0,29
Morocco,18/08/2011,4,0,0,0,0,0,0,4
Morocco,19/08/2011,-5,0,0,0,4,0,0,-1
Morocco,20/08/2011,16,0,3,0,15,0,0,34
Morocco,21/08/2011,6,0,1,0,18,0,0,25
Morocco,22/08/2011,2,0,0,0,-5,2,0,-1
Morocco,23/08/2011,14,0,0,0,6,2,0,22
Morocco,24/08/2011,10,0,0,0,11,0,0,21
Morocco,25/08/2011,5,0,0,0,0,0,0,5
Morocco,26/08/2011,2,0,0,0,2,0,0,4
Morocco,27/08/2011,3,0,0,0,0,0,0,3
Morocco,28/08/2011,12,0,0,0,0,0,0,12
Morocco,29/08/2011,6,0,0,0,5,3,0,14
Morocco,30/08/2011,8,0,0,0,6,0,0,14
Morocco,31/08/2011,9,0,0,0,-8,0,0,1
Nigeria,01/08/2011,26,0,0,0,25,4,0,55
Nigeria,02/08/2011,35,0,0,0,4,2,0,41
Nigeria,03/08/2011,19,0,0,0,10,0,0,29
Nigeria,04/08/2011,34,0,0,0,36,1,0,71
Nigeria,05/08/2011,29,0,0,0,30,1,0,60
Nigeria,06/08/2011,9,0,0,0,0,0,0,9
Nigeria,07/08/2011,21,0,0,0,11,1,0,33
Nigeria,08/08/2011,36,0,0,0,15,3,0,54
Nigeria,09/08/2011,43,0,0,0,9,7,0,59
Nigeria,10/08/2011,26,0,0,0,6,1,0,33
Nigeria,11/08/2011,53,0,1,0,39,3,0,96
Nigeria,12/08/2011,48,0,0,0,16,1,0,65
Nigeria,13/08/2011,31,0,-6,0,10,1,0,36
Nigeria,14/08/2011,34,0,0,0,13,1,0,48
Nigeria,15/08/2011,26,0,0,0,4,0,0,30
Nigeria,16/08/2011,53,2,0,0,47,2,0,104
Nigeria,17/08/2011,22,0,0,0,33,3,0,58
Nigeria,18/08/2011,17,0,0,0,13,2,0,32
Nigeria,19/08/2011,13,0,-5,0,8,2,0,18
Nigeria,20/08/2011,21,0,-6,0,0,3,0,18
Nigeria,21/08/2011,42,2,0,0,0,5,0,49
Nigeria,22/08/2011,23,0,0,0,3,2,0,28
Nigeria,23/08/2011,68,0,-2,0,-2,4,0,68
Nigeria,24/08/2011,31,0,0,0,2,2,0,35
Nigeria,25/08/2011,21,0,2,0,9,2,0,34
Nigeria,26/08/2011,27,0,0,0,39,4,0,70
Nigeria,27/08/2011,23,0,0,0,0,7,0,30
Nigeria,28/08/2011,59,0,0,0,49,16,0,124
Nigeria,29/08/2011,90,0,0,0,-1,3,0,92
Nigeria,30/08/2011,71,2,0,0,9,2,0,84
Nigeria,31/08/2011,34,0,0,0,4,11,0,49
Pakistan,01/08/2011,101,4,0,0,43,5,0,153
Pakistan,02/08/2011,128,0,0,0,24,24,0,176
Pakistan,03/08/2011,67,2,2,0,31,10,0,112
Pakistan,04/08/2011,69,0,-2,0,3,11,0,81
Pakistan,05/08/2011,82,0,0,0,32,9,0,123
Pakistan,06/08/2011,142,0,0,0,18,4,0,164
Pakistan,07/08/2011,188,2,-4,0,3,7,0,196
Pakistan,08/08/2011,192,0,0,0,3,10,0,205
Pakistan,09/08/2011,104,0,-2,0,38,13,0,153
Pakistan,10/08/2011,149,0,0,0,45,28,0,222
Pakistan,11/08/2011,248,0,1,0,78,11,0,338
Pakistan,12/08/2011,125,2,-2,0,56,12,0,193
Pakistan,13/08/2011,104,0,0,0,52,14,0,170
Pakistan,14/08/2011,95,0,3,0,30,11,0,139
Pakistan,15/08/2011,127,8,1,0,83,18,0,237
Pakistan,16/08/2011,82,2,-1,0,52,6,0,141
Pakistan,17/08/2011,52,0,0,0,62,8,0,122
Pakistan,18/08/2011,111,0,1,0,46,46,0,204
Pakistan,19/08/2011,172,0,-2,0,44,20,0,234
Pakistan,20/08/2011,145,0,-1,0,24,21,0,189
Pakistan,21/08/2011,54,0,-2,0,8,4,0,64
Pakistan,22/08/2011,61,2,-2,0,24,7,0,92
Pakistan,23/08/2011,63,0,-3,0,3,11,0,74
Pakistan,24/08/2011,61,0,2,0,10,8,0,81
Pakistan,25/08/2011,49,0,-2,0,31,10,0,88
Pakistan,26/08/2011,56,0,0,0,32,12,0,100
Pakistan,27/08/2011,193,2,-2,0,11,13,0,217
Pakistan,28/08/2011,118,0,0,0,9,18,0,145
Pakistan,29/08/2011,68,0,-2,0,11,16,0,93
Pakistan,30/08/2011,86,0,0,0,37,16,0,139
Pakistan,31/08/2011,116,0,0,0,17,79,0,212
Sierra Leone,01/08/2011,3,0,-4,0,0,1,0,0
Sierra Leone,02/08/2011,6,0,0,0,0,0,0,6
Sierra Leone,03/08/2011,2,0,0,0,3,0,0,5
Sierra Leone,04/08/2011,-2,0,1,0,1,3,0,3
Sierra Leone,05/08/2011,36,0,0,0,6,2,0,44
Sierra Leone,06/08/2011,9,0,0,0,0,0,0,9
Sierra Leone,07/08/2011,-1,0,0,0,3,0,0,2
Sierra Leone,08/08/2011,3,0,0,0,0,1,0,4
Sierra Leone,09/08/2011,9,0,0,0,0,0,0,9
Sierra Leone,10/08/2011,9,0,0,0,0,0,0,9
Sierra Leone,11/08/2011,3,0,0,0,0,2,0,5
Sierra Leone,12/08/2011,4,0,0,0,0,0,0,4
Sierra Leone,13/08/2011,0,0,1,0,0,0,0,1
Sierra Leone,14/08/2011,6,0,0,0,1,0,0,7
Sierra Leone,15/08/2011,2,0,0,0,0,0,0,2
Sierra Leone,16/08/2011,0,0,0,0,3,1,0,4
Sierra Leone,17/08/2011,0,0,0,0,6,0,0,6
Sierra Leone,18/08/2011,0,0,0,0,0,0,0,0
Sierra Leone,19/08/2011,1,0,0,0,3,0,0,4
Sierra Leone,20/08/2011,1,0,0,0,0,0,0,1
Sierra Leone,21/08/2011,0,0,0,0,0,0,0,0
Sierra Leone,22/08/2011,7,0,1,0,0,2,0,10
Sierra Leone,23/08/2011,2,0,0,0,-2,3,0,3
Sierra Leone,24/08/2011,0,0,0,0,4,8,0,12
Sierra Leone,25/08/2011,23,0,0,0,0,8,0,31
Sierra Leone,26/08/2011,-1,0,-2,0,0,1,0,-2
Sierra Leone,27/08/2011,3,0,0,0,-4,0,0,-1
Sierra Leone,28/08/2011,4,0,0,0,0,0,0,4
Sierra Leone,29/08/2011,3,0,0,0,0,0,0,3
Sierra Leone,30/08/2011,4,0,0,0,0,0,0,4
Sierra Leone,31/08/2011,2,0,0,0,0,3,0,5
Somalia,01/08/2011,84,8,0,0,4,9,0,105
Somalia,02/08/2011,90,6,0,0,52,5,0,153
Somalia,03/08/2011,99,6,0,0,6,4,0,115
Somalia,04/08/2011,57,12,1,0,25,1,0,96
Somalia,05/08/2011,83,14,2,0,44,6,0,149
Somalia,06/08/2011,2,6,0,0,2,1,0,11
Somalia,07/08/2011,25,6,0,0,-1,0,0,30
Somalia,08/08/2011,57,10,0,0,2,2,0,71
Somalia,09/08/2011,84,6,-5,0,1,0,0,86
Somalia,10/08/2011,73,4,0,0,30,12,0,119
Somalia,11/08/2011,110,12,0,0,26,12,0,160
Somalia,12/08/2011,231,10,1,0,232,33,0,507
Somalia,13/08/2011,48,4,0,0,43,8,0,103
Somalia,14/08/2011,29,6,0,0,-15,7,0,27
Somalia,15/08/2011,52,2,1,0,46,7,0,108
Somalia,16/08/2011,72,0,4,0,10,5,0,91
Somalia,17/08/2011,47,14,3,0,14,13,0,91
Somalia,18/08/2011,60,14,1,0,39,15,0,129
Somalia,19/08/2011,73,2,0,0,23,4,0,102
Somalia,20/08/2011,38,2,0,0,-5,7,0,42
Somalia,21/08/2011,20,2,0,0,-3,0,0,19
Somalia,22/08/2011,33,10,4,0,63,0,0,110
Somalia,23/08/2011,28,4,2,0,27,1,0,62
Somalia,24/08/2011,17,0,0,0,-13,0,0,4
Somalia,25/08/2011,36,2,1,0,25,2,0,66
Somalia,26/08/2011,63,4,1,0,-14,24,0,78
Somalia,27/08/2011,61,0,0,0,-3,0,0,58
Somalia,28/08/2011,29,0,0,0,-4,0,0,25
Somalia,29/08/2011,8,0,0,0,14,0,0,22
Somalia,30/08/2011,20,12,0,0,7,-2,0,37
Somalia,31/08/2011,21,2,0,0,3,1,0,27
Syria,01/08/2011,377,2,-3,0,43,105,0,524
Syria,02/08/2011,197,0,-2,0,47,76,0,318
Syria,03/08/2011,335,0,-19,0,68,87,0,471
Syria,04/08/2011,347,0,-17,0,65,65,0,460
Syria,05/08/2011,468,0,-11,0,147,88,0,692
Syria,06/08/2011,575,4,-3,0,53,122,0,751
Syria,07/08/2011,340,2,0,0,-19,51,0,374
Syria,08/08/2011,257,8,-3,0,27,39,0,328
Syria,09/08/2011,238,0,-13,0,30,29,0,284
Syria,10/08/2011,224,0,-9,0,68,49,0,332
Syria,11/08/2011,222,0,-13,0,86,62,0,357
Syria,12/08/2011,165,0,-12,0,31,39,0,223
Syria,13/08/2011,147,4,-5,0,18,33,0,197
Syria,14/08/2011,224,0,-6,0,6,72,0,296
Syria,15/08/2011,278,0,-1,0,22,89,0,388
Syria,16/08/2011,238,0,-16,0,29,77,0,328
Syria,17/08/2011,246,0,-10,0,50,63,0,349
Syria,18/08/2011,362,0,-167,0,150,95,0,440
Syria,19/08/2011,239,0,-44,0,54,54,0,303
Syria,20/08/2011,86,0,-14,0,39,17,0,128
Syria,21/08/2011,111,0,-56,0,16,26,0,97
Syria,22/08/2011,166,2,-43,0,41,15,0,181
Syria,23/08/2011,249,0,-14,0,61,30,0,326
Syria,24/08/2011,187,0,-2,0,45,14,0,244
Syria,25/08/2011,109,0,-14,0,36,15,0,146
Syria,26/08/2011,127,0,-13,0,98,16,0,228
Syria,27/08/2011,85,0,2,0,16,17,0,120
Syria,28/08/2011,100,0,-5,0,26,7,0,128
Syria,29/08/2011,85,0,-10,0,20,11,0,106
Syria,30/08/2011,108,0,-4,0,17,17,0,138
Syria,31/08/2011,134,0,0,0,59,43,0,236
Yemen,01/08/2011,8,0,0,0,12,0,0,20
Yemen,02/08/2011,1,0,-2,0,-2,1,0,-2
Yemen,03/08/2011,22,0,3,0,-6,2,0,21
Yemen,04/08/2011,39,0,0,0,6,0,0,45
Yemen,05/08/2011,18,0,-2,0,3,2,0,21
Yemen,06/08/2011,23,0,0,0,4,4,0,31
Yemen,07/08/2011,38,0,0,0,0,0,0,38
Yemen,08/08/2011,32,0,0,0,-5,0,0,27
Yemen,09/08/2011,67,0,-3,0,-3,5,0,66
Yemen,10/08/2011,57,0,-10,0,1,4,0,52
Yemen,11/08/2011,19,0,-2,0,3,7,0,27
Yemen,12/08/2011,19,0,-3,0,6,6,0,28
Yemen,13/08/2011,23,0,-1,0,0,4,0,26
Yemen,14/08/2011,14,0,0,0,3,3,0,20
Yemen,15/08/2011,30,0,0,0,9,1,0,40
Yemen,16/08/2011,26,0,0,0,2,0,0,28
Yemen,17/08/2011,12,0,-4,0,3,1,0,12
Yemen,18/08/2011,25,0,-6,0,6,8,0,33
Yemen,19/08/2011,15,0,0,0,6,0,0,21
Yemen,20/08/2011,14,0,0,0,0,2,0,16
Yemen,21/08/2011,25,0,0,0,9,5,0,39
Yemen,22/08/2011,19,0,-6,0,0,11,0,24
Yemen,23/08/2011,37,0,-1,0,0,5,0,41
Yemen,24/08/2011,66,0,-6,0,3,2,0,65
Yemen,25/08/2011,22,0,-6,0,6,5,0,27
Yemen,26/08/2011,16,0,0,0,-20,6,0,2
Yemen,27/08/2011,16,0,-2,0,-8,5,0,11
Yemen,28/08/2011,9,0,0,0,0,1,0,10
Yemen,29/08/2011,27,0,1,0,0,3,0,31
Yemen,30/08/2011,5,0,0,0,4,1,0,10
Yemen,31/08/2011,29,0,0,0,0,2,0,31
Afghanistan,01/06/2006,31,0,0,0,-1,8,0,38
Afghanistan,02/06/2006,38,0,0,0,24,0,0,62
Afghanistan,03/06/2006,25,0,0,0,14,0,0,39
Afghanistan,04/06/2006,32,0,0,0,15,5,0,52
Afghanistan,05/06/2006,37,0,0,0,5,2,0,44
Afghanistan,06/06/2006,57,0,-3,0,5,4,0,63
Afghanistan,07/06/2006,28,0,0,0,28,3,0,59
Afghanistan,08/06/2006,57,6,0,0,5,2,0,70
Afghanistan,09/06/2006,69,2,0,0,-2,0,0,69
Afghanistan,10/06/2006,20,0,0,0,0,0,0,20
Afghanistan,11/06/2006,71,0,-4,0,34,0,0,101
Afghanistan,12/06/2006,57,2,0,0,21,1,0,81
Afghanistan,13/06/2006,29,0,1,0,3,2,0,35
Afghanistan,14/06/2006,52,0,1,0,47,1,0,101
Afghanistan,15/06/2006,69,2,1,0,11,15,0,98
Afghanistan,16/06/2006,41,0,0,0,33,6,0,80
Afghanistan,17/06/2006,21,0,0,0,3,0,0,24
Afghanistan,18/06/2006,42,0,0,0,15,2,0,59
Afghanistan,19/06/2006,32,0,0,0,12,1,0,45
Afghanistan,20/06/2006,41,0,0,0,16,3,0,60
Afghanistan,21/06/2006,29,0,0,0,-29,9,0,9
Afghanistan,22/06/2006,36,0,1,0,-19,2,0,20
Afghanistan,23/06/2006,41,0,0,0,15,0,0,56
Afghanistan,24/06/2006,11,0,0,0,11,0,0,22
Afghanistan,25/06/2006,82,0,0,0,-2,5,0,85
Afghanistan,26/06/2006,42,0,0,0,-3,2,0,41
Afghanistan,27/06/2006,45,0,2,0,7,1,0,55
Afghanistan,28/06/2006,37,0,1,0,7,5,0,50
Afghanistan,29/06/2006,45,0,1,0,25,2,0,73
Afghanistan,30/06/2006,2,0,0,0,39,4,0,45
Albania,01/06/2006,3,2,-1,0,0,0,0,4
Albania,02/06/2006,4,0,0,0,0,0,0,4
Albania,03/06/2006,2,0,0,0,-2,0,0,0
Albania,04/06/2006,11,0,0,0,10,0,0,21
Albania,05/06/2006,9,0,2,0,4,0,0,15
Albania,06/06/2006,21,0,0,0,0,0,0,21
Albania,07/06/2006,8,0,0,0,-2,0,0,6
Albania,08/06/2006,2,0,0,0,6,2,0,10
Albania,09/06/2006,20,0,0,0,4,5,0,29
Albania,10/06/2006,3,0,0,0,0,0,0,3
Albania,11/06/2006,0,0,0,0,0,0,0,0
Albania,12/06/2006,-1,0,0,0,2,0,0,1
Albania,13/06/2006,5,0,1,0,0,4,0,10
Albania,14/06/2006,0,0,0,0,0,0,0,0
Albania,15/06/2006,2,2,-1,0,-2,7,0,8
Albania,16/06/2006,1,0,-1,0,9,0,0,9
Albania,17/06/2006,-1,0,0,0,0,0,0,-1
Albania,18/06/2006,0,0,0,0,0,0,0,0
Albania,19/06/2006,3,0,0,0,3,1,0,7
Albania,20/06/2006,7,0,0,0,0,2,0,9
Albania,21/06/2006,2,0,0,0,-1,1,0,2
Albania,22/06/2006,2,0,0,0,0,0,0,2
Albania,23/06/2006,7,0,0,0,3,0,0,10
Albania,24/06/2006,-2,0,0,0,6,0,0,4
Albania,25/06/2006,0,0,0,0,12,0,0,12
Albania,26/06/2006,6,0,0,0,0,0,0,6
Albania,27/06/2006,8,0,0,0,0,1,0,9
Albania,28/06/2006,30,0,0,0,15,4,0,49
Albania,29/06/2006,3,0,-2,0,0,0,0,1
Albania,30/06/2006,1,0,0,0,0,0,0,1
Algeria,01/06/2006,0,0,0,0,0,1,0,1
Algeria,02/06/2006,0,0,0,0,6,0,0,6
Algeria,03/06/2006,0,0,0,0,6,2,0,8
Algeria,04/06/2006,0,0,0,0,0,0,0,0
Algeria,05/06/2006,0,0,0,0,0,0,0,0
Algeria,06/06/2006,1,0,-2,0,3,0,0,2
Algeria,07/06/2006,-5,0,0,0,0,0,0,-5
Algeria,08/06/2006,6,0,0,0,9,0,0,15
Algeria,09/06/2006,1,0,0,0,0,0,0,1
Algeria,10/06/2006,0,0,0,0,-2,0,0,-2
Algeria,11/06/2006,0,0,0,0,0,0,0,0
Algeria,12/06/2006,8,0,0,0,0,0,0,8
Algeria,13/06/2006,0,0,0,0,3,0,0,3
Algeria,14/06/2006,-7,0,0,0,5,0,0,-2
Algeria,15/06/2006,3,0,0,0,3,0,0,6
Algeria,16/06/2006,0,0,0,0,0,0,0,0
Algeria,17/06/2006,9,0,0,0,6,0,0,15
Algeria,18/06/2006,6,0,0,0,0,0,0,6
Algeria,19/06/2006,4,0,0,0,12,0,0,16
Algeria,20/06/2006,0,0,0,0,4,0,0,4
Algeria,21/06/2006,-3,0,0,0,0,0,0,-3
Algeria,22/06/2006,2,0,0,0,15,1,0,18
Algeria,23/06/2006,-1,0,0,0,0,0,0,-1
Algeria,24/06/2006,0,0,0,0,12,0,0,12
Algeria,25/06/2006,0,0,0,0,3,0,0,3
Algeria,26/06/2006,-3,0,0,0,3,0,0,0
Algeria,27/06/2006,0,0,0,0,6,0,0,6
Algeria,28/06/2006,0,0,0,0,6,0,0,6
Algeria,29/06/2006,0,0,0,0,0,0,0,0
Algeria,30/06/2006,0,0,0,0,3,0,0,3
Bangladesh,01/06/2006,-2,0,-4,0,0,0,0,-6
Bangladesh,02/06/2006,0,0,0,0,0,0,0,0
Bangladesh,03/06/2006,18,0,0,0,12,0,0,30
Bangladesh,04/06/2006,11,0,0,0,-6,0,0,5
Bangladesh,05/06/2006,8,0,0,0,-2,0,0,6
Bangladesh,06/06/2006,-4,0,-1,0,0,0,0,-5
Bangladesh,07/06/2006,-1,0,0,0,0,0,0,-1
Bangladesh,08/06/2006,1,0,0,0,3,0,0,4
Bangladesh,09/06/2006,7,0,0,0,0,1,0,8
Bangladesh,10/06/2006,0,0,0,0,0,0,0,0
Bangladesh,11/06/2006,4,0,0,0,0,0,0,4
Bangladesh,13/06/2006,2,2,0,0,1,0,0,5
Bangladesh,14/06/2006,4,0,1,0,3,0,0,8
Bangladesh,15/06/2006,0,0,0,0,0,0,0,0
Bangladesh,16/06/2006,0,0,0,0,6,0,0,6
Bangladesh,17/06/2006,1,0,0,0,0,2,0,3
Bangladesh,18/06/2006,4,0,0,0,0,0,0,4
Bangladesh,19/06/2006,7,0,0,0,-2,0,0,5
Bangladesh,20/06/2006,4,0,0,0,3,0,0,7
Bangladesh,21/06/2006,-5,0,0,0,0,22,0,17
Bangladesh,22/06/2006,2,0,0,0,0,0,0,2
Bangladesh,23/06/2006,6,0,0,0,9,0,0,15
Bangladesh,24/06/2006,9,2,0,0,-3,2,0,10
Bangladesh,25/06/2006,2,0,0,0,0,0,0,2
Bangladesh,26/06/2006,15,0,0,0,0,1,0,16
Bangladesh,27/06/2006,10,0,0,0,0,0,0,10
Bangladesh,28/06/2006,4,0,0,0,0,0,0,4
Bangladesh,29/06/2006,3,0,0,0,0,0,0,3
Bangladesh,30/06/2006,1,0,0,0,0,0,0,1
Cameroon,01/06/2006,0,0,0,0,0,0,0,0
Cameroon,02/06/2006,0,0,0,0,0,0,0,0
Cameroon,03/06/2006,0,0,0,0,0,0,0,0
Cameroon,05/06/2006,0,0,0,0,3,0,0,3
Cameroon,06/06/2006,2,0,0,0,3,0,0,5
Cameroon,07/06/2006,5,0,0,0,0,0,0,5
Cameroon,08/06/2006,0,0,0,0,0,0,0,0
Cameroon,09/06/2006,5,0,0,0,0,0,0,5
Cameroon,11/06/2006,4,0,0,0,0,0,0,4
Cameroon,12/06/2006,10,0,0,0,0,0,0,10
Cameroon,13/06/2006,6,0,0,0,0,0,0,6
Cameroon,14/06/2006,-4,0,0,0,3,0,0,-1
Cameroon,15/06/2006,-5,0,0,0,0,1,0,-4
Cameroon,17/06/2006,0,0,0,0,0,0,0,0
Cameroon,19/06/2006,0,0,0,0,0,0,0,0
Cameroon,20/06/2006,0,0,0,0,3,0,0,3
Cameroon,21/06/2006,-1,0,0,0,0,0,0,-1
Cameroon,22/06/2006,0,0,0,0,-2,0,0,-2
Cameroon,23/06/2006,0,0,0,0,-2,0,0,-2
Cameroon,26/06/2006,1,0,0,0,3,0,0,4
Cameroon,27/06/2006,2,0,0,0,0,0,0,2
Cameroon,28/06/2006,0,0,0,0,6,0,0,6
Cameroon,29/06/2006,18,0,0,0,1,0,0,19
Cameroon,30/06/2006,0,0,0,0,0,0,0,0
China,01/06/2006,-10,0,0,0,-4,2,0,-12
China,02/06/2006,13,0,-1,0,4,3,0,19
China,03/06/2006,19,0,1,0,-1,3,0,22
China,04/06/2006,2,0,0,0,-2,0,0,0
China,05/06/2006,14,0,0,0,6,3,0,23
China,06/06/2006,4,2,0,0,10,1,0,17
China,07/06/2006,10,0,-4,0,17,3,0,26
China,08/06/2006,24,0,-1,0,1,3,0,27
China,09/06/2006,10,0,0,0,26,0,0,36
China,10/06/2006,-3,0,0,0,3,0,0,0
China,11/06/2006,9,0,0,0,15,0,0,24
China,12/06/2006,11,0,0,0,3,0,0,14
China,13/06/2006,5,0,0,0,-2,4,0,7
China,14/06/2006,13,0,1,0,9,5,0,28
China,15/06/2006,13,0,-1,0,1,0,0,13
China,16/06/2006,10,0,1,0,0,5,0,16
China,17/06/2006,6,0,0,0,0,2,0,8
China,18/06/2006,4,0,0,0,-6,1,0,-1
China,19/06/2006,31,0,1,0,3,4,0,39
China,20/06/2006,7,0,0,0,2,5,0,14
China,21/06/2006,-11,2,0,0,25,4,0,20
China,22/06/2006,6,2,-5,0,12,1,0,16
China,23/06/2006,14,0,-3,0,3,0,0,14
China,24/06/2006,46,0,0,0,12,1,0,59
China,25/06/2006,19,0,0,0,11,1,0,31
China,26/06/2006,22,0,0,0,18,5,0,45
China,27/06/2006,46,0,-3,0,29,3,0,75
China,28/06/2006,25,0,-2,0,9,1,0,33
China,29/06/2006,22,0,0,0,2,2,0,26
China,30/06/2006,15,0,-2,0,15,1,0,29
Egypt,01/06/2006,5,0,0,0,0,0,0,5
Egypt,02/06/2006,52,0,0,0,3,3,0,58
Egypt,03/06/2006,30,0,2,0,1,2,0,35
Egypt,04/06/2006,27,0,0,0,16,1,0,44
Egypt,05/06/2006,19,0,0,0,19,1,0,39
Egypt,06/06/2006,2,0,0,0,3,0,0,5
Egypt,07/06/2006,0,0,0,0,3,3,0,6
Egypt,08/06/2006,12,0,0,0,0,0,0,12
Egypt,09/06/2006,23,2,0,0,1,0,0,26
Egypt,10/06/2006,6,0,0,0,-8,0,0,-2
Egypt,11/06/2006,0,0,0,0,0,0,0,0
Egypt,12/06/2006,2,0,0,0,0,3,0,5
Egypt,13/06/2006,1,0,0,0,3,1,0,5
Egypt,14/06/2006,23,2,0,0,-4,5,0,26
Egypt,15/06/2006,20,0,0,0,2,1,0,23
Egypt,16/06/2006,1,0,0,0,3,0,0,4
Egypt,17/06/2006,18,0,0,0,3,0,0,21
Egypt,18/06/2006,8,0,0,0,0,2,0,10
Egypt,19/06/2006,15,0,0,0,3,0,0,18
Egypt,20/06/2006,12,0,0,0,-6,0,0,6
Egypt,21/06/2006,11,0,0,0,2,9,0,22
Egypt,22/06/2006,13,0,0,0,24,1,0,38
Egypt,23/06/2006,4,0,0,0,-3,1,0,2
Egypt,24/06/2006,5,0,0,0,0,0,0,5
Egypt,25/06/2006,31,0,0,0,3,0,0,34
Egypt,26/06/2006,12,0,0,0,-2,1,0,11
Egypt,27/06/2006,9,0,0,0,11,0,0,20
Egypt,28/06/2006,11,0,0,0,3,0,0,14
Egypt,29/06/2006,29,0,0,0,27,4,0,60
Egypt,30/06/2006,40,0,0,0,-29,3,0,14
Eritrea,01/06/2006,2,0,0,0,0,0,0,2
Eritrea,02/06/2006,0,0,0,0,0,0,0,0
Eritrea,03/06/2006,5,0,0,0,0,0,0,5
Eritrea,05/06/2006,3,0,0,0,0,0,0,3
Eritrea,06/06/2006,0,0,0,0,0,0,0,0
Eritrea,07/06/2006,-3,0,0,0,0,0,0,-3
Eritrea,09/06/2006,0,0,0,0,0,0,0,0
Eritrea,10/06/2006,2,0,0,0,0,0,0,2
Eritrea,12/06/2006,0,0,0,0,0,0,0,0
Eritrea,13/06/2006,5,0,0,0,-4,0,0,1
Eritrea,14/06/2006,4,0,0,0,0,0,0,4
Eritrea,15/06/2006,9,0,0,0,0,0,0,9
Eritrea,16/06/2006,0,0,0,0,0,0,0,0
Eritrea,17/06/2006,0,0,0,0,0,0,0,0
Eritrea,18/06/2006,2,0,0,0,0,0,0,2
Eritrea,19/06/2006,2,0,0,0,0,0,0,2
Eritrea,20/06/2006,6,0,0,0,0,0,0,6
Eritrea,21/06/2006,0,0,0,0,3,0,0,3
Eritrea,22/06/2006,4,0,0,0,6,0,0,10
Eritrea,23/06/2006,1,0,0,0,0,0,0,1
Eritrea,24/06/2006,0,0,0,0,3,0,0,3
Eritrea,26/06/2006,7,0,0,0,0,0,0,7
Eritrea,27/06/2006,2,0,0,0,0,1,0,3
Eritrea,28/06/2006,4,0,0,0,0,0,0,4
Eritrea,29/06/2006,3,0,0,0,4,0,0,7
Eritrea,30/06/2006,0,0,0,0,0,0,0,0
Georgia,01/06/2006,-7,2,0,0,0,0,0,-5
Georgia,02/06/2006,0,0,0,0,0,0,0,0
Georgia,03/06/2006,2,0,0,0,3,0,0,5
Georgia,04/06/2006,3,0,0,0,0,0,0,3
Georgia,05/06/2006,0,0,0,0,3,0,0,3
Georgia,06/06/2006,3,0,0,0,3,0,0,6
Georgia,07/06/2006,13,0,0,0,-2,0,0,11
Georgia,08/06/2006,0,0,0,0,3,0,0,3
Georgia,09/06/2006,5,0,-2,0,6,0,0,9
Georgia,10/06/2006,2,0,0,0,0,0,0,2
Georgia,12/06/2006,3,0,0,0,0,0,0,3
Georgia,13/06/2006,0,0,0,0,1,0,0,1
Georgia,14/06/2006,0,0,0,0,0,0,0,0
Georgia,15/06/2006,2,0,0,0,3,0,0,5
Georgia,16/06/2006,0,0,-1,0,9,0,0,8
Georgia,17/06/2006,-1,0,0,0,0,0,0,-1
Georgia,18/06/2006,-5,0,0,0,0,0,0,-5
Georgia,19/06/2006,0,0,0,0,0,2,0,2
Georgia,20/06/2006,6,0,0,0,13,0,0,19
Georgia,21/06/2006,6,0,0,0,8,0,0,14
Georgia,22/06/2006,3,0,0,0,0,0,0,3
Georgia,23/06/2006,9,0,0,0,3,0,0,12
Georgia,24/06/2006,0,0,0,0,0,0,0,0
Georgia,25/06/2006,2,0,0,0,3,0,0,5
Georgia,26/06/2006,1,0,0,0,0,0,0,1
Georgia,27/06/2006,11,0,0,0,3,0,0,14
Georgia,28/06/2006,8,0,0,0,9,0,0,17
Georgia,29/06/2006,2,0,0,0,-4,0,0,-2
Georgia,30/06/2006,0,0,0,0,-2,3,0,1
India,01/06/2006,18,0,-1,0,-1,1,0,17
India,02/06/2006,0,0,0,0,-2,0,0,-2
India,03/06/2006,5,0,0,0,1,0,0,6
India,04/06/2006,1,0,0,0,3,0,0,4
India,05/06/2006,6,0,0,0,3,0,0,9
India,06/06/2006,13,0,0,0,10,0,0,23
India,07/06/2006,5,0,0,0,7,4,0,16
India,08/06/2006,4,0,-2,0,9,0,0,11
India,09/06/2006,15,0,0,0,3,1,0,19
India,10/06/2006,0,0,0,0,3,0,0,3
India,11/06/2006,0,0,0,0,0,0,0,0
India,12/06/2006,4,0,0,0,0,0,0,4
India,13/06/2006,0,0,0,0,1,0,0,1
India,14/06/2006,14,0,0,0,0,2,0,16
India,15/06/2006,13,0,0,0,0,0,0,13
India,16/06/2006,6,0,0,0,0,0,0,6
India,17/06/2006,4,0,0,0,-3,2,0,3
India,18/06/2006,8,0,0,0,3,0,0,11
India,19/06/2006,5,0,0,0,4,1,0,10
India,20/06/2006,10,0,-4,0,0,2,0,8
India,21/06/2006,14,0,0,0,-2,1,0,13
India,22/06/2006,-4,0,0,0,0,0,0,-4
India,23/06/2006,12,0,0,0,5,0,0,17
India,24/06/2006,17,0,0,0,-2,3,0,18
India,25/06/2006,3,0,0,0,0,0,0,3
India,26/06/2006,17,0,-2,0,10,7,0,32
India,27/06/2006,24,0,0,0,3,0,0,27
India,28/06/2006,27,0,0,0,4,7,0,38
India,29/06/2006,14,0,-2,0,0,0,0,12
India,30/06/2006,9,0,0,0,-4,5,0,10
Iran,01/06/2006,21,0,0,0,10,2,0,33
Iran,02/06/2006,14,0,-1,0,7,1,0,21
Iran,03/06/2006,6,0,0,0,3,3,0,12
Iran,04/06/2006,2,0,0,0,9,1,0,12
Iran,05/06/2006,36,0,0,0,6,17,0,59
Iran,06/06/2006,26,0,0,0,15,14,0,55
Iran,07/06/2006,22,0,2,0,17,16,0,57
Iran,08/06/2006,25,0,-2,0,1,3,0,27
Iran,09/06/2006,33,0,-2,0,0,5,0,36
Iran,10/06/2006,3,0,0,0,3,2,0,8
Iran,11/06/2006,5,0,0,0,3,0,0,8
Iran,12/06/2006,14,0,0,0,10,1,0,25
Iran,13/06/2006,25,0,0,0,0,1,0,26
Iran,14/06/2006,26,2,0,0,15,3,0,46
Iran,15/06/2006,17,0,0,0,9,1,0,27
Iran,16/06/2006,10,0,0,0,3,3,0,16
Iran,17/06/2006,15,0,0,0,1,4,0,20
Iran,18/06/2006,29,0,0,0,4,5,0,38
Iran,19/06/2006,22,0,0,0,24,7,0,53
Iran,20/06/2006,20,0,0,0,9,5,0,34
Iran,21/06/2006,13,0,-1,0,-4,0,0,8
Iran,22/06/2006,29,0,1,0,12,0,0,42
Iran,23/06/2006,18,0,-2,0,0,3,0,19
Iran,24/06/2006,15,0,0,0,1,3,0,19
Iran,25/06/2006,9,0,0,0,0,2,0,11
Iran,26/06/2006,5,0,0,0,-8,4,0,1
Iran,27/06/2006,34,0,0,0,10,5,0,49
Iran,28/06/2006,27,2,0,0,-2,1,0,28
Iran,29/06/2006,30,0,0,0,1,0,0,31
Iran,30/06/2006,29,0,0,0,6,2,0,37
Iraq,01/06/2006,85,0,0,0,59,8,0,152
Iraq,02/06/2006,86,0,0,0,30,13,0,129
Iraq,03/06/2006,50,0,0,0,15,18,0,83
Iraq,04/06/2006,47,0,1,0,-3,9,0,54
Iraq,05/06/2006,59,0,-2,0,6,2,0,65
Iraq,06/06/2006,98,0,1,0,9,3,0,111
Iraq,07/06/2006,42,0,1,0,24,4,0,71
Iraq,08/06/2006,277,0,0,0,80,15,0,372
Iraq,09/06/2006,150,2,2,0,11,10,0,175
Iraq,10/06/2006,23,0,0,0,0,0,0,23
Iraq,11/06/2006,46,0,0,0,8,3,0,57
Iraq,12/06/2006,73,0,0,0,26,10,0,109
Iraq,13/06/2006,59,0,-4,0,24,2,0,81
Iraq,14/06/2006,91,2,-3,0,65,5,0,160
Iraq,15/06/2006,77,0,0,0,-1,10,0,86
Iraq,16/06/2006,45,2,-2,0,16,2,0,63
Iraq,17/06/2006,14,0,0,0,6,2,0,22
Iraq,18/06/2006,10,0,0,0,-3,4,0,11
Iraq,19/06/2006,63,0,0,0,45,0,0,108
Iraq,20/06/2006,166,0,7,0,71,11,0,255
Iraq,21/06/2006,152,2,1,0,38,8,0,201
Iraq,22/06/2006,68,0,1,0,21,14,0,104
Iraq,23/06/2006,79,0,0,0,10,8,0,97
Iraq,24/06/2006,88,0,0,0,15,2,0,105
Iraq,25/06/2006,102,2,-2,0,9,28,0,139
Iraq,26/06/2006,97,0,-1,0,31,11,0,138
Iraq,27/06/2006,164,0,-3,0,32,8,0,201
Iraq,28/06/2006,93,0,-9,0,17,5,0,106
Iraq,29/06/2006,14,0,-7,0,9,8,0,24
Iraq,30/06/2006,61,0,-6,0,10,2,0,67
Morocco,01/06/2006,-3,0,0,0,6,0,0,3
Morocco,02/06/2006,0,0,0,0,3,0,0,3
Morocco,03/06/2006,1,0,0,0,6,0,0,7
Morocco,04/06/2006,0,0,0,0,0,0,0,0
Morocco,05/06/2006,0,0,0,0,3,0,0,3
Morocco,06/06/2006,1,0,0,0,0,0,0,1
Morocco,07/06/2006,10,0,0,0,3,0,0,13
Morocco,08/06/2006,-2,0,0,0,3,0,0,1
Morocco,09/06/2006,4,0,0,0,0,0,0,4
Morocco,10/06/2006,0,0,0,0,6,0,0,6
Morocco,13/06/2006,0,0,0,0,3,0,0,3
Morocco,14/06/2006,-6,0,0,0,0,0,0,-6
Morocco,15/06/2006,5,0,0,0,-2,0,0,3
Morocco,17/06/2006,0,0,0,0,3,0,0,3
Morocco,18/06/2006,0,0,0,0,0,0,0,0
Morocco,19/06/2006,3,0,0,0,9,0,0,12
Morocco,20/06/2006,0,0,0,0,2,0,0,2
Morocco,21/06/2006,6,0,0,0,0,0,0,6
Morocco,22/06/2006,0,0,0,0,0,0,0,0
Morocco,23/06/2006,1,0,0,0,0,0,0,1
Morocco,24/06/2006,0,0,0,0,0,2,0,2
Morocco,25/06/2006,0,0,0,0,3,2,0,5
Morocco,26/06/2006,6,0,0,0,0,0,0,6
Morocco,27/06/2006,2,0,0,0,0,0,0,2
Morocco,28/06/2006,6,0,0,0,3,0,0,9
Morocco,29/06/2006,2,0,0,0,0,0,0,2
Morocco,30/06/2006,3,0,0,0,9,0,0,12
Nigeria,01/06/2006,20,0,-2,0,8,1,0,27
Nigeria,02/06/2006,6,0,-1,0,12,0,0,17
Nigeria,03/06/2006,3,0,0,0,6,0,0,9
Nigeria,04/06/2006,5,0,0,0,11,1,0,17
Nigeria,05/06/2006,14,0,0,0,13,0,0,27
Nigeria,06/06/2006,23,0,0,0,1,5,0,29
Nigeria,07/06/2006,13,0,0,0,33,3,0,49
Nigeria,08/06/2006,20,0,0,0,24,1,0,45
Nigeria,09/06/2006,2,0,0,0,3,3,0,8
Nigeria,10/06/2006,6,0,0,0,0,0,0,6
Nigeria,11/06/2006,9,0,0,0,0,2,0,11
Nigeria,12/06/2006,-11,0,0,0,2,0,0,-9
Nigeria,13/06/2006,4,0,0,0,6,4,0,14
Nigeria,14/06/2006,3,0,0,0,11,0,0,14
Nigeria,15/06/2006,-3,0,2,0,27,2,0,28
Nigeria,16/06/2006,0,0,2,0,6,0,0,8
Nigeria,17/06/2006,3,0,0,0,6,2,0,11
Nigeria,18/06/2006,4,0,0,0,0,0,0,4
Nigeria,19/06/2006,12,0,0,0,6,0,0,18
Nigeria,20/06/2006,-1,0,1,0,3,3,0,6
Nigeria,21/06/2006,24,0,1,0,13,13,0,51
Nigeria,22/06/2006,-20,0,2,0,1,1,0,-16
Nigeria,23/06/2006,3,0,0,0,0,5,0,8
Nigeria,24/06/2006,4,0,0,0,0,1,0,5
Nigeria,25/06/2006,5,0,0,0,0,1,0,6
Nigeria,26/06/2006,21,0,0,0,7,8,0,36
Nigeria,27/06/2006,35,0,0,0,33,3,0,71
Nigeria,28/06/2006,1,0,0,0,12,0,0,13
Nigeria,29/06/2006,15,0,0,0,13,0,0,28
Nigeria,30/06/2006,9,0,0,0,3,1,0,13
Pakistan,01/06/2006,22,0,-2,0,10,0,0,30
Pakistan,02/06/2006,36,0,0,0,5,3,0,44
Pakistan,03/06/2006,30,6,0,0,12,5,0,53
Pakistan,04/06/2006,15,0,1,0,-1,0,0,15
Pakistan,05/06/2006,20,0,0,0,3,0,0,23
Pakistan,06/06/2006,13,0,0,0,12,6,0,31
Pakistan,07/06/2006,8,0,0,0,12,1,0,21
Pakistan,08/06/2006,21,0,0,0,4,1,0,26
Pakistan,09/06/2006,47,0,-2,0,14,1,0,60
Pakistan,10/06/2006,4,0,0,0,3,0,0,7
Pakistan,11/06/2006,15,0,0,0,3,0,0,18
Pakistan,12/06/2006,22,0,1,0,4,0,0,27
Pakistan,13/06/2006,15,0,0,0,4,2,0,21
Pakistan,14/06/2006,70,0,1,0,3,2,0,76
Pakistan,15/06/2006,16,0,0,0,9,0,0,25
Pakistan,16/06/2006,10,0,0,0,1,0,0,11
Pakistan,17/06/2006,9,0,0,0,0,0,0,9
Pakistan,18/06/2006,18,0,0,0,-1,0,0,17
Pakistan,19/06/2006,16,0,0,0,6,0,0,22
Pakistan,20/06/2006,31,0,0,0,-4,2,0,29
Pakistan,21/06/2006,38,0,0,0,3,0,0,41
Pakistan,22/06/2006,25,0,0,0,0,4,0,29
Pakistan,23/06/2006,20,0,0,0,0,4,0,24
Pakistan,24/06/2006,16,0,0,0,3,0,0,19
Pakistan,25/06/2006,18,0,0,0,3,5,0,26
Pakistan,26/06/2006,12,0,0,0,0,1,0,13
Pakistan,27/06/2006,23,0,0,0,0,0,0,23
Pakistan,28/06/2006,29,0,0,0,9,0,0,38
Pakistan,29/06/2006,22,0,0,0,3,0,0,25
Pakistan,30/06/2006,13,0,0,0,0,2,0,15
Sierra Leone,01/06/2006,-1,0,0,0,0,1,0,0
Sierra Leone,02/06/2006,-1,0,0,0,0,2,0,1
Sierra Leone,03/06/2006,0,0,0,0,0,0,0,0
Sierra Leone,04/06/2006,0,0,0,0,0,0,0,0
Sierra Leone,05/06/2006,1,0,0,0,0,0,0,1
Sierra Leone,06/06/2006,0,0,0,0,3,0,0,3
Sierra Leone,07/06/2006,0,0,0,0,6,0,0,6
Sierra Leone,08/06/2006,0,0,0,0,6,1,0,7
Sierra Leone,09/06/2006,1,0,0,0,3,0,0,4
Sierra Leone,12/06/2006,4,0,0,0,3,0,0,7
Sierra Leone,13/06/2006,8,0,0,0,0,1,0,9
Sierra Leone,14/06/2006,0,0,-4,0,0,0,0,-4
Sierra Leone,15/06/2006,10,0,2,0,27,8,0,47
Sierra Leone,16/06/2006,9,0,0,0,18,0,0,27
Sierra Leone,17/06/2006,0,0,0,0,0,0,0,0
Sierra Leone,19/06/2006,0,0,0,0,0,2,0,2
Sierra Leone,20/06/2006,12,0,1,0,21,2,0,36
Sierra Leone,21/06/2006,22,0,0,0,1,2,0,25
Sierra Leone,22/06/2006,3,0,0,0,0,0,0,3
Sierra Leone,23/06/2006,2,0,0,0,12,0,0,14
Sierra Leone,24/06/2006,0,0,0,0,0,0,0,0
Sierra Leone,26/06/2006,0,0,0,0,0,0,0,0
Sierra Leone,27/06/2006,0,0,-2,0,12,0,0,10
Sierra Leone,28/06/2006,2,0,0,0,3,0,0,5
Sierra Leone,29/06/2006,2,0,0,0,0,0,0,2
Sierra Leone,30/06/2006,1,4,0,0,-2,0,0,3
Somalia,01/06/2006,5,0,0,0,0,0,0,5
Somalia,02/06/2006,-1,0,0,0,2,0,0,1
Somalia,03/06/2006,0,0,0,0,-2,0,0,-2
Somalia,04/06/2006,3,0,0,0,-4,0,0,-1
Somalia,05/06/2006,31,0,0,0,0,0,0,31
Somalia,06/06/2006,8,0,0,0,0,0,0,8
Somalia,07/06/2006,0,0,0,0,3,0,0,3
Somalia,08/06/2006,5,0,0,0,0,0,0,5
Somalia,09/06/2006,3,0,0,0,0,0,0,3
Somalia,10/06/2006,3,0,0,0,0,0,0,3
Somalia,11/06/2006,9,0,0,0,9,1,0,19
Somalia,12/06/2006,0,0,0,0,0,0,0,0
Somalia,13/06/2006,9,0,0,0,3,1,0,13
Somalia,14/06/2006,10,0,0,0,3,0,0,13
Somalia,15/06/2006,4,0,0,0,0,0,0,4
Somalia,16/06/2006,4,0,0,0,0,1,0,5
Somalia,17/06/2006,18,0,0,0,0,0,0,18
Somalia,18/06/2006,0,0,0,0,0,0,0,0
Somalia,19/06/2006,0,0,0,0,0,0,0,0
Somalia,20/06/2006,-1,0,0,0,4,0,0,3
Somalia,21/06/2006,23,2,0,0,8,0,0,33
Somalia,22/06/2006,16,4,0,0,8,0,0,28
Somalia,23/06/2006,7,0,0,0,0,0,0,7
Somalia,24/06/2006,0,0,0,0,6,0,0,6
Somalia,25/06/2006,3,0,0,0,0,0,0,3
Somalia,26/06/2006,3,0,0,0,0,0,0,3
Somalia,27/06/2006,8,0,0,0,0,1,0,9
Somalia,28/06/2006,4,0,0,0,6,3,0,13
Somalia,29/06/2006,14,0,-4,0,6,3,0,19
Somalia,30/06/2006,5,0,-7,0,-4,3,0,-3
Syria,01/06/2006,-9,0,0,0,3,0,0,-6
Syria,02/06/2006,-1,0,0,0,0,2,0,1
Syria,03/06/2006,11,0,0,0,-2,0,0,9
Syria,04/06/2006,4,0,0,0,6,3,0,13
Syria,05/06/2006,10,0,0,0,4,2,0,16
Syria,06/06/2006,6,0,0,0,13,0,0,19
Syria,07/06/2006,0,0,0,0,6,0,0,6
Syria,08/06/2006,3,0,0,0,-1,0,0,2
Syria,09/06/2006,-1,0,0,0,0,0,0,-1
Syria,10/06/2006,40,0,0,0,21,1,0,62
Syria,11/06/2006,17,0,0,0,0,0,0,17
Syria,12/06/2006,8,0,0,0,3,1,0,12
Syria,13/06/2006,8,0,0,0,5,0,0,13
Syria,14/06/2006,3,0,2,0,9,0,0,14
Syria,15/06/2006,11,0,0,0,4,0,0,15
Syria,16/06/2006,-5,0,0,0,0,0,0,-5
Syria,17/06/2006,7,0,0,0,0,0,0,7
Syria,18/06/2006,6,0,0,0,-2,0,0,4
Syria,19/06/2006,0,0,0,0,-2,0,0,-2
Syria,20/06/2006,8,0,1,0,0,0,0,9
Syria,21/06/2006,3,0,0,0,4,8,0,15
Syria,22/06/2006,-6,0,0,0,12,2,0,8
Syria,23/06/2006,1,0,0,0,0,0,0,1
Syria,24/06/2006,21,0,0,0,0,0,0,21
Syria,25/06/2006,2,0,0,0,6,0,0,8
Syria,26/06/2006,5,0,0,0,0,2,0,7
Syria,27/06/2006,4,0,0,0,4,0,0,8
Syria,28/06/2006,29,0,0,0,10,2,0,41
Syria,29/06/2006,12,0,2,0,9,1,0,24
Syria,30/06/2006,13,0,0,0,-3,1,0,11
Yemen,02/06/2006,-2,0,0,0,0,0,0,-2
Yemen,03/06/2006,0,0,-1,0,0,0,0,-1
Yemen,04/06/2006,0,0,-1,0,0,0,0,-1
Yemen,05/06/2006,1,0,0,0,0,0,0,1
Yemen,06/06/2006,0,0,0,0,3,0,0,3
Yemen,07/06/2006,3,0,0,0,0,0,0,3
Yemen,08/06/2006,9,0,0,0,0,0,0,9
Yemen,09/06/2006,6,0,0,0,6,0,0,12
Yemen,10/06/2006,0,0,0,0,0,0,0,0
Yemen,11/06/2006,2,0,0,0,0,4,0,6
Yemen,12/06/2006,4,0,0,0,3,0,0,7
Yemen,13/06/2006,7,0,0,0,6,0,0,13
Yemen,14/06/2006,16,0,0,0,15,12,0,43
Yemen,15/06/2006,2,0,1,0,0,0,0,3
Yemen,16/06/2006,-1,0,1,0,0,0,0,0
Yemen,17/06/2006,5,0,0,0,12,0,0,17
Yemen,18/06/2006,-1,0,0,0,0,0,0,-1
Yemen,19/06/2006,19,4,0,0,4,0,0,27
Yemen,20/06/2006,0,0,0,0,0,0,0,0
Yemen,21/06/2006,2,0,0,0,0,0,0,2
Yemen,22/06/2006,0,0,-4,0,0,0,0,-4
Yemen,23/06/2006,2,0,0,0,1,0,0,3
Yemen,24/06/2006,4,0,-4,0,-2,0,0,-2
Yemen,25/06/2006,0,0,0,0,-8,0,0,-8
Yemen,26/06/2006,0,0,0,0,0,0,0,0
Yemen,28/06/2006,0,0,0,0,0,0,0,0
Yemen,29/06/2006,14,0,0,0,17,0,0,31
Yemen,30/06/2006,17,0,0,0,21,2,0,40
Afghanistan,01/12/2006,35,0,0,0,-5,2,0,32
Afghanistan,02/12/2006,35,0,0,0,9,9,0,53
Afghanistan,03/12/2006,64,0,0,0,3,19,0,86
Afghanistan,04/12/2006,44,0,0,0,11,8,0,63
Afghanistan,05/12/2006,66,0,0,0,6,19,0,91
Afghanistan,06/12/2006,65,2,0,0,28,84,0,179
Afghanistan,07/12/2006,52,0,1,0,27,13,0,93
Afghanistan,08/12/2006,22,0,0,0,5,2,0,29
Afghanistan,09/12/2006,15,0,0,0,14,3,0,32
Afghanistan,10/12/2006,19,0,0,0,3,1,0,23
Afghanistan,11/12/2006,21,0,0,0,1,2,0,24
Afghanistan,12/12/2006,48,0,0,0,-1,3,0,50
Afghanistan,13/12/2006,44,0,0,0,8,2,0,54
Afghanistan,14/12/2006,32,0,-2,0,8,8,0,46
Afghanistan,15/12/2006,18,0,-2,0,-10,3,0,9
Afghanistan,16/12/2006,22,0,0,0,-7,1,0,16
Afghanistan,17/12/2006,65,0,2,0,-7,2,0,62
Afghanistan,18/12/2006,44,0,0,0,20,4,0,68
Afghanistan,19/12/2006,64,0,-2,0,20,6,0,88
Afghanistan,20/12/2006,49,0,0,0,9,0,0,58
Afghanistan,21/12/2006,19,0,-1,0,14,2,0,34
Afghanistan,22/12/2006,6,0,-2,0,9,3,0,16
Afghanistan,23/12/2006,17,0,0,0,3,4,0,24
Afghanistan,24/12/2006,27,0,0,0,-3,5,0,29
Afghanistan,25/12/2006,4,0,0,0,18,6,0,28
Afghanistan,26/12/2006,60,0,0,0,11,28,0,99
Afghanistan,27/12/2006,79,0,0,0,0,9,0,88
Afghanistan,28/12/2006,79,0,0,0,8,12,0,99
Afghanistan,29/12/2006,28,0,0,0,14,2,0,44
Afghanistan,30/12/2006,57,0,0,0,-2,2,0,57
Afghanistan,31/12/2006,63,0,0,0,20,0,0,83
Albania,01/12/2006,14,0,0,0,3,0,0,17
Albania,02/12/2006,6,0,-4,0,0,1,0,3
Albania,03/12/2006,-2,0,0,0,0,0,0,-2
Albania,04/12/2006,4,0,0,0,0,0,0,4
Albania,05/12/2006,3,0,0,0,0,0,0,3
Albania,06/12/2006,0,0,-1,0,0,0,0,-1
Albania,07/12/2006,1,0,0,0,0,4,0,5
Albania,08/12/2006,9,0,1,0,10,0,0,20
Albania,09/12/2006,3,0,0,0,0,0,0,3
Albania,10/12/2006,2,0,0,0,6,0,0,8
Albania,11/12/2006,9,0,0,0,0,0,0,9
Albania,12/12/2006,10,0,-2,0,0,0,0,8
Albania,13/12/2006,13,0,0,0,3,0,0,16
Albania,14/12/2006,2,0,2,0,-6,2,0,0
Albania,15/12/2006,6,0,-2,0,9,2,0,15
Albania,16/12/2006,0,0,-2,0,1,1,0,0
Albania,17/12/2006,0,0,0,0,8,0,0,8
Albania,18/12/2006,2,0,0,0,-2,0,0,0
Albania,19/12/2006,6,0,0,0,3,0,0,9
Albania,20/12/2006,0,0,0,0,3,0,0,3
Albania,21/12/2006,6,0,-4,0,6,0,0,8
Albania,22/12/2006,3,0,0,0,3,0,0,6
Albania,23/12/2006,-2,4,0,0,3,0,0,5
Albania,24/12/2006,7,0,0,0,0,0,0,7
Albania,25/12/2006,0,0,0,0,0,0,0,0
Albania,27/12/2006,1,2,0,0,0,3,0,6
Albania,28/12/2006,8,0,-3,0,0,0,0,5
Albania,29/12/2006,0,0,0,0,-4,0,0,-4
Albania,30/12/2006,9,0,-2,0,0,0,0,7
Albania,31/12/2006,3,0,-1,0,-6,0,0,-4
Algeria,01/12/2006,0,0,0,0,0,0,0,0
Algeria,02/12/2006,0,0,0,0,0,0,0,0
Algeria,03/12/2006,3,0,0,0,0,0,0,3
Algeria,04/12/2006,0,0,0,0,0,0,0,0
Algeria,05/12/2006,-2,0,0,0,0,0,0,-2
Algeria,06/12/2006,4,0,0,0,0,0,0,4
Algeria,07/12/2006,2,0,0,0,0,0,0,2
Algeria,08/12/2006,0,0,0,0,162,0,0,162
Algeria,09/12/2006,0,0,0,0,0,0,0,0
Algeria,10/12/2006,0,0,0,0,0,0,0,0
Algeria,11/12/2006,18,0,1,0,0,0,0,19
Algeria,12/12/2006,0,0,0,0,1,0,0,1
Algeria,13/12/2006,0,0,0,0,0,0,0,0
Algeria,14/12/2006,0,0,0,0,0,0,0,0
Algeria,15/12/2006,0,0,0,0,0,0,0,0
Algeria,16/12/2006,18,0,0,0,0,0,0,18
Algeria,17/12/2006,0,0,0,0,0,0,0,0
Algeria,18/12/2006,5,0,0,0,3,0,0,8
Algeria,19/12/2006,0,0,0,0,0,0,0,0
Algeria,20/12/2006,1,0,0,0,3,0,0,4
Algeria,21/12/2006,18,0,0,0,3,0,0,21
Algeria,23/12/2006,2,0,0,0,0,0,0,2
Algeria,25/12/2006,-5,0,0,0,0,0,0,-5
Algeria,26/12/2006,3,0,0,0,6,0,0,9
Algeria,27/12/2006,3,0,0,0,12,0,0,15
Algeria,28/12/2006,0,0,0,0,3,0,0,3
Algeria,29/12/2006,0,0,0,0,0,0,0,0
Algeria,30/12/2006,0,0,0,0,0,0,0,0
Algeria,31/12/2006,0,0,0,0,0,0,0,0
Bangladesh,01/12/2006,6,0,-2,0,-2,2,0,4
Bangladesh,02/12/2006,17,0,0,0,3,0,0,20
Bangladesh,03/12/2006,0,0,0,0,0,1,0,1
Bangladesh,04/12/2006,16,0,0,0,6,6,0,28
Bangladesh,05/12/2006,5,0,0,0,3,3,0,11
Bangladesh,06/12/2006,3,0,0,0,0,0,0,3
Bangladesh,07/12/2006,8,0,0,0,1,6,0,15
Bangladesh,08/12/2006,4,0,0,0,0,0,0,4
Bangladesh,09/12/2006,15,0,-2,0,0,1,0,14
Bangladesh,10/12/2006,15,0,-2,0,3,0,0,16
Bangladesh,11/12/2006,5,0,-6,0,0,0,0,-1
Bangladesh,12/12/2006,18,0,0,0,0,0,0,18
Bangladesh,13/12/2006,9,0,1,0,6,1,0,17
Bangladesh,14/12/2006,4,0,-2,0,9,0,0,11
Bangladesh,15/12/2006,14,0,0,0,0,0,0,14
Bangladesh,16/12/2006,8,0,0,0,5,0,0,13
Bangladesh,17/12/2006,6,0,0,0,1,0,0,7
Bangladesh,18/12/2006,2,2,3,0,4,-2,0,9
Bangladesh,19/12/2006,1,0,0,0,3,1,0,5
Bangladesh,20/12/2006,6,0,2,0,3,4,0,15
Bangladesh,21/12/2006,12,0,0,0,0,0,0,12
Bangladesh,22/12/2006,2,0,2,0,0,0,0,4
Bangladesh,23/12/2006,5,0,0,0,0,2,0,7
Bangladesh,24/12/2006,-2,0,0,0,0,0,0,-2
Bangladesh,25/12/2006,0,0,-4,0,0,-2,0,-6
Bangladesh,26/12/2006,2,0,0,0,6,0,0,8
Bangladesh,27/12/2006,6,0,0,0,3,0,0,9
Bangladesh,28/12/2006,9,0,-2,0,0,1,0,8
Bangladesh,29/12/2006,18,0,-2,0,7,2,0,25
Bangladesh,30/12/2006,0,0,0,0,0,1,0,1
Bangladesh,31/12/2006,10,0,0,0,9,1,0,20
Cameroon,01/12/2006,3,0,0,0,0,0,0,3
Cameroon,02/12/2006,3,0,0,0,0,0,0,3
Cameroon,04/12/2006,0,0,0,0,0,0,0,0
Cameroon,05/12/2006,0,0,0,0,0,0,0,0
Cameroon,06/12/2006,0,0,0,0,0,0,0,0
Cameroon,07/12/2006,-1,0,0,0,0,0,0,-1
Cameroon,08/12/2006,0,0,0,0,0,0,0,0
Cameroon,09/12/2006,0,0,0,0,0,0,0,0
Cameroon,11/12/2006,0,0,0,0,3,0,0,3
Cameroon,12/12/2006,0,0,0,0,0,0,0,0
Cameroon,13/12/2006,-1,0,0,0,0,0,0,-1
Cameroon,14/12/2006,0,0,0,0,0,0,0,0
Cameroon,15/12/2006,0,0,0,0,0,0,0,0
Cameroon,16/12/2006,0,0,0,0,3,0,0,3
Cameroon,17/12/2006,0,0,0,0,0,0,0,0
Cameroon,18/12/2006,0,0,0,0,0,0,0,0
Cameroon,19/12/2006,0,0,0,0,0,0,0,0
Cameroon,20/12/2006,0,0,0,0,0,0,0,0
Cameroon,21/12/2006,0,0,0,0,0,0,0,0
Cameroon,22/12/2006,0,0,0,0,0,1,0,1
Cameroon,23/12/2006,-3,0,0,0,0,0,0,-3
Cameroon,27/12/2006,2,0,0,0,0,0,0,2
Cameroon,28/12/2006,0,0,0,0,0,0,0,0
China,01/12/2006,45,0,0,0,5,5,0,55
China,02/12/2006,7,0,0,0,4,3,0,14
China,03/12/2006,18,0,1,0,6,0,0,25
China,04/12/2006,33,0,-1,0,0,4,0,36
China,05/12/2006,16,0,-4,0,27,2,0,41
China,06/12/2006,29,0,4,0,21,6,0,60
China,07/12/2006,19,0,1,0,8,9,0,37
China,08/12/2006,13,0,-1,0,49,0,0,61
China,09/12/2006,6,0,0,0,9,3,0,18
China,10/12/2006,7,0,-2,0,6,3,0,14
China,11/12/2006,29,2,0,0,11,2,0,44
China,12/12/2006,50,0,0,0,6,3,0,59
China,13/12/2006,34,0,0,0,19,2,0,55
China,14/12/2006,27,0,0,0,3,2,0,32
China,15/12/2006,16,0,0,0,31,3,0,50
China,16/12/2006,-2,0,-4,0,21,6,0,21
China,17/12/2006,7,0,0,0,6,1,0,14
China,18/12/2006,22,0,0,0,1,2,0,25
China,19/12/2006,34,2,-1,0,21,0,0,56
China,20/12/2006,58,0,-1,0,39,1,0,97
China,21/12/2006,35,0,3,0,3,3,0,44
China,22/12/2006,18,0,2,0,25,7,0,52
China,23/12/2006,33,0,-2,0,11,1,0,43
China,24/12/2006,10,0,0,0,15,2,0,27
China,25/12/2006,9,0,0,0,0,6,0,15
China,26/12/2006,12,0,0,0,6,0,0,18
China,27/12/2006,3,0,0,0,3,2,0,8
China,28/12/2006,34,0,0,0,9,2,0,45
China,29/12/2006,72,0,0,0,29,5,0,106
China,30/12/2006,16,0,1,0,6,1,0,24
China,31/12/2006,27,0,-2,0,10,2,0,37
Egypt,01/12/2006,13,0,0,0,12,0,0,25
Egypt,02/12/2006,1,0,0,0,0,0,0,1
Egypt,03/12/2006,19,0,0,0,6,0,0,25
Egypt,04/12/2006,9,0,0,0,3,1,0,13
Egypt,05/12/2006,4,0,0,0,12,0,0,16
Egypt,06/12/2006,3,0,0,0,0,0,0,3
Egypt,07/12/2006,3,0,-2,0,4,0,0,5
Egypt,08/12/2006,15,0,0,0,6,0,0,21
Egypt,09/12/2006,2,0,-2,0,9,1,0,10
Egypt,10/12/2006,12,0,0,0,12,3,0,27
Egypt,11/12/2006,11,0,2,0,-3,3,0,13
Egypt,12/12/2006,13,0,0,0,0,0,0,13
Egypt,13/12/2006,35,0,0,0,0,0,0,35
Egypt,14/12/2006,28,0,0,0,9,2,0,39
Egypt,15/12/2006,85,0,3,0,1,8,0,97
Egypt,16/12/2006,30,0,0,0,6,4,0,40
Egypt,17/12/2006,13,0,0,0,2,0,0,15
Egypt,18/12/2006,46,0,0,0,7,1,0,54
Egypt,19/12/2006,26,0,3,0,0,0,0,29
Egypt,20/12/2006,16,0,0,0,-2,2,0,16
Egypt,21/12/2006,3,0,2,0,0,0,0,5
Egypt,22/12/2006,24,0,0,0,0,0,0,24
Egypt,23/12/2006,3,0,0,0,-2,1,0,2
Egypt,24/12/2006,10,0,0,0,0,0,0,10
Egypt,25/12/2006,10,0,0,0,0,0,0,10
Egypt,26/12/2006,10,0,3,0,0,0,0,13
Egypt,27/12/2006,32,0,0,0,22,1,0,55
Egypt,28/12/2006,4,0,0,0,1,0,0,5
Egypt,29/12/2006,2,0,0,0,3,2,0,7
Egypt,30/12/2006,1,0,0,0,6,4,0,11
Egypt,31/12/2006,27,0,0,0,-10,4,0,21
Eritrea,01/12/2006,8,0,0,0,0,0,0,8
Eritrea,02/12/2006,12,0,1,0,3,0,0,16
Eritrea,03/12/2006,2,0,0,0,0,0,0,2
Eritrea,04/12/2006,6,0,0,0,0,0,0,6
Eritrea,05/12/2006,3,0,0,0,3,0,0,6
Eritrea,06/12/2006,1,0,0,0,0,0,0,1
Eritrea,07/12/2006,29,0,0,0,0,0,0,29
Eritrea,08/12/2006,11,0,0,0,15,0,0,26
Eritrea,09/12/2006,7,0,0,0,0,0,0,7
Eritrea,10/12/2006,0,0,0,0,6,0,0,6
Eritrea,11/12/2006,5,0,0,0,0,0,0,5
Eritrea,12/12/2006,8,0,0,0,3,0,0,11
Eritrea,13/12/2006,0,0,0,0,6,0,0,6
Eritrea,14/12/2006,4,0,0,0,0,0,0,4
Eritrea,15/12/2006,3,0,0,0,0,0,0,3
Eritrea,16/12/2006,0,0,0,0,0,0,0,0
Eritrea,17/12/2006,0,0,0,0,0,0,0,0
Eritrea,18/12/2006,3,0,0,0,0,0,0,3
Eritrea,19/12/2006,1,0,0,0,3,0,0,4
Eritrea,20/12/2006,21,0,0,0,0,0,0,21
Eritrea,21/12/2006,23,0,0,0,0,0,0,23
Eritrea,22/12/2006,13,0,0,0,2,0,0,15
Eritrea,23/12/2006,35,0,0,0,0,1,0,36
Eritrea,24/12/2006,13,0,0,0,0,0,0,13
Eritrea,25/12/2006,23,0,0,0,0,1,0,24
Eritrea,26/12/2006,18,0,0,0,0,0,0,18
Eritrea,27/12/2006,17,0,0,0,0,0,0,17
Eritrea,28/12/2006,6,0,0,0,0,2,0,8
Eritrea,29/12/2006,4,0,0,0,0,0,0,4
Eritrea,30/12/2006,8,0,0,0,6,0,0,14
Eritrea,31/12/2006,8,0,0,0,0,0,0,8
Georgia,01/12/2006,-2,0,0,0,0,0,0,-2
Georgia,02/12/2006,2,0,0,0,0,0,0,2
Georgia,03/12/2006,0,0,0,0,0,0,0,0
Georgia,04/12/2006,14,0,0,0,0,0,0,14
Georgia,05/12/2006,3,0,0,0,-2,0,0,1
Georgia,06/12/2006,2,0,0,0,0,0,0,2
Georgia,07/12/2006,0,0,0,0,4,0,0,4
Georgia,08/12/2006,3,0,0,0,0,1,0,4
Georgia,09/12/2006,5,0,0,0,6,0,0,11
Georgia,11/12/2006,0,0,0,0,0,0,0,0
Georgia,12/12/2006,1,0,0,0,0,0,0,1
Georgia,13/12/2006,4,0,0,0,0,0,0,4
Georgia,14/12/2006,2,0,0,0,-2,1,0,1
Georgia,15/12/2006,-3,0,-1,0,3,2,0,1
Georgia,16/12/2006,2,0,0,0,0,0,0,2
Georgia,17/12/2006,6,0,0,0,0,0,0,6
Georgia,18/12/2006,5,0,0,0,0,0,0,5
Georgia,19/12/2006,1,0,-2,0,1,0,0,0
Georgia,20/12/2006,6,0,0,0,1,1,0,8
Georgia,21/12/2006,1,0,-2,0,0,0,0,-1
Georgia,22/12/2006,3,0,0,0,12,0,0,15
Georgia,23/12/2006,-1,0,0,0,0,0,0,-1
Georgia,24/12/2006,-1,0,0,0,0,0,0,-1
Georgia,25/12/2006,-1,0,0,0,0,0,0,-1
Georgia,26/12/2006,0,0,0,0,0,2,0,2
Georgia,27/12/2006,0,0,-1,0,0,0,0,-1
Georgia,28/12/2006,5,0,0,0,0,2,0,7
Georgia,29/12/2006,0,0,0,0,0,0,0,0
Georgia,30/12/2006,5,0,0,0,0,0,0,5
Georgia,31/12/2006,0,0,0,0,0,0,0,0
India,01/12/2006,12,0,0,0,1,0,0,13
India,02/12/2006,3,0,0,0,9,0,0,12
India,03/12/2006,20,0,0,0,6,0,0,26
India,04/12/2006,18,0,0,0,-2,3,0,19
India,05/12/2006,7,0,0,0,3,1,0,11
India,06/12/2006,7,2,3,0,15,6,0,33
India,07/12/2006,5,2,0,0,4,0,0,11
India,08/12/2006,17,0,0,0,-5,1,0,13
India,09/12/2006,22,0,0,0,6,0,0,28
India,10/12/2006,5,0,0,0,0,0,0,5
India,11/12/2006,38,0,0,0,8,1,0,47
India,12/12/2006,7,0,0,0,11,1,0,19
India,13/12/2006,16,0,0,0,-2,6,0,20
India,14/12/2006,8,0,0,0,6,2,0,16
India,15/12/2006,14,0,0,0,7,0,0,21
India,16/12/2006,10,0,0,0,0,1,0,11
India,17/12/2006,6,0,0,0,3,3,0,12
India,18/12/2006,6,0,0,0,7,0,0,13
India,19/12/2006,23,0,0,0,-2,3,0,24
India,20/12/2006,27,0,0,0,11,3,0,41
India,21/12/2006,6,0,0,0,4,2,0,12
India,22/12/2006,19,0,1,0,2,4,0,26
India,23/12/2006,8,0,0,0,6,4,0,18
India,24/12/2006,8,0,0,0,0,0,0,8
India,25/12/2006,2,0,-2,0,0,-1,0,-1
India,26/12/2006,12,0,0,0,-2,1,0,11
India,27/12/2006,34,6,0,0,8,8,0,56
India,28/12/2006,12,2,0,0,-1,4,0,17
India,29/12/2006,16,0,2,0,-4,1,0,15
India,30/12/2006,11,0,0,0,3,2,0,16
India,31/12/2006,8,0,0,0,1,1,0,10
Iran,01/12/2006,26,0,0,0,7,1,0,34
Iran,02/12/2006,27,0,1,0,9,4,0,41
Iran,03/12/2006,25,0,0,0,0,1,0,26
Iran,04/12/2006,29,0,-9,0,6,2,0,28
Iran,05/12/2006,96,6,-8,0,14,4,0,112
Iran,06/12/2006,62,4,0,0,28,10,0,104
Iran,07/12/2006,42,8,0,0,3,10,0,63
Iran,08/12/2006,42,6,0,0,12,3,0,63
Iran,09/12/2006,17,0,-2,0,-1,5,0,19
Iran,10/12/2006,37,0,-3,0,-8,3,0,29
Iran,11/12/2006,52,0,-2,0,11,16,0,77
Iran,12/12/2006,66,0,-6,0,27,14,0,101
Iran,13/12/2006,64,0,3,0,-1,3,0,69
Iran,14/12/2006,33,0,-1,0,7,5,0,44
Iran,15/12/2006,44,2,2,0,18,3,0,69
Iran,16/12/2006,23,0,1,0,-2,2,0,24
Iran,17/12/2006,36,4,0,0,-7,0,0,33
Iran,18/12/2006,26,0,-2,0,23,0,0,47
Iran,19/12/2006,50,0,-2,0,20,3,0,71
Iran,20/12/2006,42,2,1,0,14,1,0,60
Iran,21/12/2006,18,2,1,0,18,2,0,41
Iran,22/12/2006,8,0,0,0,2,3,0,13
Iran,23/12/2006,35,4,0,0,13,0,0,52
Iran,24/12/2006,54,0,0,0,17,19,0,90
Iran,25/12/2006,31,0,1,0,42,0,0,74
Iran,26/12/2006,27,0,0,0,4,1,0,32
Iran,27/12/2006,32,2,1,0,18,4,0,57
Iran,28/12/2006,42,0,5,0,7,6,0,60
Iran,29/12/2006,21,0,3,0,-4,5,0,25
Iran,30/12/2006,47,0,1,0,36,7,0,91
Iran,31/12/2006,22,0,0,0,1,4,0,27
Iraq,01/12/2006,88,4,0,0,12,9,0,113
Iraq,02/12/2006,33,10,0,0,19,6,0,68
Iraq,03/12/2006,50,8,2,0,15,10,0,85
Iraq,04/12/2006,66,0,0,0,20,23,0,109
Iraq,05/12/2006,160,0,-2,0,18,12,0,188
Iraq,06/12/2006,130,0,4,0,17,21,0,172
Iraq,07/12/2006,132,4,-5,0,26,17,0,174
Iraq,08/12/2006,94,4,2,0,29,14,0,143
Iraq,09/12/2006,56,0,-3,0,11,13,0,77
Iraq,10/12/2006,49,2,1,0,-3,15,0,64
Iraq,11/12/2006,73,0,0,0,27,13,0,113
Iraq,12/12/2006,69,2,1,0,41,14,0,127
Iraq,13/12/2006,83,8,-3,0,14,23,0,125
Iraq,14/12/2006,80,8,-5,0,26,17,0,126
Iraq,15/12/2006,134,0,-3,0,24,2,0,157
Iraq,16/12/2006,107,0,1,0,11,3,0,122
Iraq,17/12/2006,40,0,-2,0,6,3,0,47
Iraq,18/12/2006,105,0,0,0,20,19,0,144
Iraq,19/12/2006,128,0,-4,0,17,6,0,147
Iraq,20/12/2006,151,0,-5,0,36,8,0,190
Iraq,21/12/2006,53,0,-2,0,13,10,0,74
Iraq,22/12/2006,80,0,0,0,16,4,0,100
Iraq,23/12/2006,76,0,0,0,33,9,0,118
Iraq,24/12/2006,57,0,0,0,-7,0,0,50
Iraq,25/12/2006,34,0,-1,0,65,3,0,101
Iraq,26/12/2006,49,0,0,0,15,0,0,64
Iraq,27/12/2006,79,0,4,0,18,13,0,114
Iraq,28/12/2006,109,2,5,0,13,13,0,142
Iraq,29/12/2006,118,0,-2,0,19,18,0,153
Iraq,30/12/2006,137,0,5,0,39,21,0,202
Iraq,31/12/2006,198,0,-1,0,35,25,0,257
Morocco,01/12/2006,5,0,0,0,0,0,0,5
Morocco,02/12/2006,0,0,0,0,9,1,0,10
Morocco,05/12/2006,3,0,0,0,0,0,0,3
Morocco,06/12/2006,2,0,0,0,0,0,0,2
Morocco,07/12/2006,0,0,0,0,0,0,0,0
Morocco,08/12/2006,0,0,0,0,0,0,0,0
Morocco,10/12/2006,0,0,0,0,0,0,0,0
Morocco,11/12/2006,0,0,0,0,0,0,0,0
Morocco,12/12/2006,2,0,0,0,0,0,0,2
Morocco,13/12/2006,0,0,0,0,6,0,0,6
Morocco,14/12/2006,24,0,0,0,0,0,0,24
Morocco,15/12/2006,9,0,0,0,0,0,0,9
Morocco,16/12/2006,9,0,0,0,6,0,0,15
Morocco,17/12/2006,12,0,0,0,0,0,0,12
Morocco,18/12/2006,9,0,0,0,0,0,0,9
Morocco,19/12/2006,0,0,0,0,0,0,0,0
Morocco,20/12/2006,0,0,0,0,0,0,0,0
Morocco,21/12/2006,6,0,0,0,9,0,0,15
Morocco,22/12/2006,2,0,0,0,6,0,0,8
Morocco,24/12/2006,0,0,0,0,0,0,0,0
Morocco,25/12/2006,-5,0,0,0,0,0,0,-5
Morocco,27/12/2006,0,0,0,0,0,0,0,0
Morocco,29/12/2006,0,0,0,0,0,0,0,0
Morocco,30/12/2006,0,0,0,0,6,1,0,7
Morocco,31/12/2006,12,0,0,0,6,0,0,18
Nigeria,01/12/2006,4,0,-2,0,6,0,0,8
Nigeria,02/12/2006,3,0,0,0,3,0,0,6
Nigeria,03/12/2006,5,0,0,0,12,4,0,21
Nigeria,04/12/2006,11,0,0,0,0,0,0,11
Nigeria,05/12/2006,-1,2,-2,0,-2,0,0,-3
Nigeria,06/12/2006,4,0,0,0,-1,1,0,4
Nigeria,07/12/2006,18,0,0,0,3,2,0,23
Nigeria,08/12/2006,11,0,0,0,9,0,0,20
Nigeria,09/12/2006,12,0,0,0,0,0,0,12
Nigeria,10/12/2006,1,0,-2,0,0,0,0,-1
Nigeria,11/12/2006,8,0,0,0,5,2,0,15
Nigeria,12/12/2006,9,0,0,0,6,3,0,18
Nigeria,13/12/2006,8,0,1,0,3,1,0,13
Nigeria,14/12/2006,1,0,0,0,10,2,0,13
Nigeria,15/12/2006,26,0,0,0,0,1,0,27
Nigeria,16/12/2006,7,0,0,0,0,1,0,8
Nigeria,17/12/2006,11,0,0,0,9,2,0,22
Nigeria,18/12/2006,27,0,0,0,6,0,0,33
Nigeria,19/12/2006,14,0,0,0,5,4,0,23
Nigeria,20/12/2006,4,0,0,0,6,7,0,17
Nigeria,21/12/2006,10,0,0,0,3,1,0,14
Nigeria,22/12/2006,17,0,0,0,1,3,0,21
Nigeria,23/12/2006,8,0,0,0,9,0,0,17
Nigeria,24/12/2006,19,0,0,0,9,2,0,30
Nigeria,25/12/2006,26,0,0,0,9,11,0,46
Nigeria,26/12/2006,21,0,2,0,3,4,0,30
Nigeria,27/12/2006,7,4,0,0,1,1,0,13
Nigeria,28/12/2006,13,0,0,0,2,5,0,20
Nigeria,29/12/2006,2,0,0,0,0,0,0,2
Nigeria,30/12/2006,3,0,0,0,0,0,0,3
Nigeria,31/12/2006,13,0,0,0,2,0,0,15
Pakistan,01/12/2006,37,0,0,0,21,4,0,62
Pakistan,02/12/2006,16,0,0,0,0,4,0,20
Pakistan,03/12/2006,11,0,0,0,1,2,0,14
Pakistan,04/12/2006,8,0,0,0,3,0,0,11
Pakistan,05/12/2006,25,0,0,0,15,4,0,44
Pakistan,06/12/2006,23,0,0,0,3,3,0,29
Pakistan,07/12/2006,21,0,0,0,-4,16,0,33
Pakistan,08/12/2006,49,0,3,0,3,13,0,68
Pakistan,09/12/2006,23,0,2,0,7,0,0,32
Pakistan,10/12/2006,39,0,5,0,22,1,0,67
Pakistan,11/12/2006,18,0,0,0,3,0,0,21
Pakistan,12/12/2006,25,0,0,0,-1,2,0,26
Pakistan,13/12/2006,27,0,0,0,14,7,0,48
Pakistan,14/12/2006,15,0,1,0,9,2,0,27
Pakistan,15/12/2006,42,0,0,0,1,0,0,43
Pakistan,16/12/2006,17,0,0,0,10,0,0,27
Pakistan,17/12/2006,12,0,0,0,1,5,0,18
Pakistan,18/12/2006,17,0,0,0,-6,6,0,17
Pakistan,19/12/2006,18,0,0,0,6,3,0,27
Pakistan,20/12/2006,9,0,0,0,12,0,0,21
Pakistan,21/12/2006,5,0,0,0,7,0,0,12
Pakistan,22/12/2006,21,0,0,0,3,0,0,24
Pakistan,23/12/2006,56,0,0,0,6,0,0,62
Pakistan,24/12/2006,56,0,0,0,21,1,0,78
Pakistan,25/12/2006,34,0,0,0,18,1,0,53
Pakistan,26/12/2006,15,0,0,0,27,0,0,42
Pakistan,27/12/2006,22,0,0,0,0,0,0,22
Pakistan,28/12/2006,8,0,0,0,12,0,0,20
Pakistan,29/12/2006,7,0,0,0,24,0,0,31
Pakistan,30/12/2006,11,0,0,0,6,0,0,17
Pakistan,31/12/2006,18,0,0,0,12,0,0,30
Sierra Leone,01/12/2006,0,0,0,0,0,0,0,0
Sierra Leone,04/12/2006,0,0,0,0,0,0,0,0
Sierra Leone,05/12/2006,3,0,0,0,0,0,0,3
Sierra Leone,06/12/2006,2,0,0,0,6,0,0,8
Sierra Leone,07/12/2006,2,0,0,0,18,0,0,20
Sierra Leone,08/12/2006,0,0,0,0,8,0,0,8
Sierra Leone,09/12/2006,-3,0,0,0,6,0,0,3
Sierra Leone,10/12/2006,2,0,0,0,0,0,0,2
Sierra Leone,11/12/2006,0,0,0,0,0,0,0,0
Sierra Leone,12/12/2006,2,0,0,0,0,0,0,2
Sierra Leone,14/12/2006,3,0,0,0,0,1,0,4
Sierra Leone,15/12/2006,3,0,0,0,0,0,0,3
Sierra Leone,16/12/2006,0,0,0,0,0,0,0,0
Sierra Leone,17/12/2006,0,0,0,0,0,0,0,0
Sierra Leone,18/12/2006,1,0,0,0,3,0,0,4
Sierra Leone,19/12/2006,0,0,0,0,0,0,0,0
Sierra Leone,20/12/2006,0,0,0,0,0,0,0,0
Sierra Leone,21/12/2006,9,0,0,0,0,0,0,9
Sierra Leone,22/12/2006,1,0,0,0,0,0,0,1
Sierra Leone,23/12/2006,1,0,0,0,0,0,0,1
Sierra Leone,24/12/2006,3,0,0,0,-2,0,0,1
Sierra Leone,27/12/2006,0,0,0,0,0,0,0,0
Sierra Leone,28/12/2006,0,0,0,0,0,1,0,1
Sierra Leone,29/12/2006,4,0,0,0,3,0,0,7
Sierra Leone,30/12/2006,0,0,0,0,3,0,0,3
Sierra Leone,31/12/2006,0,0,0,0,0,0,0,0
Somalia,01/12/2006,9,0,0,0,0,1,0,10
Somalia,02/12/2006,3,0,0,0,3,0,0,6
Somalia,03/12/2006,2,0,0,0,0,0,0,2
Somalia,04/12/2006,14,0,0,0,11,3,0,28
Somalia,05/12/2006,30,2,1,0,2,0,0,35
Somalia,06/12/2006,3,0,0,0,0,0,0,3
Somalia,07/12/2006,67,4,0,0,9,0,0,80
Somalia,08/12/2006,12,0,0,0,4,0,0,16
Somalia,09/12/2006,7,0,0,0,0,0,0,7
Somalia,10/12/2006,0,0,0,0,18,0,0,18
Somalia,11/12/2006,6,2,0,0,-2,0,0,6
Somalia,12/12/2006,5,0,0,0,0,0,0,5
Somalia,13/12/2006,13,0,0,0,0,0,0,13
Somalia,14/12/2006,6,2,0,0,0,0,0,8
Somalia,15/12/2006,11,0,0,0,-4,0,0,7
Somalia,16/12/2006,3,0,0,0,0,2,0,5
Somalia,17/12/2006,11,0,0,0,0,0,0,11
Somalia,18/12/2006,4,0,0,0,0,0,0,4
Somalia,19/12/2006,1,0,0,0,-2,0,0,-1
Somalia,20/12/2006,18,0,0,0,18,0,0,36
Somalia,21/12/2006,11,0,0,0,6,5,0,22
Somalia,22/12/2006,8,0,0,0,0,0,0,8
Somalia,23/12/2006,25,0,0,0,0,0,0,25
Somalia,24/12/2006,5,0,0,0,0,0,0,5
Somalia,25/12/2006,15,0,0,0,3,0,0,18
Somalia,26/12/2006,36,0,0,0,3,0,0,39
Somalia,27/12/2006,45,8,3,0,1,0,0,57
Somalia,28/12/2006,28,2,-1,0,10,2,0,41
Somalia,29/12/2006,17,0,0,0,7,2,0,26
Somalia,30/12/2006,2,0,0,0,0,0,0,2
Somalia,31/12/2006,-6,0,0,0,0,0,0,-6
Syria,01/12/2006,51,0,-2,0,0,12,0,61
Syria,02/12/2006,16,0,3,0,6,4,0,29
Syria,03/12/2006,34,0,0,0,-2,1,0,33
Syria,04/12/2006,60,0,0,0,5,8,0,73
Syria,05/12/2006,34,4,2,0,9,7,0,56
Syria,06/12/2006,27,0,0,0,9,3,0,39
Syria,07/12/2006,61,0,0,0,27,18,0,106
Syria,08/12/2006,27,0,2,0,2,12,0,43
Syria,09/12/2006,6,0,2,0,18,6,0,32
Syria,10/12/2006,36,0,0,0,46,9,0,91
Syria,11/12/2006,8,0,-3,0,0,3,0,8
Syria,12/12/2006,10,0,0,0,22,-8,0,24
Syria,13/12/2006,10,0,-2,0,6,5,0,19
Syria,14/12/2006,31,0,0,0,15,3,0,49
Syria,15/12/2006,20,0,0,0,12,2,0,34
Syria,16/12/2006,20,0,1,0,0,1,0,22
Syria,17/12/2006,25,2,0,0,0,0,0,27
Syria,18/12/2006,15,0,1,0,0,1,0,17
Syria,19/12/2006,25,0,0,0,7,2,0,34
Syria,20/12/2006,5,2,-2,0,12,1,0,18
Syria,21/12/2006,17,4,0,0,24,0,0,45
Syria,22/12/2006,3,0,0,0,0,0,0,3
Syria,23/12/2006,5,0,0,0,0,1,0,6
Syria,24/12/2006,12,0,-4,0,-4,0,0,4
Syria,25/12/2006,4,0,1,0,0,0,0,5
Syria,26/12/2006,14,0,-2,0,3,0,0,15
Syria,27/12/2006,4,0,-2,0,3,1,0,6
Syria,28/12/2006,6,0,0,0,3,0,0,9
Syria,29/12/2006,5,0,-2,0,3,0,0,6
Syria,30/12/2006,12,0,0,0,0,0,0,12
Syria,31/12/2006,12,0,0,0,0,0,0,12
Yemen,01/12/2006,3,0,0,0,7,0,0,10
Yemen,02/12/2006,3,0,0,0,0,0,0,3
Yemen,03/12/2006,7,0,0,0,0,0,0,7
Yemen,04/12/2006,0,0,0,0,0,0,0,0
Yemen,05/12/2006,7,0,1,0,3,2,0,13
Yemen,06/12/2006,5,0,0,0,36,0,0,41
Yemen,07/12/2006,9,0,0,0,9,0,0,18
Yemen,08/12/2006,5,0,0,0,8,1,0,14
Yemen,09/12/2006,-1,0,0,0,0,0,0,-1
Yemen,10/12/2006,4,0,0,0,6,2,0,12
Yemen,11/12/2006,0,0,0,0,-2,0,0,-2
Yemen,12/12/2006,2,0,0,0,0,0,0,2
Yemen,13/12/2006,-1,0,0,0,6,0,0,5
Yemen,14/12/2006,4,0,0,0,12,0,0,16
Yemen,15/12/2006,4,0,0,0,0,3,0,7
Yemen,16/12/2006,4,0,0,0,6,0,0,10
Yemen,17/12/2006,-3,0,0,0,-1,0,0,-4
Yemen,18/12/2006,-1,0,0,0,-4,0,0,-5
Yemen,19/12/2006,-6,0,0,0,-4,0,0,-10
Yemen,20/12/2006,6,2,0,0,9,0,0,17
Yemen,21/12/2006,0,0,0,0,0,0,0,0
Yemen,23/12/2006,0,0,0,0,0,0,0,0
Yemen,24/12/2006,0,0,0,0,0,0,0,0
Yemen,25/12/2006,2,0,0,0,0,0,0,2
Yemen,26/12/2006,1,0,0,0,0,0,0,1
Yemen,27/12/2006,6,0,0,0,12,0,0,18
Yemen,28/12/2006,28,0,0,0,12,0,0,40
Yemen,29/12/2006,27,0,0,0,15,0,0,42
Yemen,30/12/2006,4,0,0,0,0,0,0,4
Yemen,31/12/2006,3,0,0,0,0,0,0,3
Afghanistan,01/09/2008,164,0,1,0,8,9,0,182
Afghanistan,02/09/2008,54,0,-3,0,12,3,0,66
Afghanistan,03/09/2008,33,0,0,0,3,1,0,37
Afghanistan,04/09/2008,82,0,0,0,10,3,0,95
Afghanistan,05/09/2008,58,0,0,0,12,4,0,74
Afghanistan,06/09/2008,26,0,1,0,3,4,0,34
Afghanistan,07/09/2008,258,0,3,0,5,66,0,332
Afghanistan,08/09/2008,132,0,0,0,21,15,0,168
Afghanistan,09/09/2008,300,0,-5,0,47,30,0,372
Afghanistan,10/09/2008,294,0,-2,0,25,16,0,333
Afghanistan,11/09/2008,347,6,0,0,31,44,0,428
Afghanistan,12/09/2008,294,2,0,0,26,8,0,330
Afghanistan,13/09/2008,132,0,0,0,24,17,0,173
Afghanistan,14/09/2008,172,4,0,0,7,21,0,204
Afghanistan,15/09/2008,223,0,0,0,-1,11,0,233
Afghanistan,16/09/2008,265,0,-2,0,81,10,0,354
Afghanistan,17/09/2008,214,0,-1,0,-4,6,0,215
Afghanistan,18/09/2008,129,0,-3,0,28,8,0,162
Afghanistan,19/09/2008,58,0,-1,0,13,0,0,70
Afghanistan,20/09/2008,161,0,0,0,18,14,0,193
Afghanistan,21/09/2008,119,0,-2,0,16,5,0,138
Afghanistan,22/09/2008,279,0,-3,0,70,48,0,394
Afghanistan,23/09/2008,188,0,0,0,74,22,0,284
Afghanistan,24/09/2008,108,0,-3,0,53,13,0,171
Afghanistan,25/09/2008,171,4,4,0,21,11,0,211
Afghanistan,26/09/2008,200,2,-6,0,36,25,0,257
Afghanistan,27/09/2008,82,0,0,0,2,3,0,87
Afghanistan,28/09/2008,143,0,0,0,24,10,0,177
Afghanistan,29/09/2008,232,0,0,0,8,25,0,265
Afghanistan,30/09/2008,223,6,0,0,-1,4,0,232
Albania,01/09/2008,0,2,0,0,0,0,0,2
Albania,02/09/2008,6,0,0,0,0,0,0,6
Albania,04/09/2008,12,0,0,0,0,0,0,12
Albania,05/09/2008,2,0,0,0,-2,1,0,1
Albania,06/09/2008,4,0,0,0,6,0,0,10
Albania,07/09/2008,0,0,0,0,0,0,0,0
Albania,08/09/2008,4,0,0,0,9,2,0,15
Albania,09/09/2008,5,0,0,0,3,3,0,11
Albania,10/09/2008,4,0,0,0,0,0,0,4
Albania,11/09/2008,6,0,-1,0,4,0,0,9
Albania,12/09/2008,1,0,-2,0,12,0,0,11
Albania,13/09/2008,5,0,0,0,0,0,0,5
Albania,14/09/2008,14,0,0,0,-2,0,0,12
Albania,15/09/2008,5,0,0,0,0,0,0,5
Albania,16/09/2008,6,0,1,0,0,0,0,7
Albania,17/09/2008,6,0,0,0,0,0,0,6
Albania,18/09/2008,9,0,0,0,0,1,0,10
Albania,19/09/2008,0,0,0,0,3,0,0,3
Albania,20/09/2008,7,0,0,0,3,0,0,10
Albania,21/09/2008,3,0,0,0,6,0,0,9
Albania,22/09/2008,1,0,0,0,0,0,0,1
Albania,23/09/2008,0,0,0,0,0,0,0,0
Albania,24/09/2008,0,0,0,0,9,0,0,9
Albania,25/09/2008,12,0,0,0,-2,0,0,10
Albania,26/09/2008,3,0,0,0,0,0,0,3
Albania,27/09/2008,7,0,0,0,0,0,0,7
Albania,28/09/2008,8,0,0,0,0,0,0,8
Albania,29/09/2008,6,0,0,0,3,0,0,9
Albania,30/09/2008,10,0,-2,0,0,2,0,10
Algeria,01/09/2008,0,0,0,0,0,6,0,6
Algeria,02/09/2008,1,0,0,0,0,0,0,1
Algeria,03/09/2008,0,0,0,0,0,0,0,0
Algeria,04/09/2008,0,0,0,0,0,0,0,0
Algeria,05/09/2008,0,0,0,0,0,0,0,0
Algeria,06/09/2008,1,0,0,0,0,0,0,1
Algeria,07/09/2008,57,0,0,0,3,1,0,61
Algeria,08/09/2008,3,0,0,0,0,0,0,3
Algeria,09/09/2008,2,0,0,0,0,0,0,2
Algeria,10/09/2008,0,0,0,0,3,0,0,3
Algeria,11/09/2008,4,0,0,0,1,0,0,5
Algeria,12/09/2008,3,0,0,0,12,0,0,15
Algeria,13/09/2008,0,0,0,0,0,0,0,0
Algeria,14/09/2008,0,0,0,0,0,0,0,0
Algeria,15/09/2008,5,0,0,0,6,0,0,11
Algeria,16/09/2008,3,0,0,0,0,0,0,3
Algeria,17/09/2008,5,0,0,0,0,0,0,5
Algeria,18/09/2008,1,0,0,0,0,0,0,1
Algeria,19/09/2008,1,0,0,0,0,0,0,1
Algeria,20/09/2008,12,2,0,0,3,0,0,17
Algeria,21/09/2008,6,0,0,0,-2,0,0,4
Algeria,22/09/2008,6,0,0,0,3,0,0,9
Algeria,23/09/2008,6,0,0,0,0,0,0,6
Algeria,24/09/2008,5,0,-2,0,3,0,0,6
Algeria,25/09/2008,7,0,0,0,0,0,0,7
Algeria,26/09/2008,0,0,0,0,0,0,0,0
Algeria,27/09/2008,0,0,0,0,0,0,0,0
Algeria,28/09/2008,4,0,0,0,0,0,0,4
Algeria,29/09/2008,5,0,0,0,0,0,0,5
Algeria,30/09/2008,4,0,0,0,-8,0,0,-4
Bangladesh,01/09/2008,4,0,7,0,4,0,0,15
Bangladesh,02/09/2008,-2,0,0,0,30,0,0,28
Bangladesh,03/09/2008,0,0,0,0,6,2,0,8
Bangladesh,04/09/2008,3,0,2,0,-4,0,0,1
Bangladesh,05/09/2008,17,0,0,0,0,0,0,17
Bangladesh,07/09/2008,17,0,0,0,-4,4,0,17
Bangladesh,08/09/2008,0,0,0,0,3,2,0,5
Bangladesh,09/09/2008,6,0,0,0,9,0,0,15
Bangladesh,10/09/2008,2,0,0,0,-2,6,0,6
Bangladesh,11/09/2008,12,2,0,0,-1,0,0,13
Bangladesh,12/09/2008,2,0,-2,0,-11,0,0,-11
Bangladesh,13/09/2008,0,0,0,0,14,1,0,15
Bangladesh,14/09/2008,6,0,0,0,-1,2,0,7
Bangladesh,15/09/2008,8,0,0,0,-10,0,0,-2
Bangladesh,16/09/2008,1,0,0,0,0,2,0,3
Bangladesh,17/09/2008,0,0,0,0,-10,0,0,-10
Bangladesh,18/09/2008,6,0,0,0,12,2,0,20
Bangladesh,19/09/2008,8,0,0,0,21,0,0,29
Bangladesh,20/09/2008,1,0,0,0,5,0,0,6
Bangladesh,21/09/2008,-2,0,-4,0,10,1,0,5
Bangladesh,22/09/2008,-1,0,0,0,3,0,0,2
Bangladesh,23/09/2008,2,0,0,0,12,1,0,15
Bangladesh,24/09/2008,-2,0,0,0,9,0,0,7
Bangladesh,25/09/2008,0,0,0,0,12,0,0,12
Bangladesh,26/09/2008,16,0,0,0,6,0,0,22
Bangladesh,27/09/2008,1,0,0,0,0,0,0,1
Bangladesh,28/09/2008,0,0,0,0,0,0,0,0
Bangladesh,29/09/2008,3,0,2,0,14,0,0,19
Bangladesh,30/09/2008,4,0,0,0,9,1,0,14
Cameroon,01/09/2008,0,0,0,0,0,0,0,0
Cameroon,07/09/2008,0,0,-4,0,0,0,0,-4
Cameroon,08/09/2008,0,0,0,0,0,0,0,0
Cameroon,09/09/2008,0,0,0,0,0,0,0,0
Cameroon,10/09/2008,0,0,0,0,0,0,0,0
Cameroon,11/09/2008,0,0,0,0,0,0,0,0
Cameroon,12/09/2008,0,0,0,0,0,0,0,0
Cameroon,15/09/2008,0,0,0,0,0,0,0,0
Cameroon,16/09/2008,0,0,0,0,0,0,0,0
Cameroon,18/09/2008,2,0,0,0,0,0,0,2
Cameroon,19/09/2008,0,0,0,0,3,0,0,3
Cameroon,20/09/2008,0,0,0,0,0,0,0,0
Cameroon,24/09/2008,3,0,0,0,3,0,0,6
Cameroon,26/09/2008,10,0,0,0,0,0,0,10
Cameroon,28/09/2008,0,0,0,0,0,0,0,0
Cameroon,29/09/2008,1,0,0,0,0,0,0,1
Cameroon,30/09/2008,0,0,0,0,0,0,0,0
China,01/09/2008,61,0,-6,0,32,3,0,90
China,02/09/2008,37,0,1,0,51,6,0,95
China,03/09/2008,30,0,0,0,9,0,0,39
China,04/09/2008,9,0,0,0,-2,3,0,10
China,05/09/2008,8,0,0,0,6,-2,0,12
China,06/09/2008,1,0,-1,0,0,0,0,0
China,07/09/2008,45,0,-1,0,9,3,0,56
China,08/09/2008,15,2,0,0,22,0,0,39
China,09/09/2008,100,0,-2,0,20,10,0,128
China,10/09/2008,50,2,1,0,20,16,0,89
China,11/09/2008,63,4,-1,0,9,12,0,87
China,12/09/2008,31,0,-2,0,49,12,0,90
China,13/09/2008,58,6,0,0,35,7,0,106
China,14/09/2008,44,2,0,0,23,5,0,74
China,15/09/2008,39,0,-8,0,53,13,0,97
China,16/09/2008,52,0,0,0,29,2,0,83
China,17/09/2008,55,2,-5,0,22,3,0,77
China,18/09/2008,28,0,-2,0,18,7,0,51
China,19/09/2008,55,0,2,0,56,15,0,128
China,20/09/2008,28,0,0,0,6,1,0,35
China,21/09/2008,43,0,0,0,9,2,0,54
China,22/09/2008,127,0,1,0,36,2,0,166
China,23/09/2008,16,6,0,0,51,1,0,74
China,24/09/2008,68,4,-2,0,75,4,0,149
China,25/09/2008,42,2,-6,0,69,3,0,110
China,26/09/2008,59,0,-2,0,36,2,0,95
China,27/09/2008,-6,0,0,0,1,0,0,-5
China,28/09/2008,23,0,0,0,9,12,0,44
China,29/09/2008,19,0,0,0,18,9,0,46
China,30/09/2008,56,6,0,0,27,8,0,97
Egypt,01/09/2008,23,0,1,0,8,0,0,32
Egypt,02/09/2008,9,0,0,0,4,1,0,14
Egypt,03/09/2008,10,0,2,0,1,2,0,15
Egypt,04/09/2008,3,0,0,0,0,0,0,3
Egypt,05/09/2008,3,0,0,0,3,0,0,6
Egypt,06/09/2008,4,0,0,0,3,0,0,7
Egypt,07/09/2008,79,0,-1,0,9,22,0,109
Egypt,08/09/2008,5,0,0,0,3,0,0,8
Egypt,09/09/2008,4,0,0,0,-3,2,0,3
Egypt,10/09/2008,15,0,0,0,4,5,0,24
Egypt,11/09/2008,25,0,0,0,1,2,0,28
Egypt,12/09/2008,9,0,0,0,4,4,0,17
Egypt,13/09/2008,8,0,0,0,0,4,0,12
Egypt,14/09/2008,10,0,1,0,2,0,0,13
Egypt,15/09/2008,32,0,0,0,9,0,0,41
Egypt,16/09/2008,17,0,0,0,3,2,0,22
Egypt,17/09/2008,6,0,0,0,3,2,0,11
Egypt,18/09/2008,47,0,1,0,1,3,0,52
Egypt,19/09/2008,3,0,0,0,13,0,0,16
Egypt,20/09/2008,11,0,0,0,9,2,0,22
Egypt,21/09/2008,11,0,0,0,12,0,0,23
Egypt,22/09/2008,50,0,0,0,73,7,0,130
Egypt,23/09/2008,9,0,0,0,8,2,0,19
Egypt,24/09/2008,48,0,0,0,22,4,0,74
Egypt,25/09/2008,54,0,0,0,30,4,0,88
Egypt,26/09/2008,9,0,0,0,14,0,0,23
Egypt,27/09/2008,14,0,0,0,-4,0,0,10
Egypt,28/09/2008,35,0,0,0,17,4,0,56
Egypt,29/09/2008,36,0,0,0,56,11,0,103
Egypt,30/09/2008,30,0,0,0,42,10,0,82
Eritrea,01/09/2008,11,0,0,0,-4,0,0,7
Eritrea,02/09/2008,0,0,0,0,0,0,0,0
Eritrea,03/09/2008,3,0,0,0,0,0,0,3
Eritrea,06/09/2008,0,0,0,0,0,0,0,0
Eritrea,07/09/2008,0,0,0,0,0,0,0,0
Eritrea,09/09/2008,0,0,0,0,3,0,0,3
Eritrea,10/09/2008,4,0,0,0,0,0,0,4
Eritrea,12/09/2008,0,0,0,0,0,0,0,0
Eritrea,13/09/2008,0,0,0,0,3,0,0,3
Eritrea,15/09/2008,-2,0,0,0,0,0,0,-2
Eritrea,18/09/2008,4,0,0,0,-4,0,0,0
Eritrea,19/09/2008,3,0,0,0,0,0,0,3
Eritrea,20/09/2008,0,0,0,0,0,0,0,0
Eritrea,22/09/2008,0,0,0,0,0,0,0,0
Eritrea,23/09/2008,0,0,0,0,0,0,0,0
Eritrea,24/09/2008,6,0,0,0,3,0,0,9
Eritrea,25/09/2008,6,0,0,0,3,0,0,9
Eritrea,26/09/2008,0,0,0,0,0,0,0,0
Eritrea,28/09/2008,5,0,0,0,0,2,0,7
Eritrea,29/09/2008,-1,0,0,0,0,0,0,-1
Eritrea,30/09/2008,-1,0,0,0,0,0,0,-1
Georgia,01/09/2008,15,0,0,0,15,1,0,31
Georgia,02/09/2008,6,0,0,0,3,1,0,10
Georgia,03/09/2008,0,0,0,0,0,0,0,0
Georgia,04/09/2008,-1,0,0,0,0,0,0,-1
Georgia,05/09/2008,3,0,0,0,0,0,0,3
Georgia,06/09/2008,-1,0,0,0,0,0,0,-1
Georgia,07/09/2008,5,0,0,0,6,5,0,16
Georgia,08/09/2008,-1,0,0,0,0,2,0,1
Georgia,09/09/2008,18,0,-2,0,4,1,0,21
Georgia,10/09/2008,2,0,0,0,5,0,0,7
Georgia,11/09/2008,7,0,0,0,7,0,0,14
Georgia,12/09/2008,21,0,0,0,0,1,0,22
Georgia,13/09/2008,-2,0,0,0,2,4,0,4
Georgia,14/09/2008,7,0,0,0,0,0,0,7
Georgia,15/09/2008,11,0,0,0,-2,1,0,10
Georgia,16/09/2008,6,0,-2,0,1,0,0,5
Georgia,17/09/2008,5,0,0,0,0,2,0,7
Georgia,18/09/2008,6,0,0,0,0,0,0,6
Georgia,19/09/2008,9,0,0,0,0,2,0,11
Georgia,20/09/2008,2,0,0,0,0,0,0,2
Georgia,21/09/2008,0,0,0,0,0,0,0,0
Georgia,22/09/2008,2,0,0,0,0,0,0,2
Georgia,23/09/2008,9,0,0,0,0,0,0,9
Georgia,24/09/2008,6,0,0,0,-5,1,0,2
Georgia,25/09/2008,8,0,0,0,9,2,0,19
Georgia,26/09/2008,-1,0,0,0,3,2,0,4
Georgia,27/09/2008,2,0,0,0,3,1,0,6
Georgia,28/09/2008,7,0,0,0,0,0,0,7
Georgia,29/09/2008,15,2,0,0,3,0,0,20
Georgia,30/09/2008,7,0,0,0,-2,0,0,5
India,01/09/2008,35,0,1,0,6,3,0,45
India,02/09/2008,33,0,-1,0,1,9,0,42
India,03/09/2008,0,0,0,0,0,0,0,0
India,04/09/2008,0,0,0,0,0,1,0,1
India,05/09/2008,-1,0,0,0,3,1,0,3
India,06/09/2008,9,0,0,0,0,0,0,9
India,07/09/2008,40,0,0,0,10,9,0,59
India,08/09/2008,9,0,0,0,9,3,0,21
India,09/09/2008,41,0,1,0,34,4,0,80
India,10/09/2008,45,0,1,0,10,3,0,59
India,11/09/2008,16,4,1,0,9,2,0,32
India,12/09/2008,6,0,0,0,11,0,0,17
India,13/09/2008,19,4,0,0,7,5,0,35
India,14/09/2008,16,2,0,0,1,0,0,19
India,15/09/2008,45,0,-1,0,3,4,0,51
India,16/09/2008,29,0,0,0,4,1,0,34
India,17/09/2008,26,0,0,0,9,0,0,35
India,18/09/2008,14,0,0,0,0,0,0,14
India,19/09/2008,23,0,0,0,3,2,0,28
India,20/09/2008,21,0,0,0,0,0,0,21
India,21/09/2008,33,0,0,0,0,0,0,33
India,22/09/2008,21,0,0,0,0,1,0,22
India,23/09/2008,14,0,0,0,14,1,0,29
India,24/09/2008,10,0,0,0,7,1,0,18
India,25/09/2008,18,2,-1,0,3,1,0,23
India,26/09/2008,0,0,-5,0,0,0,0,-5
India,27/09/2008,24,0,0,0,9,5,0,38
India,28/09/2008,21,0,0,0,4,4,0,29
India,29/09/2008,31,0,-2,0,1,10,0,40
India,30/09/2008,61,2,1,0,10,21,0,95
Iran,01/09/2008,10,0,-2,0,19,16,0,43
Iran,02/09/2008,45,0,0,0,49,2,0,96
Iran,03/09/2008,4,0,0,0,-1,0,0,3
Iran,04/09/2008,4,0,0,0,3,0,0,7
Iran,05/09/2008,1,0,0,0,8,2,0,11
Iran,06/09/2008,7,0,0,0,0,2,0,9
Iran,07/09/2008,26,0,-2,0,-8,4,0,20
Iran,08/09/2008,19,0,0,0,6,0,0,25
Iran,09/09/2008,35,4,-2,0,7,4,0,48
Iran,10/09/2008,44,4,0,0,29,23,0,100
Iran,11/09/2008,62,0,0,0,12,1,0,75
Iran,12/09/2008,20,0,1,0,10,10,0,41
Iran,13/09/2008,27,4,0,0,27,0,0,58
Iran,14/09/2008,34,0,0,0,3,4,0,41
Iran,15/09/2008,68,0,3,0,4,9,0,84
Iran,16/09/2008,20,0,2,0,-7,10,0,25
Iran,17/09/2008,21,0,-1,0,6,5,0,31
Iran,18/09/2008,42,0,0,0,18,4,0,64
Iran,19/09/2008,25,0,-1,0,0,0,0,24
Iran,20/09/2008,19,0,0,0,9,4,0,32
Iran,21/09/2008,24,2,-4,0,0,0,0,22
Iran,22/09/2008,20,0,1,0,24,6,0,51
Iran,23/09/2008,118,4,0,0,13,13,0,148
Iran,24/09/2008,47,0,1,0,7,0,0,55
Iran,25/09/2008,31,0,-7,0,7,6,0,37
Iran,26/09/2008,66,0,-4,0,-3,0,0,59
Iran,27/09/2008,54,0,0,0,5,9,0,68
Iran,28/09/2008,28,0,0,0,9,0,0,37
Iran,29/09/2008,24,6,0,0,2,0,0,32
Iran,30/09/2008,30,0,0,0,3,2,0,35
Iraq,01/09/2008,141,6,4,0,32,12,0,195
Iraq,02/09/2008,51,6,2,0,37,9,0,105
Iraq,03/09/2008,19,0,0,0,5,7,0,31
Iraq,04/09/2008,10,0,1,0,4,2,0,17
Iraq,05/09/2008,7,0,0,0,9,0,0,16
Iraq,06/09/2008,4,0,0,0,0,2,0,6
Iraq,07/09/2008,111,0,3,0,25,11,0,150
Iraq,08/09/2008,29,0,0,0,3,7,0,39
Iraq,09/09/2008,144,2,-5,0,37,30,0,208
Iraq,10/09/2008,111,0,0,0,17,17,0,145
Iraq,11/09/2008,94,2,1,0,39,12,0,148
Iraq,12/09/2008,63,2,0,0,21,7,0,93
Iraq,13/09/2008,65,0,2,0,34,24,0,125
Iraq,14/09/2008,49,0,2,0,11,14,0,76
Iraq,15/09/2008,55,0,-1,0,26,10,0,90
Iraq,16/09/2008,72,0,-2,0,30,8,0,108
Iraq,17/09/2008,55,0,0,0,26,17,0,98
Iraq,18/09/2008,46,0,0,0,16,21,0,83
Iraq,19/09/2008,43,0,0,0,9,6,0,58
Iraq,20/09/2008,36,0,0,0,0,5,0,41
Iraq,21/09/2008,54,4,-4,0,1,0,0,55
Iraq,22/09/2008,70,0,-8,0,-1,5,0,66
Iraq,23/09/2008,85,0,-6,0,22,0,0,101
Iraq,24/09/2008,32,6,0,0,43,2,0,83
Iraq,25/09/2008,129,2,1,0,28,13,0,173
Iraq,26/09/2008,86,0,0,0,-2,6,0,90
Iraq,27/09/2008,112,0,0,0,-5,8,0,115
Iraq,28/09/2008,37,0,2,0,9,4,0,52
Iraq,29/09/2008,95,0,-5,0,20,11,0,121
Iraq,30/09/2008,88,0,-1,0,35,5,0,127
Morocco,01/09/2008,0,0,0,0,0,0,0,0
Morocco,02/09/2008,-2,0,0,0,6,0,0,4
Morocco,03/09/2008,0,0,0,0,4,0,0,4
Morocco,04/09/2008,0,0,0,0,0,0,0,0
Morocco,05/09/2008,0,0,0,0,0,0,0,0
Morocco,06/09/2008,0,0,0,0,0,0,0,0
Morocco,07/09/2008,7,0,0,0,1,0,0,8
Morocco,08/09/2008,0,0,0,0,0,0,0,0
Morocco,09/09/2008,3,0,0,0,0,0,0,3
Morocco,10/09/2008,0,0,0,0,-4,0,0,-4
Morocco,11/09/2008,1,0,0,0,0,0,0,1
Morocco,12/09/2008,0,0,0,0,0,0,0,0
Morocco,13/09/2008,3,0,0,0,0,0,0,3
Morocco,14/09/2008,0,0,0,0,0,0,0,0
Morocco,15/09/2008,2,0,0,0,0,0,0,2
Morocco,16/09/2008,0,0,0,0,3,0,0,3
Morocco,17/09/2008,0,0,0,0,3,3,0,6
Morocco,18/09/2008,-2,0,0,0,0,0,0,-2
Morocco,19/09/2008,1,0,0,0,0,0,0,1
Morocco,20/09/2008,0,0,0,0,0,0,0,0
Morocco,21/09/2008,0,0,0,0,0,0,0,0
Morocco,22/09/2008,8,0,0,0,0,0,0,8
Morocco,23/09/2008,0,0,0,0,0,0,0,0
Morocco,24/09/2008,0,0,0,0,3,0,0,3
Morocco,25/09/2008,1,0,0,0,1,0,0,2
Morocco,26/09/2008,3,0,0,0,0,0,0,3
Morocco,27/09/2008,0,0,0,0,0,0,0,0
Morocco,28/09/2008,0,0,0,0,3,0,0,3
Morocco,29/09/2008,2,0,0,0,0,0,0,2
Morocco,30/09/2008,0,0,0,0,-8,0,0,-8
Nigeria,01/09/2008,14,0,0,0,6,3,0,23
Nigeria,02/09/2008,14,0,0,0,6,0,0,20
Nigeria,03/09/2008,1,0,0,0,0,0,0,1
Nigeria,04/09/2008,0,0,0,0,0,0,0,0
Nigeria,05/09/2008,0,0,-2,0,0,0,0,-2
Nigeria,06/09/2008,0,0,0,0,0,0,0,0
Nigeria,07/09/2008,6,0,0,0,9,1,0,16
Nigeria,08/09/2008,0,0,0,0,6,0,0,6
Nigeria,09/09/2008,1,0,1,0,6,1,0,9
Nigeria,10/09/2008,5,0,0,0,12,0,0,17
Nigeria,11/09/2008,3,0,-3,0,0,0,0,0
Nigeria,12/09/2008,17,0,0,0,0,0,0,17
Nigeria,13/09/2008,15,0,0,0,0,0,0,15
Nigeria,14/09/2008,0,0,0,0,0,0,0,0
Nigeria,15/09/2008,18,0,0,0,0,0,0,18
Nigeria,16/09/2008,10,0,0,0,21,0,0,31
Nigeria,17/09/2008,4,0,0,0,2,0,0,6
Nigeria,18/09/2008,22,0,0,0,0,0,0,22
Nigeria,19/09/2008,-1,0,0,0,3,0,0,2
Nigeria,20/09/2008,4,0,0,0,0,0,0,4
Nigeria,21/09/2008,0,0,0,0,1,0,0,1
Nigeria,22/09/2008,9,0,0,0,9,0,0,18
Nigeria,23/09/2008,2,0,0,0,0,0,0,2
Nigeria,24/09/2008,4,0,0,0,0,0,0,4
Nigeria,25/09/2008,0,0,0,0,3,0,0,3
Nigeria,26/09/2008,-2,0,1,0,3,1,0,3
Nigeria,27/09/2008,0,0,0,0,0,0,0,0
Nigeria,28/09/2008,0,0,0,0,0,4,0,4
Nigeria,29/09/2008,4,0,0,0,3,0,0,7
Nigeria,30/09/2008,8,0,0,0,3,2,0,13
Pakistan,01/09/2008,46,0,0,0,17,2,0,65
Pakistan,02/09/2008,31,0,0,0,26,0,0,57
Pakistan,03/09/2008,8,0,0,0,0,0,0,8
Pakistan,04/09/2008,25,0,0,0,-2,4,0,27
Pakistan,05/09/2008,8,0,0,0,0,0,0,8
Pakistan,06/09/2008,11,0,-2,0,0,0,0,9
Pakistan,07/09/2008,178,0,-12,0,49,22,0,237
Pakistan,08/09/2008,42,0,1,0,3,0,0,46
Pakistan,09/09/2008,150,0,-2,0,40,4,0,192
Pakistan,10/09/2008,111,0,-4,0,25,21,0,153
Pakistan,11/09/2008,142,0,1,0,19,7,0,169
Pakistan,12/09/2008,76,2,-4,0,31,0,0,105
Pakistan,13/09/2008,108,0,-1,0,33,3,0,143
Pakistan,14/09/2008,134,0,1,0,26,5,0,166
Pakistan,15/09/2008,92,0,2,0,24,26,0,144
Pakistan,16/09/2008,164,2,0,0,37,12,0,215
Pakistan,17/09/2008,49,0,-2,0,-1,8,0,54
Pakistan,18/09/2008,80,0,0,0,19,2,0,101
Pakistan,19/09/2008,26,0,0,0,22,3,0,51
Pakistan,20/09/2008,64,0,0,0,20,4,0,88
Pakistan,21/09/2008,50,0,0,0,3,0,0,53
Pakistan,22/09/2008,27,0,0,0,2,11,0,40
Pakistan,23/09/2008,69,0,0,0,3,2,0,74
Pakistan,24/09/2008,45,2,-2,0,29,3,0,77
Pakistan,25/09/2008,168,0,2,0,49,3,0,222
Pakistan,26/09/2008,126,2,0,0,18,5,0,151
Pakistan,27/09/2008,55,0,0,0,2,4,0,61
Pakistan,28/09/2008,32,0,0,0,9,9,0,50
Pakistan,29/09/2008,116,0,0,0,8,8,0,132
Pakistan,30/09/2008,64,0,-2,0,7,2,0,71
Sierra Leone,01/09/2008,1,0,0,0,-2,1,0,0
Sierra Leone,02/09/2008,0,0,0,0,0,0,0,0
Sierra Leone,05/09/2008,0,0,0,0,9,0,0,9
Sierra Leone,07/09/2008,0,0,0,0,0,0,0,0
Sierra Leone,09/09/2008,0,0,0,0,12,0,0,12
Sierra Leone,10/09/2008,0,0,0,0,-4,0,0,-4
Sierra Leone,11/09/2008,-1,2,0,0,0,0,0,1
Sierra Leone,12/09/2008,0,0,0,0,0,0,0,0
Sierra Leone,13/09/2008,0,0,0,0,-2,0,0,-2
Sierra Leone,15/09/2008,3,0,0,0,9,0,0,12
Sierra Leone,16/09/2008,0,0,0,0,12,0,0,12
Sierra Leone,17/09/2008,3,0,0,0,-2,1,0,2
Sierra Leone,21/09/2008,0,0,0,0,0,0,0,0
Sierra Leone,22/09/2008,0,0,0,0,0,0,0,0
Sierra Leone,23/09/2008,1,0,0,0,3,6,0,10
Sierra Leone,24/09/2008,0,0,0,0,3,0,0,3
Sierra Leone,25/09/2008,3,0,0,0,3,0,0,6
Sierra Leone,28/09/2008,0,0,0,0,0,0,0,0
Sierra Leone,29/09/2008,-1,0,0,0,0,0,0,-1
Sierra Leone,30/09/2008,3,0,0,0,0,0,0,3
Somalia,01/09/2008,44,0,0,0,-4,0,0,40
Somalia,02/09/2008,39,2,0,0,40,1,0,82
Somalia,03/09/2008,1,0,0,0,3,0,0,4
Somalia,04/09/2008,6,0,0,0,3,0,0,9
Somalia,05/09/2008,6,2,0,0,3,0,0,11
Somalia,06/09/2008,7,0,0,0,3,0,0,10
Somalia,07/09/2008,20,0,0,0,4,2,0,26
Somalia,08/09/2008,23,0,0,0,8,2,0,33
Somalia,09/09/2008,52,0,0,0,58,3,0,113
Somalia,10/09/2008,43,0,0,0,20,0,0,63
Somalia,11/09/2008,39,0,3,0,-6,2,0,38
Somalia,12/09/2008,25,0,-6,0,13,1,0,33
Somalia,13/09/2008,4,0,-1,0,0,0,0,3
Somalia,14/09/2008,32,0,1,0,0,0,0,33
Somalia,15/09/2008,58,4,0,0,57,5,0,124
Somalia,16/09/2008,40,0,0,0,92,3,0,135
Somalia,17/09/2008,34,0,0,0,27,4,0,65
Somalia,18/09/2008,29,0,0,0,6,6,0,41
Somalia,19/09/2008,23,0,0,0,24,0,0,47
Somalia,20/09/2008,25,2,0,0,-6,3,0,24
Somalia,21/09/2008,11,2,1,0,5,6,0,25
Somalia,22/09/2008,47,4,1,0,20,6,0,78
Somalia,23/09/2008,38,0,-2,0,3,0,0,39
Somalia,24/09/2008,38,0,-4,0,-2,2,0,34
Somalia,25/09/2008,44,0,1,0,2,0,0,47
Somalia,26/09/2008,57,0,0,0,57,4,0,118
Somalia,27/09/2008,40,0,1,0,18,16,0,75
Somalia,28/09/2008,35,0,0,0,-1,0,0,34
Somalia,29/09/2008,85,0,0,0,4,0,0,89
Somalia,30/09/2008,172,0,0,0,-21,16,0,167
Syria,01/09/2008,41,0,2,0,69,2,0,114
Syria,02/09/2008,12,0,0,0,0,1,0,13
Syria,03/09/2008,3,0,0,0,3,0,0,6
Syria,04/09/2008,15,0,0,0,0,0,0,15
Syria,05/09/2008,0,0,0,0,0,0,0,0
Syria,06/09/2008,3,0,0,0,0,0,0,3
Syria,07/09/2008,4,0,0,0,1,0,0,5
Syria,08/09/2008,3,0,0,0,1,0,0,4
Syria,09/09/2008,6,0,0,0,6,0,0,12
Syria,10/09/2008,14,0,0,0,0,10,0,24
Syria,11/09/2008,63,0,-2,0,4,6,0,71
Syria,12/09/2008,25,0,0,0,3,0,0,28
Syria,13/09/2008,9,0,0,0,0,0,0,9
Syria,14/09/2008,7,0,-4,0,0,0,0,3
Syria,15/09/2008,16,0,1,0,6,0,0,23
Syria,16/09/2008,13,0,1,0,0,6,0,20
Syria,17/09/2008,11,0,-2,0,9,0,0,18
Syria,18/09/2008,4,0,0,0,3,0,0,7
Syria,19/09/2008,1,0,0,0,0,0,0,1
Syria,20/09/2008,3,0,0,0,0,0,0,3
Syria,21/09/2008,10,0,0,0,0,0,0,10
Syria,22/09/2008,22,0,0,0,0,0,0,22
Syria,23/09/2008,21,0,1,0,3,0,0,25
Syria,24/09/2008,9,0,0,0,6,0,0,15
Syria,25/09/2008,7,0,0,0,0,1,0,8
Syria,26/09/2008,-2,0,0,0,0,0,0,-2
Syria,27/09/2008,5,0,0,0,0,0,0,5
Syria,28/09/2008,0,0,0,0,3,0,0,3
Syria,29/09/2008,28,0,-6,0,7,21,0,50
Syria,30/09/2008,64,0,0,0,3,0,0,67
Yemen,01/09/2008,12,0,0,0,0,0,0,12
Yemen,02/09/2008,0,0,0,0,7,0,0,7
Yemen,03/09/2008,0,0,0,0,-8,0,0,-8
Yemen,04/09/2008,0,0,0,0,-2,0,0,-2
Yemen,07/09/2008,0,0,0,0,6,0,0,6
Yemen,08/09/2008,0,0,0,0,-2,0,0,-2
Yemen,09/09/2008,1,0,0,0,0,0,0,1
Yemen,10/09/2008,16,0,0,0,6,0,0,22
Yemen,11/09/2008,8,0,0,0,-6,6,0,8
Yemen,12/09/2008,2,0,0,0,-6,0,0,-4
Yemen,13/09/2008,0,0,0,0,6,0,0,6
Yemen,15/09/2008,2,0,0,0,0,1,0,3
Yemen,16/09/2008,6,0,0,0,15,0,0,21
Yemen,17/09/2008,82,0,2,0,16,16,0,116
Yemen,18/09/2008,163,0,0,0,78,29,0,270
Yemen,19/09/2008,7,0,0,0,0,2,0,9
Yemen,20/09/2008,10,0,0,0,0,0,0,10
Yemen,21/09/2008,0,0,0,0,0,0,0,0
Yemen,22/09/2008,23,0,0,0,0,0,0,23
Yemen,23/09/2008,34,0,0,0,0,0,0,34
Yemen,24/09/2008,14,0,0,0,4,0,0,18
Yemen,25/09/2008,8,0,0,0,10,0,0,18
Yemen,26/09/2008,10,0,0,0,10,0,0,20
Yemen,27/09/2008,0,0,0,0,0,0,0,0
Yemen,28/09/2008,18,0,0,0,0,0,0,18
Yemen,29/09/2008,22,0,0,0,-1,4,0,25
Yemen,30/09/2008,4,0,0,0,0,3,0,7
Afghanistan,01/04/2006,36,0,0,0,4,6,0,46
Afghanistan,02/04/2006,33,0,0,0,2,13,0,48
Afghanistan,03/04/2006,26,0,0,0,7,7,0,40
Afghanistan,04/04/2006,19,0,0,0,10,1,0,30
Afghanistan,05/04/2006,59,0,1,0,16,3,0,79
Afghanistan,06/04/2006,24,0,0,0,19,2,0,45
Afghanistan,07/04/2006,14,0,0,0,12,4,0,30
Afghanistan,08/04/2006,40,0,0,0,0,8,0,48
Afghanistan,09/04/2006,4,0,0,0,-8,3,0,-1
Afghanistan,10/04/2006,28,0,0,0,10,7,0,45
Afghanistan,11/04/2006,41,0,0,0,3,10,0,54
Afghanistan,12/04/2006,30,0,0,0,13,0,0,43
Afghanistan,13/04/2006,36,0,0,0,0,1,0,37
Afghanistan,14/04/2006,158,0,0,0,12,4,0,174
Afghanistan,15/04/2006,34,0,1,0,4,4,0,43
Afghanistan,16/04/2006,17,0,0,0,0,6,0,23
Afghanistan,17/04/2006,49,0,1,0,18,2,0,70
Afghanistan,18/04/2006,27,0,0,0,-2,2,0,27
Afghanistan,19/04/2006,21,0,0,0,8,10,0,39
Afghanistan,20/04/2006,59,0,1,0,8,11,0,79
Afghanistan,21/04/2006,15,0,1,0,16,4,0,36
Afghanistan,22/04/2006,31,0,0,0,-2,1,0,30
Afghanistan,23/04/2006,66,0,2,0,3,6,0,77
Afghanistan,24/04/2006,61,0,0,0,-1,1,0,61
Afghanistan,25/04/2006,77,0,0,0,13,0,0,90
Afghanistan,26/04/2006,38,0,0,0,4,2,0,44
Afghanistan,27/04/2006,16,0,0,0,-4,1,0,13
Afghanistan,28/04/2006,17,0,0,0,27,0,0,44
Afghanistan,29/04/2006,2,0,0,0,-2,4,0,4
Afghanistan,30/04/2006,25,0,0,0,13,0,0,38
Albania,01/04/2006,2,0,0,0,9,0,0,11
Albania,02/04/2006,2,0,0,0,3,0,0,5
Albania,03/04/2006,6,0,-2,0,15,0,0,19
Albania,04/04/2006,6,0,-3,0,6,0,0,9
Albania,05/04/2006,2,0,0,0,12,0,0,14
Albania,06/04/2006,0,0,0,0,0,0,0,0
Albania,07/04/2006,10,0,0,0,-2,2,0,10
Albania,08/04/2006,1,0,0,0,0,1,0,2
Albania,09/04/2006,0,0,0,0,0,0,0,0
Albania,10/04/2006,0,0,0,0,0,0,0,0
Albania,11/04/2006,0,0,0,0,16,1,0,17
Albania,12/04/2006,3,0,0,0,-2,0,0,1
Albania,13/04/2006,8,0,0,0,0,0,0,8
Albania,14/04/2006,3,0,-2,0,0,0,0,1
Albania,15/04/2006,0,0,0,0,-3,1,0,-2
Albania,16/04/2006,2,0,0,0,0,2,0,4
Albania,17/04/2006,5,0,0,0,0,0,0,5
Albania,18/04/2006,1,0,-1,0,-8,0,0,-8
Albania,19/04/2006,1,0,0,0,3,1,0,5
Albania,20/04/2006,6,0,0,0,0,0,0,6
Albania,21/04/2006,5,0,0,0,-4,0,0,1
Albania,22/04/2006,0,0,0,0,0,0,0,0
Albania,23/04/2006,2,0,0,0,0,0,0,2
Albania,24/04/2006,0,0,0,0,0,1,0,1
Albania,25/04/2006,5,0,0,0,0,5,0,10
Albania,26/04/2006,-1,0,0,0,10,1,0,10
Albania,27/04/2006,0,0,0,0,-2,0,0,-2
Albania,28/04/2006,3,0,0,0,-2,0,0,1
Albania,29/04/2006,0,0,0,0,0,2,0,2
Albania,30/04/2006,2,0,0,0,9,0,0,11
Algeria,01/04/2006,0,0,0,0,0,0,0,0
Algeria,02/04/2006,0,0,0,0,0,0,0,0
Algeria,03/04/2006,3,0,0,0,9,0,0,12
Algeria,04/04/2006,1,0,0,0,0,0,0,1
Algeria,05/04/2006,7,0,0,0,0,0,0,7
Algeria,07/04/2006,6,0,0,0,0,4,0,10
Algeria,08/04/2006,0,0,0,0,0,0,0,0
Algeria,09/04/2006,-1,0,0,0,0,0,0,-1
Algeria,10/04/2006,5,2,0,0,0,0,0,7
Algeria,11/04/2006,2,0,0,0,0,0,0,2
Algeria,12/04/2006,-1,0,0,0,3,0,0,2
Algeria,13/04/2006,1,0,0,0,6,0,0,7
Algeria,14/04/2006,0,0,0,0,0,0,0,0
Algeria,15/04/2006,0,0,0,0,0,2,0,2
Algeria,16/04/2006,0,0,0,0,0,0,0,0
Algeria,17/04/2006,0,0,0,0,-2,0,0,-2
Algeria,18/04/2006,0,0,0,0,0,14,0,14
Algeria,19/04/2006,4,0,0,0,24,0,0,28
Algeria,20/04/2006,0,0,0,0,0,2,0,2
Algeria,21/04/2006,5,0,0,0,3,0,0,8
Algeria,22/04/2006,3,0,0,0,3,0,0,6
Algeria,23/04/2006,2,0,0,0,-4,0,0,-2
Algeria,24/04/2006,1,0,0,0,5,0,0,6
Algeria,25/04/2006,3,0,0,0,9,0,0,12
Algeria,26/04/2006,2,0,0,0,0,0,0,2
Algeria,27/04/2006,0,0,0,0,0,0,0,0
Algeria,28/04/2006,5,0,0,0,6,0,0,11
Algeria,29/04/2006,5,0,0,0,0,2,0,7
Algeria,30/04/2006,0,0,0,0,0,0,0,0
Bangladesh,01/04/2006,9,0,0,0,0,0,0,9
Bangladesh,02/04/2006,3,0,0,0,0,0,0,3
Bangladesh,03/04/2006,9,0,0,0,6,0,0,15
Bangladesh,04/04/2006,0,0,0,0,3,0,0,3
Bangladesh,05/04/2006,8,0,1,0,9,3,0,21
Bangladesh,06/04/2006,0,0,0,0,3,0,0,3
Bangladesh,07/04/2006,1,0,0,0,0,1,0,2
Bangladesh,08/04/2006,0,0,0,0,0,0,0,0
Bangladesh,10/04/2006,4,0,0,0,6,0,0,10
Bangladesh,11/04/2006,-2,0,0,0,0,0,0,-2
Bangladesh,12/04/2006,0,0,0,0,3,0,0,3
Bangladesh,13/04/2006,-2,0,0,0,0,1,0,-1
Bangladesh,14/04/2006,1,0,0,0,7,0,0,8
Bangladesh,18/04/2006,21,0,0,0,1,0,0,22
Bangladesh,19/04/2006,0,0,0,0,0,0,0,0
Bangladesh,20/04/2006,5,0,0,0,-4,0,0,1
Bangladesh,21/04/2006,3,0,0,0,3,0,0,6
Bangladesh,22/04/2006,0,0,0,0,6,0,0,6
Bangladesh,23/04/2006,0,0,0,0,0,1,0,1
Bangladesh,24/04/2006,2,0,0,0,-2,0,0,0
Bangladesh,25/04/2006,4,0,0,0,0,0,0,4
Bangladesh,26/04/2006,1,0,0,0,0,0,0,1
Bangladesh,27/04/2006,2,0,0,0,0,0,0,2
Bangladesh,28/04/2006,-1,0,0,0,0,0,0,-1
Bangladesh,29/04/2006,9,0,0,0,9,2,0,20
Bangladesh,30/04/2006,0,0,0,0,0,3,0,3
Cameroon,01/04/2006,10,0,0,0,6,0,0,16
Cameroon,02/04/2006,3,0,0,0,-2,0,0,1
Cameroon,03/04/2006,10,0,-4,0,1,2,0,9
Cameroon,04/04/2006,9,0,0,0,-2,0,0,7
Cameroon,06/04/2006,0,0,0,0,-4,0,0,-4
Cameroon,07/04/2006,3,0,0,0,0,0,0,3
Cameroon,08/04/2006,3,0,0,0,0,0,0,3
Cameroon,09/04/2006,0,0,0,0,0,0,0,0
Cameroon,10/04/2006,7,0,0,0,-2,0,0,5
Cameroon,11/04/2006,0,0,0,0,6,0,0,6
Cameroon,12/04/2006,5,0,0,0,0,0,0,5
Cameroon,14/04/2006,0,0,0,0,0,0,0,0
Cameroon,16/04/2006,0,0,0,0,0,0,0,0
Cameroon,17/04/2006,0,0,0,0,0,0,0,0
Cameroon,18/04/2006,0,0,0,0,0,1,0,1
Cameroon,19/04/2006,0,0,0,0,0,0,0,0
Cameroon,20/04/2006,0,0,0,0,3,0,0,3
Cameroon,21/04/2006,2,0,0,0,0,0,0,2
Cameroon,24/04/2006,0,0,0,0,0,0,0,0
Cameroon,25/04/2006,8,0,0,0,0,0,0,8
Cameroon,27/04/2006,-1,0,-2,0,0,0,0,-3
Cameroon,28/04/2006,1,0,0,0,0,0,0,1
Cameroon,29/04/2006,0,0,0,0,0,0,0,0
China,01/04/2006,6,0,0,0,9,3,0,18
China,02/04/2006,15,0,0,0,0,3,0,18
China,03/04/2006,11,2,-1,0,0,1,0,13
China,04/04/2006,41,2,-1,0,18,6,0,66
China,05/04/2006,31,0,0,0,30,4,0,65
China,06/04/2006,42,0,0,0,26,1,0,69
China,07/04/2006,31,0,0,0,2,2,0,35
China,08/04/2006,8,0,0,0,3,0,0,11
China,09/04/2006,3,0,0,0,17,6,0,26
China,10/04/2006,22,0,-1,0,3,0,0,24
China,11/04/2006,3,0,-3,0,8,6,0,14
China,12/04/2006,14,0,0,0,3,3,0,20
China,13/04/2006,22,0,0,0,6,1,0,29
China,14/04/2006,15,0,0,0,15,1,0,31
China,15/04/2006,3,0,0,0,3,0,0,6
China,16/04/2006,8,0,0,0,3,1,0,12
China,17/04/2006,12,0,0,0,7,2,0,21
China,18/04/2006,67,0,-9,0,15,19,0,92
China,19/04/2006,27,0,0,0,12,6,0,45
China,20/04/2006,71,0,0,0,36,15,0,122
China,21/04/2006,28,0,0,0,16,6,0,50
China,22/04/2006,17,0,-4,0,12,0,0,25
China,23/04/2006,13,0,-2,0,4,5,0,20
China,24/04/2006,14,0,1,0,9,13,0,37
China,25/04/2006,26,0,1,0,9,5,0,41
China,26/04/2006,-2,0,-6,0,-4,6,0,-6
China,27/04/2006,7,0,-6,0,3,1,0,5
China,28/04/2006,8,0,-1,0,6,4,0,17
China,29/04/2006,14,0,0,0,8,0,0,22
China,30/04/2006,8,0,1,0,0,0,0,9
Egypt,01/04/2006,15,0,0,0,0,3,0,18
Egypt,02/04/2006,2,0,0,0,-7,0,0,-5
Egypt,03/04/2006,21,0,0,0,27,0,0,48
Egypt,04/04/2006,2,0,0,0,3,5,0,10
Egypt,05/04/2006,2,0,0,0,2,0,0,4
Egypt,06/04/2006,6,0,0,0,-4,0,0,2
Egypt,07/04/2006,22,0,0,0,18,6,0,46
Egypt,08/04/2006,3,0,0,0,0,0,0,3
Egypt,09/04/2006,6,0,0,0,0,0,0,6
Egypt,10/04/2006,-1,0,0,0,3,4,0,6
Egypt,11/04/2006,14,0,0,0,1,0,0,15
Egypt,12/04/2006,0,0,0,0,0,0,0,0
Egypt,13/04/2006,29,0,0,0,4,0,0,33
Egypt,14/04/2006,27,0,0,0,0,0,0,27
Egypt,15/04/2006,12,0,0,0,9,0,0,21
Egypt,16/04/2006,2,0,0,0,0,1,0,3
Egypt,17/04/2006,9,0,0,0,0,0,0,9
Egypt,18/04/2006,27,0,0,0,12,0,0,39
Egypt,19/04/2006,27,0,0,0,6,5,0,38
Egypt,20/04/2006,-2,0,0,0,9,4,0,11
Egypt,21/04/2006,9,0,0,0,3,0,0,12
Egypt,22/04/2006,9,0,1,0,0,3,0,13
Egypt,23/04/2006,12,0,0,0,0,6,0,18
Egypt,24/04/2006,24,0,0,0,0,8,0,32
Egypt,25/04/2006,17,0,2,0,9,22,0,50
Egypt,26/04/2006,15,0,2,0,21,18,0,56
Egypt,27/04/2006,20,0,0,0,6,4,0,30
Egypt,28/04/2006,2,0,0,0,0,0,0,2
Egypt,29/04/2006,3,0,0,0,0,0,0,3
Egypt,30/04/2006,0,0,0,0,0,0,0,0
Eritrea,01/04/2006,0,0,0,0,0,1,0,1
Eritrea,02/04/2006,0,0,0,0,0,0,0,0
Eritrea,03/04/2006,0,0,0,0,0,1,0,1
Eritrea,04/04/2006,3,0,0,0,0,0,0,3
Eritrea,05/04/2006,4,0,0,0,0,0,0,4
Eritrea,07/04/2006,0,0,0,0,6,0,0,6
Eritrea,08/04/2006,0,0,0,0,0,0,0,0
Eritrea,09/04/2006,0,0,0,0,0,1,0,1
Eritrea,10/04/2006,-3,0,0,0,0,0,0,-3
Eritrea,11/04/2006,0,0,0,0,0,0,0,0
Eritrea,12/04/2006,0,0,0,0,0,0,0,0
Eritrea,13/04/2006,6,0,0,0,3,0,0,9
Eritrea,16/04/2006,0,0,0,0,0,0,0,0
Eritrea,17/04/2006,0,0,0,0,0,0,0,0
Eritrea,18/04/2006,0,0,0,0,3,0,0,3
Eritrea,19/04/2006,14,0,0,0,0,0,0,14
Eritrea,21/04/2006,0,0,0,0,0,0,0,0
Eritrea,22/04/2006,0,2,0,0,0,0,0,2
Eritrea,23/04/2006,0,0,0,0,0,0,0,0
Eritrea,25/04/2006,-1,0,0,0,0,0,0,-1
Eritrea,26/04/2006,0,0,0,0,0,0,0,0
Eritrea,27/04/2006,0,0,0,0,0,0,0,0
Eritrea,28/04/2006,3,0,0,0,0,0,0,3
Eritrea,29/04/2006,0,0,0,0,0,0,0,0
Georgia,01/04/2006,2,0,0,0,0,0,0,2
Georgia,02/04/2006,0,0,0,0,0,0,0,0
Georgia,03/04/2006,4,0,0,0,0,0,0,4
Georgia,04/04/2006,1,0,1,0,6,0,0,8
Georgia,05/04/2006,6,0,0,0,-2,4,0,8
Georgia,06/04/2006,8,0,0,0,0,0,0,8
Georgia,07/04/2006,0,0,0,0,6,0,0,6
Georgia,08/04/2006,0,0,0,0,6,0,0,6
Georgia,09/04/2006,0,0,0,0,3,0,0,3
Georgia,10/04/2006,0,0,0,0,9,0,0,9
Georgia,11/04/2006,1,0,0,0,0,0,0,1
Georgia,12/04/2006,2,0,0,0,-2,0,0,0
Georgia,13/04/2006,10,0,0,0,-2,0,0,8
Georgia,14/04/2006,0,0,0,0,0,0,0,0
Georgia,16/04/2006,0,0,0,0,0,0,0,0
Georgia,17/04/2006,0,0,0,0,0,0,0,0
Georgia,18/04/2006,11,0,0,0,2,1,0,14
Georgia,19/04/2006,4,0,0,0,3,0,0,7
Georgia,20/04/2006,1,0,0,0,3,0,0,4
Georgia,21/04/2006,0,0,0,0,3,0,0,3
Georgia,23/04/2006,0,0,0,0,0,0,0,0
Georgia,24/04/2006,0,0,0,0,0,0,0,0
Georgia,25/04/2006,5,0,0,0,3,0,0,8
Georgia,26/04/2006,0,0,0,0,3,0,0,3
Georgia,27/04/2006,2,0,0,0,6,0,0,8
Georgia,28/04/2006,0,0,0,0,0,0,0,0
Georgia,29/04/2006,0,0,0,0,0,0,0,0
India,01/04/2006,8,0,0,0,6,0,0,14
India,02/04/2006,7,0,-2,0,0,0,0,5
India,03/04/2006,2,0,2,0,10,1,0,15
India,04/04/2006,9,0,0,0,9,0,0,18
India,05/04/2006,4,0,1,0,-1,2,0,6
India,06/04/2006,10,0,0,0,4,1,0,15
India,07/04/2006,30,0,0,0,-4,3,0,29
India,08/04/2006,3,0,0,0,0,2,0,5
India,09/04/2006,14,0,0,0,0,3,0,17
India,10/04/2006,0,0,0,0,9,3,0,12
India,11/04/2006,3,0,0,0,0,0,0,3
India,12/04/2006,0,0,0,0,15,4,0,19
India,13/04/2006,10,0,0,0,3,0,0,13
India,14/04/2006,-1,0,0,0,0,0,0,-1
India,15/04/2006,0,0,0,0,0,1,0,1
India,16/04/2006,0,0,0,0,0,0,0,0
India,17/04/2006,13,0,0,0,0,0,0,13
India,18/04/2006,32,0,0,0,-1,3,0,34
India,19/04/2006,11,0,1,0,6,0,0,18
India,20/04/2006,29,0,2,0,9,1,0,41
India,21/04/2006,15,0,0,0,9,2,0,26
India,22/04/2006,0,0,0,0,0,0,0,0
India,23/04/2006,6,0,0,0,2,0,0,8
India,24/04/2006,9,0,0,0,3,2,0,14
India,25/04/2006,22,0,-4,0,15,1,0,34
India,26/04/2006,12,0,0,0,0,1,0,13
India,27/04/2006,12,0,0,0,9,0,0,21
India,28/04/2006,4,0,0,0,-3,0,0,1
India,29/04/2006,9,0,0,0,0,2,0,11
India,30/04/2006,2,0,0,0,1,2,0,5
Iran,01/04/2006,22,0,0,0,6,0,0,28
Iran,02/04/2006,33,0,0,0,9,1,0,43
Iran,03/04/2006,58,0,0,0,16,10,0,84
Iran,04/04/2006,18,0,-7,0,15,3,0,29
Iran,05/04/2006,33,0,0,0,9,3,0,45
Iran,06/04/2006,27,0,1,0,6,2,0,36
Iran,07/04/2006,26,2,1,0,16,2,0,47
Iran,08/04/2006,10,0,0,0,3,0,0,13
Iran,09/04/2006,9,0,0,0,0,0,0,9
Iran,10/04/2006,20,0,0,0,3,1,0,24
Iran,11/04/2006,74,0,0,0,9,4,0,87
Iran,12/04/2006,25,0,0,0,0,2,0,27
Iran,13/04/2006,24,0,1,0,3,4,0,32
Iran,14/04/2006,2,0,-2,0,-3,2,0,-1
Iran,15/04/2006,13,0,0,0,4,0,0,17
Iran,16/04/2006,32,0,0,0,-1,2,0,33
Iran,17/04/2006,53,0,0,0,13,14,0,80
Iran,18/04/2006,101,0,-3,0,15,12,0,125
Iran,19/04/2006,34,0,-6,0,6,6,0,40
Iran,20/04/2006,58,4,3,0,0,8,0,73
Iran,21/04/2006,18,0,0,0,-2,5,0,21
Iran,22/04/2006,8,0,-4,0,3,2,0,9
Iran,23/04/2006,10,2,-2,0,-2,1,0,9
Iran,24/04/2006,32,0,2,0,9,12,0,55
Iran,25/04/2006,18,0,1,0,12,4,0,35
Iran,26/04/2006,35,0,0,0,6,1,0,42
Iran,27/04/2006,22,0,3,0,25,2,0,52
Iran,28/04/2006,36,0,0,0,6,0,0,42
Iran,29/04/2006,24,0,0,0,6,2,0,32
Iran,30/04/2006,29,0,0,0,15,1,0,45
Iraq,01/04/2006,65,6,0,0,15,6,0,92
Iraq,02/04/2006,36,0,1,0,0,10,0,47
Iraq,03/04/2006,93,0,1,0,6,3,0,103
Iraq,04/04/2006,15,4,3,0,19,2,0,43
Iraq,05/04/2006,44,4,-10,0,17,-2,0,53
Iraq,06/04/2006,23,0,0,0,31,4,0,58
Iraq,07/04/2006,83,4,0,0,30,8,0,125
Iraq,08/04/2006,38,0,0,0,1,10,0,49
Iraq,09/04/2006,34,0,1,0,3,7,0,45
Iraq,10/04/2006,27,0,0,0,19,9,0,55
Iraq,11/04/2006,29,0,1,0,15,1,0,46
Iraq,12/04/2006,78,0,6,0,1,1,0,86
Iraq,13/04/2006,55,0,1,0,31,3,0,90
Iraq,14/04/2006,32,0,-11,0,20,4,0,45
Iraq,15/04/2006,41,0,-2,0,0,0,0,39
Iraq,16/04/2006,44,0,-2,0,-2,0,0,40
Iraq,17/04/2006,57,0,-3,0,6,0,0,60
Iraq,18/04/2006,108,2,-21,0,36,8,0,133
Iraq,19/04/2006,47,0,-4,0,18,0,0,61
Iraq,20/04/2006,71,4,-4,0,66,4,0,141
Iraq,21/04/2006,24,0,1,0,9,5,0,39
Iraq,22/04/2006,10,0,1,0,6,0,0,17
Iraq,23/04/2006,46,0,1,0,8,7,0,62
Iraq,24/04/2006,55,0,0,0,30,5,0,90
Iraq,25/04/2006,122,0,1,0,17,23,0,163
Iraq,26/04/2006,67,0,0,0,10,3,0,80
Iraq,27/04/2006,48,0,-6,0,16,2,0,60
Iraq,28/04/2006,15,0,0,0,17,4,0,36
Iraq,29/04/2006,7,0,-6,0,6,2,0,9
Iraq,30/04/2006,23,0,-2,0,18,4,0,43
Morocco,02/04/2006,6,0,0,0,0,0,0,6
Morocco,03/04/2006,2,0,0,0,6,0,0,8
Morocco,04/04/2006,8,0,0,0,9,0,0,17
Morocco,05/04/2006,0,0,0,0,-2,0,0,-2
Morocco,06/04/2006,4,0,0,0,12,0,0,16
Morocco,07/04/2006,7,0,0,0,6,2,0,15
Morocco,10/04/2006,2,0,0,0,-4,0,0,-2
Morocco,11/04/2006,24,0,0,0,45,0,0,69
Morocco,12/04/2006,0,0,0,0,3,0,0,3
Morocco,13/04/2006,1,0,0,0,0,0,0,1
Morocco,14/04/2006,0,0,0,0,3,0,0,3
Morocco,15/04/2006,1,2,0,0,0,0,0,3
Morocco,17/04/2006,0,0,0,0,3,0,0,3
Morocco,18/04/2006,16,0,0,0,0,0,0,16
Morocco,19/04/2006,3,0,0,0,0,0,0,3
Morocco,20/04/2006,3,0,0,0,0,0,0,3
Morocco,21/04/2006,-1,0,1,0,0,0,0,0
Morocco,22/04/2006,-7,0,0,0,-4,1,0,-10
Morocco,23/04/2006,0,0,0,0,0,0,0,0
Morocco,24/04/2006,0,0,0,0,-4,0,0,-4
Morocco,25/04/2006,-1,0,0,0,0,0,0,-1
Morocco,26/04/2006,-1,0,0,0,0,0,0,-1
Morocco,27/04/2006,2,0,0,0,0,0,0,2
Morocco,28/04/2006,-8,0,0,0,0,0,0,-8
Morocco,29/04/2006,3,0,0,0,0,0,0,3
Morocco,30/04/2006,6,0,0,0,0,0,0,6
Nigeria,01/04/2006,7,0,-2,0,20,0,0,25
Nigeria,02/04/2006,6,0,0,0,18,0,0,24
Nigeria,03/04/2006,14,0,0,0,46,2,0,62
Nigeria,04/04/2006,21,0,1,0,24,2,0,48
Nigeria,05/04/2006,12,0,-5,0,15,5,0,27
Nigeria,06/04/2006,23,0,2,0,3,1,0,29
Nigeria,07/04/2006,24,2,0,0,9,1,0,36
Nigeria,08/04/2006,0,0,0,0,1,0,0,1
Nigeria,09/04/2006,1,0,0,0,3,1,0,5
Nigeria,10/04/2006,6,0,-2,0,10,4,0,18
Nigeria,11/04/2006,3,0,0,0,3,1,0,7
Nigeria,12/04/2006,3,0,-2,0,6,0,0,7
Nigeria,13/04/2006,16,0,0,0,6,10,0,32
Nigeria,14/04/2006,19,0,0,0,0,2,0,21
Nigeria,15/04/2006,0,0,0,0,0,0,0,0
Nigeria,16/04/2006,7,0,-1,0,0,2,0,8
Nigeria,17/04/2006,15,0,0,0,0,1,0,16
Nigeria,18/04/2006,23,0,0,0,12,3,0,38
Nigeria,19/04/2006,30,0,0,0,6,4,0,40
Nigeria,20/04/2006,17,0,0,0,-1,3,0,19
Nigeria,21/04/2006,10,0,1,0,0,2,0,13
Nigeria,22/04/2006,1,0,0,0,0,0,0,1
Nigeria,23/04/2006,0,0,0,0,0,0,0,0
Nigeria,24/04/2006,7,0,0,0,0,0,0,7
Nigeria,25/04/2006,26,0,0,0,2,0,0,28
Nigeria,26/04/2006,15,0,0,0,-8,7,0,14
Nigeria,27/04/2006,35,0,1,0,-1,2,0,37
Nigeria,28/04/2006,6,0,0,0,9,1,0,16
Nigeria,29/04/2006,6,2,0,0,0,4,0,12
Nigeria,30/04/2006,2,0,0,0,3,0,0,5
Pakistan,01/04/2006,5,0,0,0,18,1,0,24
Pakistan,02/04/2006,16,0,1,0,12,2,0,31
Pakistan,03/04/2006,13,0,0,0,24,3,0,40
Pakistan,04/04/2006,14,0,0,0,9,0,0,23
Pakistan,05/04/2006,19,0,0,0,33,3,0,55
Pakistan,06/04/2006,14,0,0,0,4,0,0,18
Pakistan,07/04/2006,8,0,0,0,6,0,0,14
Pakistan,08/04/2006,-8,0,3,0,3,1,0,-1
Pakistan,09/04/2006,0,0,0,0,0,0,0,0
Pakistan,10/04/2006,9,2,0,0,-2,0,0,9
Pakistan,11/04/2006,13,0,0,0,2,0,0,15
Pakistan,12/04/2006,26,0,0,0,13,2,0,41
Pakistan,13/04/2006,3,0,0,0,12,0,0,15
Pakistan,14/04/2006,3,0,0,0,0,4,0,7
Pakistan,15/04/2006,11,0,0,0,0,1,0,12
Pakistan,16/04/2006,3,0,0,0,3,0,0,6
Pakistan,17/04/2006,14,0,0,0,6,1,0,21
Pakistan,18/04/2006,8,0,0,0,24,1,0,33
Pakistan,19/04/2006,0,0,0,0,12,0,0,12
Pakistan,20/04/2006,17,0,0,0,11,0,0,28
Pakistan,21/04/2006,14,0,0,0,21,0,0,35
Pakistan,22/04/2006,12,2,0,0,12,0,0,26
Pakistan,23/04/2006,9,0,0,0,9,0,0,18
Pakistan,24/04/2006,34,0,0,0,15,2,0,51
Pakistan,25/04/2006,15,6,0,0,18,4,0,43
Pakistan,26/04/2006,14,0,0,0,4,0,0,18
Pakistan,27/04/2006,5,0,0,0,12,0,0,17
Pakistan,28/04/2006,7,0,0,0,5,1,0,13
Pakistan,29/04/2006,5,0,0,0,1,1,0,7
Pakistan,30/04/2006,5,0,0,0,-2,0,0,3
Sierra Leone,01/04/2006,7,0,0,0,27,0,0,34
Sierra Leone,02/04/2006,0,0,0,0,9,0,0,9
Sierra Leone,03/04/2006,11,0,0,0,27,1,0,39
Sierra Leone,04/04/2006,5,0,0,0,3,1,0,9
Sierra Leone,05/04/2006,2,0,0,0,3,5,0,10
Sierra Leone,06/04/2006,4,0,-2,0,6,1,0,9
Sierra Leone,07/04/2006,6,0,1,0,6,2,0,15
Sierra Leone,08/04/2006,-3,0,0,0,3,0,0,0
Sierra Leone,11/04/2006,3,0,0,0,0,0,0,3
Sierra Leone,12/04/2006,-1,0,0,0,4,0,0,3
Sierra Leone,13/04/2006,0,0,0,0,0,0,0,0
Sierra Leone,14/04/2006,0,0,0,0,0,0,0,0
Sierra Leone,16/04/2006,0,0,0,0,0,0,0,0
Sierra Leone,17/04/2006,1,0,0,0,0,0,0,1
Sierra Leone,18/04/2006,13,0,0,0,0,0,0,13
Sierra Leone,19/04/2006,-3,0,0,0,6,0,0,3
Sierra Leone,20/04/2006,0,0,0,0,12,4,0,16
Sierra Leone,21/04/2006,3,0,0,0,0,1,0,4
Sierra Leone,23/04/2006,6,0,0,0,0,0,0,6
Sierra Leone,24/04/2006,7,0,0,0,12,0,0,19
Sierra Leone,25/04/2006,2,0,0,0,4,3,0,9
Sierra Leone,26/04/2006,2,0,0,0,9,0,0,11
Sierra Leone,27/04/2006,0,0,0,0,3,0,0,3
Sierra Leone,28/04/2006,7,0,0,0,1,0,0,8
Somalia,01/04/2006,3,4,0,0,3,0,0,10
Somalia,02/04/2006,3,2,0,0,-2,6,0,9
Somalia,03/04/2006,5,0,0,0,6,0,0,11
Somalia,04/04/2006,6,2,0,0,3,0,0,11
Somalia,05/04/2006,11,0,0,0,3,2,0,16
Somalia,06/04/2006,0,0,0,0,0,1,0,1
Somalia,07/04/2006,1,2,0,0,0,0,0,3
Somalia,08/04/2006,12,0,0,0,5,0,0,17
Somalia,09/04/2006,0,0,0,0,-2,0,0,-2
Somalia,10/04/2006,2,0,0,0,6,0,0,8
Somalia,11/04/2006,1,0,0,0,0,0,0,1
Somalia,12/04/2006,6,0,0,0,9,0,0,15
Somalia,13/04/2006,3,4,0,0,0,1,0,8
Somalia,14/04/2006,0,0,0,0,0,0,0,0
Somalia,15/04/2006,9,0,-2,0,15,1,0,23
Somalia,16/04/2006,3,0,0,0,0,0,0,3
Somalia,17/04/2006,11,0,0,0,0,0,0,11
Somalia,18/04/2006,6,0,-6,0,1,0,0,1
Somalia,19/04/2006,0,0,0,0,0,0,0,0
Somalia,20/04/2006,4,2,0,0,0,6,0,12
Somalia,21/04/2006,0,0,0,0,0,0,0,0
Somalia,22/04/2006,2,0,0,0,1,0,0,3
Somalia,23/04/2006,3,0,0,0,0,1,0,4
Somalia,24/04/2006,11,0,0,0,0,0,0,11
Somalia,25/04/2006,10,0,0,0,0,0,0,10
Somalia,26/04/2006,7,2,0,0,-1,0,0,8
Somalia,27/04/2006,0,0,0,0,3,0,0,3
Somalia,28/04/2006,0,0,0,0,6,0,0,6
Somalia,29/04/2006,16,0,0,0,3,0,0,19
Somalia,30/04/2006,6,0,0,0,-8,2,0,0
Syria,01/04/2006,15,0,-1,0,0,2,0,16
Syria,02/04/2006,12,0,0,0,3,2,0,17
Syria,03/04/2006,31,0,0,0,6,2,0,39
Syria,04/04/2006,8,0,0,0,30,0,0,38
Syria,05/04/2006,9,0,-2,0,22,0,0,29
Syria,06/04/2006,16,0,0,0,9,0,0,25
Syria,07/04/2006,8,0,0,0,12,0,0,20
Syria,08/04/2006,6,0,0,0,0,0,0,6
Syria,09/04/2006,0,0,0,0,3,0,0,3
Syria,10/04/2006,7,0,-2,0,3,0,0,8
Syria,11/04/2006,2,0,0,0,0,0,0,2
Syria,12/04/2006,0,0,0,0,9,0,0,9
Syria,13/04/2006,0,0,0,0,0,0,0,0
Syria,14/04/2006,0,0,0,0,6,0,0,6
Syria,15/04/2006,-2,0,0,0,0,0,0,-2
Syria,16/04/2006,0,0,0,0,0,0,0,0
Syria,17/04/2006,17,0,0,0,0,0,0,17
Syria,18/04/2006,10,0,0,0,6,3,0,19
Syria,19/04/2006,-6,0,0,0,0,0,0,-6
Syria,20/04/2006,20,0,-2,0,14,4,0,36
Syria,21/04/2006,2,0,-4,0,0,0,0,-2
Syria,22/04/2006,2,0,0,0,0,2,0,4
Syria,23/04/2006,8,0,0,0,3,0,0,11
Syria,24/04/2006,3,0,0,0,0,0,0,3
Syria,25/04/2006,3,0,0,0,-1,0,0,2
Syria,26/04/2006,-5,0,0,0,9,0,0,4
Syria,27/04/2006,-4,0,0,0,-2,0,0,-6
Syria,28/04/2006,9,0,-2,0,0,0,0,7
Syria,29/04/2006,4,0,0,0,0,0,0,4
Syria,30/04/2006,5,0,0,0,0,0,0,5
Yemen,01/04/2006,0,0,0,0,0,0,0,0
Yemen,02/04/2006,0,0,0,0,-1,0,0,-1
Yemen,03/04/2006,0,0,0,0,3,0,0,3
Yemen,04/04/2006,0,2,0,0,7,0,0,9
Yemen,05/04/2006,9,0,0,0,10,0,0,19
Yemen,06/04/2006,3,0,0,0,0,0,0,3
Yemen,07/04/2006,2,0,0,0,4,0,0,6
Yemen,08/04/2006,1,0,0,0,0,0,0,1
Yemen,09/04/2006,1,0,0,0,3,0,0,4
Yemen,10/04/2006,-2,0,0,0,0,0,0,-2
Yemen,11/04/2006,0,0,0,0,6,0,0,6
Yemen,12/04/2006,0,0,0,0,0,0,0,0
Yemen,16/04/2006,15,0,0,0,0,0,0,15
Yemen,17/04/2006,0,0,0,0,0,0,0,0
Yemen,18/04/2006,0,0,0,0,0,0,0,0
Yemen,19/04/2006,6,0,0,0,0,0,0,6
Yemen,20/04/2006,3,0,0,0,-4,0,0,-1
Yemen,21/04/2006,6,0,0,0,0,0,0,6
Yemen,23/04/2006,0,0,0,0,0,6,0,6
Yemen,24/04/2006,0,0,0,0,0,0,0,0
Yemen,25/04/2006,0,0,0,0,0,0,0,0
Yemen,26/04/2006,3,0,0,0,0,0,0,3
Yemen,27/04/2006,0,0,0,0,0,0,0,0
Yemen,28/04/2006,5,0,0,0,0,0,0,5
Yemen,29/04/2006,3,0,0,0,-2,0,0,1
Yemen,30/04/2006,2,0,0,0,0,0,0,2
Afghanistan,01/10/2006,62,0,0,0,29,2,0,93
Afghanistan,02/10/2006,30,2,0,0,5,5,0,42
Afghanistan,03/10/2006,62,0,0,0,2,12,0,76
Afghanistan,04/10/2006,44,0,0,0,21,12,0,77
Afghanistan,05/10/2006,58,2,1,0,-1,2,0,62
Afghanistan,06/10/2006,51,0,0,0,15,5,0,71
Afghanistan,07/10/2006,45,0,0,0,30,4,0,79
Afghanistan,08/10/2006,21,0,0,0,3,0,0,24
Afghanistan,09/10/2006,21,0,0,0,-11,2,0,12
Afghanistan,10/10/2006,32,0,0,0,3,0,0,35
Afghanistan,11/10/2006,23,0,0,0,0,1,0,24
Afghanistan,12/10/2006,23,0,0,0,4,11,0,38
Afghanistan,13/10/2006,35,0,0,0,4,29,0,68
Afghanistan,14/10/2006,32,0,0,0,15,3,0,50
Afghanistan,15/10/2006,9,0,0,0,0,0,0,9
Afghanistan,16/10/2006,32,0,0,0,30,11,0,73
Afghanistan,17/10/2006,27,0,0,0,-2,6,0,31
Afghanistan,18/10/2006,48,0,0,0,27,0,0,75
Afghanistan,19/10/2006,27,0,0,0,7,5,0,39
Afghanistan,20/10/2006,16,0,0,0,3,0,0,19
Afghanistan,21/10/2006,6,0,0,0,6,0,0,12
Afghanistan,22/10/2006,22,0,0,0,3,0,0,25
Afghanistan,23/10/2006,39,4,-1,0,-2,4,0,44
Afghanistan,24/10/2006,71,0,-3,0,8,4,0,80
Afghanistan,25/10/2006,13,0,0,0,3,4,0,20
Afghanistan,26/10/2006,22,0,-2,0,6,2,0,28
Afghanistan,27/10/2006,111,0,-3,0,21,19,0,148
Afghanistan,28/10/2006,56,4,-1,0,-4,1,0,56
Afghanistan,29/10/2006,21,0,1,0,7,6,0,35
Afghanistan,30/10/2006,66,0,-3,0,5,3,0,71
Afghanistan,31/10/2006,76,4,-1,0,17,6,0,102
Albania,01/10/2006,8,0,0,0,0,0,0,8
Albania,02/10/2006,10,0,0,0,15,0,0,25
Albania,03/10/2006,1,0,-2,0,0,0,0,-1
Albania,04/10/2006,4,0,0,0,4,0,0,8
Albania,05/10/2006,0,0,0,0,0,0,0,0
Albania,06/10/2006,0,0,0,0,0,0,0,0
Albania,07/10/2006,0,0,0,0,0,0,0,0
Albania,08/10/2006,0,0,0,0,0,0,0,0
Albania,09/10/2006,7,0,0,0,0,0,0,7
Albania,10/10/2006,1,0,0,0,0,0,0,1
Albania,11/10/2006,2,0,0,0,0,1,0,3
Albania,12/10/2006,3,0,-1,0,18,0,0,20
Albania,13/10/2006,-3,0,0,0,0,0,0,-3
Albania,14/10/2006,0,0,0,0,-2,0,0,-2
Albania,15/10/2006,0,0,0,0,0,0,0,0
Albania,16/10/2006,4,0,0,0,3,1,0,8
Albania,17/10/2006,4,0,0,0,0,0,0,4
Albania,18/10/2006,2,0,0,0,0,0,0,2
Albania,19/10/2006,11,0,0,0,6,0,0,17
Albania,20/10/2006,17,0,0,0,9,0,0,26
Albania,21/10/2006,2,0,-1,0,-2,0,0,-1
Albania,22/10/2006,0,0,0,0,0,0,0,0
Albania,23/10/2006,-1,0,0,0,6,0,0,5
Albania,24/10/2006,4,0,0,0,0,0,0,4
Albania,25/10/2006,0,0,0,0,0,1,0,1
Albania,26/10/2006,5,0,0,0,-2,0,0,3
Albania,27/10/2006,4,0,0,0,2,2,0,8
Albania,28/10/2006,16,0,-1,0,0,4,0,19
Albania,29/10/2006,11,0,0,0,0,1,0,12
Albania,30/10/2006,11,0,-7,0,3,9,0,16
Albania,31/10/2006,12,0,0,0,9,6,0,27
Algeria,01/10/2006,1,0,0,0,0,0,0,1
Algeria,02/10/2006,3,0,0,0,18,0,0,21
Algeria,03/10/2006,5,0,0,0,6,0,0,11
Algeria,04/10/2006,0,0,0,0,3,0,0,3
Algeria,05/10/2006,0,0,0,0,0,0,0,0
Algeria,06/10/2006,2,0,0,0,0,0,0,2
Algeria,07/10/2006,0,0,0,0,3,0,0,3
Algeria,08/10/2006,13,0,0,0,1,0,0,14
Algeria,09/10/2006,4,0,0,0,3,0,0,7
Algeria,10/10/2006,11,0,0,0,-6,2,0,7
Algeria,11/10/2006,0,0,0,0,-5,0,0,-5
Algeria,12/10/2006,2,0,0,0,3,0,0,5
Algeria,13/10/2006,0,0,0,0,0,4,0,4
Algeria,15/10/2006,0,0,0,0,0,0,0,0
Algeria,16/10/2006,-8,0,0,0,0,0,0,-8
Algeria,17/10/2006,0,0,0,0,0,0,0,0
Algeria,18/10/2006,1,0,0,0,0,0,0,1
Algeria,19/10/2006,-1,0,0,0,6,0,0,5
Algeria,20/10/2006,0,0,0,0,0,0,0,0
Algeria,22/10/2006,0,0,0,0,3,0,0,3
Algeria,23/10/2006,8,0,0,0,0,0,0,8
Algeria,24/10/2006,3,0,0,0,1,0,0,4
Algeria,25/10/2006,1,0,0,0,6,3,0,10
Algeria,26/10/2006,1,0,0,0,0,0,0,1
Algeria,27/10/2006,4,0,0,0,3,0,0,7
Algeria,28/10/2006,2,0,0,0,0,0,0,2
Algeria,29/10/2006,1,0,0,0,0,2,0,3
Algeria,30/10/2006,17,0,0,0,6,0,0,23
Algeria,31/10/2006,10,0,0,0,0,0,0,10
Bangladesh,01/10/2006,7,0,2,0,0,2,0,11
Bangladesh,02/10/2006,4,0,1,0,0,0,0,5
Bangladesh,03/10/2006,2,0,0,0,0,1,0,3
Bangladesh,04/10/2006,11,0,2,0,0,1,0,14
Bangladesh,05/10/2006,4,0,2,0,18,0,0,24
Bangladesh,06/10/2006,0,0,0,0,0,0,0,0
Bangladesh,07/10/2006,19,0,0,0,0,4,0,23
Bangladesh,08/10/2006,12,0,0,0,0,4,0,16
Bangladesh,10/10/2006,2,0,0,0,3,0,0,5
Bangladesh,12/10/2006,2,0,0,0,0,0,0,2
Bangladesh,13/10/2006,2,2,0,0,0,1,0,5
Bangladesh,14/10/2006,9,0,0,0,0,2,0,11
Bangladesh,15/10/2006,0,0,0,0,0,0,0,0
Bangladesh,16/10/2006,-1,0,0,0,0,0,0,-1
Bangladesh,17/10/2006,0,0,0,0,0,0,0,0
Bangladesh,18/10/2006,0,0,0,0,0,0,0,0
Bangladesh,19/10/2006,2,0,0,0,0,0,0,2
Bangladesh,20/10/2006,0,0,0,0,6,0,0,6
Bangladesh,23/10/2006,0,0,0,0,-4,0,0,-4
Bangladesh,24/10/2006,0,0,0,0,0,0,0,0
Bangladesh,25/10/2006,5,0,-2,0,0,0,0,3
Bangladesh,26/10/2006,2,0,0,0,0,0,0,2
Bangladesh,27/10/2006,3,0,0,0,4,0,0,7
Bangladesh,28/10/2006,16,0,-4,0,6,1,0,19
Bangladesh,29/10/2006,4,0,-2,0,0,1,0,3
Bangladesh,30/10/2006,25,0,1,0,3,3,0,32
Bangladesh,31/10/2006,7,0,0,0,0,2,0,9
Cameroon,02/10/2006,3,0,0,0,0,1,0,4
Cameroon,03/10/2006,0,0,0,0,0,0,0,0
Cameroon,04/10/2006,-3,0,0,0,0,0,0,-3
Cameroon,05/10/2006,0,0,0,0,0,0,0,0
Cameroon,06/10/2006,0,0,0,0,0,0,0,0
Cameroon,07/10/2006,0,0,0,0,3,0,0,3
Cameroon,10/10/2006,0,0,0,0,0,0,0,0
Cameroon,11/10/2006,0,0,0,0,12,0,0,12
Cameroon,12/10/2006,0,0,0,0,0,1,0,1
Cameroon,15/10/2006,0,0,0,0,3,0,0,3
Cameroon,17/10/2006,2,0,0,0,0,0,0,2
Cameroon,18/10/2006,0,0,0,0,0,0,0,0
Cameroon,19/10/2006,0,0,0,0,-2,0,0,-2
Cameroon,23/10/2006,0,0,0,0,3,1,0,4
Cameroon,24/10/2006,0,0,0,0,0,0,0,0
Cameroon,25/10/2006,0,0,0,0,0,0,0,0
Cameroon,26/10/2006,0,0,0,0,0,0,0,0
Cameroon,27/10/2006,0,0,0,0,0,0,0,0
Cameroon,28/10/2006,0,0,0,0,3,0,0,3
Cameroon,29/10/2006,0,0,0,0,0,0,0,0
Cameroon,30/10/2006,0,0,0,0,0,0,0,0
Cameroon,31/10/2006,0,0,0,0,0,2,0,2
China,01/10/2006,-2,0,0,0,6,0,0,4
China,02/10/2006,12,0,4,0,10,2,0,28
China,03/10/2006,36,0,0,0,12,1,0,49
China,04/10/2006,26,0,0,0,4,3,0,33
China,05/10/2006,37,0,0,0,7,4,0,48
China,06/10/2006,14,0,0,0,7,2,0,23
China,07/10/2006,2,0,0,0,7,1,0,10
China,08/10/2006,9,0,0,0,3,1,0,13
China,09/10/2006,17,0,0,0,-2,10,0,25
China,10/10/2006,36,0,1,0,-6,6,0,37
China,11/10/2006,13,0,0,0,0,4,0,17
China,12/10/2006,-4,2,-5,0,-1,1,0,-7
China,13/10/2006,18,0,0,0,0,1,0,19
China,14/10/2006,27,0,0,0,4,2,0,33
China,15/10/2006,1,0,0,0,12,0,0,13
China,16/10/2006,17,0,-4,0,12,3,0,28
China,17/10/2006,16,0,1,0,21,0,0,38
China,18/10/2006,14,0,1,0,15,1,0,31
China,19/10/2006,13,0,0,0,4,0,0,17
China,20/10/2006,22,0,0,0,9,2,0,33
China,21/10/2006,2,0,-2,0,0,0,0,0
China,22/10/2006,7,0,0,0,-4,0,0,3
China,23/10/2006,35,4,2,0,13,3,0,57
China,24/10/2006,48,0,0,0,18,0,0,66
China,25/10/2006,3,0,3,0,12,9,0,27
China,26/10/2006,12,0,1,0,13,0,0,26
China,27/10/2006,26,0,0,0,1,4,0,31
China,28/10/2006,10,0,0,0,-2,2,0,10
China,29/10/2006,8,0,0,0,8,2,0,18
China,30/10/2006,18,6,-2,0,44,11,0,77
China,31/10/2006,33,2,-2,0,22,5,0,60
Egypt,01/10/2006,20,0,0,0,10,2,0,32
Egypt,02/10/2006,2,2,-2,0,6,0,0,8
Egypt,03/10/2006,9,0,0,0,1,0,0,10
Egypt,04/10/2006,1,0,-1,0,3,0,0,3
Egypt,05/10/2006,37,0,0,0,7,0,0,44
Egypt,06/10/2006,20,0,0,0,12,0,0,32
Egypt,07/10/2006,16,0,0,0,-1,0,0,15
Egypt,08/10/2006,4,0,0,0,3,0,0,7
Egypt,09/10/2006,0,0,0,0,0,0,0,0
Egypt,10/10/2006,5,0,1,0,6,1,0,13
Egypt,11/10/2006,3,0,2,0,0,0,0,5
Egypt,12/10/2006,7,0,0,0,5,0,0,12
Egypt,13/10/2006,7,0,0,0,6,0,0,13
Egypt,14/10/2006,7,0,0,0,0,0,0,7
Egypt,15/10/2006,1,0,0,0,3,0,0,4
Egypt,16/10/2006,-3,0,0,0,6,0,0,3
Egypt,17/10/2006,15,2,0,0,3,3,0,23
Egypt,18/10/2006,5,0,0,0,6,1,0,12
Egypt,19/10/2006,12,0,0,0,3,0,0,15
Egypt,20/10/2006,16,0,0,0,11,0,0,27
Egypt,21/10/2006,0,0,0,0,0,0,0,0
Egypt,22/10/2006,0,0,1,0,-1,1,0,1
Egypt,23/10/2006,18,0,0,0,6,0,0,24
Egypt,24/10/2006,4,0,0,0,15,0,0,19
Egypt,25/10/2006,12,0,0,0,3,0,0,15
Egypt,26/10/2006,5,0,0,0,0,6,0,11
Egypt,27/10/2006,19,0,0,0,3,1,0,23
Egypt,28/10/2006,33,0,0,0,4,0,0,37
Egypt,29/10/2006,17,0,0,0,1,0,0,18
Egypt,30/10/2006,11,0,0,0,22,0,0,33
Egypt,31/10/2006,4,0,0,0,33,3,0,40
Eritrea,01/10/2006,4,0,0,0,0,0,0,4
Eritrea,02/10/2006,0,0,0,0,0,0,0,0
Eritrea,03/10/2006,4,0,0,0,0,0,0,4
Eritrea,04/10/2006,0,0,0,0,4,0,0,4
Eritrea,05/10/2006,0,0,0,0,0,0,0,0
Eritrea,06/10/2006,0,0,0,0,0,0,0,0
Eritrea,09/10/2006,3,0,0,0,0,0,0,3
Eritrea,10/10/2006,0,0,0,0,0,0,0,0
Eritrea,11/10/2006,0,0,0,0,0,0,0,0
Eritrea,12/10/2006,0,0,0,0,0,0,0,0
Eritrea,14/10/2006,3,0,0,0,0,1,0,4
Eritrea,15/10/2006,0,0,0,0,0,0,0,0
Eritrea,16/10/2006,0,0,2,0,0,0,0,2
Eritrea,17/10/2006,5,0,0,0,0,0,0,5
Eritrea,18/10/2006,4,0,0,0,0,1,0,5
Eritrea,19/10/2006,13,0,0,0,0,4,0,17
Eritrea,20/10/2006,1,0,0,0,0,0,0,1
Eritrea,21/10/2006,0,0,0,0,0,0,0,0
Eritrea,23/10/2006,0,0,0,0,0,0,0,0
Eritrea,24/10/2006,0,0,0,0,9,0,0,9
Eritrea,26/10/2006,3,0,0,0,0,0,0,3
Eritrea,27/10/2006,8,0,0,0,0,0,0,8
Eritrea,28/10/2006,10,0,0,0,0,0,0,10
Eritrea,29/10/2006,11,0,0,0,3,0,0,14
Eritrea,30/10/2006,9,0,0,0,3,0,0,12
Eritrea,31/10/2006,0,0,0,0,0,0,0,0
Georgia,01/10/2006,5,0,0,0,0,0,0,5
Georgia,02/10/2006,3,0,0,0,7,1,0,11
Georgia,03/10/2006,0,0,0,0,9,2,0,11
Georgia,04/10/2006,9,0,0,0,12,0,0,21
Georgia,05/10/2006,4,0,0,0,1,1,0,6
Georgia,06/10/2006,4,2,0,0,8,0,0,14
Georgia,07/10/2006,2,2,0,0,0,0,0,4
Georgia,08/10/2006,8,0,0,0,3,2,0,13
Georgia,09/10/2006,0,0,0,0,0,0,0,0
Georgia,10/10/2006,-1,0,0,0,0,0,0,-1
Georgia,11/10/2006,3,0,0,0,0,0,0,3
Georgia,12/10/2006,3,0,0,0,0,0,0,3
Georgia,13/10/2006,3,0,0,0,0,1,0,4
Georgia,14/10/2006,3,0,0,0,0,0,0,3
Georgia,15/10/2006,3,0,0,0,0,0,0,3
Georgia,16/10/2006,0,0,0,0,3,0,0,3
Georgia,17/10/2006,9,0,0,0,3,1,0,13
Georgia,18/10/2006,11,0,0,0,0,0,0,11
Georgia,19/10/2006,0,0,-1,0,0,0,0,-1
Georgia,20/10/2006,4,0,-2,0,3,1,0,6
Georgia,21/10/2006,0,0,0,0,0,0,0,0
Georgia,22/10/2006,1,0,0,0,0,0,0,1
Georgia,23/10/2006,6,0,0,0,0,0,0,6
Georgia,24/10/2006,5,0,0,0,-2,0,0,3
Georgia,25/10/2006,6,0,0,0,0,0,0,6
Georgia,26/10/2006,5,2,0,0,6,0,0,13
Georgia,27/10/2006,0,0,0,0,0,0,0,0
Georgia,28/10/2006,0,0,-2,0,0,2,0,0
Georgia,29/10/2006,0,0,0,0,0,0,0,0
Georgia,30/10/2006,7,0,0,0,3,0,0,10
Georgia,31/10/2006,2,0,0,0,-2,1,0,1
India,01/10/2006,3,0,0,0,15,6,0,24
India,02/10/2006,1,0,1,0,0,0,0,2
India,03/10/2006,4,0,0,0,5,0,0,9
India,04/10/2006,15,2,0,0,3,4,0,24
India,05/10/2006,18,0,0,0,1,0,0,19
India,06/10/2006,4,0,0,0,9,3,0,16
India,07/10/2006,7,0,0,0,3,0,0,10
India,08/10/2006,0,0,0,0,0,0,0,0
India,09/10/2006,16,0,0,0,3,0,0,19
India,10/10/2006,4,0,0,0,0,3,0,7
India,11/10/2006,2,0,1,0,0,0,0,3
India,12/10/2006,1,0,0,0,0,0,0,1
India,13/10/2006,31,0,0,0,3,0,0,34
India,14/10/2006,3,0,0,0,0,2,0,5
India,15/10/2006,0,0,0,0,3,1,0,4
India,16/10/2006,4,0,0,0,0,0,0,4
India,17/10/2006,3,0,0,0,0,3,0,6
India,18/10/2006,2,0,0,0,-2,0,0,0
India,19/10/2006,9,0,0,0,9,2,0,20
India,20/10/2006,10,0,0,0,9,0,0,19
India,21/10/2006,0,0,0,0,0,0,0,0
India,22/10/2006,0,0,0,0,3,0,0,3
India,23/10/2006,11,2,0,0,0,3,0,16
India,24/10/2006,11,0,1,0,-2,2,0,12
India,25/10/2006,8,0,-2,0,0,0,0,6
India,26/10/2006,3,0,-1,0,0,1,0,3
India,27/10/2006,2,2,0,0,9,1,0,14
India,28/10/2006,5,0,0,0,-2,2,0,5
India,29/10/2006,3,0,0,0,0,0,0,3
India,30/10/2006,11,0,0,0,0,0,0,11
India,31/10/2006,15,0,0,0,4,1,0,20
Iran,01/10/2006,14,0,0,0,-6,0,0,8
Iran,02/10/2006,13,0,0,0,0,1,0,14
Iran,03/10/2006,23,0,0,0,6,4,0,33
Iran,04/10/2006,21,0,-1,0,6,2,0,28
Iran,05/10/2006,20,0,0,0,5,2,0,27
Iran,06/10/2006,13,0,0,0,3,1,0,17
Iran,07/10/2006,11,0,0,0,0,0,0,11
Iran,08/10/2006,6,0,0,0,2,0,0,8
Iran,09/10/2006,9,0,0,0,4,1,0,14
Iran,10/10/2006,34,0,3,0,4,0,0,41
Iran,11/10/2006,3,0,0,0,-1,0,0,2
Iran,12/10/2006,5,2,0,0,-6,0,0,1
Iran,13/10/2006,2,0,0,0,1,1,0,4
Iran,14/10/2006,2,0,0,0,0,1,0,3
Iran,15/10/2006,17,0,0,0,0,2,0,19
Iran,16/10/2006,32,0,-2,0,9,8,0,47
Iran,17/10/2006,15,0,0,0,19,5,0,39
Iran,18/10/2006,21,0,0,0,0,0,0,21
Iran,19/10/2006,26,0,0,0,8,0,0,34
Iran,20/10/2006,5,0,0,0,9,2,0,16
Iran,21/10/2006,2,0,0,0,0,-1,0,1
Iran,22/10/2006,-2,0,0,0,0,2,0,0
Iran,23/10/2006,34,0,0,0,-4,2,0,32
Iran,24/10/2006,4,0,-2,0,1,3,0,6
Iran,25/10/2006,10,0,-1,0,6,0,0,15
Iran,26/10/2006,14,0,0,0,0,1,0,15
Iran,27/10/2006,18,0,1,0,15,0,0,34
Iran,28/10/2006,10,0,2,0,18,1,0,31
Iran,29/10/2006,14,0,3,0,4,4,0,25
Iran,30/10/2006,12,0,-8,0,15,1,0,20
Iran,31/10/2006,51,0,-4,0,14,2,0,63
Iraq,01/10/2006,38,0,-5,0,14,5,0,52
Iraq,02/10/2006,75,0,-2,0,14,7,0,94
Iraq,03/10/2006,97,0,0,0,-10,6,0,93
Iraq,04/10/2006,52,0,0,0,33,7,0,92
Iraq,05/10/2006,59,0,0,0,22,7,0,88
Iraq,06/10/2006,120,0,-10,0,12,13,0,135
Iraq,07/10/2006,76,0,-5,0,48,0,0,119
Iraq,08/10/2006,6,0,0,0,3,1,0,10
Iraq,09/10/2006,24,0,1,0,9,4,0,38
Iraq,10/10/2006,38,0,0,0,24,5,0,67
Iraq,11/10/2006,29,2,0,0,19,2,0,52
Iraq,12/10/2006,36,0,0,0,21,0,0,57
Iraq,13/10/2006,83,2,0,0,1,2,0,88
Iraq,14/10/2006,44,0,0,0,8,6,0,58
Iraq,15/10/2006,29,0,0,0,-2,0,0,27
Iraq,16/10/2006,50,0,0,0,30,0,0,80
Iraq,17/10/2006,39,0,1,0,3,1,0,44
Iraq,18/10/2006,40,0,2,0,-1,2,0,43
Iraq,19/10/2006,46,0,2,0,23,8,0,79
Iraq,20/10/2006,23,0,-2,0,6,2,0,29
Iraq,21/10/2006,12,2,3,0,-6,1,0,12
Iraq,22/10/2006,48,0,0,0,6,1,0,55
Iraq,23/10/2006,70,6,-2,0,54,26,0,154
Iraq,24/10/2006,82,0,-10,0,20,4,0,96
Iraq,25/10/2006,21,0,-8,0,7,4,0,24
Iraq,26/10/2006,17,0,1,0,18,8,0,44
Iraq,27/10/2006,100,0,2,0,35,15,0,152
Iraq,28/10/2006,92,2,-2,0,5,3,0,100
Iraq,29/10/2006,68,6,1,0,10,14,0,99
Iraq,30/10/2006,78,0,0,0,24,4,0,106
Iraq,31/10/2006,171,0,-4,0,-1,23,0,189
Morocco,01/10/2006,0,0,0,0,0,1,0,1
Morocco,02/10/2006,6,0,0,0,0,0,0,6
Morocco,03/10/2006,6,0,0,0,0,0,0,6
Morocco,04/10/2006,0,0,0,0,0,0,0,0
Morocco,05/10/2006,2,0,0,0,0,0,0,2
Morocco,06/10/2006,50,2,1,0,38,14,0,105
Morocco,07/10/2006,2,0,0,0,6,2,0,10
Morocco,08/10/2006,2,0,0,0,0,2,0,4
Morocco,09/10/2006,0,0,0,0,0,6,0,6
Morocco,10/10/2006,0,0,0,0,0,3,0,3
Morocco,11/10/2006,2,0,0,0,18,0,0,20
Morocco,12/10/2006,1,0,0,0,9,0,0,10
Morocco,13/10/2006,0,0,0,0,0,0,0,0
Morocco,15/10/2006,2,0,0,0,0,0,0,2
Morocco,16/10/2006,0,0,0,0,0,0,0,0
Morocco,17/10/2006,2,0,0,0,0,1,0,3
Morocco,19/10/2006,1,0,0,0,-6,0,0,-5
Morocco,20/10/2006,2,0,0,0,0,0,0,2
Morocco,21/10/2006,0,0,0,0,-1,0,0,-1
Morocco,22/10/2006,0,0,0,0,0,0,0,0
Morocco,23/10/2006,0,0,0,0,3,0,0,3
Morocco,24/10/2006,-1,0,0,0,0,0,0,-1
Morocco,26/10/2006,4,0,0,0,3,1,0,8
Morocco,27/10/2006,1,0,0,0,11,0,0,12
Morocco,29/10/2006,4,0,0,0,6,0,0,10
Morocco,30/10/2006,0,0,0,0,0,0,0,0
Morocco,31/10/2006,-6,0,0,0,0,0,0,-6
Nigeria,01/10/2006,3,2,1,0,10,0,0,16
Nigeria,02/10/2006,21,0,0,0,0,0,0,21
Nigeria,03/10/2006,18,0,1,0,14,0,0,33
Nigeria,04/10/2006,8,0,0,0,9,1,0,18
Nigeria,05/10/2006,5,0,-2,0,0,2,0,5
Nigeria,06/10/2006,12,0,-2,0,12,0,0,22
Nigeria,07/10/2006,0,0,0,0,0,0,0,0
Nigeria,08/10/2006,4,0,0,0,3,0,0,7
Nigeria,09/10/2006,15,0,-2,0,3,0,0,16
Nigeria,10/10/2006,19,0,4,0,1,0,0,24
Nigeria,11/10/2006,11,0,0,0,7,3,0,21
Nigeria,12/10/2006,8,0,0,0,3,0,0,11
Nigeria,13/10/2006,12,0,2,0,0,1,0,15
Nigeria,14/10/2006,1,0,0,0,0,1,0,2
Nigeria,15/10/2006,0,0,0,0,0,0,0,0
Nigeria,16/10/2006,8,0,0,0,3,0,0,11
Nigeria,17/10/2006,3,0,1,0,0,1,0,5
Nigeria,18/10/2006,15,2,0,0,-2,2,0,17
Nigeria,19/10/2006,16,0,0,0,-2,0,0,14
Nigeria,20/10/2006,7,0,0,0,-3,2,0,6
Nigeria,21/10/2006,4,0,0,0,0,0,0,4
Nigeria,22/10/2006,15,0,2,0,2,1,0,20
Nigeria,23/10/2006,16,0,0,0,3,0,0,19
Nigeria,24/10/2006,11,0,0,0,2,3,0,16
Nigeria,25/10/2006,0,0,0,0,0,0,0,0
Nigeria,26/10/2006,-1,0,0,0,0,0,0,-1
Nigeria,27/10/2006,10,0,0,0,-2,2,0,10
Nigeria,28/10/2006,3,0,0,0,6,1,0,10
Nigeria,29/10/2006,39,2,0,0,33,11,0,85
Nigeria,30/10/2006,43,0,0,0,31,6,0,80
Nigeria,31/10/2006,21,0,-2,0,9,0,0,28
Pakistan,01/10/2006,19,0,0,0,9,0,0,28
Pakistan,02/10/2006,6,0,0,0,9,0,0,15
Pakistan,03/10/2006,8,0,0,0,3,3,0,14
Pakistan,04/10/2006,31,0,0,0,-1,0,0,30
Pakistan,05/10/2006,17,2,0,0,1,2,0,22
Pakistan,06/10/2006,31,4,0,0,19,9,0,63
Pakistan,07/10/2006,6,6,0,0,9,0,0,21
Pakistan,08/10/2006,16,0,0,0,3,1,0,20
Pakistan,09/10/2006,61,0,0,0,0,5,0,66
Pakistan,10/10/2006,32,0,0,0,6,1,0,39
Pakistan,11/10/2006,13,0,0,0,6,0,0,19
Pakistan,12/10/2006,10,0,0,0,3,0,0,13
Pakistan,13/10/2006,4,0,0,0,1,0,0,5
Pakistan,14/10/2006,17,0,-1,0,3,0,0,19
Pakistan,15/10/2006,30,0,-1,0,0,2,0,31
Pakistan,16/10/2006,17,0,0,0,9,0,0,26
Pakistan,17/10/2006,21,0,0,0,5,8,0,34
Pakistan,18/10/2006,27,0,0,0,15,0,0,42
Pakistan,19/10/2006,2,0,0,0,9,0,0,11
Pakistan,20/10/2006,6,0,0,0,6,0,0,12
Pakistan,21/10/2006,0,0,-1,0,0,3,0,2
Pakistan,22/10/2006,8,0,0,0,6,0,0,14
Pakistan,23/10/2006,5,0,0,0,4,0,0,9
Pakistan,24/10/2006,14,0,-4,0,10,2,0,22
Pakistan,25/10/2006,2,0,0,0,0,0,0,2
Pakistan,26/10/2006,4,0,0,0,-3,1,0,2
Pakistan,27/10/2006,30,0,0,0,21,1,0,52
Pakistan,28/10/2006,16,0,0,0,3,0,0,19
Pakistan,29/10/2006,9,0,0,0,0,1,0,10
Pakistan,30/10/2006,68,0,0,0,24,4,0,96
Pakistan,31/10/2006,34,0,-2,0,13,4,0,49
Sierra Leone,02/10/2006,0,0,0,0,3,0,0,3
Sierra Leone,03/10/2006,0,0,0,0,0,0,0,0
Sierra Leone,04/10/2006,3,0,0,0,9,0,0,12
Sierra Leone,05/10/2006,2,0,0,0,3,0,0,5
Sierra Leone,06/10/2006,0,0,0,0,0,0,0,0
Sierra Leone,07/10/2006,4,0,0,0,0,0,0,4
Sierra Leone,09/10/2006,3,0,0,0,0,0,0,3
Sierra Leone,10/10/2006,-1,0,-2,0,0,0,0,-3
Sierra Leone,11/10/2006,1,0,0,0,0,0,0,1
Sierra Leone,12/10/2006,0,0,0,0,0,1,0,1
Sierra Leone,13/10/2006,10,0,0,0,3,0,0,13
Sierra Leone,14/10/2006,0,0,0,0,-2,0,0,-2
Sierra Leone,16/10/2006,2,0,0,0,0,0,0,2
Sierra Leone,17/10/2006,0,0,0,0,0,2,0,2
Sierra Leone,18/10/2006,3,0,0,0,0,1,0,4
Sierra Leone,19/10/2006,0,0,0,0,0,0,0,0
Sierra Leone,20/10/2006,0,0,0,0,0,0,0,0
Sierra Leone,23/10/2006,0,0,0,0,-2,0,0,-2
Sierra Leone,24/10/2006,3,0,0,0,0,0,0,3
Sierra Leone,25/10/2006,2,0,0,0,0,0,0,2
Sierra Leone,26/10/2006,4,0,0,0,0,0,0,4
Sierra Leone,27/10/2006,0,0,0,0,0,0,0,0
Sierra Leone,30/10/2006,0,0,0,0,0,0,0,0
Sierra Leone,31/10/2006,4,0,-2,0,0,0,0,2
Somalia,01/10/2006,3,0,0,0,0,0,0,3
Somalia,02/10/2006,10,0,0,0,0,0,0,10
Somalia,03/10/2006,2,0,0,0,0,0,0,2
Somalia,04/10/2006,19,0,0,0,-2,1,0,18
Somalia,05/10/2006,6,0,0,0,0,2,0,8
Somalia,06/10/2006,6,0,0,0,0,2,0,8
Somalia,07/10/2006,9,0,0,0,0,0,0,9
Somalia,08/10/2006,0,0,0,0,0,0,0,0
Somalia,09/10/2006,5,0,0,0,3,0,0,8
Somalia,10/10/2006,9,0,0,0,-2,2,0,9
Somalia,11/10/2006,-1,0,0,0,0,4,0,3
Somalia,12/10/2006,1,0,0,0,0,0,0,1
Somalia,13/10/2006,1,2,0,0,0,3,0,6
Somalia,14/10/2006,8,0,-6,0,0,0,0,2
Somalia,15/10/2006,3,0,0,0,0,0,0,3
Somalia,16/10/2006,0,0,-4,0,0,0,0,-4
Somalia,17/10/2006,5,4,-4,0,0,0,0,5
Somalia,18/10/2006,8,0,-2,0,0,0,0,6
Somalia,19/10/2006,7,0,0,0,0,0,0,7
Somalia,20/10/2006,3,0,0,0,0,2,0,5
Somalia,21/10/2006,12,0,0,0,-2,0,0,10
Somalia,22/10/2006,1,0,0,0,0,0,0,1
Somalia,23/10/2006,6,0,0,0,0,0,0,6
Somalia,24/10/2006,0,0,0,0,0,0,0,0
Somalia,25/10/2006,4,0,0,0,0,1,0,5
Somalia,26/10/2006,0,0,0,0,12,0,0,12
Somalia,27/10/2006,10,0,0,0,27,0,0,37
Somalia,28/10/2006,8,0,0,0,9,3,0,20
Somalia,29/10/2006,3,0,0,0,6,0,0,9
Somalia,30/10/2006,6,0,0,0,6,0,0,12
Somalia,31/10/2006,6,0,1,0,3,0,0,10
Syria,01/10/2006,7,0,0,0,9,2,0,18
Syria,02/10/2006,3,0,0,0,0,0,0,3
Syria,03/10/2006,2,0,0,0,0,0,0,2
Syria,04/10/2006,12,0,0,0,13,0,0,25
Syria,05/10/2006,15,0,0,0,0,1,0,16
Syria,06/10/2006,14,0,0,0,6,6,0,26
Syria,07/10/2006,12,0,0,0,3,2,0,17
Syria,08/10/2006,5,0,0,0,0,0,0,5
Syria,09/10/2006,2,0,0,0,0,0,0,2
Syria,10/10/2006,19,0,0,0,0,1,0,20
Syria,11/10/2006,15,0,2,0,3,0,0,20
Syria,12/10/2006,12,0,2,0,6,0,0,20
Syria,13/10/2006,2,0,0,0,1,0,0,3
Syria,14/10/2006,5,0,0,0,0,0,0,5
Syria,15/10/2006,1,0,0,0,0,0,0,1
Syria,16/10/2006,0,0,0,0,0,0,0,0
Syria,17/10/2006,1,0,0,0,-2,0,0,-1
Syria,18/10/2006,9,0,0,0,0,0,0,9
Syria,19/10/2006,1,0,0,0,1,0,0,2
Syria,20/10/2006,2,0,0,0,0,0,0,2
Syria,21/10/2006,2,0,0,0,0,0,0,2
Syria,22/10/2006,0,0,0,0,0,0,0,0
Syria,23/10/2006,11,0,0,0,0,1,0,12
Syria,24/10/2006,9,0,0,0,0,0,0,9
Syria,25/10/2006,12,0,0,0,0,0,0,12
Syria,26/10/2006,0,0,0,0,3,0,0,3
Syria,27/10/2006,15,0,-1,0,3,0,0,17
Syria,28/10/2006,9,0,2,0,-2,0,0,9
Syria,29/10/2006,23,0,0,0,0,4,0,27
Syria,30/10/2006,6,0,0,0,9,2,0,17
Syria,31/10/2006,20,0,0,0,12,0,0,32
Yemen,01/10/2006,18,0,0,0,27,15,0,60
Yemen,02/10/2006,3,0,0,0,9,0,0,12
Yemen,03/10/2006,0,0,0,0,6,0,0,6
Yemen,04/10/2006,0,0,0,0,0,0,0,0
Yemen,05/10/2006,0,0,0,0,18,0,0,18
Yemen,06/10/2006,0,0,0,0,0,0,0,0
Yemen,07/10/2006,1,0,0,0,0,0,0,1
Yemen,08/10/2006,1,0,0,0,0,0,0,1
Yemen,10/10/2006,-2,0,0,0,0,0,0,-2
Yemen,11/10/2006,7,0,0,0,6,2,0,15
Yemen,12/10/2006,0,0,0,0,0,0,0,0
Yemen,13/10/2006,0,0,0,0,0,0,0,0
Yemen,14/10/2006,0,0,0,0,0,0,0,0
Yemen,15/10/2006,0,0,0,0,0,0,0,0
Yemen,16/10/2006,0,0,0,0,12,0,0,12
Yemen,17/10/2006,9,0,0,0,-4,0,0,5
Yemen,23/10/2006,2,0,0,0,0,0,0,2
Yemen,26/10/2006,0,0,1,0,3,0,0,4
Yemen,27/10/2006,2,0,0,0,0,2,0,4
Yemen,28/10/2006,0,0,0,0,0,12,0,12
Yemen,29/10/2006,4,0,0,0,21,0,0,25
Yemen,30/10/2006,4,0,0,0,21,0,0,25
Yemen,31/10/2006,8,0,1,0,21,0,0,30
Afghanistan,01/01/2003,45,0,0,0,7,5,0,57
Afghanistan,02/01/2003,30,0,0,0,7,38,0,75
Afghanistan,03/01/2003,73,0,0,0,13,1,0,87
Afghanistan,04/01/2003,25,0,-2,0,9,2,0,34
Afghanistan,05/01/2003,15,0,0,0,2,0,0,17
Afghanistan,06/01/2003,16,0,0,0,4,1,0,21
Afghanistan,07/01/2003,54,0,0,0,6,3,0,63
Afghanistan,08/01/2003,40,0,0,0,14,8,0,62
Afghanistan,09/01/2003,41,0,0,0,28,8,0,77
Afghanistan,10/01/2003,8,0,1,0,33,1,0,43
Afghanistan,11/01/2003,40,0,0,0,-9,0,0,31
Afghanistan,12/01/2003,15,0,0,0,13,6,0,34
Afghanistan,13/01/2003,19,0,-1,0,52,6,0,76
Afghanistan,14/01/2003,24,0,0,0,24,0,0,48
Afghanistan,15/01/2003,17,6,0,0,0,0,0,23
Afghanistan,16/01/2003,21,0,0,0,15,0,0,36
Afghanistan,17/01/2003,36,0,0,0,21,2,0,59
Afghanistan,18/01/2003,8,0,0,0,-5,4,0,7
Afghanistan,19/01/2003,19,0,0,0,5,3,0,27
Afghanistan,20/01/2003,16,0,0,0,15,1,0,32
Afghanistan,21/01/2003,37,0,-2,0,27,2,0,64
Afghanistan,22/01/2003,47,4,1,0,27,2,0,81
Afghanistan,23/01/2003,35,0,0,0,22,0,0,57
Afghanistan,24/01/2003,24,0,0,0,6,0,0,30
Afghanistan,25/01/2003,17,0,0,0,3,4,0,24
Afghanistan,26/01/2003,31,2,0,0,28,0,0,61
Afghanistan,27/01/2003,33,0,0,0,10,7,0,50
Afghanistan,28/01/2003,50,0,0,0,16,3,0,69
Afghanistan,29/01/2003,59,0,0,0,13,3,0,75
Afghanistan,30/01/2003,47,0,0,0,9,7,0,63
Afghanistan,31/01/2003,42,0,0,0,21,11,0,74
Afghanistan,01/02/2003,13,0,0,0,-8,0,0,5
Afghanistan,02/02/2003,19,0,0,0,9,5,0,33
Afghanistan,03/02/2003,24,4,1,0,-7,0,0,22
Afghanistan,04/02/2003,40,0,0,0,24,6,0,70
Afghanistan,05/02/2003,10,0,0,0,9,2,0,21
Afghanistan,06/02/2003,67,0,0,0,-14,3,0,56
Afghanistan,07/02/2003,44,0,0,0,4,7,0,55
Afghanistan,08/02/2003,22,0,0,0,6,1,0,29
Afghanistan,09/02/2003,36,2,0,0,2,0,0,40
Afghanistan,10/02/2003,22,0,0,0,9,0,0,31
Afghanistan,11/02/2003,21,0,0,0,-4,0,0,17
Afghanistan,12/02/2003,31,0,0,0,5,0,0,36
Afghanistan,13/02/2003,11,0,0,0,0,0,0,11
Afghanistan,14/02/2003,31,0,1,0,13,1,0,46
Afghanistan,15/02/2003,5,0,3,0,6,0,0,14
Afghanistan,16/02/2003,14,0,0,0,5,0,0,19
Afghanistan,17/02/2003,13,0,0,0,15,0,0,28
Afghanistan,18/02/2003,22,0,0,0,5,3,0,30
Afghanistan,19/02/2003,66,0,0,0,11,1,0,78
Afghanistan,20/02/2003,54,0,0,0,4,3,0,61
Afghanistan,21/02/2003,30,4,2,0,12,0,0,48
Afghanistan,22/02/2003,37,0,0,0,9,3,0,49
Afghanistan,23/02/2003,15,0,0,0,0,1,0,16
Afghanistan,24/02/2003,63,0,0,0,18,2,0,83
Afghanistan,25/02/2003,71,0,0,0,9,0,0,80
Afghanistan,26/02/2003,50,0,0,0,4,0,0,54
Afghanistan,27/02/2003,12,0,0,0,0,5,0,17
Afghanistan,28/02/2003,25,0,0,0,21,0,0,46
Afghanistan,01/03/2003,53,0,0,0,19,0,0,72
Afghanistan,02/03/2003,20,0,0,0,13,0,0,33
Afghanistan,03/03/2003,32,0,0,0,7,3,0,42
Afghanistan,04/03/2003,25,0,0,0,-10,3,0,18
Afghanistan,05/03/2003,26,0,0,0,2,5,0,33
Afghanistan,06/03/2003,30,0,0,0,19,0,0,49
Afghanistan,07/03/2003,42,0,0,0,46,0,0,88
Afghanistan,08/03/2003,17,0,0,0,24,0,0,41
Afghanistan,09/03/2003,17,0,0,0,15,0,0,32
Afghanistan,10/03/2003,12,0,0,0,-3,2,0,11
Afghanistan,11/03/2003,25,2,0,0,10,1,0,38
Afghanistan,12/03/2003,32,0,0,0,-3,7,0,36
Afghanistan,13/03/2003,26,0,0,0,15,2,0,43
Afghanistan,14/03/2003,34,0,0,0,-2,4,0,36
Afghanistan,15/03/2003,7,0,0,0,2,0,0,9
Afghanistan,16/03/2003,26,0,0,0,9,2,0,37
Afghanistan,17/03/2003,31,10,0,0,23,6,0,70
Afghanistan,18/03/2003,15,6,0,0,8,1,0,30
Afghanistan,19/03/2003,36,0,0,0,-6,1,0,31
Afghanistan,20/03/2003,50,0,0,0,9,14,0,73
Afghanistan,21/03/2003,29,0,0,0,9,4,0,42
Afghanistan,22/03/2003,12,0,0,0,6,0,0,18
Afghanistan,23/03/2003,33,0,0,0,-2,6,0,37
Afghanistan,24/03/2003,16,0,0,0,16,1,0,33
Afghanistan,25/03/2003,49,2,0,0,2,6,0,59
Afghanistan,26/03/2003,31,0,-4,0,12,6,0,45
Afghanistan,27/03/2003,15,0,0,0,-3,6,0,18
Afghanistan,28/03/2003,6,0,0,0,-3,0,0,3
Afghanistan,29/03/2003,6,0,0,0,6,0,0,12
Afghanistan,30/03/2003,7,0,0,0,-1,0,0,6
Afghanistan,31/03/2003,10,0,1,0,9,2,0,22
Afghanistan,01/04/2003,13,0,0,0,21,4,0,38
Afghanistan,02/04/2003,21,0,0,0,3,2,0,26
Afghanistan,03/04/2003,15,0,0,0,9,1,0,25
Afghanistan,04/04/2003,9,0,0,0,0,2,0,11
Afghanistan,05/04/2003,14,0,0,0,4,0,0,18
Afghanistan,06/04/2003,31,0,0,0,6,0,0,37
Afghanistan,07/04/2003,57,0,0,0,6,2,0,65
Afghanistan,08/04/2003,37,0,-5,0,-2,3,0,33
Afghanistan,09/04/2003,28,0,0,0,0,3,0,31
Afghanistan,10/04/2003,23,0,0,0,16,2,0,41
Afghanistan,11/04/2003,19,0,0,0,15,2,0,36
Afghanistan,12/04/2003,38,0,0,0,0,2,0,40
Afghanistan,13/04/2003,28,0,0,0,0,2,0,30
Afghanistan,14/04/2003,36,0,1,0,15,6,0,58
Afghanistan,15/04/2003,15,2,0,0,12,3,0,32
Afghanistan,16/04/2003,33,0,0,0,6,1,0,40
Afghanistan,17/04/2003,3,2,0,0,-2,2,0,5
Afghanistan,18/04/2003,9,0,0,0,-7,0,0,2
Afghanistan,19/04/2003,25,0,0,0,0,0,0,25
Afghanistan,20/04/2003,6,0,0,0,-9,0,0,-3
Afghanistan,21/04/2003,28,0,0,0,-14,2,0,16
Afghanistan,22/04/2003,23,0,-1,0,2,2,0,26
Afghanistan,23/04/2003,20,0,0,0,12,4,0,36
Afghanistan,24/04/2003,25,0,0,0,11,1,0,37
Afghanistan,25/04/2003,28,0,0,0,16,3,0,47
Afghanistan,26/04/2003,7,0,0,0,2,0,0,9
Afghanistan,27/04/2003,39,0,-2,0,6,3,0,46
Afghanistan,28/04/2003,34,0,-4,0,12,7,0,49
Afghanistan,29/04/2003,15,0,0,0,0,4,0,19
Afghanistan,30/04/2003,28,0,0,0,20,0,0,48
Afghanistan,01/05/2003,19,0,0,0,21,0,0,40
Afghanistan,02/05/2003,16,0,0,0,10,4,0,30
Afghanistan,03/05/2003,16,2,0,0,1,1,0,20
Afghanistan,04/05/2003,11,0,0,0,9,8,0,28
Afghanistan,05/05/2003,10,0,0,0,24,1,0,35
Afghanistan,06/05/2003,34,0,0,0,4,3,0,41
Afghanistan,07/05/2003,22,0,-7,0,4,2,0,21
Afghanistan,08/05/2003,17,0,0,0,6,0,0,23
Afghanistan,09/05/2003,26,0,1,0,24,6,0,57
Afghanistan,10/05/2003,40,0,1,0,12,5,0,58
Afghanistan,11/05/2003,24,2,0,0,11,1,0,38
Afghanistan,12/05/2003,26,0,0,0,1,0,0,27
Afghanistan,13/05/2003,13,0,0,0,15,0,0,28
Afghanistan,14/05/2003,23,0,0,0,4,7,0,34
Afghanistan,15/05/2003,38,4,0,0,12,1,0,55
Afghanistan,16/05/2003,17,0,0,0,3,0,0,20
Afghanistan,17/05/2003,25,0,0,0,-7,2,0,20
Afghanistan,18/05/2003,42,0,0,0,1,4,0,47
Afghanistan,19/05/2003,37,0,1,0,12,0,0,50
Afghanistan,20/05/2003,22,0,-6,0,8,2,0,26
Afghanistan,21/05/2003,32,0,-2,0,3,6,0,39
Afghanistan,22/05/2003,66,0,0,0,21,6,0,93
Afghanistan,23/05/2003,30,0,0,0,-3,8,0,35
Afghanistan,24/05/2003,16,4,1,0,13,2,0,36
Afghanistan,25/05/2003,28,0,0,0,11,0,0,39
Afghanistan,26/05/2003,5,0,0,0,3,0,0,8
Afghanistan,27/05/2003,7,0,0,0,3,0,0,10
Afghanistan,28/05/2003,47,0,0,0,29,2,0,78
Afghanistan,29/05/2003,8,2,0,0,12,2,0,24
Afghanistan,30/05/2003,17,0,0,0,6,0,0,23
Afghanistan,31/05/2003,15,2,0,0,-10,2,0,9
Afghanistan,01/06/2003,2,2,0,0,20,3,0,27
Afghanistan,02/06/2003,51,0,0,0,12,0,0,63
Afghanistan,03/06/2003,6,0,0,0,1,4,0,11
Afghanistan,04/06/2003,33,0,1,0,12,3,0,49
Afghanistan,05/06/2003,6,0,0,0,20,8,0,34
Afghanistan,06/06/2003,49,0,0,0,-11,4,0,42
Afghanistan,07/06/2003,2,0,0,0,-14,0,0,-12
Afghanistan,08/06/2003,10,2,0,0,2,3,0,17
Afghanistan,09/06/2003,19,0,0,0,19,3,0,41
Afghanistan,10/06/2003,23,0,0,0,15,6,0,44
Afghanistan,11/06/2003,24,0,0,0,16,4,0,44
Afghanistan,12/06/2003,39,2,0,0,9,0,0,50
Afghanistan,13/06/2003,6,0,0,0,2,0,0,8
Afghanistan,14/06/2003,-6,0,0,0,8,1,0,3
Afghanistan,15/06/2003,10,0,0,0,9,2,0,21
Afghanistan,16/06/2003,32,0,0,0,15,5,0,52
Afghanistan,17/06/2003,14,0,0,0,2,0,0,16
Afghanistan,18/06/2003,46,0,-1,0,19,5,0,69
Afghanistan,19/06/2003,40,0,-2,0,29,6,0,73
Afghanistan,20/06/2003,9,0,0,0,-15,7,0,1
Afghanistan,21/06/2003,20,0,0,0,8,6,0,34
Afghanistan,22/06/2003,25,0,0,0,21,0,0,46
Afghanistan,23/06/2003,45,0,-1,0,32,0,0,76
Afghanistan,24/06/2003,20,0,0,0,13,2,0,35
Afghanistan,25/06/2003,10,0,0,0,-6,8,0,12
Afghanistan,26/06/2003,54,0,0,0,-3,3,0,54
Afghanistan,27/06/2003,29,0,0,0,0,1,0,30
Afghanistan,28/06/2003,44,0,0,0,4,4,0,52
Afghanistan,29/06/2003,22,0,0,0,9,0,0,31
Afghanistan,30/06/2003,18,0,0,0,12,2,0,32
Afghanistan,01/07/2003,38,0,0,0,20,3,0,61
Afghanistan,02/07/2003,28,0,0,0,14,0,0,42
Afghanistan,03/07/2003,58,0,0,0,9,9,0,76
Afghanistan,04/07/2003,23,0,0,0,27,2,0,52
Afghanistan,05/07/2003,25,0,0,0,12,0,0,37
Afghanistan,06/07/2003,42,0,1,0,15,1,0,59
Afghanistan,07/07/2003,36,0,0,0,13,0,0,49
Afghanistan,08/07/2003,24,0,-2,0,5,3,0,30
Afghanistan,09/07/2003,25,0,0,0,8,2,0,35
Afghanistan,10/07/2003,57,0,0,0,16,3,0,76
Afghanistan,11/07/2003,14,0,0,0,-7,0,0,7
Afghanistan,12/07/2003,7,0,0,0,-6,2,0,3
Afghanistan,13/07/2003,40,0,0,0,7,0,0,47
Afghanistan,14/07/2003,32,0,0,0,0,0,0,32
Afghanistan,15/07/2003,8,0,-2,0,27,2,0,35
Afghanistan,16/07/2003,28,0,0,0,15,2,0,45
Afghanistan,17/07/2003,25,0,0,0,23,0,0,48
Afghanistan,18/07/2003,21,0,0,0,21,0,0,42
Afghanistan,19/07/2003,23,0,0,0,38,0,0,61
Afghanistan,20/07/2003,14,0,0,0,6,0,0,20
Afghanistan,21/07/2003,24,0,0,0,12,0,0,36
Afghanistan,22/07/2003,44,0,0,0,6,0,0,50
Afghanistan,23/07/2003,25,0,0,0,10,0,0,35
Afghanistan,24/07/2003,41,0,0,0,-2,14,0,53
Afghanistan,25/07/2003,13,0,0,0,5,5,0,23
Afghanistan,26/07/2003,17,0,0,0,9,8,0,34
Afghanistan,27/07/2003,11,0,0,0,3,4,0,18
Afghanistan,28/07/2003,12,0,0,0,14,3,0,29
Afghanistan,29/07/2003,16,0,0,0,2,3,0,21
Afghanistan,30/07/2003,47,0,0,0,6,5,0,58
Afghanistan,31/07/2003,36,0,0,0,7,8,0,51
Afghanistan,01/08/2003,16,0,0,0,0,0,0,16
Afghanistan,02/08/2003,11,0,0,0,-4,0,0,7
Afghanistan,03/08/2003,8,0,0,0,11,0,0,19
Afghanistan,04/08/2003,43,2,0,0,6,0,0,51
Afghanistan,05/08/2003,15,0,0,0,3,0,0,18
Afghanistan,06/08/2003,34,0,0,0,15,0,0,49
Afghanistan,07/08/2003,20,0,0,0,17,8,0,45
Afghanistan,08/08/2003,12,0,0,0,36,1,0,49
Afghanistan,09/08/2003,13,0,0,0,-3,7,0,17
Afghanistan,10/08/2003,12,0,0,0,27,2,0,41
Afghanistan,11/08/2003,28,0,-1,0,10,4,0,41
Afghanistan,12/08/2003,11,0,0,0,7,3,0,21
Afghanistan,13/08/2003,32,0,0,0,3,-1,0,34
Afghanistan,14/08/2003,49,0,0,0,11,0,0,60
Afghanistan,15/08/2003,3,0,0,0,7,0,0,10
Afghanistan,16/08/2003,15,0,0,0,-1,0,0,14
Afghanistan,17/08/2003,19,0,0,0,6,6,0,31
Afghanistan,18/08/2003,9,0,0,0,2,0,0,11
Afghanistan,19/08/2003,11,0,0,0,6,5,0,22
Afghanistan,20/08/2003,34,0,0,0,3,0,0,37
Afghanistan,21/08/2003,20,0,2,0,7,6,0,35
Afghanistan,22/08/2003,35,0,0,0,1,2,0,38
Afghanistan,23/08/2003,33,0,0,0,-3,2,0,32
Afghanistan,24/08/2003,9,0,0,0,7,1,0,17
Afghanistan,25/08/2003,29,0,0,0,9,0,0,38
Afghanistan,26/08/2003,24,0,0,0,10,2,0,36
Afghanistan,27/08/2003,36,0,0,0,20,5,0,61
Afghanistan,28/08/2003,34,0,0,0,0,0,0,34
Afghanistan,29/08/2003,8,0,0,0,0,2,0,10
Afghanistan,30/08/2003,35,0,0,0,8,0,0,43
Afghanistan,31/08/2003,21,0,0,0,3,2,0,26
Afghanistan,01/09/2003,29,0,0,0,6,0,0,35
Afghanistan,02/09/2003,31,4,1,0,24,4,0,64
Afghanistan,03/09/2003,23,0,-3,0,14,5,0,39
Afghanistan,04/09/2003,22,0,-2,0,-1,4,0,23
Afghanistan,05/09/2003,15,0,0,0,9,0,0,24
Afghanistan,06/09/2003,33,4,0,0,27,0,0,64
Afghanistan,07/09/2003,43,0,0,0,38,2,0,83
Afghanistan,08/09/2003,24,0,0,0,-4,5,0,25
Afghanistan,09/09/2003,18,2,0,0,0,0,0,20
Afghanistan,10/09/2003,67,0,-1,0,31,0,0,97
Afghanistan,11/09/2003,71,0,3,0,24,0,0,98
Afghanistan,12/09/2003,34,0,0,0,24,3,0,61
Afghanistan,13/09/2003,16,0,0,0,4,3,0,23
Afghanistan,14/09/2003,21,0,0,0,12,2,0,35
Afghanistan,15/09/2003,41,0,0,0,13,0,0,54
Afghanistan,16/09/2003,18,0,0,0,15,2,0,35
Afghanistan,17/09/2003,8,0,0,0,-2,2,0,8
Afghanistan,18/09/2003,26,0,0,0,9,2,0,37
Afghanistan,19/09/2003,10,0,0,0,15,0,0,25
Afghanistan,20/09/2003,10,0,0,0,18,4,0,32
Afghanistan,21/09/2003,30,2,0,0,3,0,0,35
Afghanistan,22/09/2003,22,0,-4,0,8,10,0,36
Afghanistan,23/09/2003,27,0,0,0,21,0,0,48
Afghanistan,24/09/2003,28,0,0,0,30,4,0,62
Afghanistan,25/09/2003,38,0,0,0,19,2,0,59
Afghanistan,26/09/2003,14,0,0,0,17,3,0,34
Afghanistan,27/09/2003,8,0,0,0,3,2,0,13
Afghanistan,28/09/2003,7,0,-2,0,6,0,0,11
Afghanistan,29/09/2003,39,2,0,0,22,1,0,64
Afghanistan,30/09/2003,21,2,2,0,3,1,0,29
Afghanistan,01/10/2003,29,6,0,0,13,7,0,55
Afghanistan,02/10/2003,29,4,0,0,2,7,0,42
Afghanistan,03/10/2003,14,0,0,0,21,3,0,38
Afghanistan,04/10/2003,1,0,0,0,16,2,0,19
Afghanistan,05/10/2003,25,0,1,0,-3,0,0,23
Afghanistan,06/10/2003,4,2,0,0,2,0,0,8
Afghanistan,07/10/2003,35,0,0,0,8,2,0,45
Afghanistan,08/10/2003,49,0,0,0,10,0,0,59
Afghanistan,09/10/2003,24,0,0,0,6,1,0,31
Afghanistan,10/10/2003,39,0,2,0,14,1,0,56
Afghanistan,11/10/2003,25,0,0,0,13,0,0,38
Afghanistan,12/10/2003,14,0,0,0,1,0,0,15
Afghanistan,13/10/2003,14,0,0,0,19,1,0,34
Afghanistan,14/10/2003,11,0,0,0,24,3,0,38
Afghanistan,15/10/2003,21,0,0,0,21,4,0,46
Afghanistan,16/10/2003,17,0,0,0,3,2,0,22
Afghanistan,17/10/2003,25,4,0,0,15,0,0,44
Afghanistan,18/10/2003,22,0,0,0,6,3,0,31
Afghanistan,19/10/2003,25,0,0,0,13,0,0,38
Afghanistan,20/10/2003,15,0,0,0,4,2,0,21
Afghanistan,21/10/2003,23,0,0,0,-1,0,0,22
Afghanistan,22/10/2003,21,0,-1,0,18,6,0,44
Afghanistan,23/10/2003,11,0,0,0,6,2,0,19
Afghanistan,24/10/2003,-5,0,0,0,0,6,0,1
Afghanistan,25/10/2003,25,2,0,0,11,0,0,38
Afghanistan,26/10/2003,13,0,0,0,3,1,0,17
Afghanistan,27/10/2003,34,0,0,0,23,2,0,59
Afghanistan,28/10/2003,52,0,-1,0,-3,1,0,49
Afghanistan,29/10/2003,39,0,0,0,-2,0,0,37
Afghanistan,30/10/2003,24,2,0,0,14,0,0,40
Afghanistan,31/10/2003,18,0,0,0,15,1,0,34
Afghanistan,01/11/2003,56,0,0,0,1,5,0,62
Afghanistan,02/11/2003,32,0,0,0,0,0,0,32
Afghanistan,03/11/2003,42,0,0,0,18,7,0,67
Afghanistan,04/11/2003,8,0,0,0,0,3,0,11
Afghanistan,05/11/2003,25,0,0,0,22,4,0,51
Afghanistan,06/11/2003,9,2,0,0,7,0,0,18
Afghanistan,07/11/2003,16,0,0,0,13,1,0,30
Afghanistan,08/11/2003,2,0,0,0,0,1,0,3
Afghanistan,09/11/2003,10,0,0,0,0,12,0,22
Afghanistan,10/11/2003,23,0,0,0,16,3,0,42
Afghanistan,11/11/2003,20,0,0,0,32,7,0,59
Afghanistan,12/11/2003,44,6,0,0,13,16,0,79
Afghanistan,13/11/2003,22,0,0,0,16,7,0,45
Afghanistan,14/11/2003,46,0,0,0,25,2,0,73
Afghanistan,15/11/2003,49,0,0,0,-4,2,0,47
Afghanistan,16/11/2003,39,0,0,0,9,0,0,48
Afghanistan,17/11/2003,39,0,0,0,15,2,0,56
Afghanistan,18/11/2003,20,0,0,0,22,6,0,48
Afghanistan,19/11/2003,37,0,0,0,-3,5,0,39
Afghanistan,20/11/2003,59,0,-1,0,25,5,0,88
Afghanistan,21/11/2003,34,0,0,0,1,2,0,37
Afghanistan,22/11/2003,73,0,0,0,-4,7,0,76
Afghanistan,23/11/2003,30,0,0,0,6,1,0,37
Afghanistan,24/11/2003,38,0,0,0,10,4,0,52
Afghanistan,25/11/2003,36,0,0,0,24,1,0,61
Afghanistan,26/11/2003,22,0,0,0,33,0,0,55
Afghanistan,27/11/2003,16,0,-3,0,5,1,0,19
Afghanistan,28/11/2003,27,0,-6,0,-6,2,0,17
Afghanistan,29/11/2003,22,0,0,0,8,2,0,32
Afghanistan,30/11/2003,54,0,0,0,18,1,0,73
Afghanistan,01/12/2003,60,6,0,0,15,0,0,81
Afghanistan,02/12/2003,20,0,0,0,-5,2,0,17
Afghanistan,03/12/2003,22,0,0,0,19,0,0,41
Afghanistan,04/12/2003,37,0,0,0,42,2,0,81
Afghanistan,05/12/2003,17,0,-1,0,13,0,0,29
Afghanistan,06/12/2003,25,0,-2,0,-3,0,0,20
Afghanistan,07/12/2003,20,0,0,0,10,0,0,30
Afghanistan,08/12/2003,10,0,0,0,0,1,0,11
Afghanistan,09/12/2003,11,0,0,0,37,1,0,49
Afghanistan,10/12/2003,23,0,-4,0,-3,2,0,18
Afghanistan,11/12/2003,21,6,0,0,0,23,0,50
Afghanistan,12/12/2003,27,6,0,0,6,2,0,41
Afghanistan,13/12/2003,21,0,0,0,4,4,0,29
Afghanistan,14/12/2003,18,0,0,0,18,5,0,41
Afghanistan,15/12/2003,22,0,0,0,1,0,0,23
Afghanistan,16/12/2003,26,0,-2,0,37,1,0,62
Afghanistan,17/12/2003,19,0,1,0,36,1,0,57
Afghanistan,18/12/2003,26,0,0,0,29,1,0,56
Afghanistan,19/12/2003,46,0,0,0,27,2,0,75
Afghanistan,20/12/2003,19,0,0,0,24,0,0,43
Afghanistan,21/12/2003,15,0,-2,0,9,3,0,25
Afghanistan,22/12/2003,25,0,0,0,24,4,0,53
Afghanistan,23/12/2003,34,0,3,0,30,1,0,68
Afghanistan,24/12/2003,31,0,0,0,0,7,0,38
Afghanistan,25/12/2003,33,2,-3,0,36,7,0,75
Afghanistan,26/12/2003,17,0,0,0,9,2,0,28
Afghanistan,27/12/2003,30,0,0,0,-2,2,0,30
Afghanistan,28/12/2003,4,0,0,0,6,6,0,16
Afghanistan,29/12/2003,14,8,0,0,19,1,0,42
Afghanistan,30/12/2003,20,0,0,0,23,3,0,46
Afghanistan,31/12/2003,20,0,0,0,13,2,0,35
Albania,01/01/2003,0,0,0,0,6,0,0,6
Albania,02/01/2003,5,0,0,0,0,0,0,5
Albania,03/01/2003,12,0,0,0,15,0,0,27
Albania,04/01/2003,18,0,-1,0,3,0,0,20
Albania,05/01/2003,2,0,0,0,0,0,0,2
Albania,06/01/2003,3,0,0,0,0,0,0,3
Albania,07/01/2003,-1,0,0,0,0,0,0,-1
Albania,08/01/2003,10,0,-1,0,3,1,0,13
Albania,09/01/2003,21,0,0,0,6,3,0,30
Albania,10/01/2003,9,0,0,0,0,0,0,9
Albania,11/01/2003,2,0,0,0,0,0,0,2
Albania,12/01/2003,7,0,0,0,3,0,0,10
Albania,13/01/2003,0,0,0,0,0,0,0,0
Albania,14/01/2003,10,0,0,0,0,2,0,12
Albania,15/01/2003,14,0,0,0,1,3,0,18
Albania,16/01/2003,10,0,0,0,4,2,0,16
Albania,17/01/2003,19,0,0,0,6,0,0,25
Albania,18/01/2003,13,0,1,0,0,0,0,14
Albania,20/01/2003,15,0,-2,0,15,0,0,28
Albania,21/01/2003,3,0,0,0,7,4,0,14
Albania,22/01/2003,17,0,-2,0,0,0,0,15
Albania,23/01/2003,0,0,0,0,2,3,0,5
Albania,24/01/2003,7,0,0,0,0,0,0,7
Albania,25/01/2003,2,0,0,0,0,0,0,2
Albania,26/01/2003,21,0,0,0,9,0,0,30
Albania,27/01/2003,2,0,0,0,8,0,0,10
Albania,28/01/2003,0,0,2,0,0,0,0,2
Albania,29/01/2003,9,0,0,0,3,3,0,15
Albania,30/01/2003,2,0,0,0,0,0,0,2
Albania,31/01/2003,1,0,0,0,3,2,0,6
Albania,01/02/2003,4,0,0,0,3,0,0,7
Albania,02/02/2003,5,0,0,0,9,0,0,14
Albania,03/02/2003,15,0,-1,0,48,0,0,62
Albania,04/02/2003,35,0,0,0,6,0,0,41
Albania,05/02/2003,9,0,3,0,12,4,0,28
Albania,06/02/2003,7,0,4,0,10,2,0,23
Albania,07/02/2003,9,0,0,0,3,0,0,12
Albania,08/02/2003,0,0,0,0,14,3,0,17
Albania,09/02/2003,25,0,0,0,15,4,0,44
Albania,10/02/2003,14,0,-2,0,18,3,0,33
Albania,11/02/2003,17,4,0,0,3,0,0,24
Albania,12/02/2003,30,0,1,0,3,0,0,34
Albania,13/02/2003,11,0,0,0,5,0,0,16
Albania,14/02/2003,2,0,0,0,3,0,0,5
Albania,15/02/2003,2,0,0,0,0,1,0,3
Albania,16/02/2003,7,0,0,0,3,0,0,10
Albania,17/02/2003,11,0,0,0,57,5,0,73
Albania,18/02/2003,58,0,4,0,47,4,0,113
Albania,19/02/2003,15,0,0,0,51,5,0,71
Albania,20/02/2003,10,0,0,0,21,0,0,31
Albania,21/02/2003,0,0,0,0,7,2,0,9
Albania,22/02/2003,2,0,0,0,3,0,0,5
Albania,23/02/2003,4,0,0,0,0,0,0,4
Albania,24/02/2003,1,0,0,0,6,4,0,11
Albania,25/02/2003,41,0,0,0,18,3,0,62
Albania,26/02/2003,7,0,0,0,12,3,0,22
Albania,27/02/2003,3,0,0,0,-2,0,0,1
Albania,28/02/2003,15,0,0,0,-8,1,0,8
Albania,01/03/2003,10,0,0,0,12,1,0,23
Albania,02/03/2003,3,0,0,0,6,0,0,9
Albania,03/03/2003,5,0,0,0,0,0,0,5
Albania,04/03/2003,20,0,0,0,36,0,0,56
Albania,05/03/2003,37,0,0,0,33,3,0,73
Albania,06/03/2003,-2,0,0,0,3,0,0,1
Albania,07/03/2003,9,0,-1,0,12,24,0,44
Albania,08/03/2003,11,0,1,0,0,0,0,12
Albania,09/03/2003,4,0,0,0,0,0,0,4
Albania,10/03/2003,15,0,0,0,16,10,0,41
Albania,11/03/2003,2,0,0,0,16,0,0,18
Albania,12/03/2003,10,0,0,0,0,0,0,10
Albania,13/03/2003,19,0,0,0,6,0,0,25
Albania,14/03/2003,2,0,-6,0,2,0,0,-2
Albania,15/03/2003,4,0,0,0,10,0,0,14
Albania,16/03/2003,3,0,0,0,0,0,0,3
Albania,17/03/2003,4,0,0,0,0,0,0,4
Albania,18/03/2003,34,0,0,0,-2,9,0,41
Albania,19/03/2003,30,0,0,0,0,1,0,31
Albania,20/03/2003,3,0,0,0,4,2,0,9
Albania,21/03/2003,2,0,0,0,1,1,0,4
Albania,22/03/2003,1,0,0,0,6,0,0,7
Albania,23/03/2003,0,0,0,0,0,0,0,0
Albania,24/03/2003,3,0,0,0,0,0,0,3
Albania,25/03/2003,4,0,0,0,0,1,0,5
Albania,26/03/2003,4,0,0,0,0,0,0,4
Albania,27/03/2003,0,0,0,0,0,0,0,0
Albania,28/03/2003,4,0,0,0,-4,0,0,0
Albania,29/03/2003,0,0,0,0,0,0,0,0
Albania,30/03/2003,8,0,0,0,0,0,0,8
Albania,31/03/2003,5,0,0,0,0,1,0,6
Albania,01/04/2003,9,0,0,0,0,0,0,9
Albania,02/04/2003,3,0,0,0,3,0,0,6
Albania,03/04/2003,26,0,0,0,0,0,0,26
Albania,04/04/2003,9,0,-4,0,6,0,0,11
Albania,05/04/2003,2,0,0,0,0,0,0,2
Albania,06/04/2003,2,0,0,0,-2,0,0,0
Albania,07/04/2003,4,0,0,0,4,0,0,8
Albania,08/04/2003,5,0,0,0,0,0,0,5
Albania,09/04/2003,9,0,0,0,0,1,0,10
Albania,10/04/2003,8,0,0,0,-10,2,0,0
Albania,11/04/2003,-1,0,0,0,4,0,0,3
Albania,12/04/2003,8,0,2,0,0,6,0,16
Albania,14/04/2003,7,0,0,0,9,0,0,16
Albania,15/04/2003,7,0,0,0,0,0,0,7
Albania,16/04/2003,0,0,0,0,2,0,0,2
Albania,17/04/2003,9,0,0,0,-2,0,0,7
Albania,18/04/2003,4,0,-12,0,8,0,0,0
Albania,19/04/2003,15,0,0,0,4,0,0,19
Albania,20/04/2003,2,0,0,0,2,0,0,4
Albania,21/04/2003,9,0,0,0,0,0,0,9
Albania,22/04/2003,14,0,0,0,6,1,0,21
Albania,23/04/2003,0,0,0,0,25,13,0,38
Albania,24/04/2003,2,0,0,0,4,0,0,6
Albania,25/04/2003,5,0,0,0,0,1,0,6
Albania,26/04/2003,10,0,0,0,0,0,0,10
Albania,27/04/2003,0,0,0,0,0,0,0,0
Albania,28/04/2003,7,0,0,0,15,0,0,22
Albania,29/04/2003,0,0,0,0,0,0,0,0
Albania,30/04/2003,0,0,-1,0,0,0,0,-1
Albania,01/05/2003,8,0,0,0,4,0,0,12
Albania,02/05/2003,2,0,0,0,-2,0,0,0
Albania,03/05/2003,3,0,0,0,0,0,0,3
Albania,04/05/2003,5,0,0,0,-1,0,0,4
Albania,05/05/2003,6,0,0,0,-2,0,0,4
Albania,06/05/2003,2,0,0,0,0,0,0,2
Albania,07/05/2003,16,0,0,0,4,3,0,23
Albania,08/05/2003,13,0,0,0,9,0,0,22
Albania,09/05/2003,6,0,0,0,0,0,0,6
Albania,10/05/2003,0,0,0,0,0,1,0,1
Albania,11/05/2003,-6,0,0,0,0,0,0,-6
Albania,12/05/2003,7,0,0,0,0,0,0,7
Albania,13/05/2003,6,0,0,0,3,2,0,11
Albania,14/05/2003,11,0,0,0,15,0,0,26
Albania,15/05/2003,10,0,-1,0,7,2,0,18
Albania,16/05/2003,20,0,0,0,-1,5,0,24
Albania,17/05/2003,19,0,0,0,6,2,0,27
Albania,18/05/2003,12,0,-1,0,0,0,0,11
Albania,19/05/2003,19,0,0,0,0,0,0,19
Albania,20/05/2003,6,0,0,0,3,3,0,12
Albania,21/05/2003,1,0,-2,0,5,3,0,7
Albania,22/05/2003,5,0,-2,0,0,0,0,3
Albania,23/05/2003,-6,0,0,0,3,1,0,-2
Albania,24/05/2003,12,0,0,0,4,0,0,16
Albania,25/05/2003,-1,0,0,0,-4,0,0,-5
Albania,26/05/2003,13,0,0,0,18,0,0,31
Albania,27/05/2003,-5,0,0,0,6,0,0,1
Albania,28/05/2003,4,0,0,0,-6,1,0,-1
Albania,29/05/2003,0,0,0,0,0,1,0,1
Albania,30/05/2003,2,0,0,0,6,0,0,8
Albania,31/05/2003,0,0,0,0,9,0,0,9
Albania,01/06/2003,0,0,0,0,3,0,0,3
Albania,02/06/2003,13,0,0,0,3,2,0,18
Albania,03/06/2003,8,0,0,0,7,0,0,15
Albania,04/06/2003,23,0,0,0,0,4,0,27
Albania,05/06/2003,11,0,-1,0,0,1,0,11
Albania,06/06/2003,11,0,0,0,3,3,0,17
Albania,07/06/2003,9,0,0,0,6,2,0,17
Albania,08/06/2003,-1,0,0,0,0,0,0,-1
Albania,09/06/2003,21,0,0,0,0,2,0,23
Albania,10/06/2003,11,0,0,0,16,0,0,27
Albania,11/06/2003,22,0,0,0,6,0,0,28
Albania,12/06/2003,5,0,-1,0,12,0,0,16
Albania,13/06/2003,13,0,0,0,3,0,0,16
Albania,14/06/2003,2,2,0,0,3,0,0,7
Albania,15/06/2003,0,0,0,0,0,0,0,0
Albania,16/06/2003,8,0,0,0,10,0,0,18
Albania,17/06/2003,12,0,0,0,8,1,0,21
Albania,18/06/2003,10,0,0,0,14,0,0,24
Albania,19/06/2003,1,0,0,0,3,3,0,7
Albania,20/06/2003,7,0,0,0,2,2,0,11
Albania,21/06/2003,6,0,0,0,3,0,0,9
Albania,22/06/2003,2,0,0,0,0,3,0,5
Albania,23/06/2003,31,0,1,0,-2,0,0,30
Albania,24/06/2003,2,0,0,0,0,0,0,2
Albania,25/06/2003,9,0,0,0,3,2,0,14
Albania,26/06/2003,0,0,0,0,12,0,0,12
Albania,27/06/2003,1,0,0,0,0,1,0,2
Albania,28/06/2003,1,0,0,0,0,2,0,3
Albania,29/06/2003,2,0,0,0,-4,0,0,-2
Albania,30/06/2003,5,0,0,0,9,3,0,17
Albania,01/07/2003,7,0,0,0,19,0,0,26
Albania,02/07/2003,4,0,0,0,6,5,0,15
Albania,03/07/2003,3,0,-1,0,0,0,0,2
Albania,04/07/2003,1,0,0,0,29,0,0,30
Albania,05/07/2003,17,0,0,0,10,0,0,27
Albania,06/07/2003,0,0,0,0,3,0,0,3
Albania,07/07/2003,10,0,0,0,-4,0,0,6
Albania,08/07/2003,10,0,0,0,15,2,0,27
Albania,09/07/2003,9,0,0,0,10,0,0,19
Albania,10/07/2003,25,0,0,0,-1,6,0,30
Albania,11/07/2003,-1,0,0,0,9,2,0,10
Albania,12/07/2003,3,0,-3,0,5,0,0,5
Albania,13/07/2003,3,0,0,0,3,0,0,6
Albania,14/07/2003,8,0,0,0,15,0,0,23
Albania,15/07/2003,13,0,0,0,0,0,0,13
Albania,16/07/2003,10,0,0,0,54,9,0,73
Albania,17/07/2003,26,0,0,0,12,6,0,44
Albania,18/07/2003,9,0,4,0,6,0,0,19
Albania,19/07/2003,9,0,-9,0,0,0,0,0
Albania,20/07/2003,19,0,-8,0,6,0,0,17
Albania,21/07/2003,11,0,-4,0,6,0,0,13
Albania,22/07/2003,21,0,0,0,9,0,0,30
Albania,23/07/2003,19,0,0,0,0,2,0,21
Albania,24/07/2003,20,0,-1,0,3,1,0,23
Albania,25/07/2003,15,0,0,0,6,0,0,21
Albania,26/07/2003,2,0,0,0,0,0,0,2
Albania,27/07/2003,0,0,0,0,0,-2,0,-2
Albania,28/07/2003,0,0,0,0,0,0,0,0
Albania,29/07/2003,7,0,-8,0,6,0,0,5
Albania,30/07/2003,7,0,0,0,0,0,0,7
Albania,31/07/2003,8,0,0,0,0,0,0,8
Albania,01/08/2003,3,0,0,0,7,0,0,10
Albania,03/08/2003,1,0,0,0,0,0,0,1
Albania,04/08/2003,20,0,-2,0,9,2,0,29
Albania,05/08/2003,8,0,0,0,6,0,0,14
Albania,06/08/2003,10,0,0,0,9,0,0,19
Albania,07/08/2003,0,0,0,0,6,0,0,6
Albania,08/08/2003,3,0,0,0,9,-4,0,8
Albania,09/08/2003,6,0,0,0,0,0,0,6
Albania,10/08/2003,1,0,0,0,0,0,0,1
Albania,11/08/2003,20,0,0,0,9,0,0,29
Albania,12/08/2003,66,0,0,0,27,0,0,93
Albania,13/08/2003,59,0,-2,0,1,17,0,75
Albania,14/08/2003,33,0,0,0,-4,8,0,37
Albania,15/08/2003,22,0,0,0,9,14,0,45
Albania,16/08/2003,18,0,0,0,0,0,0,18
Albania,17/08/2003,52,0,0,0,0,0,0,52
Albania,18/08/2003,18,0,0,0,0,0,0,18
Albania,19/08/2003,46,0,0,0,3,25,0,74
Albania,20/08/2003,0,0,0,0,3,0,0,3
Albania,21/08/2003,0,0,0,0,0,0,0,0
Albania,22/08/2003,29,0,0,0,0,0,0,29
Albania,23/08/2003,6,0,0,0,0,0,0,6
Albania,24/08/2003,6,0,1,0,0,0,0,7
Albania,25/08/2003,11,0,0,0,0,4,0,15
Albania,26/08/2003,9,0,0,0,0,0,0,9
Albania,27/08/2003,36,0,-2,0,-3,0,0,31
Albania,28/08/2003,6,0,0,0,20,0,0,26
Albania,29/08/2003,4,0,0,0,0,0,0,4
Albania,30/08/2003,14,0,0,0,0,0,0,14
Albania,01/09/2003,22,0,0,0,13,3,0,38
Albania,02/09/2003,17,0,0,0,-2,1,0,16
Albania,03/09/2003,22,0,2,0,14,0,0,38
Albania,04/09/2003,23,0,0,0,6,4,0,33
Albania,05/09/2003,4,0,0,0,15,0,0,19
Albania,06/09/2003,7,0,0,0,0,0,0,7
Albania,07/09/2003,9,0,0,0,-1,2,0,10
Albania,08/09/2003,40,0,-2,0,0,0,0,38
Albania,09/09/2003,34,0,0,0,24,0,0,58
Albania,10/09/2003,23,0,0,0,0,0,0,23
Albania,11/09/2003,10,0,-2,0,0,0,0,8
Albania,12/09/2003,22,0,0,0,3,2,0,27
Albania,13/09/2003,6,0,0,0,6,0,0,12
Albania,14/09/2003,6,0,0,0,0,0,0,6
Albania,15/09/2003,10,2,0,0,0,0,0,12
Albania,16/09/2003,32,4,0,0,0,6,0,42
Albania,17/09/2003,6,0,0,0,6,6,0,18
Albania,18/09/2003,7,0,0,0,0,1,0,8
Albania,19/09/2003,3,0,0,0,3,6,0,12
Albania,20/09/2003,0,0,0,0,0,0,0,0
Albania,21/09/2003,11,0,2,0,0,0,0,13
Albania,22/09/2003,2,0,0,0,6,0,0,8
Albania,23/09/2003,0,0,0,0,3,0,0,3
Albania,24/09/2003,18,0,0,0,8,0,0,26
Albania,25/09/2003,10,0,0,0,1,4,0,15
Albania,26/09/2003,26,0,0,0,3,13,0,42
Albania,27/09/2003,3,0,2,0,0,0,0,5
Albania,28/09/2003,2,0,0,0,0,0,0,2
Albania,29/09/2003,7,0,0,0,7,0,0,14
Albania,30/09/2003,8,0,0,0,6,0,0,14
Albania,01/10/2003,12,0,0,0,-4,0,0,8
Albania,02/10/2003,10,0,0,0,5,1,0,16
Albania,03/10/2003,-1,0,0,0,0,0,0,-1
Albania,04/10/2003,8,0,0,0,6,0,0,14
Albania,05/10/2003,-1,0,0,0,6,0,0,5
Albania,06/10/2003,4,0,0,0,-2,0,0,2
Albania,07/10/2003,17,0,0,0,3,0,0,20
Albania,08/10/2003,18,0,0,0,0,1,0,19
Albania,09/10/2003,2,0,0,0,0,1,0,3
Albania,10/10/2003,2,0,-2,0,6,1,0,7
Albania,11/10/2003,22,0,0,0,0,0,0,22
Albania,12/10/2003,3,0,0,0,0,0,0,3
Albania,13/10/2003,23,2,0,0,13,2,0,40
Albania,14/10/2003,3,0,-2,0,9,3,0,13
Albania,15/10/2003,8,0,0,0,9,4,0,21
Albania,16/10/2003,8,0,0,0,-4,0,0,4
Albania,17/10/2003,11,0,0,0,0,3,0,14
Albania,18/10/2003,6,0,0,0,0,0,0,6
Albania,19/10/2003,9,0,0,0,0,0,0,9
Albania,20/10/2003,10,0,-2,0,36,2,0,46
Albania,21/10/2003,10,0,0,0,16,0,0,26
Albania,22/10/2003,6,0,0,0,30,6,0,42
Albania,23/10/2003,12,0,0,0,3,3,0,18
Albania,24/10/2003,3,0,0,0,15,0,0,18
Albania,25/10/2003,8,0,-2,0,0,0,0,6
Albania,26/10/2003,6,0,-2,0,0,2,0,6
Albania,27/10/2003,7,0,0,0,20,6,0,33
Albania,28/10/2003,2,0,0,0,30,13,0,45
Albania,29/10/2003,9,0,0,0,18,3,0,30
Albania,30/10/2003,-4,0,-2,0,3,0,0,-3
Albania,31/10/2003,7,0,0,0,0,0,0,7
Albania,01/11/2003,4,0,0,0,1,0,0,5
Albania,02/11/2003,0,0,0,0,-4,0,0,-4
Albania,03/11/2003,4,0,0,0,2,3,0,9
Albania,04/11/2003,4,0,1,0,9,2,0,16
Albania,05/11/2003,6,0,0,0,3,0,0,9
Albania,06/11/2003,11,0,1,0,15,0,0,27
Albania,07/11/2003,4,0,0,0,15,0,0,19
Albania,08/11/2003,3,0,0,0,3,2,0,8
Albania,09/11/2003,6,0,0,0,-2,3,0,7
Albania,10/11/2003,11,0,1,0,3,0,0,15
Albania,11/11/2003,7,0,0,0,3,0,0,10
Albania,12/11/2003,-1,0,0,0,-4,1,0,-4
Albania,13/11/2003,25,0,-1,0,9,2,0,35
Albania,14/11/2003,3,0,-1,0,0,7,0,9
Albania,15/11/2003,14,0,0,0,0,0,0,14
Albania,16/11/2003,2,0,-2,0,0,2,0,2
Albania,17/11/2003,8,0,0,0,6,0,0,14
Albania,18/11/2003,3,0,0,0,6,3,0,12
Albania,19/11/2003,1,0,0,0,4,10,0,15
Albania,20/11/2003,1,0,0,0,-6,0,0,-5
Albania,21/11/2003,0,0,0,0,0,2,0,2
Albania,22/11/2003,3,0,0,0,0,4,0,7
Albania,24/11/2003,17,0,-1,0,0,2,0,18
Albania,25/11/2003,5,0,0,0,0,10,0,15
Albania,26/11/2003,21,0,-6,0,3,1,0,19
Albania,27/11/2003,4,0,0,0,3,3,0,10
Albania,28/11/2003,9,0,-2,0,-2,2,0,7
Albania,29/11/2003,18,0,0,0,0,0,0,18
Albania,30/11/2003,0,0,0,0,0,0,0,0
Albania,01/12/2003,19,0,-2,0,8,0,0,25
Albania,02/12/2003,3,0,-2,0,0,3,0,4
Albania,03/12/2003,16,0,0,0,-2,3,0,17
Albania,04/12/2003,27,0,0,0,4,2,0,33
Albania,05/12/2003,-1,0,0,0,-3,0,0,-4
Albania,06/12/2003,18,0,0,0,0,5,0,23
Albania,07/12/2003,0,0,0,0,0,0,0,0
Albania,08/12/2003,6,0,0,0,0,0,0,6
Albania,09/12/2003,11,0,0,0,0,2,0,13
Albania,10/12/2003,10,0,0,0,3,11,0,24
Albania,11/12/2003,7,0,0,0,6,0,0,13
Albania,12/12/2003,0,0,-4,0,1,2,0,-1
Albania,13/12/2003,-1,0,0,0,12,2,0,13
Albania,14/12/2003,4,0,0,0,0,2,0,6
Albania,15/12/2003,3,0,0,0,0,0,0,3
Albania,16/12/2003,-7,0,0,0,0,0,0,-7
Albania,17/12/2003,13,0,0,0,6,0,0,19
Albania,18/12/2003,10,0,0,0,14,4,0,28
Albania,19/12/2003,6,0,0,0,0,0,0,6
Albania,20/12/2003,8,0,0,0,6,3,0,17
Albania,21/12/2003,0,0,0,0,0,1,0,1
Albania,22/12/2003,14,0,0,0,0,1,0,15
Albania,23/12/2003,12,0,-1,0,16,0,0,27
Albania,24/12/2003,1,0,0,0,0,0,0,1
Albania,25/12/2003,3,0,0,0,0,0,0,3
Albania,26/12/2003,-5,0,0,0,-2,0,0,-7
Albania,27/12/2003,7,0,0,0,0,0,0,7
Albania,28/12/2003,11,0,0,0,0,1,0,12
Albania,29/12/2003,9,0,0,0,0,13,0,22
Albania,30/12/2003,17,0,0,0,-2,3,0,18
Albania,31/12/2003,25,0,0,0,0,0,0,25
Algeria,01/01/2003,4,0,0,0,15,0,0,19
Algeria,02/01/2003,0,0,0,0,0,0,0,0
Algeria,03/01/2003,1,0,0,0,12,0,0,13
Algeria,04/01/2003,0,0,0,0,3,1,0,4
Algeria,05/01/2003,1,0,0,0,0,0,0,1
Algeria,06/01/2003,0,0,0,0,0,0,0,0
Algeria,07/01/2003,14,0,0,0,6,0,0,20
Algeria,08/01/2003,1,0,0,0,9,0,0,10
Algeria,09/01/2003,1,0,0,0,0,0,0,1
Algeria,10/01/2003,39,0,0,0,-3,0,0,36
Algeria,11/01/2003,15,0,0,0,9,0,0,24
Algeria,12/01/2003,2,0,0,0,0,0,0,2
Algeria,13/01/2003,4,0,0,0,9,0,0,13
Algeria,14/01/2003,6,0,-1,0,18,2,0,25
Algeria,15/01/2003,6,0,0,0,18,0,0,24
Algeria,16/01/2003,44,0,0,0,24,2,0,70
Algeria,17/01/2003,8,0,0,0,24,0,0,32
Algeria,18/01/2003,5,0,0,0,6,0,0,11
Algeria,19/01/2003,0,0,0,0,0,0,0,0
Algeria,20/01/2003,11,0,0,0,30,0,0,41
Algeria,21/01/2003,4,0,0,0,30,0,0,34
Algeria,22/01/2003,8,0,0,0,21,1,0,30
Algeria,23/01/2003,0,0,0,0,0,0,0,0
Algeria,24/01/2003,6,0,0,0,9,0,0,15
Algeria,25/01/2003,6,0,0,0,15,0,0,21
Algeria,26/01/2003,0,0,0,0,9,0,0,9
Algeria,27/01/2003,8,0,0,0,3,0,0,11
Algeria,28/01/2003,4,0,0,0,2,0,0,6
Algeria,29/01/2003,0,0,0,0,0,0,0,0
Algeria,30/01/2003,8,0,0,0,6,0,0,14
Algeria,31/01/2003,8,0,0,0,6,0,0,14
Algeria,01/02/2003,9,0,0,0,6,0,0,15
Algeria,02/02/2003,0,0,0,0,3,0,0,3
Algeria,03/02/2003,12,0,0,0,0,0,0,12
Algeria,04/02/2003,6,0,0,0,6,0,0,12
Algeria,05/02/2003,9,0,0,0,0,0,0,9
Algeria,06/02/2003,0,0,0,0,9,1,0,10
Algeria,07/02/2003,5,0,0,0,12,0,0,17
Algeria,08/02/2003,0,0,0,0,0,0,0,0
Algeria,09/02/2003,0,0,0,0,0,0,0,0
Algeria,10/02/2003,7,0,0,0,3,0,0,10
Algeria,11/02/2003,0,0,0,0,3,0,0,3
Algeria,12/02/2003,7,0,0,0,3,0,0,10
Algeria,13/02/2003,0,0,0,0,3,0,0,3
Algeria,14/02/2003,2,0,0,0,0,0,0,2
Algeria,15/02/2003,1,0,0,0,-6,1,0,-4
Algeria,16/02/2003,2,0,0,0,3,0,0,5
Algeria,17/02/2003,16,0,0,0,6,0,0,22
Algeria,18/02/2003,0,0,0,0,0,0,0,0
Algeria,19/02/2003,0,0,0,0,0,0,0,0
Algeria,20/02/2003,0,0,0,0,0,0,0,0
Algeria,21/02/2003,1,0,0,0,0,0,0,1
Algeria,22/02/2003,11,0,0,0,0,0,0,11
Algeria,23/02/2003,0,0,0,0,0,0,0,0
Algeria,24/02/2003,0,0,0,0,0,0,0,0
Algeria,25/02/2003,7,0,0,0,12,2,0,21
Algeria,26/02/2003,1,0,0,0,6,4,0,11
Algeria,27/02/2003,34,0,0,0,21,4,0,59
Algeria,28/02/2003,1,0,1,0,0,0,0,2
Algeria,01/03/2003,-1,0,0,0,0,0,0,-1
Algeria,02/03/2003,0,0,0,0,0,0,0,0
Algeria,03/03/2003,1,0,-2,0,0,0,0,-1
Algeria,04/03/2003,0,0,0,0,9,0,0,9
Algeria,05/03/2003,1,0,0,0,3,0,0,4
Algeria,06/03/2003,4,0,0,0,0,0,0,4
Algeria,07/03/2003,0,0,0,0,0,1,0,1
Algeria,08/03/2003,0,0,0,0,0,0,0,0
Algeria,09/03/2003,3,0,0,0,6,0,0,9
Algeria,10/03/2003,16,0,0,0,15,1,0,32
Algeria,11/03/2003,7,0,0,0,-2,0,0,5
Algeria,12/03/2003,0,0,0,0,3,0,0,3
Algeria,13/03/2003,0,0,0,0,3,0,0,3
Algeria,14/03/2003,0,0,0,0,3,0,0,3
Algeria,15/03/2003,7,0,0,0,6,0,0,13
Algeria,16/03/2003,5,0,0,0,3,0,0,8
Algeria,17/03/2003,-1,0,0,0,0,0,0,-1
Algeria,18/03/2003,0,0,0,0,3,0,0,3
Algeria,19/03/2003,0,0,0,0,3,0,0,3
Algeria,20/03/2003,0,0,0,0,9,0,0,9
Algeria,21/03/2003,-1,0,3,0,-4,0,0,-2
Algeria,22/03/2003,0,0,0,0,0,0,0,0
Algeria,23/03/2003,2,0,0,0,0,0,0,2
Algeria,24/03/2003,17,0,0,0,-4,0,0,13
Algeria,25/03/2003,2,0,0,0,-2,0,0,0
Algeria,26/03/2003,1,0,0,0,6,0,0,7
Algeria,27/03/2003,0,0,0,0,0,0,0,0
Algeria,28/03/2003,0,0,0,0,0,5,0,5
Algeria,29/03/2003,0,0,0,0,0,0,0,0
Algeria,30/03/2003,3,0,0,0,0,0,0,3
Algeria,31/03/2003,12,0,0,0,0,1,0,13
Algeria,01/04/2003,1,4,2,0,15,1,0,23
Algeria,02/04/2003,0,4,0,0,3,3,0,10
Algeria,03/04/2003,5,0,0,0,0,0,0,5
Algeria,04/04/2003,12,0,0,0,30,1,0,43
Algeria,05/04/2003,2,6,0,0,18,0,0,26
Algeria,06/04/2003,0,0,0,0,0,0,0,0
Algeria,07/04/2003,2,0,1,0,0,0,0,3
Algeria,08/04/2003,3,0,0,0,9,0,0,12
Algeria,09/04/2003,6,0,0,0,6,0,0,12
Algeria,10/04/2003,0,0,0,0,0,0,0,0
Algeria,11/04/2003,-1,0,0,0,0,0,0,-1
Algeria,12/04/2003,1,0,0,0,9,0,0,10
Algeria,13/04/2003,2,0,0,0,9,0,0,11
Algeria,14/04/2003,2,0,0,0,6,0,0,8
Algeria,15/04/2003,2,0,0,0,0,0,0,2
Algeria,16/04/2003,3,0,0,0,3,0,0,6
Algeria,17/04/2003,2,0,0,0,0,0,0,2
Algeria,18/04/2003,5,0,-4,0,0,0,0,1
Algeria,19/04/2003,0,0,2,0,0,2,0,4
Algeria,20/04/2003,2,0,0,0,0,1,0,3
Algeria,21/04/2003,4,0,0,0,0,0,0,4
Algeria,22/04/2003,0,0,0,0,0,1,0,1
Algeria,23/04/2003,4,0,0,0,0,0,0,4
Algeria,24/04/2003,0,0,0,0,0,0,0,0
Algeria,25/04/2003,0,0,0,0,12,0,0,12
Algeria,26/04/2003,2,0,0,0,3,0,0,5
Algeria,28/04/2003,1,0,0,0,0,0,0,1
Algeria,29/04/2003,0,0,0,0,0,0,0,0
Algeria,30/04/2003,5,0,0,0,9,0,0,14
Algeria,01/05/2003,0,0,0,0,0,0,0,0
Algeria,02/05/2003,0,0,0,0,0,0,0,0
Algeria,03/05/2003,0,0,0,0,0,1,0,1
Algeria,04/05/2003,0,0,0,0,0,0,0,0
Algeria,05/05/2003,0,0,0,0,-6,0,0,-6
Algeria,06/05/2003,3,0,0,0,0,0,0,3
Algeria,07/05/2003,6,0,0,0,1,1,0,8
Algeria,08/05/2003,0,0,0,0,0,0,0,0
Algeria,09/05/2003,1,0,0,0,3,0,0,4
Algeria,10/05/2003,1,0,0,0,0,0,0,1
Algeria,11/05/2003,0,0,0,0,0,0,0,0
Algeria,12/05/2003,6,0,0,0,-4,0,0,2
Algeria,13/05/2003,1,0,0,0,0,0,0,1
Algeria,14/05/2003,-2,0,0,0,0,1,0,-1
Algeria,15/05/2003,4,0,0,0,-6,0,0,-2
Algeria,16/05/2003,0,0,0,0,0,0,0,0
Algeria,17/05/2003,3,0,0,0,0,0,0,3
Algeria,18/05/2003,0,0,0,0,6,4,0,10
Algeria,19/05/2003,2,0,0,0,-11,0,0,-9
Algeria,20/05/2003,11,0,0,0,0,0,0,11
Algeria,21/05/2003,0,0,0,0,6,0,0,6
Algeria,22/05/2003,14,2,0,0,3,2,0,21
Algeria,23/05/2003,-4,0,0,0,0,0,0,-4
Algeria,24/05/2003,0,0,0,0,3,0,0,3
Algeria,25/05/2003,0,0,0,0,6,0,0,6
Algeria,26/05/2003,4,0,0,0,0,1,0,5
Algeria,27/05/2003,3,0,0,0,0,1,0,4
Algeria,28/05/2003,2,0,0,0,3,0,0,5
Algeria,29/05/2003,2,0,0,0,-2,0,0,0
Algeria,30/05/2003,4,0,0,0,0,0,0,4
Algeria,31/05/2003,6,0,0,0,0,0,0,6
Algeria,01/06/2003,0,2,0,0,6,0,0,8
Algeria,02/06/2003,0,0,0,0,0,0,0,0
Algeria,03/06/2003,-1,0,0,0,-2,2,0,-1
Algeria,04/06/2003,1,0,0,0,9,2,0,12
Algeria,05/06/2003,-6,0,0,0,3,0,0,-3
Algeria,06/06/2003,0,0,0,0,0,4,0,4
Algeria,07/06/2003,9,0,0,0,0,0,0,9
Algeria,09/06/2003,5,0,0,0,0,0,0,5
Algeria,10/06/2003,1,0,0,0,0,0,0,1
Algeria,11/06/2003,4,0,0,0,0,0,0,4
Algeria,12/06/2003,2,0,0,0,0,0,0,2
Algeria,13/06/2003,1,0,0,0,0,0,0,1
Algeria,14/06/2003,3,0,0,0,0,2,0,5
Algeria,15/06/2003,0,0,0,0,0,0,0,0
Algeria,16/06/2003,3,0,0,0,3,0,0,6
Algeria,17/06/2003,1,0,0,0,3,0,0,4
Algeria,18/06/2003,0,0,0,0,6,0,0,6
Algeria,19/06/2003,4,0,0,0,3,0,0,7
Algeria,20/06/2003,0,0,0,0,3,6,0,9
Algeria,21/06/2003,0,0,0,0,0,0,0,0
Algeria,22/06/2003,0,0,0,0,0,0,0,0
Algeria,23/06/2003,0,0,0,0,0,0,0,0
Algeria,24/06/2003,3,0,0,0,0,1,0,4
Algeria,25/06/2003,0,0,0,0,3,0,0,3
Algeria,26/06/2003,0,0,0,0,6,0,0,6
Algeria,27/06/2003,6,0,0,0,3,1,0,10
Algeria,28/06/2003,2,0,0,0,0,0,0,2
Algeria,29/06/2003,0,0,0,0,0,0,0,0
Algeria,30/06/2003,6,0,0,0,0,0,0,6
Algeria,01/07/2003,0,0,0,0,-1,0,0,-1
Algeria,02/07/2003,12,0,0,0,7,2,0,21
Algeria,03/07/2003,0,0,0,0,-2,0,0,-2
Algeria,04/07/2003,2,0,0,0,0,1,0,3
Algeria,05/07/2003,0,0,0,0,0,0,0,0
Algeria,06/07/2003,7,0,0,0,0,0,0,7
Algeria,07/07/2003,3,0,0,0,0,0,0,3
Algeria,08/07/2003,3,0,0,0,3,0,0,6
Algeria,09/07/2003,6,0,0,0,0,0,0,6
Algeria,10/07/2003,1,0,0,0,0,2,0,3
Algeria,11/07/2003,0,0,0,0,0,0,0,0
Algeria,12/07/2003,2,0,0,0,0,0,0,2
Algeria,13/07/2003,11,0,0,0,-2,0,0,9
Algeria,14/07/2003,1,0,0,0,6,0,0,7
Algeria,15/07/2003,4,0,0,0,12,0,0,16
Algeria,16/07/2003,0,0,0,0,3,0,0,3
Algeria,17/07/2003,4,0,0,0,3,0,0,7
Algeria,18/07/2003,3,0,0,0,3,1,0,7
Algeria,19/07/2003,0,0,0,0,0,0,0,0
Algeria,20/07/2003,3,0,0,0,0,0,0,3
Algeria,21/07/2003,3,0,0,0,3,0,0,6
Algeria,22/07/2003,-3,0,0,0,3,1,0,1
Algeria,23/07/2003,6,0,0,0,0,0,0,6
Algeria,24/07/2003,0,0,0,0,0,0,0,0
Algeria,25/07/2003,-1,0,0,0,0,0,0,-1
Algeria,26/07/2003,0,0,0,0,0,0,0,0
Algeria,27/07/2003,0,0,0,0,0,0,0,0
Algeria,28/07/2003,16,0,0,0,0,0,0,16
Algeria,29/07/2003,0,0,0,0,0,0,0,0
Algeria,30/07/2003,0,0,0,0,3,0,0,3
Algeria,31/07/2003,2,0,0,0,14,0,0,16
Algeria,01/08/2003,6,0,0,0,5,1,0,12
Algeria,02/08/2003,3,0,0,0,2,0,0,5
Algeria,03/08/2003,2,0,0,0,26,0,0,28
Algeria,04/08/2003,4,0,0,0,0,0,0,4
Algeria,05/08/2003,9,0,0,0,0,0,0,9
Algeria,06/08/2003,12,0,0,0,14,0,0,26
Algeria,07/08/2003,4,0,0,0,9,0,0,13
Algeria,08/08/2003,1,0,0,0,15,0,0,16
Algeria,09/08/2003,3,0,0,0,3,0,0,6
Algeria,10/08/2003,1,0,0,0,15,0,0,16
Algeria,11/08/2003,0,0,0,0,-1,0,0,-1
Algeria,12/08/2003,-2,0,0,0,0,0,0,-2
Algeria,13/08/2003,0,0,0,0,3,0,0,3
Algeria,14/08/2003,6,0,-2,0,-5,0,0,-1
Algeria,15/08/2003,3,0,0,0,-1,5,0,7
Algeria,16/08/2003,11,0,0,0,3,0,0,14
Algeria,17/08/2003,4,0,0,0,2,0,0,6
Algeria,18/08/2003,13,0,0,0,-5,0,0,8
Algeria,19/08/2003,9,0,0,0,-1,1,0,9
Algeria,20/08/2003,2,0,0,0,0,0,0,2
Algeria,21/08/2003,0,0,0,0,-4,0,0,-4
Algeria,22/08/2003,7,0,0,0,-2,4,0,9
Algeria,23/08/2003,5,0,1,0,39,2,0,47
Algeria,24/08/2003,-4,0,0,0,4,0,0,0
Algeria,25/08/2003,1,0,0,0,10,0,0,11
Algeria,26/08/2003,0,0,0,0,1,0,0,1
Algeria,27/08/2003,0,0,0,0,0,0,0,0
Algeria,28/08/2003,0,0,0,0,0,0,0,0
Algeria,29/08/2003,0,0,0,0,0,0,0,0
Algeria,30/08/2003,0,0,0,0,0,0,0,0
Algeria,31/08/2003,15,0,0,0,0,0,0,15
Algeria,01/09/2003,8,0,-2,0,13,0,0,19
Algeria,02/09/2003,7,0,0,0,0,0,0,7
Algeria,03/09/2003,2,0,1,0,5,0,0,8
Algeria,04/09/2003,0,0,0,0,1,3,0,4
Algeria,05/09/2003,0,0,0,0,3,0,0,3
Algeria,06/09/2003,-2,0,0,0,3,1,0,2
Algeria,07/09/2003,1,0,0,0,0,0,0,1
Algeria,08/09/2003,0,0,0,0,0,0,0,0
Algeria,09/09/2003,10,0,0,0,-1,0,0,9
Algeria,10/09/2003,1,0,0,0,0,0,0,1
Algeria,11/09/2003,8,0,0,0,24,0,0,32
Algeria,12/09/2003,0,0,0,0,9,0,0,9
Algeria,13/09/2003,4,0,0,0,0,0,0,4
Algeria,14/09/2003,0,0,0,0,0,0,0,0
Algeria,15/09/2003,6,0,0,0,3,0,0,9
Algeria,16/09/2003,2,0,0,0,3,0,0,5
Algeria,17/09/2003,11,0,0,0,3,0,0,14
Algeria,18/09/2003,0,0,0,0,0,0,0,0
Algeria,20/09/2003,5,0,0,0,7,0,0,12
Algeria,21/09/2003,0,0,0,0,0,0,0,0
Algeria,22/09/2003,1,0,0,0,3,0,0,4
Algeria,23/09/2003,3,0,0,0,0,0,0,3
Algeria,24/09/2003,-1,0,0,0,0,0,0,-1
Algeria,25/09/2003,6,2,-1,0,0,2,0,9
Algeria,26/09/2003,8,0,0,0,27,0,0,35
Algeria,27/09/2003,0,0,0,0,31,0,0,31
Algeria,28/09/2003,0,0,0,0,3,0,0,3
Algeria,29/09/2003,1,0,0,0,0,0,0,1
Algeria,30/09/2003,7,0,0,0,12,2,0,21
Algeria,01/10/2003,0,0,0,0,9,0,0,9
Algeria,02/10/2003,-5,0,0,0,3,2,0,0
Algeria,03/10/2003,0,0,0,0,0,0,0,0
Algeria,04/10/2003,2,0,0,0,4,0,0,6
Algeria,05/10/2003,2,0,0,0,18,0,0,20
Algeria,06/10/2003,6,0,0,0,3,3,0,12
Algeria,07/10/2003,-3,0,0,0,0,2,0,-1
Algeria,08/10/2003,0,0,0,0,0,0,0,0
Algeria,09/10/2003,5,0,0,0,0,1,0,6
Algeria,10/10/2003,0,0,0,0,12,0,0,12
Algeria,11/10/2003,1,0,0,0,9,0,0,10
Algeria,12/10/2003,6,0,0,0,9,0,0,15
Algeria,13/10/2003,-4,0,0,0,9,0,0,5
Algeria,14/10/2003,6,0,1,0,2,1,0,10
Algeria,15/10/2003,1,0,0,0,15,4,0,20
Algeria,16/10/2003,2,0,0,0,0,0,0,2
Algeria,17/10/2003,0,0,0,0,6,0,0,6
Algeria,18/10/2003,-1,0,0,0,0,0,0,-1
Algeria,19/10/2003,0,0,0,0,3,0,0,3
Algeria,20/10/2003,2,0,0,0,8,0,0,10
Algeria,21/10/2003,0,0,0,0,2,0,0,2
Algeria,22/10/2003,1,0,0,0,0,0,0,1
Algeria,23/10/2003,0,0,0,0,0,0,0,0
Algeria,24/10/2003,-1,0,0,0,0,0,0,-1
Algeria,25/10/2003,1,0,0,0,-2,0,0,-1
Algeria,26/10/2003,1,0,1,0,6,0,0,8
Algeria,27/10/2003,0,0,0,0,0,0,0,0
Algeria,28/10/2003,-1,0,0,0,0,0,0,-1
Algeria,29/10/2003,10,0,0,0,25,0,0,35
Algeria,30/10/2003,8,0,0,0,18,0,0,26
Algeria,31/10/2003,15,0,0,0,12,0,0,27
Algeria,01/11/2003,12,0,0,0,3,0,0,15
Algeria,02/11/2003,0,0,-4,0,0,0,0,-4
Algeria,03/11/2003,3,0,0,0,0,0,0,3
Algeria,04/11/2003,0,0,0,0,0,0,0,0
Algeria,05/11/2003,4,0,0,0,12,0,0,16
Algeria,06/11/2003,-1,0,0,0,0,0,0,-1
Algeria,07/11/2003,1,0,0,0,-5,0,0,-4
Algeria,08/11/2003,0,0,0,0,6,0,0,6
Algeria,09/11/2003,0,0,0,0,9,0,0,9
Algeria,10/11/2003,3,0,0,0,6,0,0,9
Algeria,11/11/2003,2,0,0,0,0,2,0,4
Algeria,12/11/2003,1,0,0,0,-2,0,0,-1
Algeria,13/11/2003,2,0,0,0,3,0,0,5
Algeria,14/11/2003,0,0,0,0,0,0,0,0
Algeria,15/11/2003,1,0,0,0,-4,0,0,-3
Algeria,16/11/2003,2,0,0,0,6,0,0,8
Algeria,17/11/2003,2,0,0,0,0,0,0,2
Algeria,18/11/2003,2,0,0,0,6,0,0,8
Algeria,19/11/2003,8,0,0,0,0,0,0,8
Algeria,20/11/2003,0,0,0,0,0,0,0,0
Algeria,21/11/2003,0,0,0,0,-6,0,0,-6
Algeria,22/11/2003,7,0,0,0,-5,0,0,2
Algeria,23/11/2003,1,0,0,0,0,0,0,1
Algeria,24/11/2003,2,0,0,0,0,0,0,2
Algeria,25/11/2003,1,0,0,0,12,0,0,13
Algeria,26/11/2003,5,0,0,0,9,0,0,14
Algeria,27/11/2003,8,0,0,0,36,6,0,50
Algeria,28/11/2003,4,0,0,0,11,0,0,15
Algeria,29/11/2003,10,0,0,0,6,0,0,16
Algeria,30/11/2003,-3,0,-2,0,0,0,0,-5
Algeria,01/12/2003,1,0,0,0,0,0,0,1
Algeria,02/12/2003,6,0,0,0,-1,0,0,5
Algeria,03/12/2003,13,0,0,0,6,0,0,19
Algeria,04/12/2003,0,0,0,0,18,0,0,18
Algeria,05/12/2003,0,0,0,0,6,0,0,6
Algeria,06/12/2003,1,0,0,0,0,0,0,1
Algeria,07/12/2003,-2,0,0,0,0,0,0,-2
Algeria,08/12/2003,0,0,0,0,5,0,0,5
Algeria,09/12/2003,0,0,0,0,9,0,0,9
Algeria,10/12/2003,10,0,0,0,9,0,0,19
Algeria,11/12/2003,-1,0,0,0,3,0,0,2
Algeria,12/12/2003,3,0,0,0,-2,0,0,1
Algeria,13/12/2003,0,0,0,0,0,0,0,0
Algeria,14/12/2003,3,0,0,0,0,0,0,3
Algeria,15/12/2003,0,0,0,0,0,0,0,0
Algeria,16/12/2003,0,0,0,0,0,0,0,0
Algeria,17/12/2003,0,0,0,0,0,0,0,0
Algeria,18/12/2003,3,0,0,0,12,3,0,18
Algeria,19/12/2003,15,0,0,0,9,3,0,27
Algeria,20/12/2003,0,0,0,0,3,0,0,3
Algeria,21/12/2003,2,0,0,0,13,0,0,15
Algeria,22/12/2003,2,0,0,0,9,0,0,11
Algeria,23/12/2003,7,0,0,0,24,0,0,31
Algeria,24/12/2003,5,0,0,0,1,2,0,8
Algeria,25/12/2003,0,0,0,0,9,0,0,9
Algeria,26/12/2003,3,0,0,0,6,0,0,9
Algeria,27/12/2003,2,0,0,0,0,0,0,2
Algeria,28/12/2003,0,0,0,0,0,0,0,0
Algeria,29/12/2003,0,0,0,0,6,0,0,6
Algeria,30/12/2003,4,0,0,0,9,0,0,13
Algeria,31/12/2003,0,0,0,0,0,2,0,2
Bangladesh,02/01/2003,3,0,0,0,0,0,0,3
Bangladesh,03/01/2003,-1,0,0,0,0,0,0,-1
Bangladesh,04/01/2003,0,0,0,0,0,0,0,0
Bangladesh,05/01/2003,2,0,0,0,3,0,0,5
Bangladesh,06/01/2003,6,0,0,0,9,0,0,15
Bangladesh,07/01/2003,9,0,0,0,9,0,0,18
Bangladesh,08/01/2003,-1,0,0,0,0,0,0,-1
Bangladesh,09/01/2003,0,0,0,0,0,0,0,0
Bangladesh,10/01/2003,11,0,0,0,-2,0,0,9
Bangladesh,11/01/2003,3,0,0,0,5,0,0,8
Bangladesh,12/01/2003,0,0,0,0,0,0,0,0
Bangladesh,13/01/2003,3,0,0,0,3,0,0,6
Bangladesh,14/01/2003,0,0,0,0,4,0,0,4
Bangladesh,15/01/2003,0,0,0,0,-1,0,0,-1
Bangladesh,16/01/2003,3,0,0,0,-2,1,0,2
Bangladesh,17/01/2003,2,0,0,0,0,3,0,5
Bangladesh,18/01/2003,-4,0,0,0,0,0,0,-4
Bangladesh,19/01/2003,9,0,0,0,0,0,0,9
Bangladesh,20/01/2003,6,0,0,0,0,0,0,6
Bangladesh,21/01/2003,0,0,0,0,0,0,0,0
Bangladesh,22/01/2003,0,0,0,0,0,0,0,0
Bangladesh,23/01/2003,3,0,0,0,18,0,0,21
Bangladesh,24/01/2003,0,0,0,0,0,0,0,0
Bangladesh,26/01/2003,0,0,0,0,0,0,0,0
Bangladesh,27/01/2003,12,0,0,0,0,0,0,12
Bangladesh,28/01/2003,0,2,0,0,0,0,0,2
Bangladesh,29/01/2003,6,0,0,0,0,0,0,6
Bangladesh,30/01/2003,-1,2,0,0,0,0,0,1
Bangladesh,31/01/2003,0,0,0,0,3,0,0,3
Bangladesh,01/02/2003,6,0,0,0,-2,0,0,4
Bangladesh,02/02/2003,1,0,0,0,0,0,0,1
Bangladesh,03/02/2003,1,0,0,0,3,0,0,4
Bangladesh,04/02/2003,2,0,0,0,0,0,0,2
Bangladesh,05/02/2003,6,0,0,0,0,0,0,6
Bangladesh,06/02/2003,0,0,0,0,0,0,0,0
Bangladesh,07/02/2003,0,0,0,0,0,0,0,0
Bangladesh,08/02/2003,0,0,0,0,0,0,0,0
Bangladesh,09/02/2003,0,0,0,0,6,0,0,6
Bangladesh,10/02/2003,0,0,0,0,0,0,0,0
Bangladesh,13/02/2003,0,0,0,0,0,0,0,0
Bangladesh,14/02/2003,0,0,0,0,0,0,0,0
Bangladesh,15/02/2003,0,0,0,0,0,0,0,0
Bangladesh,16/02/2003,12,0,1,0,6,0,0,19
Bangladesh,17/02/2003,2,0,0,0,0,0,0,2
Bangladesh,18/02/2003,6,0,0,0,9,0,0,15
Bangladesh,20/02/2003,1,0,0,0,3,0,0,4
Bangladesh,23/02/2003,0,0,0,0,0,0,0,0
Bangladesh,24/02/2003,0,0,0,0,0,0,0,0
Bangladesh,26/02/2003,0,0,0,0,2,2,0,4
Bangladesh,27/02/2003,15,0,0,0,6,0,0,21
Bangladesh,28/02/2003,5,0,0,0,10,0,0,15
Bangladesh,01/03/2003,0,0,0,0,1,2,0,3
Bangladesh,02/03/2003,7,0,0,0,0,0,0,7
Bangladesh,04/03/2003,4,0,0,0,0,0,0,4
Bangladesh,05/03/2003,0,0,0,0,0,2,0,2
Bangladesh,06/03/2003,0,0,0,0,0,0,0,0
Bangladesh,07/03/2003,0,0,0,0,3,0,0,3
Bangladesh,09/03/2003,0,0,-2,0,0,0,0,-2
Bangladesh,10/03/2003,-1,0,0,0,0,0,0,-1
Bangladesh,11/03/2003,0,0,0,0,0,1,0,1
Bangladesh,13/03/2003,-1,0,0,0,0,0,0,-1
Bangladesh,14/03/2003,1,0,0,0,0,0,0,1
Bangladesh,15/03/2003,0,0,0,0,0,0,0,0
Bangladesh,16/03/2003,0,0,0,0,0,0,0,0
Bangladesh,17/03/2003,8,0,0,0,0,0,0,8
Bangladesh,18/03/2003,1,0,0,0,6,0,0,7
Bangladesh,19/03/2003,0,0,0,0,0,0,0,0
Bangladesh,20/03/2003,0,0,0,0,0,0,0,0
Bangladesh,21/03/2003,0,0,0,0,0,5,0,5
Bangladesh,22/03/2003,0,0,0,0,6,0,0,6
Bangladesh,23/03/2003,0,0,0,0,0,0,0,0
Bangladesh,24/03/2003,1,0,0,0,0,0,0,1
Bangladesh,25/03/2003,3,0,0,0,3,0,0,6
Bangladesh,26/03/2003,0,0,0,0,0,1,0,1
Bangladesh,27/03/2003,6,0,0,0,0,2,0,8
Bangladesh,28/03/2003,3,0,0,0,0,0,0,3
Bangladesh,30/03/2003,3,0,0,0,0,0,0,3
Bangladesh,31/03/2003,-2,0,0,0,0,0,0,-2
Bangladesh,01/04/2003,5,0,0,0,3,0,0,8
Bangladesh,03/04/2003,-3,0,0,0,0,0,0,-3
Bangladesh,04/04/2003,6,0,0,0,3,0,0,9
Bangladesh,05/04/2003,0,0,0,0,0,0,0,0
Bangladesh,06/04/2003,3,0,1,0,0,0,0,4
Bangladesh,07/04/2003,0,0,0,0,3,0,0,3
Bangladesh,08/04/2003,0,0,0,0,-4,1,0,-3
Bangladesh,09/04/2003,5,0,0,0,3,0,0,8
Bangladesh,10/04/2003,0,0,0,0,6,0,0,6
Bangladesh,11/04/2003,0,0,0,0,0,0,0,0
Bangladesh,12/04/2003,0,0,0,0,0,0,0,0
Bangladesh,13/04/2003,0,0,0,0,0,0,0,0
Bangladesh,15/04/2003,1,0,0,0,0,0,0,1
Bangladesh,16/04/2003,0,0,0,0,0,1,0,1
Bangladesh,18/04/2003,0,0,0,0,0,0,0,0
Bangladesh,19/04/2003,0,0,0,0,0,0,0,0
Bangladesh,21/04/2003,0,0,0,0,0,0,0,0
Bangladesh,22/04/2003,0,0,0,0,0,0,0,0
Bangladesh,23/04/2003,1,0,0,0,0,0,0,1
Bangladesh,24/04/2003,3,0,0,0,3,0,0,6
Bangladesh,25/04/2003,0,0,0,0,0,0,0,0
Bangladesh,28/04/2003,9,0,0,0,0,0,0,9
Bangladesh,29/04/2003,0,0,0,0,0,0,0,0
Bangladesh,30/04/2003,0,0,0,0,0,0,0,0
Bangladesh,01/05/2003,3,0,0,0,0,0,0,3
Bangladesh,02/05/2003,0,0,0,0,0,0,0,0
Bangladesh,03/05/2003,2,0,0,0,0,0,0,2
Bangladesh,04/05/2003,-6,0,0,0,0,0,0,-6
Bangladesh,05/05/2003,1,0,0,0,0,0,0,1
Bangladesh,06/05/2003,0,0,0,0,0,1,0,1
Bangladesh,07/05/2003,6,0,0,0,0,0,0,6
Bangladesh,08/05/2003,0,0,0,0,0,0,0,0
Bangladesh,09/05/2003,3,0,0,0,3,0,0,6
Bangladesh,10/05/2003,0,0,0,0,0,0,0,0
Bangladesh,11/05/2003,1,0,0,0,0,0,0,1
Bangladesh,12/05/2003,0,0,0,0,0,0,0,0
Bangladesh,13/05/2003,11,0,0,0,0,0,0,11
Bangladesh,14/05/2003,0,0,0,0,0,0,0,0
Bangladesh,16/05/2003,0,0,0,0,0,0,0,0
Bangladesh,17/05/2003,3,0,0,0,3,0,0,6
Bangladesh,18/05/2003,0,0,0,0,3,0,0,3
Bangladesh,19/05/2003,0,0,0,0,0,0,0,0
Bangladesh,20/05/2003,1,0,0,0,3,0,0,4
Bangladesh,21/05/2003,0,0,0,0,0,0,0,0
Bangladesh,22/05/2003,0,0,0,0,0,2,0,2
Bangladesh,23/05/2003,0,0,0,0,0,0,0,0
Bangladesh,25/05/2003,0,0,0,0,3,0,0,3
Bangladesh,26/05/2003,3,0,0,0,3,0,0,6
Bangladesh,27/05/2003,5,0,0,0,0,0,0,5
Bangladesh,28/05/2003,14,0,0,0,6,0,0,20
Bangladesh,29/05/2003,2,0,0,0,0,0,0,2
Bangladesh,30/05/2003,0,0,0,0,6,0,0,6
Bangladesh,31/05/2003,0,0,0,0,0,0,0,0
Bangladesh,01/06/2003,0,0,0,0,6,0,0,6
Bangladesh,02/06/2003,19,0,0,0,3,0,0,22
Bangladesh,03/06/2003,0,0,0,0,18,0,0,18
Bangladesh,04/06/2003,0,0,0,0,4,0,0,4
Bangladesh,05/06/2003,6,0,0,0,6,0,0,12
Bangladesh,06/06/2003,3,0,0,0,0,1,0,4
Bangladesh,08/06/2003,1,0,0,0,0,2,0,3
Bangladesh,10/06/2003,1,0,0,0,0,1,0,2
Bangladesh,11/06/2003,0,0,0,0,0,0,0,0
Bangladesh,12/06/2003,2,0,0,0,0,0,0,2
Bangladesh,13/06/2003,0,0,0,0,3,0,0,3
Bangladesh,16/06/2003,0,0,0,0,6,0,0,6
Bangladesh,17/06/2003,0,0,0,0,0,0,0,0
Bangladesh,18/06/2003,0,0,0,0,21,0,0,21
Bangladesh,19/06/2003,0,0,0,0,0,0,0,0
Bangladesh,20/06/2003,1,0,0,0,12,0,0,13
Bangladesh,21/06/2003,-3,0,0,0,-4,0,0,-7
Bangladesh,22/06/2003,3,0,0,0,-4,0,0,-1
Bangladesh,23/06/2003,-1,0,0,0,6,0,0,5
Bangladesh,24/06/2003,3,0,0,0,6,1,0,10
Bangladesh,25/06/2003,2,0,0,0,0,0,0,2
Bangladesh,26/06/2003,0,0,0,0,6,0,0,6
Bangladesh,27/06/2003,0,0,0,0,0,0,0,0
Bangladesh,28/06/2003,0,0,0,0,0,0,0,0
Bangladesh,29/06/2003,0,0,0,0,0,0,0,0
Bangladesh,01/07/2003,11,0,0,0,7,0,0,18
Bangladesh,02/07/2003,6,0,0,0,6,0,0,12
Bangladesh,03/07/2003,0,0,0,0,0,0,0,0
Bangladesh,04/07/2003,0,0,0,0,0,0,0,0
Bangladesh,05/07/2003,0,0,0,0,3,0,0,3
Bangladesh,07/07/2003,0,0,0,0,0,0,0,0
Bangladesh,08/07/2003,4,0,0,0,0,0,0,4
Bangladesh,09/07/2003,1,0,0,0,3,0,0,4
Bangladesh,10/07/2003,0,0,0,0,0,0,0,0
Bangladesh,11/07/2003,0,0,0,0,0,0,0,0
Bangladesh,12/07/2003,2,0,0,0,0,0,0,2
Bangladesh,13/07/2003,0,0,0,0,0,0,0,0
Bangladesh,14/07/2003,3,0,0,0,0,0,0,3
Bangladesh,15/07/2003,2,0,0,0,3,0,0,5
Bangladesh,16/07/2003,1,0,0,0,0,0,0,1
Bangladesh,17/07/2003,0,0,0,0,0,0,0,0
Bangladesh,18/07/2003,9,0,0,0,0,0,0,9
Bangladesh,19/07/2003,1,0,0,0,0,0,0,1
Bangladesh,20/07/2003,4,0,0,0,3,0,0,7
Bangladesh,21/07/2003,0,0,0,0,3,0,0,3
Bangladesh,22/07/2003,0,0,0,0,3,0,0,3
Bangladesh,23/07/2003,7,0,0,0,0,0,0,7
Bangladesh,24/07/2003,2,0,0,0,22,0,0,24
Bangladesh,25/07/2003,9,0,0,0,0,0,0,9
Bangladesh,27/07/2003,0,0,0,0,0,0,0,0
Bangladesh,28/07/2003,1,0,0,0,0,0,0,1
Bangladesh,29/07/2003,1,0,0,0,-2,2,0,1
Bangladesh,30/07/2003,2,0,0,0,6,2,0,10
Bangladesh,31/07/2003,1,0,0,0,0,0,0,1
Bangladesh,01/08/2003,0,0,0,0,0,0,0,0
Bangladesh,02/08/2003,0,0,0,0,0,0,0,0
Bangladesh,03/08/2003,0,0,0,0,0,0,0,0
Bangladesh,04/08/2003,0,0,0,0,0,0,0,0
Bangladesh,05/08/2003,3,0,0,0,0,0,0,3
Bangladesh,06/08/2003,3,0,0,0,9,0,0,12
Bangladesh,07/08/2003,0,0,0,0,3,0,0,3
Bangladesh,08/08/2003,0,0,0,0,3,2,0,5
Bangladesh,10/08/2003,0,0,0,0,0,0,0,0
Bangladesh,11/08/2003,19,0,0,0,12,0,0,31
Bangladesh,12/08/2003,3,0,0,0,0,0,0,3
Bangladesh,13/08/2003,-4,0,0,0,0,0,0,-4
Bangladesh,14/08/2003,0,0,0,0,0,0,0,0
Bangladesh,15/08/2003,0,0,0,0,6,0,0,6
Bangladesh,16/08/2003,5,0,1,0,0,0,0,6
Bangladesh,17/08/2003,0,0,0,0,3,0,0,3
Bangladesh,18/08/2003,3,0,0,0,0,0,0,3
Bangladesh,19/08/2003,0,0,0,0,0,0,0,0
Bangladesh,20/08/2003,6,0,0,0,0,0,0,6
Bangladesh,21/08/2003,5,0,0,0,-2,0,0,3
Bangladesh,24/08/2003,0,0,0,0,0,0,0,0
Bangladesh,25/08/2003,2,0,0,0,0,0,0,2
Bangladesh,27/08/2003,1,0,0,0,-2,0,0,-1
Bangladesh,29/08/2003,0,0,0,0,0,0,0,0
Bangladesh,30/08/2003,0,0,0,0,0,0,0,0
Bangladesh,31/08/2003,0,0,0,0,6,0,0,6
Bangladesh,01/09/2003,10,2,0,0,0,0,0,12
Bangladesh,02/09/2003,0,0,0,0,0,0,0,0
Bangladesh,03/09/2003,1,0,0,0,0,0,0,1
Bangladesh,04/09/2003,6,0,0,0,0,0,0,6
Bangladesh,05/09/2003,0,0,0,0,0,0,0,0
Bangladesh,06/09/2003,0,0,0,0,0,0,0,0
Bangladesh,07/09/2003,0,0,0,0,0,0,0,0
Bangladesh,08/09/2003,3,0,0,0,0,0,0,3
Bangladesh,09/09/2003,-1,0,0,0,0,0,0,-1
Bangladesh,10/09/2003,0,0,0,0,0,0,0,0
Bangladesh,11/09/2003,1,0,0,0,0,0,0,1
Bangladesh,12/09/2003,-1,0,0,0,0,0,0,-1
Bangladesh,13/09/2003,0,0,0,0,0,0,0,0
Bangladesh,15/09/2003,0,0,0,0,0,0,0,0
Bangladesh,16/09/2003,0,0,0,0,3,0,0,3
Bangladesh,17/09/2003,9,0,0,0,3,0,0,12
Bangladesh,18/09/2003,1,0,-1,0,-2,0,0,-2
Bangladesh,19/09/2003,0,0,0,0,0,0,0,0
Bangladesh,20/09/2003,0,0,0,0,0,0,0,0
Bangladesh,21/09/2003,3,0,0,0,0,0,0,3
Bangladesh,22/09/2003,6,0,0,0,3,0,0,9
Bangladesh,23/09/2003,0,0,0,0,0,0,0,0
Bangladesh,24/09/2003,12,0,0,0,0,0,0,12
Bangladesh,25/09/2003,10,0,0,0,3,2,0,15
Bangladesh,27/09/2003,2,0,0,0,0,0,0,2
Bangladesh,28/09/2003,0,0,0,0,0,0,0,0
Bangladesh,29/09/2003,0,0,0,0,30,1,0,31
Bangladesh,30/09/2003,0,0,0,0,0,0,0,0
Bangladesh,01/10/2003,8,2,0,0,0,0,0,10
Bangladesh,02/10/2003,19,0,0,0,4,0,0,23
Bangladesh,03/10/2003,6,0,0,0,0,1,0,7
Bangladesh,04/10/2003,3,0,0,0,0,0,0,3
Bangladesh,05/10/2003,0,0,0,0,0,0,0,0
Bangladesh,06/10/2003,-1,0,0,0,0,0,0,-1
Bangladesh,07/10/2003,16,0,0,0,0,0,0,16
Bangladesh,08/10/2003,8,0,0,0,0,0,0,8
Bangladesh,09/10/2003,-4,0,0,0,0,0,0,-4
Bangladesh,10/10/2003,0,0,0,0,0,0,0,0
Bangladesh,11/10/2003,5,0,0,0,0,1,0,6
Bangladesh,12/10/2003,0,0,0,0,0,0,0,0
Bangladesh,13/10/2003,0,0,0,0,0,0,0,0
Bangladesh,14/10/2003,4,0,0,0,3,0,0,7
Bangladesh,15/10/2003,0,0,0,0,0,0,0,0
Bangladesh,16/10/2003,1,0,0,0,0,0,0,1
Bangladesh,17/10/2003,3,0,0,0,0,0,0,3
Bangladesh,18/10/2003,2,0,0,0,0,0,0,2
Bangladesh,19/10/2003,0,0,0,0,0,0,0,0
Bangladesh,20/10/2003,5,0,0,0,0,0,0,5
Bangladesh,21/10/2003,4,0,0,0,0,0,0,4
Bangladesh,22/10/2003,1,0,0,0,3,0,0,4
Bangladesh,23/10/2003,0,0,0,0,0,0,0,0
Bangladesh,25/10/2003,0,0,0,0,0,0,0,0
Bangladesh,26/10/2003,0,0,0,0,3,0,0,3
Bangladesh,27/10/2003,3,0,0,0,0,1,0,4
Bangladesh,28/10/2003,0,0,0,0,0,0,0,0
Bangladesh,29/10/2003,6,0,0,0,0,0,0,6
Bangladesh,30/10/2003,12,0,0,0,6,9,0,27
Bangladesh,31/10/2003,0,0,0,0,3,0,0,3
Bangladesh,01/11/2003,0,0,0,0,3,0,0,3
Bangladesh,02/11/2003,1,0,0,0,3,0,0,4
Bangladesh,03/11/2003,0,0,0,0,-2,0,0,-2
Bangladesh,05/11/2003,0,0,0,0,0,0,0,0
Bangladesh,06/11/2003,9,0,0,0,0,0,0,9
Bangladesh,07/11/2003,3,0,0,0,0,0,0,3
Bangladesh,08/11/2003,10,0,0,0,0,0,0,10
Bangladesh,09/11/2003,3,0,0,0,0,0,0,3
Bangladesh,10/11/2003,0,0,0,0,3,0,0,3
Bangladesh,11/11/2003,0,0,0,0,0,0,0,0
Bangladesh,12/11/2003,4,0,0,0,0,0,0,4
Bangladesh,13/11/2003,0,0,0,0,0,0,0,0
Bangladesh,14/11/2003,0,0,0,0,0,1,0,1
Bangladesh,15/11/2003,0,0,0,0,0,0,0,0
Bangladesh,17/11/2003,1,0,0,0,0,0,0,1
Bangladesh,18/11/2003,1,0,0,0,3,0,0,4
Bangladesh,19/11/2003,0,0,0,0,6,4,0,10
Bangladesh,20/11/2003,0,0,0,0,0,1,0,1
Bangladesh,21/11/2003,0,0,0,0,0,0,0,0
Bangladesh,23/11/2003,7,0,0,0,0,0,0,7
Bangladesh,24/11/2003,0,0,0,0,0,0,0,0
Bangladesh,25/11/2003,0,0,0,0,0,0,0,0
Bangladesh,26/11/2003,10,0,0,0,12,0,0,22
Bangladesh,27/11/2003,0,0,0,0,0,0,0,0
Bangladesh,28/11/2003,3,0,-4,0,6,0,0,5
Bangladesh,29/11/2003,0,0,0,0,6,0,0,6
Bangladesh,30/11/2003,0,0,0,0,15,0,0,15
Bangladesh,02/12/2003,0,0,0,0,0,1,0,1
Bangladesh,03/12/2003,0,0,0,0,0,0,0,0
Bangladesh,04/12/2003,0,0,0,0,21,0,0,21
Bangladesh,05/12/2003,2,0,0,0,22,0,0,24
Bangladesh,06/12/2003,3,0,0,0,0,0,0,3
Bangladesh,07/12/2003,1,0,0,0,0,0,0,1
Bangladesh,08/12/2003,0,0,0,0,-4,2,0,-2
Bangladesh,09/12/2003,6,0,2,0,9,2,0,19
Bangladesh,10/12/2003,2,0,0,0,3,0,0,5
Bangladesh,11/12/2003,0,0,0,0,-4,1,0,-3
Bangladesh,12/12/2003,0,0,0,0,0,0,0,0
Bangladesh,13/12/2003,0,0,0,0,0,0,0,0
Bangladesh,14/12/2003,0,0,0,0,0,0,0,0
Bangladesh,16/12/2003,-2,0,0,0,3,0,0,1
Bangladesh,17/12/2003,0,0,0,0,-2,0,0,-2
Bangladesh,18/12/2003,11,0,0,0,10,0,0,21
Bangladesh,19/12/2003,5,0,0,0,0,0,0,5
Bangladesh,20/12/2003,-1,0,0,0,0,0,0,-1
Bangladesh,21/12/2003,4,0,0,0,3,2,0,9
Bangladesh,22/12/2003,11,0,0,0,9,2,0,22
Bangladesh,23/12/2003,5,0,0,0,6,0,0,11
Bangladesh,24/12/2003,0,0,0,0,0,0,0,0
Bangladesh,25/12/2003,0,0,0,0,6,0,0,6
Bangladesh,26/12/2003,0,0,0,0,0,0,0,0
Bangladesh,27/12/2003,0,0,0,0,1,0,0,1
Bangladesh,28/12/2003,0,0,0,0,-6,0,0,-6
Bangladesh,29/12/2003,0,0,0,0,0,0,0,0
Bangladesh,30/12/2003,0,0,0,0,0,5,0,5
Bangladesh,31/12/2003,3,0,0,0,-2,0,0,1
Cameroon,02/01/2003,0,0,0,0,0,0,0,0
Cameroon,07/01/2003,0,0,0,0,0,0,0,0
Cameroon,08/01/2003,0,0,0,0,0,0,0,0
Cameroon,12/01/2003,0,0,0,0,0,0,0,0
Cameroon,14/01/2003,0,0,0,0,0,0,0,0
Cameroon,18/01/2003,0,0,0,0,0,0,0,0
Cameroon,20/01/2003,0,0,0,0,0,0,0,0
Cameroon,21/01/2003,2,0,0,0,0,0,0,2
Cameroon,24/01/2003,0,0,0,0,0,0,0,0
Cameroon,27/01/2003,0,0,0,0,0,0,0,0
Cameroon,28/01/2003,0,0,0,0,0,0,0,0
Cameroon,29/01/2003,9,0,0,0,0,0,0,9
Cameroon,31/01/2003,-1,0,0,0,0,0,0,-1
Cameroon,03/02/2003,2,0,0,0,0,0,0,2
Cameroon,05/02/2003,4,0,0,0,0,0,0,4
Cameroon,06/02/2003,4,0,0,0,0,0,0,4
Cameroon,07/02/2003,0,0,0,0,0,0,0,0
Cameroon,10/02/2003,0,0,0,0,0,0,0,0
Cameroon,13/02/2003,0,0,0,0,0,0,0,0
Cameroon,14/02/2003,0,0,0,0,-2,0,0,-2
Cameroon,15/02/2003,0,0,0,0,0,0,0,0
Cameroon,17/02/2003,0,0,0,0,6,0,0,6
Cameroon,19/02/2003,0,0,0,0,0,0,0,0
Cameroon,20/02/2003,0,0,0,0,0,0,0,0
Cameroon,21/02/2003,0,0,0,0,0,0,0,0
Cameroon,22/02/2003,0,0,0,0,0,0,0,0
Cameroon,23/02/2003,0,0,0,0,0,0,0,0
Cameroon,24/02/2003,0,0,0,0,0,0,0,0
Cameroon,25/02/2003,0,0,0,0,0,0,0,0
Cameroon,26/02/2003,0,0,0,0,0,0,0,0
Cameroon,27/02/2003,0,0,0,0,0,3,0,3
Cameroon,28/02/2003,1,0,0,0,0,0,0,1
Cameroon,01/03/2003,0,0,0,0,0,0,0,0
Cameroon,02/03/2003,0,0,0,0,0,3,0,3
Cameroon,03/03/2003,3,0,0,0,0,0,0,3
Cameroon,04/03/2003,6,0,0,0,0,1,0,7
Cameroon,05/03/2003,3,0,0,0,0,0,0,3
Cameroon,06/03/2003,0,0,0,0,0,2,0,2
Cameroon,07/03/2003,-1,0,0,0,0,0,0,-1
Cameroon,08/03/2003,0,0,0,0,0,0,0,0
Cameroon,09/03/2003,1,0,0,0,0,0,0,1
Cameroon,10/03/2003,38,0,0,0,0,0,0,38
Cameroon,11/03/2003,0,0,0,0,0,0,0,0
Cameroon,12/03/2003,0,0,0,0,0,2,0,2
Cameroon,13/03/2003,7,0,0,0,0,0,0,7
Cameroon,14/03/2003,14,0,0,0,3,1,0,18
Cameroon,15/03/2003,3,0,0,0,0,0,0,3
Cameroon,16/03/2003,12,0,0,0,3,0,0,15
Cameroon,17/03/2003,10,0,0,0,3,0,0,13
Cameroon,18/03/2003,4,0,0,0,3,0,0,7
Cameroon,19/03/2003,1,0,0,0,0,0,0,1
Cameroon,20/03/2003,4,0,0,0,6,0,0,10
Cameroon,21/03/2003,1,0,0,0,0,2,0,3
Cameroon,22/03/2003,0,0,0,0,0,0,0,0
Cameroon,23/03/2003,0,0,0,0,-10,0,0,-10
Cameroon,24/03/2003,1,0,0,0,0,0,0,1
Cameroon,25/03/2003,0,0,0,0,0,0,0,0
Cameroon,30/03/2003,0,0,0,0,0,0,0,0
Cameroon,31/03/2003,0,0,0,0,0,0,0,0
Cameroon,04/04/2003,2,0,0,0,0,0,0,2
Cameroon,08/04/2003,0,0,0,0,0,1,0,1
Cameroon,09/04/2003,0,0,0,0,0,0,0,0
Cameroon,11/04/2003,0,0,0,0,0,0,0,0
Cameroon,14/04/2003,0,0,0,0,0,0,0,0
Cameroon,15/04/2003,0,0,0,0,0,0,0,0
Cameroon,16/04/2003,0,0,0,0,0,0,0,0
Cameroon,17/04/2003,0,0,0,0,0,0,0,0
Cameroon,18/04/2003,2,0,0,0,0,0,0,2
Cameroon,21/04/2003,2,0,0,0,-2,0,0,0
Cameroon,22/04/2003,0,0,0,0,0,0,0,0
Cameroon,23/04/2003,2,0,0,0,6,0,0,8
Cameroon,24/04/2003,1,0,0,0,3,0,0,4
Cameroon,28/04/2003,0,0,0,0,0,0,0,0
Cameroon,29/04/2003,0,0,0,0,0,0,0,0
Cameroon,02/05/2003,0,0,0,0,0,0,0,0
Cameroon,05/05/2003,0,0,0,0,0,0,0,0
Cameroon,07/05/2003,0,0,0,0,0,0,0,0
Cameroon,08/05/2003,0,0,0,0,0,0,0,0
Cameroon,09/05/2003,1,0,0,0,0,0,0,1
Cameroon,12/05/2003,3,0,0,0,0,0,0,3
Cameroon,13/05/2003,0,0,0,0,0,0,0,0
Cameroon,14/05/2003,2,0,0,0,0,0,0,2
Cameroon,15/05/2003,0,0,0,0,3,0,0,3
Cameroon,19/05/2003,7,0,0,0,0,0,0,7
Cameroon,20/05/2003,0,0,0,0,0,0,0,0
Cameroon,21/05/2003,0,0,0,0,0,0,0,0
Cameroon,22/05/2003,-6,0,0,0,0,0,0,-6
Cameroon,23/05/2003,0,0,0,0,0,0,0,0
Cameroon,26/05/2003,0,0,0,0,0,0,0,0
Cameroon,27/05/2003,-7,0,0,0,0,0,0,-7
Cameroon,28/05/2003,0,0,0,0,0,0,0,0
Cameroon,29/05/2003,1,0,0,0,0,0,0,1
Cameroon,30/05/2003,5,0,0,0,0,0,0,5
Cameroon,02/06/2003,3,0,0,0,0,0,0,3
Cameroon,03/06/2003,0,0,0,0,0,0,0,0
Cameroon,04/06/2003,0,0,0,0,0,0,0,0
Cameroon,05/06/2003,0,0,0,0,0,0,0,0
Cameroon,09/06/2003,1,0,0,0,0,0,0,1
Cameroon,10/06/2003,0,0,0,0,0,0,0,0
Cameroon,11/06/2003,0,0,0,0,0,0,0,0
Cameroon,12/06/2003,2,0,0,0,0,0,0,2
Cameroon,13/06/2003,0,0,0,0,0,0,0,0
Cameroon,15/06/2003,0,0,0,0,0,0,0,0
Cameroon,16/06/2003,0,0,0,0,0,0,0,0
Cameroon,18/06/2003,0,0,0,0,0,0,0,0
Cameroon,19/06/2003,0,0,0,0,0,0,0,0
Cameroon,20/06/2003,0,0,0,0,0,0,0,0
Cameroon,22/06/2003,0,0,0,0,0,0,0,0
Cameroon,23/06/2003,1,0,0,0,0,0,0,1
Cameroon,24/06/2003,0,0,0,0,0,0,0,0
Cameroon,25/06/2003,2,0,0,0,6,0,0,8
Cameroon,27/06/2003,0,0,0,0,0,0,0,0
Cameroon,01/07/2003,-2,0,0,0,0,0,0,-2
Cameroon,07/07/2003,-1,0,0,0,0,0,0,-1
Cameroon,09/07/2003,0,0,0,0,0,0,0,0
Cameroon,10/07/2003,0,0,0,0,0,0,0,0
Cameroon,14/07/2003,0,0,0,0,0,0,0,0
Cameroon,15/07/2003,0,0,0,0,0,0,0,0
Cameroon,16/07/2003,0,0,0,0,0,0,0,0
Cameroon,17/07/2003,0,0,0,0,0,0,0,0
Cameroon,18/07/2003,0,0,0,0,0,0,0,0
Cameroon,21/07/2003,0,0,0,0,0,0,0,0
Cameroon,22/07/2003,0,0,0,0,0,0,0,0
Cameroon,23/07/2003,0,0,0,0,0,0,0,0
Cameroon,25/07/2003,4,0,0,0,0,0,0,4
Cameroon,27/07/2003,0,0,0,0,0,0,0,0
Cameroon,29/07/2003,0,0,0,0,0,0,0,0
Cameroon,30/07/2003,0,0,0,0,0,0,0,0
Cameroon,31/07/2003,-1,0,0,0,0,0,0,-1
Cameroon,01/08/2003,1,0,0,0,6,0,0,7
Cameroon,03/08/2003,0,0,0,0,0,0,0,0
Cameroon,06/08/2003,0,0,0,0,0,0,0,0
Cameroon,07/08/2003,0,0,0,0,0,1,0,1
Cameroon,10/08/2003,0,0,0,0,0,0,0,0
Cameroon,11/08/2003,0,0,0,0,3,0,0,3
Cameroon,12/08/2003,0,0,0,0,0,0,0,0
Cameroon,14/08/2003,2,0,0,0,0,0,0,2
Cameroon,17/08/2003,0,0,0,0,0,0,0,0
Cameroon,18/08/2003,4,0,0,0,6,1,0,11
Cameroon,19/08/2003,0,0,0,0,0,0,0,0
Cameroon,20/08/2003,6,0,0,0,0,0,0,6
Cameroon,21/08/2003,0,0,0,0,0,0,0,0
Cameroon,22/08/2003,2,0,0,0,6,0,0,8
Cameroon,24/08/2003,2,0,0,0,0,0,0,2
Cameroon,25/08/2003,0,0,0,0,0,0,0,0
Cameroon,26/08/2003,0,0,0,0,0,0,0,0
Cameroon,29/08/2003,0,0,0,0,0,0,0,0
Cameroon,03/09/2003,0,0,0,0,0,0,0,0
Cameroon,04/09/2003,10,0,0,0,0,0,0,10
Cameroon,05/09/2003,14,0,0,0,0,0,0,14
Cameroon,07/09/2003,0,0,0,0,0,0,0,0
Cameroon,08/09/2003,0,0,0,0,0,0,0,0
Cameroon,10/09/2003,12,0,0,0,0,0,0,12
Cameroon,15/09/2003,2,0,0,0,-2,0,0,0
Cameroon,16/09/2003,0,0,0,0,0,0,0,0
Cameroon,17/09/2003,0,0,0,0,0,0,0,0
Cameroon,18/09/2003,0,0,0,0,0,0,0,0
Cameroon,21/09/2003,0,0,0,0,0,0,0,0
Cameroon,22/09/2003,1,0,0,0,0,0,0,1
Cameroon,23/09/2003,0,0,0,0,0,0,0,0
Cameroon,24/09/2003,2,0,0,0,0,0,0,2
Cameroon,25/09/2003,2,0,0,0,0,0,0,2
Cameroon,26/09/2003,0,0,0,0,0,0,0,0
Cameroon,29/09/2003,3,0,0,0,0,0,0,3
Cameroon,30/09/2003,2,0,0,0,0,0,0,2
Cameroon,02/10/2003,0,2,0,0,0,0,0,2
Cameroon,03/10/2003,0,0,0,0,0,0,0,0
Cameroon,05/10/2003,0,0,0,0,0,0,0,0
Cameroon,06/10/2003,0,0,0,0,0,0,0,0
Cameroon,07/10/2003,0,0,0,0,0,0,0,0
Cameroon,08/10/2003,-1,0,-4,0,0,0,0,-5
Cameroon,12/10/2003,0,0,0,0,0,0,0,0
Cameroon,13/10/2003,0,0,0,0,0,0,0,0
Cameroon,14/10/2003,4,0,0,0,0,1,0,5
Cameroon,15/10/2003,4,0,0,0,-2,1,0,3
Cameroon,16/10/2003,2,0,0,0,1,0,0,3
Cameroon,17/10/2003,0,0,0,0,0,0,0,0
Cameroon,20/10/2003,1,0,0,0,0,0,0,1
Cameroon,22/10/2003,1,0,0,0,0,0,0,1
Cameroon,23/10/2003,0,0,0,0,0,0,0,0
Cameroon,24/10/2003,0,0,0,0,0,0,0,0
Cameroon,26/10/2003,0,0,0,0,0,0,0,0
Cameroon,27/10/2003,2,0,0,0,0,0,0,2
Cameroon,28/10/2003,0,0,0,0,0,0,0,0
Cameroon,29/10/2003,0,0,0,0,-2,1,0,-1
Cameroon,30/10/2003,0,0,0,0,-2,0,0,-2
Cameroon,31/10/2003,1,0,0,0,0,0,0,1
Cameroon,02/11/2003,6,0,0,0,3,0,0,9
Cameroon,03/11/2003,0,0,0,0,0,0,0,0
Cameroon,04/11/2003,3,0,0,0,0,0,0,3
Cameroon,05/11/2003,0,0,0,0,3,0,0,3
Cameroon,06/11/2003,0,0,0,0,0,0,0,0
Cameroon,07/11/2003,0,0,0,0,0,0,0,0
Cameroon,13/11/2003,0,0,0,0,0,0,0,0
Cameroon,14/11/2003,0,0,0,0,0,0,0,0
Cameroon,17/11/2003,0,0,0,0,0,0,0,0
Cameroon,18/11/2003,-1,0,0,0,0,1,0,0
Cameroon,19/11/2003,0,0,0,0,0,0,0,0
Cameroon,20/11/2003,0,0,0,0,0,0,0,0
Cameroon,24/11/2003,0,0,0,0,0,0,0,0
Cameroon,25/11/2003,0,0,0,0,0,0,0,0
Cameroon,26/11/2003,0,0,0,0,-2,0,0,-2
Cameroon,28/11/2003,3,0,0,0,0,0,0,3
Cameroon,30/11/2003,0,0,0,0,1,0,0,1
Cameroon,01/12/2003,1,0,0,0,0,0,0,1
Cameroon,02/12/2003,0,0,0,0,6,0,0,6
Cameroon,03/12/2003,0,0,0,0,18,0,0,18
Cameroon,04/12/2003,0,0,0,0,6,0,0,6
Cameroon,05/12/2003,0,0,0,0,3,0,0,3
Cameroon,08/12/2003,0,0,0,0,0,0,0,0
Cameroon,09/12/2003,0,0,0,0,0,0,0,0
Cameroon,10/12/2003,0,0,0,0,0,0,0,0
Cameroon,11/12/2003,1,0,0,0,-5,0,0,-4
Cameroon,15/12/2003,2,0,0,0,3,0,0,5
Cameroon,17/12/2003,0,0,0,0,1,0,0,1
Cameroon,18/12/2003,1,0,0,0,0,0,0,1
Cameroon,19/12/2003,-3,0,0,0,9,0,0,6
Cameroon,21/12/2003,0,0,0,0,0,0,0,0
Cameroon,22/12/2003,0,0,0,0,3,2,0,5
Cameroon,23/12/2003,0,0,0,0,0,0,0,0
Cameroon,24/12/2003,0,0,-2,0,6,0,0,4
Cameroon,26/12/2003,0,0,0,0,0,0,0,0
Cameroon,27/12/2003,0,0,0,0,0,0,0,0
Cameroon,30/12/2003,0,0,0,0,0,0,0,0
Cameroon,31/12/2003,9,0,0,0,0,0,0,9
China,01/01/2003,18,0,0,0,9,2,0,29
China,02/01/2003,4,0,0,0,-4,0,0,0
China,03/01/2003,17,0,1,0,-2,0,0,16
China,04/01/2003,-2,0,-2,0,22,0,0,18
China,05/01/2003,3,0,-3,0,0,0,0,0
China,06/01/2003,23,0,0,0,18,11,0,52
China,07/01/2003,5,0,0,0,24,2,0,31
China,08/01/2003,29,0,0,0,0,-1,0,28
China,09/01/2003,12,0,0,0,9,2,0,23
China,10/01/2003,11,0,0,0,2,0,0,13
China,11/01/2003,2,0,0,0,0,0,0,2
China,12/01/2003,15,0,0,0,0,0,0,15
China,13/01/2003,23,0,0,0,24,5,0,52
China,14/01/2003,12,0,0,0,7,5,0,24
China,15/01/2003,20,0,0,0,6,1,0,27
China,16/01/2003,10,0,0,0,6,0,0,16
China,17/01/2003,7,0,0,0,0,0,0,7
China,18/01/2003,3,0,0,0,6,0,0,9
China,19/01/2003,-1,0,-2,0,10,0,0,7
China,20/01/2003,41,0,0,0,9,3,0,53
China,21/01/2003,23,0,-1,0,3,2,0,27
China,22/01/2003,20,0,0,0,6,0,0,26
China,23/01/2003,29,2,-7,0,30,0,0,54
China,24/01/2003,0,0,0,0,0,0,0,0
China,25/01/2003,3,0,0,0,9,0,0,12
China,26/01/2003,21,0,0,0,0,0,0,21
China,27/01/2003,21,0,0,0,12,1,0,34
China,28/01/2003,21,0,0,0,12,2,0,35
China,29/01/2003,31,0,0,0,26,6,0,63
China,30/01/2003,12,2,0,0,1,0,0,15
China,31/01/2003,9,0,-2,0,12,3,0,22
China,01/02/2003,10,0,0,0,0,3,0,13
China,02/02/2003,1,0,0,0,0,2,0,3
China,03/02/2003,5,0,0,0,4,0,0,9
China,04/02/2003,10,0,0,0,12,4,0,26
China,05/02/2003,31,0,0,0,0,2,0,33
China,06/02/2003,19,0,0,0,9,0,0,28
China,07/02/2003,13,0,0,0,3,0,0,16
China,08/02/2003,16,0,0,0,18,4,0,38
China,09/02/2003,15,0,0,0,3,0,0,18
China,10/02/2003,10,2,0,0,21,1,0,34
China,11/02/2003,19,0,1,0,2,12,0,34
China,12/02/2003,20,0,0,0,-2,1,0,19
China,13/02/2003,15,0,3,0,7,1,0,26
China,14/02/2003,19,0,1,0,15,2,0,37
China,15/02/2003,27,0,2,0,7,0,0,36
China,16/02/2003,5,0,0,0,6,0,0,11
China,17/02/2003,18,0,2,0,9,1,0,30
China,18/02/2003,23,0,0,0,8,1,0,32
China,19/02/2003,0,0,-1,0,3,1,0,3
China,20/02/2003,23,0,0,0,4,1,0,28
China,21/02/2003,1,6,0,0,3,1,0,11
China,22/02/2003,8,0,0,0,-9,0,0,-1
China,23/02/2003,13,0,0,0,6,1,0,20
China,24/02/2003,9,0,0,0,9,1,0,19
China,25/02/2003,18,0,1,0,17,3,0,39
China,26/02/2003,6,0,0,0,0,3,0,9
China,27/02/2003,11,0,1,0,12,0,0,24
China,28/02/2003,25,0,-2,0,8,1,0,32
China,01/03/2003,11,0,0,0,0,0,0,11
China,02/03/2003,3,0,0,0,3,0,0,6
China,03/03/2003,7,0,0,0,0,1,0,8
China,04/03/2003,11,0,0,0,0,2,0,13
China,05/03/2003,3,0,0,0,3,4,0,10
China,06/03/2003,40,0,0,0,9,5,0,54
China,07/03/2003,17,2,-2,0,0,6,0,23
China,08/03/2003,15,0,0,0,-6,2,0,11
China,09/03/2003,34,0,2,0,0,5,0,41
China,10/03/2003,21,0,0,0,0,7,0,28
China,11/03/2003,26,0,0,0,5,1,0,32
China,12/03/2003,26,0,0,0,3,2,0,31
China,13/03/2003,24,0,-1,0,-7,8,0,24
China,14/03/2003,29,0,0,0,3,3,0,35
China,15/03/2003,6,0,1,0,9,0,0,16
China,16/03/2003,7,0,-4,0,7,1,0,11
China,17/03/2003,25,0,-1,0,7,1,0,32
China,18/03/2003,30,0,-1,0,6,1,0,36
China,19/03/2003,19,0,0,0,12,0,0,31
China,20/03/2003,32,0,3,0,0,5,0,40
China,21/03/2003,28,0,0,0,3,3,0,34
China,22/03/2003,12,0,0,0,3,0,0,15
China,23/03/2003,2,0,0,0,0,2,0,4
China,24/03/2003,9,0,0,0,0,2,0,11
China,25/03/2003,16,0,0,0,15,0,0,31
China,26/03/2003,28,0,0,0,10,0,0,38
China,27/03/2003,15,0,0,0,2,1,0,18
China,28/03/2003,13,0,0,0,8,14,0,35
China,29/03/2003,17,0,-1,0,21,5,0,42
China,30/03/2003,0,0,0,0,3,0,0,3
China,31/03/2003,31,0,0,0,17,2,0,50
China,01/04/2003,40,0,2,0,6,4,0,52
China,02/04/2003,21,0,0,0,20,3,0,44
China,03/04/2003,28,0,0,0,12,4,0,44
China,04/04/2003,44,0,0,0,11,1,0,56
China,05/04/2003,10,0,0,0,3,7,0,20
China,06/04/2003,17,0,0,0,0,0,0,17
China,07/04/2003,3,0,-2,0,10,1,0,12
China,08/04/2003,5,0,0,0,0,4,0,9
China,09/04/2003,24,0,0,0,30,0,0,54
China,10/04/2003,43,0,0,0,18,3,0,64
China,11/04/2003,19,0,0,0,12,0,0,31
China,12/04/2003,25,0,0,0,3,0,0,28
China,13/04/2003,4,0,0,0,18,2,0,24
China,14/04/2003,26,0,0,0,24,1,0,51
China,15/04/2003,27,0,0,0,36,1,0,64
China,16/04/2003,14,2,0,0,5,2,0,23
China,17/04/2003,2,0,0,0,9,0,0,11
China,18/04/2003,8,0,0,0,3,0,0,11
China,19/04/2003,2,0,0,0,6,4,0,12
China,20/04/2003,1,0,3,0,4,1,0,9
China,21/04/2003,27,0,0,0,3,2,0,32
China,22/04/2003,13,0,1,0,12,0,0,26
China,23/04/2003,19,0,0,0,7,0,0,26
China,24/04/2003,21,0,0,0,3,4,0,28
China,25/04/2003,16,0,0,0,-4,2,0,14
China,26/04/2003,10,0,0,0,27,0,0,37
China,27/04/2003,13,0,0,0,-2,0,0,11
China,28/04/2003,11,0,0,0,24,1,0,36
China,29/04/2003,35,0,5,0,30,6,0,76
China,30/04/2003,33,0,0,0,9,7,0,49
China,01/05/2003,23,0,0,0,4,1,0,28
China,02/05/2003,2,0,0,0,0,4,0,6
China,03/05/2003,6,0,1,0,1,4,0,12
China,04/05/2003,20,0,1,0,0,6,0,27
China,05/05/2003,11,0,0,0,4,0,0,15
China,06/05/2003,19,0,0,0,21,3,0,43
China,07/05/2003,24,0,0,0,15,0,0,39
China,08/05/2003,60,4,-2,0,60,2,0,124
China,09/05/2003,23,0,1,0,26,2,0,52
China,10/05/2003,1,0,0,0,15,1,0,17
China,11/05/2003,13,0,0,0,12,0,0,25
China,12/05/2003,18,0,0,0,14,1,0,33
China,13/05/2003,35,0,0,0,17,7,0,59
China,14/05/2003,24,0,0,0,33,5,0,62
China,15/05/2003,6,0,0,0,18,1,0,25
China,16/05/2003,5,0,0,0,3,5,0,13
China,17/05/2003,9,0,0,0,9,0,0,18
China,18/05/2003,8,0,0,0,0,0,0,8
China,19/05/2003,23,0,-6,0,9,2,0,28
China,20/05/2003,9,2,0,0,-1,4,0,14
China,21/05/2003,9,0,1,0,0,0,0,10
China,22/05/2003,43,2,-4,0,10,2,0,53
China,23/05/2003,26,0,4,0,34,1,0,65
China,24/05/2003,12,0,2,0,12,0,0,26
China,25/05/2003,6,0,0,0,6,0,0,12
China,26/05/2003,5,0,1,0,20,0,0,26
China,27/05/2003,14,0,0,0,4,0,0,18
China,28/05/2003,20,0,0,0,20,2,0,42
China,29/05/2003,17,0,0,0,3,0,0,20
China,30/05/2003,22,0,-3,0,18,0,0,37
China,31/05/2003,7,0,-4,0,-2,2,0,3
China,01/06/2003,-4,0,0,0,-2,6,0,0
China,02/06/2003,21,2,0,0,6,2,0,31
China,03/06/2003,17,0,0,0,7,1,0,25
China,04/06/2003,23,0,-1,0,30,1,0,53
China,05/06/2003,15,2,0,0,-2,1,0,16
China,06/06/2003,2,0,-2,0,2,5,0,7
China,07/06/2003,2,0,0,0,0,2,0,4
China,08/06/2003,2,0,0,0,0,0,0,2
China,09/06/2003,31,0,0,0,3,2,0,36
China,10/06/2003,35,0,-6,0,21,4,0,54
China,11/06/2003,11,0,0,0,2,6,0,19
China,12/06/2003,14,0,0,0,8,3,0,25
China,13/06/2003,20,2,0,0,8,3,0,33
China,14/06/2003,10,0,0,0,0,0,0,10
China,15/06/2003,10,0,0,0,-6,3,0,7
China,16/06/2003,18,0,-2,0,14,1,0,31
China,17/06/2003,6,0,0,0,-6,0,0,0
China,18/06/2003,11,0,2,0,1,4,0,18
China,19/06/2003,1,0,0,0,44,4,0,49
China,20/06/2003,11,0,0,0,3,1,0,15
China,21/06/2003,7,0,-6,0,6,0,0,7
China,22/06/2003,4,0,0,0,0,3,0,7
China,23/06/2003,21,0,-1,0,6,0,0,26
China,24/06/2003,18,0,0,0,0,0,0,18
China,25/06/2003,15,0,1,0,-2,2,0,16
China,26/06/2003,26,0,0,0,0,0,0,26
China,27/06/2003,6,0,0,0,20,0,0,26
China,28/06/2003,8,0,0,0,9,2,0,19
China,29/06/2003,7,0,0,0,0,1,0,8
China,30/06/2003,10,0,1,0,24,0,0,35
China,01/07/2003,12,0,3,0,12,3,0,30
China,02/07/2003,5,0,-4,0,11,5,0,17
China,03/07/2003,9,0,0,0,-2,2,0,9
China,04/07/2003,14,0,0,0,7,2,0,23
China,05/07/2003,9,0,0,0,7,2,0,18
China,06/07/2003,7,0,0,0,3,2,0,12
China,07/07/2003,6,0,0,0,18,3,0,27
China,08/07/2003,7,0,1,0,6,1,0,15
China,09/07/2003,12,0,-2,0,15,0,0,25
China,10/07/2003,5,0,0,0,15,1,0,21
China,11/07/2003,7,0,0,0,0,0,0,7
China,12/07/2003,5,0,-1,0,-2,0,0,2
China,13/07/2003,6,0,0,0,15,0,0,21
China,14/07/2003,8,0,3,0,0,2,0,13
China,15/07/2003,16,0,0,0,6,3,0,25
China,16/07/2003,16,0,0,0,14,0,0,30
China,17/07/2003,20,0,-2,0,3,3,0,24
China,18/07/2003,12,0,0,0,10,0,0,22
China,19/07/2003,21,0,0,0,24,0,0,45
China,20/07/2003,12,0,0,0,0,0,0,12
China,21/07/2003,2,0,0,0,1,0,0,3
China,22/07/2003,11,2,-4,0,10,1,0,20
China,23/07/2003,11,0,1,0,10,0,0,22
China,24/07/2003,8,0,-1,0,9,3,0,19
China,25/07/2003,15,0,1,0,6,1,0,23
China,26/07/2003,-2,0,0,0,-6,0,0,-8
China,27/07/2003,17,2,0,0,0,1,0,20
China,28/07/2003,22,0,0,0,-10,4,0,16
China,29/07/2003,8,0,1,0,7,1,0,17
China,30/07/2003,4,0,0,0,-1,1,0,4
China,31/07/2003,3,0,0,0,8,2,0,13
China,01/08/2003,22,0,0,0,6,5,0,33
China,02/08/2003,21,0,-2,0,23,2,0,44
China,03/08/2003,18,0,0,0,0,0,0,18
China,04/08/2003,3,0,0,0,11,4,0,18
China,05/08/2003,9,0,0,0,-2,0,0,7
China,06/08/2003,12,0,0,0,3,0,0,15
China,07/08/2003,9,0,-2,0,19,0,0,26
China,08/08/2003,6,0,0,0,8,0,0,14
China,09/08/2003,12,0,1,0,0,0,0,13
China,10/08/2003,-1,0,0,0,0,1,0,0
China,11/08/2003,12,0,0,0,27,0,0,39
China,12/08/2003,7,0,1,0,12,0,0,20
China,13/08/2003,24,0,1,0,6,0,0,31
China,14/08/2003,12,0,0,0,-4,1,0,9
China,15/08/2003,11,0,-1,0,0,2,0,12
China,16/08/2003,10,0,0,0,4,3,0,17
China,17/08/2003,4,0,-2,0,4,0,0,6
China,18/08/2003,19,0,0,0,13,0,0,32
China,19/08/2003,11,0,0,0,12,-2,0,21
China,20/08/2003,16,0,0,0,-3,1,0,14
China,21/08/2003,2,0,0,0,-16,4,0,-10
China,22/08/2003,7,0,0,0,4,4,0,15
China,23/08/2003,14,0,0,0,18,3,0,35
China,24/08/2003,9,0,0,0,1,0,0,10
China,25/08/2003,28,2,0,0,15,0,0,45
China,26/08/2003,13,0,0,0,6,5,0,24
China,27/08/2003,14,0,0,0,-12,0,0,2
China,28/08/2003,5,0,0,0,-7,0,0,-2
China,29/08/2003,9,0,0,0,15,3,0,27
China,30/08/2003,-2,0,0,0,-2,2,0,-2
China,31/08/2003,12,0,0,0,6,0,0,18
China,01/09/2003,23,0,-2,0,22,2,0,45
China,02/09/2003,8,0,0,0,19,0,0,27
China,03/09/2003,13,0,1,0,18,2,0,34
China,04/09/2003,8,2,0,0,11,1,0,22
China,05/09/2003,14,0,0,0,1,1,0,16
China,06/09/2003,14,0,0,0,18,0,0,32
China,07/09/2003,6,0,0,0,-2,0,0,4
China,08/09/2003,17,2,-1,0,0,1,0,19
China,09/09/2003,7,0,0,0,2,0,0,9
China,10/09/2003,5,0,-1,0,0,0,0,4
China,11/09/2003,12,2,-1,0,15,2,0,30
China,12/09/2003,9,0,-4,0,9,4,0,18
China,13/09/2003,4,0,0,0,-4,7,0,7
China,14/09/2003,11,0,0,0,0,6,0,17
China,15/09/2003,8,0,0,0,4,0,0,12
China,16/09/2003,2,0,0,0,5,1,0,8
China,17/09/2003,14,0,-1,0,0,1,0,14
China,18/09/2003,-7,0,0,0,0,0,0,-7
China,19/09/2003,5,0,0,0,3,0,0,8
China,20/09/2003,15,0,0,0,2,4,0,21
China,21/09/2003,3,0,0,0,0,0,0,3
China,22/09/2003,17,0,0,0,0,0,0,17
China,23/09/2003,25,2,0,0,1,2,0,30
China,24/09/2003,10,0,0,0,0,1,0,11
China,25/09/2003,11,0,0,0,0,0,0,11
China,26/09/2003,16,0,0,0,-2,0,0,14
China,27/09/2003,3,0,0,0,-3,1,0,1
China,28/09/2003,11,0,0,0,9,3,0,23
China,29/09/2003,12,0,0,0,-4,3,0,11
China,30/09/2003,13,0,0,0,9,1,0,23
China,01/10/2003,3,2,0,0,6,0,0,11
China,02/10/2003,-1,0,0,0,3,0,0,2
China,03/10/2003,4,0,0,0,1,0,0,5
China,04/10/2003,-1,0,0,0,0,0,0,-1
China,05/10/2003,25,0,0,0,0,0,0,25
China,06/10/2003,8,0,0,0,0,5,0,13
China,07/10/2003,22,0,0,0,7,4,0,33
China,08/10/2003,12,0,-1,0,10,6,0,27
China,09/10/2003,33,0,-1,0,3,1,0,36
China,10/10/2003,7,0,0,0,30,0,0,37
China,11/10/2003,0,0,0,0,6,0,0,6
China,12/10/2003,9,0,-1,0,0,0,0,8
China,13/10/2003,15,2,0,0,1,-4,0,14
China,14/10/2003,1,4,0,0,0,1,0,6
China,15/10/2003,27,2,0,0,21,0,0,50
China,16/10/2003,12,0,-4,0,6,4,0,18
China,17/10/2003,7,0,-1,0,5,1,0,12
China,18/10/2003,27,0,0,0,0,1,0,28
China,19/10/2003,10,0,0,0,3,2,0,15
China,20/10/2003,15,0,0,0,10,0,0,25
China,21/10/2003,34,0,-6,0,5,3,0,36
China,22/10/2003,34,0,0,0,28,0,0,62
China,23/10/2003,16,0,0,0,30,1,0,47
China,24/10/2003,34,0,0,0,3,1,0,38
China,25/10/2003,-2,0,0,0,0,1,0,-1
China,26/10/2003,25,2,0,0,2,1,0,30
China,27/10/2003,6,0,-4,0,13,2,0,17
China,28/10/2003,12,0,0,0,0,3,0,15
China,29/10/2003,21,0,0,0,2,2,0,25
China,30/10/2003,18,0,0,0,3,2,0,23
China,31/10/2003,8,0,0,0,21,0,0,29
China,01/11/2003,11,0,0,0,0,0,0,11
China,02/11/2003,6,0,0,0,0,0,0,6
China,03/11/2003,10,4,0,0,0,1,0,15
China,04/11/2003,6,0,-1,0,2,1,0,8
China,05/11/2003,5,0,0,0,11,1,0,17
China,06/11/2003,1,4,0,0,15,0,0,20
China,07/11/2003,28,2,0,0,11,4,0,45
China,08/11/2003,2,0,0,0,0,0,0,2
China,09/11/2003,9,0,0,0,0,3,0,12
China,10/11/2003,22,0,0,0,0,5,0,27
China,11/11/2003,23,0,0,0,27,1,0,51
China,12/11/2003,8,0,1,0,11,0,0,20
China,13/11/2003,31,0,1,0,3,0,0,35
China,14/11/2003,8,0,2,0,37,4,0,51
China,15/11/2003,19,0,0,0,12,0,0,31
China,16/11/2003,11,0,0,0,9,3,0,23
China,17/11/2003,11,0,0,0,0,2,0,13
China,18/11/2003,40,0,0,0,7,4,0,51
China,19/11/2003,1,0,0,0,33,0,0,34
China,20/11/2003,16,0,0,0,0,0,0,16
China,21/11/2003,6,0,1,0,15,4,0,26
China,22/11/2003,14,0,0,0,6,2,0,22
China,23/11/2003,5,0,0,0,0,3,0,8
China,24/11/2003,26,0,0,0,12,1,0,39
China,25/11/2003,12,0,0,0,3,10,0,25
China,26/11/2003,34,0,0,0,9,0,0,43
China,27/11/2003,8,0,0,0,6,6,0,20
China,28/11/2003,3,0,1,0,3,5,0,12
China,29/11/2003,0,0,0,0,0,1,0,1
China,30/11/2003,7,2,0,0,3,0,0,12
China,01/12/2003,9,0,-2,0,-2,1,0,6
China,02/12/2003,17,0,0,0,4,2,0,23
China,03/12/2003,18,0,0,0,6,5,0,29
China,04/12/2003,11,0,0,0,9,0,0,20
China,05/12/2003,36,0,0,0,-1,1,0,36
China,06/12/2003,5,0,0,0,0,0,0,5
China,07/12/2003,6,0,0,0,3,1,0,10
China,08/12/2003,6,0,-1,0,-5,2,0,2
China,09/12/2003,17,0,-4,0,1,2,0,16
China,10/12/2003,10,4,-1,0,9,1,0,23
China,11/12/2003,2,2,0,0,15,2,0,21
China,12/12/2003,21,0,0,0,24,1,0,46
China,13/12/2003,15,0,0,0,-2,2,0,15
China,14/12/2003,8,0,0,0,0,4,0,12
China,15/12/2003,7,0,0,0,15,1,0,23
China,16/12/2003,8,0,0,0,0,0,0,8
China,17/12/2003,3,0,0,0,30,2,0,35
China,18/12/2003,14,0,0,0,1,0,0,15
China,19/12/2003,17,0,0,0,4,2,0,23
China,20/12/2003,19,0,0,0,0,5,0,24
China,21/12/2003,16,0,-1,0,3,2,0,20
China,22/12/2003,12,0,-2,0,0,0,0,10
China,23/12/2003,17,0,0,0,-10,0,0,7
China,24/12/2003,9,0,0,0,15,0,0,24
China,25/12/2003,15,0,-2,0,4,0,0,17
China,26/12/2003,8,0,0,0,12,0,0,20
China,27/12/2003,7,0,0,0,39,0,0,46
China,28/12/2003,0,0,-3,0,0,0,0,-3
China,29/12/2003,1,0,0,0,2,2,0,5
China,30/12/2003,5,0,0,0,6,1,0,12
China,31/12/2003,14,0,-2,0,5,0,0,17
Egypt,01/01/2003,7,0,0,0,3,0,0,10
Egypt,02/01/2003,3,0,0,0,4,4,0,11
Egypt,03/01/2003,4,0,0,0,-4,0,0,0
Egypt,04/01/2003,23,0,0,0,0,1,0,24
Egypt,05/01/2003,16,0,0,0,3,2,0,21
Egypt,06/01/2003,34,0,0,0,3,0,0,37
Egypt,07/01/2003,7,0,0,0,0,0,0,7
Egypt,08/01/2003,-1,0,0,0,0,0,0,-1
Egypt,09/01/2003,3,0,0,0,6,0,0,9
Egypt,10/01/2003,6,0,0,0,9,0,0,15
Egypt,11/01/2003,11,0,0,0,0,0,0,11
Egypt,12/01/2003,20,0,0,0,1,0,0,21
Egypt,13/01/2003,37,2,0,0,21,4,0,64
Egypt,14/01/2003,4,0,0,0,7,0,0,11
Egypt,15/01/2003,5,0,0,0,3,0,0,8
Egypt,16/01/2003,13,0,0,0,9,4,0,26
Egypt,17/01/2003,14,0,0,0,0,2,0,16
Egypt,18/01/2003,-14,0,0,0,0,2,0,-12
Egypt,19/01/2003,5,0,0,0,1,0,0,6
Egypt,20/01/2003,24,0,1,0,5,3,0,33
Egypt,21/01/2003,15,0,-6,0,21,4,0,34
Egypt,22/01/2003,16,0,0,0,0,5,0,21
Egypt,23/01/2003,18,0,0,0,12,1,0,31
Egypt,24/01/2003,16,0,-2,0,0,2,0,16
Egypt,25/01/2003,12,0,0,0,3,0,0,15
Egypt,26/01/2003,14,0,0,0,0,0,0,14
Egypt,27/01/2003,17,0,1,0,15,4,0,37
Egypt,28/01/2003,37,4,-1,0,12,0,0,52
Egypt,29/01/2003,16,0,0,0,0,2,0,18
Egypt,30/01/2003,1,0,0,0,12,4,0,17
Egypt,31/01/2003,2,0,0,0,15,2,0,19
Egypt,01/02/2003,7,0,0,0,3,3,0,13
Egypt,02/02/2003,6,0,0,0,21,0,0,27
Egypt,03/02/2003,6,0,0,0,6,0,0,12
Egypt,04/02/2003,3,0,0,0,3,0,0,6
Egypt,05/02/2003,7,0,0,0,-2,0,0,5
Egypt,06/02/2003,9,0,0,0,3,3,0,15
Egypt,07/02/2003,0,0,0,0,0,0,0,0
Egypt,08/02/2003,10,2,0,0,0,0,0,12
Egypt,09/02/2003,15,0,0,0,0,0,0,15
Egypt,10/02/2003,2,0,0,0,0,0,0,2
Egypt,11/02/2003,-4,0,0,0,12,0,0,8
Egypt,12/02/2003,0,0,0,0,3,0,0,3
Egypt,13/02/2003,7,0,-2,0,6,3,0,14
Egypt,14/02/2003,21,0,0,0,0,0,0,21
Egypt,15/02/2003,2,0,0,0,0,0,0,2
Egypt,16/02/2003,0,0,0,0,0,0,0,0
Egypt,17/02/2003,2,0,0,0,6,2,0,10
Egypt,18/02/2003,16,0,0,0,18,0,0,34
Egypt,19/02/2003,23,0,0,0,-8,0,0,15
Egypt,20/02/2003,0,0,0,0,3,0,0,3
Egypt,21/02/2003,15,0,0,0,9,3,0,27
Egypt,22/02/2003,8,0,0,0,0,1,0,9
Egypt,23/02/2003,13,0,0,0,3,1,0,17
Egypt,24/02/2003,20,0,0,0,0,0,0,20
Egypt,25/02/2003,10,0,0,0,0,0,0,10
Egypt,26/02/2003,8,0,0,0,0,1,0,9
Egypt,27/02/2003,1,0,0,0,0,0,0,1
Egypt,28/02/2003,5,0,0,0,0,2,0,7
Egypt,01/03/2003,18,0,-4,0,3,7,0,24
Egypt,02/03/2003,5,0,-6,0,12,0,0,11
Egypt,03/03/2003,14,0,0,0,3,0,0,17
Egypt,04/03/2003,19,0,0,0,26,0,0,45
Egypt,05/03/2003,1,0,0,0,0,0,0,1
Egypt,06/03/2003,9,0,-2,0,15,0,0,22
Egypt,07/03/2003,3,0,0,0,0,4,0,7
Egypt,08/03/2003,5,4,0,0,0,0,0,9
Egypt,09/03/2003,7,0,0,0,0,4,0,11
Egypt,10/03/2003,1,0,0,0,3,0,0,4
Egypt,11/03/2003,0,6,0,0,-4,0,0,2
Egypt,12/03/2003,5,0,0,0,0,0,0,5
Egypt,13/03/2003,25,0,-2,0,9,2,0,34
Egypt,14/03/2003,12,0,0,0,3,1,0,16
Egypt,15/03/2003,6,0,0,0,0,1,0,7
Egypt,16/03/2003,17,0,0,0,0,3,0,20
Egypt,17/03/2003,3,0,0,0,0,0,0,3
Egypt,18/03/2003,15,0,0,0,4,0,0,19
Egypt,19/03/2003,5,0,0,0,6,0,0,11
Egypt,20/03/2003,0,0,0,0,3,2,0,5
Egypt,21/03/2003,2,0,0,0,-12,0,0,-10
Egypt,22/03/2003,0,0,0,0,0,1,0,1
Egypt,23/03/2003,7,0,0,0,0,2,0,9
Egypt,24/03/2003,18,0,0,0,3,0,0,21
Egypt,25/03/2003,0,0,0,0,0,2,0,2
Egypt,26/03/2003,0,0,0,0,0,0,0,0
Egypt,27/03/2003,6,0,0,0,1,1,0,8
Egypt,28/03/2003,3,0,0,0,0,0,0,3
Egypt,29/03/2003,1,0,0,0,0,4,0,5
Egypt,30/03/2003,0,0,2,0,0,4,0,6
Egypt,31/03/2003,1,0,0,0,0,0,0,1
Egypt,01/04/2003,0,0,0,0,9,2,0,11
Egypt,02/04/2003,4,0,0,0,6,0,0,10
Egypt,03/04/2003,27,0,0,0,4,7,0,38
Egypt,04/04/2003,-2,0,0,0,0,1,0,-1
Egypt,05/04/2003,4,0,0,0,9,0,0,13
Egypt,06/04/2003,17,0,0,0,6,0,0,23
Egypt,07/04/2003,32,0,0,0,0,0,0,32
Egypt,08/04/2003,4,0,0,0,3,0,0,7
Egypt,09/04/2003,10,0,0,0,3,2,0,15
Egypt,10/04/2003,2,0,0,0,0,6,0,8
Egypt,11/04/2003,3,0,0,0,5,2,0,10
Egypt,12/04/2003,6,0,0,0,6,1,0,13
Egypt,13/04/2003,3,0,0,0,0,0,0,3
Egypt,14/04/2003,3,0,0,0,0,0,0,3
Egypt,15/04/2003,3,0,0,0,-5,0,0,-2
Egypt,16/04/2003,2,0,1,0,15,1,0,19
Egypt,17/04/2003,2,0,0,0,-2,0,0,0
Egypt,18/04/2003,8,0,0,0,0,0,0,8
Egypt,19/04/2003,22,0,0,0,0,0,0,22
Egypt,20/04/2003,23,0,0,0,4,3,0,30
Egypt,21/04/2003,26,0,0,0,3,0,0,29
Egypt,22/04/2003,-3,0,0,0,0,0,0,-3
Egypt,23/04/2003,-5,0,0,0,0,0,0,-5
Egypt,24/04/2003,8,0,0,0,9,2,0,19
Egypt,25/04/2003,-10,0,-2,0,9,1,0,-2
Egypt,26/04/2003,2,0,0,0,9,0,0,11
Egypt,27/04/2003,0,0,0,0,25,0,0,25
Egypt,28/04/2003,1,0,0,0,0,0,0,1
Egypt,29/04/2003,-1,0,0,0,-2,3,0,0
Egypt,30/04/2003,0,0,0,0,0,0,0,0
Egypt,01/05/2003,21,0,0,0,7,1,0,29
Egypt,02/05/2003,2,0,0,0,1,0,0,3
Egypt,03/05/2003,6,0,0,0,3,0,0,9
Egypt,04/05/2003,12,0,0,0,18,3,0,33
Egypt,05/05/2003,-1,0,0,0,6,0,0,5
Egypt,06/05/2003,9,0,0,0,0,0,0,9
Egypt,07/05/2003,3,0,0,0,1,0,0,4
Egypt,08/05/2003,14,0,-4,0,0,0,0,10
Egypt,09/05/2003,0,0,-2,0,3,0,0,1
Egypt,10/05/2003,9,0,0,0,7,6,0,22
Egypt,11/05/2003,0,0,0,0,6,0,0,6
Egypt,12/05/2003,8,0,0,0,3,0,0,11
Egypt,13/05/2003,15,0,0,0,3,5,0,23
Egypt,14/05/2003,-6,0,0,0,0,0,0,-6
Egypt,15/05/2003,14,0,0,0,0,0,0,14
Egypt,16/05/2003,1,0,-2,0,0,2,0,1
Egypt,17/05/2003,7,0,0,0,6,0,0,13
Egypt,18/05/2003,9,0,0,0,3,0,0,12
Egypt,19/05/2003,6,0,0,0,3,5,0,14
Egypt,20/05/2003,0,0,0,0,0,0,0,0
Egypt,21/05/2003,8,0,0,0,6,3,0,17
Egypt,22/05/2003,2,0,0,0,0,2,0,4
Egypt,23/05/2003,5,0,0,0,0,3,0,8
Egypt,24/05/2003,5,0,0,0,1,0,0,6
Egypt,25/05/2003,14,0,0,0,6,6,0,26
Egypt,26/05/2003,8,0,0,0,6,0,0,14
Egypt,27/05/2003,20,0,0,0,3,3,0,26
Egypt,28/05/2003,16,0,0,0,21,0,0,37
Egypt,29/05/2003,10,0,1,0,16,1,0,28
Egypt,30/05/2003,0,2,0,0,7,0,0,9
Egypt,31/05/2003,8,0,0,0,7,0,0,15
Egypt,01/06/2003,11,0,0,0,0,1,0,12
Egypt,02/06/2003,2,0,0,0,0,0,0,2
Egypt,03/06/2003,18,0,0,0,-2,3,0,19
Egypt,04/06/2003,10,0,0,0,6,0,0,16
Egypt,05/06/2003,0,0,0,0,0,0,0,0
Egypt,06/06/2003,6,0,0,0,4,0,0,10
Egypt,07/06/2003,6,0,0,0,0,1,0,7
Egypt,08/06/2003,6,0,0,0,0,0,0,6
Egypt,09/06/2003,17,0,0,0,3,1,0,21
Egypt,10/06/2003,6,0,0,0,0,2,0,8
Egypt,11/06/2003,20,0,0,0,0,6,0,26
Egypt,12/06/2003,15,0,0,0,3,0,0,18
Egypt,13/06/2003,6,0,0,0,12,0,0,18
Egypt,14/06/2003,-4,0,-2,0,-6,0,0,-12
Egypt,15/06/2003,18,0,0,0,24,4,0,46
Egypt,16/06/2003,15,0,0,0,12,2,0,29
Egypt,17/06/2003,9,0,0,0,14,1,0,24
Egypt,18/06/2003,7,0,-1,0,5,0,0,11
Egypt,19/06/2003,6,0,0,0,2,2,0,10
Egypt,20/06/2003,0,0,0,0,6,9,0,15
Egypt,21/06/2003,15,0,0,0,6,0,0,21
Egypt,22/06/2003,10,0,0,0,12,1,0,23
Egypt,23/06/2003,2,0,0,0,3,0,0,5
Egypt,24/06/2003,0,0,0,0,-1,0,0,-1
Egypt,25/06/2003,7,0,0,0,9,0,0,16
Egypt,26/06/2003,-2,0,0,0,0,0,0,-2
Egypt,27/06/2003,0,0,0,0,0,0,0,0
Egypt,28/06/2003,4,0,0,0,10,0,0,14
Egypt,29/06/2003,10,0,0,0,0,0,0,10
Egypt,30/06/2003,4,0,0,0,-1,0,0,3
Egypt,01/07/2003,5,0,0,0,0,0,0,5
Egypt,02/07/2003,10,0,0,0,1,0,0,11
Egypt,03/07/2003,1,0,0,0,0,0,0,1
Egypt,04/07/2003,5,0,0,0,0,0,0,5
Egypt,05/07/2003,16,0,0,0,0,0,0,16
Egypt,06/07/2003,0,0,0,0,9,0,0,9
Egypt,07/07/2003,6,0,0,0,0,0,0,6
Egypt,08/07/2003,14,0,0,0,0,0,0,14
Egypt,09/07/2003,3,0,0,0,3,2,0,8
Egypt,10/07/2003,15,0,-4,0,-8,5,0,8
Egypt,11/07/2003,6,0,0,0,0,0,0,6
Egypt,12/07/2003,8,0,0,0,0,0,0,8
Egypt,13/07/2003,7,0,0,0,0,0,0,7
Egypt,14/07/2003,2,0,0,0,0,0,0,2
Egypt,15/07/2003,-3,0,0,0,3,0,0,0
Egypt,16/07/2003,3,0,0,0,1,2,0,6
Egypt,17/07/2003,2,0,0,0,3,0,0,5
Egypt,18/07/2003,18,0,1,0,6,0,0,25
Egypt,19/07/2003,-1,0,0,0,-5,0,0,-6
Egypt,20/07/2003,3,0,1,0,0,0,0,4
Egypt,21/07/2003,9,0,0,0,0,0,0,9
Egypt,22/07/2003,1,0,0,0,0,2,0,3
Egypt,23/07/2003,0,0,0,0,0,0,0,0
Egypt,24/07/2003,9,0,0,0,0,0,0,9
Egypt,25/07/2003,12,0,0,0,0,1,0,13
Egypt,26/07/2003,11,0,0,0,-2,0,0,9
Egypt,27/07/2003,2,0,0,0,0,0,0,2
Egypt,28/07/2003,1,0,0,0,6,0,0,7
Egypt,29/07/2003,4,0,0,0,0,0,0,4
Egypt,30/07/2003,7,0,0,0,0,0,0,7
Egypt,31/07/2003,0,0,0,0,9,0,0,9
Egypt,01/08/2003,5,0,0,0,20,0,0,25
Egypt,02/08/2003,5,0,0,0,2,0,0,7
Egypt,03/08/2003,2,0,0,0,4,5,0,11
Egypt,04/08/2003,1,0,0,0,0,0,0,1
Egypt,05/08/2003,13,0,0,0,6,0,0,19
Egypt,06/08/2003,29,0,0,0,1,1,0,31
Egypt,07/08/2003,17,0,0,0,9,1,0,27
Egypt,08/08/2003,7,0,0,0,0,0,0,7
Egypt,09/08/2003,6,0,0,0,9,0,0,15
Egypt,10/08/2003,5,0,0,0,0,0,0,5
Egypt,11/08/2003,4,0,0,0,0,0,0,4
Egypt,12/08/2003,5,0,0,0,0,0,0,5
Egypt,13/08/2003,6,0,0,0,4,2,0,12
Egypt,14/08/2003,5,0,0,0,5,0,0,10
Egypt,15/08/2003,0,0,0,0,1,0,0,1
Egypt,16/08/2003,2,0,0,0,3,2,0,7
Egypt,17/08/2003,0,0,0,0,-4,0,0,-4
Egypt,18/08/2003,3,0,0,0,0,0,0,3
Egypt,19/08/2003,2,0,0,0,0,0,0,2
Egypt,20/08/2003,0,0,0,0,3,0,0,3
Egypt,21/08/2003,14,0,0,0,-2,1,0,13
Egypt,22/08/2003,15,2,1,0,1,0,0,19
Egypt,23/08/2003,6,0,0,0,3,0,0,9
Egypt,24/08/2003,39,0,0,0,0,1,0,40
Egypt,25/08/2003,5,0,0,0,0,0,0,5
Egypt,26/08/2003,9,0,0,0,3,3,0,15
Egypt,27/08/2003,11,0,0,0,9,0,0,20
Egypt,28/08/2003,14,0,0,0,0,0,0,14
Egypt,29/08/2003,3,0,0,0,6,0,0,9
Egypt,30/08/2003,0,0,0,0,4,3,0,7
Egypt,31/08/2003,7,0,0,0,0,0,0,7
Egypt,01/09/2003,0,0,0,0,9,3,0,12
Egypt,02/09/2003,2,0,-2,0,0,2,0,2
Egypt,03/09/2003,6,0,0,0,3,2,0,11
Egypt,04/09/2003,14,0,0,0,4,0,0,18
Egypt,05/09/2003,15,0,0,0,3,1,0,19
Egypt,06/09/2003,5,0,0,0,0,0,0,5
Egypt,07/09/2003,2,0,0,0,4,0,0,6
Egypt,08/09/2003,2,0,0,0,9,0,0,11
Egypt,09/09/2003,12,0,0,0,9,0,0,21
Egypt,10/09/2003,3,0,0,0,18,3,0,24
Egypt,11/09/2003,21,2,0,0,-2,4,0,25
Egypt,12/09/2003,3,0,0,0,0,0,0,3
Egypt,13/09/2003,6,0,0,0,3,0,0,9
Egypt,14/09/2003,2,0,0,0,6,0,0,8
Egypt,15/09/2003,4,0,0,0,0,2,0,6
Egypt,16/09/2003,12,0,0,0,0,0,0,12
Egypt,17/09/2003,10,0,0,0,21,2,0,33
Egypt,18/09/2003,5,0,0,0,0,0,0,5
Egypt,19/09/2003,3,0,0,0,21,0,0,24
Egypt,20/09/2003,2,0,0,0,0,0,0,2
Egypt,21/09/2003,0,0,0,0,0,0,0,0
Egypt,22/09/2003,4,0,0,0,0,0,0,4
Egypt,23/09/2003,0,0,0,0,3,0,0,3
Egypt,24/09/2003,15,0,0,0,18,0,0,33
Egypt,25/09/2003,0,0,0,0,-4,0,0,-4
Egypt,26/09/2003,-5,0,0,0,0,0,0,-5
Egypt,27/09/2003,4,0,0,0,-4,0,0,0
Egypt,28/09/2003,3,0,1,0,-2,0,0,2
Egypt,29/09/2003,11,4,0,0,6,0,0,21
Egypt,30/09/2003,4,0,0,0,0,0,0,4
Egypt,01/10/2003,25,0,-5,0,12,1,0,33
Egypt,02/10/2003,4,0,0,0,11,0,0,15
Egypt,03/10/2003,10,0,-2,0,0,0,0,8
Egypt,04/10/2003,0,0,0,0,4,1,0,5
Egypt,05/10/2003,9,0,0,0,0,0,0,9
Egypt,06/10/2003,0,0,0,0,0,0,0,0
Egypt,07/10/2003,18,0,0,0,-2,0,0,16
Egypt,08/10/2003,7,0,0,0,0,3,0,10
Egypt,09/10/2003,11,0,0,0,12,1,0,24
Egypt,10/10/2003,13,0,0,0,10,0,0,23
Egypt,11/10/2003,21,0,0,0,0,0,0,21
Egypt,12/10/2003,1,0,0,0,5,1,0,7
Egypt,13/10/2003,8,0,0,0,-2,2,0,8
Egypt,14/10/2003,6,0,1,0,0,0,0,7
Egypt,15/10/2003,21,0,0,0,0,0,0,21
Egypt,16/10/2003,20,0,0,0,4,0,0,24
Egypt,17/10/2003,34,0,0,0,9,0,0,43
Egypt,18/10/2003,10,0,0,0,6,5,0,21
Egypt,19/10/2003,4,0,0,0,0,4,0,8
Egypt,20/10/2003,2,0,0,0,0,0,0,2
Egypt,21/10/2003,8,0,0,0,7,3,0,18
Egypt,22/10/2003,22,0,0,0,3,0,0,25
Egypt,23/10/2003,0,0,0,0,-4,0,0,-4
Egypt,24/10/2003,6,0,0,0,3,0,0,9
Egypt,25/10/2003,-1,0,0,0,9,0,0,8
Egypt,26/10/2003,3,0,0,0,3,0,0,6
Egypt,27/10/2003,2,0,0,0,-2,1,0,1
Egypt,28/10/2003,6,0,0,0,-2,0,0,4
Egypt,29/10/2003,29,0,0,0,3,1,0,33
Egypt,30/10/2003,5,0,0,0,0,0,0,5
Egypt,31/10/2003,0,0,0,0,3,0,0,3
Egypt,01/11/2003,18,0,0,0,3,0,0,21
Egypt,02/11/2003,9,0,0,0,6,0,0,15
Egypt,03/11/2003,22,0,0,0,9,2,0,33
Egypt,04/11/2003,0,0,0,0,0,2,0,2
Egypt,05/11/2003,0,0,0,0,0,0,0,0
Egypt,06/11/2003,8,0,0,0,6,0,0,14
Egypt,07/11/2003,3,0,0,0,9,0,0,12
Egypt,08/11/2003,1,0,0,0,3,0,0,4
Egypt,09/11/2003,12,12,2,0,15,0,0,41
Egypt,10/11/2003,10,0,0,0,3,2,0,15
Egypt,11/11/2003,10,0,0,0,-4,2,0,8
Egypt,12/11/2003,6,0,0,0,9,0,0,15
Egypt,13/11/2003,14,0,2,0,6,1,0,23
Egypt,14/11/2003,1,0,0,0,3,0,0,4
Egypt,15/11/2003,7,0,0,0,-5,4,0,6
Egypt,16/11/2003,3,0,0,0,18,0,0,21
Egypt,17/11/2003,2,0,0,0,0,0,0,2
Egypt,18/11/2003,9,0,0,0,3,2,0,14
Egypt,19/11/2003,4,0,0,0,0,0,0,4
Egypt,20/11/2003,15,0,0,0,9,0,0,24
Egypt,21/11/2003,27,0,0,0,0,3,0,30
Egypt,22/11/2003,3,0,0,0,0,1,0,4
Egypt,23/11/2003,-1,0,0,0,-2,0,0,-3
Egypt,24/11/2003,3,0,0,0,3,1,0,7
Egypt,25/11/2003,0,0,0,0,0,0,0,0
Egypt,26/11/2003,8,0,0,0,0,0,0,8
Egypt,27/11/2003,0,0,1,0,0,0,0,1
Egypt,28/11/2003,2,0,0,0,0,0,0,2
Egypt,29/11/2003,12,0,-2,0,15,0,0,25
Egypt,30/11/2003,2,0,0,0,10,1,0,13
Egypt,01/12/2003,0,2,0,0,5,0,0,7
Egypt,02/12/2003,3,0,0,0,0,1,0,4
Egypt,03/12/2003,10,0,0,0,3,1,0,14
Egypt,04/12/2003,23,0,0,0,0,2,0,25
Egypt,05/12/2003,-1,0,0,0,0,0,0,-1
Egypt,06/12/2003,5,0,0,0,0,0,0,5
Egypt,07/12/2003,0,0,0,0,0,0,0,0
Egypt,08/12/2003,6,4,0,0,3,0,0,13
Egypt,09/12/2003,7,0,0,0,0,0,0,7
Egypt,10/12/2003,5,0,0,0,3,4,0,12
Egypt,11/12/2003,9,0,0,0,0,3,0,12
Egypt,12/12/2003,16,0,0,0,-6,5,0,15
Egypt,13/12/2003,-1,0,0,0,0,3,0,2
Egypt,14/12/2003,2,0,0,0,3,0,0,5
Egypt,15/12/2003,15,0,0,0,-2,0,0,13
Egypt,16/12/2003,4,0,0,0,16,2,0,22
Egypt,17/12/2003,7,0,-1,0,3,0,0,9
Egypt,18/12/2003,7,0,0,0,12,0,0,19
Egypt,19/12/2003,3,0,0,0,0,2,0,5
Egypt,20/12/2003,-3,0,0,0,-2,0,0,-5
Egypt,21/12/2003,-1,0,0,0,0,0,0,-1
Egypt,22/12/2003,58,0,0,0,3,14,0,75
Egypt,23/12/2003,22,0,0,0,12,2,0,36
Egypt,24/12/2003,13,0,0,0,0,3,0,16
Egypt,25/12/2003,18,0,1,0,12,5,0,36
Egypt,26/12/2003,13,0,0,0,-4,6,0,15
Egypt,27/12/2003,1,0,0,0,2,0,0,3
Egypt,28/12/2003,0,0,0,0,3,4,0,7
Egypt,29/12/2003,13,0,0,0,-9,1,0,5
Egypt,30/12/2003,6,0,0,0,-1,0,0,5
Egypt,31/12/2003,21,0,0,0,8,5,0,34
Eritrea,01/01/2003,1,0,0,0,0,0,0,1
Eritrea,03/01/2003,6,0,0,0,0,0,0,6
Eritrea,06/01/2003,0,0,0,0,0,0,0,0
Eritrea,07/01/2003,0,0,0,0,0,0,0,0
Eritrea,08/01/2003,1,0,1,0,0,0,0,2
Eritrea,09/01/2003,0,0,0,0,0,0,0,0
Eritrea,10/01/2003,3,0,0,0,0,0,0,3
Eritrea,11/01/2003,8,0,0,0,0,0,0,8
Eritrea,12/01/2003,11,0,0,0,0,0,0,11
Eritrea,13/01/2003,0,0,0,0,0,0,0,0
Eritrea,14/01/2003,2,0,0,0,0,0,0,2
Eritrea,15/01/2003,0,0,0,0,0,0,0,0
Eritrea,16/01/2003,1,0,0,0,0,0,0,1
Eritrea,17/01/2003,3,0,0,0,0,0,0,3
Eritrea,20/01/2003,0,0,0,0,0,0,0,0
Eritrea,23/01/2003,0,0,0,0,0,0,0,0
Eritrea,24/01/2003,0,0,0,0,0,0,0,0
Eritrea,25/01/2003,0,0,0,0,0,0,0,0
Eritrea,28/01/2003,-3,0,0,0,0,0,0,-3
Eritrea,29/01/2003,2,2,0,0,0,0,0,4
Eritrea,30/01/2003,6,0,0,0,0,0,0,6
Eritrea,31/01/2003,0,0,0,0,0,0,0,0
Eritrea,02/02/2003,0,0,0,0,0,0,0,0
Eritrea,03/02/2003,0,0,0,0,0,0,0,0
Eritrea,04/02/2003,0,0,0,0,0,0,0,0
Eritrea,05/02/2003,0,0,0,0,3,1,0,4
Eritrea,06/02/2003,2,0,0,0,0,0,0,2
Eritrea,07/02/2003,0,0,0,0,0,0,0,0
Eritrea,08/02/2003,0,0,0,0,0,0,0,0
Eritrea,09/02/2003,0,0,0,0,0,0,0,0
Eritrea,10/02/2003,0,0,0,0,0,0,0,0
Eritrea,11/02/2003,3,0,0,0,0,0,0,3
Eritrea,12/02/2003,3,0,0,0,0,0,0,3
Eritrea,13/02/2003,3,0,0,0,0,0,0,3
Eritrea,14/02/2003,2,0,0,0,0,1,0,3
Eritrea,16/02/2003,0,0,0,0,3,0,0,3
Eritrea,17/02/2003,2,0,0,0,0,0,0,2
Eritrea,19/02/2003,0,0,0,0,0,0,0,0
Eritrea,20/02/2003,0,0,0,0,-2,0,0,-2
Eritrea,21/02/2003,10,0,0,0,0,0,0,10
Eritrea,22/02/2003,1,0,0,0,0,2,0,3
Eritrea,24/02/2003,0,0,0,0,0,0,0,0
Eritrea,25/02/2003,0,0,0,0,0,0,0,0
Eritrea,27/02/2003,1,0,0,0,0,0,0,1
Eritrea,28/02/2003,2,0,0,0,0,0,0,2
Eritrea,01/03/2003,0,0,0,0,0,0,0,0
Eritrea,03/03/2003,0,0,0,0,0,0,0,0
Eritrea,04/03/2003,0,0,0,0,0,0,0,0
Eritrea,05/03/2003,0,0,0,0,0,0,0,0
Eritrea,06/03/2003,3,0,0,0,0,0,0,3
Eritrea,07/03/2003,0,0,0,0,0,0,0,0
Eritrea,08/03/2003,0,0,0,0,0,0,0,0
Eritrea,10/03/2003,0,0,0,0,0,0,0,0
Eritrea,11/03/2003,0,0,0,0,0,0,0,0
Eritrea,13/03/2003,0,0,0,0,0,0,0,0
Eritrea,14/03/2003,0,0,0,0,0,0,0,0
Eritrea,16/03/2003,4,0,0,0,0,0,0,4
Eritrea,17/03/2003,0,0,0,0,0,0,0,0
Eritrea,18/03/2003,0,0,0,0,0,0,0,0
Eritrea,19/03/2003,0,0,0,0,0,0,0,0
Eritrea,20/03/2003,0,0,0,0,0,0,0,0
Eritrea,21/03/2003,-1,0,0,0,0,0,0,-1
Eritrea,22/03/2003,0,0,0,0,0,1,0,1
Eritrea,23/03/2003,0,0,0,0,0,0,0,0
Eritrea,24/03/2003,10,0,0,0,0,0,0,10
Eritrea,25/03/2003,0,0,0,0,0,0,0,0
Eritrea,26/03/2003,0,0,-2,0,0,0,0,-2
Eritrea,27/03/2003,2,0,0,0,0,1,0,3
Eritrea,28/03/2003,0,0,0,0,0,0,0,0
Eritrea,29/03/2003,0,0,0,0,0,0,0,0
Eritrea,31/03/2003,4,0,0,0,-1,0,0,3
Eritrea,01/04/2003,-7,0,0,0,3,1,0,-3
Eritrea,02/04/2003,4,0,0,0,0,0,0,4
Eritrea,04/04/2003,2,0,0,0,3,0,0,5
Eritrea,05/04/2003,2,0,0,0,0,0,0,2
Eritrea,09/04/2003,-4,0,0,0,0,0,0,-4
Eritrea,10/04/2003,2,0,0,0,0,0,0,2
Eritrea,11/04/2003,0,0,0,0,3,0,0,3
Eritrea,12/04/2003,36,0,0,0,0,0,0,36
Eritrea,13/04/2003,0,0,0,0,0,0,0,0
Eritrea,14/04/2003,2,0,0,0,0,0,0,2
Eritrea,15/04/2003,0,0,0,0,0,0,0,0
Eritrea,16/04/2003,0,0,0,0,-10,0,0,-10
Eritrea,17/04/2003,6,0,0,0,0,0,0,6
Eritrea,18/04/2003,7,0,0,0,6,0,0,13
Eritrea,19/04/2003,0,0,0,0,0,0,0,0
Eritrea,21/04/2003,0,0,0,0,0,0,0,0
Eritrea,22/04/2003,3,0,0,0,0,0,0,3
Eritrea,23/04/2003,10,0,0,0,0,0,0,10
Eritrea,24/04/2003,0,0,0,0,0,0,0,0
Eritrea,25/04/2003,0,0,0,0,0,0,0,0
Eritrea,26/04/2003,0,0,0,0,0,0,0,0
Eritrea,27/04/2003,8,0,0,0,3,0,0,11
Eritrea,29/04/2003,0,0,0,0,0,0,0,0
Eritrea,30/04/2003,1,0,0,0,3,0,0,4
Eritrea,01/05/2003,5,0,0,0,2,0,0,7
Eritrea,02/05/2003,10,0,0,0,0,0,0,10
Eritrea,03/05/2003,13,0,0,0,0,0,0,13
Eritrea,04/05/2003,0,0,0,0,3,0,0,3
Eritrea,06/05/2003,0,0,0,0,0,0,0,0
Eritrea,07/05/2003,4,0,0,0,0,0,0,4
Eritrea,08/05/2003,0,0,0,0,0,0,0,0
Eritrea,09/05/2003,0,0,0,0,3,3,0,6
Eritrea,12/05/2003,0,0,0,0,0,0,0,0
Eritrea,14/05/2003,4,0,-1,0,0,0,0,3
Eritrea,15/05/2003,0,0,0,0,0,0,0,0
Eritrea,16/05/2003,0,0,0,0,0,0,0,0
Eritrea,19/05/2003,0,0,0,0,6,0,0,6
Eritrea,20/05/2003,0,0,0,0,0,0,0,0
Eritrea,21/05/2003,2,0,0,0,0,0,0,2
Eritrea,22/05/2003,2,0,0,0,0,0,0,2
Eritrea,23/05/2003,0,0,0,0,0,0,0,0
Eritrea,24/05/2003,0,0,0,0,0,0,0,0
Eritrea,25/05/2003,0,0,0,0,0,0,0,0
Eritrea,26/05/2003,3,0,0,0,0,0,0,3
Eritrea,27/05/2003,0,0,0,0,0,0,0,0
Eritrea,28/05/2003,0,0,0,0,0,0,0,0
Eritrea,29/05/2003,6,0,0,0,0,0,0,6
Eritrea,30/05/2003,3,0,0,0,0,0,0,3
Eritrea,31/05/2003,3,0,0,0,0,0,0,3
Eritrea,01/06/2003,0,0,0,0,0,0,0,0
Eritrea,02/06/2003,0,0,0,0,0,1,0,1
Eritrea,03/06/2003,2,0,0,0,0,0,0,2
Eritrea,04/06/2003,0,0,0,0,0,0,0,0
Eritrea,06/06/2003,0,2,0,0,9,0,0,11
Eritrea,09/06/2003,0,4,0,0,0,0,0,4
Eritrea,10/06/2003,0,0,0,0,0,0,0,0
Eritrea,11/06/2003,3,0,0,0,0,0,0,3
Eritrea,13/06/2003,-3,0,0,0,0,1,0,-2
Eritrea,16/06/2003,2,0,0,0,0,0,0,2
Eritrea,17/06/2003,0,0,0,0,0,0,0,0
Eritrea,18/06/2003,0,0,0,0,0,0,0,0
Eritrea,19/06/2003,1,0,0,0,0,0,0,1
Eritrea,20/06/2003,1,0,0,0,0,0,0,1
Eritrea,21/06/2003,0,0,0,0,0,0,0,0
Eritrea,23/06/2003,0,0,0,0,0,0,0,0
Eritrea,24/06/2003,-1,0,0,0,0,0,0,-1
Eritrea,25/06/2003,0,0,0,0,3,0,0,3
Eritrea,26/06/2003,6,0,0,0,3,0,0,9
Eritrea,28/06/2003,0,0,0,0,0,0,0,0
Eritrea,30/06/2003,0,0,0,0,0,0,0,0
Eritrea,01/07/2003,0,0,0,0,0,0,0,0
Eritrea,02/07/2003,3,0,0,0,0,0,0,3
Eritrea,03/07/2003,3,0,0,0,0,0,0,3
Eritrea,05/07/2003,0,0,0,0,0,0,0,0
Eritrea,07/07/2003,0,0,0,0,0,0,0,0
Eritrea,08/07/2003,1,0,0,0,-7,0,0,-6
Eritrea,09/07/2003,0,0,0,0,-2,0,0,-2
Eritrea,10/07/2003,0,0,0,0,9,0,0,9
Eritrea,11/07/2003,0,0,0,0,0,0,0,0
Eritrea,12/07/2003,0,0,0,0,0,0,0,0
Eritrea,14/07/2003,0,0,0,0,0,0,0,0
Eritrea,15/07/2003,0,0,0,0,0,0,0,0
Eritrea,16/07/2003,0,0,0,0,0,0,0,0
Eritrea,17/07/2003,0,0,0,0,3,0,0,3
Eritrea,19/07/2003,0,0,0,0,0,0,0,0
Eritrea,21/07/2003,0,0,0,0,0,0,0,0
Eritrea,23/07/2003,1,0,0,0,0,2,0,3
Eritrea,24/07/2003,0,0,0,0,0,0,0,0
Eritrea,25/07/2003,6,0,0,0,0,0,0,6
Eritrea,28/07/2003,0,0,0,0,0,0,0,0
Eritrea,29/07/2003,-2,0,0,0,0,0,0,-2
Eritrea,30/07/2003,0,0,0,0,0,0,0,0
Eritrea,31/07/2003,0,0,0,0,0,0,0,0
Eritrea,01/08/2003,1,0,0,0,0,0,0,1
Eritrea,02/08/2003,0,0,0,0,0,0,0,0
Eritrea,03/08/2003,0,0,0,0,0,0,0,0
Eritrea,04/08/2003,0,0,0,0,0,0,0,0
Eritrea,05/08/2003,0,0,0,0,0,0,0,0
Eritrea,06/08/2003,0,0,0,0,0,0,0,0
Eritrea,07/08/2003,-5,0,0,0,0,0,0,-5
Eritrea,08/08/2003,0,0,0,0,6,0,0,6
Eritrea,09/08/2003,0,0,0,0,0,1,0,1
Eritrea,10/08/2003,0,0,0,0,0,0,0,0
Eritrea,11/08/2003,6,0,0,0,3,0,0,9
Eritrea,12/08/2003,6,0,0,0,0,0,0,6
Eritrea,14/08/2003,0,0,0,0,0,0,0,0
Eritrea,15/08/2003,5,0,0,0,0,0,0,5
Eritrea,18/08/2003,3,0,0,0,0,0,0,3
Eritrea,19/08/2003,0,0,0,0,0,0,0,0
Eritrea,20/08/2003,0,0,0,0,24,0,0,24
Eritrea,21/08/2003,0,0,0,0,6,0,0,6
Eritrea,22/08/2003,0,0,0,0,0,0,0,0
Eritrea,23/08/2003,0,0,0,0,0,0,0,0
Eritrea,26/08/2003,0,0,0,0,0,0,0,0
Eritrea,27/08/2003,0,0,0,0,0,0,0,0
Eritrea,28/08/2003,9,0,0,0,0,0,0,9
Eritrea,29/08/2003,0,0,0,0,3,0,0,3
Eritrea,30/08/2003,-1,0,0,0,0,0,0,-1
Eritrea,31/08/2003,2,0,0,0,0,0,0,2
Eritrea,01/09/2003,2,0,0,0,0,0,0,2
Eritrea,02/09/2003,0,0,0,0,0,0,0,0
Eritrea,03/09/2003,0,0,0,0,0,0,0,0
Eritrea,04/09/2003,0,0,0,0,0,0,0,0
Eritrea,05/09/2003,3,0,0,0,0,0,0,3
Eritrea,07/09/2003,0,0,0,0,0,0,0,0
Eritrea,09/09/2003,0,0,0,0,0,0,0,0
Eritrea,10/09/2003,5,0,0,0,3,0,0,8
Eritrea,11/09/2003,0,0,0,0,0,1,0,1
Eritrea,12/09/2003,0,0,0,0,0,0,0,0
Eritrea,13/09/2003,0,0,0,0,0,0,0,0
Eritrea,14/09/2003,0,0,0,0,0,0,0,0
Eritrea,15/09/2003,0,0,0,0,0,0,0,0
Eritrea,16/09/2003,1,0,0,0,0,0,0,1
Eritrea,17/09/2003,3,0,0,0,0,0,0,3
Eritrea,18/09/2003,0,0,0,0,7,0,0,7
Eritrea,19/09/2003,0,0,0,0,0,0,0,0
Eritrea,21/09/2003,0,0,0,0,0,0,0,0
Eritrea,22/09/2003,0,0,0,0,0,0,0,0
Eritrea,23/09/2003,0,0,0,0,0,0,0,0
Eritrea,24/09/2003,0,0,0,0,0,0,0,0
Eritrea,25/09/2003,3,0,2,0,0,0,0,5
Eritrea,26/09/2003,0,0,2,0,0,0,0,2
Eritrea,27/09/2003,0,0,0,0,0,0,0,0
Eritrea,28/09/2003,0,0,0,0,0,0,0,0
Eritrea,29/09/2003,8,0,0,0,3,4,0,15
Eritrea,30/09/2003,2,0,0,0,6,0,0,8
Eritrea,01/10/2003,6,0,0,0,0,0,0,6
Eritrea,02/10/2003,7,0,0,0,3,0,0,10
Eritrea,03/10/2003,0,0,0,0,0,0,0,0
Eritrea,06/10/2003,0,0,0,0,0,0,0,0
Eritrea,07/10/2003,3,0,0,0,0,0,0,3
Eritrea,08/10/2003,0,0,0,0,0,0,0,0
Eritrea,09/10/2003,1,0,0,0,0,0,0,1
Eritrea,10/10/2003,5,0,0,0,0,0,0,5
Eritrea,11/10/2003,0,0,0,0,0,0,0,0
Eritrea,12/10/2003,0,0,0,0,0,0,0,0
Eritrea,13/10/2003,3,0,0,0,0,0,0,3
Eritrea,14/10/2003,0,0,0,0,-4,0,0,-4
Eritrea,15/10/2003,2,0,0,0,-8,0,0,-6
Eritrea,16/10/2003,2,0,0,0,0,0,0,2
Eritrea,17/10/2003,2,0,0,0,0,0,0,2
Eritrea,18/10/2003,2,0,0,0,0,0,0,2
Eritrea,19/10/2003,5,0,0,0,0,0,0,5
Eritrea,20/10/2003,2,0,0,0,0,0,0,2
Eritrea,21/10/2003,0,0,0,0,6,0,0,6
Eritrea,22/10/2003,10,0,0,0,0,0,0,10
Eritrea,23/10/2003,5,0,0,0,-2,0,0,3
Eritrea,24/10/2003,4,0,0,0,0,0,0,4
Eritrea,25/10/2003,0,0,0,0,6,0,0,6
Eritrea,26/10/2003,0,0,0,0,0,0,0,0
Eritrea,27/10/2003,0,0,0,0,0,0,0,0
Eritrea,28/10/2003,1,0,0,0,3,0,0,4
Eritrea,29/10/2003,0,0,0,0,0,0,0,0
Eritrea,30/10/2003,0,0,0,0,3,0,0,3
Eritrea,31/10/2003,0,0,0,0,0,0,0,0
Eritrea,01/11/2003,0,0,0,0,0,0,0,0
Eritrea,02/11/2003,0,0,0,0,0,0,0,0
Eritrea,03/11/2003,3,0,0,0,0,0,0,3
Eritrea,04/11/2003,6,0,0,0,-2,4,0,8
Eritrea,05/11/2003,0,0,0,0,0,0,0,0
Eritrea,06/11/2003,5,0,0,0,0,0,0,5
Eritrea,07/11/2003,3,0,0,0,6,0,0,9
Eritrea,08/11/2003,0,0,0,0,0,0,0,0
Eritrea,09/11/2003,0,0,0,0,0,0,0,0
Eritrea,10/11/2003,3,0,0,0,0,0,0,3
Eritrea,11/11/2003,12,0,0,0,-6,0,0,6
Eritrea,12/11/2003,0,0,0,0,0,1,0,1
Eritrea,13/11/2003,10,0,0,0,0,0,0,10
Eritrea,14/11/2003,0,0,0,0,-2,0,0,-2
Eritrea,16/11/2003,2,0,0,0,0,0,0,2
Eritrea,17/11/2003,0,0,0,0,0,0,0,0
Eritrea,18/11/2003,0,0,0,0,0,0,0,0
Eritrea,19/11/2003,0,0,0,0,0,0,0,0
Eritrea,20/11/2003,5,0,0,0,0,0,0,5
Eritrea,21/11/2003,4,0,0,0,0,0,0,4
Eritrea,23/11/2003,0,0,0,0,0,0,0,0
Eritrea,24/11/2003,2,0,0,0,0,0,0,2
Eritrea,25/11/2003,0,0,0,0,0,1,0,1
Eritrea,26/11/2003,5,0,0,0,0,0,0,5
Eritrea,27/11/2003,0,0,0,0,0,0,0,0
Eritrea,28/11/2003,5,0,0,0,0,0,0,5
Eritrea,29/11/2003,0,0,0,0,0,0,0,0
Eritrea,01/12/2003,0,0,0,0,0,0,0,0
Eritrea,02/12/2003,1,0,0,0,0,0,0,1
Eritrea,03/12/2003,7,0,0,0,0,0,0,7
Eritrea,04/12/2003,0,0,0,0,0,0,0,0
Eritrea,05/12/2003,0,0,0,0,-4,0,0,-4
Eritrea,06/12/2003,0,0,0,0,0,0,0,0
Eritrea,07/12/2003,0,0,0,0,0,0,0,0
Eritrea,09/12/2003,0,0,0,0,0,0,0,0
Eritrea,11/12/2003,0,0,0,0,6,0,0,6
Eritrea,12/12/2003,0,0,0,0,0,0,0,0
Eritrea,13/12/2003,6,0,0,0,0,0,0,6
Eritrea,14/12/2003,0,0,0,0,0,0,0,0
Eritrea,15/12/2003,0,0,0,0,0,0,0,0
Eritrea,16/12/2003,0,0,0,0,0,0,0,0
Eritrea,17/12/2003,2,0,0,0,0,0,0,2
Eritrea,18/12/2003,6,0,0,0,0,0,0,6
Eritrea,19/12/2003,1,0,0,0,0,1,0,2
Eritrea,20/12/2003,6,0,0,0,0,0,0,6
Eritrea,21/12/2003,6,0,0,0,0,0,0,6
Eritrea,22/12/2003,6,0,0,0,0,0,0,6
Eritrea,23/12/2003,3,0,0,0,-1,0,0,2
Eritrea,24/12/2003,6,0,0,0,0,0,0,6
Eritrea,27/12/2003,2,0,0,0,0,0,0,2
Eritrea,28/12/2003,0,0,-2,0,0,0,0,-2
Eritrea,29/12/2003,3,0,0,0,0,0,0,3
Eritrea,30/12/2003,0,0,0,0,0,0,0,0
Eritrea,31/12/2003,2,0,0,0,6,0,0,8
Georgia,01/01/2003,0,0,0,0,0,0,0,0
Georgia,02/01/2003,6,0,0,0,0,0,0,6
Georgia,03/01/2003,5,0,0,0,0,0,0,5
Georgia,04/01/2003,0,0,0,0,0,0,0,0
Georgia,06/01/2003,1,0,0,0,0,0,0,1
Georgia,07/01/2003,0,0,0,0,0,1,0,1
Georgia,08/01/2003,2,0,0,0,0,1,0,3
Georgia,09/01/2003,2,0,-2,0,0,0,0,0
Georgia,10/01/2003,0,0,0,0,-4,0,0,-4
Georgia,11/01/2003,8,0,0,0,0,0,0,8
Georgia,13/01/2003,0,0,0,0,-2,0,0,-2
Georgia,14/01/2003,3,0,0,0,0,0,0,3
Georgia,15/01/2003,1,0,0,0,0,0,0,1
Georgia,16/01/2003,0,0,0,0,0,0,0,0
Georgia,17/01/2003,0,0,0,0,0,0,0,0
Georgia,18/01/2003,0,0,0,0,0,3,0,3
Georgia,19/01/2003,0,0,0,0,0,0,0,0
Georgia,20/01/2003,1,0,0,0,0,0,0,1
Georgia,21/01/2003,2,0,0,0,3,0,0,5
Georgia,22/01/2003,2,0,2,0,0,0,0,4
Georgia,23/01/2003,5,0,0,0,0,0,0,5
Georgia,24/01/2003,2,0,0,0,0,0,0,2
Georgia,25/01/2003,0,0,0,0,3,0,0,3
Georgia,26/01/2003,0,0,0,0,0,0,0,0
Georgia,27/01/2003,6,0,0,0,0,0,0,6
Georgia,28/01/2003,0,0,0,0,0,0,0,0
Georgia,29/01/2003,-2,0,0,0,0,2,0,0
Georgia,30/01/2003,1,0,0,0,1,0,0,2
Georgia,31/01/2003,0,0,0,0,-4,0,0,-4
Georgia,01/02/2003,0,0,0,0,0,0,0,0
Georgia,02/02/2003,4,0,0,0,0,0,0,4
Georgia,03/02/2003,0,0,0,0,-2,0,0,-2
Georgia,04/02/2003,6,0,0,0,3,0,0,9
Georgia,05/02/2003,2,0,0,0,0,0,0,2
Georgia,06/02/2003,0,0,0,0,0,0,0,0
Georgia,07/02/2003,0,0,0,0,0,0,0,0
Georgia,08/02/2003,1,0,0,0,0,0,0,1
Georgia,09/02/2003,0,0,0,0,-2,0,0,-2
Georgia,10/02/2003,3,0,0,0,0,0,0,3
Georgia,11/02/2003,0,0,0,0,0,0,0,0
Georgia,12/02/2003,-1,0,0,0,0,0,0,-1
Georgia,13/02/2003,0,0,0,0,0,0,0,0
Georgia,14/02/2003,1,0,0,0,0,0,0,1
Georgia,17/02/2003,-2,0,0,0,0,0,0,-2
Georgia,20/02/2003,0,0,0,0,0,0,0,0
Georgia,21/02/2003,2,0,1,0,0,1,0,4
Georgia,24/02/2003,5,0,0,0,0,2,0,7
Georgia,25/02/2003,0,0,0,0,0,0,0,0
Georgia,26/02/2003,0,0,0,0,0,0,0,0
Georgia,27/02/2003,0,0,0,0,0,0,0,0
Georgia,28/02/2003,1,0,0,0,0,0,0,1
Georgia,01/03/2003,0,0,0,0,0,0,0,0
Georgia,03/03/2003,0,0,0,0,0,0,0,0
Georgia,04/03/2003,3,0,0,0,0,0,0,3
Georgia,05/03/2003,3,0,0,0,0,0,0,3
Georgia,06/03/2003,2,0,0,0,0,0,0,2
Georgia,07/03/2003,0,0,0,0,0,0,0,0
Georgia,08/03/2003,1,0,0,0,0,-1,0,0
Georgia,10/03/2003,10,0,0,0,0,0,0,10
Georgia,11/03/2003,0,0,0,0,0,0,0,0
Georgia,12/03/2003,0,0,0,0,0,0,0,0
Georgia,13/03/2003,10,0,0,0,0,0,0,10
Georgia,15/03/2003,5,0,0,0,0,0,0,5
Georgia,18/03/2003,0,0,0,0,0,0,0,0
Georgia,19/03/2003,-1,0,0,0,0,0,0,-1
Georgia,20/03/2003,2,0,0,0,0,0,0,2
Georgia,21/03/2003,0,0,0,0,0,1,0,1
Georgia,23/03/2003,0,0,0,0,0,0,0,0
Georgia,24/03/2003,0,0,0,0,0,0,0,0
Georgia,25/03/2003,3,0,0,0,3,0,0,6
Georgia,26/03/2003,0,0,1,0,3,0,0,4
Georgia,27/03/2003,0,0,0,0,0,0,0,0
Georgia,30/03/2003,3,0,0,0,0,0,0,3
Georgia,31/03/2003,2,0,0,0,0,0,0,2
Georgia,01/04/2003,1,0,0,0,3,0,0,4
Georgia,02/04/2003,-2,0,0,0,0,2,0,0
Georgia,03/04/2003,8,0,0,0,0,0,0,8
Georgia,04/04/2003,5,0,0,0,0,0,0,5
Georgia,05/04/2003,5,0,0,0,0,0,0,5
Georgia,07/04/2003,3,0,0,0,3,0,0,6
Georgia,08/04/2003,8,0,-2,0,0,2,0,8
Georgia,09/04/2003,4,0,0,0,0,0,0,4
Georgia,10/04/2003,2,0,1,0,0,1,0,4
Georgia,11/04/2003,1,0,0,0,27,0,0,28
Georgia,12/04/2003,0,0,0,0,0,0,0,0
Georgia,13/04/2003,0,0,0,0,0,0,0,0
Georgia,14/04/2003,0,0,0,0,-2,1,0,-1
Georgia,15/04/2003,5,0,-1,0,0,0,0,4
Georgia,16/04/2003,4,0,0,0,0,0,0,4
Georgia,17/04/2003,4,0,0,0,0,0,0,4
Georgia,18/04/2003,0,0,0,0,0,0,0,0
Georgia,19/04/2003,4,0,0,0,0,0,0,4
Georgia,21/04/2003,1,0,0,0,0,0,0,1
Georgia,22/04/2003,9,0,0,0,0,1,0,10
Georgia,23/04/2003,0,0,0,0,0,0,0,0
Georgia,24/04/2003,2,0,0,0,0,1,0,3
Georgia,25/04/2003,2,0,0,0,0,0,0,2
Georgia,26/04/2003,7,0,0,0,0,0,0,7
Georgia,27/04/2003,0,0,0,0,0,0,0,0
Georgia,28/04/2003,0,0,0,0,0,0,0,0
Georgia,29/04/2003,-2,0,0,0,0,0,0,-2
Georgia,30/04/2003,8,0,0,0,0,0,0,8
Georgia,01/05/2003,8,0,0,0,3,0,0,11
Georgia,02/05/2003,3,0,0,0,0,0,0,3
Georgia,05/05/2003,3,0,0,0,0,0,0,3
Georgia,06/05/2003,3,0,0,0,3,2,0,8
Georgia,07/05/2003,0,0,0,0,0,0,0,0
Georgia,08/05/2003,14,0,0,0,0,0,0,14
Georgia,09/05/2003,3,0,0,0,0,0,0,3
Georgia,10/05/2003,2,0,-2,0,0,0,0,0
Georgia,12/05/2003,2,0,0,0,0,0,0,2
Georgia,13/05/2003,4,0,0,0,3,0,0,7
Georgia,14/05/2003,3,0,0,0,0,0,0,3
Georgia,15/05/2003,3,0,0,0,0,0,0,3
Georgia,16/05/2003,4,0,0,0,0,0,0,4
Georgia,17/05/2003,2,0,2,0,0,0,0,4
Georgia,19/05/2003,3,0,0,0,0,1,0,4
Georgia,20/05/2003,3,0,0,0,0,0,0,3
Georgia,21/05/2003,6,0,-4,0,0,0,0,2
Georgia,22/05/2003,2,0,0,0,0,0,0,2
Georgia,23/05/2003,7,0,0,0,0,0,0,7
Georgia,24/05/2003,0,0,0,0,0,0,0,0
Georgia,26/05/2003,0,0,0,0,3,0,0,3
Georgia,27/05/2003,0,0,0,0,0,0,0,0
Georgia,28/05/2003,6,0,1,0,0,0,0,7
Georgia,29/05/2003,3,0,0,0,0,0,0,3
Georgia,30/05/2003,9,0,0,0,0,1,0,10
Georgia,31/05/2003,0,0,0,0,3,0,0,3
Georgia,02/06/2003,2,0,0,0,0,0,0,2
Georgia,03/06/2003,0,0,0,0,0,0,0,0
Georgia,04/06/2003,2,0,0,0,0,0,0,2
Georgia,05/06/2003,0,0,0,0,5,1,0,6
Georgia,06/06/2003,3,0,0,0,-4,6,0,5
Georgia,07/06/2003,-1,0,0,0,0,0,0,-1
Georgia,08/06/2003,0,0,0,0,0,0,0,0
Georgia,09/06/2003,0,0,1,0,3,0,0,4
Georgia,10/06/2003,0,0,0,0,0,0,0,0
Georgia,11/06/2003,0,0,0,0,0,0,0,0
Georgia,12/06/2003,0,0,0,0,-4,0,0,-4
Georgia,13/06/2003,0,0,0,0,0,0,0,0
Georgia,14/06/2003,1,0,0,0,-2,0,0,-1
Georgia,15/06/2003,0,0,0,0,0,0,0,0
Georgia,16/06/2003,-1,0,0,0,0,0,0,-1
Georgia,17/06/2003,0,0,0,0,3,2,0,5
Georgia,18/06/2003,3,0,0,0,3,0,0,6
Georgia,19/06/2003,0,0,0,0,0,0,0,0
Georgia,20/06/2003,1,0,0,0,0,0,0,1
Georgia,21/06/2003,2,0,0,0,0,0,0,2
Georgia,23/06/2003,0,0,0,0,0,0,0,0
Georgia,24/06/2003,-3,0,0,0,0,0,0,-3
Georgia,25/06/2003,-2,0,0,0,9,0,0,7
Georgia,26/06/2003,1,0,-1,0,-2,0,0,-2
Georgia,27/06/2003,4,0,0,0,0,0,0,4
Georgia,28/06/2003,2,0,0,0,0,0,0,2
Georgia,29/06/2003,1,0,1,0,0,2,0,4
Georgia,30/06/2003,0,0,0,0,0,0,0,0
Georgia,01/07/2003,0,0,0,0,0,0,0,0
Georgia,02/07/2003,0,0,0,0,0,0,0,0
Georgia,03/07/2003,4,0,0,0,0,0,0,4
Georgia,04/07/2003,2,0,0,0,0,0,0,2
Georgia,05/07/2003,0,0,0,0,0,0,0,0
Georgia,06/07/2003,1,0,0,0,0,0,0,1
Georgia,07/07/2003,2,0,0,0,0,0,0,2
Georgia,08/07/2003,-2,0,0,0,6,0,0,4
Georgia,09/07/2003,3,0,0,0,0,0,0,3
Georgia,10/07/2003,0,0,0,0,0,0,0,0
Georgia,11/07/2003,2,0,0,0,0,0,0,2
Georgia,14/07/2003,2,0,0,0,0,0,0,2
Georgia,15/07/2003,5,0,0,0,0,0,0,5
Georgia,16/07/2003,3,0,0,0,0,0,0,3
Georgia,17/07/2003,3,0,0,0,3,0,0,6
Georgia,18/07/2003,0,0,0,0,0,1,0,1
Georgia,20/07/2003,2,0,0,0,0,0,0,2
Georgia,21/07/2003,0,0,0,0,0,0,0,0
Georgia,22/07/2003,4,0,0,0,0,0,0,4
Georgia,23/07/2003,0,0,0,0,0,0,0,0
Georgia,24/07/2003,0,0,0,0,0,0,0,0
Georgia,25/07/2003,-2,0,0,0,0,0,0,-2
Georgia,26/07/2003,6,0,0,0,0,0,0,6
Georgia,28/07/2003,0,0,0,0,0,2,0,2
Georgia,29/07/2003,1,0,0,0,0,0,0,1
Georgia,31/07/2003,0,0,0,0,0,0,0,0
Georgia,02/08/2003,2,0,0,0,0,0,0,2
Georgia,03/08/2003,0,0,0,0,0,0,0,0
Georgia,04/08/2003,2,0,0,0,0,0,0,2
Georgia,05/08/2003,6,0,0,0,0,0,0,6
Georgia,06/08/2003,0,0,0,0,0,0,0,0
Georgia,07/08/2003,0,0,0,0,0,0,0,0
Georgia,08/08/2003,4,0,0,0,0,0,0,4
Georgia,09/08/2003,0,0,0,0,0,1,0,1
Georgia,11/08/2003,2,0,0,0,0,0,0,2
Georgia,12/08/2003,0,0,0,0,0,0,0,0
Georgia,13/08/2003,0,0,0,0,0,0,0,0
Georgia,15/08/2003,0,0,-2,0,0,0,0,-2
Georgia,18/08/2003,5,0,0,0,0,0,0,5
Georgia,19/08/2003,0,0,0,0,0,0,0,0
Georgia,20/08/2003,2,0,0,0,0,0,0,2
Georgia,21/08/2003,5,0,0,0,0,0,0,5
Georgia,22/08/2003,6,0,0,0,0,2,0,8
Georgia,24/08/2003,3,0,0,0,0,0,0,3
Georgia,26/08/2003,0,0,0,0,2,1,0,3
Georgia,27/08/2003,0,0,0,0,0,0,0,0
Georgia,29/08/2003,0,0,0,0,9,0,0,9
Georgia,30/08/2003,0,0,0,0,0,1,0,1
Georgia,31/08/2003,2,0,0,0,0,0,0,2
Georgia,01/09/2003,2,0,0,0,0,0,0,2
Georgia,03/09/2003,1,0,0,0,0,0,0,1
Georgia,04/09/2003,-1,0,0,0,0,0,0,-1
Georgia,05/09/2003,0,0,0,0,0,0,0,0
Georgia,06/09/2003,5,0,0,0,0,-2,0,3
Georgia,07/09/2003,0,0,0,0,6,1,0,7
Georgia,08/09/2003,0,0,0,0,0,0,0,0
Georgia,09/09/2003,2,0,0,0,0,0,0,2
Georgia,10/09/2003,3,0,0,0,3,0,0,6
Georgia,11/09/2003,0,0,0,0,0,1,0,1
Georgia,12/09/2003,0,0,0,0,-2,0,0,-2
Georgia,13/09/2003,-2,0,0,0,0,0,0,-2
Georgia,14/09/2003,0,0,0,0,0,0,0,0
Georgia,16/09/2003,3,0,0,0,0,0,0,3
Georgia,17/09/2003,0,0,0,0,0,0,0,0
Georgia,18/09/2003,3,0,0,0,0,0,0,3
Georgia,19/09/2003,1,0,0,0,0,0,0,1
Georgia,20/09/2003,0,0,0,0,0,0,0,0
Georgia,22/09/2003,0,0,0,0,0,0,0,0
Georgia,23/09/2003,0,0,0,0,0,0,0,0
Georgia,24/09/2003,2,0,0,0,6,0,0,8
Georgia,25/09/2003,0,0,0,0,0,0,0,0
Georgia,26/09/2003,4,0,0,0,0,0,0,4
Georgia,27/09/2003,0,0,0,0,0,1,0,1
Georgia,28/09/2003,0,0,0,0,0,0,0,0
Georgia,29/09/2003,2,0,0,0,0,0,0,2
Georgia,30/09/2003,6,0,0,0,0,1,0,7
Georgia,01/10/2003,0,0,0,0,1,0,0,1
Georgia,02/10/2003,0,0,0,0,3,0,0,3
Georgia,03/10/2003,1,0,0,0,0,0,0,1
Georgia,04/10/2003,4,0,0,0,0,0,0,4
Georgia,05/10/2003,0,0,0,0,0,0,0,0
Georgia,06/10/2003,0,0,0,0,0,0,0,0
Georgia,07/10/2003,0,0,0,0,0,0,0,0
Georgia,08/10/2003,0,0,0,0,0,0,0,0
Georgia,09/10/2003,0,0,0,0,0,0,0,0
Georgia,12/10/2003,0,0,0,0,0,0,0,0
Georgia,13/10/2003,3,0,0,0,0,0,0,3
Georgia,14/10/2003,0,0,1,0,0,0,0,1
Georgia,15/10/2003,2,4,0,0,0,0,0,6
Georgia,16/10/2003,0,0,0,0,0,0,0,0
Georgia,17/10/2003,0,0,0,0,0,0,0,0
Georgia,18/10/2003,0,0,0,0,0,0,0,0
Georgia,21/10/2003,-1,0,0,0,0,0,0,-1
Georgia,22/10/2003,-1,0,0,0,0,0,0,-1
Georgia,23/10/2003,0,0,0,0,0,0,0,0
Georgia,24/10/2003,0,0,-2,0,0,0,0,-2
Georgia,26/10/2003,0,0,0,0,0,0,0,0
Georgia,27/10/2003,0,0,0,0,0,0,0,0
Georgia,28/10/2003,0,0,0,0,0,0,0,0
Georgia,29/10/2003,2,0,0,0,0,0,0,2
Georgia,30/10/2003,0,0,0,0,0,0,0,0
Georgia,31/10/2003,1,0,0,0,0,0,0,1
Georgia,02/11/2003,0,0,1,0,0,0,0,1
Georgia,03/11/2003,0,0,0,0,0,1,0,1
Georgia,04/11/2003,2,0,0,0,0,0,0,2
Georgia,05/11/2003,4,0,0,0,-4,0,0,0
Georgia,06/11/2003,4,0,-2,0,0,0,0,2
Georgia,07/11/2003,0,0,0,0,0,0,0,0
Georgia,08/11/2003,0,0,0,0,0,0,0,0
Georgia,09/11/2003,3,0,1,0,0,1,0,5
Georgia,10/11/2003,2,0,1,0,2,1,0,6
Georgia,11/11/2003,2,0,0,0,0,0,0,2
Georgia,12/11/2003,0,0,0,0,0,0,0,0
Georgia,13/11/2003,3,0,0,0,0,1,0,4
Georgia,14/11/2003,1,0,0,0,0,0,0,1
Georgia,15/11/2003,0,0,0,0,0,0,0,0
Georgia,16/11/2003,2,0,0,0,0,0,0,2
Georgia,17/11/2003,0,0,0,0,3,0,0,3
Georgia,18/11/2003,3,0,0,0,0,0,0,3
Georgia,19/11/2003,3,0,-7,0,0,0,0,-4
Georgia,20/11/2003,0,0,0,0,0,0,0,0
Georgia,21/11/2003,0,0,0,0,0,1,0,1
Georgia,22/11/2003,5,0,0,0,-2,5,0,8
Georgia,23/11/2003,14,0,-8,0,3,3,0,12
Georgia,24/11/2003,11,0,-7,0,-1,1,0,4
Georgia,25/11/2003,19,0,0,0,0,5,0,24
Georgia,26/11/2003,9,0,0,0,-4,0,0,5
Georgia,27/11/2003,-1,0,0,0,0,2,0,1
Georgia,28/11/2003,0,0,0,0,0,0,0,0
Georgia,29/11/2003,-2,0,0,0,0,0,0,-2
Georgia,30/11/2003,0,0,0,0,0,0,0,0
Georgia,01/12/2003,0,0,0,0,3,0,0,3
Georgia,02/12/2003,11,0,0,0,0,0,0,11
Georgia,03/12/2003,4,0,0,0,3,0,0,7
Georgia,04/12/2003,0,2,0,0,0,0,0,2
Georgia,05/12/2003,-2,0,0,0,0,0,0,-2
Georgia,06/12/2003,0,0,0,0,0,0,0,0
Georgia,07/12/2003,0,0,0,0,0,0,0,0
Georgia,08/12/2003,0,0,0,0,0,0,0,0
Georgia,09/12/2003,0,0,0,0,-2,0,0,-2
Georgia,10/12/2003,5,0,0,0,6,0,0,11
Georgia,11/12/2003,0,0,0,0,-2,0,0,-2
Georgia,12/12/2003,0,0,0,0,3,0,0,3
Georgia,13/12/2003,0,0,0,0,0,0,0,0
Georgia,14/12/2003,0,0,0,0,0,0,0,0
Georgia,15/12/2003,26,0,0,0,0,1,0,27
Georgia,16/12/2003,0,0,0,0,0,0,0,0
Georgia,17/12/2003,5,0,0,0,3,0,0,8
Georgia,18/12/2003,7,0,0,0,3,3,0,13
Georgia,19/12/2003,2,0,0,0,6,1,0,9
Georgia,21/12/2003,12,0,0,0,3,0,0,15
Georgia,22/12/2003,0,0,0,0,0,0,0,0
Georgia,23/12/2003,0,0,0,0,0,0,0,0
Georgia,24/12/2003,0,0,0,0,0,0,0,0
Georgia,25/12/2003,-1,0,0,0,3,0,0,2
Georgia,26/12/2003,3,0,0,0,0,0,0,3
Georgia,27/12/2003,0,0,0,0,0,0,0,0
Georgia,28/12/2003,3,0,0,0,0,0,0,3
Georgia,29/12/2003,2,0,0,0,0,0,0,2
Georgia,30/12/2003,3,0,0,0,3,0,0,6
Georgia,31/12/2003,0,0,0,0,6,0,0,6
India,01/01/2003,5,0,0,0,0,0,0,5
India,02/01/2003,5,0,0,0,3,0,0,8
India,03/01/2003,15,0,0,0,6,2,0,23
India,04/01/2003,29,0,0,0,3,0,0,32
India,05/01/2003,2,0,0,0,0,0,0,2
India,06/01/2003,6,0,0,0,0,0,0,6
India,07/01/2003,0,0,0,0,0,0,0,0
India,08/01/2003,3,0,0,0,-2,2,0,3
India,09/01/2003,1,0,0,0,-4,0,0,-3
India,10/01/2003,2,0,0,0,6,0,0,8
India,11/01/2003,3,0,0,0,9,0,0,12
India,12/01/2003,0,0,0,0,0,0,0,0
India,13/01/2003,17,2,0,0,-2,0,0,17
India,14/01/2003,8,0,0,0,9,1,0,18
India,15/01/2003,-1,0,0,0,0,2,0,1
India,16/01/2003,3,0,0,0,0,1,0,4
India,17/01/2003,9,0,0,0,-2,0,0,7
India,18/01/2003,16,0,0,0,0,0,0,16
India,19/01/2003,5,0,0,0,0,0,0,5
India,20/01/2003,20,0,0,0,12,0,0,32
India,21/01/2003,17,0,0,0,0,-2,0,15
India,22/01/2003,8,0,0,0,18,4,0,30
India,23/01/2003,15,0,0,0,9,3,0,27
India,24/01/2003,17,0,0,0,18,0,0,35
India,25/01/2003,7,0,0,0,15,2,0,24
India,26/01/2003,5,0,0,0,0,0,0,5
India,27/01/2003,1,0,0,0,6,2,0,9
India,28/01/2003,18,0,0,0,0,0,0,18
India,29/01/2003,18,0,0,0,3,3,0,24
India,30/01/2003,12,0,0,0,0,5,0,17
India,31/01/2003,15,0,0,0,-1,0,0,14
India,01/02/2003,12,0,0,0,-2,0,0,10
India,02/02/2003,0,0,0,0,0,2,0,2
India,03/02/2003,7,0,0,0,0,2,0,9
India,04/02/2003,11,0,0,0,0,2,0,13
India,05/02/2003,8,0,0,0,0,3,0,11
India,06/02/2003,12,0,0,0,12,0,0,24
India,07/02/2003,7,0,0,0,3,0,0,10
India,08/02/2003,5,0,0,0,3,0,0,8
India,09/02/2003,0,0,0,0,0,0,0,0
India,10/02/2003,6,0,0,0,6,0,0,12
India,11/02/2003,16,0,0,0,3,0,0,19
India,12/02/2003,-2,0,0,0,6,0,0,4
India,13/02/2003,7,0,0,0,0,1,0,8
India,14/02/2003,7,0,0,0,3,0,0,10
India,15/02/2003,4,0,0,0,0,2,0,6
India,16/02/2003,0,0,0,0,-4,1,0,-3
India,17/02/2003,2,0,0,0,0,0,0,2
India,18/02/2003,1,0,0,0,0,0,0,1
India,19/02/2003,4,0,0,0,0,3,0,7
India,20/02/2003,5,0,0,0,6,1,0,12
India,21/02/2003,6,0,0,0,0,0,0,6
India,22/02/2003,8,0,2,0,0,0,0,10
India,23/02/2003,15,0,0,0,0,0,0,15
India,24/02/2003,5,0,0,0,-8,0,0,-3
India,25/02/2003,7,0,0,0,-4,2,0,5
India,26/02/2003,5,0,0,0,0,0,0,5
India,27/02/2003,-2,0,0,0,0,0,0,-2
India,28/02/2003,-7,0,0,0,3,0,0,-4
India,01/03/2003,2,0,0,0,-4,0,0,-2
India,02/03/2003,13,0,0,0,3,0,0,16
India,03/03/2003,0,0,0,0,0,0,0,0
India,04/03/2003,9,2,0,0,0,0,0,11
India,05/03/2003,3,0,0,0,6,0,0,9
India,06/03/2003,0,0,0,0,3,0,0,3
India,07/03/2003,0,2,0,0,3,0,0,5
India,08/03/2003,3,0,0,0,3,0,0,6
India,09/03/2003,4,0,-1,0,0,1,0,4
India,10/03/2003,0,0,0,0,3,0,0,3
India,11/03/2003,1,0,0,0,0,0,0,1
India,12/03/2003,10,0,0,0,9,2,0,21
India,13/03/2003,10,0,0,0,0,2,0,12
India,14/03/2003,10,0,0,0,12,0,0,22
India,15/03/2003,0,0,0,0,6,0,0,6
India,16/03/2003,0,0,0,0,0,1,0,1
India,17/03/2003,5,0,0,0,3,0,0,8
India,18/03/2003,10,0,0,0,3,0,0,13
India,19/03/2003,3,0,0,0,-2,2,0,3
India,20/03/2003,4,0,0,0,0,1,0,5
India,21/03/2003,10,0,0,0,3,3,0,16
India,22/03/2003,0,0,0,0,0,0,0,0
India,23/03/2003,12,0,-2,0,0,0,0,10
India,24/03/2003,5,0,0,0,0,0,0,5
India,25/03/2003,3,0,0,0,3,0,0,6
India,26/03/2003,13,0,0,0,0,4,0,17
India,27/03/2003,0,0,0,0,0,0,0,0
India,28/03/2003,3,0,0,0,0,0,0,3
India,29/03/2003,3,0,0,0,-2,1,0,2
India,30/03/2003,3,0,0,0,0,0,0,3
India,31/03/2003,3,0,0,0,0,0,0,3
India,01/04/2003,0,0,0,0,0,0,0,0
India,02/04/2003,19,0,0,0,0,2,0,21
India,03/04/2003,7,0,0,0,-6,0,0,1
India,04/04/2003,2,0,0,0,0,0,0,2
India,05/04/2003,6,0,0,0,0,0,0,6
India,06/04/2003,0,0,0,0,3,0,0,3
India,07/04/2003,3,0,0,0,3,0,0,6
India,08/04/2003,4,0,0,0,0,0,0,4
India,09/04/2003,5,0,0,0,0,0,0,5
India,10/04/2003,0,0,0,0,0,2,0,2
India,11/04/2003,11,0,0,0,3,0,0,14
India,12/04/2003,17,0,-2,0,0,0,0,15
India,13/04/2003,5,0,0,0,0,0,0,5
India,14/04/2003,2,0,0,0,0,0,0,2
India,15/04/2003,2,0,0,0,6,0,0,8
India,16/04/2003,11,0,0,0,0,0,0,11
India,17/04/2003,1,0,0,0,0,1,0,2
India,18/04/2003,2,0,0,0,3,0,0,5
India,19/04/2003,2,0,0,0,3,0,0,5
India,20/04/2003,2,0,0,0,-4,2,0,0
India,21/04/2003,6,0,0,0,0,0,0,6
India,22/04/2003,17,0,0,0,0,2,0,19
India,23/04/2003,2,0,0,0,3,0,0,5
India,24/04/2003,3,0,0,0,-2,0,0,1
India,25/04/2003,0,0,0,0,-6,0,0,-6
India,26/04/2003,0,0,0,0,0,0,0,0
India,27/04/2003,0,0,0,0,3,0,0,3
India,28/04/2003,17,0,0,0,0,0,0,17
India,29/04/2003,-2,0,0,0,0,0,0,-2
India,30/04/2003,11,0,0,0,0,0,0,11
India,01/05/2003,18,0,-2,0,0,4,0,20
India,02/05/2003,2,0,0,0,-2,0,0,0
India,03/05/2003,1,0,0,0,0,0,0,1
India,04/05/2003,1,0,2,0,0,0,0,3
India,05/05/2003,17,0,0,0,3,2,0,22
India,06/05/2003,18,0,0,0,9,1,0,28
India,07/05/2003,7,0,0,0,3,0,0,10
India,08/05/2003,9,2,0,0,0,0,0,11
India,09/05/2003,11,0,0,0,0,3,0,14
India,10/05/2003,5,0,0,0,1,0,0,6
India,11/05/2003,5,0,0,0,1,0,0,6
India,12/05/2003,7,0,0,0,3,0,0,10
India,13/05/2003,8,0,0,0,0,0,0,8
India,14/05/2003,8,0,1,0,-1,0,0,8
India,15/05/2003,4,0,0,0,3,3,0,10
India,16/05/2003,5,0,0,0,0,1,0,6
India,17/05/2003,9,0,0,0,0,0,0,9
India,18/05/2003,8,0,0,0,-4,6,0,10
India,19/05/2003,7,0,0,0,3,3,0,13
India,20/05/2003,5,0,0,0,0,3,0,8
India,21/05/2003,16,0,0,0,0,0,0,16
India,22/05/2003,1,0,0,0,3,0,0,4
India,23/05/2003,4,0,0,0,0,1,0,5
India,24/05/2003,5,0,0,0,-2,6,0,9
India,25/05/2003,0,0,0,0,-2,2,0,0
India,26/05/2003,4,0,0,0,3,1,0,8
India,27/05/2003,6,0,0,0,-2,0,0,4
India,28/05/2003,5,0,0,0,1,6,0,12
India,29/05/2003,5,0,1,0,0,0,0,6
India,30/05/2003,14,0,0,0,0,1,0,15
India,31/05/2003,7,0,0,0,-4,0,0,3
India,01/06/2003,8,0,-4,0,0,0,0,4
India,02/06/2003,5,0,1,0,-2,0,0,4
India,03/06/2003,5,0,0,0,0,3,0,8
India,04/06/2003,10,0,0,0,0,5,0,15
India,05/06/2003,7,0,2,0,-2,2,0,9
India,06/06/2003,-1,0,0,0,-2,0,0,-3
India,07/06/2003,2,0,0,0,0,1,0,3
India,08/06/2003,0,0,0,0,-4,1,0,-3
India,09/06/2003,4,4,-2,0,0,0,0,6
India,10/06/2003,1,0,0,0,0,0,0,1
India,11/06/2003,16,2,0,0,9,0,0,27
India,12/06/2003,9,0,0,0,6,3,0,18
India,13/06/2003,8,0,0,0,3,0,0,11
India,14/06/2003,3,0,0,0,3,0,0,6
India,15/06/2003,1,0,0,0,3,1,0,5
India,16/06/2003,4,0,2,0,3,0,0,9
India,17/06/2003,11,0,0,0,-2,2,0,11
India,18/06/2003,19,0,0,0,0,2,0,21
India,19/06/2003,12,0,-1,0,0,3,0,14
India,20/06/2003,6,0,0,0,3,0,0,9
India,21/06/2003,6,0,0,0,0,3,0,9
India,22/06/2003,4,0,0,0,0,0,0,4
India,23/06/2003,3,0,0,0,3,0,0,6
India,24/06/2003,8,0,0,0,6,1,0,15
India,25/06/2003,12,0,0,0,0,2,0,14
India,26/06/2003,11,0,0,0,0,0,0,11
India,27/06/2003,11,0,0,0,0,2,0,13
India,28/06/2003,17,0,0,0,0,0,0,17
India,29/06/2003,14,0,0,0,-2,4,0,16
India,30/06/2003,11,0,0,0,0,0,0,11
India,01/07/2003,9,0,0,0,0,0,0,9
India,02/07/2003,5,0,0,0,3,1,0,9
India,03/07/2003,0,0,0,0,0,0,0,0
India,04/07/2003,15,0,0,0,3,0,0,18
India,05/07/2003,7,0,0,0,0,0,0,7
India,06/07/2003,-1,0,0,0,6,0,0,5
India,07/07/2003,6,0,0,0,9,0,0,15
India,08/07/2003,1,0,0,0,-2,3,0,2
India,09/07/2003,4,4,1,0,9,0,0,18
India,10/07/2003,-3,0,0,0,0,2,0,-1
India,11/07/2003,7,0,0,0,0,0,0,7
India,12/07/2003,2,0,0,0,3,0,0,5
India,13/07/2003,3,0,0,0,0,0,0,3
India,14/07/2003,10,0,0,0,0,0,0,10
India,15/07/2003,15,0,0,0,6,3,0,24
India,16/07/2003,9,0,0,0,6,1,0,16
India,17/07/2003,7,0,0,0,3,0,0,10
India,18/07/2003,9,0,0,0,0,0,0,9
India,19/07/2003,11,0,0,0,3,0,0,14
India,20/07/2003,4,0,0,0,3,0,0,7
India,21/07/2003,7,0,0,0,4,4,0,15
India,22/07/2003,6,0,0,0,15,0,0,21
India,23/07/2003,15,0,0,0,0,2,0,17
India,24/07/2003,25,0,0,0,6,0,0,31
India,25/07/2003,16,0,0,0,0,0,0,16
India,26/07/2003,3,0,0,0,-2,0,0,1
India,27/07/2003,5,0,0,0,0,2,0,7
India,28/07/2003,9,0,0,0,0,5,0,14
India,29/07/2003,4,0,0,0,0,0,0,4
India,30/07/2003,10,0,0,0,0,0,0,10
India,31/07/2003,2,0,0,0,0,0,0,2
India,01/08/2003,10,0,0,0,3,1,0,14
India,02/08/2003,2,0,0,0,0,0,0,2
India,03/08/2003,0,0,0,0,6,0,0,6
India,04/08/2003,20,2,0,0,0,0,0,22
India,05/08/2003,3,0,0,0,0,2,0,5
India,06/08/2003,20,0,0,0,-1,2,0,21
India,07/08/2003,8,0,0,0,6,0,0,14
India,08/08/2003,0,0,0,0,1,2,0,3
India,09/08/2003,4,0,0,0,0,0,0,4
India,10/08/2003,3,0,0,0,0,2,0,5
India,11/08/2003,2,0,0,0,0,1,0,3
India,12/08/2003,4,0,0,0,0,0,0,4
India,13/08/2003,0,0,0,0,0,3,0,3
India,14/08/2003,15,0,0,0,12,1,0,28
India,15/08/2003,9,0,0,0,0,0,0,9
India,16/08/2003,10,0,0,0,0,0,0,10
India,17/08/2003,2,0,0,0,0,2,0,4
India,18/08/2003,5,0,0,0,0,1,0,6
India,19/08/2003,5,0,0,0,3,0,0,8
India,20/08/2003,0,0,0,0,0,0,0,0
India,21/08/2003,0,0,0,0,0,0,0,0
India,22/08/2003,19,0,0,0,0,0,0,19
India,23/08/2003,5,0,0,0,0,0,0,5
India,24/08/2003,0,0,0,0,2,0,0,2
India,25/08/2003,6,0,0,0,6,0,0,12
India,26/08/2003,1,0,0,0,0,0,0,1
India,27/08/2003,31,0,0,0,8,2,0,41
India,28/08/2003,13,0,0,0,-2,0,0,11
India,29/08/2003,10,0,0,0,0,0,0,10
India,30/08/2003,41,0,0,0,0,0,0,41
India,31/08/2003,0,0,0,0,0,0,0,0
India,01/09/2003,4,0,0,0,-8,2,0,-2
India,02/09/2003,0,0,0,0,3,0,0,3
India,03/09/2003,16,0,0,0,0,0,0,16
India,04/09/2003,9,0,0,0,1,2,0,12
India,05/09/2003,7,0,0,0,1,1,0,9
India,06/09/2003,14,0,0,0,-2,1,0,13
India,07/09/2003,8,0,-1,0,0,2,0,9
India,08/09/2003,18,0,0,0,-2,2,0,18
India,09/09/2003,17,0,0,0,-2,9,0,24
India,10/09/2003,10,0,0,0,6,2,0,18
India,11/09/2003,28,0,0,0,6,7,0,41
India,12/09/2003,11,0,0,0,4,0,0,15
India,13/09/2003,13,0,0,0,0,2,0,15
India,14/09/2003,17,0,0,0,0,2,0,19
India,15/09/2003,10,0,0,0,0,0,0,10
India,16/09/2003,16,0,0,0,0,0,0,16
India,17/09/2003,4,0,0,0,9,0,0,13
India,18/09/2003,7,0,0,0,9,0,0,16
India,19/09/2003,11,0,0,0,2,0,0,13
India,20/09/2003,25,0,0,0,-2,0,0,23
India,21/09/2003,14,0,0,0,0,0,0,14
India,22/09/2003,10,0,0,0,7,0,0,17
India,23/09/2003,1,0,0,0,0,2,0,3
India,24/09/2003,11,0,0,0,0,0,0,11
India,25/09/2003,-2,0,0,0,0,0,0,-2
India,26/09/2003,11,2,0,0,0,0,0,13
India,27/09/2003,8,0,-2,0,0,0,0,6
India,28/09/2003,8,0,-6,0,0,4,0,6
India,29/09/2003,28,0,0,0,-10,-1,0,17
India,30/09/2003,7,0,0,0,0,0,0,7
India,01/10/2003,10,0,0,0,0,1,0,11
India,02/10/2003,9,0,-2,0,0,0,0,7
India,03/10/2003,8,0,0,0,3,1,0,12
India,04/10/2003,6,0,0,0,1,2,0,9
India,05/10/2003,5,0,0,0,0,4,0,9
India,06/10/2003,8,0,0,0,1,0,0,9
India,07/10/2003,4,0,0,0,-2,0,0,2
India,08/10/2003,5,0,0,0,0,0,0,5
India,09/10/2003,11,0,0,0,0,4,0,15
India,10/10/2003,9,0,-2,0,-2,0,0,5
India,11/10/2003,2,0,0,0,9,0,0,11
India,12/10/2003,6,0,0,0,0,0,0,6
India,13/10/2003,8,0,0,0,0,0,0,8
India,14/10/2003,6,2,0,0,3,1,0,12
India,15/10/2003,10,0,0,0,3,1,0,14
India,16/10/2003,6,0,0,0,2,1,0,9
India,17/10/2003,5,0,0,0,6,0,0,11
India,18/10/2003,15,0,0,0,3,0,0,18
India,19/10/2003,-1,0,0,0,3,1,0,3
India,20/10/2003,6,0,0,0,0,1,0,7
India,21/10/2003,15,0,0,0,1,0,0,16
India,22/10/2003,8,0,0,0,6,1,0,15
India,23/10/2003,2,0,0,0,6,0,0,8
India,24/10/2003,9,0,0,0,1,0,0,10
India,25/10/2003,1,0,1,0,0,0,0,2
India,26/10/2003,0,0,0,0,0,1,0,1
India,27/10/2003,25,0,-2,0,-6,0,0,17
India,28/10/2003,8,0,0,0,-6,0,0,2
India,29/10/2003,4,0,0,0,-2,0,0,2
India,30/10/2003,2,0,0,0,1,0,0,3
India,31/10/2003,3,0,1,0,3,0,0,7
India,01/11/2003,7,0,0,0,0,0,0,7
India,02/11/2003,5,0,0,0,3,0,0,8
India,03/11/2003,4,0,0,0,0,0,0,4
India,04/11/2003,46,0,0,0,3,0,0,49
India,05/11/2003,37,0,0,0,3,0,0,40
India,06/11/2003,7,0,0,0,0,0,0,7
India,07/11/2003,4,0,0,0,0,0,0,4
India,08/11/2003,13,0,0,0,16,0,0,29
India,09/11/2003,9,0,0,0,6,0,0,15
India,10/11/2003,6,0,0,0,6,0,0,12
India,11/11/2003,2,0,0,0,6,0,0,8
India,12/11/2003,10,0,0,0,6,0,0,16
India,13/11/2003,11,0,0,0,18,4,0,33
India,14/11/2003,8,0,1,0,3,0,0,12
India,15/11/2003,8,0,0,0,15,1,0,24
India,16/11/2003,9,0,0,0,7,0,0,16
India,17/11/2003,15,0,0,0,12,0,0,27
India,18/11/2003,4,0,0,0,0,0,0,4
India,19/11/2003,3,0,0,0,3,0,0,6
India,20/11/2003,0,0,0,0,21,2,0,23
India,21/11/2003,12,0,0,0,4,0,0,16
India,22/11/2003,7,0,1,0,0,1,0,9
India,23/11/2003,9,2,0,0,0,0,0,11
India,24/11/2003,10,2,0,0,9,0,0,21
India,25/11/2003,18,0,-1,0,0,0,0,17
India,26/11/2003,2,0,0,0,0,0,0,2
India,27/11/2003,2,0,0,0,0,0,0,2
India,28/11/2003,3,0,0,0,0,0,0,3
India,29/11/2003,0,0,0,0,3,0,0,3
India,30/11/2003,2,0,0,0,0,0,0,2
India,01/12/2003,-2,0,0,0,0,0,0,-2
India,02/12/2003,10,0,0,0,-8,1,0,3
India,03/12/2003,18,0,1,0,0,0,0,19
India,04/12/2003,19,0,0,0,4,1,0,24
India,05/12/2003,3,0,0,0,0,3,0,6
India,06/12/2003,13,0,-1,0,-2,1,0,11
India,07/12/2003,6,0,0,0,0,2,0,8
India,08/12/2003,3,0,0,0,2,0,0,5
India,09/12/2003,3,0,0,0,6,5,0,14
India,10/12/2003,5,0,0,0,0,0,0,5
India,11/12/2003,5,0,0,0,0,0,0,5
India,12/12/2003,4,0,0,0,9,1,0,14
India,13/12/2003,6,0,0,0,3,0,0,9
India,14/12/2003,-2,0,0,0,6,0,0,4
India,15/12/2003,25,0,0,0,0,0,0,25
India,16/12/2003,9,0,0,0,3,3,0,15
India,17/12/2003,5,0,0,0,4,0,0,9
India,18/12/2003,36,0,0,0,7,2,0,45
India,19/12/2003,5,0,0,0,0,0,0,5
India,20/12/2003,4,0,0,0,3,4,0,11
India,21/12/2003,11,0,0,0,0,0,0,11
India,22/12/2003,6,0,0,0,-2,0,0,4
India,23/12/2003,9,0,0,0,0,0,0,9
India,24/12/2003,1,0,0,0,0,0,0,1
India,25/12/2003,9,0,-1,0,4,0,0,12
India,26/12/2003,5,0,0,0,0,0,0,5
India,27/12/2003,3,0,0,0,3,0,0,6
India,28/12/2003,7,0,0,0,0,0,0,7
India,29/12/2003,8,0,0,0,-2,0,0,6
India,30/12/2003,35,0,0,0,-8,13,0,40
India,31/12/2003,9,0,0,0,-2,3,0,10
Iran,01/01/2003,13,0,1,0,0,0,0,14
Iran,02/01/2003,3,0,0,0,0,2,0,5
Iran,03/01/2003,6,0,0,0,0,0,0,6
Iran,04/01/2003,2,0,0,0,6,0,0,8
Iran,05/01/2003,2,0,0,0,0,0,0,2
Iran,06/01/2003,10,0,0,0,2,0,0,12
Iran,07/01/2003,21,0,0,0,4,6,0,31
Iran,08/01/2003,3,0,1,0,12,0,0,16
Iran,09/01/2003,27,0,0,0,9,0,0,36
Iran,10/01/2003,6,0,0,0,3,0,0,9
Iran,11/01/2003,0,0,0,0,0,0,0,0
Iran,12/01/2003,3,0,1,0,3,0,0,7
Iran,13/01/2003,9,0,0,0,7,2,0,18
Iran,14/01/2003,13,0,-2,0,6,10,0,27
Iran,15/01/2003,6,2,0,0,3,1,0,12
Iran,16/01/2003,11,0,-2,0,6,1,0,16
Iran,17/01/2003,14,0,0,0,0,4,0,18
Iran,18/01/2003,-4,0,0,0,15,1,0,12
Iran,19/01/2003,30,0,-2,0,4,0,0,32
Iran,20/01/2003,3,0,0,0,0,0,0,3
Iran,21/01/2003,4,0,2,0,4,2,0,12
Iran,22/01/2003,19,0,0,0,-12,1,0,8
Iran,23/01/2003,43,0,0,0,12,7,0,62
Iran,24/01/2003,2,0,0,0,3,0,0,5
Iran,25/01/2003,21,0,0,0,0,1,0,22
Iran,26/01/2003,35,0,-1,0,6,0,0,40
Iran,27/01/2003,9,0,0,0,10,3,0,22
Iran,28/01/2003,21,0,-2,0,12,0,0,31
Iran,29/01/2003,12,0,0,0,-9,2,0,5
Iran,30/01/2003,19,0,0,0,-10,0,0,9
Iran,31/01/2003,18,0,0,0,-2,0,0,16
Iran,01/02/2003,16,0,-3,0,-9,5,0,9
Iran,02/02/2003,-2,0,0,0,2,0,0,0
Iran,03/02/2003,9,0,0,0,9,0,0,18
Iran,04/02/2003,23,0,0,0,4,1,0,28
Iran,05/02/2003,12,0,0,0,-8,1,0,5
Iran,06/02/2003,24,0,0,0,2,4,0,30
Iran,07/02/2003,39,0,0,0,6,2,0,47
Iran,08/02/2003,43,0,-2,0,16,5,0,62
Iran,09/02/2003,28,0,0,0,7,0,0,35
Iran,10/02/2003,16,0,0,0,1,3,0,20
Iran,11/02/2003,16,0,-2,0,3,3,0,20
Iran,12/02/2003,15,0,0,0,0,0,0,15
Iran,13/02/2003,24,0,0,0,0,6,0,30
Iran,14/02/2003,7,0,0,0,3,1,0,11
Iran,15/02/2003,12,0,0,0,2,1,0,15
Iran,16/02/2003,10,0,0,0,6,0,0,16
Iran,17/02/2003,13,0,0,0,1,1,0,15
Iran,18/02/2003,12,0,0,0,13,0,0,25
Iran,19/02/2003,8,0,0,0,3,3,0,14
Iran,20/02/2003,26,0,0,0,0,0,0,26
Iran,21/02/2003,13,0,0,0,0,1,0,14
Iran,22/02/2003,21,0,0,0,0,0,0,21
Iran,23/02/2003,47,0,1,0,0,2,0,50
Iran,24/02/2003,8,0,0,0,-1,0,0,7
Iran,25/02/2003,33,0,0,0,9,0,0,42
Iran,26/02/2003,6,0,1,0,0,1,0,8
Iran,27/02/2003,17,0,0,0,4,0,0,21
Iran,28/02/2003,50,0,0,0,-4,6,0,52
Iran,01/03/2003,11,0,0,0,3,0,0,14
Iran,02/03/2003,12,0,0,0,7,3,0,22
Iran,03/03/2003,1,0,-2,0,0,1,0,0
Iran,04/03/2003,9,0,0,0,6,0,0,15
Iran,05/03/2003,19,0,1,0,12,0,0,32
Iran,06/03/2003,3,0,0,0,0,1,0,4
Iran,07/03/2003,3,2,0,0,15,0,0,20
Iran,08/03/2003,33,0,-4,0,5,0,0,34
Iran,09/03/2003,10,0,0,0,0,1,0,11
Iran,10/03/2003,11,0,-8,0,21,2,0,26
Iran,11/03/2003,19,0,-4,0,13,1,0,29
Iran,12/03/2003,17,0,0,0,1,0,0,18
Iran,13/03/2003,8,0,0,0,-25,0,0,-17
Iran,14/03/2003,4,0,0,0,-3,0,0,1
Iran,15/03/2003,15,0,0,0,6,2,0,23
Iran,16/03/2003,-3,0,0,0,-4,0,0,-7
Iran,17/03/2003,21,0,0,0,11,1,0,33
Iran,18/03/2003,24,0,0,0,-7,0,0,17
Iran,19/03/2003,26,0,0,0,-13,0,0,13
Iran,20/03/2003,20,0,1,0,6,2,0,29
Iran,21/03/2003,31,0,0,0,-7,6,0,30
Iran,22/03/2003,11,0,0,0,9,3,0,23
Iran,23/03/2003,3,0,0,0,1,5,0,9
Iran,24/03/2003,6,0,0,0,3,0,0,9
Iran,25/03/2003,16,0,0,0,1,0,0,17
Iran,26/03/2003,40,0,0,0,6,0,0,46
Iran,27/03/2003,13,0,0,0,0,1,0,14
Iran,28/03/2003,5,0,1,0,6,4,0,16
Iran,29/03/2003,15,0,0,0,0,1,0,16
Iran,30/03/2003,9,0,0,0,0,3,0,12
Iran,31/03/2003,11,0,0,0,9,1,0,21
Iran,01/04/2003,26,0,1,0,3,0,0,30
Iran,02/04/2003,14,0,0,0,9,1,0,24
Iran,03/04/2003,43,0,0,0,-2,1,0,42
Iran,04/04/2003,5,0,0,0,0,0,0,5
Iran,05/04/2003,23,0,0,0,1,1,0,25
Iran,06/04/2003,46,0,2,0,6,1,0,55
Iran,07/04/2003,29,0,0,0,3,3,0,35
Iran,08/04/2003,25,0,0,0,3,2,0,30
Iran,09/04/2003,8,0,0,0,-4,10,0,14
Iran,10/04/2003,16,0,0,0,3,1,0,20
Iran,11/04/2003,11,0,1,0,0,2,0,14
Iran,12/04/2003,17,0,0,0,1,0,0,18
Iran,13/04/2003,39,0,0,0,12,3,0,54
Iran,14/04/2003,41,0,0,0,26,2,0,69
Iran,15/04/2003,81,0,0,0,10,13,0,104
Iran,16/04/2003,37,0,-2,0,-4,0,0,31
Iran,17/04/2003,41,0,0,0,0,1,0,42
Iran,18/04/2003,11,0,0,0,0,1,0,12
Iran,19/04/2003,18,0,0,0,16,0,0,34
Iran,20/04/2003,4,0,0,0,1,0,0,5
Iran,21/04/2003,29,0,0,0,-2,2,0,29
Iran,22/04/2003,12,0,0,0,12,0,0,24
Iran,23/04/2003,9,0,0,0,0,2,0,11
Iran,24/04/2003,12,0,1,0,5,4,0,22
Iran,25/04/2003,2,0,0,0,0,0,0,2
Iran,26/04/2003,12,0,0,0,16,0,0,28
Iran,27/04/2003,20,0,0,0,6,2,0,28
Iran,28/04/2003,11,0,0,0,6,6,0,23
Iran,29/04/2003,23,0,0,0,0,6,0,29
Iran,30/04/2003,13,0,0,0,3,3,0,19
Iran,01/05/2003,29,0,0,0,0,0,0,29
Iran,02/05/2003,7,0,0,0,0,0,0,7
Iran,03/05/2003,32,0,0,0,3,0,0,35
Iran,04/05/2003,6,0,0,0,3,0,0,9
Iran,05/05/2003,15,0,1,0,-4,2,0,14
Iran,06/05/2003,11,0,0,0,4,0,0,15
Iran,07/05/2003,12,0,0,0,1,1,0,14
Iran,08/05/2003,8,0,0,0,-4,0,0,4
Iran,09/05/2003,19,0,0,0,5,7,0,31
Iran,10/05/2003,21,0,0,0,0,3,0,24
Iran,11/05/2003,24,0,0,0,6,1,0,31
Iran,12/05/2003,21,0,0,0,18,8,0,47
Iran,13/05/2003,19,0,0,0,-4,0,0,15
Iran,14/05/2003,9,0,-2,0,-5,2,0,4
Iran,15/05/2003,38,0,0,0,0,1,0,39
Iran,16/05/2003,1,0,0,0,0,0,0,1
Iran,17/05/2003,23,0,0,0,15,0,0,38
Iran,18/05/2003,4,0,0,0,9,0,0,13
Iran,19/05/2003,8,0,0,0,0,1,0,9
Iran,20/05/2003,7,0,0,0,-1,3,0,9
Iran,21/05/2003,20,0,2,0,-2,2,0,22
Iran,22/05/2003,24,0,0,0,9,0,0,33
Iran,23/05/2003,3,0,0,0,3,0,0,6
Iran,24/05/2003,14,0,0,0,6,2,0,22
Iran,25/05/2003,13,0,0,0,17,1,0,31
Iran,26/05/2003,17,0,0,0,17,3,0,37
Iran,27/05/2003,14,0,0,0,1,1,0,16
Iran,28/05/2003,2,0,0,0,2,7,0,11
Iran,29/05/2003,49,0,4,0,-2,2,0,53
Iran,30/05/2003,18,0,0,0,8,15,0,41
Iran,31/05/2003,17,0,0,0,1,0,0,18
Iran,01/06/2003,29,0,0,0,18,3,0,50
Iran,02/06/2003,8,0,0,0,27,2,0,37
Iran,03/06/2003,17,0,0,0,4,2,0,23
Iran,04/06/2003,23,0,0,0,6,2,0,31
Iran,05/06/2003,44,0,0,0,1,16,0,61
Iran,06/06/2003,21,0,1,0,3,1,0,26
Iran,07/06/2003,10,0,1,0,1,0,0,12
Iran,08/06/2003,18,0,3,0,0,2,0,23
Iran,09/06/2003,27,0,1,0,6,2,0,36
Iran,10/06/2003,7,0,0,0,6,0,0,13
Iran,11/06/2003,4,0,-1,0,9,2,0,14
Iran,12/06/2003,14,0,0,0,4,4,0,22
Iran,13/06/2003,6,0,0,0,10,2,0,18
Iran,14/06/2003,12,0,0,0,6,1,0,19
Iran,15/06/2003,1,0,0,0,-10,0,0,-9
Iran,16/06/2003,38,0,0,0,12,8,0,58
Iran,17/06/2003,19,0,0,0,21,7,0,47
Iran,18/06/2003,46,0,0,0,12,35,0,93
Iran,19/06/2003,41,0,0,0,25,29,0,95
Iran,20/06/2003,32,0,0,0,20,13,0,65
Iran,21/06/2003,22,0,0,0,14,5,0,41
Iran,22/06/2003,8,0,1,0,2,3,0,14
Iran,23/06/2003,14,0,0,0,16,24,0,54
Iran,24/06/2003,19,0,0,0,40,5,0,64
Iran,25/06/2003,21,0,0,0,11,1,0,33
Iran,26/06/2003,11,0,0,0,9,4,0,24
Iran,27/06/2003,15,0,0,0,0,2,0,17
Iran,28/06/2003,41,0,0,0,7,5,0,53
Iran,29/06/2003,1,0,0,0,7,3,0,11
Iran,30/06/2003,44,0,3,0,28,4,0,79
Iran,01/07/2003,23,0,1,0,-6,16,0,34
Iran,02/07/2003,10,0,0,0,1,1,0,12
Iran,03/07/2003,14,0,0,0,2,1,0,17
Iran,04/07/2003,10,0,0,0,7,2,0,19
Iran,05/07/2003,23,0,1,0,6,4,0,34
Iran,06/07/2003,7,0,0,0,-1,10,0,16
Iran,07/07/2003,14,0,-2,0,3,1,0,16
Iran,08/07/2003,28,0,0,0,-2,1,0,27
Iran,09/07/2003,18,0,0,0,13,0,0,31
Iran,10/07/2003,29,0,0,0,6,3,0,38
Iran,11/07/2003,13,0,0,0,1,2,0,16
Iran,12/07/2003,12,0,0,0,18,7,0,37
Iran,13/07/2003,40,0,0,0,-2,0,0,38
Iran,14/07/2003,6,0,1,0,0,0,0,7
Iran,15/07/2003,14,0,0,0,13,0,0,27
Iran,16/07/2003,12,0,0,0,0,0,0,12
Iran,17/07/2003,13,0,0,0,6,1,0,20
Iran,18/07/2003,16,0,0,0,3,2,0,21
Iran,19/07/2003,15,0,0,0,17,0,0,32
Iran,20/07/2003,2,0,1,0,3,0,0,6
Iran,21/07/2003,2,0,0,0,17,0,0,19
Iran,22/07/2003,14,0,0,0,7,3,0,24
Iran,23/07/2003,29,0,1,0,6,0,0,36
Iran,24/07/2003,33,0,0,0,-3,0,0,30
Iran,25/07/2003,5,0,0,0,12,0,0,17
Iran,26/07/2003,24,0,0,0,4,5,0,33
Iran,27/07/2003,11,0,0,0,17,2,0,30
Iran,28/07/2003,19,0,-4,0,-3,5,0,17
Iran,29/07/2003,23,0,-2,0,-6,1,0,16
Iran,30/07/2003,8,0,0,0,-1,1,0,8
Iran,31/07/2003,28,0,0,0,10,1,0,39
Iran,01/08/2003,6,0,0,0,9,0,0,15
Iran,02/08/2003,13,0,0,0,3,1,0,17
Iran,03/08/2003,14,0,0,0,1,0,0,15
Iran,04/08/2003,20,0,0,0,5,3,0,28
Iran,05/08/2003,15,0,0,0,3,2,0,20
Iran,06/08/2003,6,0,0,0,-2,0,0,4
Iran,07/08/2003,19,0,1,0,-4,0,0,16
Iran,08/08/2003,16,0,0,0,15,0,0,31
Iran,09/08/2003,20,0,0,0,-1,5,0,24
Iran,10/08/2003,17,0,-2,0,11,2,0,28
Iran,11/08/2003,12,0,1,0,18,2,0,33
Iran,12/08/2003,22,0,0,0,-4,2,0,20
Iran,13/08/2003,22,0,0,0,4,0,0,26
Iran,14/08/2003,17,0,0,0,22,2,0,41
Iran,15/08/2003,0,0,0,0,-2,2,0,0
Iran,16/08/2003,5,0,0,0,6,2,0,13
Iran,17/08/2003,14,0,0,0,3,0,0,17
Iran,18/08/2003,9,0,0,0,1,0,0,10
Iran,19/08/2003,4,0,1,0,-2,0,0,3
Iran,20/08/2003,18,0,0,0,6,5,0,29
Iran,21/08/2003,18,0,0,0,9,0,0,27
Iran,22/08/2003,27,0,0,0,10,0,0,37
Iran,23/08/2003,25,0,-2,0,3,2,0,28
Iran,24/08/2003,19,0,0,0,29,1,0,49
Iran,25/08/2003,11,0,0,0,10,2,0,23
Iran,26/08/2003,6,0,0,0,0,0,0,6
Iran,27/08/2003,9,0,0,0,8,0,0,17
Iran,28/08/2003,18,0,0,0,9,1,0,28
Iran,29/08/2003,12,0,0,0,3,0,0,15
Iran,30/08/2003,6,0,0,0,6,1,0,13
Iran,31/08/2003,7,0,0,0,0,3,0,10
Iran,01/09/2003,50,0,0,0,11,6,0,67
Iran,02/09/2003,30,0,0,0,-16,0,0,14
Iran,03/09/2003,36,0,0,0,4,0,0,40
Iran,04/09/2003,8,0,0,0,0,1,0,9
Iran,05/09/2003,12,0,0,0,7,0,0,19
Iran,06/09/2003,7,0,0,0,3,0,0,10
Iran,07/09/2003,3,0,0,0,16,5,0,24
Iran,08/09/2003,21,0,0,0,7,0,0,28
Iran,09/09/2003,14,0,0,0,13,8,0,35
Iran,10/09/2003,8,0,0,0,3,4,0,15
Iran,11/09/2003,13,0,0,0,-4,3,0,12
Iran,12/09/2003,30,0,0,0,-20,0,0,10
Iran,13/09/2003,30,0,-2,0,-8,10,0,30
Iran,14/09/2003,13,0,1,0,0,4,0,18
Iran,15/09/2003,6,0,0,0,3,2,0,11
Iran,16/09/2003,22,0,0,0,3,0,0,25
Iran,17/09/2003,26,0,0,0,5,2,0,33
Iran,18/09/2003,24,0,1,0,0,0,0,25
Iran,19/09/2003,3,0,0,0,-2,2,0,3
Iran,20/09/2003,10,0,0,0,-4,1,0,7
Iran,21/09/2003,6,0,0,0,6,0,0,12
Iran,22/09/2003,27,0,-2,0,-5,1,0,21
Iran,23/09/2003,13,0,1,0,0,0,0,14
Iran,24/09/2003,11,0,0,0,7,0,0,18
Iran,25/09/2003,7,0,2,0,26,5,0,40
Iran,26/09/2003,28,0,0,0,12,0,0,40
Iran,27/09/2003,19,0,0,0,7,2,0,28
Iran,28/09/2003,13,0,1,0,0,0,0,14
Iran,29/09/2003,5,0,0,0,7,2,0,14
Iran,30/09/2003,14,0,0,0,0,3,0,17
Iran,01/10/2003,39,0,0,0,9,3,0,51
Iran,02/10/2003,4,0,-2,0,0,3,0,5
Iran,03/10/2003,7,0,0,0,3,0,0,10
Iran,04/10/2003,16,0,-1,0,-2,0,0,13
Iran,05/10/2003,8,0,1,0,-2,0,0,7
Iran,06/10/2003,38,0,0,0,3,0,0,41
Iran,07/10/2003,19,0,0,0,15,0,0,34
Iran,08/10/2003,17,0,0,0,1,10,0,28
Iran,09/10/2003,15,0,0,0,4,0,0,19
Iran,10/10/2003,9,0,0,0,13,1,0,23
Iran,11/10/2003,25,0,1,0,14,1,0,41
Iran,12/10/2003,21,0,0,0,12,0,0,33
Iran,13/10/2003,17,0,2,0,10,1,0,30
Iran,14/10/2003,46,0,0,0,6,3,0,55
Iran,15/10/2003,39,0,0,0,-1,1,0,39
Iran,16/10/2003,5,0,0,0,-2,2,0,5
Iran,17/10/2003,20,0,0,0,0,1,0,21
Iran,18/10/2003,7,0,-2,0,3,2,0,10
Iran,19/10/2003,16,0,0,0,3,0,0,19
Iran,20/10/2003,-1,0,0,0,5,0,0,4
Iran,21/10/2003,18,0,0,0,4,0,0,22
Iran,22/10/2003,6,0,-2,0,8,0,0,12
Iran,23/10/2003,11,0,0,0,13,3,0,27
Iran,24/10/2003,6,0,0,0,0,0,0,6
Iran,25/10/2003,2,0,0,0,4,0,0,6
Iran,26/10/2003,8,0,0,0,3,2,0,13
Iran,27/10/2003,25,0,0,0,3,1,0,29
Iran,28/10/2003,8,0,0,0,4,3,0,15
Iran,29/10/2003,17,0,0,0,15,3,0,35
Iran,30/10/2003,15,0,0,0,6,2,0,23
Iran,31/10/2003,8,0,0,0,0,0,0,8
Iran,01/11/2003,14,0,0,0,3,4,0,21
Iran,02/11/2003,0,0,1,0,6,2,0,9
Iran,03/11/2003,29,0,0,0,0,0,0,29
Iran,04/11/2003,6,2,0,0,-1,0,0,7
Iran,05/11/2003,21,0,0,0,7,0,0,28
Iran,06/11/2003,11,0,0,0,3,5,0,19
Iran,07/11/2003,7,0,0,0,2,3,0,12
Iran,08/11/2003,16,0,0,0,-3,4,0,17
Iran,09/11/2003,26,0,0,0,16,1,0,43
Iran,10/11/2003,21,0,0,0,26,5,0,52
Iran,11/11/2003,15,0,0,0,0,1,0,16
Iran,12/11/2003,12,0,1,0,0,0,0,13
Iran,13/11/2003,15,0,1,0,0,4,0,20
Iran,14/11/2003,10,0,0,0,12,1,0,23
Iran,15/11/2003,45,0,0,0,1,3,0,49
Iran,16/11/2003,2,0,0,0,0,0,0,2
Iran,17/11/2003,26,0,0,0,-1,0,0,25
Iran,18/11/2003,36,0,0,0,-2,16,0,50
Iran,19/11/2003,33,0,0,0,4,1,0,38
Iran,20/11/2003,27,0,2,0,3,2,0,34
Iran,21/11/2003,26,0,-1,0,6,3,0,34
Iran,22/11/2003,37,0,-3,0,-4,3,0,33
Iran,23/11/2003,19,0,-1,0,-1,0,0,17
Iran,24/11/2003,15,0,-4,0,3,3,0,17
Iran,25/11/2003,13,0,-2,0,0,1,0,12
Iran,26/11/2003,5,0,3,0,0,0,0,8
Iran,27/11/2003,7,0,0,0,0,0,0,7
Iran,28/11/2003,9,0,1,0,3,0,0,13
Iran,29/11/2003,6,0,0,0,0,1,0,7
Iran,30/11/2003,7,0,0,0,1,1,0,9
Iran,01/12/2003,47,0,0,0,9,1,0,57
Iran,02/12/2003,17,0,0,0,0,0,0,17
Iran,03/12/2003,13,0,1,0,6,2,0,22
Iran,04/12/2003,15,0,1,0,27,4,0,47
Iran,05/12/2003,5,0,0,0,0,2,0,7
Iran,06/12/2003,5,0,0,0,0,0,0,5
Iran,07/12/2003,6,0,1,0,0,0,0,7
Iran,08/12/2003,14,0,-2,0,9,1,0,22
Iran,09/12/2003,22,0,1,0,-4,10,0,29
Iran,10/12/2003,16,0,-1,0,0,3,0,18
Iran,11/12/2003,25,0,-1,0,-1,5,0,28
Iran,12/12/2003,39,0,3,0,1,1,0,44
Iran,13/12/2003,12,0,1,0,0,0,0,13
Iran,14/12/2003,20,0,1,0,18,6,0,45
Iran,15/12/2003,14,2,1,0,4,2,0,23
Iran,16/12/2003,14,0,0,0,4,0,0,18
Iran,17/12/2003,26,0,0,0,5,0,0,31
Iran,18/12/2003,20,0,0,0,-6,2,0,16
Iran,19/12/2003,10,0,0,0,6,2,0,18
Iran,20/12/2003,-1,0,1,0,6,0,0,6
Iran,21/12/2003,20,0,0,0,15,0,0,35
Iran,22/12/2003,17,0,0,0,18,0,0,35
Iran,23/12/2003,-13,0,0,0,6,0,0,-7
Iran,24/12/2003,15,8,0,0,1,7,0,31
Iran,25/12/2003,22,0,-1,0,-2,0,0,19
Iran,26/12/2003,20,6,0,0,1,2,0,29
Iran,27/12/2003,14,8,0,0,-4,8,0,26
Iran,28/12/2003,24,4,0,0,0,5,0,33
Iran,29/12/2003,9,8,0,0,3,5,0,25
Iran,30/12/2003,7,2,0,0,0,1,0,10
Iran,31/12/2003,16,0,0,0,-1,4,0,19
Iraq,01/01/2003,46,0,0,0,19,8,0,73
Iraq,02/01/2003,53,0,0,0,9,5,0,67
Iraq,03/01/2003,52,0,0,0,9,11,0,72
Iraq,04/01/2003,53,0,2,0,26,4,0,85
Iraq,05/01/2003,64,0,0,0,3,3,0,70
Iraq,06/01/2003,119,0,-6,0,34,8,0,155
Iraq,07/01/2003,174,0,-4,0,0,17,0,187
Iraq,08/01/2003,127,0,-2,0,15,10,0,150
Iraq,09/01/2003,190,4,0,0,17,10,0,221
Iraq,10/01/2003,133,1,4,0,11,11,0,160
Iraq,11/01/2003,73,0,-1,0,18,9,0,99
Iraq,12/01/2003,77,0,1,0,10,21,0,109
Iraq,13/01/2003,85,0,1,0,50,16,0,152
Iraq,14/01/2003,133,2,0,0,14,16,0,165
Iraq,15/01/2003,150,0,1,0,25,11,0,187
Iraq,16/01/2003,105,0,-1,0,18,28,0,150
Iraq,17/01/2003,109,0,0,0,18,20,0,147
Iraq,18/01/2003,139,0,1,0,40,43,0,223
Iraq,19/01/2003,97,0,2,0,15,18,0,132
Iraq,20/01/2003,133,0,2,0,15,27,0,177
Iraq,21/01/2003,188,0,6,0,28,34,0,256
Iraq,22/01/2003,169,0,-4,0,25,24,0,214
Iraq,23/01/2003,218,0,-2,0,17,16,0,249
Iraq,24/01/2003,109,0,-6,0,8,25,0,136
Iraq,25/01/2003,106,0,5,0,4,30,0,145
Iraq,26/01/2003,119,0,0,0,22,24,0,165
Iraq,27/01/2003,128,0,2,0,14,28,0,172
Iraq,28/01/2003,208,1,8,0,15,34,0,266
Iraq,29/01/2003,284,0,-2,0,22,36,0,340
Iraq,30/01/2003,209,0,4,0,-2,38,0,249
Iraq,31/01/2003,194,6,6,0,12,23,0,241
Iraq,01/02/2003,99,0,10,0,24,16,0,149
Iraq,02/02/2003,83,0,3,0,15,14,0,115
Iraq,03/02/2003,148,0,1,0,19,9,0,177
Iraq,04/02/2003,149,2,1,0,10,18,0,180
Iraq,05/02/2003,211,6,6,0,31,14,0,268
Iraq,06/02/2003,235,0,8,0,20,41,0,304
Iraq,07/02/2003,189,0,3,0,13,33,0,238
Iraq,08/02/2003,138,0,3,0,12,23,0,176
Iraq,09/02/2003,145,0,-1,0,4,23,0,171
Iraq,10/02/2003,206,2,-1,0,22,25,0,254
Iraq,11/02/2003,213,4,-4,0,20,36,0,269
Iraq,12/02/2003,282,2,3,0,16,24,0,327
Iraq,13/02/2003,225,6,8,0,3,25,0,267
Iraq,14/02/2003,204,0,3,0,61,41,0,309
Iraq,15/02/2003,154,8,-10,0,50,127,0,329
Iraq,16/02/2003,156,2,-1,0,16,42,0,215
Iraq,17/02/2003,208,2,3,0,10,61,0,284
Iraq,18/02/2003,244,2,6,0,11,38,0,301
Iraq,19/02/2003,259,4,4,0,3,55,0,325
Iraq,20/02/2003,171,2,3,0,26,37,0,239
Iraq,21/02/2003,181,2,2,0,68,29,0,282
Iraq,22/02/2003,153,0,0,0,20,22,0,195
Iraq,23/02/2003,182,0,5,0,15,20,0,222
Iraq,24/02/2003,192,0,2,0,21,19,0,234
Iraq,25/02/2003,223,2,-3,0,10,29,0,261
Iraq,26/02/2003,260,8,-4,0,8,40,0,312
Iraq,27/02/2003,202,4,-2,0,10,30,0,244
Iraq,28/02/2003,205,0,-17,0,7,28,0,223
Iraq,01/03/2003,155,0,-7,0,29,46,0,223
Iraq,02/03/2003,121,0,-2,0,26,31,0,176
Iraq,03/03/2003,205,4,-5,0,35,26,0,265
Iraq,04/03/2003,221,4,-2,0,18,20,0,261
Iraq,05/03/2003,305,0,-9,0,48,48,0,392
Iraq,06/03/2003,261,0,-2,0,24,24,0,307
Iraq,07/03/2003,319,4,17,0,68,38,0,446
Iraq,08/03/2003,189,0,1,0,37,43,0,270
Iraq,09/03/2003,194,0,-21,0,34,46,0,253
Iraq,10/03/2003,262,4,-26,0,38,55,0,333
Iraq,11/03/2003,265,6,-15,0,36,25,0,317
Iraq,12/03/2003,231,8,-1,0,7,39,0,284
Iraq,13/03/2003,317,2,-6,0,7,33,0,353
Iraq,14/03/2003,325,0,-7,0,9,56,0,383
Iraq,15/03/2003,196,0,1,0,24,58,0,279
Iraq,16/03/2003,197,4,4,0,29,47,0,281
Iraq,17/03/2003,382,8,-17,0,47,42,0,462
Iraq,18/03/2003,594,2,-24,0,104,97,0,773
Iraq,19/03/2003,648,4,1,0,35,88,0,776
Iraq,20/03/2003,1119,20,10,0,175,196,0,1520
Iraq,21/03/2003,885,18,5,0,130,185,0,1223
Iraq,22/03/2003,538,4,-1,0,99,94,0,734
Iraq,23/03/2003,490,0,3,0,101,70,0,664
Iraq,24/03/2003,382,2,-5,0,139,88,0,606
Iraq,25/03/2003,415,20,0,0,142,94,0,671
Iraq,26/03/2003,518,12,-4,0,78,100,0,704
Iraq,27/03/2003,332,4,-5,0,57,74,0,462
Iraq,28/03/2003,330,24,5,0,49,85,0,493
Iraq,29/03/2003,398,6,0,0,60,85,0,549
Iraq,30/03/2003,201,2,-1,0,39,40,0,281
Iraq,31/03/2003,399,6,-2,0,44,104,0,551
Iraq,01/04/2003,398,6,-7,0,58,98,0,553
Iraq,02/04/2003,413,0,1,0,23,52,0,489
Iraq,03/04/2003,377,10,0,0,40,54,0,481
Iraq,04/04/2003,258,18,-1,0,45,60,0,380
Iraq,05/04/2003,196,4,2,0,28,54,0,284
Iraq,06/04/2003,233,0,6,0,22,50,0,311
Iraq,07/04/2003,276,14,2,0,21,53,0,366
Iraq,08/04/2003,400,10,6,0,86,49,0,551
Iraq,09/04/2003,242,2,-3,0,55,42,0,338
Iraq,10/04/2003,256,8,4,0,42,39,0,349
Iraq,11/04/2003,277,2,2,0,47,51,0,379
Iraq,12/04/2003,159,2,-2,0,1,60,0,220
Iraq,13/04/2003,235,0,3,0,50,32,0,320
Iraq,14/04/2003,262,0,0,0,60,38,0,360
Iraq,15/04/2003,228,1,-1,0,17,45,0,290
Iraq,16/04/2003,283,6,-7,0,9,39,0,330
Iraq,17/04/2003,155,2,0,0,31,19,0,207
Iraq,18/04/2003,128,1,3,0,26,26,0,184
Iraq,19/04/2003,129,2,-1,0,-4,33,0,159
Iraq,20/04/2003,118,2,0,0,4,21,0,145
Iraq,21/04/2003,188,5,-1,0,37,16,0,245
Iraq,22/04/2003,108,0,-5,0,21,20,0,144
Iraq,23/04/2003,123,2,0,0,19,31,0,175
Iraq,24/04/2003,131,2,-2,0,8,18,0,157
Iraq,25/04/2003,93,0,0,0,49,9,0,151
Iraq,26/04/2003,60,2,2,0,22,13,0,99
Iraq,27/04/2003,55,0,-11,0,33,16,0,93
Iraq,28/04/2003,76,1,0,0,-3,21,0,95
Iraq,29/04/2003,141,4,-4,0,14,15,0,170
Iraq,30/04/2003,162,0,-1,0,23,12,0,196
Iraq,01/05/2003,99,0,0,0,16,11,0,126
Iraq,02/05/2003,111,2,-4,0,15,3,0,127
Iraq,03/05/2003,88,0,0,0,4,8,0,100
Iraq,04/05/2003,77,0,2,0,10,0,0,89
Iraq,05/05/2003,88,0,-3,0,12,14,0,111
Iraq,06/05/2003,140,0,-9,0,0,14,0,145
Iraq,07/05/2003,102,7,-2,0,3,15,0,125
Iraq,08/05/2003,114,2,-5,0,13,15,0,139
Iraq,09/05/2003,90,4,-1,0,17,8,0,118
Iraq,10/05/2003,103,1,5,0,9,4,0,122
Iraq,11/05/2003,55,0,-3,0,-2,17,0,67
Iraq,12/05/2003,95,2,-13,0,15,18,0,117
Iraq,13/05/2003,64,4,-5,0,31,5,0,99
Iraq,14/05/2003,121,1,-11,0,0,2,0,113
Iraq,15/05/2003,92,2,1,0,16,8,0,119
Iraq,16/05/2003,26,1,0,0,3,10,0,40
Iraq,17/05/2003,21,0,-1,0,21,10,0,51
Iraq,18/05/2003,78,4,0,0,-13,14,0,83
Iraq,19/05/2003,84,2,-4,0,1,20,0,103
Iraq,20/05/2003,81,0,0,0,8,8,0,97
Iraq,21/05/2003,123,2,0,0,7,10,0,142
Iraq,22/05/2003,149,2,1,0,1,25,0,178
Iraq,23/05/2003,89,3,-3,0,45,10,0,144
Iraq,24/05/2003,52,2,0,0,21,9,0,84
Iraq,25/05/2003,54,3,0,0,7,3,0,67
Iraq,26/05/2003,43,0,-1,0,12,9,0,63
Iraq,27/05/2003,49,0,0,0,-3,5,0,51
Iraq,28/05/2003,65,2,-2,0,15,3,0,83
Iraq,29/05/2003,85,0,-2,0,25,7,0,115
Iraq,30/05/2003,43,0,2,0,34,9,0,88
Iraq,31/05/2003,40,0,-3,0,-3,0,0,34
Iraq,01/06/2003,59,2,3,0,12,12,0,88
Iraq,02/06/2003,55,2,-2,0,9,15,0,79
Iraq,03/06/2003,72,0,-3,0,23,10,0,102
Iraq,04/06/2003,25,0,-2,0,11,5,0,39
Iraq,05/06/2003,131,0,-2,0,8,13,0,150
Iraq,06/06/2003,57,0,4,0,15,2,0,78
Iraq,07/06/2003,31,0,0,0,6,2,0,39
Iraq,08/06/2003,32,0,-6,0,31,2,0,59
Iraq,09/06/2003,46,2,0,0,-4,5,0,49
Iraq,10/06/2003,46,0,0,0,-5,10,0,51
Iraq,11/06/2003,57,6,-2,0,7,9,0,77
Iraq,12/06/2003,52,0,-4,0,19,3,0,70
Iraq,13/06/2003,55,2,0,0,7,6,0,70
Iraq,14/06/2003,32,0,0,0,-2,6,0,36
Iraq,15/06/2003,55,0,-4,0,12,2,0,65
Iraq,16/06/2003,70,0,-10,0,34,12,0,106
Iraq,17/06/2003,76,0,-6,0,23,7,0,100
Iraq,18/06/2003,72,0,-2,0,12,24,0,106
Iraq,19/06/2003,59,0,-10,0,9,10,0,68
Iraq,20/06/2003,51,6,-11,0,24,12,0,82
Iraq,21/06/2003,53,0,0,0,3,9,0,65
Iraq,22/06/2003,22,0,0,0,9,6,0,37
Iraq,23/06/2003,57,2,1,0,7,9,0,76
Iraq,24/06/2003,98,0,-8,0,15,8,0,113
Iraq,25/06/2003,61,8,0,0,4,8,0,81
Iraq,26/06/2003,36,0,-2,0,13,6,0,53
Iraq,27/06/2003,65,2,-4,0,12,17,0,92
Iraq,28/06/2003,33,0,0,0,28,5,0,66
Iraq,29/06/2003,54,0,0,0,9,12,0,75
Iraq,30/06/2003,38,4,-7,0,6,15,0,56
Iraq,01/07/2003,54,4,-4,0,7,5,0,66
Iraq,02/07/2003,51,0,0,0,-2,12,0,61
Iraq,03/07/2003,100,2,-2,0,-13,5,0,92
Iraq,04/07/2003,67,2,1,0,13,12,0,95
Iraq,05/07/2003,35,0,1,0,15,4,0,55
Iraq,06/07/2003,62,0,0,0,18,8,0,88
Iraq,07/07/2003,83,8,0,0,6,8,0,105
Iraq,08/07/2003,85,0,-2,0,21,14,0,118
Iraq,09/07/2003,99,4,-4,0,11,5,0,115
Iraq,10/07/2003,80,0,0,0,13,11,0,104
Iraq,11/07/2003,89,0,0,0,9,3,0,101
Iraq,12/07/2003,47,8,-3,0,-2,17,0,67
Iraq,13/07/2003,79,2,1,0,-2,3,0,83
Iraq,14/07/2003,45,2,-9,0,-8,9,0,39
Iraq,15/07/2003,44,8,-1,0,-7,9,0,53
Iraq,16/07/2003,79,2,-4,0,-1,20,0,96
Iraq,17/07/2003,87,2,-4,0,15,2,0,102
Iraq,18/07/2003,117,8,3,0,22,19,0,169
Iraq,19/07/2003,81,0,5,0,39,4,0,129
Iraq,20/07/2003,90,2,-3,0,38,8,0,135
Iraq,21/07/2003,138,0,-6,0,20,3,0,155
Iraq,22/07/2003,116,2,-1,0,10,13,0,140
Iraq,23/07/2003,133,4,0,0,17,12,0,166
Iraq,24/07/2003,65,0,-4,0,4,6,0,71
Iraq,25/07/2003,52,0,1,0,-10,15,0,58
Iraq,26/07/2003,58,0,0,0,32,11,0,101
Iraq,27/07/2003,76,0,0,0,16,7,0,99
Iraq,28/07/2003,54,2,-6,0,8,7,0,65
Iraq,29/07/2003,56,2,1,0,-1,8,0,66
Iraq,30/07/2003,52,2,0,0,7,13,0,74
Iraq,31/07/2003,46,2,5,0,15,4,0,72
Iraq,01/08/2003,56,0,0,0,8,14,0,78
Iraq,02/08/2003,21,0,-4,0,7,0,0,24
Iraq,03/08/2003,16,0,-7,0,-2,3,0,10
Iraq,04/08/2003,33,0,2,0,12,5,0,52
Iraq,05/08/2003,74,0,2,0,6,5,0,87
Iraq,06/08/2003,66,2,3,0,-3,5,0,73
Iraq,07/08/2003,53,2,-1,0,22,7,0,83
Iraq,08/08/2003,57,0,-4,0,12,3,0,68
Iraq,09/08/2003,21,0,0,0,9,11,0,41
Iraq,10/08/2003,57,0,0,0,1,5,0,63
Iraq,11/08/2003,57,2,2,0,16,10,0,87
Iraq,12/08/2003,114,0,0,0,20,16,0,150
Iraq,13/08/2003,57,0,0,0,6,5,0,68
Iraq,14/08/2003,75,2,8,0,11,5,0,101
Iraq,15/08/2003,55,0,0,0,-3,4,0,56
Iraq,16/08/2003,25,2,-2,0,-6,6,0,25
Iraq,17/08/2003,48,0,-1,0,4,4,0,55
Iraq,18/08/2003,62,0,0,0,34,5,0,101
Iraq,19/08/2003,87,2,-2,0,18,10,0,115
Iraq,20/08/2003,70,2,0,0,-2,7,0,77
Iraq,21/08/2003,79,4,2,0,12,5,0,102
Iraq,22/08/2003,76,2,0,0,14,13,0,105
Iraq,23/08/2003,37,0,0,0,10,3,0,50
Iraq,24/08/2003,32,0,0,0,-2,6,0,36
Iraq,25/08/2003,69,0,-2,0,-8,3,0,62
Iraq,26/08/2003,78,0,0,0,13,7,0,98
Iraq,27/08/2003,53,0,0,0,4,6,0,63
Iraq,28/08/2003,45,0,-4,0,21,15,0,77
Iraq,29/08/2003,99,2,-13,0,10,9,0,107
Iraq,30/08/2003,38,0,-4,0,5,8,0,47
Iraq,31/08/2003,56,0,-1,0,9,18,0,82
Iraq,01/09/2003,138,0,-1,0,44,12,0,193
Iraq,02/09/2003,76,0,-6,0,26,13,0,109
Iraq,03/09/2003,139,0,-3,0,22,10,0,168
Iraq,04/09/2003,93,4,-2,0,6,12,0,113
Iraq,05/09/2003,131,0,-2,0,19,19,0,167
Iraq,06/09/2003,35,2,2,0,-1,6,0,44
Iraq,07/09/2003,109,0,0,0,7,4,0,120
Iraq,08/09/2003,140,14,-5,0,17,24,0,190
Iraq,09/09/2003,129,16,-5,0,8,10,0,158
Iraq,10/09/2003,133,0,-1,0,14,18,0,164
Iraq,11/09/2003,166,2,-1,0,7,17,0,191
Iraq,12/09/2003,108,0,-3,0,-4,10,0,111
Iraq,13/09/2003,40,10,3,0,6,10,0,69
Iraq,14/09/2003,47,2,0,0,15,9,0,73
Iraq,15/09/2003,28,2,-2,0,0,3,0,31
Iraq,16/09/2003,96,0,-4,0,8,9,0,109
Iraq,17/09/2003,72,2,-6,0,14,8,0,90
Iraq,18/09/2003,51,4,-1,0,17,13,0,84
Iraq,19/09/2003,80,4,2,0,0,8,0,94
Iraq,20/09/2003,65,6,3,0,0,6,0,80
Iraq,21/09/2003,36,2,2,0,-4,1,0,37
Iraq,22/09/2003,93,2,-2,0,16,6,0,115
Iraq,23/09/2003,108,4,-4,0,16,2,0,126
Iraq,24/09/2003,90,8,-5,0,19,13,0,125
Iraq,25/09/2003,109,0,-6,0,20,12,0,135
Iraq,26/09/2003,80,0,-5,0,2,7,0,84
Iraq,27/09/2003,63,10,1,0,-5,16,0,85
Iraq,28/09/2003,54,0,2,0,5,16,0,77
Iraq,29/09/2003,47,0,-1,0,-4,5,0,47
Iraq,30/09/2003,82,0,2,0,1,11,0,96
Iraq,01/10/2003,45,8,-3,0,6,13,0,69
Iraq,02/10/2003,91,8,2,0,51,7,0,159
Iraq,03/10/2003,125,2,-4,0,20,7,0,150
Iraq,04/10/2003,89,2,0,0,22,15,0,128
Iraq,05/10/2003,57,0,-4,0,3,5,0,61
Iraq,06/10/2003,54,0,1,0,-4,6,0,57
Iraq,07/10/2003,101,0,0,0,3,8,0,112
Iraq,08/10/2003,59,2,1,0,1,8,0,71
Iraq,09/10/2003,86,0,1,0,9,4,0,100
Iraq,10/10/2003,91,2,3,0,9,5,0,110
Iraq,11/10/2003,86,2,1,0,7,6,0,102
Iraq,12/10/2003,92,2,-2,0,18,10,0,120
Iraq,13/10/2003,104,16,-2,0,-4,10,0,124
Iraq,14/10/2003,85,2,-3,0,27,10,0,121
Iraq,15/10/2003,82,2,-3,0,11,13,0,105
Iraq,16/10/2003,100,4,0,0,-3,22,0,123
Iraq,17/10/2003,96,0,-3,0,-3,6,0,96
Iraq,18/10/2003,53,4,-2,0,-3,3,0,55
Iraq,19/10/2003,42,12,0,0,18,11,0,83
Iraq,20/10/2003,96,8,1,0,0,10,0,115
Iraq,21/10/2003,84,4,-7,0,-2,5,0,84
Iraq,22/10/2003,77,6,2,0,23,7,0,115
Iraq,23/10/2003,99,14,1,0,50,11,0,175
Iraq,24/10/2003,42,10,0,0,8,4,0,64
Iraq,25/10/2003,58,6,0,0,6,26,0,96
Iraq,26/10/2003,33,6,-2,0,12,7,0,56
Iraq,27/10/2003,62,2,0,0,27,8,0,99
Iraq,28/10/2003,123,2,2,0,5,7,0,139
Iraq,29/10/2003,72,0,1,0,3,9,0,85
Iraq,30/10/2003,34,2,0,0,19,4,0,59
Iraq,31/10/2003,27,6,1,0,6,8,0,48
Iraq,01/11/2003,40,0,1,0,8,6,0,55
Iraq,02/11/2003,80,2,0,0,-1,4,0,85
Iraq,03/11/2003,81,0,0,0,16,7,0,104
Iraq,04/11/2003,160,0,0,0,18,8,0,186
Iraq,05/11/2003,21,4,0,0,4,5,0,34
Iraq,06/11/2003,46,0,-1,0,-3,5,0,47
Iraq,07/11/2003,90,0,1,0,2,9,0,102
Iraq,08/11/2003,51,0,0,0,3,4,0,58
Iraq,09/11/2003,69,0,0,0,11,22,0,102
Iraq,10/11/2003,82,0,-2,0,38,13,0,131
Iraq,11/11/2003,58,0,0,0,-2,8,0,64
Iraq,12/11/2003,115,2,0,0,12,19,0,148
Iraq,13/11/2003,127,4,-3,0,17,28,0,173
Iraq,14/11/2003,83,0,-4,0,5,16,0,100
Iraq,15/11/2003,81,0,-9,0,6,14,0,92
Iraq,16/11/2003,43,0,0,0,4,18,0,65
Iraq,17/11/2003,93,0,1,0,16,20,0,130
Iraq,18/11/2003,84,0,-11,0,-3,5,0,75
Iraq,19/11/2003,137,2,-2,0,21,19,0,177
Iraq,20/11/2003,108,0,0,0,5,9,0,122
Iraq,21/11/2003,98,2,0,0,6,24,0,130
Iraq,22/11/2003,59,0,-2,0,0,7,0,64
Iraq,23/11/2003,75,0,0,0,9,4,0,88
Iraq,24/11/2003,69,0,-2,0,11,31,0,109
Iraq,25/11/2003,49,0,-2,0,3,5,0,55
Iraq,26/11/2003,26,0,0,0,-5,3,0,24
Iraq,27/11/2003,59,0,-8,0,23,6,0,80
Iraq,28/11/2003,55,4,-6,0,17,18,0,88
Iraq,29/11/2003,34,0,-4,0,18,8,0,56
Iraq,30/11/2003,64,2,0,0,-4,11,0,73
Iraq,01/12/2003,136,0,0,0,29,13,0,178
Iraq,02/12/2003,125,0,1,0,17,6,0,149
Iraq,03/12/2003,50,4,0,0,15,3,0,72
Iraq,04/12/2003,91,2,4,0,49,15,0,161
Iraq,05/12/2003,52,0,0,0,5,7,0,64
Iraq,06/12/2003,50,4,0,0,8,7,0,69
Iraq,07/12/2003,37,0,0,0,12,2,0,51
Iraq,08/12/2003,75,0,-5,0,-9,13,0,74
Iraq,09/12/2003,76,0,-1,0,48,12,0,135
Iraq,10/12/2003,58,0,3,0,17,10,0,88
Iraq,11/12/2003,93,10,0,0,45,24,0,172
Iraq,12/12/2003,73,8,0,0,24,5,0,110
Iraq,13/12/2003,49,0,1,0,21,16,0,87
Iraq,14/12/2003,74,0,-2,0,117,8,0,197
Iraq,15/12/2003,102,2,0,0,105,6,0,215
Iraq,16/12/2003,137,2,-2,0,69,18,0,224
Iraq,17/12/2003,87,0,-3,0,47,15,0,146
Iraq,18/12/2003,108,2,1,0,55,16,0,182
Iraq,19/12/2003,56,4,2,0,24,12,0,98
Iraq,20/12/2003,68,0,0,0,35,12,0,115
Iraq,21/12/2003,66,0,-3,0,31,1,0,95
Iraq,22/12/2003,64,0,0,0,40,10,0,114
Iraq,23/12/2003,75,0,0,0,14,8,0,97
Iraq,24/12/2003,38,2,0,0,27,3,0,70
Iraq,25/12/2003,28,4,0,0,-1,1,0,32
Iraq,26/12/2003,58,0,0,0,1,13,0,72
Iraq,27/12/2003,37,2,0,0,36,6,0,81
Iraq,28/12/2003,16,0,-2,0,1,4,0,19
Iraq,29/12/2003,27,2,1,0,4,2,0,36
Iraq,30/12/2003,37,2,1,0,7,17,0,64
Iraq,31/12/2003,52,2,1,0,7,3,0,65
Morocco,01/01/2003,2,0,0,0,0,0,0,2
Morocco,02/01/2003,0,0,0,0,0,0,0,0
Morocco,03/01/2003,0,0,0,0,6,2,0,8
Morocco,04/01/2003,6,0,0,0,0,0,0,6
Morocco,05/01/2003,0,0,0,0,0,0,0,0
Morocco,06/01/2003,0,0,0,0,0,0,0,0
Morocco,07/01/2003,10,0,0,0,3,0,0,13
Morocco,08/01/2003,2,0,0,0,8,0,0,10
Morocco,09/01/2003,2,0,0,0,6,0,0,8
Morocco,10/01/2003,0,0,0,0,0,0,0,0
Morocco,11/01/2003,0,0,0,0,0,0,0,0
Morocco,12/01/2003,4,0,0,0,0,0,0,4
Morocco,13/01/2003,0,0,0,0,6,0,0,6
Morocco,14/01/2003,2,0,0,0,0,0,0,2
Morocco,15/01/2003,6,0,0,0,18,0,0,24
Morocco,16/01/2003,0,0,0,0,2,0,0,2
Morocco,17/01/2003,4,0,0,0,0,0,0,4
Morocco,18/01/2003,-15,0,0,0,0,0,0,-15
Morocco,19/01/2003,2,0,0,0,6,0,0,8
Morocco,20/01/2003,0,0,0,0,0,0,0,0
Morocco,21/01/2003,2,0,0,0,6,0,0,8
Morocco,22/01/2003,1,0,0,0,3,1,0,5
Morocco,23/01/2003,6,0,0,0,8,0,0,14
Morocco,24/01/2003,3,0,0,0,27,0,0,30
Morocco,25/01/2003,0,0,0,0,3,0,0,3
Morocco,26/01/2003,0,0,0,0,0,0,0,0
Morocco,27/01/2003,1,0,0,0,3,2,0,6
Morocco,28/01/2003,5,2,0,0,0,2,0,9
Morocco,29/01/2003,0,0,0,0,-2,0,0,-2
Morocco,30/01/2003,-1,0,0,0,3,1,0,3
Morocco,31/01/2003,-3,0,0,0,9,0,0,6
Morocco,01/02/2003,11,0,0,0,4,0,0,15
Morocco,02/02/2003,0,0,0,0,0,0,0,0
Morocco,03/02/2003,3,0,0,0,0,0,0,3
Morocco,04/02/2003,6,0,0,0,9,0,0,15
Morocco,05/02/2003,9,0,0,0,12,6,0,27
Morocco,06/02/2003,2,0,0,0,0,0,0,2
Morocco,07/02/2003,0,0,0,0,0,0,0,0
Morocco,09/02/2003,0,0,0,0,-2,0,0,-2
Morocco,10/02/2003,3,0,0,0,1,2,0,6
Morocco,11/02/2003,-1,0,0,0,-4,0,0,-5
Morocco,12/02/2003,12,2,0,0,2,0,0,16
Morocco,13/02/2003,2,0,0,0,-4,0,0,-2
Morocco,14/02/2003,0,0,0,0,0,0,0,0
Morocco,15/02/2003,0,0,-2,0,0,0,0,-2
Morocco,16/02/2003,0,0,0,0,0,0,0,0
Morocco,17/02/2003,3,0,0,0,0,1,0,4
Morocco,18/02/2003,1,0,0,0,6,0,0,7
Morocco,19/02/2003,22,0,0,0,33,0,0,55
Morocco,20/02/2003,-2,0,0,0,0,2,0,0
Morocco,21/02/2003,0,0,0,0,-2,0,0,-2
Morocco,22/02/2003,0,0,0,0,9,0,0,9
Morocco,23/02/2003,3,0,0,0,0,0,0,3
Morocco,24/02/2003,0,0,0,0,0,0,0,0
Morocco,25/02/2003,5,0,0,0,0,0,0,5
Morocco,26/02/2003,0,0,0,0,-2,0,0,-2
Morocco,27/02/2003,5,0,0,0,1,0,0,6
Morocco,28/02/2003,4,0,0,0,0,0,0,4
Morocco,01/03/2003,0,0,0,0,3,0,0,3
Morocco,02/03/2003,0,0,0,0,0,0,0,0
Morocco,03/03/2003,0,0,0,0,0,0,0,0
Morocco,04/03/2003,14,0,0,0,0,1,0,15
Morocco,05/03/2003,-2,0,0,0,-3,0,0,-5
Morocco,06/03/2003,5,0,0,0,3,0,0,8
Morocco,07/03/2003,8,0,0,0,0,0,0,8
Morocco,08/03/2003,2,0,0,0,3,0,0,5
Morocco,10/03/2003,2,0,0,0,3,1,0,6
Morocco,11/03/2003,0,0,0,0,-9,0,0,-9
Morocco,12/03/2003,15,0,0,0,0,0,0,15
Morocco,13/03/2003,0,0,0,0,6,0,0,6
Morocco,14/03/2003,-1,0,0,0,0,0,0,-1
Morocco,15/03/2003,2,0,0,0,21,1,0,24
Morocco,16/03/2003,0,0,0,0,6,0,0,6
Morocco,17/03/2003,0,0,0,0,15,0,0,15
Morocco,18/03/2003,2,0,0,0,6,0,0,8
Morocco,19/03/2003,2,0,0,0,7,0,0,9
Morocco,20/03/2003,0,0,0,0,9,0,0,9
Morocco,21/03/2003,1,0,0,0,0,0,0,1
Morocco,22/03/2003,0,0,0,0,0,2,0,2
Morocco,23/03/2003,0,0,0,0,3,0,0,3
Morocco,24/03/2003,0,0,0,0,3,0,0,3
Morocco,25/03/2003,3,0,0,0,0,0,0,3
Morocco,26/03/2003,4,0,0,0,-4,0,0,0
Morocco,27/03/2003,4,0,0,0,0,0,0,4
Morocco,28/03/2003,0,0,0,0,0,0,0,0
Morocco,29/03/2003,0,0,0,0,3,0,0,3
Morocco,30/03/2003,0,0,0,0,0,4,0,4
Morocco,31/03/2003,0,0,0,0,6,0,0,6
Morocco,01/04/2003,3,0,1,0,9,0,0,13
Morocco,02/04/2003,0,0,0,0,5,0,0,5
Morocco,03/04/2003,0,0,0,0,0,0,0,0
Morocco,04/04/2003,2,0,0,0,0,0,0,2
Morocco,06/04/2003,0,0,0,0,2,4,0,6
Morocco,07/04/2003,0,0,0,0,0,0,0,0
Morocco,08/04/2003,0,0,0,0,0,0,0,0
Morocco,09/04/2003,0,0,0,0,3,0,0,3
Morocco,10/04/2003,0,0,0,0,-4,0,0,-4
Morocco,11/04/2003,4,0,0,0,0,0,0,4
Morocco,12/04/2003,0,0,-1,0,0,0,0,-1
Morocco,14/04/2003,-1,0,0,0,0,0,0,-1
Morocco,15/04/2003,0,0,0,0,0,3,0,3
Morocco,16/04/2003,0,0,0,0,0,0,0,0
Morocco,17/04/2003,0,0,0,0,0,0,0,0
Morocco,18/04/2003,-1,0,0,0,6,2,0,7
Morocco,19/04/2003,1,0,0,0,0,0,0,1
Morocco,20/04/2003,6,0,0,0,6,0,0,12
Morocco,22/04/2003,6,0,0,0,3,2,0,11
Morocco,23/04/2003,0,0,0,0,0,0,0,0
Morocco,24/04/2003,0,0,0,0,6,0,0,6
Morocco,25/04/2003,0,0,0,0,3,4,0,7
Morocco,26/04/2003,0,0,0,0,0,0,0,0
Morocco,28/04/2003,0,0,0,0,0,0,0,0
Morocco,29/04/2003,0,0,0,0,0,0,0,0
Morocco,30/04/2003,0,0,0,0,0,0,0,0
Morocco,01/05/2003,0,0,0,0,0,1,0,1
Morocco,03/05/2003,6,0,0,0,3,1,0,10
Morocco,04/05/2003,7,0,0,0,0,0,0,7
Morocco,05/05/2003,2,0,0,0,16,0,0,18
Morocco,06/05/2003,0,0,0,0,0,0,0,0
Morocco,07/05/2003,-1,0,0,0,0,0,0,-1
Morocco,08/05/2003,-1,0,0,0,-1,0,0,-2
Morocco,09/05/2003,15,0,0,0,4,0,0,19
Morocco,10/05/2003,0,0,0,0,6,0,0,6
Morocco,11/05/2003,0,0,0,0,3,0,0,3
Morocco,12/05/2003,1,0,0,0,9,0,0,10
Morocco,13/05/2003,5,0,0,0,-4,0,0,1
Morocco,14/05/2003,0,0,0,0,-2,0,0,-2
Morocco,15/05/2003,10,0,0,0,0,0,0,10
Morocco,16/05/2003,6,0,0,0,3,0,0,9
Morocco,17/05/2003,6,0,0,0,3,3,0,12
Morocco,18/05/2003,13,0,0,0,3,9,0,25
Morocco,19/05/2003,9,0,0,0,24,6,0,39
Morocco,20/05/2003,9,0,2,0,3,1,0,15
Morocco,21/05/2003,21,0,0,0,24,3,0,48
Morocco,22/05/2003,2,0,0,0,21,1,0,24
Morocco,23/05/2003,4,0,0,0,6,0,0,10
Morocco,24/05/2003,3,0,0,0,0,0,0,3
Morocco,25/05/2003,3,0,0,0,6,0,0,9
Morocco,26/05/2003,0,0,0,0,0,0,0,0
Morocco,27/05/2003,12,0,0,0,0,0,0,12
Morocco,28/05/2003,-2,0,0,0,0,0,0,-2
Morocco,29/05/2003,1,0,0,0,0,0,0,1
Morocco,30/05/2003,12,0,0,0,0,0,0,12
Morocco,31/05/2003,23,0,0,0,5,0,0,28
Morocco,01/06/2003,0,0,0,0,0,0,0,0
Morocco,02/06/2003,3,0,0,0,3,0,0,6
Morocco,03/06/2003,3,0,0,0,10,0,0,13
Morocco,04/06/2003,1,0,0,0,0,0,0,1
Morocco,05/06/2003,-4,0,0,0,27,1,0,24
Morocco,06/06/2003,6,0,0,0,39,1,0,46
Morocco,07/06/2003,9,0,0,0,15,0,0,24
Morocco,08/06/2003,3,0,0,0,0,0,0,3
Morocco,09/06/2003,6,0,0,0,6,0,0,12
Morocco,10/06/2003,0,0,0,0,0,0,0,0
Morocco,11/06/2003,0,0,0,0,0,0,0,0
Morocco,12/06/2003,0,0,3,0,3,0,0,6
Morocco,13/06/2003,0,0,0,0,0,0,0,0
Morocco,14/06/2003,0,0,0,0,0,0,0,0
Morocco,15/06/2003,4,0,0,0,0,0,0,4
Morocco,16/06/2003,6,0,0,0,-4,1,0,3
Morocco,17/06/2003,1,0,0,0,3,0,0,4
Morocco,18/06/2003,0,0,0,0,0,0,0,0
Morocco,19/06/2003,-1,0,0,0,3,0,0,2
Morocco,20/06/2003,45,0,0,0,21,1,0,67
Morocco,21/06/2003,0,0,0,0,0,0,0,0
Morocco,22/06/2003,0,0,0,0,0,0,0,0
Morocco,23/06/2003,0,0,0,0,6,1,0,7
Morocco,24/06/2003,37,0,0,0,6,0,0,43
Morocco,25/06/2003,1,0,0,0,-3,0,0,-2
Morocco,26/06/2003,-1,0,0,0,0,0,0,-1
Morocco,27/06/2003,0,0,0,0,9,0,0,9
Morocco,28/06/2003,0,0,0,0,0,0,0,0
Morocco,29/06/2003,0,0,0,0,1,0,0,1
Morocco,30/06/2003,1,0,0,0,3,0,0,4
Morocco,01/07/2003,2,0,0,0,6,0,0,8
Morocco,02/07/2003,7,0,0,0,18,0,0,25
Morocco,03/07/2003,0,0,0,0,0,0,0,0
Morocco,04/07/2003,1,0,0,0,0,0,0,1
Morocco,05/07/2003,0,0,0,0,0,0,0,0
Morocco,06/07/2003,0,0,0,0,3,0,0,3
Morocco,07/07/2003,0,0,0,0,0,0,0,0
Morocco,08/07/2003,0,0,0,0,2,0,0,2
Morocco,09/07/2003,1,0,0,0,0,0,0,1
Morocco,10/07/2003,0,0,0,0,2,0,0,2
Morocco,11/07/2003,6,0,0,0,6,0,0,12
Morocco,12/07/2003,3,0,1,0,0,0,0,4
Morocco,13/07/2003,0,0,0,0,0,0,0,0
Morocco,14/07/2003,5,0,0,0,0,0,0,5
Morocco,15/07/2003,1,0,0,0,0,0,0,1
Morocco,16/07/2003,2,0,-1,0,6,0,0,7
Morocco,17/07/2003,6,0,0,0,0,0,0,6
Morocco,18/07/2003,6,0,0,0,0,0,0,6
Morocco,19/07/2003,0,0,0,0,0,0,0,0
Morocco,20/07/2003,0,0,0,0,0,0,0,0
Morocco,22/07/2003,4,0,0,0,0,0,0,4
Morocco,23/07/2003,-3,0,0,0,3,0,0,0
Morocco,24/07/2003,2,0,0,0,3,0,0,5
Morocco,25/07/2003,1,0,0,0,9,0,0,10
Morocco,26/07/2003,8,0,0,0,0,0,0,8
Morocco,27/07/2003,0,0,0,0,0,0,0,0
Morocco,28/07/2003,-2,0,0,0,0,0,0,-2
Morocco,29/07/2003,11,0,0,0,-2,0,0,9
Morocco,30/07/2003,10,0,0,0,0,2,0,12
Morocco,31/07/2003,6,0,0,0,0,0,0,6
Morocco,01/08/2003,-1,0,0,0,15,0,0,14
Morocco,02/08/2003,3,0,0,0,3,0,0,6
Morocco,03/08/2003,5,0,0,0,0,0,0,5
Morocco,04/08/2003,21,0,0,0,3,0,0,24
Morocco,05/08/2003,2,0,0,0,0,0,0,2
Morocco,06/08/2003,3,0,0,0,15,1,0,19
Morocco,07/08/2003,1,0,0,0,6,0,0,7
Morocco,08/08/2003,0,0,0,0,0,3,0,3
Morocco,09/08/2003,1,0,0,0,0,0,0,1
Morocco,10/08/2003,1,0,0,0,0,1,0,2
Morocco,11/08/2003,4,0,0,0,6,0,0,10
Morocco,12/08/2003,3,0,0,0,6,0,0,9
Morocco,13/08/2003,4,0,0,0,6,0,0,10
Morocco,14/08/2003,8,0,0,0,12,1,0,21
Morocco,15/08/2003,1,0,0,0,-14,0,0,-13
Morocco,16/08/2003,4,0,0,0,-3,0,0,1
Morocco,17/08/2003,-2,0,0,0,-2,0,0,-4
Morocco,18/08/2003,0,0,0,0,0,0,0,0
Morocco,19/08/2003,0,0,0,0,0,0,0,0
Morocco,20/08/2003,0,0,0,0,3,0,0,3
Morocco,22/08/2003,0,0,0,0,0,0,0,0
Morocco,23/08/2003,6,0,0,0,3,0,0,9
Morocco,25/08/2003,0,0,0,0,0,0,0,0
Morocco,26/08/2003,4,0,0,0,0,0,0,4
Morocco,27/08/2003,6,0,0,0,-2,0,0,4
Morocco,28/08/2003,1,0,0,0,9,0,0,10
Morocco,29/08/2003,3,0,0,0,3,0,0,6
Morocco,30/08/2003,1,0,0,0,0,3,0,4
Morocco,31/08/2003,4,0,0,0,9,1,0,14
Morocco,01/09/2003,11,0,0,0,-20,0,0,-9
Morocco,02/09/2003,8,0,0,0,-2,0,0,6
Morocco,03/09/2003,3,0,0,0,0,0,0,3
Morocco,04/09/2003,4,0,2,0,6,0,0,12
Morocco,05/09/2003,0,0,0,0,0,0,0,0
Morocco,06/09/2003,-3,0,0,0,7,0,0,4
Morocco,07/09/2003,3,0,0,0,3,0,0,6
Morocco,08/09/2003,0,0,0,0,-4,0,0,-4
Morocco,09/09/2003,4,0,0,0,6,0,0,10
Morocco,10/09/2003,13,0,0,0,6,1,0,20
Morocco,11/09/2003,2,0,0,0,0,0,0,2
Morocco,12/09/2003,6,0,0,0,0,0,0,6
Morocco,13/09/2003,1,0,0,0,3,1,0,5
Morocco,14/09/2003,0,0,0,0,0,0,0,0
Morocco,15/09/2003,0,0,0,0,0,0,0,0
Morocco,16/09/2003,0,0,0,0,3,0,0,3
Morocco,17/09/2003,3,0,0,0,0,0,0,3
Morocco,18/09/2003,2,0,0,0,12,0,0,14
Morocco,19/09/2003,0,0,0,0,0,0,0,0
Morocco,20/09/2003,2,0,0,0,6,0,0,8
Morocco,21/09/2003,0,0,0,0,0,0,0,0
Morocco,22/09/2003,0,0,0,0,0,0,0,0
Morocco,23/09/2003,5,0,0,0,6,5,0,16
Morocco,24/09/2003,0,0,0,0,0,0,0,0
Morocco,25/09/2003,4,0,-4,0,9,0,0,9
Morocco,26/09/2003,1,0,0,0,9,0,0,10
Morocco,27/09/2003,3,0,0,0,0,0,0,3
Morocco,28/09/2003,0,0,0,0,0,0,0,0
Morocco,29/09/2003,2,0,0,0,0,0,0,2
Morocco,30/09/2003,1,0,0,0,0,0,0,1
Morocco,01/10/2003,6,0,0,0,15,0,0,21
Morocco,02/10/2003,-6,0,0,0,0,0,0,-6
Morocco,03/10/2003,-6,0,0,0,0,1,0,-5
Morocco,04/10/2003,2,0,0,0,0,0,0,2
Morocco,05/10/2003,0,0,0,0,0,0,0,0
Morocco,06/10/2003,0,0,0,0,3,0,0,3
Morocco,07/10/2003,5,0,0,0,0,0,0,5
Morocco,08/10/2003,2,0,0,0,9,2,0,13
Morocco,09/10/2003,0,0,0,0,10,3,0,13
Morocco,10/10/2003,4,0,0,0,9,0,0,13
Morocco,11/10/2003,0,0,0,0,3,0,0,3
Morocco,12/10/2003,-1,0,0,0,0,0,0,-1
Morocco,13/10/2003,3,0,0,0,0,0,0,3
Morocco,14/10/2003,-4,0,0,0,12,0,0,8
Morocco,15/10/2003,0,0,0,0,0,0,0,0
Morocco,16/10/2003,3,0,0,0,6,0,0,9
Morocco,17/10/2003,0,0,0,0,6,1,0,7
Morocco,19/10/2003,1,0,0,0,3,0,0,4
Morocco,20/10/2003,7,0,0,0,6,1,0,14
Morocco,21/10/2003,-2,0,0,0,0,0,0,-2
Morocco,22/10/2003,3,0,0,0,0,0,0,3
Morocco,23/10/2003,4,0,0,0,6,1,0,11
Morocco,24/10/2003,5,0,0,0,9,0,0,14
Morocco,25/10/2003,3,0,0,0,0,0,0,3
Morocco,26/10/2003,4,0,0,0,0,0,0,4
Morocco,27/10/2003,10,0,0,0,1,1,0,12
Morocco,28/10/2003,2,0,0,0,3,2,0,7
Morocco,29/10/2003,15,0,0,0,15,0,0,30
Morocco,30/10/2003,0,0,0,0,0,0,0,0
Morocco,31/10/2003,4,0,0,0,3,0,0,7
Morocco,02/11/2003,0,0,0,0,0,0,0,0
Morocco,03/11/2003,2,0,0,0,0,0,0,2
Morocco,04/11/2003,9,0,0,0,20,0,0,29
Morocco,05/11/2003,0,0,0,0,18,0,0,18
Morocco,06/11/2003,2,0,0,0,12,1,0,15
Morocco,07/11/2003,18,0,0,0,9,0,0,27
Morocco,08/11/2003,5,0,0,0,-6,0,0,-1
Morocco,09/11/2003,3,0,0,0,9,0,0,12
Morocco,10/11/2003,-2,0,0,0,3,0,0,1
Morocco,11/11/2003,3,0,0,0,5,0,0,8
Morocco,12/11/2003,1,0,0,0,4,0,0,5
Morocco,13/11/2003,0,0,0,0,6,1,0,7
Morocco,14/11/2003,2,0,0,0,-5,0,0,-3
Morocco,15/11/2003,6,0,0,0,6,0,0,12
Morocco,16/11/2003,24,0,0,0,0,0,0,24
Morocco,17/11/2003,1,0,0,0,-3,0,0,-2
Morocco,18/11/2003,0,0,0,0,0,0,0,0
Morocco,19/11/2003,3,0,0,0,0,0,0,3
Morocco,20/11/2003,7,0,0,0,9,0,0,16
Morocco,21/11/2003,11,0,0,0,6,0,0,17
Morocco,22/11/2003,15,0,0,0,1,0,0,16
Morocco,23/11/2003,1,0,0,0,6,0,0,7
Morocco,24/11/2003,2,0,0,0,0,0,0,2
Morocco,25/11/2003,0,0,0,0,6,0,0,6
Morocco,26/11/2003,4,0,0,0,9,0,0,13
Morocco,27/11/2003,3,0,0,0,8,3,0,14
Morocco,28/11/2003,2,0,0,0,3,0,0,5
Morocco,29/11/2003,0,0,0,0,3,0,0,3
Morocco,30/11/2003,0,0,0,0,0,0,0,0
Morocco,01/12/2003,4,0,0,0,3,0,0,7
Morocco,02/12/2003,0,0,0,0,6,0,0,6
Morocco,03/12/2003,8,0,0,0,0,0,0,8
Morocco,04/12/2003,3,0,0,0,3,0,0,6
Morocco,05/12/2003,2,0,0,0,3,1,0,6
Morocco,06/12/2003,5,0,0,0,-1,2,0,6
Morocco,07/12/2003,0,0,0,0,3,0,0,3
Morocco,08/12/2003,0,0,0,0,-2,0,0,-2
Morocco,09/12/2003,4,0,0,0,7,0,0,11
Morocco,10/12/2003,0,0,0,0,3,0,0,3
Morocco,11/12/2003,-1,0,0,0,4,0,0,3
Morocco,12/12/2003,2,0,0,0,9,0,0,11
Morocco,13/12/2003,2,0,0,0,3,0,0,5
Morocco,14/12/2003,1,0,0,0,0,0,0,1
Morocco,15/12/2003,-2,0,0,0,-2,0,0,-4
Morocco,16/12/2003,2,0,0,0,-3,0,0,-1
Morocco,17/12/2003,19,0,0,0,15,0,0,34
Morocco,18/12/2003,-1,0,0,0,3,0,0,2
Morocco,19/12/2003,13,0,0,0,6,0,0,19
Morocco,20/12/2003,6,0,2,0,11,0,0,19
Morocco,22/12/2003,3,0,-1,0,0,0,0,2
Morocco,23/12/2003,4,0,0,0,-4,0,0,0
Morocco,24/12/2003,2,0,0,0,-6,0,0,-4
Morocco,25/12/2003,1,0,0,0,-2,0,0,-1
Morocco,26/12/2003,-3,0,0,0,0,0,0,-3
Morocco,27/12/2003,1,0,0,0,0,0,0,1
Morocco,28/12/2003,0,0,0,0,0,0,0,0
Morocco,29/12/2003,0,0,0,0,0,0,0,0
Morocco,30/12/2003,0,0,0,0,9,0,0,9
Nigeria,01/01/2003,-1,0,3,0,9,0,0,11
Nigeria,02/01/2003,4,0,0,0,0,0,0,4
Nigeria,03/01/2003,5,0,0,0,0,0,0,5
Nigeria,04/01/2003,0,0,0,0,0,0,0,0
Nigeria,05/01/2003,11,0,0,0,0,6,0,17
Nigeria,06/01/2003,6,0,0,0,3,3,0,12
Nigeria,07/01/2003,11,0,3,0,0,1,0,15
Nigeria,08/01/2003,12,0,0,0,0,0,0,12
Nigeria,09/01/2003,1,0,0,0,7,2,0,10
Nigeria,10/01/2003,5,0,-2,0,3,0,0,6
Nigeria,11/01/2003,0,0,0,0,0,2,0,2
Nigeria,12/01/2003,2,0,0,0,-2,1,0,1
Nigeria,13/01/2003,7,0,0,0,0,0,0,7
Nigeria,14/01/2003,21,0,0,0,9,1,0,31
Nigeria,15/01/2003,13,0,1,0,0,2,0,16
Nigeria,16/01/2003,15,0,-2,0,7,0,0,20
Nigeria,17/01/2003,6,0,0,0,3,2,0,11
Nigeria,18/01/2003,5,0,-2,0,-4,0,0,-1
Nigeria,19/01/2003,4,0,0,0,3,0,0,7
Nigeria,20/01/2003,20,4,0,0,12,0,0,36
Nigeria,21/01/2003,23,0,-2,0,13,1,0,35
Nigeria,22/01/2003,20,0,-2,0,22,3,0,43
Nigeria,23/01/2003,15,0,0,0,6,0,0,21
Nigeria,24/01/2003,19,0,0,0,6,0,0,25
Nigeria,25/01/2003,-1,0,1,0,1,0,0,1
Nigeria,26/01/2003,8,0,0,0,0,1,0,9
Nigeria,27/01/2003,9,0,0,0,0,1,0,10
Nigeria,28/01/2003,4,0,-4,0,9,2,0,11
Nigeria,29/01/2003,9,0,0,0,0,2,0,11
Nigeria,30/01/2003,15,0,0,0,3,0,0,18
Nigeria,31/01/2003,13,2,0,0,20,0,0,35
Nigeria,01/02/2003,3,0,0,0,0,2,0,5
Nigeria,02/02/2003,1,0,0,0,3,0,0,4
Nigeria,03/02/2003,17,0,0,0,0,1,0,18
Nigeria,04/02/2003,14,0,0,0,12,3,0,29
Nigeria,05/02/2003,17,0,1,0,15,1,0,34
Nigeria,06/02/2003,6,0,1,0,7,3,0,17
Nigeria,07/02/2003,1,0,0,0,-2,2,0,1
Nigeria,08/02/2003,13,0,0,0,1,0,0,14
Nigeria,09/02/2003,4,0,0,0,0,0,0,4
Nigeria,10/02/2003,13,0,0,0,0,0,0,13
Nigeria,11/02/2003,10,0,-2,0,3,2,0,13
Nigeria,12/02/2003,12,0,1,0,6,3,0,22
Nigeria,13/02/2003,11,0,0,0,3,0,0,14
Nigeria,14/02/2003,9,0,0,0,3,1,0,13
Nigeria,15/02/2003,0,0,0,0,4,1,0,5
Nigeria,16/02/2003,2,0,0,0,-4,1,0,-1
Nigeria,17/02/2003,2,0,0,0,12,0,0,14
Nigeria,18/02/2003,16,0,0,0,3,4,0,23
Nigeria,19/02/2003,19,0,0,0,0,4,0,23
Nigeria,20/02/2003,14,0,0,0,16,6,0,36
Nigeria,21/02/2003,20,0,0,0,12,2,0,34
Nigeria,22/02/2003,13,0,-1,0,3,0,0,15
Nigeria,23/02/2003,2,0,0,0,0,1,0,3
Nigeria,24/02/2003,20,0,0,0,12,0,0,32
Nigeria,25/02/2003,12,0,-2,0,9,1,0,20
Nigeria,26/02/2003,5,0,0,0,0,0,0,5
Nigeria,27/02/2003,10,0,0,0,6,2,0,18
Nigeria,28/02/2003,-3,0,0,0,0,4,0,1
Nigeria,01/03/2003,2,0,0,0,3,0,0,5
Nigeria,02/03/2003,3,0,0,0,0,0,0,3
Nigeria,03/03/2003,29,0,1,0,6,0,0,36
Nigeria,04/03/2003,5,0,0,0,2,2,0,9
Nigeria,05/03/2003,16,0,2,0,6,6,0,30
Nigeria,06/03/2003,16,0,0,0,21,0,0,37
Nigeria,07/03/2003,1,0,1,0,6,3,0,11
Nigeria,08/03/2003,6,0,-2,0,5,2,0,11
Nigeria,09/03/2003,10,0,0,0,0,0,0,10
Nigeria,10/03/2003,17,0,0,0,1,-2,0,16
Nigeria,11/03/2003,14,0,0,0,12,3,0,29
Nigeria,12/03/2003,11,0,-1,0,0,2,0,12
Nigeria,13/03/2003,9,0,0,0,25,3,0,37
Nigeria,14/03/2003,11,0,0,0,3,0,0,14
Nigeria,15/03/2003,13,0,-2,0,4,0,0,15
Nigeria,16/03/2003,4,2,-4,0,0,3,0,5
Nigeria,17/03/2003,9,0,0,0,0,0,0,9
Nigeria,18/03/2003,4,0,0,0,3,0,0,7
Nigeria,19/03/2003,19,0,0,0,-4,6,0,21
Nigeria,20/03/2003,5,0,0,0,0,1,0,6
Nigeria,21/03/2003,4,0,0,0,1,4,0,9
Nigeria,22/03/2003,4,0,0,0,3,1,0,8
Nigeria,23/03/2003,2,0,0,0,0,0,0,2
Nigeria,24/03/2003,19,0,0,0,-2,0,0,17
Nigeria,25/03/2003,6,0,0,0,0,1,0,7
Nigeria,26/03/2003,11,0,0,0,0,0,0,11
Nigeria,27/03/2003,19,0,0,0,3,0,0,22
Nigeria,28/03/2003,6,0,0,0,7,0,0,13
Nigeria,29/03/2003,6,0,0,0,0,0,0,6
Nigeria,30/03/2003,3,0,0,0,0,0,0,3
Nigeria,31/03/2003,11,0,0,0,9,-3,0,17
Nigeria,01/04/2003,0,0,0,0,9,0,0,9
Nigeria,02/04/2003,1,0,1,0,3,0,0,5
Nigeria,03/04/2003,6,0,0,0,3,0,0,9
Nigeria,04/04/2003,2,0,0,0,9,2,0,13
Nigeria,05/04/2003,6,0,0,0,0,0,0,6
Nigeria,06/04/2003,6,0,0,0,9,0,0,15
Nigeria,07/04/2003,9,0,0,0,3,0,0,12
Nigeria,08/04/2003,12,0,0,0,0,0,0,12
Nigeria,09/04/2003,7,0,-4,0,3,1,0,7
Nigeria,10/04/2003,6,0,0,0,-2,1,0,5
Nigeria,11/04/2003,7,0,1,0,3,4,0,15
Nigeria,12/04/2003,6,0,0,0,6,1,0,13
Nigeria,13/04/2003,4,0,0,0,-4,0,0,0
Nigeria,14/04/2003,4,0,0,0,9,2,0,15
Nigeria,15/04/2003,13,0,2,0,0,1,0,16
Nigeria,16/04/2003,20,0,0,0,-1,1,0,20
Nigeria,17/04/2003,10,0,-2,0,1,1,0,10
Nigeria,18/04/2003,2,0,0,0,0,0,0,2
Nigeria,19/04/2003,4,0,0,0,0,0,0,4
Nigeria,20/04/2003,-1,0,0,0,9,0,0,8
Nigeria,21/04/2003,14,0,0,0,7,2,0,23
Nigeria,22/04/2003,8,0,0,0,6,0,0,14
Nigeria,23/04/2003,18,0,0,0,3,1,0,22
Nigeria,24/04/2003,7,0,-2,0,9,3,0,17
Nigeria,25/04/2003,1,0,0,0,0,0,0,1
Nigeria,26/04/2003,10,0,-2,0,1,6,0,15
Nigeria,27/04/2003,0,0,1,0,3,-2,0,2
Nigeria,28/04/2003,13,0,0,0,0,3,0,16
Nigeria,29/04/2003,15,0,0,0,3,1,0,19
Nigeria,30/04/2003,10,0,0,0,4,6,0,20
Nigeria,01/05/2003,8,0,0,0,-4,0,0,4
Nigeria,02/05/2003,12,0,1,0,-4,0,0,9
Nigeria,03/05/2003,8,0,0,0,0,0,0,8
Nigeria,04/05/2003,4,0,0,0,0,0,0,4
Nigeria,05/05/2003,10,0,-2,0,3,0,0,11
Nigeria,06/05/2003,22,0,-4,0,3,-2,0,19
Nigeria,07/05/2003,29,0,-2,0,1,3,0,31
Nigeria,08/05/2003,24,0,1,0,7,1,0,33
Nigeria,09/05/2003,18,0,0,0,-1,0,0,17
Nigeria,10/05/2003,6,0,0,0,0,0,0,6
Nigeria,11/05/2003,1,0,0,0,3,1,0,5
Nigeria,12/05/2003,16,0,2,0,3,0,0,21
Nigeria,13/05/2003,12,0,0,0,6,-2,0,16
Nigeria,14/05/2003,11,0,0,0,0,0,0,11
Nigeria,15/05/2003,14,0,1,0,0,0,0,15
Nigeria,16/05/2003,20,0,2,0,-2,3,0,23
Nigeria,17/05/2003,4,0,2,0,3,0,0,9
Nigeria,18/05/2003,12,0,1,0,3,0,0,16
Nigeria,19/05/2003,7,0,1,0,0,2,0,10
Nigeria,20/05/2003,8,0,2,0,6,3,0,19
Nigeria,21/05/2003,16,0,0,0,8,2,0,26
Nigeria,22/05/2003,5,0,0,0,9,3,0,17
Nigeria,23/05/2003,-3,0,0,0,8,2,0,7
Nigeria,24/05/2003,5,0,1,0,0,0,0,6
Nigeria,25/05/2003,21,0,0,0,0,2,0,23
Nigeria,26/05/2003,9,0,0,0,9,0,0,18
Nigeria,27/05/2003,31,0,1,0,7,0,0,39
Nigeria,28/05/2003,13,0,0,0,43,1,0,57
Nigeria,29/05/2003,2,0,-1,0,1,5,0,7
Nigeria,30/05/2003,4,0,0,0,3,3,0,10
Nigeria,31/05/2003,6,0,0,0,9,0,0,15
Nigeria,01/06/2003,-2,0,0,0,-2,3,0,-1
Nigeria,02/06/2003,39,0,-1,0,-6,8,0,40
Nigeria,03/06/2003,27,0,1,0,-2,0,0,26
Nigeria,04/06/2003,12,0,1,0,6,0,0,19
Nigeria,05/06/2003,18,0,-2,0,9,0,0,25
Nigeria,06/06/2003,16,0,0,0,6,0,0,22
Nigeria,07/06/2003,3,0,-2,0,0,1,0,2
Nigeria,08/06/2003,7,0,0,0,-2,1,0,6
Nigeria,09/06/2003,4,0,-1,0,3,0,0,6
Nigeria,10/06/2003,15,0,1,0,-6,0,0,10
Nigeria,11/06/2003,6,0,2,0,9,0,0,17
Nigeria,12/06/2003,0,0,2,0,7,0,0,9
Nigeria,13/06/2003,3,0,0,0,4,0,0,7
Nigeria,14/06/2003,0,0,0,0,0,0,0,0
Nigeria,15/06/2003,8,0,0,0,0,0,0,8
Nigeria,16/06/2003,19,0,0,0,2,5,0,26
Nigeria,17/06/2003,14,0,-4,0,6,1,0,17
Nigeria,18/06/2003,1,2,0,0,0,1,0,4
Nigeria,19/06/2003,33,0,0,0,9,5,0,47
Nigeria,20/06/2003,20,0,-3,0,2,0,0,19
Nigeria,21/06/2003,0,0,0,0,0,0,0,0
Nigeria,22/06/2003,4,0,0,0,0,1,0,5
Nigeria,23/06/2003,10,0,-2,0,3,2,0,13
Nigeria,24/06/2003,21,0,0,0,0,9,0,30
Nigeria,25/06/2003,15,0,0,0,-2,3,0,16
Nigeria,26/06/2003,12,0,1,0,1,1,0,15
Nigeria,27/06/2003,5,0,0,0,3,5,0,13
Nigeria,28/06/2003,3,0,-6,0,0,0,0,-3
Nigeria,29/06/2003,1,0,0,0,0,1,0,2
Nigeria,30/06/2003,4,0,0,0,2,1,0,7
Nigeria,01/07/2003,17,0,0,0,1,6,0,24
Nigeria,02/07/2003,13,0,1,0,9,0,0,23
Nigeria,03/07/2003,9,4,0,0,1,1,0,15
Nigeria,04/07/2003,14,0,-2,0,1,1,0,14
Nigeria,05/07/2003,14,0,-2,0,0,2,0,14
Nigeria,06/07/2003,9,0,-4,0,6,3,0,14
Nigeria,07/07/2003,10,0,0,0,10,1,0,21
Nigeria,08/07/2003,14,0,-8,0,1,2,0,9
Nigeria,09/07/2003,13,0,1,0,9,1,0,24
Nigeria,10/07/2003,11,0,0,0,3,0,0,14
Nigeria,11/07/2003,8,0,0,0,1,2,0,11
Nigeria,12/07/2003,7,0,-2,0,3,1,0,9
Nigeria,13/07/2003,9,0,0,0,0,1,0,10
Nigeria,14/07/2003,20,0,1,0,-4,2,0,19
Nigeria,15/07/2003,18,0,0,0,-18,0,0,0
Nigeria,16/07/2003,4,0,-2,0,-8,5,0,-1
Nigeria,17/07/2003,3,0,0,0,1,0,0,4
Nigeria,18/07/2003,43,2,0,0,5,3,0,53
Nigeria,19/07/2003,11,0,0,0,-2,0,0,9
Nigeria,20/07/2003,11,0,-3,0,-2,0,0,6
Nigeria,21/07/2003,21,0,-2,0,-1,5,0,23
Nigeria,22/07/2003,44,0,-2,0,-2,3,0,43
Nigeria,23/07/2003,20,0,0,0,21,2,0,43
Nigeria,24/07/2003,19,2,0,0,-6,3,0,18
Nigeria,25/07/2003,14,0,-2,0,12,1,0,25
Nigeria,26/07/2003,4,0,0,0,1,0,0,5
Nigeria,27/07/2003,6,0,0,0,0,0,0,6
Nigeria,28/07/2003,29,0,-4,0,-4,2,0,23
Nigeria,29/07/2003,18,2,0,0,12,4,0,36
Nigeria,30/07/2003,30,0,-2,0,12,3,0,43
Nigeria,31/07/2003,56,0,-6,0,0,5,0,55
Nigeria,01/08/2003,24,0,-1,0,4,4,0,31
Nigeria,02/08/2003,17,0,-6,0,6,4,0,21
Nigeria,03/08/2003,19,0,-2,0,6,1,0,24
Nigeria,04/08/2003,23,0,-14,0,8,2,0,19
Nigeria,05/08/2003,21,0,-14,0,-10,1,0,-2
Nigeria,06/08/2003,15,2,-7,0,-4,0,0,6
Nigeria,07/08/2003,29,0,4,0,-1,4,0,36
Nigeria,08/08/2003,22,0,-1,0,1,4,0,26
Nigeria,09/08/2003,8,0,0,0,12,6,0,26
Nigeria,10/08/2003,15,0,-2,0,-2,1,0,12
Nigeria,11/08/2003,28,0,-10,0,3,2,0,23
Nigeria,12/08/2003,9,0,-1,0,5,2,0,15
Nigeria,13/08/2003,25,0,0,0,-2,1,0,24
Nigeria,14/08/2003,20,0,0,0,38,5,0,63
Nigeria,15/08/2003,28,0,1,0,16,4,0,49
Nigeria,16/08/2003,12,0,0,0,6,0,0,18
Nigeria,17/08/2003,25,0,0,0,5,2,0,32
Nigeria,18/08/2003,23,2,-2,0,9,7,0,39
Nigeria,19/08/2003,27,0,0,0,-2,1,0,26
Nigeria,20/08/2003,22,0,0,0,-1,1,0,22
Nigeria,21/08/2003,11,0,0,0,-2,1,0,10
Nigeria,22/08/2003,13,0,0,0,-2,0,0,11
Nigeria,23/08/2003,3,0,0,0,0,0,0,3
Nigeria,24/08/2003,1,0,0,0,3,0,0,4
Nigeria,25/08/2003,18,0,0,0,9,2,0,29
Nigeria,26/08/2003,20,0,0,0,-1,2,0,21
Nigeria,27/08/2003,21,0,-4,0,12,0,0,29
Nigeria,28/08/2003,16,0,0,0,4,0,0,20
Nigeria,29/08/2003,12,0,0,0,3,5,0,20
Nigeria,30/08/2003,8,0,0,0,1,0,0,9
Nigeria,31/08/2003,4,0,0,0,0,1,0,5
Nigeria,01/09/2003,19,0,0,0,0,1,0,20
Nigeria,02/09/2003,10,2,0,0,-2,2,0,12
Nigeria,03/09/2003,10,0,0,0,0,4,0,14
Nigeria,04/09/2003,22,0,0,0,-2,5,0,25
Nigeria,05/09/2003,2,0,1,0,-2,0,0,1
Nigeria,06/09/2003,2,0,1,0,0,0,0,3
Nigeria,07/09/2003,2,0,0,0,3,0,0,5
Nigeria,08/09/2003,19,0,0,0,6,2,0,27
Nigeria,09/09/2003,-2,0,0,0,9,0,0,7
Nigeria,10/09/2003,21,0,0,0,29,2,0,52
Nigeria,11/09/2003,9,0,-10,0,1,0,0,0
Nigeria,12/09/2003,11,0,-4,0,2,8,0,17
Nigeria,13/09/2003,5,0,0,0,0,5,0,10
Nigeria,14/09/2003,6,0,0,0,0,0,0,6
Nigeria,15/09/2003,21,0,-2,0,3,0,0,22
Nigeria,16/09/2003,5,0,0,0,-2,1,0,4
Nigeria,17/09/2003,9,0,0,0,6,1,0,16
Nigeria,18/09/2003,17,0,0,0,9,3,0,29
Nigeria,19/09/2003,-1,0,0,0,5,1,0,5
Nigeria,20/09/2003,-1,0,0,0,0,3,0,2
Nigeria,21/09/2003,11,0,0,0,0,0,0,11
Nigeria,22/09/2003,10,0,1,0,20,1,0,32
Nigeria,23/09/2003,17,0,0,0,-5,8,0,20
Nigeria,24/09/2003,15,0,0,0,5,1,0,21
Nigeria,25/09/2003,23,0,0,0,17,8,0,48
Nigeria,26/09/2003,14,2,0,0,5,3,0,24
Nigeria,27/09/2003,1,0,0,0,0,2,0,3
Nigeria,28/09/2003,1,0,0,0,-2,0,0,-1
Nigeria,29/09/2003,10,0,0,0,-4,0,0,6
Nigeria,30/09/2003,1,0,0,0,0,0,0,1
Nigeria,01/10/2003,38,0,0,0,5,5,0,48
Nigeria,02/10/2003,10,0,0,0,0,1,0,11
Nigeria,03/10/2003,7,0,1,0,-1,2,0,9
Nigeria,04/10/2003,1,0,0,0,3,0,0,4
Nigeria,05/10/2003,2,0,0,0,0,0,0,2
Nigeria,06/10/2003,7,0,0,0,3,2,0,12
Nigeria,07/10/2003,17,0,0,0,1,1,0,19
Nigeria,08/10/2003,2,0,0,0,3,4,0,9
Nigeria,09/10/2003,19,0,0,0,1,0,0,20
Nigeria,10/10/2003,25,0,-1,0,13,3,0,40
Nigeria,11/10/2003,7,0,0,0,0,-1,0,6
Nigeria,12/10/2003,3,0,-2,0,0,0,0,1
Nigeria,13/10/2003,17,2,-2,0,7,3,0,27
Nigeria,14/10/2003,41,2,-6,0,6,3,0,46
Nigeria,15/10/2003,18,0,0,0,-2,0,0,16
Nigeria,16/10/2003,10,0,-2,0,4,0,0,12
Nigeria,17/10/2003,6,4,0,0,-2,0,0,8
Nigeria,18/10/2003,3,0,0,0,0,0,0,3
Nigeria,19/10/2003,1,0,0,0,0,0,0,1
Nigeria,20/10/2003,4,0,0,0,8,1,0,13
Nigeria,21/10/2003,13,0,0,0,8,2,0,23
Nigeria,22/10/2003,16,0,0,0,-3,0,0,13
Nigeria,23/10/2003,-2,0,0,0,2,0,0,0
Nigeria,24/10/2003,7,0,0,0,3,2,0,12
Nigeria,25/10/2003,4,0,-2,0,-4,0,0,-2
Nigeria,26/10/2003,1,0,0,0,6,0,0,7
Nigeria,27/10/2003,11,0,0,0,-1,8,0,18
Nigeria,28/10/2003,9,0,0,0,-5,1,0,5
Nigeria,29/10/2003,16,0,0,0,6,1,0,23
Nigeria,30/10/2003,17,0,0,0,20,6,0,43
Nigeria,31/10/2003,22,0,-2,0,1,1,0,22
Nigeria,01/11/2003,6,0,0,0,3,0,0,9
Nigeria,02/11/2003,8,0,0,0,0,2,0,10
Nigeria,03/11/2003,19,0,0,0,-3,0,0,16
Nigeria,04/11/2003,15,0,-2,0,3,4,0,20
Nigeria,05/11/2003,5,0,1,0,0,9,0,15
Nigeria,06/11/2003,26,0,1,0,12,7,0,46
Nigeria,07/11/2003,11,0,0,0,13,1,0,25
Nigeria,08/11/2003,7,0,0,0,0,0,0,7
Nigeria,09/11/2003,0,0,0,0,0,0,0,0
Nigeria,10/11/2003,13,2,0,0,3,1,0,19
Nigeria,11/11/2003,14,0,2,0,6,2,0,24
Nigeria,12/11/2003,0,0,0,0,-2,0,0,-2
Nigeria,13/11/2003,4,0,0,0,15,1,0,20
Nigeria,14/11/2003,41,0,0,0,13,2,0,56
Nigeria,15/11/2003,18,0,0,0,-4,0,0,14
Nigeria,16/11/2003,3,0,0,0,3,2,0,8
Nigeria,17/11/2003,21,0,0,0,-4,5,0,22
Nigeria,18/11/2003,4,0,-3,0,4,1,0,6
Nigeria,19/11/2003,6,0,0,0,-5,1,0,2
Nigeria,20/11/2003,1,0,0,0,6,1,0,8
Nigeria,21/11/2003,17,0,0,0,-2,2,0,17
Nigeria,22/11/2003,0,0,0,0,0,0,0,0
Nigeria,23/11/2003,4,0,0,0,0,4,0,8
Nigeria,24/11/2003,6,0,0,0,15,1,0,22
Nigeria,25/11/2003,8,0,0,0,13,3,0,24
Nigeria,26/11/2003,9,0,0,0,0,5,0,14
Nigeria,27/11/2003,4,0,2,0,-4,0,0,2
Nigeria,28/11/2003,1,0,1,0,9,0,0,11
Nigeria,29/11/2003,3,0,0,0,-4,2,0,1
Nigeria,30/11/2003,0,0,0,0,-1,0,0,-1
Nigeria,01/12/2003,5,0,0,0,4,0,0,9
Nigeria,02/12/2003,8,0,0,0,0,7,0,15
Nigeria,03/12/2003,11,0,0,0,9,2,0,22
Nigeria,04/12/2003,17,0,0,0,24,2,0,43
Nigeria,05/12/2003,12,0,1,0,3,0,0,16
Nigeria,06/12/2003,10,0,0,0,0,1,0,11
Nigeria,07/12/2003,10,0,0,0,3,0,0,13
Nigeria,08/12/2003,6,0,0,0,3,2,0,11
Nigeria,09/12/2003,16,0,0,0,16,8,0,40
Nigeria,10/12/2003,14,0,0,0,3,2,0,19
Nigeria,11/12/2003,8,0,-1,0,12,2,0,21
Nigeria,12/12/2003,3,0,0,0,15,2,0,20
Nigeria,13/12/2003,0,0,2,0,0,0,0,2
Nigeria,14/12/2003,0,0,1,0,0,0,0,1
Nigeria,15/12/2003,4,0,0,0,16,6,0,26
Nigeria,16/12/2003,0,0,0,0,6,0,0,6
Nigeria,17/12/2003,12,0,0,0,5,6,0,23
Nigeria,18/12/2003,16,0,0,0,13,2,0,31
Nigeria,19/12/2003,8,2,0,0,3,2,0,15
Nigeria,20/12/2003,9,0,0,0,-6,0,0,3
Nigeria,21/12/2003,2,0,0,0,3,0,0,5
Nigeria,22/12/2003,8,0,0,0,3,0,0,11
Nigeria,23/12/2003,8,0,0,0,2,0,0,10
Nigeria,24/12/2003,4,0,0,0,9,3,0,16
Nigeria,25/12/2003,3,0,0,0,0,0,0,3
Nigeria,26/12/2003,5,0,0,0,3,0,0,8
Nigeria,27/12/2003,0,0,0,0,3,0,0,3
Nigeria,28/12/2003,1,0,0,0,0,0,0,1
Nigeria,29/12/2003,10,0,0,0,-2,0,0,8
Nigeria,30/12/2003,8,0,0,0,6,0,0,14
Nigeria,31/12/2003,2,0,0,0,-1,3,0,4
Pakistan,01/01/2003,26,0,-2,0,9,0,0,33
Pakistan,02/01/2003,34,0,0,0,0,0,0,34
Pakistan,03/01/2003,31,0,0,0,15,2,0,48
Pakistan,04/01/2003,26,0,0,0,1,0,0,27
Pakistan,05/01/2003,57,0,0,0,3,1,0,61
Pakistan,06/01/2003,28,0,0,0,2,8,0,38
Pakistan,07/01/2003,22,0,0,0,11,1,0,34
Pakistan,08/01/2003,34,0,0,0,7,6,0,47
Pakistan,09/01/2003,54,0,0,0,6,0,0,60
Pakistan,10/01/2003,5,0,0,0,-3,0,0,2
Pakistan,11/01/2003,9,0,0,0,1,0,0,10
Pakistan,12/01/2003,19,0,0,0,1,0,0,20
Pakistan,13/01/2003,19,0,0,0,6,0,0,25
Pakistan,14/01/2003,11,0,0,0,6,0,0,17
Pakistan,15/01/2003,12,0,0,0,0,0,0,12
Pakistan,16/01/2003,13,0,0,0,6,0,0,19
Pakistan,17/01/2003,29,0,0,0,21,0,0,50
Pakistan,18/01/2003,1,0,0,0,6,0,0,7
Pakistan,19/01/2003,19,0,0,0,-2,0,0,17
Pakistan,20/01/2003,31,0,0,0,0,6,0,37
Pakistan,21/01/2003,6,0,0,0,6,0,0,12
Pakistan,22/01/2003,23,0,0,0,12,4,0,39
Pakistan,23/01/2003,25,0,0,0,19,6,0,50
Pakistan,24/01/2003,8,0,0,0,0,0,0,8
Pakistan,25/01/2003,3,0,0,0,1,0,0,4
Pakistan,26/01/2003,5,0,0,0,2,2,0,9
Pakistan,27/01/2003,10,0,0,0,0,1,0,11
Pakistan,28/01/2003,68,0,0,0,6,1,0,75
Pakistan,29/01/2003,35,0,0,0,3,1,0,39
Pakistan,30/01/2003,46,0,0,0,8,0,0,54
Pakistan,31/01/2003,24,0,0,0,12,0,0,36
Pakistan,01/02/2003,14,0,0,0,0,2,0,16
Pakistan,02/02/2003,24,0,0,0,15,2,0,41
Pakistan,03/02/2003,31,0,0,0,15,3,0,49
Pakistan,04/02/2003,13,0,0,0,3,4,0,20
Pakistan,05/02/2003,15,0,0,0,13,2,0,30
Pakistan,06/02/2003,37,0,-1,0,9,0,0,45
Pakistan,07/02/2003,19,0,0,0,10,3,0,32
Pakistan,08/02/2003,9,0,0,0,2,0,0,11
Pakistan,09/02/2003,7,0,0,0,18,1,0,26
Pakistan,10/02/2003,14,0,0,0,13,0,0,27
Pakistan,11/02/2003,18,0,0,0,8,5,0,31
Pakistan,12/02/2003,9,0,0,0,0,0,0,9
Pakistan,13/02/2003,17,0,1,0,1,0,0,19
Pakistan,14/02/2003,8,0,0,0,1,2,0,11
Pakistan,15/02/2003,2,0,0,0,0,3,0,5
Pakistan,16/02/2003,0,0,0,0,0,0,0,0
Pakistan,17/02/2003,4,0,0,0,3,0,0,7
Pakistan,18/02/2003,7,0,0,0,-10,0,0,-3
Pakistan,19/02/2003,20,0,0,0,0,1,0,21
Pakistan,20/02/2003,12,0,0,0,3,4,0,19
Pakistan,21/02/2003,8,0,0,0,1,1,0,10
Pakistan,22/02/2003,8,0,0,0,4,5,0,17
Pakistan,23/02/2003,17,0,0,0,6,0,0,23
Pakistan,24/02/2003,20,0,0,0,6,1,0,27
Pakistan,25/02/2003,40,0,0,0,31,0,0,71
Pakistan,26/02/2003,6,0,0,0,6,2,0,14
Pakistan,27/02/2003,2,0,0,0,6,1,0,9
Pakistan,28/02/2003,10,2,0,0,11,0,0,23
Pakistan,01/03/2003,18,0,0,0,4,0,0,22
Pakistan,02/03/2003,8,0,0,0,1,0,0,9
Pakistan,03/03/2003,36,0,0,0,24,0,0,60
Pakistan,04/03/2003,38,0,1,0,36,2,0,77
Pakistan,05/03/2003,9,0,0,0,24,2,0,35
Pakistan,06/03/2003,36,0,0,0,23,1,0,60
Pakistan,07/03/2003,42,0,0,0,45,0,0,87
Pakistan,08/03/2003,18,0,0,0,12,3,0,33
Pakistan,09/03/2003,8,0,0,0,9,0,0,17
Pakistan,10/03/2003,46,0,2,0,-2,6,0,52
Pakistan,11/03/2003,20,0,0,0,22,1,0,43
Pakistan,12/03/2003,25,2,0,0,9,0,0,36
Pakistan,13/03/2003,18,0,0,0,18,0,0,36
Pakistan,14/03/2003,25,0,-1,0,6,2,0,32
Pakistan,15/03/2003,21,0,0,0,18,8,0,47
Pakistan,16/03/2003,22,4,0,0,0,3,0,29
Pakistan,17/03/2003,45,0,0,0,2,0,0,47
Pakistan,18/03/2003,9,0,0,0,7,1,0,17
Pakistan,19/03/2003,24,0,0,0,-9,7,0,22
Pakistan,20/03/2003,28,4,1,0,4,7,0,44
Pakistan,21/03/2003,20,0,0,0,3,0,0,23
Pakistan,22/03/2003,0,0,0,0,9,0,0,9
Pakistan,23/03/2003,14,0,0,0,-3,0,0,11
Pakistan,24/03/2003,3,0,-1,0,3,0,0,5
Pakistan,25/03/2003,26,0,0,0,3,6,0,35
Pakistan,26/03/2003,34,0,0,0,0,5,0,39
Pakistan,27/03/2003,12,0,0,0,0,3,0,15
Pakistan,28/03/2003,3,0,0,0,3,8,0,14
Pakistan,29/03/2003,16,0,0,0,0,4,0,20
Pakistan,30/03/2003,12,0,0,0,0,0,0,12
Pakistan,31/03/2003,24,0,0,0,6,0,0,30
Pakistan,01/04/2003,19,0,0,0,7,0,0,26
Pakistan,02/04/2003,30,0,0,0,3,2,0,35
Pakistan,03/04/2003,10,0,0,0,-3,0,0,7
Pakistan,04/04/2003,0,0,0,0,3,1,0,4
Pakistan,05/04/2003,16,0,0,0,1,2,0,19
Pakistan,06/04/2003,15,0,-2,0,0,1,0,14
Pakistan,07/04/2003,17,0,0,0,0,1,0,18
Pakistan,08/04/2003,1,0,0,0,-5,0,0,-4
Pakistan,09/04/2003,14,0,0,0,15,2,0,31
Pakistan,10/04/2003,-1,0,0,0,15,0,0,14
Pakistan,11/04/2003,30,0,0,0,9,0,0,39
Pakistan,12/04/2003,20,0,0,0,0,2,0,22
Pakistan,13/04/2003,15,0,0,0,9,0,0,24
Pakistan,14/04/2003,12,0,-4,0,6,1,0,15
Pakistan,15/04/2003,24,0,0,0,3,2,0,29
Pakistan,16/04/2003,18,0,0,0,3,4,0,25
Pakistan,17/04/2003,17,0,0,0,12,2,0,31
Pakistan,18/04/2003,13,0,0,0,2,5,0,20
Pakistan,19/04/2003,21,0,0,0,18,0,0,39
Pakistan,20/04/2003,3,0,0,0,3,0,0,6
Pakistan,21/04/2003,3,0,0,0,45,4,0,52
Pakistan,22/04/2003,8,0,0,0,7,2,0,17
Pakistan,23/04/2003,19,0,0,0,0,1,0,20
Pakistan,24/04/2003,33,0,0,0,24,0,0,57
Pakistan,25/04/2003,33,2,0,0,17,0,0,52
Pakistan,26/04/2003,50,0,0,0,9,0,0,59
Pakistan,27/04/2003,7,0,0,0,3,0,0,10
Pakistan,28/04/2003,19,0,0,0,6,1,0,26
Pakistan,29/04/2003,42,0,0,0,15,6,0,63
Pakistan,30/04/2003,30,0,0,0,12,3,0,45
Pakistan,01/05/2003,24,0,-3,0,4,0,0,25
Pakistan,02/05/2003,32,0,0,0,4,0,0,36
Pakistan,03/05/2003,12,0,1,0,0,0,0,13
Pakistan,04/05/2003,3,2,0,0,0,1,0,6
Pakistan,05/05/2003,34,0,0,0,19,0,0,53
Pakistan,06/05/2003,31,0,0,0,-4,3,0,30
Pakistan,07/05/2003,14,0,0,0,-8,3,0,9
Pakistan,08/05/2003,8,0,-4,0,1,0,0,5
Pakistan,09/05/2003,15,0,0,0,9,1,0,25
Pakistan,10/05/2003,55,0,-2,0,4,0,0,57
Pakistan,11/05/2003,34,0,0,0,3,18,0,55
Pakistan,12/05/2003,28,0,0,0,-1,0,0,27
Pakistan,13/05/2003,10,0,-1,0,0,0,0,9
Pakistan,14/05/2003,15,0,0,0,-2,3,0,16
Pakistan,15/05/2003,15,0,-2,0,12,1,0,26
Pakistan,16/05/2003,51,0,1,0,9,0,0,61
Pakistan,17/05/2003,18,0,0,0,19,6,0,43
Pakistan,18/05/2003,16,0,0,0,0,1,0,17
Pakistan,19/05/2003,24,0,0,0,24,2,0,50
Pakistan,20/05/2003,9,0,0,0,1,6,0,16
Pakistan,21/05/2003,13,0,0,0,20,0,0,33
Pakistan,22/05/2003,28,0,0,0,13,0,0,41
Pakistan,23/05/2003,15,0,0,0,9,2,0,26
Pakistan,24/05/2003,7,0,0,0,15,0,0,22
Pakistan,25/05/2003,9,0,0,0,3,0,0,12
Pakistan,26/05/2003,33,0,0,0,-2,0,0,31
Pakistan,27/05/2003,13,0,-2,0,4,2,0,17
Pakistan,28/05/2003,12,0,0,0,55,0,0,67
Pakistan,29/05/2003,9,4,0,0,1,1,0,15
Pakistan,30/05/2003,13,0,0,0,12,0,0,25
Pakistan,31/05/2003,7,0,0,0,-3,0,0,4
Pakistan,01/06/2003,2,0,0,0,6,0,0,8
Pakistan,02/06/2003,11,0,0,0,-1,0,0,10
Pakistan,03/06/2003,12,0,0,0,3,0,0,15
Pakistan,04/06/2003,16,0,0,0,15,2,0,33
Pakistan,05/06/2003,21,0,0,0,6,5,0,32
Pakistan,06/06/2003,4,0,0,0,6,0,0,10
Pakistan,07/06/2003,19,0,0,0,0,0,0,19
Pakistan,08/06/2003,1,0,0,0,0,0,0,1
Pakistan,09/06/2003,3,0,0,0,3,5,0,11
Pakistan,10/06/2003,38,0,0,0,0,0,0,38
Pakistan,11/06/2003,34,0,0,0,0,-1,0,33
Pakistan,12/06/2003,10,0,0,0,20,2,0,32
Pakistan,13/06/2003,8,0,0,0,24,5,0,37
Pakistan,14/06/2003,8,0,0,0,0,1,0,9
Pakistan,15/06/2003,25,0,0,0,2,1,0,28
Pakistan,16/06/2003,5,0,0,0,14,2,0,21
Pakistan,17/06/2003,41,0,0,0,3,0,0,44
Pakistan,18/06/2003,21,0,0,0,45,0,0,66
Pakistan,19/06/2003,12,0,1,0,5,2,0,20
Pakistan,20/06/2003,23,0,0,0,9,7,0,39
Pakistan,21/06/2003,3,0,0,0,15,0,0,18
Pakistan,22/06/2003,20,0,-2,0,6,7,0,31
Pakistan,23/06/2003,36,0,0,0,-4,0,0,32
Pakistan,24/06/2003,12,0,0,0,15,0,0,27
Pakistan,25/06/2003,14,0,0,0,2,1,0,17
Pakistan,26/06/2003,18,0,0,0,38,4,0,60
Pakistan,27/06/2003,34,0,0,0,6,1,0,41
Pakistan,28/06/2003,41,0,1,0,4,1,0,47
Pakistan,29/06/2003,26,2,0,0,10,0,0,38
Pakistan,30/06/2003,40,0,-2,0,0,8,0,46
Pakistan,01/07/2003,32,0,0,0,14,1,0,47
Pakistan,02/07/2003,25,0,0,0,9,7,0,41
Pakistan,03/07/2003,48,0,0,0,15,4,0,67
Pakistan,04/07/2003,28,0,0,0,9,3,0,40
Pakistan,05/07/2003,48,0,0,0,12,15,0,75
Pakistan,06/07/2003,20,0,1,0,5,1,0,27
Pakistan,07/07/2003,51,2,1,0,14,2,0,70
Pakistan,08/07/2003,91,0,0,0,24,27,0,142
Pakistan,09/07/2003,31,0,0,0,8,2,0,41
Pakistan,10/07/2003,17,0,0,0,3,10,0,30
Pakistan,11/07/2003,23,0,0,0,15,9,0,47
Pakistan,12/07/2003,8,0,0,0,3,1,0,12
Pakistan,13/07/2003,40,0,0,0,6,0,0,46
Pakistan,14/07/2003,48,0,0,0,3,2,0,53
Pakistan,15/07/2003,25,0,-2,0,24,2,0,49
Pakistan,16/07/2003,18,2,0,0,9,0,0,29
Pakistan,17/07/2003,23,0,0,0,21,1,0,45
Pakistan,18/07/2003,64,0,2,0,15,1,0,82
Pakistan,19/07/2003,19,0,0,0,31,5,0,55
Pakistan,20/07/2003,8,0,0,0,18,2,0,28
Pakistan,21/07/2003,56,0,0,0,7,4,0,67
Pakistan,22/07/2003,54,0,0,0,0,2,0,56
Pakistan,23/07/2003,38,0,0,0,52,2,0,92
Pakistan,24/07/2003,26,0,0,0,15,2,0,43
Pakistan,25/07/2003,31,0,0,0,7,2,0,40
Pakistan,26/07/2003,15,0,0,0,6,3,0,24
Pakistan,27/07/2003,4,0,0,0,9,0,0,13
Pakistan,28/07/2003,21,0,0,0,18,0,0,39
Pakistan,29/07/2003,0,0,0,0,6,2,0,8
Pakistan,30/07/2003,19,0,0,0,6,0,0,25
Pakistan,31/07/2003,14,0,0,0,6,4,0,24
Pakistan,01/08/2003,31,0,0,0,55,5,0,91
Pakistan,02/08/2003,15,0,0,0,-1,0,0,14
Pakistan,03/08/2003,3,0,0,0,6,3,0,12
Pakistan,04/08/2003,7,0,0,0,22,3,0,32
Pakistan,05/08/2003,15,0,0,0,15,0,0,30
Pakistan,06/08/2003,16,0,-5,0,11,0,0,22
Pakistan,07/08/2003,21,0,0,0,4,0,0,25
Pakistan,08/08/2003,22,0,0,0,5,1,0,28
Pakistan,09/08/2003,13,0,0,0,-2,0,0,11
Pakistan,10/08/2003,4,0,0,0,12,6,0,22
Pakistan,11/08/2003,2,0,2,0,3,0,0,7
Pakistan,12/08/2003,17,0,0,0,3,0,0,20
Pakistan,13/08/2003,21,0,0,0,-4,3,0,20
Pakistan,14/08/2003,20,4,0,0,3,0,0,27
Pakistan,15/08/2003,15,0,0,0,21,5,0,41
Pakistan,16/08/2003,22,0,-2,0,-2,4,0,22
Pakistan,17/08/2003,82,0,0,0,6,7,0,95
Pakistan,18/08/2003,69,0,2,0,9,1,0,81
Pakistan,19/08/2003,48,0,0,0,4,0,0,52
Pakistan,20/08/2003,50,0,0,0,3,4,0,57
Pakistan,21/08/2003,26,0,0,0,10,3,0,39
Pakistan,22/08/2003,5,0,0,0,3,4,0,12
Pakistan,23/08/2003,46,0,0,0,28,0,0,74
Pakistan,24/08/2003,30,0,0,0,21,10,0,61
Pakistan,25/08/2003,44,0,0,0,39,2,0,85
Pakistan,26/08/2003,56,0,0,0,18,1,0,75
Pakistan,27/08/2003,21,0,0,0,10,1,0,32
Pakistan,28/08/2003,26,0,0,0,9,4,0,39
Pakistan,29/08/2003,3,0,0,0,6,1,0,10
Pakistan,30/08/2003,37,0,0,0,12,2,0,51
Pakistan,31/08/2003,33,0,0,0,3,10,0,46
Pakistan,01/09/2003,20,0,0,0,5,0,0,25
Pakistan,02/09/2003,16,0,0,0,5,0,0,21
Pakistan,03/09/2003,43,0,0,0,1,6,0,50
Pakistan,04/09/2003,35,0,0,0,38,1,0,74
Pakistan,05/09/2003,16,2,0,0,-1,0,0,17
Pakistan,06/09/2003,34,0,0,0,13,0,0,47
Pakistan,07/09/2003,32,0,0,0,15,2,0,49
Pakistan,08/09/2003,24,0,-2,0,24,4,0,50
Pakistan,09/09/2003,11,0,0,0,3,0,0,14
Pakistan,10/09/2003,27,0,0,0,2,5,0,34
Pakistan,11/09/2003,24,0,-2,0,9,0,0,31
Pakistan,12/09/2003,11,0,0,0,2,0,0,13
Pakistan,13/09/2003,17,0,0,0,-2,0,0,15
Pakistan,14/09/2003,34,0,0,0,12,2,0,48
Pakistan,15/09/2003,22,0,0,0,15,0,0,37
Pakistan,16/09/2003,11,0,0,0,-4,0,0,7
Pakistan,17/09/2003,19,0,0,0,12,2,0,33
Pakistan,18/09/2003,10,0,0,0,-1,0,0,9
Pakistan,19/09/2003,10,0,-2,0,27,3,0,38
Pakistan,20/09/2003,34,0,0,0,2,0,0,36
Pakistan,21/09/2003,28,0,0,0,1,0,0,29
Pakistan,22/09/2003,21,0,2,0,9,0,0,32
Pakistan,23/09/2003,32,2,0,0,27,3,0,64
Pakistan,24/09/2003,15,0,0,0,19,8,0,42
Pakistan,25/09/2003,18,0,0,0,16,1,0,35
Pakistan,26/09/2003,17,0,0,0,2,5,0,24
Pakistan,27/09/2003,6,0,0,0,15,2,0,23
Pakistan,28/09/2003,27,0,0,0,15,1,0,43
Pakistan,29/09/2003,43,0,0,0,14,2,0,59
Pakistan,30/09/2003,22,2,0,0,9,0,0,33
Pakistan,01/10/2003,6,0,0,0,12,0,0,18
Pakistan,02/10/2003,15,0,0,0,6,0,0,21
Pakistan,03/10/2003,16,0,0,0,9,0,0,25
Pakistan,04/10/2003,33,2,0,0,0,3,0,38
Pakistan,05/10/2003,8,0,0,0,3,0,0,11
Pakistan,06/10/2003,50,0,0,0,18,2,0,70
Pakistan,07/10/2003,6,0,0,0,15,6,0,27
Pakistan,08/10/2003,46,0,1,0,6,0,0,53
Pakistan,09/10/2003,11,0,0,0,0,0,0,11
Pakistan,10/10/2003,15,0,0,0,0,1,0,16
Pakistan,11/10/2003,40,0,0,0,9,2,0,51
Pakistan,12/10/2003,11,0,0,0,15,0,0,26
Pakistan,13/10/2003,60,4,0,0,21,0,0,85
Pakistan,14/10/2003,11,0,0,0,6,2,0,19
Pakistan,15/10/2003,22,0,0,0,0,4,0,26
Pakistan,16/10/2003,36,0,0,0,0,0,0,36
Pakistan,17/10/2003,38,0,-2,0,3,4,0,43
Pakistan,18/10/2003,7,0,0,0,0,0,0,7
Pakistan,19/10/2003,6,0,0,0,6,0,0,12
Pakistan,20/10/2003,14,0,0,0,6,3,0,23
Pakistan,21/10/2003,30,0,-2,0,3,3,0,34
Pakistan,22/10/2003,19,0,0,0,12,5,0,36
Pakistan,23/10/2003,4,0,0,0,6,0,0,10
Pakistan,24/10/2003,23,0,0,0,10,2,0,35
Pakistan,25/10/2003,6,0,0,0,0,0,0,6
Pakistan,26/10/2003,16,0,0,0,3,2,0,21
Pakistan,27/10/2003,0,0,0,0,3,0,0,3
Pakistan,28/10/2003,31,0,0,0,9,0,0,40
Pakistan,29/10/2003,25,0,0,0,3,0,0,28
Pakistan,30/10/2003,21,0,-2,0,3,2,0,24
Pakistan,31/10/2003,40,0,0,0,3,4,0,47
Pakistan,01/11/2003,17,0,0,0,-2,0,0,15
Pakistan,02/11/2003,11,0,0,0,-7,2,0,6
Pakistan,03/11/2003,18,0,0,0,-1,0,0,17
Pakistan,04/11/2003,0,0,0,0,13,2,0,15
Pakistan,05/11/2003,17,0,0,0,6,0,0,23
Pakistan,06/11/2003,2,0,0,0,0,0,0,2
Pakistan,07/11/2003,-1,0,0,0,5,0,0,4
Pakistan,08/11/2003,30,0,0,0,9,0,0,39
Pakistan,09/11/2003,56,0,0,0,0,0,0,56
Pakistan,10/11/2003,2,0,0,0,15,5,0,22
Pakistan,11/11/2003,5,0,0,0,33,0,0,38
Pakistan,12/11/2003,10,0,0,0,3,4,0,17
Pakistan,13/11/2003,10,0,0,0,0,1,0,11
Pakistan,14/11/2003,15,0,0,0,3,0,0,18
Pakistan,15/11/2003,40,0,0,0,8,7,0,55
Pakistan,16/11/2003,38,0,0,0,15,0,0,53
Pakistan,17/11/2003,38,0,0,0,19,2,0,59
Pakistan,18/11/2003,13,0,0,0,-6,0,0,7
Pakistan,19/11/2003,8,0,0,0,13,0,0,21
Pakistan,20/11/2003,-2,0,0,0,10,0,0,8
Pakistan,21/11/2003,17,0,0,0,12,0,0,29
Pakistan,22/11/2003,23,0,0,0,23,0,0,46
Pakistan,23/11/2003,-2,0,0,0,-5,2,0,-5
Pakistan,24/11/2003,80,0,0,0,-2,1,0,79
Pakistan,25/11/2003,11,0,0,0,12,2,0,25
Pakistan,26/11/2003,33,0,3,0,7,0,0,43
Pakistan,27/11/2003,26,0,0,0,10,4,0,40
Pakistan,28/11/2003,-2,0,0,0,-1,0,0,-3
Pakistan,29/11/2003,5,0,0,0,0,0,0,5
Pakistan,30/11/2003,14,0,0,0,9,0,0,23
Pakistan,01/12/2003,13,0,0,0,28,0,0,41
Pakistan,02/12/2003,35,0,0,0,0,2,0,37
Pakistan,03/12/2003,12,0,0,0,1,3,0,16
Pakistan,04/12/2003,13,0,2,0,1,1,0,17
Pakistan,05/12/2003,12,0,0,0,1,0,0,13
Pakistan,06/12/2003,12,0,0,0,21,1,0,34
Pakistan,07/12/2003,9,0,0,0,12,0,0,21
Pakistan,08/12/2003,55,0,0,0,9,2,0,66
Pakistan,09/12/2003,25,0,0,0,4,7,0,36
Pakistan,10/12/2003,22,0,0,0,23,1,0,46
Pakistan,11/12/2003,35,0,0,0,28,8,0,71
Pakistan,12/12/2003,25,4,0,0,14,0,0,43
Pakistan,13/12/2003,14,0,0,0,18,8,0,40
Pakistan,14/12/2003,12,0,0,0,6,0,0,18
Pakistan,15/12/2003,26,0,0,0,3,0,0,29
Pakistan,16/12/2003,17,0,0,0,11,0,0,28
Pakistan,17/12/2003,24,0,0,0,6,0,0,30
Pakistan,18/12/2003,1,0,0,0,24,3,0,28
Pakistan,19/12/2003,15,0,0,0,0,3,0,18
Pakistan,20/12/2003,-1,0,0,0,0,0,0,-1
Pakistan,21/12/2003,12,0,0,0,-5,2,0,9
Pakistan,22/12/2003,27,0,0,0,3,0,0,30
Pakistan,23/12/2003,60,0,0,0,6,0,0,66
Pakistan,24/12/2003,18,0,-2,0,4,4,0,24
Pakistan,25/12/2003,1,0,0,0,6,0,0,7
Pakistan,26/12/2003,19,0,-1,0,3,0,0,21
Pakistan,27/12/2003,21,2,0,0,4,0,0,27
Pakistan,28/12/2003,17,0,0,0,1,2,0,20
Pakistan,29/12/2003,12,0,0,0,4,4,0,20
Pakistan,30/12/2003,42,0,0,0,12,0,0,54
Pakistan,31/12/2003,7,0,-2,0,15,0,0,20
Sierra Leone,01/01/2003,4,0,0,0,0,0,0,4
Sierra Leone,03/01/2003,2,0,0,0,0,0,0,2
Sierra Leone,04/01/2003,0,0,0,0,0,0,0,0
Sierra Leone,06/01/2003,-3,0,0,0,0,0,0,-3
Sierra Leone,07/01/2003,0,0,0,0,0,0,0,0
Sierra Leone,08/01/2003,2,0,0,0,0,0,0,2
Sierra Leone,09/01/2003,0,0,0,0,0,0,0,0
Sierra Leone,10/01/2003,3,0,0,0,0,0,0,3
Sierra Leone,11/01/2003,2,0,0,0,0,0,0,2
Sierra Leone,12/01/2003,3,0,0,0,0,2,0,5
Sierra Leone,14/01/2003,2,0,0,0,0,4,0,6
Sierra Leone,15/01/2003,0,0,0,0,0,4,0,4
Sierra Leone,16/01/2003,2,0,0,0,3,1,0,6
Sierra Leone,17/01/2003,2,0,0,0,3,3,0,8
Sierra Leone,20/01/2003,1,0,0,0,9,0,0,10
Sierra Leone,21/01/2003,5,0,0,0,0,0,0,5
Sierra Leone,22/01/2003,-2,0,0,0,0,0,0,-2
Sierra Leone,23/01/2003,-2,0,0,0,0,0,0,-2
Sierra Leone,24/01/2003,2,0,0,0,0,0,0,2
Sierra Leone,25/01/2003,1,0,0,0,0,0,0,1
Sierra Leone,26/01/2003,0,0,0,0,0,0,0,0
Sierra Leone,28/01/2003,4,0,0,0,-2,0,0,2
Sierra Leone,29/01/2003,-2,0,0,0,0,0,0,-2
Sierra Leone,30/01/2003,0,0,0,0,0,0,0,0
Sierra Leone,31/01/2003,0,0,0,0,0,0,0,0
Sierra Leone,01/02/2003,0,0,0,0,0,0,0,0
Sierra Leone,02/02/2003,0,0,0,0,0,0,0,0
Sierra Leone,05/02/2003,0,0,0,0,0,0,0,0
Sierra Leone,06/02/2003,1,0,0,0,3,0,0,4
Sierra Leone,07/02/2003,0,0,0,0,-1,0,0,-1
Sierra Leone,09/02/2003,-2,0,0,0,0,0,0,-2
Sierra Leone,10/02/2003,0,0,0,0,0,0,0,0
Sierra Leone,11/02/2003,0,0,0,0,0,0,0,0
Sierra Leone,12/02/2003,0,0,0,0,0,0,0,0
Sierra Leone,13/02/2003,0,0,0,0,0,0,0,0
Sierra Leone,14/02/2003,9,0,0,0,0,0,0,9
Sierra Leone,17/02/2003,0,0,0,0,0,0,0,0
Sierra Leone,18/02/2003,9,0,0,0,0,0,0,9
Sierra Leone,19/02/2003,19,0,0,0,3,0,0,22
Sierra Leone,20/02/2003,10,0,0,0,0,0,0,10
Sierra Leone,21/02/2003,18,0,0,0,0,0,0,18
Sierra Leone,24/02/2003,1,0,0,0,0,0,0,1
Sierra Leone,25/02/2003,4,0,0,0,9,0,0,13
Sierra Leone,26/02/2003,-1,0,0,0,0,0,0,-1
Sierra Leone,27/02/2003,2,0,0,0,3,0,0,5
Sierra Leone,28/02/2003,0,0,0,0,0,0,0,0
Sierra Leone,01/03/2003,0,0,0,0,0,0,0,0
Sierra Leone,03/03/2003,0,0,0,0,0,0,0,0
Sierra Leone,04/03/2003,-1,0,0,0,0,0,0,-1
Sierra Leone,05/03/2003,0,0,0,0,0,0,0,0
Sierra Leone,06/03/2003,0,0,0,0,6,0,0,6
Sierra Leone,07/03/2003,0,0,0,0,0,0,0,0
Sierra Leone,10/03/2003,15,0,0,0,12,1,0,28
Sierra Leone,11/03/2003,4,0,0,0,12,0,0,16
Sierra Leone,12/03/2003,18,0,1,0,-3,0,0,16
Sierra Leone,13/03/2003,0,0,0,0,16,0,0,16
Sierra Leone,14/03/2003,2,0,0,0,0,0,0,2
Sierra Leone,15/03/2003,0,0,0,0,0,0,0,0
Sierra Leone,17/03/2003,2,0,0,0,0,0,0,2
Sierra Leone,18/03/2003,9,0,0,0,4,2,0,15
Sierra Leone,20/03/2003,0,0,0,0,4,2,0,6
Sierra Leone,21/03/2003,0,0,0,0,0,0,0,0
Sierra Leone,25/03/2003,0,0,0,0,0,0,0,0
Sierra Leone,26/03/2003,0,0,0,0,0,0,0,0
Sierra Leone,27/03/2003,3,0,0,0,0,0,0,3
Sierra Leone,28/03/2003,0,0,0,0,0,6,0,6
Sierra Leone,29/03/2003,0,0,0,0,0,0,0,0
Sierra Leone,31/03/2003,0,0,0,0,0,0,0,0
Sierra Leone,01/04/2003,0,0,0,0,0,0,0,0
Sierra Leone,02/04/2003,6,0,0,0,0,0,0,6
Sierra Leone,03/04/2003,3,0,0,0,0,0,0,3
Sierra Leone,04/04/2003,4,0,0,0,0,0,0,4
Sierra Leone,05/04/2003,0,0,0,0,6,0,0,6
Sierra Leone,06/04/2003,0,0,0,0,0,0,0,0
Sierra Leone,07/04/2003,1,0,0,0,0,0,0,1
Sierra Leone,08/04/2003,0,0,0,0,0,0,0,0
Sierra Leone,09/04/2003,0,0,0,0,0,0,0,0
Sierra Leone,10/04/2003,0,0,1,0,0,0,0,1
Sierra Leone,11/04/2003,3,0,0,0,3,2,0,8
Sierra Leone,13/04/2003,0,0,1,0,0,0,0,1
Sierra Leone,14/04/2003,0,0,0,0,0,0,0,0
Sierra Leone,15/04/2003,3,0,0,0,3,0,0,6
Sierra Leone,16/04/2003,2,0,0,0,0,0,0,2
Sierra Leone,17/04/2003,0,2,0,0,0,0,0,2
Sierra Leone,18/04/2003,0,0,0,0,3,0,0,3
Sierra Leone,19/04/2003,0,0,0,0,0,0,0,0
Sierra Leone,25/04/2003,0,0,0,0,0,0,0,0
Sierra Leone,26/04/2003,2,0,0,0,0,0,0,2
Sierra Leone,27/04/2003,0,0,0,0,0,0,0,0
Sierra Leone,28/04/2003,16,0,0,0,0,0,0,16
Sierra Leone,29/04/2003,17,0,0,0,3,6,0,26
Sierra Leone,30/04/2003,4,2,0,0,-1,0,0,5
Sierra Leone,01/05/2003,4,0,0,0,9,0,0,13
Sierra Leone,02/05/2003,6,0,0,0,0,4,0,10
Sierra Leone,05/05/2003,4,0,0,0,3,0,0,7
Sierra Leone,06/05/2003,40,0,0,0,33,0,0,73
Sierra Leone,07/05/2003,13,0,0,0,13,1,0,27
Sierra Leone,08/05/2003,7,0,0,0,7,0,0,14
Sierra Leone,09/05/2003,16,0,0,0,3,0,0,19
Sierra Leone,11/05/2003,0,0,0,0,3,0,0,3
Sierra Leone,12/05/2003,2,0,0,0,-3,0,0,-1
Sierra Leone,13/05/2003,5,0,0,0,5,0,0,10
Sierra Leone,14/05/2003,2,0,0,0,-2,1,0,1
Sierra Leone,15/05/2003,2,0,0,0,6,0,0,8
Sierra Leone,16/05/2003,0,0,0,0,3,0,0,3
Sierra Leone,18/05/2003,3,0,0,0,0,0,0,3
Sierra Leone,19/05/2003,2,0,0,0,0,0,0,2
Sierra Leone,20/05/2003,3,0,0,0,0,0,0,3
Sierra Leone,21/05/2003,1,0,0,0,0,0,0,1
Sierra Leone,22/05/2003,7,0,0,0,0,0,0,7
Sierra Leone,23/05/2003,3,0,0,0,0,0,0,3
Sierra Leone,26/05/2003,0,0,0,0,0,0,0,0
Sierra Leone,27/05/2003,0,0,0,0,0,0,0,0
Sierra Leone,28/05/2003,0,0,-2,0,6,0,0,4
Sierra Leone,29/05/2003,5,0,0,0,-1,2,0,6
Sierra Leone,30/05/2003,0,0,0,0,2,0,0,2
Sierra Leone,31/05/2003,9,0,0,0,0,0,0,9
Sierra Leone,02/06/2003,-1,0,0,0,-2,0,0,-3
Sierra Leone,03/06/2003,0,0,0,0,6,0,0,6
Sierra Leone,04/06/2003,0,0,0,0,21,0,0,21
Sierra Leone,05/06/2003,6,0,0,0,12,1,0,19
Sierra Leone,06/06/2003,4,0,0,0,16,2,0,22
Sierra Leone,07/06/2003,1,0,0,0,10,0,0,11
Sierra Leone,08/06/2003,0,0,0,0,6,0,0,6
Sierra Leone,09/06/2003,10,0,0,0,0,3,0,13
Sierra Leone,10/06/2003,4,0,0,0,2,0,0,6
Sierra Leone,11/06/2003,4,0,-2,0,6,0,0,8
Sierra Leone,12/06/2003,3,0,0,0,9,0,0,12
Sierra Leone,13/06/2003,-2,0,0,0,9,0,0,7
Sierra Leone,14/06/2003,0,0,0,0,3,0,0,3
Sierra Leone,15/06/2003,0,0,0,0,3,0,0,3
Sierra Leone,16/06/2003,2,2,0,0,6,0,0,10
Sierra Leone,17/06/2003,-1,0,0,0,22,0,0,21
Sierra Leone,18/06/2003,4,0,-2,0,24,2,0,28
Sierra Leone,19/06/2003,4,0,-2,0,1,0,0,3
Sierra Leone,20/06/2003,5,0,0,0,11,1,0,17
Sierra Leone,21/06/2003,1,0,0,0,3,0,0,4
Sierra Leone,23/06/2003,11,0,0,0,6,2,0,19
Sierra Leone,24/06/2003,19,0,0,0,-2,0,0,17
Sierra Leone,25/06/2003,0,0,0,0,12,0,0,12
Sierra Leone,26/06/2003,3,0,0,0,5,3,0,11
Sierra Leone,27/06/2003,5,0,-2,0,-2,0,0,1
Sierra Leone,28/06/2003,1,0,-6,0,0,0,0,-5
Sierra Leone,29/06/2003,0,0,0,0,1,0,0,1
Sierra Leone,30/06/2003,3,0,0,0,3,0,0,6
Sierra Leone,01/07/2003,8,0,0,0,15,0,0,23
Sierra Leone,02/07/2003,12,0,-2,0,18,4,0,32
Sierra Leone,03/07/2003,1,0,0,0,12,5,0,18
Sierra Leone,04/07/2003,16,0,-2,0,0,1,0,15
Sierra Leone,05/07/2003,4,0,0,0,-2,2,0,4
Sierra Leone,06/07/2003,4,0,0,0,9,0,0,13
Sierra Leone,07/07/2003,3,0,-2,0,6,1,0,8
Sierra Leone,08/07/2003,12,0,0,0,9,2,0,23
Sierra Leone,09/07/2003,6,0,1,0,12,0,0,19
Sierra Leone,10/07/2003,5,0,0,0,9,1,0,15
Sierra Leone,11/07/2003,4,0,-4,0,3,6,0,9
Sierra Leone,12/07/2003,4,0,0,0,3,0,0,7
Sierra Leone,13/07/2003,0,0,0,0,0,0,0,0
Sierra Leone,14/07/2003,1,0,-1,0,7,1,0,8
Sierra Leone,15/07/2003,7,0,-2,0,19,0,0,24
Sierra Leone,16/07/2003,-1,0,1,0,6,0,0,6
Sierra Leone,17/07/2003,9,0,0,0,15,0,0,24
Sierra Leone,18/07/2003,6,4,0,0,10,0,0,20
Sierra Leone,19/07/2003,16,0,0,0,0,0,0,16
Sierra Leone,20/07/2003,9,0,0,0,6,0,0,15
Sierra Leone,21/07/2003,14,0,0,0,17,4,0,35
Sierra Leone,22/07/2003,10,2,0,0,7,3,0,22
Sierra Leone,23/07/2003,9,0,-4,0,24,0,0,29
Sierra Leone,24/07/2003,11,0,0,0,-2,0,0,9
Sierra Leone,25/07/2003,6,0,-2,0,3,0,0,7
Sierra Leone,26/07/2003,13,0,0,0,0,2,0,15
Sierra Leone,27/07/2003,0,0,0,0,0,0,0,0
Sierra Leone,28/07/2003,-1,0,-2,0,0,0,0,-3
Sierra Leone,29/07/2003,4,0,0,0,0,0,0,4
Sierra Leone,30/07/2003,1,0,-4,0,6,0,0,3
Sierra Leone,31/07/2003,5,0,0,0,3,0,0,8
Sierra Leone,01/08/2003,8,0,0,0,9,0,0,17
Sierra Leone,02/08/2003,3,0,-2,0,9,0,0,10
Sierra Leone,03/08/2003,14,0,-2,0,6,0,0,18
Sierra Leone,04/08/2003,29,0,-10,0,21,2,0,42
Sierra Leone,05/08/2003,11,0,0,0,12,0,0,23
Sierra Leone,06/08/2003,6,0,0,0,15,0,0,21
Sierra Leone,07/08/2003,13,0,-2,0,21,0,0,32
Sierra Leone,08/08/2003,23,0,-5,0,4,0,0,22
Sierra Leone,09/08/2003,0,0,0,0,3,1,0,4
Sierra Leone,10/08/2003,4,0,-6,0,6,0,0,4
Sierra Leone,11/08/2003,10,0,-12,0,-3,1,0,-4
Sierra Leone,12/08/2003,18,0,-4,0,37,1,0,52
Sierra Leone,13/08/2003,8,0,0,0,1,2,0,11
Sierra Leone,14/08/2003,10,0,0,0,0,0,0,10
Sierra Leone,15/08/2003,0,0,0,0,6,0,0,6
Sierra Leone,16/08/2003,6,0,0,0,0,0,0,6
Sierra Leone,17/08/2003,0,0,0,0,0,0,0,0
Sierra Leone,18/08/2003,2,0,0,0,0,0,0,2
Sierra Leone,19/08/2003,0,0,0,0,6,2,0,8
Sierra Leone,20/08/2003,0,0,0,0,-2,2,0,0
Sierra Leone,21/08/2003,6,0,0,0,1,0,0,7
Sierra Leone,22/08/2003,5,0,0,0,15,0,0,20
Sierra Leone,23/08/2003,2,0,0,0,0,0,0,2
Sierra Leone,24/08/2003,2,0,0,0,0,0,0,2
Sierra Leone,25/08/2003,0,0,0,0,0,0,0,0
Sierra Leone,26/08/2003,5,0,0,0,6,0,0,11
Sierra Leone,27/08/2003,0,0,0,0,3,0,0,3
Sierra Leone,28/08/2003,2,0,0,0,0,0,0,2
Sierra Leone,29/08/2003,0,0,0,0,0,0,0,0
Sierra Leone,30/08/2003,0,0,0,0,-2,0,0,-2
Sierra Leone,31/08/2003,0,0,0,0,0,0,0,0
Sierra Leone,01/09/2003,0,0,0,0,14,0,0,14
Sierra Leone,02/09/2003,0,0,-2,0,3,0,0,1
Sierra Leone,03/09/2003,10,0,0,0,3,0,0,13
Sierra Leone,04/09/2003,0,0,0,0,0,0,0,0
Sierra Leone,05/09/2003,6,0,0,0,7,0,0,13
Sierra Leone,08/09/2003,1,0,0,0,0,0,0,1
Sierra Leone,09/09/2003,0,0,0,0,0,0,0,0
Sierra Leone,10/09/2003,0,0,0,0,-1,0,0,-1
Sierra Leone,11/09/2003,9,0,0,0,0,0,0,9
Sierra Leone,12/09/2003,0,0,0,0,0,0,0,0
Sierra Leone,14/09/2003,0,0,0,0,0,0,0,0
Sierra Leone,15/09/2003,0,0,0,0,0,0,0,0
Sierra Leone,16/09/2003,-1,0,0,0,0,0,0,-1
Sierra Leone,17/09/2003,5,0,0,0,0,0,0,5
Sierra Leone,18/09/2003,0,0,0,0,0,0,0,0
Sierra Leone,19/09/2003,0,0,0,0,0,0,0,0
Sierra Leone,21/09/2003,0,0,0,0,0,0,0,0
Sierra Leone,23/09/2003,0,0,0,0,0,2,0,2
Sierra Leone,24/09/2003,0,0,0,0,0,0,0,0
Sierra Leone,25/09/2003,9,0,0,0,3,0,0,12
Sierra Leone,26/09/2003,-1,0,0,0,0,0,0,-1
Sierra Leone,28/09/2003,0,0,0,0,0,2,0,2
Sierra Leone,29/09/2003,4,0,0,0,6,0,0,10
Sierra Leone,30/09/2003,0,0,0,0,0,0,0,0
Sierra Leone,01/10/2003,6,0,0,0,18,0,0,24
Sierra Leone,02/10/2003,4,0,0,0,9,1,0,14
Sierra Leone,03/10/2003,2,0,0,0,0,6,0,8
Sierra Leone,05/10/2003,0,0,0,0,0,0,0,0
Sierra Leone,06/10/2003,0,0,0,0,0,0,0,0
Sierra Leone,07/10/2003,1,0,0,0,0,2,0,3
Sierra Leone,08/10/2003,3,0,0,0,9,0,0,12
Sierra Leone,09/10/2003,7,0,0,0,3,0,0,10
Sierra Leone,10/10/2003,0,2,0,0,3,0,0,5
Sierra Leone,11/10/2003,0,0,0,0,0,0,0,0
Sierra Leone,12/10/2003,6,0,0,0,0,0,0,6
Sierra Leone,13/10/2003,2,0,0,0,0,3,0,5
Sierra Leone,14/10/2003,7,0,0,0,1,0,0,8
Sierra Leone,15/10/2003,-1,0,0,0,0,0,0,-1
Sierra Leone,16/10/2003,-1,0,0,0,6,0,0,5
Sierra Leone,17/10/2003,1,0,0,0,0,0,0,1
Sierra Leone,18/10/2003,0,0,0,0,0,0,0,0
Sierra Leone,20/10/2003,2,0,1,0,7,0,0,10
Sierra Leone,21/10/2003,8,0,0,0,3,0,0,11
Sierra Leone,22/10/2003,3,0,0,0,5,0,0,8
Sierra Leone,23/10/2003,2,0,0,0,-2,0,0,0
Sierra Leone,24/10/2003,0,0,0,0,0,0,0,0
Sierra Leone,25/10/2003,0,0,0,0,3,0,0,3
Sierra Leone,26/10/2003,0,0,0,0,6,0,0,6
Sierra Leone,27/10/2003,0,0,-2,0,0,0,0,-2
Sierra Leone,28/10/2003,0,0,0,0,0,0,0,0
Sierra Leone,29/10/2003,0,0,0,0,3,0,0,3
Sierra Leone,30/10/2003,2,0,0,0,-2,1,0,1
Sierra Leone,31/10/2003,3,0,0,0,0,0,0,3
Sierra Leone,01/11/2003,0,0,0,0,0,0,0,0
Sierra Leone,03/11/2003,0,0,0,0,0,0,0,0
Sierra Leone,04/11/2003,5,0,0,0,3,3,0,11
Sierra Leone,05/11/2003,2,0,0,0,0,0,0,2
Sierra Leone,06/11/2003,2,0,0,0,3,1,0,6
Sierra Leone,07/11/2003,4,0,0,0,3,0,0,7
Sierra Leone,08/11/2003,1,0,0,0,6,0,0,7
Sierra Leone,09/11/2003,2,0,0,0,15,0,0,17
Sierra Leone,10/11/2003,2,0,0,0,4,2,0,8
Sierra Leone,11/11/2003,2,0,0,0,12,0,0,14
Sierra Leone,12/11/2003,3,0,0,0,0,1,0,4
Sierra Leone,14/11/2003,1,0,0,0,0,0,0,1
Sierra Leone,17/11/2003,2,0,0,0,0,0,0,2
Sierra Leone,18/11/2003,3,0,0,0,0,0,0,3
Sierra Leone,19/11/2003,0,0,0,0,0,0,0,0
Sierra Leone,20/11/2003,0,2,0,0,0,0,0,2
Sierra Leone,21/11/2003,5,0,0,0,0,0,0,5
Sierra Leone,24/11/2003,2,0,0,0,18,0,0,20
Sierra Leone,25/11/2003,1,0,0,0,6,0,0,7
Sierra Leone,26/11/2003,0,0,0,0,0,0,0,0
Sierra Leone,27/11/2003,0,0,0,0,0,0,0,0
Sierra Leone,28/11/2003,-2,0,0,0,3,0,0,1
Sierra Leone,29/11/2003,0,0,0,0,0,0,0,0
Sierra Leone,30/11/2003,0,0,0,0,0,0,0,0
Sierra Leone,01/12/2003,0,0,0,0,6,0,0,6
Sierra Leone,02/12/2003,0,0,0,0,0,0,0,0
Sierra Leone,03/12/2003,0,0,0,0,0,0,0,0
Sierra Leone,04/12/2003,14,0,1,0,12,0,0,27
Sierra Leone,05/12/2003,10,0,0,0,12,1,0,23
Sierra Leone,06/12/2003,0,0,0,0,0,0,0,0
Sierra Leone,07/12/2003,0,0,0,0,3,1,0,4
Sierra Leone,08/12/2003,-2,0,0,0,3,1,0,2
Sierra Leone,10/12/2003,3,0,0,0,7,0,0,10
Sierra Leone,11/12/2003,0,0,0,0,4,0,0,4
Sierra Leone,12/12/2003,6,0,0,0,0,0,0,6
Sierra Leone,13/12/2003,2,0,0,0,9,0,0,11
Sierra Leone,14/12/2003,0,0,0,0,3,0,0,3
Sierra Leone,15/12/2003,0,0,0,0,6,0,0,6
Sierra Leone,16/12/2003,0,0,0,0,0,0,0,0
Sierra Leone,17/12/2003,0,0,0,0,0,0,0,0
Sierra Leone,18/12/2003,1,0,0,0,0,0,0,1
Sierra Leone,19/12/2003,0,0,0,0,0,1,0,1
Sierra Leone,20/12/2003,0,0,0,0,0,0,0,0
Sierra Leone,22/12/2003,2,0,0,0,3,2,0,7
Sierra Leone,23/12/2003,0,0,0,0,0,0,0,0
Sierra Leone,24/12/2003,0,0,0,0,0,0,0,0
Sierra Leone,26/12/2003,0,0,0,0,0,0,0,0
Sierra Leone,27/12/2003,0,0,0,0,0,0,0,0
Sierra Leone,28/12/2003,0,0,0,0,0,0,0,0
Sierra Leone,29/12/2003,2,0,0,0,0,2,0,4
Sierra Leone,30/12/2003,2,0,0,0,3,2,0,7
Sierra Leone,31/12/2003,0,0,0,0,0,0,0,0
Somalia,01/01/2003,0,0,0,0,3,0,0,3
Somalia,02/01/2003,2,0,0,0,0,0,0,2
Somalia,03/01/2003,1,4,0,0,0,0,0,5
Somalia,04/01/2003,0,0,0,0,0,0,0,0
Somalia,05/01/2003,5,0,0,0,0,2,0,7
Somalia,06/01/2003,1,0,0,0,3,0,0,4
Somalia,07/01/2003,3,0,0,0,0,0,0,3
Somalia,08/01/2003,2,0,0,0,9,0,0,11
Somalia,09/01/2003,4,0,0,0,6,0,0,10
Somalia,10/01/2003,2,0,0,0,0,0,0,2
Somalia,11/01/2003,6,0,0,0,3,0,0,9
Somalia,12/01/2003,6,0,0,0,0,0,0,6
Somalia,13/01/2003,1,0,0,0,0,0,0,1
Somalia,14/01/2003,5,0,0,0,0,0,0,5
Somalia,15/01/2003,9,0,0,0,0,0,0,9
Somalia,16/01/2003,0,0,1,0,0,0,0,1
Somalia,17/01/2003,24,0,0,0,-6,0,0,18
Somalia,19/01/2003,0,0,0,0,0,0,0,0
Somalia,20/01/2003,4,0,-4,0,9,1,0,10
Somalia,21/01/2003,6,0,-4,0,9,0,0,11
Somalia,22/01/2003,1,0,0,0,0,0,0,1
Somalia,23/01/2003,0,0,0,0,0,2,0,2
Somalia,24/01/2003,7,0,0,0,0,0,0,7
Somalia,25/01/2003,3,0,0,0,0,0,0,3
Somalia,26/01/2003,-3,0,0,0,0,0,0,-3
Somalia,27/01/2003,5,0,0,0,3,0,0,8
Somalia,28/01/2003,9,0,0,0,3,0,0,12
Somalia,29/01/2003,1,0,0,0,3,2,0,6
Somalia,30/01/2003,9,0,0,0,0,6,0,15
Somalia,31/01/2003,5,0,0,0,0,0,0,5
Somalia,01/02/2003,0,0,0,0,0,0,0,0
Somalia,02/02/2003,8,0,0,0,9,0,0,17
Somalia,03/02/2003,-1,0,0,0,0,0,0,-1
Somalia,04/02/2003,0,0,0,0,0,0,0,0
Somalia,05/02/2003,0,0,0,0,0,0,0,0
Somalia,06/02/2003,0,0,0,0,0,0,0,0
Somalia,07/02/2003,-3,0,0,0,0,0,0,-3
Somalia,08/02/2003,8,0,0,0,0,0,0,8
Somalia,09/02/2003,3,0,0,0,1,0,0,4
Somalia,10/02/2003,2,0,0,0,0,1,0,3
Somalia,11/02/2003,0,0,0,0,0,0,0,0
Somalia,12/02/2003,1,0,0,0,0,0,0,1
Somalia,13/02/2003,5,0,0,0,0,0,0,5
Somalia,14/02/2003,1,0,0,0,0,0,0,1
Somalia,15/02/2003,0,0,0,0,0,0,0,0
Somalia,16/02/2003,7,0,0,0,0,0,0,7
Somalia,17/02/2003,6,4,0,0,9,2,0,21
Somalia,18/02/2003,3,0,0,0,6,0,0,9
Somalia,19/02/2003,0,0,0,0,0,0,0,0
Somalia,20/02/2003,2,0,0,0,0,0,0,2
Somalia,21/02/2003,2,0,0,0,0,0,0,2
Somalia,22/02/2003,0,0,0,0,0,0,0,0
Somalia,24/02/2003,0,0,0,0,3,0,0,3
Somalia,25/02/2003,3,2,0,0,0,0,0,5
Somalia,26/02/2003,0,0,0,0,0,0,0,0
Somalia,27/02/2003,0,0,0,0,0,0,0,0
Somalia,28/02/2003,2,0,0,0,0,0,0,2
Somalia,01/03/2003,0,0,-1,0,0,1,0,0
Somalia,02/03/2003,3,0,0,0,6,0,0,9
Somalia,03/03/2003,7,0,0,0,3,0,0,10
Somalia,04/03/2003,1,0,0,0,-6,0,0,-5
Somalia,05/03/2003,0,0,0,0,4,0,0,4
Somalia,06/03/2003,6,0,0,0,0,0,0,6
Somalia,07/03/2003,2,0,0,0,0,0,0,2
Somalia,09/03/2003,6,0,0,0,0,2,0,8
Somalia,10/03/2003,15,0,0,0,0,3,0,18
Somalia,11/03/2003,0,0,0,0,0,0,0,0
Somalia,12/03/2003,6,0,0,0,-2,0,0,4
Somalia,13/03/2003,2,0,0,0,0,0,0,2
Somalia,14/03/2003,0,0,0,0,3,3,0,6
Somalia,15/03/2003,12,0,0,0,-2,0,0,10
Somalia,16/03/2003,5,0,-2,0,0,0,0,3
Somalia,17/03/2003,0,0,0,0,0,0,0,0
Somalia,18/03/2003,6,0,0,0,0,0,0,6
Somalia,19/03/2003,2,0,0,0,-2,0,0,0
Somalia,20/03/2003,2,0,0,0,3,0,0,5
Somalia,21/03/2003,-10,0,0,0,-26,1,0,-35
Somalia,22/03/2003,0,0,0,0,0,0,0,0
Somalia,23/03/2003,0,0,0,0,3,0,0,3
Somalia,24/03/2003,9,0,0,0,0,0,0,9
Somalia,25/03/2003,0,0,0,0,0,0,0,0
Somalia,26/03/2003,2,0,0,0,0,0,0,2
Somalia,27/03/2003,3,0,0,0,0,0,0,3
Somalia,28/03/2003,5,0,0,0,0,2,0,7
Somalia,29/03/2003,9,0,0,0,0,0,0,9
Somalia,30/03/2003,6,0,0,0,-2,0,0,4
Somalia,31/03/2003,4,0,0,0,0,0,0,4
Somalia,01/04/2003,0,0,1,0,0,0,0,1
Somalia,02/04/2003,0,0,0,0,0,0,0,0
Somalia,03/04/2003,3,0,-3,0,7,1,0,8
Somalia,04/04/2003,0,0,0,0,3,0,0,3
Somalia,06/04/2003,6,0,0,0,0,0,0,6
Somalia,07/04/2003,-2,0,1,0,0,0,0,-1
Somalia,08/04/2003,6,0,0,0,0,0,0,6
Somalia,09/04/2003,1,0,1,0,0,0,0,2
Somalia,10/04/2003,7,0,0,0,0,0,0,7
Somalia,11/04/2003,0,0,0,0,9,3,0,12
Somalia,12/04/2003,0,0,0,0,0,0,0,0
Somalia,13/04/2003,1,0,0,0,0,0,0,1
Somalia,15/04/2003,2,0,1,0,0,1,0,4
Somalia,16/04/2003,5,0,0,0,0,0,0,5
Somalia,17/04/2003,-3,0,0,0,0,0,0,-3
Somalia,18/04/2003,0,0,0,0,0,2,0,2
Somalia,19/04/2003,0,0,0,0,0,0,0,0
Somalia,21/04/2003,0,0,0,0,0,0,0,0
Somalia,22/04/2003,0,0,0,0,0,0,0,0
Somalia,23/04/2003,0,0,0,0,0,0,0,0
Somalia,24/04/2003,-2,0,0,0,0,0,0,-2
Somalia,27/04/2003,1,0,0,0,0,0,0,1
Somalia,28/04/2003,0,0,0,0,6,1,0,7
Somalia,29/04/2003,1,0,0,0,0,0,0,1
Somalia,30/04/2003,-3,0,0,0,0,0,0,-3
Somalia,02/05/2003,0,0,2,0,0,0,0,2
Somalia,03/05/2003,8,0,0,0,0,0,0,8
Somalia,04/05/2003,0,0,0,0,0,0,0,0
Somalia,05/05/2003,9,0,1,0,0,0,0,10
Somalia,06/05/2003,0,0,0,0,0,3,0,3
Somalia,07/05/2003,0,0,0,0,0,0,0,0
Somalia,08/05/2003,6,0,0,0,-6,1,0,1
Somalia,09/05/2003,0,0,0,0,3,0,0,3
Somalia,11/05/2003,1,0,0,0,0,0,0,1
Somalia,12/05/2003,1,0,0,0,3,0,0,4
Somalia,13/05/2003,2,0,0,0,-6,0,0,-4
Somalia,15/05/2003,16,0,1,0,0,3,0,20
Somalia,16/05/2003,8,0,0,0,3,0,0,11
Somalia,17/05/2003,6,0,0,0,-6,0,0,0
Somalia,18/05/2003,3,0,0,0,0,1,0,4
Somalia,20/05/2003,12,0,0,0,-2,3,0,13
Somalia,21/05/2003,0,0,0,0,-1,0,0,-1
Somalia,23/05/2003,5,0,0,0,4,0,0,9
Somalia,25/05/2003,0,0,0,0,0,0,0,0
Somalia,26/05/2003,3,0,0,0,3,0,0,6
Somalia,27/05/2003,0,0,0,0,0,0,0,0
Somalia,28/05/2003,4,0,0,0,0,0,0,4
Somalia,29/05/2003,0,0,0,0,0,0,0,0
Somalia,30/05/2003,0,0,0,0,3,0,0,3
Somalia,31/05/2003,-1,0,0,0,0,0,0,-1
Somalia,01/06/2003,0,0,0,0,0,0,0,0
Somalia,02/06/2003,-2,0,0,0,0,0,0,-2
Somalia,03/06/2003,1,0,0,0,0,0,0,1
Somalia,04/06/2003,0,0,0,0,0,0,0,0
Somalia,05/06/2003,6,0,0,0,0,0,0,6
Somalia,06/06/2003,0,0,0,0,-6,0,0,-6
Somalia,07/06/2003,0,0,0,0,0,0,0,0
Somalia,08/06/2003,2,0,0,0,0,0,0,2
Somalia,09/06/2003,0,0,0,0,0,0,0,0
Somalia,10/06/2003,1,0,0,0,0,0,0,1
Somalia,11/06/2003,1,0,0,0,0,0,0,1
Somalia,12/06/2003,-3,0,0,0,0,0,0,-3
Somalia,14/06/2003,2,0,0,0,0,0,0,2
Somalia,15/06/2003,2,0,0,0,0,0,0,2
Somalia,16/06/2003,0,0,0,0,-2,0,0,-2
Somalia,17/06/2003,4,0,0,0,0,0,0,4
Somalia,18/06/2003,0,0,0,0,0,0,0,0
Somalia,19/06/2003,0,0,0,0,4,0,0,4
Somalia,20/06/2003,0,0,0,0,-4,0,0,-4
Somalia,21/06/2003,3,0,0,0,9,0,0,12
Somalia,22/06/2003,3,0,0,0,36,1,0,40
Somalia,23/06/2003,20,1,0,0,18,1,0,40
Somalia,24/06/2003,3,0,0,0,6,3,0,12
Somalia,25/06/2003,11,0,0,0,6,0,0,17
Somalia,26/06/2003,11,0,0,0,3,0,0,14
Somalia,27/06/2003,7,0,0,0,15,0,0,22
Somalia,28/06/2003,2,0,0,0,0,0,0,2
Somalia,29/06/2003,0,0,0,0,3,0,0,3
Somalia,30/06/2003,1,0,0,0,0,0,0,1
Somalia,01/07/2003,9,0,0,0,3,0,0,12
Somalia,02/07/2003,0,0,0,0,3,0,0,3
Somalia,03/07/2003,0,0,0,0,0,0,0,0
Somalia,04/07/2003,3,1,0,0,3,0,0,7
Somalia,05/07/2003,2,0,0,0,15,0,0,17
Somalia,06/07/2003,5,0,0,0,3,0,0,8
Somalia,07/07/2003,14,0,0,0,0,0,0,14
Somalia,08/07/2003,7,0,0,0,15,0,0,22
Somalia,09/07/2003,3,0,0,0,0,0,0,3
Somalia,10/07/2003,8,0,0,0,0,2,0,10
Somalia,11/07/2003,2,0,0,0,0,0,0,2
Somalia,12/07/2003,1,0,0,0,0,0,0,1
Somalia,13/07/2003,0,0,0,0,0,0,0,0
Somalia,14/07/2003,1,0,0,0,0,0,0,1
Somalia,15/07/2003,0,0,0,0,0,0,0,0
Somalia,16/07/2003,4,0,0,0,0,0,0,4
Somalia,17/07/2003,3,0,0,0,0,0,0,3
Somalia,18/07/2003,15,0,0,0,0,0,0,15
Somalia,19/07/2003,0,0,0,0,0,0,0,0
Somalia,20/07/2003,5,0,0,0,0,0,0,5
Somalia,21/07/2003,2,0,0,0,0,2,0,4
Somalia,22/07/2003,0,0,0,0,0,0,0,0
Somalia,23/07/2003,6,0,0,0,0,0,0,6
Somalia,24/07/2003,13,0,0,0,0,0,0,13
Somalia,25/07/2003,13,0,0,0,0,0,0,13
Somalia,28/07/2003,0,0,0,0,0,0,0,0
Somalia,29/07/2003,10,0,0,0,0,0,0,10
Somalia,30/07/2003,5,0,0,0,0,1,0,6
Somalia,31/07/2003,2,0,1,0,0,0,0,3
Somalia,01/08/2003,0,0,0,0,0,0,0,0
Somalia,02/08/2003,0,0,0,0,0,0,0,0
Somalia,03/08/2003,9,0,0,0,6,0,0,15
Somalia,04/08/2003,4,0,0,0,1,0,0,5
Somalia,05/08/2003,5,0,0,0,9,0,0,14
Somalia,06/08/2003,16,0,0,0,0,0,0,16
Somalia,07/08/2003,8,0,0,0,0,0,0,8
Somalia,08/08/2003,10,0,0,0,0,0,0,10
Somalia,09/08/2003,3,0,0,0,0,0,0,3
Somalia,10/08/2003,2,0,0,0,7,0,0,9
Somalia,11/08/2003,0,0,0,0,0,0,0,0
Somalia,12/08/2003,4,0,0,0,0,0,0,4
Somalia,13/08/2003,7,0,0,0,0,0,0,7
Somalia,15/08/2003,0,0,0,0,-2,0,0,-2
Somalia,16/08/2003,0,0,0,0,0,0,0,0
Somalia,17/08/2003,0,0,0,0,0,0,0,0
Somalia,18/08/2003,-1,0,0,0,0,3,0,2
Somalia,19/08/2003,0,0,0,0,0,0,0,0
Somalia,20/08/2003,6,0,0,0,6,0,0,12
Somalia,21/08/2003,5,0,0,0,2,0,0,7
Somalia,22/08/2003,6,0,0,0,-2,1,0,5
Somalia,23/08/2003,0,0,0,0,-4,1,0,-3
Somalia,24/08/2003,0,0,0,0,0,0,0,0
Somalia,25/08/2003,0,0,0,0,0,0,0,0
Somalia,26/08/2003,0,0,0,0,3,0,0,3
Somalia,27/08/2003,1,0,0,0,-1,0,0,0
Somalia,28/08/2003,0,0,0,0,0,0,0,0
Somalia,29/08/2003,0,0,0,0,0,0,0,0
Somalia,30/08/2003,0,0,0,0,0,0,0,0
Somalia,31/08/2003,0,0,0,0,3,0,0,3
Somalia,01/09/2003,1,0,0,0,9,0,0,10
Somalia,02/09/2003,2,0,0,0,0,0,0,2
Somalia,03/09/2003,2,0,0,0,0,0,0,2
Somalia,04/09/2003,18,2,0,0,-4,0,0,16
Somalia,05/09/2003,4,0,0,0,0,0,0,4
Somalia,06/09/2003,0,0,-1,0,0,0,0,-1
Somalia,07/09/2003,18,0,0,0,0,0,0,18
Somalia,09/09/2003,0,0,0,0,0,0,0,0
Somalia,10/09/2003,0,0,0,0,0,0,0,0
Somalia,11/09/2003,0,0,0,0,0,0,0,0
Somalia,12/09/2003,0,0,0,0,0,0,0,0
Somalia,13/09/2003,7,0,0,0,0,0,0,7
Somalia,16/09/2003,14,0,0,0,0,2,0,16
Somalia,17/09/2003,0,0,0,0,0,0,0,0
Somalia,18/09/2003,6,0,0,0,0,2,0,8
Somalia,19/09/2003,9,0,0,0,0,0,0,9
Somalia,20/09/2003,1,0,0,0,0,0,0,1
Somalia,21/09/2003,0,0,0,0,9,0,0,9
Somalia,22/09/2003,2,0,0,0,0,0,0,2
Somalia,23/09/2003,0,0,0,0,0,0,0,0
Somalia,24/09/2003,7,0,0,0,0,0,0,7
Somalia,25/09/2003,16,0,0,0,0,1,0,17
Somalia,26/09/2003,15,0,0,0,0,1,0,16
Somalia,27/09/2003,6,0,0,0,0,0,0,6
Somalia,28/09/2003,0,0,0,0,0,0,0,0
Somalia,29/09/2003,-7,0,0,0,0,2,0,-5
Somalia,30/09/2003,7,0,1,0,0,0,0,8
Somalia,01/10/2003,0,0,0,0,0,0,0,0
Somalia,02/10/2003,2,0,0,0,0,0,0,2
Somalia,03/10/2003,0,0,0,0,3,0,0,3
Somalia,05/10/2003,-3,0,0,0,0,0,0,-3
Somalia,06/10/2003,9,0,0,0,0,0,0,9
Somalia,07/10/2003,39,0,0,0,0,0,0,39
Somalia,08/10/2003,6,0,0,0,0,0,0,6
Somalia,09/10/2003,5,0,0,0,3,0,0,8
Somalia,10/10/2003,9,0,0,0,0,0,0,9
Somalia,12/10/2003,0,0,0,0,0,0,0,0
Somalia,13/10/2003,4,0,0,0,0,0,0,4
Somalia,14/10/2003,0,0,0,0,0,0,0,0
Somalia,15/10/2003,0,0,0,0,0,0,0,0
Somalia,16/10/2003,0,0,0,0,3,0,0,3
Somalia,17/10/2003,0,0,0,0,0,1,0,1
Somalia,18/10/2003,0,0,0,0,0,0,0,0
Somalia,19/10/2003,18,0,0,0,0,0,0,18
Somalia,20/10/2003,16,0,0,0,0,0,0,16
Somalia,21/10/2003,-1,0,0,0,0,1,0,0
Somalia,22/10/2003,0,0,0,0,0,0,0,0
Somalia,23/10/2003,4,0,0,0,0,0,0,4
Somalia,24/10/2003,6,0,0,0,3,3,0,12
Somalia,25/10/2003,-6,0,0,0,0,0,0,-6
Somalia,26/10/2003,0,0,0,0,0,0,0,0
Somalia,27/10/2003,12,0,0,0,0,0,0,12
Somalia,28/10/2003,5,0,0,0,6,0,0,11
Somalia,29/10/2003,16,0,0,0,27,0,0,43
Somalia,30/10/2003,0,0,0,0,-2,0,0,-2
Somalia,31/10/2003,10,0,0,0,0,0,0,10
Somalia,01/11/2003,6,0,0,0,0,0,0,6
Somalia,02/11/2003,2,0,0,0,-2,0,0,0
Somalia,03/11/2003,6,0,0,0,0,0,0,6
Somalia,04/11/2003,-3,0,0,0,0,0,0,-3
Somalia,05/11/2003,6,0,0,0,0,0,0,6
Somalia,06/11/2003,9,0,0,0,24,0,0,33
Somalia,07/11/2003,4,0,0,0,0,0,0,4
Somalia,08/11/2003,0,0,0,0,0,0,0,0
Somalia,09/11/2003,0,0,0,0,0,0,0,0
Somalia,10/11/2003,3,0,0,0,0,0,0,3
Somalia,11/11/2003,0,0,0,0,9,0,0,9
Somalia,12/11/2003,0,0,0,0,0,0,0,0
Somalia,13/11/2003,0,0,0,0,0,0,0,0
Somalia,14/11/2003,12,0,0,0,0,0,0,12
Somalia,15/11/2003,3,0,0,0,0,0,0,3
Somalia,16/11/2003,0,0,0,0,0,0,0,0
Somalia,17/11/2003,0,0,0,0,0,0,0,0
Somalia,18/11/2003,7,0,1,0,0,1,0,9
Somalia,19/11/2003,0,0,0,0,0,0,0,0
Somalia,20/11/2003,2,0,0,0,0,0,0,2
Somalia,22/11/2003,0,0,0,0,-4,0,0,-4
Somalia,23/11/2003,3,0,0,0,0,0,0,3
Somalia,24/11/2003,10,0,-4,0,4,0,0,10
Somalia,25/11/2003,4,0,-6,0,3,0,0,1
Somalia,27/11/2003,2,0,0,0,0,0,0,2
Somalia,28/11/2003,-1,0,0,0,9,0,0,8
Somalia,29/11/2003,-3,0,0,0,3,0,0,0
Somalia,30/11/2003,11,0,0,0,9,0,0,20
Somalia,01/12/2003,3,2,0,0,0,1,0,6
Somalia,02/12/2003,2,0,0,0,2,0,0,4
Somalia,03/12/2003,4,0,0,0,0,0,0,4
Somalia,04/12/2003,0,0,0,0,-2,0,0,-2
Somalia,05/12/2003,0,0,0,0,0,0,0,0
Somalia,06/12/2003,0,0,0,0,0,0,0,0
Somalia,07/12/2003,0,2,0,0,0,0,0,2
Somalia,08/12/2003,8,0,1,0,3,0,0,12
Somalia,09/12/2003,8,0,0,0,0,0,0,8
Somalia,10/12/2003,0,0,0,0,0,0,0,0
Somalia,11/12/2003,0,0,0,0,0,0,0,0
Somalia,12/12/2003,7,0,0,0,6,0,0,13
Somalia,13/12/2003,0,0,0,0,0,0,0,0
Somalia,15/12/2003,0,0,0,0,0,0,0,0
Somalia,16/12/2003,0,0,0,0,0,0,0,0
Somalia,17/12/2003,0,0,0,0,6,0,0,6
Somalia,18/12/2003,0,0,0,0,0,0,0,0
Somalia,19/12/2003,2,0,0,0,0,0,0,2
Somalia,21/12/2003,0,0,0,0,0,0,0,0
Somalia,22/12/2003,0,0,0,0,0,0,0,0
Somalia,23/12/2003,1,0,0,0,0,0,0,1
Somalia,25/12/2003,0,0,0,0,-4,0,0,-4
Somalia,28/12/2003,3,0,0,0,0,0,0,3
Somalia,29/12/2003,5,0,0,0,0,0,0,5
Somalia,30/12/2003,6,0,0,0,0,0,0,6
Somalia,31/12/2003,0,0,0,0,0,0,0,0
Syria,01/01/2003,0,0,0,0,0,0,0,0
Syria,02/01/2003,-1,0,0,0,0,0,0,-1
Syria,03/01/2003,1,0,0,0,0,0,0,1
Syria,04/01/2003,-1,0,0,0,0,0,0,-1
Syria,05/01/2003,2,0,0,0,19,0,0,21
Syria,06/01/2003,0,0,0,0,0,0,0,0
Syria,07/01/2003,2,0,0,0,0,0,0,2
Syria,08/01/2003,0,0,0,0,0,0,0,0
Syria,09/01/2003,3,0,0,0,10,0,0,13
Syria,10/01/2003,9,0,0,0,12,0,0,21
Syria,11/01/2003,4,0,0,0,0,0,0,4
Syria,12/01/2003,-1,0,0,0,0,0,0,-1
Syria,13/01/2003,3,0,0,0,-5,0,0,-2
Syria,14/01/2003,6,0,0,0,0,6,0,12
Syria,15/01/2003,2,0,2,0,0,0,0,4
Syria,16/01/2003,8,0,0,0,0,0,0,8
Syria,17/01/2003,0,0,0,0,0,2,0,2
Syria,18/01/2003,-35,0,0,0,6,1,0,-28
Syria,19/01/2003,5,0,0,0,0,0,0,5
Syria,20/01/2003,0,0,0,0,0,0,0,0
Syria,21/01/2003,7,0,1,0,0,0,0,8
Syria,22/01/2003,3,0,0,0,0,0,0,3
Syria,23/01/2003,7,0,0,0,0,0,0,7
Syria,24/01/2003,4,0,0,0,0,0,0,4
Syria,25/01/2003,4,0,0,0,0,0,0,4
Syria,26/01/2003,0,0,0,0,6,0,0,6
Syria,27/01/2003,9,0,0,0,0,0,0,9
Syria,28/01/2003,2,0,0,0,4,0,0,6
Syria,29/01/2003,3,0,0,0,4,0,0,7
Syria,30/01/2003,4,0,0,0,3,0,0,7
Syria,31/01/2003,-2,0,0,0,0,1,0,-1
Syria,01/02/2003,2,0,0,0,6,0,0,8
Syria,02/02/2003,2,0,0,0,0,0,0,2
Syria,03/02/2003,10,0,0,0,0,0,0,10
Syria,04/02/2003,2,0,0,0,6,0,0,8
Syria,05/02/2003,6,0,0,0,0,0,0,6
Syria,06/02/2003,0,0,0,0,6,0,0,6
Syria,07/02/2003,2,0,0,0,-6,1,0,-3
Syria,08/02/2003,0,0,0,0,0,0,0,0
Syria,09/02/2003,0,0,0,0,0,1,0,1
Syria,10/02/2003,2,0,0,0,0,0,0,2
Syria,11/02/2003,4,0,0,0,0,0,0,4
Syria,12/02/2003,0,0,0,0,0,0,0,0
Syria,13/02/2003,0,0,1,0,0,0,0,1
Syria,14/02/2003,4,0,0,0,0,0,0,4
Syria,15/02/2003,1,0,0,0,0,0,0,1
Syria,16/02/2003,3,0,0,0,0,0,0,3
Syria,17/02/2003,0,0,0,0,0,0,0,0
Syria,18/02/2003,2,0,0,0,0,0,0,2
Syria,19/02/2003,0,0,0,0,3,0,0,3
Syria,20/02/2003,21,0,-2,0,6,2,0,27
Syria,21/02/2003,6,0,0,0,2,4,0,12
Syria,22/02/2003,0,0,0,0,0,0,0,0
Syria,23/02/2003,2,0,0,0,0,0,0,2
Syria,24/02/2003,12,2,0,0,0,0,0,14
Syria,25/02/2003,18,0,0,0,0,0,0,18
Syria,26/02/2003,2,0,0,0,0,0,0,2
Syria,27/02/2003,15,0,0,0,0,0,0,15
Syria,28/02/2003,15,0,0,0,0,3,0,18
Syria,01/03/2003,-1,0,0,0,0,0,0,-1
Syria,02/03/2003,4,0,0,0,0,1,0,5
Syria,03/03/2003,7,0,0,0,-2,2,0,7
Syria,04/03/2003,0,0,0,0,0,1,0,1
Syria,05/03/2003,3,0,0,0,6,3,0,12
Syria,06/03/2003,8,0,0,0,6,2,0,16
Syria,07/03/2003,4,0,0,0,3,1,0,8
Syria,08/03/2003,25,0,0,0,-4,3,0,24
Syria,09/03/2003,6,0,0,0,0,0,0,6
Syria,10/03/2003,14,0,0,0,0,0,0,14
Syria,11/03/2003,-1,0,0,0,-4,0,0,-5
Syria,12/03/2003,11,0,0,0,0,2,0,13
Syria,13/03/2003,9,0,0,0,3,0,0,12
Syria,14/03/2003,5,0,-1,0,0,0,0,4
Syria,15/03/2003,6,0,0,0,0,0,0,6
Syria,16/03/2003,13,0,0,0,0,0,0,13
Syria,17/03/2003,14,0,0,0,0,0,0,14
Syria,18/03/2003,9,0,0,0,0,2,0,11
Syria,19/03/2003,11,0,0,0,-1,0,0,10
Syria,20/03/2003,2,0,0,0,0,2,0,4
Syria,21/03/2003,1,0,0,0,0,0,0,1
Syria,22/03/2003,1,0,0,0,12,1,0,14
Syria,23/03/2003,6,0,0,0,-18,4,0,-8
Syria,24/03/2003,49,0,0,0,0,2,0,51
Syria,25/03/2003,15,0,0,0,-2,0,0,13
Syria,26/03/2003,1,0,0,0,0,0,0,1
Syria,27/03/2003,5,0,0,0,0,0,0,5
Syria,28/03/2003,6,0,0,0,3,4,0,13
Syria,29/03/2003,27,0,1,0,0,0,0,28
Syria,30/03/2003,9,0,0,0,0,0,0,9
Syria,31/03/2003,6,0,0,0,3,0,0,9
Syria,01/04/2003,19,0,0,0,9,3,0,31
Syria,02/04/2003,25,0,-6,0,12,6,0,37
Syria,03/04/2003,8,0,0,0,0,0,0,8
Syria,04/04/2003,9,0,0,0,6,0,0,15
Syria,05/04/2003,20,0,0,0,7,0,0,27
Syria,06/04/2003,29,0,0,0,3,4,0,36
Syria,07/04/2003,25,0,0,0,3,6,0,34
Syria,08/04/2003,17,0,-6,0,12,0,0,23
Syria,09/04/2003,30,0,4,0,0,0,0,34
Syria,10/04/2003,40,0,0,0,-2,0,0,38
Syria,11/04/2003,21,0,-1,0,15,4,0,39
Syria,12/04/2003,56,0,0,0,15,6,0,77
Syria,13/04/2003,76,0,0,0,12,0,0,88
Syria,14/04/2003,76,0,0,0,8,9,0,93
Syria,15/04/2003,67,0,-2,0,3,4,0,72
Syria,16/04/2003,42,0,0,0,-2,1,0,41
Syria,17/04/2003,12,0,0,0,8,5,0,25
Syria,18/04/2003,29,0,2,0,10,1,0,42
Syria,19/04/2003,38,2,2,0,3,2,0,47
Syria,20/04/2003,5,0,0,0,-2,4,0,7
Syria,21/04/2003,27,0,0,0,8,0,0,35
Syria,22/04/2003,18,0,-2,0,3,2,0,21
Syria,23/04/2003,10,0,0,0,0,0,0,10
Syria,24/04/2003,17,0,0,0,0,1,0,18
Syria,25/04/2003,7,0,0,0,3,0,0,10
Syria,26/04/2003,3,0,0,0,0,0,0,3
Syria,27/04/2003,6,0,0,0,0,0,0,6
Syria,28/04/2003,6,0,0,0,5,0,0,11
Syria,29/04/2003,11,0,0,0,5,0,0,16
Syria,30/04/2003,9,0,0,0,2,0,0,11
Syria,01/05/2003,10,0,0,0,0,0,0,10
Syria,02/05/2003,2,0,0,0,0,0,0,2
Syria,03/05/2003,13,0,0,0,9,0,0,22
Syria,04/05/2003,11,0,0,0,3,0,0,14
Syria,05/05/2003,5,0,0,0,1,1,0,7
Syria,06/05/2003,1,0,0,0,0,0,0,1
Syria,07/05/2003,0,0,0,0,3,0,0,3
Syria,08/05/2003,3,0,-2,0,0,0,0,1
Syria,09/05/2003,7,0,0,0,6,0,0,13
Syria,10/05/2003,5,0,1,0,3,0,0,9
Syria,11/05/2003,2,0,0,0,3,4,0,9
Syria,12/05/2003,13,0,0,0,0,0,0,13
Syria,13/05/2003,4,0,0,0,0,0,0,4
Syria,14/05/2003,9,0,0,0,0,0,0,9
Syria,15/05/2003,17,0,0,0,0,0,0,17
Syria,16/05/2003,3,0,0,0,6,0,0,9
Syria,17/05/2003,4,0,0,0,0,0,0,4
Syria,18/05/2003,12,0,0,0,0,0,0,12
Syria,19/05/2003,0,0,0,0,0,2,0,2
Syria,20/05/2003,7,0,0,0,0,1,0,8
Syria,21/05/2003,19,0,0,0,0,2,0,21
Syria,22/05/2003,21,0,0,0,3,2,0,26
Syria,23/05/2003,12,0,0,0,6,1,0,19
Syria,24/05/2003,6,0,0,0,2,0,0,8
Syria,25/05/2003,-1,0,0,0,0,0,0,-1
Syria,26/05/2003,1,0,0,0,-8,0,0,-7
Syria,27/05/2003,-11,0,0,0,7,2,0,-2
Syria,28/05/2003,0,0,0,0,24,2,0,26
Syria,29/05/2003,2,0,0,0,9,0,0,11
Syria,30/05/2003,23,0,0,0,6,0,0,29
Syria,31/05/2003,19,0,0,0,0,0,0,19
Syria,01/06/2003,0,0,0,0,0,2,0,2
Syria,02/06/2003,0,0,0,0,0,0,0,0
Syria,03/06/2003,7,0,0,0,0,0,0,7
Syria,04/06/2003,-1,0,0,0,15,0,0,14
Syria,05/06/2003,7,0,0,0,0,0,0,7
Syria,06/06/2003,-2,0,2,0,12,0,0,12
Syria,07/06/2003,0,0,0,0,5,0,0,5
Syria,08/06/2003,0,0,0,0,0,0,0,0
Syria,09/06/2003,10,0,0,0,0,8,0,18
Syria,10/06/2003,1,0,0,0,0,0,0,1
Syria,11/06/2003,0,0,0,0,0,0,0,0
Syria,12/06/2003,8,0,0,0,12,0,0,20
Syria,13/06/2003,4,0,0,0,13,5,0,22
Syria,14/06/2003,6,0,0,0,0,4,0,10
Syria,15/06/2003,12,0,0,0,-4,0,0,8
Syria,16/06/2003,-1,0,0,0,1,0,0,0
Syria,17/06/2003,7,0,0,0,3,0,0,10
Syria,18/06/2003,11,0,0,0,4,0,0,15
Syria,19/06/2003,3,0,0,0,0,0,0,3
Syria,20/06/2003,1,0,0,0,0,0,0,1
Syria,21/06/2003,5,0,0,0,0,0,0,5
Syria,22/06/2003,-7,0,0,0,3,0,0,-4
Syria,23/06/2003,18,0,0,0,3,0,0,21
Syria,24/06/2003,42,0,1,0,5,0,0,48
Syria,25/06/2003,29,0,0,0,0,1,0,30
Syria,26/06/2003,1,0,0,0,15,0,0,16
Syria,27/06/2003,0,0,0,0,0,0,0,0
Syria,28/06/2003,17,0,0,0,-2,0,0,15
Syria,29/06/2003,10,0,0,0,0,0,0,10
Syria,30/06/2003,6,0,0,0,9,0,0,15
Syria,01/07/2003,2,0,0,0,10,0,0,12
Syria,02/07/2003,5,0,0,0,0,0,0,5
Syria,03/07/2003,19,0,0,0,0,0,0,19
Syria,04/07/2003,3,0,0,0,0,0,0,3
Syria,05/07/2003,5,0,1,0,3,0,0,9
Syria,06/07/2003,0,0,0,0,0,0,0,0
Syria,07/07/2003,5,0,0,0,9,0,0,14
Syria,08/07/2003,3,0,0,0,3,2,0,8
Syria,09/07/2003,2,0,0,0,0,0,0,2
Syria,10/07/2003,19,0,0,0,0,0,0,19
Syria,11/07/2003,4,0,0,0,0,0,0,4
Syria,12/07/2003,8,0,0,0,0,0,0,8
Syria,13/07/2003,2,0,0,0,6,0,0,8
Syria,14/07/2003,0,0,0,0,9,0,0,9
Syria,15/07/2003,-15,0,0,0,-2,0,0,-17
Syria,16/07/2003,-16,0,1,0,-2,0,0,-17
Syria,17/07/2003,2,0,0,0,0,0,0,2
Syria,18/07/2003,10,0,0,0,3,0,0,13
Syria,19/07/2003,4,0,0,0,-2,0,0,2
Syria,20/07/2003,2,0,1,0,0,0,0,3
Syria,21/07/2003,6,0,0,0,0,0,0,6
Syria,22/07/2003,10,0,0,0,4,0,0,14
Syria,23/07/2003,12,0,0,0,6,0,0,18
Syria,24/07/2003,3,0,1,0,0,0,0,4
Syria,25/07/2003,2,0,0,0,3,0,0,5
Syria,26/07/2003,0,0,0,0,0,0,0,0
Syria,27/07/2003,1,0,0,0,0,0,0,1
Syria,28/07/2003,-3,0,0,0,0,0,0,-3
Syria,29/07/2003,6,0,0,0,0,0,0,6
Syria,30/07/2003,2,0,0,0,12,0,0,14
Syria,31/07/2003,2,0,-1,0,0,0,0,1
Syria,01/08/2003,3,0,0,0,0,0,0,3
Syria,02/08/2003,0,0,0,0,0,0,0,0
Syria,03/08/2003,6,0,0,0,0,0,0,6
Syria,04/08/2003,3,0,0,0,0,0,0,3
Syria,05/08/2003,3,2,-4,0,0,2,0,3
Syria,06/08/2003,4,0,0,0,0,0,0,4
Syria,07/08/2003,10,0,0,0,9,0,0,19
Syria,08/08/2003,14,0,0,0,9,0,0,23
Syria,09/08/2003,5,0,0,0,6,2,0,13
Syria,10/08/2003,78,0,0,0,12,0,0,90
Syria,11/08/2003,9,0,0,0,0,2,0,11
Syria,12/08/2003,2,0,0,0,3,0,0,5
Syria,13/08/2003,12,0,0,0,14,0,0,26
Syria,14/08/2003,14,0,0,0,18,0,0,32
Syria,15/08/2003,2,0,0,0,3,4,0,9
Syria,16/08/2003,14,0,0,0,2,2,0,18
Syria,17/08/2003,11,0,0,0,0,0,0,11
Syria,18/08/2003,-1,0,0,0,3,0,0,2
Syria,19/08/2003,1,0,0,0,3,0,0,4
Syria,20/08/2003,12,0,0,0,0,0,0,12
Syria,21/08/2003,9,0,0,0,0,0,0,9
Syria,22/08/2003,26,0,0,0,1,2,0,29
Syria,23/08/2003,1,0,0,0,0,0,0,1
Syria,24/08/2003,-5,0,0,0,0,0,0,-5
Syria,25/08/2003,1,0,0,0,0,0,0,1
Syria,26/08/2003,2,0,0,0,-6,0,0,-4
Syria,27/08/2003,1,0,0,0,3,0,0,4
Syria,28/08/2003,5,0,0,0,18,0,0,23
Syria,29/08/2003,8,0,0,0,3,0,0,11
Syria,30/08/2003,7,0,0,0,6,0,0,13
Syria,31/08/2003,7,0,0,0,0,1,0,8
Syria,01/09/2003,6,0,0,0,0,3,0,9
Syria,02/09/2003,8,0,0,0,17,0,0,25
Syria,03/09/2003,0,0,0,0,0,0,0,0
Syria,04/09/2003,1,0,0,0,3,1,0,5
Syria,05/09/2003,-2,0,0,0,4,0,0,2
Syria,06/09/2003,2,0,0,0,6,0,0,8
Syria,07/09/2003,2,0,0,0,10,0,0,12
Syria,08/09/2003,25,0,1,0,2,3,0,31
Syria,09/09/2003,12,0,0,0,4,0,0,16
Syria,10/09/2003,8,0,3,0,6,0,0,17
Syria,11/09/2003,6,2,0,0,3,0,0,11
Syria,12/09/2003,10,0,0,0,12,0,0,22
Syria,13/09/2003,0,0,0,0,0,0,0,0
Syria,14/09/2003,-3,0,0,0,6,0,0,3
Syria,15/09/2003,0,0,0,0,12,2,0,14
Syria,16/09/2003,3,0,0,0,3,0,0,6
Syria,17/09/2003,11,0,0,0,4,0,0,15
Syria,18/09/2003,8,0,0,0,33,1,0,42
Syria,19/09/2003,0,0,0,0,15,0,0,15
Syria,20/09/2003,5,0,0,0,9,0,0,14
Syria,21/09/2003,6,0,0,0,0,0,0,6
Syria,22/09/2003,5,0,0,0,3,0,0,8
Syria,23/09/2003,0,2,0,0,15,2,0,19
Syria,24/09/2003,3,0,0,0,48,0,0,51
Syria,25/09/2003,11,0,0,0,15,1,0,27
Syria,26/09/2003,1,0,0,0,11,0,0,12
Syria,27/09/2003,0,0,0,0,0,3,0,3
Syria,28/09/2003,0,0,1,0,9,0,0,10
Syria,29/09/2003,23,0,-2,0,6,0,0,27
Syria,30/09/2003,5,0,1,0,43,0,0,49
Syria,01/10/2003,2,0,1,0,15,0,0,18
Syria,02/10/2003,3,0,0,0,0,0,0,3
Syria,03/10/2003,4,0,0,0,0,2,0,6
Syria,04/10/2003,9,0,0,0,0,2,0,11
Syria,05/10/2003,94,2,0,0,-3,0,0,93
Syria,06/10/2003,73,0,0,0,-2,5,0,76
Syria,07/10/2003,58,0,2,0,17,3,0,80
Syria,08/10/2003,43,0,0,0,13,0,0,56
Syria,09/10/2003,32,0,0,0,6,7,0,45
Syria,10/10/2003,9,0,0,0,6,5,0,20
Syria,11/10/2003,15,0,0,0,6,2,0,23
Syria,12/10/2003,10,0,0,0,0,0,0,10
Syria,13/10/2003,16,0,0,0,6,0,0,22
Syria,14/10/2003,7,2,0,0,6,0,0,15
Syria,15/10/2003,35,0,0,0,6,0,0,41
Syria,16/10/2003,18,0,0,0,0,0,0,18
Syria,17/10/2003,15,0,0,0,3,4,0,22
Syria,18/10/2003,9,0,0,0,3,1,0,13
Syria,19/10/2003,3,0,0,0,0,0,0,3
Syria,20/10/2003,4,0,0,0,-8,0,0,-4
Syria,21/10/2003,2,0,2,0,0,0,0,4
Syria,22/10/2003,9,0,0,0,0,1,0,10
Syria,23/10/2003,12,4,0,0,0,0,0,16
Syria,24/10/2003,4,0,0,0,13,0,0,17
Syria,25/10/2003,0,0,0,0,3,1,0,4
Syria,26/10/2003,2,0,0,0,7,0,0,9
Syria,27/10/2003,25,0,0,0,0,0,0,25
Syria,28/10/2003,45,0,0,0,3,2,0,50
Syria,29/10/2003,11,0,0,0,0,4,0,15
Syria,30/10/2003,23,0,0,0,-1,0,0,22
Syria,31/10/2003,11,0,0,0,-1,0,0,10
Syria,01/11/2003,6,0,0,0,3,0,0,9
Syria,02/11/2003,6,0,0,0,4,0,0,10
Syria,03/11/2003,0,0,0,0,0,0,0,0
Syria,04/11/2003,-1,0,1,0,1,3,0,4
Syria,05/11/2003,9,0,0,0,4,0,0,13
Syria,06/11/2003,16,0,0,0,16,0,0,32
Syria,07/11/2003,5,0,0,0,19,0,0,24
Syria,08/11/2003,19,0,0,0,3,0,0,22
Syria,09/11/2003,5,0,0,0,3,0,0,8
Syria,10/11/2003,2,0,0,0,9,0,0,11
Syria,11/11/2003,2,0,0,0,9,0,0,11
Syria,12/11/2003,13,0,0,0,2,0,0,15
Syria,13/11/2003,37,0,0,0,18,1,0,56
Syria,14/11/2003,0,0,0,0,0,3,0,3
Syria,15/11/2003,0,0,0,0,-6,0,0,-6
Syria,16/11/2003,5,0,0,0,3,0,0,8
Syria,17/11/2003,14,0,-1,0,0,0,0,13
Syria,18/11/2003,3,0,0,0,15,2,0,20
Syria,19/11/2003,0,2,0,0,19,0,0,21
Syria,20/11/2003,10,0,0,0,15,0,0,25
Syria,21/11/2003,0,0,0,0,0,0,0,0
Syria,22/11/2003,7,0,0,0,0,0,0,7
Syria,23/11/2003,8,0,0,0,0,0,0,8
Syria,24/11/2003,9,0,0,0,3,0,0,12
Syria,25/11/2003,0,0,0,0,10,0,0,10
Syria,26/11/2003,6,0,0,0,0,0,0,6
Syria,27/11/2003,3,0,0,0,6,0,0,9
Syria,28/11/2003,1,0,0,0,15,3,0,19
Syria,29/11/2003,0,0,0,0,0,0,0,0
Syria,30/11/2003,1,0,0,0,5,10,0,16
Syria,01/12/2003,3,0,0,0,-8,0,0,-5
Syria,02/12/2003,10,0,0,0,-10,0,0,0
Syria,03/12/2003,7,0,0,0,19,0,0,26
Syria,04/12/2003,2,0,0,0,19,0,0,21
Syria,05/12/2003,3,0,0,0,3,0,0,6
Syria,06/12/2003,7,0,0,0,0,0,0,7
Syria,07/12/2003,15,0,0,0,3,3,0,21
Syria,08/12/2003,3,0,-2,0,8,0,0,9
Syria,09/12/2003,13,0,0,0,0,0,0,13
Syria,10/12/2003,1,0,1,0,6,0,0,8
Syria,11/12/2003,12,0,0,0,6,0,0,18
Syria,12/12/2003,0,0,0,0,0,0,0,0
Syria,13/12/2003,3,0,-2,0,3,2,0,6
Syria,14/12/2003,9,0,0,0,6,0,0,15
Syria,15/12/2003,3,0,0,0,3,0,0,6
Syria,16/12/2003,20,0,0,0,6,0,0,26
Syria,17/12/2003,20,0,0,0,0,0,0,20
Syria,18/12/2003,2,0,0,0,12,0,0,14
Syria,19/12/2003,0,0,0,0,18,0,0,18
Syria,20/12/2003,0,0,0,0,3,0,0,3
Syria,21/12/2003,0,0,0,0,3,0,0,3
Syria,22/12/2003,5,0,0,0,0,0,0,5
Syria,23/12/2003,11,0,0,0,9,0,0,20
Syria,24/12/2003,22,0,0,0,-3,1,0,20
Syria,25/12/2003,0,0,0,0,0,0,0,0
Syria,26/12/2003,6,0,0,0,6,3,0,15
Syria,27/12/2003,1,0,0,0,3,0,0,4
Syria,28/12/2003,-1,0,0,0,-2,0,0,-3
Syria,29/12/2003,7,0,0,0,0,0,0,7
Syria,30/12/2003,0,0,1,0,0,0,0,1
Syria,31/12/2003,5,0,0,0,0,0,0,5
Yemen,01/01/2003,3,0,0,0,-1,0,0,2
Yemen,02/01/2003,3,0,0,0,3,0,0,6
Yemen,03/01/2003,0,0,0,0,0,0,0,0
Yemen,04/01/2003,2,0,0,0,0,1,0,3
Yemen,05/01/2003,0,0,0,0,0,0,0,0
Yemen,06/01/2003,3,0,0,0,0,0,0,3
Yemen,07/01/2003,20,0,0,0,9,0,0,29
Yemen,08/01/2003,2,0,0,0,0,0,0,2
Yemen,09/01/2003,24,0,0,0,9,0,0,33
Yemen,10/01/2003,4,0,0,0,27,1,0,32
Yemen,11/01/2003,6,0,0,0,22,0,0,28
Yemen,12/01/2003,8,0,0,0,3,0,0,11
Yemen,13/01/2003,8,0,0,0,12,0,0,20
Yemen,14/01/2003,4,0,0,0,1,0,0,5
Yemen,15/01/2003,0,0,0,0,9,0,0,9
Yemen,16/01/2003,0,0,0,0,0,0,0,0
Yemen,17/01/2003,3,2,0,0,0,5,0,10
Yemen,18/01/2003,7,0,0,0,12,0,0,19
Yemen,19/01/2003,1,0,0,0,0,0,0,1
Yemen,20/01/2003,17,0,0,0,19,0,0,36
Yemen,21/01/2003,13,0,0,0,6,0,0,19
Yemen,22/01/2003,5,0,0,0,1,0,0,6
Yemen,23/01/2003,11,0,0,0,4,0,0,15
Yemen,24/01/2003,3,0,0,0,9,3,0,15
Yemen,25/01/2003,1,0,0,0,0,0,0,1
Yemen,26/01/2003,0,0,0,0,3,0,0,3
Yemen,27/01/2003,0,0,0,0,18,2,0,20
Yemen,28/01/2003,0,0,0,0,0,0,0,0
Yemen,29/01/2003,0,0,0,0,0,0,0,0
Yemen,30/01/2003,0,0,0,0,-4,0,0,-4
Yemen,31/01/2003,0,0,0,0,0,1,0,1
Yemen,01/02/2003,0,0,0,0,3,0,0,3
Yemen,02/02/2003,0,0,0,0,0,0,0,0
Yemen,03/02/2003,0,0,0,0,6,0,0,6
Yemen,04/02/2003,0,0,0,0,0,0,0,0
Yemen,06/02/2003,6,0,0,0,3,0,0,9
Yemen,07/02/2003,9,0,0,0,0,9,0,18
Yemen,09/02/2003,0,0,0,0,0,2,0,2
Yemen,10/02/2003,0,0,0,0,6,0,0,6
Yemen,11/02/2003,0,0,0,0,0,0,0,0
Yemen,12/02/2003,0,0,0,0,-1,0,0,-1
Yemen,13/02/2003,9,0,0,0,9,0,0,18
Yemen,14/02/2003,6,0,0,0,0,0,0,6
Yemen,15/02/2003,0,0,0,0,6,0,0,6
Yemen,17/02/2003,1,0,0,0,4,0,0,5
Yemen,18/02/2003,5,0,0,0,-1,0,0,4
Yemen,19/02/2003,0,2,0,0,0,0,0,2
Yemen,20/02/2003,0,0,0,0,3,0,0,3
Yemen,21/02/2003,6,0,0,0,0,4,0,10
Yemen,22/02/2003,-1,0,0,0,0,0,0,-1
Yemen,23/02/2003,12,0,0,0,0,0,0,12
Yemen,24/02/2003,6,0,0,0,0,0,0,6
Yemen,25/02/2003,7,0,-2,0,0,2,0,7
Yemen,26/02/2003,5,0,0,0,6,0,0,11
Yemen,27/02/2003,-3,0,0,0,0,0,0,-3
Yemen,28/02/2003,23,0,0,0,0,4,0,27
Yemen,01/03/2003,2,0,0,0,0,0,0,2
Yemen,02/03/2003,3,0,0,0,0,3,0,6
Yemen,03/03/2003,4,0,0,0,0,0,0,4
Yemen,04/03/2003,14,4,1,0,7,0,0,26
Yemen,05/03/2003,5,0,0,0,3,0,0,8
Yemen,06/03/2003,3,0,2,0,0,0,0,5
Yemen,07/03/2003,8,0,0,0,0,0,0,8
Yemen,08/03/2003,0,0,0,0,3,6,0,9
Yemen,09/03/2003,0,0,0,0,3,3,0,6
Yemen,10/03/2003,0,0,0,0,0,0,0,0
Yemen,11/03/2003,0,0,0,0,3,0,0,3
Yemen,12/03/2003,3,0,1,0,6,3,0,13
Yemen,13/03/2003,7,0,0,0,0,1,0,8
Yemen,15/03/2003,0,0,0,0,3,0,0,3
Yemen,16/03/2003,1,0,0,0,0,0,0,1
Yemen,17/03/2003,0,0,0,0,0,0,0,0
Yemen,18/03/2003,22,0,0,0,0,0,0,22
Yemen,19/03/2003,16,0,0,0,6,2,0,24
Yemen,20/03/2003,0,0,0,0,2,0,0,2
Yemen,21/03/2003,23,0,0,0,6,8,0,37
Yemen,22/03/2003,17,0,0,0,3,1,0,21
Yemen,23/03/2003,7,0,0,0,3,2,0,12
Yemen,24/03/2003,4,0,0,0,3,0,0,7
Yemen,25/03/2003,5,0,0,0,15,0,0,20
Yemen,26/03/2003,1,0,0,0,3,0,0,4
Yemen,27/03/2003,1,0,0,0,6,4,0,11
Yemen,28/03/2003,24,0,0,0,3,0,0,27
Yemen,29/03/2003,1,0,0,0,0,2,0,3
Yemen,30/03/2003,0,0,0,0,0,0,0,0
Yemen,31/03/2003,4,0,0,0,0,0,0,4
Yemen,01/04/2003,0,0,0,0,15,0,0,15
Yemen,02/04/2003,4,2,0,0,0,0,0,6
Yemen,04/04/2003,0,0,0,0,0,0,0,0
Yemen,05/04/2003,15,0,0,0,10,0,0,25
Yemen,06/04/2003,1,0,0,0,0,0,0,1
Yemen,07/04/2003,0,0,0,0,0,0,0,0
Yemen,08/04/2003,1,0,0,0,0,2,0,3
Yemen,09/04/2003,0,0,0,0,0,0,0,0
Yemen,10/04/2003,1,0,0,0,0,0,0,1
Yemen,11/04/2003,5,0,0,0,3,0,0,8
Yemen,13/04/2003,10,0,0,0,2,0,0,12
Yemen,14/04/2003,5,0,0,0,0,0,0,5
Yemen,15/04/2003,0,0,0,0,0,0,0,0
Yemen,16/04/2003,8,0,0,0,3,1,0,12
Yemen,17/04/2003,0,0,0,0,3,0,0,3
Yemen,18/04/2003,0,0,0,0,3,0,0,3
Yemen,19/04/2003,0,0,0,0,3,0,0,3
Yemen,21/04/2003,2,0,0,0,0,2,0,4
Yemen,22/04/2003,5,0,0,0,3,0,0,8
Yemen,23/04/2003,9,0,0,0,0,0,0,9
Yemen,24/04/2003,0,0,0,0,3,0,0,3
Yemen,25/04/2003,2,0,0,0,4,0,0,6
Yemen,27/04/2003,6,0,0,0,0,0,0,6
Yemen,28/04/2003,5,0,0,0,0,0,0,5
Yemen,29/04/2003,0,0,0,0,0,0,0,0
Yemen,30/04/2003,5,0,0,0,0,0,0,5
Yemen,01/05/2003,14,0,0,0,0,0,0,14
Yemen,02/05/2003,0,0,0,0,3,3,0,6
Yemen,03/05/2003,20,0,0,0,-2,0,0,18
Yemen,05/05/2003,0,0,0,0,0,0,0,0
Yemen,06/05/2003,2,0,0,0,0,0,0,2
Yemen,07/05/2003,0,0,0,0,0,0,0,0
Yemen,08/05/2003,0,0,2,0,0,0,0,2
Yemen,09/05/2003,0,0,0,0,3,0,0,3
Yemen,10/05/2003,8,0,0,0,10,1,0,19
Yemen,11/05/2003,0,0,0,0,0,0,0,0
Yemen,12/05/2003,6,0,0,0,0,0,0,6
Yemen,13/05/2003,10,0,0,0,9,6,0,25
Yemen,14/05/2003,1,0,0,0,0,1,0,2
Yemen,15/05/2003,9,0,0,0,21,0,0,30
Yemen,16/05/2003,30,0,0,0,21,0,0,51
Yemen,17/05/2003,12,0,0,0,12,0,0,24
Yemen,18/05/2003,6,0,0,0,9,6,0,21
Yemen,19/05/2003,6,0,0,0,12,15,0,33
Yemen,20/05/2003,3,0,0,0,0,6,0,9
Yemen,21/05/2003,19,0,0,0,6,0,0,25
Yemen,22/05/2003,0,0,0,0,0,0,0,0
Yemen,23/05/2003,0,0,0,0,0,0,0,0
Yemen,24/05/2003,4,0,0,0,3,1,0,8
Yemen,25/05/2003,6,0,0,0,0,0,0,6
Yemen,26/05/2003,2,0,0,0,0,0,0,2
Yemen,28/05/2003,6,0,0,0,48,0,0,54
Yemen,29/05/2003,0,0,0,0,0,0,0,0
Yemen,30/05/2003,3,0,0,0,-4,0,0,-1
Yemen,31/05/2003,6,0,0,0,3,0,0,9
Yemen,01/06/2003,3,0,0,0,3,0,0,6
Yemen,02/06/2003,13,0,0,0,0,0,0,13
Yemen,03/06/2003,6,0,0,0,0,2,0,8
Yemen,04/06/2003,5,0,0,0,3,0,0,8
Yemen,05/06/2003,0,0,0,0,9,0,0,9
Yemen,06/06/2003,8,0,0,0,0,0,0,8
Yemen,07/06/2003,0,0,0,0,0,0,0,0
Yemen,08/06/2003,2,0,0,0,0,0,0,2
Yemen,09/06/2003,5,0,0,0,0,0,0,5
Yemen,11/06/2003,0,0,0,0,0,0,0,0
Yemen,12/06/2003,0,0,0,0,0,2,0,2
Yemen,13/06/2003,3,0,0,0,3,1,0,7
Yemen,14/06/2003,1,0,0,0,0,0,0,1
Yemen,15/06/2003,0,0,0,0,3,0,0,3
Yemen,16/06/2003,0,0,0,0,0,0,0,0
Yemen,17/06/2003,0,0,0,0,0,0,0,0
Yemen,18/06/2003,0,0,0,0,3,0,0,3
Yemen,19/06/2003,2,0,0,0,-4,0,0,-2
Yemen,20/06/2003,13,0,0,0,12,0,0,25
Yemen,21/06/2003,3,0,0,0,15,0,0,18
Yemen,22/06/2003,20,0,0,0,4,0,0,24
Yemen,23/06/2003,2,0,0,0,0,0,0,2
Yemen,24/06/2003,0,0,0,0,0,0,0,0
Yemen,25/06/2003,29,0,0,0,7,6,0,42
Yemen,26/06/2003,30,0,0,0,10,4,0,44
Yemen,27/06/2003,12,0,0,0,0,2,0,14
Yemen,29/06/2003,8,0,0,0,0,0,0,8
Yemen,30/06/2003,0,0,0,0,-4,0,0,-4
Yemen,01/07/2003,3,0,0,0,3,0,0,6
Yemen,02/07/2003,1,0,0,0,0,0,0,1
Yemen,03/07/2003,2,0,0,0,9,0,0,11
Yemen,04/07/2003,0,0,0,0,0,0,0,0
Yemen,05/07/2003,0,0,0,0,0,0,0,0
Yemen,06/07/2003,0,0,0,0,0,0,0,0
Yemen,08/07/2003,18,0,0,0,0,0,0,18
Yemen,10/07/2003,0,0,0,0,1,0,0,1
Yemen,12/07/2003,9,0,0,0,0,0,0,9
Yemen,13/07/2003,3,0,0,0,0,2,0,5
Yemen,14/07/2003,1,0,0,0,6,0,0,7
Yemen,16/07/2003,0,0,0,0,0,0,0,0
Yemen,17/07/2003,1,0,0,0,0,0,0,1
Yemen,18/07/2003,0,0,0,0,0,0,0,0
Yemen,19/07/2003,0,0,0,0,0,0,0,0
Yemen,20/07/2003,2,0,0,0,0,0,0,2
Yemen,21/07/2003,3,0,2,0,16,1,0,22
Yemen,22/07/2003,3,0,0,0,0,2,0,5
Yemen,23/07/2003,-1,0,0,0,3,0,0,2
Yemen,24/07/2003,8,0,0,0,9,0,0,17
Yemen,25/07/2003,7,0,0,0,12,0,0,19
Yemen,26/07/2003,3,0,0,0,15,0,0,18
Yemen,27/07/2003,0,0,0,0,0,0,0,0
Yemen,28/07/2003,-2,0,0,0,3,0,0,1
Yemen,29/07/2003,2,0,0,0,0,0,0,2
Yemen,30/07/2003,12,0,0,0,-1,2,0,13
Yemen,31/07/2003,3,0,0,0,9,0,0,12
Yemen,01/08/2003,21,0,0,0,0,6,0,27
Yemen,02/08/2003,0,0,0,0,0,0,0,0
Yemen,03/08/2003,0,0,0,0,0,0,0,0
Yemen,04/08/2003,9,0,0,0,0,0,0,9
Yemen,05/08/2003,4,0,0,0,3,0,0,7
Yemen,06/08/2003,6,0,0,0,1,0,0,7
Yemen,07/08/2003,4,0,0,0,0,0,0,4
Yemen,09/08/2003,4,0,0,0,0,0,0,4
Yemen,10/08/2003,0,0,0,0,0,0,0,0
Yemen,11/08/2003,2,0,0,0,3,0,0,5
Yemen,12/08/2003,0,0,0,0,4,0,0,4
Yemen,13/08/2003,0,0,0,0,0,0,0,0
Yemen,14/08/2003,0,0,0,0,6,0,0,6
Yemen,16/08/2003,3,0,0,0,0,0,0,3
Yemen,17/08/2003,0,0,0,0,0,0,0,0
Yemen,18/08/2003,3,0,0,0,4,0,0,7
Yemen,19/08/2003,0,0,0,0,-6,0,0,-6
Yemen,20/08/2003,0,0,0,0,0,0,0,0
Yemen,21/08/2003,4,0,0,0,17,0,0,21
Yemen,22/08/2003,5,0,0,0,3,0,0,8
Yemen,23/08/2003,6,0,0,0,0,0,0,6
Yemen,24/08/2003,0,0,0,0,0,0,0,0
Yemen,25/08/2003,9,0,0,0,0,0,0,9
Yemen,26/08/2003,0,0,0,0,0,6,0,6
Yemen,27/08/2003,1,0,0,0,0,0,0,1
Yemen,28/08/2003,0,0,0,0,3,0,0,3
Yemen,30/08/2003,4,0,0,0,0,0,0,4
Yemen,31/08/2003,12,0,0,0,0,0,0,12
Yemen,01/09/2003,-2,0,0,0,0,0,0,-2
Yemen,02/09/2003,4,0,0,0,6,0,0,10
Yemen,03/09/2003,3,0,0,0,9,0,0,12
Yemen,04/09/2003,22,0,1,0,11,0,0,34
Yemen,05/09/2003,0,0,0,0,9,2,0,11
Yemen,06/09/2003,0,0,0,0,3,0,0,3
Yemen,07/09/2003,12,0,0,0,0,0,0,12
Yemen,08/09/2003,0,0,0,0,0,0,0,0
Yemen,09/09/2003,1,0,0,0,7,0,0,8
Yemen,10/09/2003,0,0,0,0,0,0,0,0
Yemen,11/09/2003,6,0,0,0,9,0,0,15
Yemen,12/09/2003,0,0,0,0,0,0,0,0
Yemen,13/09/2003,-1,0,0,0,0,2,0,1
Yemen,14/09/2003,6,0,0,0,0,1,0,7
Yemen,15/09/2003,0,0,0,0,0,0,0,0
Yemen,16/09/2003,0,0,0,0,3,0,0,3
Yemen,17/09/2003,0,0,0,0,6,0,0,6
Yemen,18/09/2003,4,0,0,0,0,0,0,4
Yemen,19/09/2003,0,0,0,0,9,0,0,9
Yemen,20/09/2003,6,0,0,0,3,0,0,9
Yemen,21/09/2003,0,0,0,0,0,0,0,0
Yemen,22/09/2003,9,0,0,0,0,0,0,9
Yemen,23/09/2003,0,0,0,0,3,0,0,3
Yemen,24/09/2003,0,0,0,0,0,0,0,0
Yemen,25/09/2003,5,0,0,0,3,0,0,8
Yemen,26/09/2003,-2,0,0,0,3,0,0,1
Yemen,28/09/2003,0,0,0,0,0,0,0,0
Yemen,29/09/2003,5,0,0,0,-4,0,0,1
Yemen,30/09/2003,0,0,0,0,0,0,0,0
Yemen,01/10/2003,0,0,0,0,0,0,0,0
Yemen,02/10/2003,-2,0,0,0,-2,0,0,-4
Yemen,03/10/2003,6,0,0,0,0,0,0,6
Yemen,04/10/2003,3,0,-1,0,6,0,0,8
Yemen,05/10/2003,3,0,0,0,0,0,0,3
Yemen,06/10/2003,-1,0,0,0,0,0,0,-1
Yemen,07/10/2003,3,0,0,0,18,0,0,21
Yemen,08/10/2003,14,0,0,0,-4,0,0,10
Yemen,09/10/2003,7,0,0,0,6,12,0,25
Yemen,11/10/2003,0,0,0,0,0,0,0,0
Yemen,12/10/2003,0,0,0,0,0,0,0,0
Yemen,13/10/2003,7,0,0,0,9,0,0,16
Yemen,14/10/2003,3,0,0,0,0,9,0,12
Yemen,15/10/2003,11,0,0,0,4,7,0,22
Yemen,16/10/2003,3,4,0,0,12,0,0,19
Yemen,17/10/2003,1,2,0,0,-2,0,0,1
Yemen,18/10/2003,5,0,-2,0,0,0,0,3
Yemen,19/10/2003,6,0,-2,0,3,2,0,9
Yemen,20/10/2003,0,0,0,0,-4,0,0,-4
Yemen,21/10/2003,0,0,0,0,3,0,0,3
Yemen,22/10/2003,4,0,0,0,3,0,0,7
Yemen,23/10/2003,4,0,0,0,1,2,0,7
Yemen,24/10/2003,0,0,0,0,6,2,0,8
Yemen,25/10/2003,0,0,0,0,4,0,0,4
Yemen,26/10/2003,0,0,0,0,0,0,0,0
Yemen,27/10/2003,12,0,0,0,12,0,0,24
Yemen,28/10/2003,6,0,0,0,6,0,0,12
Yemen,29/10/2003,10,0,0,0,6,0,0,16
Yemen,30/10/2003,4,0,0,0,9,0,0,13
Yemen,31/10/2003,0,0,0,0,0,0,0,0
Yemen,01/11/2003,3,0,0,0,0,0,0,3
Yemen,02/11/2003,0,0,0,0,0,0,0,0
Yemen,03/11/2003,0,0,0,0,0,0,0,0
Yemen,04/11/2003,0,0,0,0,0,0,0,0
Yemen,05/11/2003,3,0,0,0,0,0,0,3
Yemen,06/11/2003,0,0,0,0,12,0,0,12
Yemen,07/11/2003,0,0,0,0,0,0,0,0
Yemen,08/11/2003,6,0,0,0,9,4,0,19
Yemen,09/11/2003,3,0,0,0,6,3,0,12
Yemen,10/11/2003,1,0,0,0,0,0,0,1
Yemen,11/11/2003,3,0,-4,0,0,0,0,-1
Yemen,12/11/2003,6,0,0,0,0,0,0,6
Yemen,13/11/2003,3,0,0,0,9,3,0,15
Yemen,14/11/2003,0,0,0,0,0,0,0,0
Yemen,15/11/2003,3,0,0,0,6,3,0,12
Yemen,16/11/2003,5,0,-1,0,2,0,0,6
Yemen,17/11/2003,4,0,0,0,1,0,0,5
Yemen,18/11/2003,0,0,0,0,2,0,0,2
Yemen,19/11/2003,3,0,0,0,0,0,0,3
Yemen,20/11/2003,6,0,3,0,9,3,0,21
Yemen,21/11/2003,0,0,0,0,0,0,0,0
Yemen,22/11/2003,0,0,0,0,-4,0,0,-4
Yemen,24/11/2003,0,0,0,0,1,0,0,1
Yemen,25/11/2003,21,0,0,0,6,0,0,27
Yemen,26/11/2003,27,0,0,0,9,6,0,42
Yemen,27/11/2003,19,0,0,0,3,0,0,22
Yemen,30/11/2003,15,0,0,0,0,6,0,21
Yemen,01/12/2003,0,0,0,0,6,6,0,12
Yemen,02/12/2003,0,0,0,0,-2,0,0,-2
Yemen,03/12/2003,0,0,0,0,0,0,0,0
Yemen,04/12/2003,4,0,0,0,6,0,0,10
Yemen,05/12/2003,0,0,0,0,0,0,0,0
Yemen,06/12/2003,0,0,0,0,0,0,0,0
Yemen,07/12/2003,0,0,0,0,0,0,0,0
Yemen,09/12/2003,4,0,-1,0,-1,0,0,2
Yemen,10/12/2003,5,0,0,0,13,0,0,18
Yemen,11/12/2003,7,0,1,0,9,0,0,17
Yemen,12/12/2003,0,0,0,0,0,0,0,0
Yemen,13/12/2003,8,0,0,0,6,0,0,14
Yemen,14/12/2003,1,0,0,0,0,0,0,1
Yemen,15/12/2003,0,0,0,0,0,0,0,0
Yemen,16/12/2003,1,0,0,0,3,0,0,4
Yemen,17/12/2003,0,0,0,0,9,0,0,9
Yemen,18/12/2003,22,0,0,0,20,3,0,45
Yemen,19/12/2003,1,0,0,0,0,3,0,4
Yemen,20/12/2003,15,0,0,0,3,0,0,18
Yemen,21/12/2003,2,0,0,0,0,0,0,2
Yemen,22/12/2003,24,0,0,0,-2,1,0,23
Yemen,23/12/2003,17,0,0,0,0,0,0,17
Yemen,24/12/2003,3,0,0,0,0,0,0,3
Yemen,25/12/2003,0,0,0,0,3,0,0,3
Yemen,26/12/2003,3,0,0,0,22,0,0,25
Yemen,27/12/2003,0,0,0,0,0,0,0,0
Yemen,28/12/2003,0,0,0,0,0,0,0,0
Yemen,29/12/2003,13,0,0,0,3,0,0,16
Yemen,30/12/2003,0,0,0,0,0,0,0,0
Yemen,31/12/2003,0,0,0,0,3,0,0,3
Afghanistan,01/11/2006,79,0,-1,0,37,26,0,141
Afghanistan,02/11/2006,49,0,-2,0,2,20,0,69
Afghanistan,03/11/2006,45,0,0,0,11,3,0,59
Afghanistan,04/11/2006,11,0,0,0,9,5,0,25
Afghanistan,05/11/2006,23,4,0,0,9,2,0,38
Afghanistan,06/11/2006,25,2,-1,0,2,2,0,30
Afghanistan,07/11/2006,53,0,0,0,9,4,0,66
Afghanistan,08/11/2006,72,0,0,0,4,4,0,80
Afghanistan,09/11/2006,65,0,0,0,19,5,0,89
Afghanistan,10/11/2006,35,0,-2,0,-5,0,0,28
Afghanistan,11/11/2006,31,0,0,0,13,3,0,47
Afghanistan,12/11/2006,50,0,0,0,6,3,0,59
Afghanistan,13/11/2006,60,0,0,0,27,0,0,87
Afghanistan,14/11/2006,48,0,-2,0,5,2,0,53
Afghanistan,15/11/2006,25,0,0,0,3,1,0,29
Afghanistan,16/11/2006,12,0,-1,0,7,9,0,27
Afghanistan,17/11/2006,41,2,0,0,18,5,0,66
Afghanistan,18/11/2006,57,0,0,0,15,10,0,82
Afghanistan,19/11/2006,60,4,6,0,0,1,0,71
Afghanistan,20/11/2006,47,0,0,0,11,0,0,58
Afghanistan,21/11/2006,43,0,0,0,8,0,0,51
Afghanistan,22/11/2006,46,0,0,0,0,4,0,50
Afghanistan,23/11/2006,60,0,0,0,3,6,0,69
Afghanistan,24/11/2006,23,0,0,0,11,0,0,34
Afghanistan,25/11/2006,28,0,0,0,8,0,0,36
Afghanistan,26/11/2006,36,0,0,0,4,11,0,51
Afghanistan,27/11/2006,79,0,2,0,-9,29,0,101
Afghanistan,28/11/2006,189,0,0,0,2,15,0,206
Afghanistan,29/11/2006,95,0,0,0,25,14,0,134
Afghanistan,30/11/2006,36,2,-1,0,20,17,0,74
Albania,01/11/2006,16,0,0,0,0,3,0,19
Albania,02/11/2006,19,0,0,0,0,0,0,19
Albania,03/11/2006,5,4,-3,0,2,0,0,8
Albania,04/11/2006,4,0,-2,0,0,0,0,2
Albania,05/11/2006,0,0,0,0,0,0,0,0
Albania,06/11/2006,14,0,0,0,0,1,0,15
Albania,07/11/2006,1,0,-4,0,0,-2,0,-5
Albania,08/11/2006,4,0,0,0,9,0,0,13
Albania,09/11/2006,10,0,-4,0,3,0,0,9
Albania,10/11/2006,26,0,-2,0,0,4,0,28
Albania,11/11/2006,2,0,1,0,0,1,0,4
Albania,12/11/2006,0,0,0,0,0,0,0,0
Albania,13/11/2006,4,0,-2,0,0,0,0,2
Albania,14/11/2006,15,0,-3,0,0,1,0,13
Albania,15/11/2006,14,0,-1,0,0,0,0,13
Albania,16/11/2006,-1,0,0,0,0,0,0,-1
Albania,17/11/2006,9,0,0,0,3,1,0,13
Albania,18/11/2006,14,0,2,0,-4,0,0,12
Albania,19/11/2006,0,0,0,0,0,0,0,0
Albania,20/11/2006,15,0,0,0,6,0,0,21
Albania,21/11/2006,12,0,1,0,0,0,0,13
Albania,22/11/2006,3,0,0,0,0,0,0,3
Albania,23/11/2006,0,0,0,0,3,0,0,3
Albania,24/11/2006,4,0,0,0,0,0,0,4
Albania,25/11/2006,0,0,0,0,0,0,0,0
Albania,26/11/2006,0,0,0,0,0,0,0,0
Albania,27/11/2006,14,0,0,0,0,0,0,14
Albania,28/11/2006,6,0,0,0,0,2,0,8
Albania,29/11/2006,1,0,0,0,-4,9,0,6
Albania,30/11/2006,7,0,-1,0,0,0,0,6
Algeria,01/11/2006,5,0,0,0,9,0,0,14
Algeria,02/11/2006,6,0,0,0,12,0,0,18
Algeria,03/11/2006,0,0,0,0,0,0,0,0
Algeria,04/11/2006,0,0,0,0,0,0,0,0
Algeria,05/11/2006,0,0,0,0,9,0,0,9
Algeria,06/11/2006,5,0,0,0,0,0,0,5
Algeria,07/11/2006,5,0,0,0,3,0,0,8
Algeria,08/11/2006,-2,0,0,0,0,0,0,-2
Algeria,09/11/2006,-1,0,0,0,2,4,0,5
Algeria,10/11/2006,0,0,1,0,3,0,0,4
Algeria,11/11/2006,0,0,0,0,0,0,0,0
Algeria,12/11/2006,-1,0,0,0,0,0,0,-1
Algeria,13/11/2006,2,0,0,0,0,0,0,2
Algeria,14/11/2006,5,0,0,0,0,0,0,5
Algeria,15/11/2006,-3,0,0,0,0,0,0,-3
Algeria,16/11/2006,0,0,0,0,0,0,0,0
Algeria,18/11/2006,0,0,0,0,-2,0,0,-2
Algeria,19/11/2006,1,0,0,0,0,0,0,1
Algeria,20/11/2006,-4,0,0,0,0,0,0,-4
Algeria,21/11/2006,0,0,0,0,3,0,0,3
Algeria,22/11/2006,0,0,0,0,-2,0,0,-2
Algeria,23/11/2006,0,0,0,0,0,0,0,0
Algeria,24/11/2006,0,0,0,0,0,0,0,0
Algeria,25/11/2006,0,0,0,0,0,0,0,0
Algeria,26/11/2006,2,0,0,0,0,0,0,2
Algeria,27/11/2006,0,0,0,0,9,0,0,9
Algeria,28/11/2006,1,0,0,0,0,0,0,1
Algeria,29/11/2006,0,0,0,0,11,0,0,11
Algeria,30/11/2006,0,0,0,0,3,0,0,3
Bangladesh,01/11/2006,0,0,-1,0,0,0,0,-1
Bangladesh,02/11/2006,3,0,3,0,6,2,0,14
Bangladesh,03/11/2006,6,0,0,0,0,1,0,7
Bangladesh,04/11/2006,2,0,-2,0,0,0,0,0
Bangladesh,05/11/2006,11,0,-5,0,0,2,0,8
Bangladesh,06/11/2006,23,0,-2,0,3,0,0,24
Bangladesh,07/11/2006,6,0,0,0,-2,1,0,5
Bangladesh,08/11/2006,4,0,0,0,0,0,0,4
Bangladesh,09/11/2006,4,0,0,0,0,1,0,5
Bangladesh,10/11/2006,4,0,0,0,0,0,0,4
Bangladesh,11/11/2006,0,0,0,0,0,2,0,2
Bangladesh,12/11/2006,3,0,0,0,0,1,0,4
Bangladesh,13/11/2006,2,0,0,0,6,0,0,8
Bangladesh,14/11/2006,2,0,0,0,3,10,0,15
Bangladesh,15/11/2006,1,0,0,0,0,1,0,2
Bangladesh,16/11/2006,0,0,1,0,0,0,0,1
Bangladesh,17/11/2006,2,0,0,0,0,0,0,2
Bangladesh,18/11/2006,13,0,0,0,0,0,0,13
Bangladesh,19/11/2006,0,0,0,0,3,0,0,3
Bangladesh,20/11/2006,22,0,1,0,3,5,0,31
Bangladesh,21/11/2006,7,0,-4,0,0,2,0,5
Bangladesh,22/11/2006,8,0,0,0,-2,0,0,6
Bangladesh,23/11/2006,2,0,0,0,0,1,0,3
Bangladesh,24/11/2006,0,0,2,0,0,0,0,2
Bangladesh,25/11/2006,1,0,0,0,3,0,0,4
Bangladesh,26/11/2006,0,0,0,0,0,0,0,0
Bangladesh,27/11/2006,10,0,1,0,1,4,0,16
Bangladesh,28/11/2006,4,0,2,0,0,0,0,6
Bangladesh,29/11/2006,4,0,-1,0,-2,0,0,1
Bangladesh,30/11/2006,3,0,0,0,5,2,0,10
Cameroon,02/11/2006,0,0,0,0,0,0,0,0
Cameroon,03/11/2006,0,0,0,0,0,0,0,0
Cameroon,05/11/2006,0,0,0,0,0,0,0,0
Cameroon,06/11/2006,0,0,0,0,0,0,0,0
Cameroon,08/11/2006,0,0,0,0,0,0,0,0
Cameroon,10/11/2006,0,0,0,0,3,0,0,3
Cameroon,12/11/2006,0,0,0,0,0,0,0,0
Cameroon,13/11/2006,0,0,0,0,6,0,0,6
Cameroon,14/11/2006,0,0,0,0,0,0,0,0
Cameroon,15/11/2006,4,0,0,0,0,0,0,4
Cameroon,16/11/2006,0,0,0,0,0,0,0,0
Cameroon,17/11/2006,0,0,0,0,0,0,0,0
Cameroon,19/11/2006,0,0,0,0,0,0,0,0
Cameroon,20/11/2006,0,0,0,0,0,0,0,0
Cameroon,21/11/2006,0,0,0,0,0,0,0,0
Cameroon,22/11/2006,6,0,0,0,0,0,0,6
Cameroon,23/11/2006,0,0,0,0,3,0,0,3
Cameroon,25/11/2006,0,0,0,0,0,0,0,0
Cameroon,26/11/2006,0,0,0,0,0,0,0,0
Cameroon,27/11/2006,2,0,0,0,0,1,0,3
Cameroon,28/11/2006,0,0,0,0,0,0,0,0
Cameroon,29/11/2006,0,0,0,0,0,1,0,1
Cameroon,30/11/2006,0,0,0,0,0,0,0,0
China,01/11/2006,50,0,-2,0,16,4,0,68
China,02/11/2006,30,4,-1,0,38,14,0,85
China,03/11/2006,13,4,1,0,22,1,0,41
China,04/11/2006,22,0,0,0,6,1,0,29
China,05/11/2006,15,2,-2,0,7,14,0,36
China,06/11/2006,28,2,-2,0,11,2,0,41
China,07/11/2006,40,0,-1,0,19,1,0,59
China,08/11/2006,40,0,1,0,45,8,0,94
China,09/11/2006,39,2,0,0,23,1,0,65
China,10/11/2006,48,4,1,0,3,10,0,66
China,11/11/2006,10,0,-2,0,6,2,0,16
China,12/11/2006,18,2,1,0,3,0,0,24
China,13/11/2006,19,0,0,0,10,10,0,39
China,14/11/2006,18,0,-7,0,4,4,0,19
China,15/11/2006,44,0,0,0,-1,8,0,51
China,16/11/2006,100,0,-2,0,29,6,0,133
China,17/11/2006,52,0,0,0,13,10,0,75
China,18/11/2006,31,0,0,0,15,3,0,49
China,19/11/2006,19,0,0,0,21,14,0,54
China,20/11/2006,52,0,0,0,39,2,0,93
China,21/11/2006,36,0,1,0,60,2,0,99
China,22/11/2006,43,0,0,0,8,9,0,60
China,23/11/2006,20,0,-2,0,0,6,0,24
China,24/11/2006,4,8,0,0,3,3,0,18
China,25/11/2006,6,0,0,0,6,0,0,12
China,26/11/2006,18,0,1,0,-2,1,0,18
China,27/11/2006,33,0,0,0,7,6,0,46
China,28/11/2006,28,0,0,0,16,2,0,46
China,29/11/2006,57,0,-11,0,29,1,0,76
China,30/11/2006,22,0,0,0,7,0,0,29
Egypt,01/11/2006,47,0,0,0,26,3,0,76
Egypt,02/11/2006,19,0,0,0,-1,1,0,19
Egypt,03/11/2006,10,0,0,0,12,1,0,23
Egypt,04/11/2006,8,0,0,0,-2,3,0,9
Egypt,05/11/2006,11,0,0,0,-5,0,0,6
Egypt,06/11/2006,15,0,0,0,39,0,0,54
Egypt,07/11/2006,15,0,0,0,27,2,0,44
Egypt,08/11/2006,12,0,0,0,41,1,0,54
Egypt,09/11/2006,9,0,0,0,7,1,0,17
Egypt,10/11/2006,0,0,0,0,36,2,0,38
Egypt,11/11/2006,3,0,0,0,0,0,0,3
Egypt,12/11/2006,3,0,0,0,0,1,0,4
Egypt,13/11/2006,2,0,-1,0,10,3,0,14
Egypt,14/11/2006,36,0,0,0,-1,1,0,36
Egypt,15/11/2006,9,0,0,0,4,0,0,13
Egypt,16/11/2006,21,0,0,0,6,0,0,27
Egypt,17/11/2006,21,0,0,0,15,0,0,36
Egypt,18/11/2006,5,0,0,0,3,0,0,8
Egypt,19/11/2006,3,0,1,0,18,0,0,22
Egypt,20/11/2006,10,0,-1,0,12,0,0,21
Egypt,21/11/2006,1,0,0,0,0,0,0,1
Egypt,22/11/2006,10,0,0,0,-1,0,0,9
Egypt,23/11/2006,13,0,0,0,-4,0,0,9
Egypt,24/11/2006,6,0,0,0,-1,2,0,7
Egypt,25/11/2006,-3,0,0,0,-2,0,0,-5
Egypt,26/11/2006,2,0,0,0,0,0,0,2
Egypt,27/11/2006,12,0,1,0,3,0,0,16
Egypt,28/11/2006,18,0,-2,0,-3,3,0,16
Egypt,29/11/2006,3,0,0,0,1,0,0,4
Egypt,30/11/2006,15,0,0,0,-5,5,0,15
Eritrea,01/11/2006,12,0,0,0,0,0,0,12
Eritrea,02/11/2006,33,0,0,0,3,0,0,36
Eritrea,03/11/2006,33,0,0,0,0,0,0,33
Eritrea,04/11/2006,12,0,0,0,0,1,0,13
Eritrea,05/11/2006,18,0,0,0,0,0,0,18
Eritrea,06/11/2006,24,0,0,0,0,0,0,24
Eritrea,07/11/2006,2,0,0,0,0,0,0,2
Eritrea,08/11/2006,11,0,0,0,0,0,0,11
Eritrea,09/11/2006,0,0,0,0,3,0,0,3
Eritrea,10/11/2006,-1,0,0,0,0,0,0,-1
Eritrea,11/11/2006,7,0,0,0,3,0,0,10
Eritrea,12/11/2006,2,0,0,0,0,0,0,2
Eritrea,13/11/2006,11,0,0,0,6,0,0,17
Eritrea,14/11/2006,6,0,0,0,0,0,0,6
Eritrea,15/11/2006,3,0,0,0,3,0,0,6
Eritrea,16/11/2006,3,0,0,0,3,0,0,6
Eritrea,17/11/2006,4,0,0,0,0,0,0,4
Eritrea,18/11/2006,8,0,-1,0,3,0,0,10
Eritrea,19/11/2006,4,0,0,0,-2,1,0,3
Eritrea,20/11/2006,6,0,0,0,0,0,0,6
Eritrea,21/11/2006,10,0,0,0,0,0,0,10
Eritrea,22/11/2006,2,0,0,0,0,0,0,2
Eritrea,23/11/2006,3,0,0,0,6,0,0,9
Eritrea,24/11/2006,0,0,0,0,3,0,0,3
Eritrea,25/11/2006,2,0,0,0,0,2,0,4
Eritrea,27/11/2006,8,0,0,0,0,0,0,8
Eritrea,28/11/2006,16,0,0,0,3,0,0,19
Eritrea,29/11/2006,3,0,0,0,0,0,0,3
Eritrea,30/11/2006,7,0,0,0,0,0,0,7
Georgia,01/11/2006,0,0,0,0,0,0,0,0
Georgia,02/11/2006,2,0,0,0,4,0,0,6
Georgia,03/11/2006,3,0,0,0,12,1,0,16
Georgia,04/11/2006,0,0,0,0,0,0,0,0
Georgia,05/11/2006,2,0,0,0,3,0,0,5
Georgia,06/11/2006,0,0,0,0,0,0,0,0
Georgia,07/11/2006,-1,0,0,0,0,0,0,-1
Georgia,08/11/2006,5,0,0,0,-2,0,0,3
Georgia,09/11/2006,0,0,0,0,3,0,0,3
Georgia,10/11/2006,2,0,0,0,-4,0,0,-2
Georgia,11/11/2006,2,0,0,0,-2,0,0,0
Georgia,12/11/2006,0,0,0,0,0,0,0,0
Georgia,13/11/2006,7,0,0,0,0,0,0,7
Georgia,14/11/2006,4,0,0,0,4,0,0,8
Georgia,15/11/2006,4,0,0,0,0,1,0,5
Georgia,16/11/2006,-3,0,0,0,0,0,0,-3
Georgia,17/11/2006,2,0,-4,0,0,0,0,-2
Georgia,18/11/2006,0,0,0,0,0,1,0,1
Georgia,19/11/2006,0,0,0,0,0,1,0,1
Georgia,20/11/2006,0,0,0,0,0,0,0,0
Georgia,21/11/2006,3,0,0,0,-2,4,0,5
Georgia,22/11/2006,2,0,0,0,0,0,0,2
Georgia,23/11/2006,11,0,0,0,30,2,0,43
Georgia,24/11/2006,9,0,0,0,4,0,0,13
Georgia,25/11/2006,0,0,0,0,0,0,0,0
Georgia,26/11/2006,0,0,0,0,0,0,0,0
Georgia,27/11/2006,3,0,0,0,0,0,0,3
Georgia,28/11/2006,2,0,0,0,3,0,0,5
Georgia,29/11/2006,4,0,0,0,4,0,0,8
Georgia,30/11/2006,5,0,-1,0,0,1,0,5
India,01/11/2006,4,0,0,0,12,0,0,16
India,02/11/2006,8,0,0,0,6,0,0,14
India,03/11/2006,22,0,0,0,3,0,0,25
India,04/11/2006,14,0,0,0,3,1,0,18
India,05/11/2006,7,0,-2,0,0,2,0,7
India,06/11/2006,14,0,0,0,8,3,0,25
India,07/11/2006,21,0,-1,0,9,6,0,35
India,08/11/2006,14,0,0,0,1,1,0,16
India,09/11/2006,2,0,0,0,13,0,0,15
India,10/11/2006,28,0,-4,0,18,1,0,43
India,11/11/2006,6,0,0,0,1,1,0,8
India,12/11/2006,12,0,0,0,0,2,0,14
India,13/11/2006,6,0,0,0,-2,6,0,10
India,14/11/2006,-6,0,-1,0,-2,1,0,-8
India,15/11/2006,2,0,0,0,-4,1,0,-1
India,16/11/2006,16,0,0,0,0,4,0,20
India,17/11/2006,27,2,0,0,7,2,0,38
India,18/11/2006,14,2,0,0,3,3,0,22
India,19/11/2006,2,0,0,0,3,0,0,5
India,20/11/2006,17,0,0,0,0,0,0,17
India,21/11/2006,17,2,0,0,3,0,0,22
India,22/11/2006,23,0,-4,0,-4,3,0,18
India,23/11/2006,6,0,0,0,6,1,0,13
India,24/11/2006,6,2,0,0,6,1,0,15
India,25/11/2006,3,0,1,0,1,1,0,6
India,26/11/2006,14,0,1,0,9,0,0,24
India,27/11/2006,35,0,-1,0,-5,1,0,30
India,28/11/2006,16,0,0,0,-2,2,0,16
India,29/11/2006,1,0,0,0,-2,0,0,-1
India,30/11/2006,7,0,-2,0,10,3,0,18
Iran,01/11/2006,60,0,-2,0,15,9,0,82
Iran,02/11/2006,67,0,1,0,1,6,0,75
Iran,03/11/2006,42,0,0,0,1,0,0,43
Iran,04/11/2006,16,0,0,0,4,0,0,20
Iran,05/11/2006,24,0,3,0,17,2,0,46
Iran,06/11/2006,17,0,0,0,18,2,0,37
Iran,07/11/2006,12,0,-2,0,31,2,0,43
Iran,08/11/2006,32,0,-4,0,18,5,0,51
Iran,09/11/2006,38,0,0,0,9,0,0,47
Iran,10/11/2006,16,0,0,0,10,1,0,27
Iran,11/11/2006,31,0,-2,0,20,2,0,51
Iran,12/11/2006,22,0,-4,0,0,2,0,20
Iran,13/11/2006,51,0,-2,0,15,13,0,77
Iran,14/11/2006,63,6,-2,0,58,10,0,135
Iran,15/11/2006,-31,4,0,0,18,2,0,-7
Iran,16/11/2006,26,0,-1,0,4,2,0,31
Iran,17/11/2006,10,0,1,0,0,3,0,14
Iran,18/11/2006,26,4,0,0,19,3,0,52
Iran,19/11/2006,28,2,0,0,11,0,0,41
Iran,20/11/2006,17,0,0,0,13,4,0,34
Iran,21/11/2006,54,4,-3,0,15,0,0,70
Iran,22/11/2006,54,4,4,0,0,8,0,70
Iran,23/11/2006,28,0,1,0,9,1,0,39
Iran,24/11/2006,6,0,0,0,0,0,0,6
Iran,25/11/2006,15,0,0,0,7,4,0,26
Iran,26/11/2006,15,0,0,0,6,1,0,22
Iran,27/11/2006,0,0,0,0,12,2,0,14
Iran,28/11/2006,14,6,1,0,12,3,0,36
Iran,29/11/2006,31,6,1,0,16,6,0,60
Iran,30/11/2006,29,0,-2,0,12,6,0,45
Iraq,01/11/2006,109,0,-8,0,7,10,0,118
Iraq,02/11/2006,121,0,7,0,28,11,0,167
Iraq,03/11/2006,145,6,-1,0,12,27,0,189
Iraq,04/11/2006,79,0,-1,0,15,3,0,96
Iraq,05/11/2006,84,0,5,0,78,7,0,174
Iraq,06/11/2006,116,2,0,0,96,24,0,238
Iraq,07/11/2006,152,2,-1,0,70,12,0,235
Iraq,08/11/2006,185,0,-14,0,17,24,0,212
Iraq,09/11/2006,136,2,-36,0,16,25,0,143
Iraq,10/11/2006,125,0,-9,0,48,12,0,176
Iraq,11/11/2006,121,2,-12,0,12,14,0,137
Iraq,12/11/2006,146,2,-2,0,21,19,0,186
Iraq,13/11/2006,164,0,-12,0,53,19,0,224
Iraq,14/11/2006,152,6,-9,0,35,12,0,196
Iraq,15/11/2006,87,10,-8,0,72,25,0,186
Iraq,16/11/2006,146,0,2,0,105,9,0,262
Iraq,17/11/2006,116,0,-1,0,49,8,0,172
Iraq,18/11/2006,56,0,-4,0,44,14,0,110
Iraq,19/11/2006,66,0,3,0,10,15,0,94
Iraq,20/11/2006,69,0,-1,0,6,13,0,87
Iraq,21/11/2006,73,0,0,0,23,10,0,106
Iraq,22/11/2006,117,0,0,0,17,13,0,147
Iraq,23/11/2006,57,0,-2,0,10,18,0,83
Iraq,24/11/2006,24,0,-4,0,4,11,0,35
Iraq,25/11/2006,68,0,-1,0,9,5,0,81
Iraq,26/11/2006,60,2,0,0,3,5,0,70
Iraq,27/11/2006,119,10,3,0,5,9,0,146
Iraq,28/11/2006,173,8,2,0,14,7,0,204
Iraq,29/11/2006,138,0,0,0,5,7,0,150
Iraq,30/11/2006,151,0,1,0,16,23,0,191
Morocco,01/11/2006,-6,0,0,0,0,0,0,-6
Morocco,02/11/2006,1,0,0,0,1,1,0,3
Morocco,03/11/2006,0,0,0,0,3,0,0,3
Morocco,04/11/2006,0,0,0,0,0,0,0,0
Morocco,05/11/2006,1,0,0,0,0,0,0,1
Morocco,06/11/2006,2,0,0,0,7,0,0,9
Morocco,07/11/2006,2,0,0,0,7,1,0,10
Morocco,08/11/2006,0,0,0,0,0,3,0,3
Morocco,09/11/2006,15,0,0,0,0,1,0,16
Morocco,10/11/2006,29,0,0,0,0,0,0,29
Morocco,11/11/2006,0,0,0,0,0,0,0,0
Morocco,12/11/2006,0,0,0,0,0,0,0,0
Morocco,13/11/2006,0,0,0,0,6,0,0,6
Morocco,14/11/2006,2,0,0,0,0,0,0,2
Morocco,15/11/2006,0,0,0,0,-2,0,0,-2
Morocco,16/11/2006,6,0,0,0,28,4,0,38
Morocco,17/11/2006,2,0,0,0,27,0,0,29
Morocco,18/11/2006,0,0,0,0,0,0,0,0
Morocco,19/11/2006,0,0,0,0,0,0,0,0
Morocco,20/11/2006,-1,0,0,0,3,0,0,2
Morocco,21/11/2006,12,0,0,0,0,0,0,12
Morocco,22/11/2006,0,0,0,0,0,0,0,0
Morocco,23/11/2006,7,0,0,0,0,0,0,7
Morocco,24/11/2006,5,0,0,0,0,0,0,5
Morocco,25/11/2006,1,0,0,0,3,0,0,4
Morocco,26/11/2006,1,0,0,0,0,0,0,1
Morocco,27/11/2006,4,0,0,0,3,1,0,8
Morocco,28/11/2006,2,0,0,0,6,0,0,8
Morocco,29/11/2006,0,0,0,0,0,0,0,0
Morocco,30/11/2006,0,0,0,0,0,0,0,0
Nigeria,01/11/2006,28,0,-2,0,-4,0,0,22
Nigeria,02/11/2006,11,0,1,0,6,0,0,18
Nigeria,03/11/2006,5,0,-2,0,0,0,0,3
Nigeria,04/11/2006,0,0,-2,0,0,0,0,-2
Nigeria,05/11/2006,7,2,-2,0,0,7,0,14
Nigeria,06/11/2006,10,0,0,0,0,1,0,11
Nigeria,07/11/2006,8,0,0,0,14,0,0,22
Nigeria,08/11/2006,2,0,1,0,0,0,0,3
Nigeria,09/11/2006,15,0,2,0,0,0,0,17
Nigeria,10/11/2006,45,0,2,0,0,3,0,50
Nigeria,11/11/2006,7,0,0,0,6,1,0,14
Nigeria,12/11/2006,3,0,0,0,-2,0,0,1
Nigeria,13/11/2006,3,0,0,0,0,1,0,4
Nigeria,14/11/2006,8,0,0,0,2,0,0,10
Nigeria,15/11/2006,13,0,1,0,-1,4,0,17
Nigeria,16/11/2006,6,0,0,0,4,2,0,12
Nigeria,17/11/2006,10,0,0,0,0,1,0,11
Nigeria,18/11/2006,0,0,0,0,0,0,0,0
Nigeria,19/11/2006,6,0,1,0,-2,0,0,5
Nigeria,20/11/2006,26,0,0,0,9,0,0,35
Nigeria,21/11/2006,5,0,0,0,6,4,0,15
Nigeria,22/11/2006,18,0,0,0,33,6,0,57
Nigeria,23/11/2006,21,0,-2,0,3,0,0,22
Nigeria,24/11/2006,4,0,0,0,6,4,0,14
Nigeria,25/11/2006,2,0,0,0,0,0,0,2
Nigeria,26/11/2006,4,0,-2,0,15,5,0,22
Nigeria,27/11/2006,13,0,0,0,9,0,0,22
Nigeria,28/11/2006,3,0,0,0,-2,2,0,3
Nigeria,29/11/2006,14,0,2,0,6,2,0,24
Nigeria,30/11/2006,19,0,0,0,0,0,0,19
Pakistan,01/11/2006,26,0,1,0,-2,5,0,30
Pakistan,02/11/2006,13,0,0,0,3,6,0,22
Pakistan,03/11/2006,11,0,0,0,3,6,0,20
Pakistan,04/11/2006,60,0,0,0,39,7,0,106
Pakistan,05/11/2006,43,0,0,0,37,1,0,81
Pakistan,06/11/2006,27,0,0,0,27,5,0,59
Pakistan,07/11/2006,29,0,-2,0,-3,7,0,31
Pakistan,08/11/2006,58,0,0,0,24,0,0,82
Pakistan,09/11/2006,36,0,0,0,13,3,0,52
Pakistan,10/11/2006,8,0,0,0,6,0,0,14
Pakistan,11/11/2006,18,0,1,0,12,1,0,32
Pakistan,12/11/2006,20,0,0,0,3,2,0,25
Pakistan,13/11/2006,26,2,0,0,51,0,0,79
Pakistan,14/11/2006,9,0,-1,0,16,2,0,26
Pakistan,15/11/2006,20,0,0,0,5,11,0,36
Pakistan,16/11/2006,23,0,0,0,23,6,0,52
Pakistan,17/11/2006,40,0,0,0,20,2,0,62
Pakistan,18/11/2006,46,6,0,0,18,1,0,71
Pakistan,19/11/2006,44,0,-1,0,12,2,0,57
Pakistan,20/11/2006,18,0,0,0,19,0,0,37
Pakistan,21/11/2006,40,0,0,0,54,8,0,102
Pakistan,22/11/2006,8,0,0,0,21,6,0,35
Pakistan,23/11/2006,6,0,0,0,36,8,0,50
Pakistan,24/11/2006,10,0,0,0,9,1,0,20
Pakistan,25/11/2006,20,0,0,0,11,0,0,31
Pakistan,26/11/2006,27,0,0,0,29,16,0,72
Pakistan,27/11/2006,13,0,0,0,22,2,0,37
Pakistan,28/11/2006,50,0,0,0,9,1,0,60
Pakistan,29/11/2006,9,0,0,0,4,0,0,13
Pakistan,30/11/2006,11,0,0,0,6,2,0,19
Sierra Leone,01/11/2006,13,0,0,0,-2,0,0,11
Sierra Leone,02/11/2006,5,0,0,0,0,0,0,5
Sierra Leone,03/11/2006,2,0,0,0,0,0,0,2
Sierra Leone,04/11/2006,1,0,0,0,0,0,0,1
Sierra Leone,05/11/2006,0,0,0,0,0,0,0,0
Sierra Leone,07/11/2006,0,0,0,0,0,0,0,0
Sierra Leone,08/11/2006,0,0,0,0,0,0,0,0
Sierra Leone,09/11/2006,0,0,0,0,0,0,0,0
Sierra Leone,10/11/2006,0,0,0,0,0,0,0,0
Sierra Leone,14/11/2006,0,0,0,0,0,0,0,0
Sierra Leone,17/11/2006,12,0,0,0,0,0,0,12
Sierra Leone,19/11/2006,0,0,0,0,0,0,0,0
Sierra Leone,20/11/2006,0,0,0,0,0,0,0,0
Sierra Leone,22/11/2006,1,0,0,0,-2,4,0,3
Sierra Leone,24/11/2006,2,0,0,0,0,0,0,2
Sierra Leone,27/11/2006,3,0,0,0,0,0,0,3
Sierra Leone,28/11/2006,0,0,0,0,0,0,0,0
Sierra Leone,29/11/2006,1,0,0,0,0,0,0,1
Sierra Leone,30/11/2006,0,0,0,0,0,0,0,0
Somalia,01/11/2006,7,0,0,0,20,6,0,33
Somalia,02/11/2006,4,0,0,0,12,3,0,19
Somalia,03/11/2006,11,0,0,0,0,3,0,14
Somalia,04/11/2006,16,0,0,0,13,0,0,29
Somalia,05/11/2006,3,0,0,0,0,0,0,3
Somalia,06/11/2006,2,0,0,0,0,0,0,2
Somalia,07/11/2006,-2,0,0,0,0,0,0,-2
Somalia,08/11/2006,14,0,0,0,0,4,0,18
Somalia,09/11/2006,8,0,0,0,3,1,0,12
Somalia,10/11/2006,4,0,0,0,0,0,0,4
Somalia,11/11/2006,7,0,0,0,12,0,0,19
Somalia,12/11/2006,12,0,0,0,3,1,0,16
Somalia,13/11/2006,3,0,0,0,3,0,0,6
Somalia,14/11/2006,15,0,0,0,-4,1,0,12
Somalia,15/11/2006,37,2,0,0,12,0,0,51
Somalia,16/11/2006,26,0,0,0,0,0,0,26
Somalia,17/11/2006,10,0,0,0,3,0,0,13
Somalia,18/11/2006,11,0,1,0,21,0,0,33
Somalia,19/11/2006,7,0,0,0,3,1,0,11
Somalia,20/11/2006,3,0,0,0,-2,0,0,1
Somalia,21/11/2006,33,0,0,0,3,5,0,41
Somalia,22/11/2006,0,0,0,0,0,3,0,3
Somalia,23/11/2006,6,2,0,0,0,0,0,8
Somalia,24/11/2006,5,4,0,0,0,0,0,9
Somalia,25/11/2006,6,2,0,0,6,1,0,15
Somalia,26/11/2006,6,0,0,0,0,0,0,6
Somalia,27/11/2006,5,0,0,0,0,0,0,5
Somalia,28/11/2006,12,0,0,0,27,0,0,39
Somalia,29/11/2006,10,0,0,0,0,0,0,10
Somalia,30/11/2006,3,0,0,0,6,1,0,10
Syria,01/11/2006,24,0,0,0,6,3,0,33
Syria,02/11/2006,9,0,1,0,8,3,0,21
Syria,03/11/2006,7,0,0,0,3,0,0,10
Syria,04/11/2006,0,0,0,0,6,0,0,6
Syria,05/11/2006,6,0,-2,0,6,0,0,10
Syria,06/11/2006,10,0,-8,0,0,0,0,2
Syria,07/11/2006,15,0,-4,0,3,0,0,14
Syria,08/11/2006,7,0,-2,0,0,0,0,5
Syria,09/11/2006,27,2,-10,0,0,1,0,20
Syria,10/11/2006,15,2,-4,0,0,2,0,15
Syria,11/11/2006,3,0,-24,0,0,0,0,-21
Syria,12/11/2006,47,0,-28,0,-8,3,0,14
Syria,13/11/2006,31,0,-26,0,-8,5,0,2
Syria,14/11/2006,35,0,-21,0,21,4,0,39
Syria,15/11/2006,14,0,-12,0,6,0,0,8
Syria,16/11/2006,12,0,-3,0,0,0,0,9
Syria,17/11/2006,24,0,-4,0,0,7,0,27
Syria,18/11/2006,8,0,-4,0,0,5,0,9
Syria,19/11/2006,24,0,-22,0,6,10,0,18
Syria,20/11/2006,14,0,-2,0,6,4,0,22
Syria,21/11/2006,156,0,0,0,12,4,0,172
Syria,22/11/2006,52,8,-4,0,10,11,0,77
Syria,23/11/2006,54,0,-5,0,-3,20,0,66
Syria,24/11/2006,45,0,-9,0,15,2,0,53
Syria,25/11/2006,30,0,-2,0,15,6,0,49
Syria,26/11/2006,4,0,-2,0,13,2,0,17
Syria,27/11/2006,9,0,-4,0,10,8,0,23
Syria,28/11/2006,25,0,0,0,1,7,0,33
Syria,29/11/2006,14,0,1,0,27,3,0,45
Syria,30/11/2006,31,0,-2,0,1,1,0,31
Yemen,01/11/2006,0,0,0,0,18,2,0,20
Yemen,02/11/2006,6,0,0,0,15,0,0,21
Yemen,03/11/2006,0,0,0,0,6,0,0,6
Yemen,04/11/2006,0,0,0,0,9,0,0,9
Yemen,05/11/2006,8,0,0,0,18,2,0,28
Yemen,06/11/2006,4,0,0,0,0,0,0,4
Yemen,07/11/2006,12,0,0,0,0,0,0,12
Yemen,08/11/2006,3,0,0,0,0,1,0,4
Yemen,09/11/2006,9,0,0,0,0,0,0,9
Yemen,10/11/2006,0,0,0,0,0,0,0,0
Yemen,11/11/2006,6,0,0,0,0,0,0,6
Yemen,12/11/2006,0,0,0,0,0,0,0,0
Yemen,13/11/2006,0,0,0,0,9,0,0,9
Yemen,14/11/2006,0,2,0,0,9,0,0,11
Yemen,15/11/2006,-1,0,0,0,3,0,0,2
Yemen,16/11/2006,1,2,0,0,0,0,0,3
Yemen,17/11/2006,0,0,0,0,0,0,0,0
Yemen,18/11/2006,5,0,0,0,0,0,0,5
Yemen,19/11/2006,5,0,0,0,0,0,0,5
Yemen,20/11/2006,1,0,0,0,-4,0,0,-3
Yemen,21/11/2006,6,0,0,0,0,0,0,6
Yemen,22/11/2006,3,0,0,0,0,0,0,3
Yemen,23/11/2006,0,0,0,0,15,0,0,15
Yemen,25/11/2006,3,0,0,0,0,0,0,3
Yemen,26/11/2006,-1,0,0,0,30,4,0,33
Yemen,27/11/2006,0,0,0,0,0,0,0,0
Yemen,28/11/2006,0,0,0,0,0,0,0,0
Yemen,30/11/2006,0,0,0,0,0,0,0,0
Afghanistan,01/05/2006,13,0,0,0,6,2,0,21
Afghanistan,02/05/2006,19,0,0,0,21,1,0,41
Afghanistan,03/05/2006,17,2,0,0,-2,0,0,17
Afghanistan,04/05/2006,23,0,0,0,0,0,0,23
Afghanistan,05/05/2006,39,0,0,0,6,1,0,46
Afghanistan,06/05/2006,15,0,0,0,0,1,0,16
Afghanistan,07/05/2006,21,0,0,0,-5,2,0,18
Afghanistan,08/05/2006,12,2,0,0,29,0,0,43
Afghanistan,09/05/2006,14,0,0,0,22,2,0,38
Afghanistan,10/05/2006,14,0,0,0,49,1,0,64
Afghanistan,11/05/2006,16,0,0,0,19,4,0,39
Afghanistan,12/05/2006,30,2,0,0,52,13,0,97
Afghanistan,13/05/2006,39,0,0,0,13,4,0,56
Afghanistan,14/05/2006,46,0,0,0,4,0,0,50
Afghanistan,15/05/2006,44,0,0,0,9,0,0,53
Afghanistan,16/05/2006,50,0,0,0,9,9,0,68
Afghanistan,17/05/2006,112,0,0,0,-1,3,0,114
Afghanistan,18/05/2006,87,0,0,0,1,13,0,101
Afghanistan,19/05/2006,71,0,0,0,35,4,0,110
Afghanistan,20/05/2006,105,0,0,0,9,20,0,134
Afghanistan,21/05/2006,30,0,0,0,4,8,0,42
Afghanistan,22/05/2006,75,0,1,0,13,6,0,95
Afghanistan,23/05/2006,61,0,-2,0,9,10,0,78
Afghanistan,24/05/2006,70,0,0,0,35,10,0,115
Afghanistan,25/05/2006,46,0,0,0,6,0,0,52
Afghanistan,26/05/2006,16,0,0,0,21,4,0,41
Afghanistan,27/05/2006,11,0,0,0,-5,0,0,6
Afghanistan,28/05/2006,65,2,0,0,7,12,0,86
Afghanistan,29/05/2006,76,2,0,0,-4,5,0,79
Afghanistan,30/05/2006,32,0,0,0,4,8,0,44
Afghanistan,31/05/2006,28,0,0,0,-2,8,0,34
Albania,01/05/2006,2,0,0,0,0,0,0,2
Albania,02/05/2006,0,0,0,0,6,1,0,7
Albania,03/05/2006,6,0,0,0,0,0,0,6
Albania,04/05/2006,2,0,-4,0,0,1,0,-1
Albania,05/05/2006,6,0,0,0,0,1,0,7
Albania,06/05/2006,2,0,0,0,-4,3,0,1
Albania,07/05/2006,-3,0,0,0,0,0,0,-3
Albania,08/05/2006,9,0,0,0,-2,0,0,7
Albania,09/05/2006,5,0,0,0,1,2,0,8
Albania,10/05/2006,3,0,0,0,0,0,0,3
Albania,11/05/2006,4,0,0,0,0,0,0,4
Albania,12/05/2006,21,0,0,0,-5,9,0,25
Albania,15/05/2006,6,0,0,0,1,2,0,9
Albania,16/05/2006,0,0,0,0,0,0,0,0
Albania,17/05/2006,3,0,-2,0,0,0,0,1
Albania,18/05/2006,0,0,0,0,6,0,0,6
Albania,19/05/2006,4,0,0,0,15,0,0,19
Albania,20/05/2006,3,0,0,0,0,0,0,3
Albania,21/05/2006,2,0,0,0,-4,0,0,-2
Albania,22/05/2006,2,0,-1,0,2,1,0,4
Albania,23/05/2006,7,0,-1,0,0,0,0,6
Albania,24/05/2006,22,0,0,0,0,2,0,24
Albania,25/05/2006,37,0,0,0,2,4,0,43
Albania,26/05/2006,-1,0,-1,0,6,0,0,4
Albania,27/05/2006,0,0,0,0,0,0,0,0
Albania,28/05/2006,0,0,0,0,0,0,0,0
Albania,29/05/2006,0,0,0,0,0,0,0,0
Albania,30/05/2006,0,0,-2,0,0,2,0,0
Albania,31/05/2006,7,0,0,0,0,0,0,7
Algeria,02/05/2006,0,0,0,0,0,0,0,0
Algeria,03/05/2006,0,0,0,0,0,0,0,0
Algeria,04/05/2006,0,0,0,0,0,0,0,0
Algeria,06/05/2006,-1,0,0,0,0,0,0,-1
Algeria,07/05/2006,0,0,0,0,0,0,0,0
Algeria,09/05/2006,-1,0,0,0,6,0,0,5
Algeria,10/05/2006,2,0,0,0,0,0,0,2
Algeria,11/05/2006,22,0,0,0,-4,0,0,18
Algeria,12/05/2006,14,0,0,0,4,0,0,18
Algeria,14/05/2006,4,0,0,0,6,2,0,12
Algeria,15/05/2006,0,0,0,0,0,0,0,0
Algeria,16/05/2006,0,0,0,0,0,0,0,0
Algeria,17/05/2006,0,0,0,0,3,0,0,3
Algeria,18/05/2006,4,0,0,0,0,0,0,4
Algeria,19/05/2006,7,0,0,0,6,0,0,13
Algeria,20/05/2006,0,0,0,0,9,0,0,9
Algeria,21/05/2006,0,0,0,0,0,0,0,0
Algeria,22/05/2006,0,0,0,0,0,0,0,0
Algeria,23/05/2006,10,0,-2,0,3,0,0,11
Algeria,24/05/2006,20,0,-14,0,9,0,0,15
Algeria,25/05/2006,1,0,0,0,3,0,0,4
Algeria,26/05/2006,0,0,-2,0,-2,0,0,-4
Algeria,27/05/2006,-3,0,0,0,0,0,0,-3
Algeria,28/05/2006,6,0,0,0,0,0,0,6
Algeria,29/05/2006,0,0,0,0,6,0,0,6
Algeria,30/05/2006,0,0,0,0,0,0,0,0
Algeria,31/05/2006,2,0,0,0,3,1,0,6
Bangladesh,01/05/2006,0,0,0,0,6,0,0,6
Bangladesh,02/05/2006,0,0,0,0,0,0,0,0
Bangladesh,03/05/2006,11,0,0,0,0,1,0,12
Bangladesh,04/05/2006,6,0,0,0,0,0,0,6
Bangladesh,05/05/2006,1,0,0,0,0,0,0,1
Bangladesh,07/05/2006,0,0,0,0,0,0,0,0
Bangladesh,08/05/2006,0,0,0,0,0,0,0,0
Bangladesh,09/05/2006,5,0,0,0,0,0,0,5
Bangladesh,10/05/2006,0,0,0,0,0,0,0,0
Bangladesh,11/05/2006,0,0,0,0,0,0,0,0
Bangladesh,12/05/2006,4,0,0,0,0,1,0,5
Bangladesh,13/05/2006,3,0,0,0,-4,0,0,-1
Bangladesh,14/05/2006,1,0,0,0,0,0,0,1
Bangladesh,15/05/2006,2,0,0,0,12,0,0,14
Bangladesh,16/05/2006,22,0,0,0,3,6,0,31
Bangladesh,17/05/2006,2,0,0,0,0,0,0,2
Bangladesh,18/05/2006,2,0,0,0,0,0,0,2
Bangladesh,19/05/2006,6,0,0,0,3,1,0,10
Bangladesh,20/05/2006,2,0,0,0,0,0,0,2
Bangladesh,21/05/2006,0,0,0,0,0,0,0,0
Bangladesh,22/05/2006,0,0,0,0,0,0,0,0
Bangladesh,23/05/2006,2,0,0,0,0,0,0,2
Bangladesh,24/05/2006,6,0,0,0,15,0,0,21
Bangladesh,25/05/2006,2,0,-2,0,3,0,0,3
Bangladesh,26/05/2006,0,0,0,0,0,0,0,0
Bangladesh,27/05/2006,0,0,0,0,-4,0,0,-4
Bangladesh,28/05/2006,2,0,0,0,0,0,0,2
Bangladesh,29/05/2006,12,0,0,0,15,15,0,42
Bangladesh,30/05/2006,8,0,-2,0,18,2,0,26
Bangladesh,31/05/2006,1,0,0,0,13,0,0,14
Cameroon,01/05/2006,0,0,0,0,0,0,0,0
Cameroon,02/05/2006,0,0,0,0,0,1,0,1
Cameroon,03/05/2006,1,0,0,0,-2,0,0,-1
Cameroon,04/05/2006,0,0,0,0,0,0,0,0
Cameroon,05/05/2006,0,4,0,0,2,0,0,6
Cameroon,08/05/2006,0,0,0,0,0,0,0,0
Cameroon,09/05/2006,7,0,0,0,0,0,0,7
Cameroon,10/05/2006,-1,0,0,0,0,0,0,-1
Cameroon,11/05/2006,6,0,0,0,0,0,0,6
Cameroon,12/05/2006,4,0,0,0,3,0,0,7
Cameroon,15/05/2006,4,0,0,0,3,0,0,7
Cameroon,16/05/2006,0,0,0,0,0,0,0,0
Cameroon,17/05/2006,0,0,0,0,0,0,0,0
Cameroon,18/05/2006,1,0,0,0,0,0,0,1
Cameroon,19/05/2006,0,0,0,0,0,0,0,0
Cameroon,20/05/2006,0,0,0,0,0,0,0,0
Cameroon,21/05/2006,0,0,0,0,0,0,0,0
Cameroon,22/05/2006,1,0,0,0,3,0,0,4
Cameroon,23/05/2006,0,0,0,0,0,0,0,0
Cameroon,25/05/2006,0,0,0,0,0,0,0,0
Cameroon,26/05/2006,0,0,0,0,3,0,0,3
Cameroon,27/05/2006,0,0,0,0,0,0,0,0
Cameroon,28/05/2006,0,0,0,0,0,0,0,0
Cameroon,29/05/2006,0,0,0,0,0,1,0,1
Cameroon,30/05/2006,0,0,0,0,6,0,0,6
Cameroon,31/05/2006,0,0,0,0,0,0,0,0
China,01/05/2006,30,0,0,0,10,0,0,40
China,02/05/2006,18,0,0,0,14,0,0,32
China,03/05/2006,7,0,2,0,3,1,0,13
China,04/05/2006,16,0,-2,0,0,2,0,16
China,05/05/2006,-3,0,0,0,3,0,0,0
China,06/05/2006,10,0,0,0,12,1,0,23
China,07/05/2006,8,0,0,0,-2,0,0,6
China,08/05/2006,15,0,1,0,0,2,0,18
China,09/05/2006,25,0,0,0,1,3,0,29
China,10/05/2006,45,0,0,0,12,1,0,58
China,11/05/2006,43,0,-2,0,3,2,0,46
China,12/05/2006,62,0,0,0,16,5,0,83
China,13/05/2006,34,0,0,0,9,0,0,43
China,14/05/2006,6,0,0,0,-8,0,0,-2
China,15/05/2006,18,6,0,0,1,4,0,29
China,16/05/2006,50,0,0,0,4,2,0,56
China,17/05/2006,25,0,0,0,6,5,0,36
China,18/05/2006,17,0,2,0,25,4,0,48
China,19/05/2006,17,0,2,0,13,4,0,36
China,20/05/2006,16,0,0,0,13,3,0,32
China,21/05/2006,3,0,0,0,0,0,0,3
China,22/05/2006,19,4,-1,0,6,5,0,33
China,23/05/2006,40,0,0,0,21,2,0,63
China,24/05/2006,44,0,-4,0,15,3,0,58
China,25/05/2006,27,0,0,0,2,1,0,30
China,26/05/2006,9,0,0,0,14,0,0,23
China,27/05/2006,5,0,0,0,3,4,0,12
China,28/05/2006,3,2,0,0,1,0,0,6
China,29/05/2006,15,0,-5,0,-2,4,0,12
China,30/05/2006,77,0,-2,0,13,7,0,95
China,31/05/2006,6,2,0,0,7,4,0,19
Egypt,01/05/2006,5,0,4,0,0,0,0,9
Egypt,02/05/2006,5,0,0,0,0,0,0,5
Egypt,03/05/2006,0,0,0,0,0,1,0,1
Egypt,04/05/2006,12,0,0,0,6,0,0,18
Egypt,05/05/2006,2,0,0,0,0,0,0,2
Egypt,06/05/2006,0,0,0,0,3,0,0,3
Egypt,07/05/2006,0,0,0,0,0,0,0,0
Egypt,08/05/2006,5,0,0,0,0,0,0,5
Egypt,09/05/2006,32,0,1,0,25,10,0,68
Egypt,10/05/2006,4,0,0,0,4,0,0,8
Egypt,11/05/2006,6,0,0,0,9,0,0,15
Egypt,12/05/2006,24,0,0,0,25,0,0,49
Egypt,13/05/2006,-1,0,0,0,3,0,0,2
Egypt,14/05/2006,4,0,0,0,0,0,0,4
Egypt,15/05/2006,3,0,0,0,0,2,0,5
Egypt,16/05/2006,19,0,0,0,3,0,0,22
Egypt,17/05/2006,6,0,0,0,18,1,0,25
Egypt,18/05/2006,9,0,0,0,-2,0,0,7
Egypt,19/05/2006,34,2,0,0,12,0,0,48
Egypt,20/05/2006,3,0,0,0,12,6,0,21
Egypt,21/05/2006,9,0,1,0,9,2,0,21
Egypt,22/05/2006,35,0,0,0,6,1,0,42
Egypt,23/05/2006,15,0,0,0,0,3,0,18
Egypt,24/05/2006,6,0,0,0,0,0,0,6
Egypt,25/05/2006,4,0,0,0,0,0,0,4
Egypt,26/05/2006,0,0,0,0,3,1,0,4
Egypt,27/05/2006,5,0,0,0,-3,1,0,3
Egypt,28/05/2006,6,0,0,0,6,0,0,12
Egypt,29/05/2006,9,0,0,0,9,2,0,20
Egypt,30/05/2006,4,0,0,0,10,0,0,14
Egypt,31/05/2006,8,0,0,0,9,2,0,19
Eritrea,01/05/2006,0,2,0,0,0,0,0,2
Eritrea,02/05/2006,0,0,0,0,9,0,0,9
Eritrea,03/05/2006,0,0,0,0,6,1,0,7
Eritrea,04/05/2006,1,0,0,0,0,0,0,1
Eritrea,05/05/2006,0,0,0,0,0,0,0,0
Eritrea,06/05/2006,0,0,0,0,0,0,0,0
Eritrea,07/05/2006,0,0,0,0,0,0,0,0
Eritrea,08/05/2006,0,0,0,0,0,0,0,0
Eritrea,09/05/2006,0,0,0,0,0,0,0,0
Eritrea,10/05/2006,0,0,0,0,0,0,0,0
Eritrea,11/05/2006,10,0,0,0,9,1,0,20
Eritrea,12/05/2006,9,0,0,0,-1,3,0,11
Eritrea,13/05/2006,0,0,0,0,-1,0,0,-1
Eritrea,15/05/2006,0,0,0,0,4,0,0,4
Eritrea,16/05/2006,8,0,1,0,0,5,0,14
Eritrea,17/05/2006,2,0,0,0,-6,0,0,-4
Eritrea,18/05/2006,0,0,0,0,0,0,0,0
Eritrea,19/05/2006,0,0,0,0,0,0,0,0
Eritrea,20/05/2006,-3,0,0,0,3,0,0,0
Eritrea,23/05/2006,1,2,0,0,3,0,0,6
Eritrea,24/05/2006,-2,0,0,0,0,0,0,-2
Eritrea,25/05/2006,3,0,0,0,0,0,0,3
Eritrea,26/05/2006,0,0,0,0,0,0,0,0
Eritrea,27/05/2006,0,0,0,0,0,0,0,0
Eritrea,28/05/2006,1,0,0,0,0,1,0,2
Eritrea,29/05/2006,0,0,0,0,0,0,0,0
Eritrea,30/05/2006,0,0,0,0,0,0,0,0
Eritrea,31/05/2006,0,0,0,0,0,0,0,0
Georgia,01/05/2006,0,0,0,0,0,0,0,0
Georgia,02/05/2006,6,0,0,0,3,0,0,9
Georgia,03/05/2006,2,0,0,0,0,0,0,2
Georgia,04/05/2006,-2,0,0,0,0,0,0,-2
Georgia,05/05/2006,-9,0,0,0,6,0,0,-3
Georgia,06/05/2006,0,0,0,0,0,0,0,0
Georgia,07/05/2006,3,0,0,0,0,2,0,5
Georgia,08/05/2006,-3,0,-2,0,0,2,0,-3
Georgia,09/05/2006,3,0,0,0,0,0,0,3
Georgia,10/05/2006,1,0,0,0,0,0,0,1
Georgia,11/05/2006,0,0,0,0,0,0,0,0
Georgia,12/05/2006,2,0,0,0,0,0,0,2
Georgia,13/05/2006,-3,0,0,0,0,0,0,-3
Georgia,14/05/2006,0,0,0,0,0,0,0,0
Georgia,15/05/2006,0,0,0,0,0,0,0,0
Georgia,16/05/2006,3,0,0,0,0,1,0,4
Georgia,17/05/2006,7,0,0,0,9,2,0,18
Georgia,18/05/2006,4,0,0,0,12,2,0,18
Georgia,19/05/2006,2,0,0,0,3,0,0,5
Georgia,22/05/2006,1,0,0,0,0,0,0,1
Georgia,23/05/2006,-1,0,0,0,0,0,0,-1
Georgia,24/05/2006,-1,0,0,0,6,0,0,5
Georgia,25/05/2006,12,0,-2,0,6,0,0,16
Georgia,26/05/2006,0,0,0,0,0,0,0,0
Georgia,27/05/2006,-6,0,0,0,0,0,0,-6
Georgia,28/05/2006,3,0,0,0,0,0,0,3
Georgia,29/05/2006,0,0,0,0,0,0,0,0
Georgia,30/05/2006,6,0,-2,0,0,1,0,5
Georgia,31/05/2006,0,2,0,0,0,0,0,2
India,01/05/2006,3,0,0,0,-1,1,0,3
India,02/05/2006,12,0,0,0,3,1,0,16
India,03/05/2006,4,0,0,0,0,1,0,5
India,04/05/2006,9,0,-2,0,0,1,0,8
India,05/05/2006,-1,2,0,0,0,0,0,1
India,07/05/2006,3,0,0,0,0,4,0,7
India,08/05/2006,6,0,0,0,-4,0,0,2
India,09/05/2006,19,0,0,0,3,0,0,22
India,10/05/2006,5,0,0,0,0,0,0,5
India,11/05/2006,7,0,0,0,0,0,0,7
India,12/05/2006,27,0,-1,0,11,5,0,42
India,13/05/2006,11,0,0,0,-2,5,0,14
India,14/05/2006,2,0,0,0,0,0,0,2
India,15/05/2006,10,0,0,0,6,0,0,16
India,16/05/2006,0,0,0,0,10,0,0,10
India,17/05/2006,28,2,0,0,-3,0,0,27
India,18/05/2006,4,0,0,0,21,2,0,27
India,19/05/2006,9,2,0,0,3,9,0,23
India,20/05/2006,3,0,0,0,0,1,0,4
India,21/05/2006,1,0,0,0,0,0,0,1
India,22/05/2006,5,0,0,0,0,0,0,5
India,23/05/2006,9,0,0,0,6,1,0,16
India,24/05/2006,13,2,-2,0,9,10,0,32
India,25/05/2006,13,0,0,0,6,4,0,23
India,26/05/2006,8,0,-2,0,13,0,0,19
India,27/05/2006,9,0,-2,0,-4,0,0,3
India,28/05/2006,15,0,0,0,-2,1,0,14
India,29/05/2006,14,0,0,0,3,1,0,18
India,30/05/2006,14,2,1,0,4,5,0,26
India,31/05/2006,11,2,0,0,1,1,0,15
Iran,01/05/2006,26,2,0,0,0,0,0,28
Iran,02/05/2006,35,0,0,0,3,3,0,41
Iran,03/05/2006,27,0,0,0,2,4,0,33
Iran,04/05/2006,-3,0,1,0,6,1,0,5
Iran,05/05/2006,25,0,0,0,3,0,0,28
Iran,06/05/2006,0,0,0,0,9,0,0,9
Iran,07/05/2006,24,0,-4,0,-3,4,0,21
Iran,08/05/2006,25,0,0,0,0,3,0,28
Iran,09/05/2006,22,0,0,0,4,2,0,28
Iran,10/05/2006,42,0,0,0,6,2,0,50
Iran,11/05/2006,21,0,0,0,14,4,0,39
Iran,12/05/2006,36,2,1,0,27,7,0,73
Iran,13/05/2006,18,2,0,0,-1,2,0,21
Iran,14/05/2006,37,0,-2,0,6,4,0,45
Iran,15/05/2006,45,0,1,0,-2,8,0,52
Iran,16/05/2006,23,0,1,0,-2,6,0,28
Iran,17/05/2006,32,0,1,0,10,12,0,55
Iran,18/05/2006,19,0,0,0,0,2,0,21
Iran,19/05/2006,23,0,0,0,6,-1,0,28
Iran,20/05/2006,18,0,0,0,4,3,0,25
Iran,21/05/2006,20,0,0,0,0,2,0,22
Iran,22/05/2006,37,2,0,0,4,3,0,46
Iran,23/05/2006,51,2,-1,0,6,7,0,65
Iran,24/05/2006,57,0,0,0,4,5,0,66
Iran,25/05/2006,34,0,1,0,6,0,0,41
Iran,26/05/2006,33,4,1,0,11,4,0,53
Iran,27/05/2006,-4,4,0,0,6,3,0,9
Iran,28/05/2006,5,0,0,0,3,1,0,9
Iran,29/05/2006,52,0,0,0,-2,8,0,58
Iran,30/05/2006,34,0,0,0,24,14,0,72
Iran,31/05/2006,24,0,1,0,-2,3,0,26
Iraq,01/05/2006,49,0,-2,0,18,3,0,68
Iraq,02/05/2006,43,0,-2,0,22,4,0,67
Iraq,03/05/2006,31,0,-2,0,11,5,0,45
Iraq,04/05/2006,41,0,0,0,15,4,0,60
Iraq,05/05/2006,12,0,1,0,-4,0,0,9
Iraq,06/05/2006,48,0,0,0,7,7,0,62
Iraq,07/05/2006,51,0,1,0,21,4,0,77
Iraq,08/05/2006,76,0,0,0,5,11,0,92
Iraq,09/05/2006,52,0,-2,0,9,3,0,62
Iraq,10/05/2006,41,0,0,0,17,0,0,58
Iraq,11/05/2006,47,0,0,0,27,1,0,75
Iraq,12/05/2006,144,2,-2,0,43,7,0,194
Iraq,13/05/2006,47,0,1,0,3,0,0,51
Iraq,14/05/2006,20,0,-2,0,12,4,0,34
Iraq,15/05/2006,63,0,2,0,4,11,0,80
Iraq,16/05/2006,19,0,0,0,20,1,0,40
Iraq,17/05/2006,39,0,0,0,27,4,0,70
Iraq,18/05/2006,50,0,1,0,6,1,0,58
Iraq,19/05/2006,45,0,0,0,16,2,0,63
Iraq,20/05/2006,61,0,1,0,-1,12,0,73
Iraq,21/05/2006,8,0,0,0,3,1,0,12
Iraq,22/05/2006,74,0,1,0,73,11,0,159
Iraq,23/05/2006,119,0,2,0,43,18,0,182
Iraq,24/05/2006,59,0,-3,0,60,10,0,126
Iraq,25/05/2006,30,0,-1,0,33,14,0,76
Iraq,26/05/2006,43,0,3,0,9,0,0,55
Iraq,27/05/2006,45,0,0,0,5,4,0,54
Iraq,28/05/2006,51,0,0,0,19,3,0,73
Iraq,29/05/2006,96,0,0,0,29,16,0,141
Iraq,30/05/2006,45,0,0,0,2,11,0,58
Iraq,31/05/2006,54,0,0,0,18,4,0,76
Morocco,01/05/2006,0,0,0,0,0,0,0,0
Morocco,02/05/2006,4,0,0,0,0,0,0,4
Morocco,03/05/2006,1,0,0,0,6,0,0,7
Morocco,04/05/2006,7,0,0,0,6,0,0,13
Morocco,05/05/2006,0,0,0,0,0,0,0,0
Morocco,06/05/2006,0,0,0,0,0,0,0,0
Morocco,07/05/2006,0,0,0,0,0,0,0,0
Morocco,08/05/2006,0,0,0,0,0,0,0,0
Morocco,09/05/2006,0,0,0,0,0,0,0,0
Morocco,10/05/2006,2,0,0,0,0,0,0,2
Morocco,11/05/2006,0,0,0,0,0,0,0,0
Morocco,12/05/2006,4,0,0,0,3,0,0,7
Morocco,13/05/2006,1,0,0,0,15,0,0,16
Morocco,14/05/2006,4,0,0,0,0,0,0,4
Morocco,15/05/2006,7,0,0,0,0,0,0,7
Morocco,16/05/2006,1,0,0,0,6,0,0,7
Morocco,17/05/2006,0,0,0,0,6,2,0,8
Morocco,18/05/2006,4,0,0,0,0,0,0,4
Morocco,19/05/2006,3,0,0,0,18,2,0,23
Morocco,20/05/2006,0,0,0,0,3,0,0,3
Morocco,21/05/2006,0,0,0,0,1,0,0,1
Morocco,22/05/2006,3,0,0,0,0,0,0,3
Morocco,23/05/2006,25,0,0,0,5,0,0,30
Morocco,24/05/2006,4,0,0,0,12,0,0,16
Morocco,25/05/2006,0,0,0,0,-4,0,0,-4
Morocco,26/05/2006,2,0,1,0,11,0,0,14
Morocco,27/05/2006,0,0,0,0,0,0,0,0
Morocco,28/05/2006,6,0,0,0,0,0,0,6
Morocco,29/05/2006,0,0,0,0,0,0,0,0
Morocco,30/05/2006,0,0,0,0,6,0,0,6
Morocco,31/05/2006,0,0,0,0,6,0,0,6
Nigeria,01/05/2006,8,0,-1,0,3,1,0,11
Nigeria,02/05/2006,12,0,1,0,0,1,0,14
Nigeria,03/05/2006,9,0,0,0,0,1,0,10
Nigeria,04/05/2006,5,0,-2,0,-1,0,0,2
Nigeria,05/05/2006,19,0,0,0,0,3,0,22
Nigeria,06/05/2006,0,0,-2,0,0,0,0,-2
Nigeria,07/05/2006,4,0,0,0,0,0,0,4
Nigeria,08/05/2006,12,0,0,0,2,5,0,19
Nigeria,09/05/2006,16,0,1,0,6,4,0,27
Nigeria,10/05/2006,4,0,-1,0,3,0,0,6
Nigeria,11/05/2006,13,0,0,0,1,0,0,14
Nigeria,12/05/2006,18,0,-1,0,0,1,0,18
Nigeria,13/05/2006,1,0,0,0,0,2,0,3
Nigeria,14/05/2006,3,0,0,0,6,0,0,9
Nigeria,15/05/2006,12,0,0,0,0,4,0,16
Nigeria,16/05/2006,15,0,0,0,-2,-3,0,10
Nigeria,17/05/2006,10,0,0,0,-2,4,0,12
Nigeria,18/05/2006,8,0,0,0,5,2,0,15
Nigeria,19/05/2006,12,0,0,0,1,2,0,15
Nigeria,20/05/2006,5,0,0,0,4,1,0,10
Nigeria,21/05/2006,6,0,-2,0,3,0,0,7
Nigeria,22/05/2006,29,0,1,0,9,0,0,39
Nigeria,23/05/2006,45,0,-1,0,0,4,0,48
Nigeria,24/05/2006,20,6,2,0,30,5,0,63
Nigeria,25/05/2006,15,0,0,0,2,3,0,20
Nigeria,26/05/2006,5,0,0,0,12,5,0,22
Nigeria,27/05/2006,7,0,0,0,0,0,0,7
Nigeria,28/05/2006,0,0,0,0,3,0,0,3
Nigeria,29/05/2006,16,0,0,0,6,2,0,24
Nigeria,30/05/2006,8,0,0,0,3,1,0,12
Nigeria,31/05/2006,0,0,0,0,6,2,0,8
Pakistan,01/05/2006,3,0,0,0,9,0,0,12
Pakistan,02/05/2006,17,0,0,0,30,5,0,52
Pakistan,03/05/2006,3,0,0,0,0,2,0,5
Pakistan,04/05/2006,25,0,0,0,14,0,0,39
Pakistan,05/05/2006,9,0,0,0,10,0,0,19
Pakistan,06/05/2006,2,0,0,0,3,0,0,5
Pakistan,07/05/2006,3,0,0,0,-2,0,0,1
Pakistan,08/05/2006,3,0,0,0,25,0,0,28
Pakistan,09/05/2006,34,0,0,0,21,0,0,55
Pakistan,10/05/2006,7,0,0,0,15,2,0,24
Pakistan,11/05/2006,47,6,-2,0,12,7,0,70
Pakistan,12/05/2006,62,2,-2,0,11,6,0,79
Pakistan,13/05/2006,14,0,1,0,10,0,0,25
Pakistan,14/05/2006,14,0,0,0,10,0,0,24
Pakistan,15/05/2006,30,0,0,0,9,3,0,42
Pakistan,16/05/2006,12,0,0,0,-4,0,0,8
Pakistan,17/05/2006,25,0,-4,0,18,0,0,39
Pakistan,18/05/2006,26,0,1,0,-4,10,0,33
Pakistan,19/05/2006,59,0,0,0,11,14,0,84
Pakistan,20/05/2006,14,0,0,0,11,1,0,26
Pakistan,21/05/2006,23,0,0,0,0,17,0,40
Pakistan,22/05/2006,23,0,0,0,1,5,0,29
Pakistan,23/05/2006,32,0,0,0,3,4,0,39
Pakistan,24/05/2006,41,0,0,0,27,1,0,69
Pakistan,25/05/2006,13,0,0,0,27,8,0,48
Pakistan,26/05/2006,6,0,0,0,4,0,0,10
Pakistan,27/05/2006,11,0,0,0,1,0,0,12
Pakistan,28/05/2006,19,0,0,0,0,0,0,19
Pakistan,29/05/2006,26,0,0,0,6,2,0,34
Pakistan,30/05/2006,9,0,0,0,17,0,0,26
Pakistan,31/05/2006,5,0,0,0,9,1,0,15
Sierra Leone,01/05/2006,3,0,0,0,6,0,0,9
Sierra Leone,02/05/2006,2,0,0,0,-2,0,0,0
Sierra Leone,03/05/2006,0,0,0,0,0,0,0,0
Sierra Leone,04/05/2006,2,0,0,0,3,0,0,5
Sierra Leone,05/05/2006,0,0,0,0,0,0,0,0
Sierra Leone,06/05/2006,0,0,0,0,0,0,0,0
Sierra Leone,08/05/2006,6,0,0,0,3,0,0,9
Sierra Leone,09/05/2006,7,0,0,0,6,2,0,15
Sierra Leone,10/05/2006,-2,0,0,0,-2,0,0,-4
Sierra Leone,11/05/2006,0,0,0,0,3,0,0,3
Sierra Leone,12/05/2006,6,0,0,0,6,0,0,12
Sierra Leone,13/05/2006,0,0,0,0,0,0,0,0
Sierra Leone,14/05/2006,0,0,0,0,0,0,0,0
Sierra Leone,15/05/2006,0,0,-2,0,1,0,0,-1
Sierra Leone,16/05/2006,0,0,-3,0,9,0,0,6
Sierra Leone,17/05/2006,10,0,0,0,8,1,0,19
Sierra Leone,18/05/2006,3,0,0,0,6,0,0,9
Sierra Leone,19/05/2006,2,0,0,0,-2,5,0,5
Sierra Leone,22/05/2006,5,0,0,0,-2,0,0,3
Sierra Leone,23/05/2006,0,0,0,0,0,1,0,1
Sierra Leone,24/05/2006,0,0,1,0,3,0,0,4
Sierra Leone,25/05/2006,0,0,0,0,9,0,0,9
Sierra Leone,26/05/2006,-1,2,1,0,9,1,0,12
Sierra Leone,27/05/2006,-1,0,0,0,9,1,0,9
Sierra Leone,28/05/2006,0,0,0,0,0,0,0,0
Sierra Leone,29/05/2006,2,0,0,0,0,0,0,2
Sierra Leone,30/05/2006,-1,0,0,0,6,0,0,5
Sierra Leone,31/05/2006,1,0,0,0,6,0,0,7
Somalia,01/05/2006,7,0,0,0,0,0,0,7
Somalia,02/05/2006,10,0,0,0,3,0,0,13
Somalia,03/05/2006,12,2,0,0,12,0,0,26
Somalia,04/05/2006,1,0,0,0,0,0,0,1
Somalia,05/05/2006,7,0,0,0,-1,0,0,6
Somalia,06/05/2006,0,0,0,0,0,0,0,0
Somalia,07/05/2006,0,0,0,0,3,0,0,3
Somalia,08/05/2006,0,0,0,0,0,0,0,0
Somalia,09/05/2006,0,0,0,0,0,0,0,0
Somalia,10/05/2006,2,0,0,0,0,0,0,2
Somalia,11/05/2006,0,0,1,0,0,0,0,1
Somalia,12/05/2006,27,2,0,0,2,2,0,33
Somalia,13/05/2006,8,4,0,0,5,0,0,17
Somalia,14/05/2006,7,0,0,0,0,0,0,7
Somalia,15/05/2006,8,0,0,0,0,0,0,8
Somalia,16/05/2006,13,0,0,0,0,0,0,13
Somalia,17/05/2006,5,0,0,0,2,0,0,7
Somalia,18/05/2006,0,0,0,0,0,1,0,1
Somalia,19/05/2006,6,0,0,0,0,0,0,6
Somalia,20/05/2006,6,0,0,0,0,0,0,6
Somalia,21/05/2006,8,0,0,0,0,0,0,8
Somalia,22/05/2006,0,0,0,0,15,0,0,15
Somalia,23/05/2006,2,0,0,0,3,0,0,5
Somalia,24/05/2006,0,0,0,0,6,0,0,6
Somalia,25/05/2006,12,0,0,0,-2,1,0,11
Somalia,26/05/2006,1,0,0,0,0,1,0,2
Somalia,27/05/2006,0,0,0,0,5,0,0,5
Somalia,28/05/2006,6,0,0,0,0,0,0,6
Somalia,29/05/2006,1,0,0,0,0,0,0,1
Somalia,30/05/2006,-1,0,0,0,-4,0,0,-5
Somalia,31/05/2006,0,0,0,0,0,4,0,4
Syria,01/05/2006,6,0,0,0,3,0,0,9
Syria,02/05/2006,7,0,0,0,8,0,0,15
Syria,03/05/2006,4,0,0,0,-2,0,0,2
Syria,04/05/2006,14,0,-8,0,0,0,0,6
Syria,06/05/2006,3,0,0,0,0,0,0,3
Syria,07/05/2006,0,0,0,0,3,0,0,3
Syria,08/05/2006,0,0,0,0,0,0,0,0
Syria,09/05/2006,-1,0,0,0,6,3,0,8
Syria,10/05/2006,-5,0,0,0,12,0,0,7
Syria,11/05/2006,6,0,0,0,3,2,0,11
Syria,12/05/2006,12,0,0,0,14,2,0,28
Syria,13/05/2006,34,0,0,0,0,0,0,34
Syria,14/05/2006,2,0,0,0,19,1,0,22
Syria,15/05/2006,1,0,0,0,9,0,0,10
Syria,16/05/2006,-2,0,0,0,12,0,0,10
Syria,17/05/2006,3,0,0,0,7,5,0,15
Syria,18/05/2006,9,0,0,0,-1,0,0,8
Syria,19/05/2006,28,0,0,0,0,0,0,28
Syria,20/05/2006,22,0,0,0,0,12,0,34
Syria,21/05/2006,7,0,0,0,0,9,0,16
Syria,22/05/2006,9,0,0,0,7,0,0,16
Syria,23/05/2006,0,0,0,0,4,0,0,4
Syria,24/05/2006,0,0,0,0,9,0,0,9
Syria,25/05/2006,5,0,0,0,21,0,0,26
Syria,26/05/2006,4,0,0,0,3,0,0,7
Syria,27/05/2006,6,2,0,0,0,0,0,8
Syria,28/05/2006,26,0,0,0,0,0,0,26
Syria,29/05/2006,8,0,0,0,-4,0,0,4
Syria,30/05/2006,6,0,0,0,3,0,0,9
Syria,31/05/2006,6,0,0,0,0,0,0,6
Yemen,01/05/2006,0,0,0,0,0,0,0,0
Yemen,03/05/2006,3,0,0,0,6,0,0,9
Yemen,04/05/2006,3,0,0,0,3,0,0,6
Yemen,05/05/2006,0,0,0,0,3,0,0,3
Yemen,08/05/2006,0,0,0,0,0,0,0,0
Yemen,09/05/2006,3,0,0,0,0,0,0,3
Yemen,10/05/2006,0,0,0,0,6,0,0,6
Yemen,11/05/2006,0,0,0,0,-2,0,0,-2
Yemen,12/05/2006,0,0,0,0,0,0,0,0
Yemen,14/05/2006,0,0,0,0,0,0,0,0
Yemen,15/05/2006,6,0,0,0,7,0,0,13
Yemen,16/05/2006,0,0,0,0,0,0,0,0
Yemen,17/05/2006,3,0,0,0,0,0,0,3
Yemen,19/05/2006,4,0,0,0,0,0,0,4
Yemen,20/05/2006,0,0,0,0,0,0,0,0
Yemen,22/05/2006,2,0,0,0,0,0,0,2
Yemen,23/05/2006,0,0,0,0,0,0,0,0
Yemen,24/05/2006,0,0,0,0,0,0,0,0
Yemen,25/05/2006,0,0,0,0,0,0,0,0
Yemen,26/05/2006,0,0,0,0,0,0,0,0
Yemen,27/05/2006,0,0,0,0,0,2,0,2
Yemen,28/05/2006,0,0,0,0,0,0,0,0
Yemen,29/05/2006,0,0,0,0,0,0,0,0
Yemen,30/05/2006,1,0,0,0,0,0,0,1
Yemen,31/05/2006,0,0,0,0,0,0,0,0
Afghanistan,01/02/2007,87,0,0,0,47,6,0,140
Afghanistan,02/02/2007,79,0,1,0,30,3,0,113
Afghanistan,03/02/2007,87,0,0,0,39,22,0,148
Afghanistan,04/02/2007,30,0,1,0,15,3,0,49
Afghanistan,05/02/2007,57,2,1,0,63,10,0,133
Afghanistan,06/02/2007,85,2,-4,0,15,3,0,101
Afghanistan,07/02/2007,61,2,-1,0,7,14,0,83
Afghanistan,08/02/2007,123,0,-1,0,-5,1,0,118
Afghanistan,09/02/2007,29,0,0,0,1,5,0,35
Afghanistan,10/02/2007,46,0,0,0,1,0,0,47
Afghanistan,11/02/2007,64,0,0,0,10,6,0,80
Afghanistan,12/02/2007,94,4,-3,0,3,11,0,109
Afghanistan,13/02/2007,45,4,0,0,21,4,0,74
Afghanistan,14/02/2007,137,2,0,0,45,9,0,193
Afghanistan,15/02/2007,70,0,-1,0,24,6,0,99
Afghanistan,16/02/2007,73,2,0,0,40,4,0,119
Afghanistan,17/02/2007,91,2,-2,0,8,20,0,119
Afghanistan,18/02/2007,84,0,0,0,22,28,0,134
Afghanistan,19/02/2007,99,0,0,0,38,2,0,139
Afghanistan,20/02/2007,86,0,2,0,9,7,0,104
Afghanistan,21/02/2007,63,0,-27,0,9,3,0,48
Afghanistan,22/02/2007,62,2,-8,0,16,23,0,95
Afghanistan,23/02/2007,65,2,0,0,47,6,0,120
Afghanistan,24/02/2007,44,0,4,0,13,1,0,62
Afghanistan,25/02/2007,50,0,1,0,12,3,0,66
Afghanistan,26/02/2007,97,0,2,0,27,7,0,133
Afghanistan,27/02/2007,117,0,0,0,-6,9,0,120
Afghanistan,28/02/2007,69,0,-6,0,27,7,0,97
Albania,01/02/2007,31,0,-2,0,-2,0,0,27
Albania,02/02/2007,78,0,-5,0,14,5,0,92
Albania,03/02/2007,27,0,0,0,3,0,0,30
Albania,04/02/2007,3,0,1,0,12,1,0,17
Albania,05/02/2007,32,0,0,0,-1,6,0,37
Albania,06/02/2007,4,0,-2,0,6,0,0,8
Albania,07/02/2007,6,0,-1,0,12,0,0,17
Albania,08/02/2007,10,0,-1,0,3,0,0,12
Albania,09/02/2007,8,0,-7,0,0,2,0,3
Albania,10/02/2007,6,2,-7,0,6,8,0,15
Albania,11/02/2007,9,4,-2,0,12,10,0,33
Albania,12/02/2007,13,0,-4,0,12,9,0,30
Albania,13/02/2007,9,0,-2,0,9,4,0,20
Albania,14/02/2007,27,0,-10,0,6,4,0,27
Albania,15/02/2007,22,0,-8,0,4,4,0,22
Albania,16/02/2007,22,0,0,0,0,1,0,23
Albania,17/02/2007,0,0,0,0,3,0,0,3
Albania,18/02/2007,0,0,0,0,0,0,0,0
Albania,19/02/2007,37,0,0,0,-2,0,0,35
Albania,20/02/2007,9,0,-4,0,0,6,0,11
Albania,21/02/2007,11,0,0,0,0,2,0,13
Albania,22/02/2007,29,0,-1,0,0,0,0,28
Albania,23/02/2007,31,0,0,0,3,1,0,35
Albania,24/02/2007,12,0,-3,0,0,1,0,10
Albania,25/02/2007,0,0,-1,0,0,0,0,-1
Albania,26/02/2007,11,0,0,0,0,6,0,17
Albania,27/02/2007,5,0,0,0,9,1,0,15
Albania,28/02/2007,10,0,-1,0,3,4,0,16
Algeria,01/02/2007,8,0,0,0,6,0,0,14
Algeria,02/02/2007,5,0,0,0,0,0,0,5
Algeria,03/02/2007,0,0,0,0,0,0,0,0
Algeria,04/02/2007,0,0,0,0,0,0,0,0
Algeria,05/02/2007,11,0,0,0,0,0,0,11
Algeria,06/02/2007,-6,0,0,0,6,0,0,0
Algeria,07/02/2007,7,0,0,0,3,0,0,10
Algeria,08/02/2007,18,0,0,0,6,0,0,24
Algeria,09/02/2007,7,0,0,0,18,0,0,25
Algeria,10/02/2007,1,0,0,0,0,0,0,1
Algeria,11/02/2007,0,0,0,0,0,0,0,0
Algeria,12/02/2007,0,0,0,0,0,0,0,0
Algeria,13/02/2007,11,0,0,0,-2,0,0,9
Algeria,14/02/2007,0,0,0,0,0,0,0,0
Algeria,15/02/2007,0,0,0,0,0,0,0,0
Algeria,16/02/2007,0,0,0,0,0,0,0,0
Algeria,17/02/2007,25,0,0,0,-4,0,0,21
Algeria,18/02/2007,0,0,0,0,4,0,0,4
Algeria,19/02/2007,15,0,0,0,6,0,0,21
Algeria,20/02/2007,6,0,0,0,0,0,0,6
Algeria,21/02/2007,0,0,0,0,0,4,0,4
Algeria,22/02/2007,1,0,0,0,-5,0,0,-4
Algeria,23/02/2007,10,0,0,0,8,0,0,18
Algeria,24/02/2007,0,0,0,0,-10,0,0,-10
Algeria,26/02/2007,-3,0,0,0,6,0,0,3
Algeria,27/02/2007,5,0,0,0,1,0,0,6
Algeria,28/02/2007,1,0,0,0,0,2,0,3
Bangladesh,01/02/2007,2,0,0,0,0,4,0,6
Bangladesh,02/02/2007,3,0,0,0,0,0,0,3
Bangladesh,03/02/2007,2,0,0,0,4,0,0,6
Bangladesh,04/02/2007,14,0,-6,0,34,4,0,46
Bangladesh,05/02/2007,1,0,0,0,-2,0,0,-1
Bangladesh,06/02/2007,2,0,0,0,9,1,0,12
Bangladesh,07/02/2007,2,0,0,0,-8,0,0,-6
Bangladesh,08/02/2007,2,0,-4,0,5,2,0,5
Bangladesh,09/02/2007,6,0,-4,0,7,7,0,16
Bangladesh,10/02/2007,0,0,1,0,0,0,0,1
Bangladesh,11/02/2007,0,0,0,0,0,0,0,0
Bangladesh,12/02/2007,3,0,0,0,1,0,0,4
Bangladesh,13/02/2007,21,0,-3,0,9,-2,0,25
Bangladesh,14/02/2007,5,0,-2,0,0,0,0,3
Bangladesh,15/02/2007,0,0,0,0,-1,0,0,-1
Bangladesh,16/02/2007,5,0,-1,0,0,1,0,5
Bangladesh,17/02/2007,0,0,-4,0,-2,0,0,-6
Bangladesh,18/02/2007,18,0,0,0,0,0,0,18
Bangladesh,19/02/2007,22,0,0,0,30,4,0,56
Bangladesh,20/02/2007,21,0,0,0,3,1,0,25
Bangladesh,21/02/2007,12,0,0,0,0,0,0,12
Bangladesh,22/02/2007,2,0,-4,0,6,0,0,4
Bangladesh,23/02/2007,12,0,0,0,-2,0,0,10
Bangladesh,24/02/2007,0,0,0,0,6,0,0,6
Bangladesh,25/02/2007,13,0,-4,0,-2,0,0,7
Bangladesh,26/02/2007,4,0,0,0,7,0,0,11
Bangladesh,27/02/2007,2,0,0,0,-5,0,0,-3
Bangladesh,28/02/2007,0,0,-2,0,9,0,0,7
Cameroon,01/02/2007,0,0,0,0,0,0,0,0
Cameroon,02/02/2007,0,0,0,0,0,0,0,0
Cameroon,03/02/2007,0,0,0,0,0,0,0,0
Cameroon,04/02/2007,0,0,0,0,0,0,0,0
Cameroon,05/02/2007,0,0,0,0,0,0,0,0
Cameroon,06/02/2007,0,0,0,0,0,0,0,0
Cameroon,07/02/2007,0,0,0,0,6,0,0,6
Cameroon,08/02/2007,0,0,0,0,0,0,0,0
Cameroon,09/02/2007,5,0,0,0,0,2,0,7
Cameroon,10/02/2007,0,0,0,0,0,0,0,0
Cameroon,11/02/2007,0,0,0,0,0,0,0,0
Cameroon,12/02/2007,0,0,0,0,0,0,0,0
Cameroon,13/02/2007,0,0,0,0,0,0,0,0
Cameroon,15/02/2007,0,0,0,0,0,0,0,0
Cameroon,20/02/2007,0,0,0,0,0,0,0,0
Cameroon,25/02/2007,0,0,-2,0,0,0,0,-2
Cameroon,26/02/2007,0,0,0,0,0,1,0,1
China,01/02/2007,31,4,-2,0,14,3,0,50
China,02/02/2007,59,0,2,0,4,11,0,76
China,03/02/2007,12,2,0,0,4,6,0,24
China,04/02/2007,17,0,1,0,-2,3,0,19
China,05/02/2007,72,0,0,0,33,5,0,110
China,06/02/2007,36,0,0,0,17,3,0,56
China,07/02/2007,69,2,0,0,43,5,0,119
China,08/02/2007,56,0,0,0,26,4,0,86
China,09/02/2007,58,0,1,0,23,5,0,87
China,10/02/2007,8,12,0,0,10,6,0,36
China,11/02/2007,23,0,0,0,3,7,0,33
China,12/02/2007,47,0,-1,0,24,16,0,86
China,13/02/2007,50,0,1,0,15,7,0,73
China,14/02/2007,30,0,4,0,7,5,0,46
China,15/02/2007,56,2,0,0,28,10,0,96
China,16/02/2007,33,0,0,0,18,6,0,57
China,17/02/2007,35,0,0,0,8,10,0,53
China,18/02/2007,46,0,0,0,12,4,0,62
China,19/02/2007,34,4,-2,0,44,7,0,87
China,20/02/2007,65,0,0,0,43,13,0,121
China,21/02/2007,59,0,0,0,20,13,0,92
China,22/02/2007,33,4,-3,0,60,2,0,96
China,23/02/2007,77,0,6,0,33,13,0,129
China,24/02/2007,36,0,-7,0,22,2,0,53
China,25/02/2007,16,0,0,0,5,0,0,21
China,26/02/2007,48,2,-4,0,19,4,0,69
China,27/02/2007,111,0,-2,0,11,23,0,143
China,28/02/2007,134,0,0,0,34,18,0,186
Egypt,01/02/2007,72,2,0,0,14,18,0,106
Egypt,02/02/2007,142,4,0,0,5,12,0,163
Egypt,03/02/2007,35,0,0,0,21,0,0,56
Egypt,04/02/2007,19,0,0,0,-1,0,0,18
Egypt,05/02/2007,3,0,0,0,21,0,0,24
Egypt,06/02/2007,20,0,0,0,36,0,0,56
Egypt,07/02/2007,11,0,0,0,4,0,0,15
Egypt,08/02/2007,2,0,0,0,12,0,0,14
Egypt,09/02/2007,16,0,0,0,4,4,0,24
Egypt,10/02/2007,4,0,0,0,2,6,0,12
Egypt,11/02/2007,11,0,0,0,-2,1,0,10
Egypt,12/02/2007,14,0,-4,0,13,0,0,23
Egypt,13/02/2007,12,0,2,0,11,0,0,25
Egypt,14/02/2007,6,0,0,0,9,0,0,15
Egypt,15/02/2007,20,0,-8,0,56,0,0,68
Egypt,16/02/2007,27,0,-4,0,58,0,0,81
Egypt,17/02/2007,0,0,0,0,8,2,0,10
Egypt,18/02/2007,17,0,0,0,0,0,0,17
Egypt,19/02/2007,12,0,0,0,12,0,0,24
Egypt,20/02/2007,13,0,0,0,9,0,0,22
Egypt,21/02/2007,9,0,0,0,13,0,0,22
Egypt,22/02/2007,7,0,1,0,-4,18,0,22
Egypt,23/02/2007,-4,0,0,0,35,10,0,41
Egypt,24/02/2007,5,0,0,0,7,0,0,12
Egypt,25/02/2007,9,0,0,0,3,1,0,13
Egypt,26/02/2007,-3,0,0,0,6,1,0,4
Egypt,27/02/2007,8,0,0,0,6,0,0,14
Egypt,28/02/2007,10,0,0,0,18,3,0,31
Eritrea,01/02/2007,0,0,0,0,0,0,0,0
Eritrea,02/02/2007,1,0,0,0,-7,3,0,-3
Eritrea,03/02/2007,1,0,0,0,0,0,0,1
Eritrea,05/02/2007,0,0,0,0,6,0,0,6
Eritrea,06/02/2007,1,0,0,0,0,0,0,1
Eritrea,07/02/2007,0,0,0,0,6,0,0,6
Eritrea,08/02/2007,6,0,0,0,0,0,0,6
Eritrea,09/02/2007,0,0,0,0,0,0,0,0
Eritrea,12/02/2007,0,0,0,0,0,0,0,0
Eritrea,13/02/2007,2,0,0,0,0,0,0,2
Eritrea,14/02/2007,6,0,0,0,0,0,0,6
Eritrea,15/02/2007,4,0,0,0,0,0,0,4
Eritrea,16/02/2007,0,0,0,0,0,1,0,1
Eritrea,17/02/2007,0,0,0,0,0,0,0,0
Eritrea,18/02/2007,0,0,-2,0,0,0,0,-2
Eritrea,19/02/2007,-4,0,0,0,0,0,0,-4
Eritrea,20/02/2007,10,0,0,0,0,0,0,10
Eritrea,21/02/2007,2,0,0,0,7,0,0,9
Eritrea,22/02/2007,7,0,0,0,0,0,0,7
Eritrea,23/02/2007,1,0,0,0,0,2,0,3
Eritrea,24/02/2007,1,2,0,0,0,0,0,3
Eritrea,25/02/2007,2,0,0,0,0,0,0,2
Eritrea,27/02/2007,0,0,0,0,0,0,0,0
Eritrea,28/02/2007,0,0,0,0,18,0,0,18
Georgia,01/02/2007,4,0,0,0,0,0,0,4
Georgia,02/02/2007,0,0,-2,0,0,0,0,-2
Georgia,03/02/2007,0,0,0,0,0,0,0,0
Georgia,04/02/2007,0,0,0,0,0,0,0,0
Georgia,05/02/2007,2,0,0,0,6,2,0,10
Georgia,06/02/2007,0,0,0,0,0,0,0,0
Georgia,07/02/2007,1,0,-1,0,9,0,0,9
Georgia,08/02/2007,0,0,0,0,0,0,0,0
Georgia,09/02/2007,0,0,0,0,0,0,0,0
Georgia,10/02/2007,0,0,0,0,0,0,0,0
Georgia,11/02/2007,0,0,0,0,0,0,0,0
Georgia,12/02/2007,2,0,0,0,0,0,0,2
Georgia,13/02/2007,9,0,0,0,0,0,0,9
Georgia,14/02/2007,0,0,0,0,0,0,0,0
Georgia,15/02/2007,-3,0,0,0,0,0,0,-3
Georgia,16/02/2007,15,0,0,0,-4,0,0,11
Georgia,17/02/2007,3,0,0,0,0,0,0,3
Georgia,18/02/2007,0,0,0,0,0,0,0,0
Georgia,19/02/2007,-1,0,0,0,3,0,0,2
Georgia,20/02/2007,0,0,0,0,0,0,0,0
Georgia,21/02/2007,2,0,0,0,0,2,0,4
Georgia,22/02/2007,3,0,0,0,3,0,0,6
Georgia,23/02/2007,3,0,0,0,0,0,0,3
Georgia,24/02/2007,0,0,0,0,0,0,0,0
Georgia,25/02/2007,0,0,0,0,0,0,0,0
Georgia,26/02/2007,3,0,0,0,6,0,0,9
Georgia,27/02/2007,2,0,0,0,3,0,0,5
Georgia,28/02/2007,3,0,0,0,0,0,0,3
India,01/02/2007,24,0,0,0,6,1,0,31
India,02/02/2007,14,0,0,0,0,2,0,16
India,03/02/2007,24,0,0,0,-7,0,0,17
India,04/02/2007,6,0,0,0,0,2,0,8
India,05/02/2007,22,0,-3,0,9,2,0,30
India,06/02/2007,18,0,0,0,0,7,0,25
India,07/02/2007,25,0,0,0,9,12,0,46
India,08/02/2007,12,0,0,0,1,0,0,13
India,09/02/2007,17,0,0,0,6,0,0,23
India,10/02/2007,8,0,0,0,3,0,0,11
India,11/02/2007,3,0,0,0,0,4,0,7
India,12/02/2007,6,0,-1,0,-8,1,0,-2
India,13/02/2007,12,0,0,0,16,0,0,28
India,14/02/2007,19,0,1,0,1,3,0,24
India,15/02/2007,11,0,0,0,4,3,0,18
India,16/02/2007,25,0,0,0,11,8,0,44
India,17/02/2007,10,0,0,0,2,0,0,12
India,18/02/2007,32,0,-1,0,5,0,0,36
India,19/02/2007,19,0,0,0,-10,4,0,13
India,20/02/2007,14,0,0,0,-8,4,0,10
India,21/02/2007,6,0,-2,0,0,0,0,4
India,22/02/2007,14,0,0,0,3,3,0,20
India,23/02/2007,13,2,-2,0,-2,1,0,12
India,24/02/2007,6,0,-2,0,3,1,0,8
India,25/02/2007,23,0,0,0,-5,9,0,27
India,26/02/2007,7,0,0,0,11,1,0,19
India,27/02/2007,7,0,0,0,4,1,0,12
India,28/02/2007,10,0,0,0,6,0,0,16
Iran,01/02/2007,47,0,3,0,32,5,0,87
Iran,02/02/2007,94,0,0,0,36,6,0,136
Iran,03/02/2007,40,0,0,0,4,4,0,48
Iran,04/02/2007,33,0,-2,0,15,3,0,49
Iran,05/02/2007,24,0,1,0,4,1,0,30
Iran,06/02/2007,1,0,1,0,109,7,0,118
Iran,07/02/2007,49,0,0,0,73,7,0,129
Iran,08/02/2007,79,0,0,0,19,0,0,98
Iran,09/02/2007,47,0,-2,0,-2,0,0,43
Iran,10/02/2007,41,2,0,0,5,4,0,52
Iran,11/02/2007,28,0,0,0,14,8,0,50
Iran,12/02/2007,65,0,0,0,46,8,0,119
Iran,13/02/2007,98,0,2,0,14,2,0,116
Iran,14/02/2007,81,0,0,0,14,9,0,104
Iran,15/02/2007,61,0,0,0,27,5,0,93
Iran,16/02/2007,54,0,0,0,18,3,0,75
Iran,17/02/2007,44,0,0,0,13,3,0,60
Iran,18/02/2007,3,0,0,0,12,0,0,15
Iran,19/02/2007,57,2,2,0,44,3,0,108
Iran,20/02/2007,39,0,0,0,30,1,0,70
Iran,21/02/2007,38,0,0,0,19,1,0,58
Iran,22/02/2007,60,0,-2,0,23,4,0,85
Iran,23/02/2007,73,0,1,0,8,2,0,84
Iran,24/02/2007,28,0,0,0,18,8,0,54
Iran,25/02/2007,68,0,-3,0,10,64,0,139
Iran,26/02/2007,57,0,0,0,4,14,0,75
Iran,27/02/2007,97,0,-3,0,18,8,0,120
Iran,28/02/2007,42,0,0,0,18,7,0,67
Iraq,01/02/2007,142,4,0,0,45,12,0,203
Iraq,02/02/2007,187,0,-6,0,40,18,0,239
Iraq,03/02/2007,69,0,-11,0,36,5,0,99
Iraq,04/02/2007,88,8,-5,0,18,22,0,131
Iraq,05/02/2007,133,12,-4,0,52,49,0,242
Iraq,06/02/2007,210,6,-4,0,30,22,0,264
Iraq,07/02/2007,133,4,-8,0,101,15,0,245
Iraq,08/02/2007,225,2,-2,0,100,5,0,330
Iraq,09/02/2007,160,8,-8,0,20,9,0,189
Iraq,10/02/2007,50,4,-3,0,26,2,0,79
Iraq,11/02/2007,53,0,2,0,0,7,0,62
Iraq,12/02/2007,68,6,0,0,46,6,0,126
Iraq,13/02/2007,126,6,0,0,55,19,0,206
Iraq,14/02/2007,149,4,-4,0,65,13,0,227
Iraq,15/02/2007,105,10,3,0,55,20,0,193
Iraq,16/02/2007,134,0,-2,0,70,10,0,212
Iraq,17/02/2007,146,0,2,0,3,5,0,156
Iraq,18/02/2007,133,0,1,0,36,30,0,200
Iraq,19/02/2007,72,0,-2,0,10,9,0,89
Iraq,20/02/2007,97,2,0,0,21,13,0,133
Iraq,21/02/2007,30,4,0,0,47,14,0,95
Iraq,22/02/2007,111,0,6,0,57,32,0,206
Iraq,23/02/2007,142,10,-7,0,112,38,0,295
Iraq,24/02/2007,93,18,6,0,45,7,0,169
Iraq,25/02/2007,102,0,0,0,-3,7,0,106
Iraq,26/02/2007,99,12,2,0,18,10,0,141
Iraq,27/02/2007,90,28,-4,0,11,11,0,136
Iraq,28/02/2007,28,4,3,0,24,20,0,79
Morocco,01/02/2007,7,0,0,0,0,2,0,9
Morocco,02/02/2007,5,0,0,0,18,1,0,24
Morocco,03/02/2007,0,0,0,0,3,0,0,3
Morocco,05/02/2007,3,0,0,0,26,0,0,29
Morocco,06/02/2007,0,0,0,0,3,0,0,3
Morocco,07/02/2007,2,0,0,0,3,0,0,5
Morocco,08/02/2007,2,0,0,0,0,0,0,2
Morocco,09/02/2007,0,0,0,0,3,0,0,3
Morocco,10/02/2007,0,0,0,0,0,0,0,0
Morocco,11/02/2007,0,0,0,0,0,0,0,0
Morocco,12/02/2007,4,0,0,0,30,6,0,40
Morocco,13/02/2007,6,0,0,0,12,0,0,18
Morocco,14/02/2007,6,0,0,0,31,0,0,37
Morocco,15/02/2007,17,0,0,0,34,1,0,52
Morocco,16/02/2007,77,0,3,0,34,2,0,116
Morocco,17/02/2007,24,0,0,0,-2,0,0,22
Morocco,18/02/2007,-1,0,0,0,9,0,0,8
Morocco,19/02/2007,15,0,0,0,6,0,0,21
Morocco,20/02/2007,6,0,0,0,3,0,0,9
Morocco,21/02/2007,3,0,0,0,9,0,0,12
Morocco,22/02/2007,2,0,-2,0,9,0,0,9
Morocco,23/02/2007,19,0,0,0,6,0,0,25
Morocco,24/02/2007,2,0,0,0,0,0,0,2
Morocco,25/02/2007,0,0,0,0,3,0,0,3
Morocco,26/02/2007,2,0,0,0,0,0,0,2
Morocco,28/02/2007,11,0,0,0,0,0,0,11
Nigeria,01/02/2007,0,0,0,0,-6,0,0,-6
Nigeria,02/02/2007,7,0,0,0,9,2,0,18
Nigeria,03/02/2007,3,0,0,0,0,0,0,3
Nigeria,04/02/2007,19,0,0,0,30,2,0,51
Nigeria,05/02/2007,38,0,0,0,6,10,0,54
Nigeria,06/02/2007,7,0,0,0,0,0,0,7
Nigeria,07/02/2007,7,0,0,0,21,6,0,34
Nigeria,08/02/2007,4,0,0,0,6,2,0,12
Nigeria,09/02/2007,18,0,0,0,0,0,0,18
Nigeria,10/02/2007,0,0,0,0,0,0,0,0
Nigeria,11/02/2007,-5,0,0,0,0,0,0,-5
Nigeria,12/02/2007,-2,0,0,0,0,0,0,-2
Nigeria,13/02/2007,13,0,0,0,-4,0,0,9
Nigeria,14/02/2007,4,0,0,0,9,1,0,14
Nigeria,15/02/2007,0,0,0,0,-10,0,0,-10
Nigeria,16/02/2007,5,0,0,0,12,0,0,17
Nigeria,17/02/2007,4,0,0,0,-8,0,0,-4
Nigeria,18/02/2007,16,0,0,0,3,8,0,27
Nigeria,19/02/2007,11,0,0,0,7,1,0,19
Nigeria,20/02/2007,9,0,0,0,3,2,0,14
Nigeria,21/02/2007,19,0,1,0,-6,3,0,17
Nigeria,22/02/2007,4,0,0,0,0,0,0,4
Nigeria,23/02/2007,48,0,0,0,18,8,0,74
Nigeria,24/02/2007,6,0,0,0,0,0,0,6
Nigeria,25/02/2007,9,0,0,0,0,0,0,9
Nigeria,26/02/2007,10,0,0,0,0,2,0,12
Nigeria,27/02/2007,6,0,0,0,0,0,0,6
Nigeria,28/02/2007,11,0,0,0,9,0,0,20
Pakistan,01/02/2007,46,0,0,0,16,6,0,68
Pakistan,02/02/2007,73,0,0,0,49,0,0,122
Pakistan,03/02/2007,16,0,0,0,39,0,0,55
Pakistan,04/02/2007,56,0,0,0,48,3,0,107
Pakistan,05/02/2007,13,0,1,0,3,6,0,23
Pakistan,06/02/2007,-2,0,0,0,4,11,0,13
Pakistan,07/02/2007,23,0,0,0,3,4,0,30
Pakistan,08/02/2007,36,0,0,0,3,1,0,40
Pakistan,09/02/2007,33,4,-9,0,21,0,0,49
Pakistan,10/02/2007,22,0,0,0,3,2,0,27
Pakistan,11/02/2007,24,0,0,0,-6,1,0,19
Pakistan,12/02/2007,52,2,0,0,6,0,0,60
Pakistan,13/02/2007,17,0,-2,0,3,4,0,22
Pakistan,14/02/2007,47,0,0,0,12,5,0,64
Pakistan,15/02/2007,57,0,-2,0,15,5,0,75
Pakistan,16/02/2007,24,0,0,0,18,3,0,45
Pakistan,17/02/2007,13,0,0,0,18,19,0,50
Pakistan,18/02/2007,12,0,-4,0,3,3,0,14
Pakistan,19/02/2007,83,0,0,0,11,9,0,103
Pakistan,20/02/2007,32,0,0,0,12,10,0,54
Pakistan,21/02/2007,4,0,-4,0,14,3,0,17
Pakistan,22/02/2007,10,0,-2,0,10,3,0,21
Pakistan,23/02/2007,20,0,1,0,6,1,0,28
Pakistan,24/02/2007,14,0,0,0,15,3,0,32
Pakistan,25/02/2007,-1,0,0,0,3,3,0,5
Pakistan,26/02/2007,27,0,0,0,3,0,0,30
Pakistan,27/02/2007,63,2,-2,0,28,8,0,99
Pakistan,28/02/2007,44,2,2,0,58,10,0,116
Sierra Leone,05/02/2007,0,0,0,0,0,0,0,0
Sierra Leone,06/02/2007,2,0,0,0,0,0,0,2
Sierra Leone,07/02/2007,2,0,0,0,0,0,0,2
Sierra Leone,08/02/2007,0,0,0,0,0,0,0,0
Sierra Leone,10/02/2007,3,0,0,0,0,0,0,3
Sierra Leone,11/02/2007,3,0,0,0,0,0,0,3
Sierra Leone,13/02/2007,0,0,0,0,0,0,0,0
Sierra Leone,14/02/2007,12,2,0,0,0,0,0,14
Sierra Leone,15/02/2007,8,0,0,0,0,2,0,10
Sierra Leone,17/02/2007,12,0,0,0,0,1,0,13
Sierra Leone,19/02/2007,0,0,0,0,0,0,0,0
Sierra Leone,20/02/2007,4,0,0,0,0,0,0,4
Sierra Leone,21/02/2007,2,0,0,0,0,0,0,2
Sierra Leone,22/02/2007,0,0,0,0,0,0,0,0
Sierra Leone,23/02/2007,7,0,0,0,0,0,0,7
Sierra Leone,24/02/2007,0,0,0,0,0,0,0,0
Sierra Leone,25/02/2007,8,0,0,0,0,0,0,8
Sierra Leone,26/02/2007,0,0,0,0,0,0,0,0
Sierra Leone,27/02/2007,0,0,0,0,0,0,0,0
Sierra Leone,28/02/2007,-2,0,0,0,0,0,0,-2
Somalia,01/02/2007,6,0,0,0,2,0,0,8
Somalia,02/02/2007,7,0,0,0,26,1,0,34
Somalia,03/02/2007,4,0,0,0,12,0,0,16
Somalia,04/02/2007,9,0,0,0,6,0,0,15
Somalia,05/02/2007,3,0,1,0,22,0,0,26
Somalia,06/02/2007,5,0,-1,0,3,4,0,11
Somalia,07/02/2007,6,0,0,0,0,1,0,7
Somalia,08/02/2007,6,0,0,0,-14,0,0,-8
Somalia,09/02/2007,2,0,0,0,0,0,0,2
Somalia,10/02/2007,0,0,0,0,-2,0,0,-2
Somalia,11/02/2007,0,0,0,0,0,3,0,3
Somalia,12/02/2007,8,0,0,0,0,4,0,12
Somalia,13/02/2007,72,2,0,0,23,14,0,111
Somalia,14/02/2007,20,0,0,0,3,5,0,28
Somalia,15/02/2007,19,0,0,0,6,3,0,28
Somalia,16/02/2007,15,0,0,0,0,1,0,16
Somalia,17/02/2007,4,0,0,0,0,0,0,4
Somalia,18/02/2007,0,0,0,0,6,0,0,6
Somalia,19/02/2007,3,0,0,0,0,0,0,3
Somalia,20/02/2007,2,0,0,0,6,4,0,12
Somalia,21/02/2007,13,0,0,0,0,1,0,14
Somalia,22/02/2007,0,0,0,0,0,0,0,0
Somalia,23/02/2007,0,0,0,0,0,0,0,0
Somalia,24/02/2007,3,0,0,0,3,0,0,6
Somalia,25/02/2007,12,4,0,0,6,0,0,22
Somalia,26/02/2007,-1,0,0,0,0,0,0,-1
Somalia,27/02/2007,12,0,0,0,-2,4,0,14
Somalia,28/02/2007,6,0,0,0,0,1,0,7
Syria,01/02/2007,0,0,0,0,12,0,0,12
Syria,02/02/2007,32,0,0,0,2,0,0,34
Syria,03/02/2007,30,0,-2,0,2,6,0,36
Syria,04/02/2007,10,0,0,0,15,0,0,25
Syria,05/02/2007,17,0,-4,0,6,0,0,19
Syria,06/02/2007,40,0,0,0,7,0,0,47
Syria,07/02/2007,26,2,0,0,12,0,0,40
Syria,08/02/2007,9,0,0,0,18,8,0,35
Syria,09/02/2007,20,0,0,0,0,6,0,26
Syria,10/02/2007,11,0,0,0,12,1,0,24
Syria,11/02/2007,3,0,0,0,26,21,0,50
Syria,12/02/2007,7,0,0,0,18,2,0,27
Syria,13/02/2007,26,0,-2,0,17,21,0,62
Syria,14/02/2007,37,0,0,0,15,0,0,52
Syria,15/02/2007,37,0,0,0,44,3,0,84
Syria,16/02/2007,20,0,0,0,29,4,0,53
Syria,17/02/2007,29,0,1,0,30,0,0,60
Syria,18/02/2007,8,0,1,0,0,0,0,9
Syria,19/02/2007,19,0,0,0,6,2,0,27
Syria,20/02/2007,29,0,0,0,1,0,0,30
Syria,21/02/2007,9,0,0,0,2,0,0,11
Syria,22/02/2007,8,0,0,0,2,0,0,10
Syria,23/02/2007,29,0,0,0,12,0,0,41
Syria,24/02/2007,11,0,0,0,7,0,0,18
Syria,25/02/2007,6,0,0,0,0,0,0,6
Syria,26/02/2007,0,0,0,0,6,6,0,12
Syria,27/02/2007,8,0,-6,0,12,1,0,15
Syria,28/02/2007,22,0,0,0,12,6,0,40
Yemen,01/02/2007,24,0,0,0,0,0,0,24
Yemen,02/02/2007,1,0,0,0,3,0,0,4
Yemen,03/02/2007,0,0,0,0,0,4,0,4
Yemen,04/02/2007,1,0,0,0,0,7,0,8
Yemen,05/02/2007,35,0,5,0,-10,3,0,33
Yemen,06/02/2007,3,0,0,0,4,0,0,7
Yemen,07/02/2007,11,0,0,0,3,0,0,14
Yemen,08/02/2007,6,0,0,0,0,0,0,6
Yemen,09/02/2007,0,0,0,0,9,0,0,9
Yemen,10/02/2007,3,0,0,0,0,0,0,3
Yemen,11/02/2007,-1,0,0,0,0,0,0,-1
Yemen,12/02/2007,24,0,0,0,0,0,0,24
Yemen,13/02/2007,43,0,0,0,0,0,0,43
Yemen,14/02/2007,23,0,0,0,0,0,0,23
Yemen,15/02/2007,0,0,0,0,0,0,0,0
Yemen,16/02/2007,3,0,0,0,0,0,0,3
Yemen,17/02/2007,0,0,0,0,0,0,0,0
Yemen,18/02/2007,0,0,0,0,0,0,0,0
Yemen,19/02/2007,35,4,0,0,0,0,0,39
Yemen,20/02/2007,27,0,0,0,0,8,0,35
Yemen,21/02/2007,24,0,0,0,3,0,0,27
Yemen,22/02/2007,0,0,0,0,-4,0,0,-4
Yemen,23/02/2007,0,0,0,0,0,0,0,0
Yemen,24/02/2007,0,0,0,0,0,0,0,0
Yemen,25/02/2007,0,0,0,0,0,0,0,0
Yemen,26/02/2007,0,0,0,0,0,0,0,0
Yemen,27/02/2007,7,2,0,0,0,0,0,9
Yemen,28/02/2007,7,0,0,0,6,2,0,15
Afghanistan,01/03/2007,83,0,-4,0,39,6,0,124
Afghanistan,02/03/2007,28,0,-4,0,103,13,0,140
Afghanistan,03/03/2007,77,0,2,0,29,33,0,141
Afghanistan,04/03/2007,43,0,-2,0,-11,4,0,34
Afghanistan,05/03/2007,53,0,2,0,6,3,0,64
Afghanistan,06/03/2007,181,0,0,0,37,26,0,244
Afghanistan,07/03/2007,82,0,0,0,25,9,0,116
Afghanistan,08/03/2007,88,0,-4,0,43,6,0,133
Afghanistan,09/03/2007,120,0,-2,0,20,11,0,149
Afghanistan,10/03/2007,80,0,0,0,42,5,0,127
Afghanistan,11/03/2007,32,8,0,0,5,11,0,56
Afghanistan,12/03/2007,88,0,1,0,19,8,0,116
Afghanistan,13/03/2007,48,0,0,0,54,3,0,105
Afghanistan,14/03/2007,64,0,0,0,27,1,0,92
Afghanistan,15/03/2007,76,0,1,0,47,16,0,140
Afghanistan,16/03/2007,52,0,0,0,40,8,0,100
Afghanistan,17/03/2007,104,0,0,0,31,24,0,159
Afghanistan,18/03/2007,27,0,0,0,-10,13,0,30
Afghanistan,19/03/2007,78,0,-2,0,-48,10,0,38
Afghanistan,20/03/2007,169,0,0,0,9,9,0,187
Afghanistan,21/03/2007,156,0,0,0,12,18,0,186
Afghanistan,22/03/2007,131,0,0,0,-28,4,0,107
Afghanistan,23/03/2007,160,0,0,0,15,13,0,188
Afghanistan,24/03/2007,114,2,1,0,33,7,0,157
Afghanistan,25/03/2007,42,6,0,0,1,4,0,53
Afghanistan,26/03/2007,150,0,1,0,56,24,0,231
Afghanistan,27/03/2007,145,4,1,0,67,19,0,236
Afghanistan,28/03/2007,104,2,0,0,78,14,0,198
Afghanistan,29/03/2007,131,0,-4,0,53,3,0,183
Afghanistan,30/03/2007,105,0,-2,0,60,5,0,168
Afghanistan,31/03/2007,41,0,0,0,35,0,0,76
Albania,01/03/2007,5,0,-1,0,0,0,0,4
Albania,02/03/2007,5,0,-1,0,6,0,0,10
Albania,03/03/2007,14,0,-2,0,0,4,0,16
Albania,04/03/2007,48,0,0,0,20,1,0,69
Albania,05/03/2007,9,0,-4,0,35,1,0,41
Albania,06/03/2007,2,0,-6,0,15,0,0,11
Albania,07/03/2007,10,0,0,0,3,0,0,13
Albania,08/03/2007,12,0,-2,0,3,4,0,17
Albania,09/03/2007,14,0,-2,0,12,0,0,24
Albania,10/03/2007,11,0,-3,0,36,0,0,44
Albania,11/03/2007,39,0,-3,0,3,0,0,39
Albania,12/03/2007,44,0,0,0,10,2,0,56
Albania,13/03/2007,2,0,0,0,0,1,0,3
Albania,14/03/2007,7,0,0,0,0,2,0,9
Albania,15/03/2007,11,0,0,0,1,2,0,14
Albania,16/03/2007,8,0,-2,0,0,0,0,6
Albania,17/03/2007,21,0,0,0,0,0,0,21
Albania,18/03/2007,6,0,0,0,9,2,0,17
Albania,19/03/2007,29,0,0,0,0,1,0,30
Albania,20/03/2007,18,0,-2,0,3,0,0,19
Albania,21/03/2007,13,0,0,0,0,0,0,13
Albania,22/03/2007,28,0,0,0,3,1,0,32
Albania,23/03/2007,31,0,-4,0,28,1,0,56
Albania,24/03/2007,16,0,0,0,0,0,0,16
Albania,25/03/2007,44,0,0,0,6,0,0,50
Albania,26/03/2007,53,0,-10,0,7,0,0,50
Albania,27/03/2007,13,0,0,0,0,0,0,13
Albania,28/03/2007,28,0,0,0,3,3,0,34
Albania,29/03/2007,17,0,0,0,0,6,0,23
Albania,30/03/2007,17,0,-2,0,12,0,0,27
Albania,31/03/2007,5,0,-4,0,-2,2,0,1
Algeria,01/03/2007,0,0,0,0,18,0,0,18
Algeria,02/03/2007,0,0,0,0,0,0,0,0
Algeria,03/03/2007,2,0,0,0,24,0,0,26
Algeria,04/03/2007,10,0,0,0,6,3,0,19
Algeria,05/03/2007,9,0,0,0,18,0,0,27
Algeria,06/03/2007,22,0,0,0,6,0,0,28
Algeria,07/03/2007,0,0,0,0,3,0,0,3
Algeria,08/03/2007,0,0,0,0,3,0,0,3
Algeria,09/03/2007,0,0,0,0,6,0,0,6
Algeria,10/03/2007,-1,0,0,0,0,2,0,1
Algeria,11/03/2007,0,0,0,0,0,0,0,0
Algeria,12/03/2007,32,0,0,0,0,15,0,47
Algeria,13/03/2007,0,0,-1,0,0,0,0,-1
Algeria,14/03/2007,0,0,-4,0,0,0,0,-4
Algeria,15/03/2007,5,0,0,0,6,8,0,19
Algeria,16/03/2007,-8,0,0,0,0,0,0,-8
Algeria,17/03/2007,-4,0,0,0,0,0,0,-4
Algeria,18/03/2007,0,0,0,0,0,0,0,0
Algeria,19/03/2007,-2,0,0,0,-2,0,0,-4
Algeria,20/03/2007,2,0,-2,0,0,0,0,0
Algeria,21/03/2007,1,0,0,0,48,4,0,53
Algeria,22/03/2007,3,0,0,0,0,1,0,4
Algeria,23/03/2007,3,0,0,0,12,0,0,15
Algeria,24/03/2007,3,0,0,0,0,0,0,3
Algeria,25/03/2007,0,0,0,0,0,0,0,0
Algeria,26/03/2007,21,0,0,0,9,0,0,30
Algeria,27/03/2007,2,0,0,0,12,2,0,16
Algeria,28/03/2007,3,0,0,0,0,0,0,3
Algeria,29/03/2007,4,0,0,0,3,0,0,7
Algeria,30/03/2007,3,0,0,0,0,0,0,3
Algeria,31/03/2007,0,0,0,0,0,3,0,3
Bangladesh,01/03/2007,0,0,0,0,0,0,0,0
Bangladesh,02/03/2007,0,0,0,0,6,0,0,6
Bangladesh,03/03/2007,0,0,1,0,0,0,0,1
Bangladesh,04/03/2007,0,0,-4,0,0,0,0,-4
Bangladesh,05/03/2007,0,0,2,0,12,0,0,14
Bangladesh,06/03/2007,42,0,0,0,30,0,0,72
Bangladesh,07/03/2007,9,0,0,0,4,2,0,15
Bangladesh,08/03/2007,5,0,4,0,12,0,0,21
Bangladesh,09/03/2007,2,0,-5,0,9,0,0,6
Bangladesh,10/03/2007,3,0,0,0,18,0,0,21
Bangladesh,11/03/2007,0,0,0,0,4,0,0,4
Bangladesh,12/03/2007,4,0,0,0,0,0,0,4
Bangladesh,13/03/2007,9,0,0,0,0,1,0,10
Bangladesh,14/03/2007,1,0,0,0,6,0,0,7
Bangladesh,15/03/2007,10,0,0,0,9,0,0,19
Bangladesh,16/03/2007,9,0,-10,0,3,1,0,3
Bangladesh,17/03/2007,12,0,0,0,6,0,0,18
Bangladesh,18/03/2007,1,0,0,0,12,0,0,13
Bangladesh,19/03/2007,-1,0,0,0,0,0,0,-1
Bangladesh,20/03/2007,-2,0,0,0,-1,0,0,-3
Bangladesh,21/03/2007,15,0,0,0,27,0,0,42
Bangladesh,22/03/2007,9,0,-4,0,-2,0,0,3
Bangladesh,23/03/2007,0,0,0,0,0,0,0,0
Bangladesh,24/03/2007,16,0,0,0,4,0,0,20
Bangladesh,25/03/2007,6,0,0,0,0,0,0,6
Bangladesh,26/03/2007,1,0,-3,0,-1,5,0,2
Bangladesh,27/03/2007,2,0,0,0,3,0,0,5
Bangladesh,28/03/2007,9,0,0,0,6,1,0,16
Bangladesh,29/03/2007,4,0,0,0,12,3,0,19
Bangladesh,30/03/2007,20,0,0,0,21,0,0,41
Bangladesh,31/03/2007,15,0,0,0,15,0,0,30
Cameroon,01/03/2007,6,0,0,0,0,0,0,6
Cameroon,02/03/2007,0,0,0,0,3,0,0,3
Cameroon,03/03/2007,6,0,0,0,0,0,0,6
Cameroon,10/03/2007,0,0,0,0,9,0,0,9
Cameroon,12/03/2007,0,0,0,0,0,0,0,0
Cameroon,13/03/2007,0,0,0,0,0,0,0,0
Cameroon,16/03/2007,0,0,0,0,0,0,0,0
Cameroon,20/03/2007,2,0,0,0,3,0,0,5
Cameroon,21/03/2007,4,0,0,0,15,0,0,19
Cameroon,23/03/2007,0,0,0,0,0,0,0,0
Cameroon,24/03/2007,0,0,0,0,0,0,0,0
Cameroon,26/03/2007,0,0,0,0,0,0,0,0
Cameroon,27/03/2007,0,0,0,0,0,0,0,0
Cameroon,29/03/2007,0,0,0,0,0,0,0,0
Cameroon,30/03/2007,0,0,0,0,0,0,0,0
China,01/03/2007,38,0,-6,0,24,4,0,60
China,02/03/2007,17,2,0,0,2,5,0,26
China,03/03/2007,17,4,0,0,11,1,0,33
China,04/03/2007,5,0,0,0,-6,2,0,1
China,05/03/2007,84,0,0,0,5,2,0,91
China,06/03/2007,74,0,-1,0,33,5,0,111
China,07/03/2007,55,0,-10,0,30,3,0,78
China,08/03/2007,89,2,-4,0,31,24,0,142
China,09/03/2007,56,2,0,0,18,6,0,82
China,10/03/2007,94,0,-7,0,40,7,0,134
China,11/03/2007,9,0,0,0,18,0,0,27
China,12/03/2007,48,0,2,0,27,11,0,88
China,13/03/2007,29,0,3,0,29,6,0,67
China,14/03/2007,64,0,0,0,10,8,0,82
China,15/03/2007,11,0,-3,0,7,3,0,18
China,16/03/2007,-24,0,0,0,10,5,0,-9
China,17/03/2007,-24,0,0,0,21,1,0,-2
China,18/03/2007,6,0,-1,0,11,3,0,19
China,19/03/2007,53,0,0,0,13,3,0,69
China,20/03/2007,21,0,-4,0,55,5,0,77
China,21/03/2007,32,0,1,0,16,12,0,61
China,22/03/2007,-2,2,-2,0,7,6,0,11
China,23/03/2007,42,2,-5,0,42,5,0,86
China,24/03/2007,44,0,0,0,24,6,0,74
China,25/03/2007,3,0,0,0,4,0,0,7
China,26/03/2007,69,0,-1,0,26,6,0,100
China,27/03/2007,61,0,-1,0,3,6,0,69
China,28/03/2007,31,6,0,0,39,9,0,85
China,29/03/2007,57,4,3,0,43,8,0,115
China,30/03/2007,70,0,-8,0,25,4,0,91
China,31/03/2007,16,0,0,0,34,0,0,50
Egypt,01/03/2007,2,0,0,0,30,3,0,35
Egypt,02/03/2007,5,0,0,0,30,1,0,36
Egypt,03/03/2007,23,0,0,0,3,2,0,28
Egypt,04/03/2007,18,0,0,0,6,0,0,24
Egypt,05/03/2007,29,0,0,0,7,3,0,39
Egypt,06/03/2007,51,0,1,0,12,4,0,68
Egypt,07/03/2007,11,0,0,0,14,0,0,25
Egypt,08/03/2007,18,0,-2,0,6,2,0,24
Egypt,09/03/2007,5,0,0,0,24,0,0,29
Egypt,10/03/2007,26,0,0,0,-1,0,0,25
Egypt,11/03/2007,4,0,2,0,5,8,0,19
Egypt,12/03/2007,9,0,0,0,1,0,0,10
Egypt,13/03/2007,13,0,1,0,-2,1,0,13
Egypt,14/03/2007,-8,0,0,0,28,2,0,22
Egypt,15/03/2007,8,0,0,0,15,0,0,23
Egypt,16/03/2007,19,0,2,0,16,3,0,40
Egypt,17/03/2007,12,0,0,0,6,6,0,24
Egypt,18/03/2007,22,0,-2,0,0,4,0,24
Egypt,19/03/2007,19,0,-4,0,6,6,0,27
Egypt,20/03/2007,21,0,0,0,7,0,0,28
Egypt,21/03/2007,22,0,1,0,10,5,0,38
Egypt,22/03/2007,12,0,0,0,16,4,0,32
Egypt,23/03/2007,14,0,0,0,2,2,0,18
Egypt,24/03/2007,18,0,-2,0,20,1,0,37
Egypt,25/03/2007,35,4,0,0,-10,5,0,34
Egypt,26/03/2007,28,0,0,0,30,4,0,62
Egypt,27/03/2007,30,0,-4,0,-6,7,0,27
Egypt,28/03/2007,10,0,0,0,0,2,0,12
Egypt,29/03/2007,5,0,0,0,0,0,0,5
Egypt,30/03/2007,1,0,0,0,-5,0,0,-4
Egypt,31/03/2007,12,0,0,0,3,0,0,15
Eritrea,01/03/2007,0,0,0,0,9,0,0,9
Eritrea,02/03/2007,6,0,0,0,0,0,0,6
Eritrea,03/03/2007,16,0,0,0,13,0,0,29
Eritrea,04/03/2007,9,0,0,0,11,3,0,23
Eritrea,05/03/2007,47,0,0,0,5,10,0,62
Eritrea,06/03/2007,0,0,0,0,-2,2,0,0
Eritrea,07/03/2007,11,0,0,0,6,0,0,17
Eritrea,08/03/2007,6,0,-1,0,6,0,0,11
Eritrea,09/03/2007,14,0,0,0,4,0,0,18
Eritrea,10/03/2007,6,0,0,0,6,0,0,12
Eritrea,11/03/2007,4,0,0,0,0,0,0,4
Eritrea,12/03/2007,2,0,0,0,-2,0,0,0
Eritrea,13/03/2007,0,0,0,0,0,0,0,0
Eritrea,14/03/2007,4,0,0,0,-10,0,0,-6
Eritrea,15/03/2007,7,0,0,0,-9,0,0,-2
Eritrea,16/03/2007,0,0,0,0,-2,0,0,-2
Eritrea,17/03/2007,0,0,0,0,0,0,0,0
Eritrea,18/03/2007,4,0,0,0,9,0,0,13
Eritrea,19/03/2007,10,0,0,0,-8,0,0,2
Eritrea,20/03/2007,4,0,0,0,-4,0,0,0
Eritrea,21/03/2007,3,0,0,0,7,2,0,12
Eritrea,22/03/2007,3,0,0,0,9,0,0,12
Eritrea,23/03/2007,0,0,0,0,-8,0,0,-8
Eritrea,24/03/2007,9,0,0,0,0,0,0,9
Eritrea,25/03/2007,0,0,0,0,-2,0,0,-2
Eritrea,26/03/2007,0,0,0,0,-4,0,0,-4
Eritrea,27/03/2007,6,0,0,0,0,0,0,6
Eritrea,28/03/2007,-3,0,0,0,0,0,0,-3
Eritrea,29/03/2007,7,0,0,0,9,0,0,16
Eritrea,30/03/2007,0,0,0,0,-1,0,0,-1
Eritrea,31/03/2007,4,0,0,0,-5,0,0,-1
Georgia,01/03/2007,-3,0,0,0,0,0,0,-3
Georgia,02/03/2007,-1,0,0,0,0,0,0,-1
Georgia,03/03/2007,4,0,0,0,0,0,0,4
Georgia,04/03/2007,12,0,0,0,0,0,0,12
Georgia,05/03/2007,3,0,0,0,6,0,0,9
Georgia,06/03/2007,0,0,0,0,3,0,0,3
Georgia,07/03/2007,5,0,0,0,6,0,0,11
Georgia,08/03/2007,0,0,0,0,0,2,0,2
Georgia,09/03/2007,10,0,0,0,-2,0,0,8
Georgia,10/03/2007,0,0,0,0,0,0,0,0
Georgia,12/03/2007,-1,0,0,0,0,0,0,-1
Georgia,13/03/2007,10,0,0,0,3,0,0,13
Georgia,14/03/2007,-2,0,0,0,17,0,0,15
Georgia,15/03/2007,6,0,0,0,6,0,0,12
Georgia,16/03/2007,9,0,0,0,3,0,0,12
Georgia,17/03/2007,0,0,0,0,0,0,0,0
Georgia,18/03/2007,0,0,1,0,0,0,0,1
Georgia,19/03/2007,3,0,0,0,0,0,0,3
Georgia,20/03/2007,3,0,0,0,4,1,0,8
Georgia,21/03/2007,1,0,0,0,1,0,0,2
Georgia,22/03/2007,4,0,0,0,9,1,0,14
Georgia,23/03/2007,7,0,0,0,3,0,0,10
Georgia,24/03/2007,18,0,0,0,0,0,0,18
Georgia,25/03/2007,6,0,0,0,0,1,0,7
Georgia,26/03/2007,3,0,0,0,0,1,0,4
Georgia,27/03/2007,5,0,0,0,12,0,0,17
Georgia,28/03/2007,-1,0,0,0,3,1,0,3
Georgia,29/03/2007,5,0,0,0,12,2,0,19
Georgia,30/03/2007,3,0,0,0,9,0,0,12
Georgia,31/03/2007,0,0,0,0,0,1,0,1
India,01/03/2007,36,2,0,0,10,3,0,51
India,02/03/2007,3,0,0,0,6,3,0,12
India,03/03/2007,14,0,0,0,0,2,0,16
India,04/03/2007,2,0,0,0,3,0,0,5
India,05/03/2007,8,0,0,0,-4,3,0,7
India,06/03/2007,16,0,0,0,-1,2,0,17
India,07/03/2007,10,0,0,0,20,0,0,30
India,08/03/2007,9,0,-1,0,3,5,0,16
India,09/03/2007,26,0,0,0,27,2,0,55
India,10/03/2007,36,0,0,0,-2,4,0,38
India,11/03/2007,2,0,0,0,-2,1,0,1
India,12/03/2007,3,0,0,0,-5,0,0,-2
India,13/03/2007,11,0,0,0,3,2,0,16
India,14/03/2007,15,0,-1,0,12,4,0,30
India,15/03/2007,9,0,-1,0,3,0,0,11
India,16/03/2007,4,0,0,0,0,1,0,5
India,17/03/2007,6,2,0,0,6,0,0,14
India,18/03/2007,5,8,0,0,6,2,0,21
India,19/03/2007,13,0,0,0,-7,6,0,12
India,20/03/2007,6,0,0,0,1,0,0,7
India,21/03/2007,33,0,0,0,12,2,0,47
India,22/03/2007,24,4,0,0,20,3,0,51
India,23/03/2007,35,0,-8,0,6,4,0,37
India,24/03/2007,30,4,0,0,16,8,0,58
India,25/03/2007,6,0,-2,0,7,1,0,12
India,26/03/2007,17,4,-2,0,14,9,0,42
India,27/03/2007,17,2,-3,0,-6,7,0,17
India,28/03/2007,21,0,0,0,3,13,0,37
India,29/03/2007,20,0,0,0,4,4,0,28
India,30/03/2007,17,0,1,0,8,0,0,26
India,31/03/2007,3,0,0,0,0,0,0,3
Iran,01/03/2007,98,0,-1,0,30,12,0,139
Iran,02/03/2007,38,0,1,0,6,3,0,48
Iran,03/03/2007,23,0,0,0,3,1,0,27
Iran,04/03/2007,46,0,0,0,35,8,0,89
Iran,05/03/2007,53,0,0,0,-2,3,0,54
Iran,06/03/2007,51,0,0,0,34,9,0,94
Iran,07/03/2007,24,0,0,0,66,24,0,114
Iran,08/03/2007,26,0,-2,0,46,9,0,79
Iran,09/03/2007,109,4,0,0,21,7,0,141
Iran,10/03/2007,41,0,0,0,14,2,0,57
Iran,11/03/2007,40,0,0,0,23,8,0,71
Iran,12/03/2007,39,0,-4,0,37,2,0,74
Iran,13/03/2007,32,0,4,0,15,5,0,56
Iran,14/03/2007,79,0,-2,0,-3,14,0,88
Iran,15/03/2007,94,0,-2,0,10,13,0,115
Iran,16/03/2007,42,6,0,0,18,4,0,70
Iran,17/03/2007,18,4,0,0,-2,6,0,26
Iran,18/03/2007,33,0,1,0,6,2,0,42
Iran,19/03/2007,37,0,0,0,36,4,0,77
Iran,20/03/2007,34,0,4,0,27,2,0,67
Iran,21/03/2007,68,0,0,0,54,8,0,130
Iran,22/03/2007,36,0,-2,0,12,14,0,60
Iran,23/03/2007,57,0,-4,0,20,4,0,77
Iran,24/03/2007,49,0,4,0,35,7,0,95
Iran,25/03/2007,115,0,0,0,46,5,0,166
Iran,26/03/2007,137,0,2,0,32,6,0,177
Iran,27/03/2007,84,2,3,0,40,3,0,132
Iran,28/03/2007,197,0,2,0,63,11,0,273
Iran,29/03/2007,124,12,-5,0,63,19,0,213
Iran,30/03/2007,137,0,3,0,21,6,0,167
Iran,31/03/2007,28,0,-1,0,18,0,0,45
Iraq,01/03/2007,87,2,2,0,10,10,0,111
Iraq,02/03/2007,73,0,-2,0,18,2,0,91
Iraq,03/03/2007,60,0,-8,0,38,15,0,105
Iraq,04/03/2007,49,8,0,0,21,12,0,90
Iraq,05/03/2007,44,0,2,0,29,2,0,77
Iraq,06/03/2007,132,0,1,0,98,24,0,255
Iraq,07/03/2007,126,0,-10,0,90,15,0,221
Iraq,08/03/2007,59,0,0,0,42,12,0,113
Iraq,09/03/2007,53,4,-4,0,10,11,0,74
Iraq,10/03/2007,104,4,-4,0,9,10,0,123
Iraq,11/03/2007,88,0,-4,0,4,9,0,97
Iraq,12/03/2007,65,2,-2,0,30,10,0,105
Iraq,13/03/2007,110,4,-2,0,60,15,0,187
Iraq,14/03/2007,14,0,-2,0,55,10,0,77
Iraq,15/03/2007,104,0,-5,0,33,9,0,141
Iraq,16/03/2007,89,12,0,0,29,29,0,159
Iraq,17/03/2007,90,4,-2,0,82,31,0,205
Iraq,18/03/2007,94,2,1,0,47,46,0,190
Iraq,19/03/2007,118,2,1,0,66,60,0,247
Iraq,20/03/2007,200,2,-3,0,88,17,0,304
Iraq,21/03/2007,142,2,-7,0,29,4,0,170
Iraq,22/03/2007,167,0,-2,0,16,14,0,195
Iraq,23/03/2007,162,2,-1,0,93,20,0,276
Iraq,24/03/2007,109,2,2,0,66,15,0,194
Iraq,25/03/2007,82,2,2,0,97,13,0,196
Iraq,26/03/2007,116,0,-4,0,93,13,0,218
Iraq,27/03/2007,106,6,2,0,89,3,0,206
Iraq,28/03/2007,153,2,4,0,59,17,0,235
Iraq,29/03/2007,192,0,2,0,107,23,0,324
Iraq,30/03/2007,100,0,-8,0,27,3,0,122
Iraq,31/03/2007,64,0,-11,0,9,2,0,64
Morocco,01/03/2007,3,0,0,0,13,0,0,16
Morocco,02/03/2007,21,0,0,0,27,0,0,48
Morocco,03/03/2007,6,0,0,0,6,3,0,15
Morocco,04/03/2007,2,0,0,0,0,0,0,2
Morocco,05/03/2007,3,0,0,0,6,0,0,9
Morocco,06/03/2007,0,0,0,0,3,0,0,3
Morocco,07/03/2007,4,0,0,0,0,0,0,4
Morocco,08/03/2007,0,0,0,0,0,1,0,1
Morocco,10/03/2007,0,0,0,0,-2,0,0,-2
Morocco,11/03/2007,-2,0,0,0,0,0,0,-2
Morocco,12/03/2007,0,0,0,0,0,12,0,12
Morocco,13/03/2007,10,0,0,0,6,6,0,22
Morocco,14/03/2007,3,0,0,0,0,0,0,3
Morocco,15/03/2007,3,0,0,0,6,0,0,9
Morocco,16/03/2007,2,0,0,0,0,0,0,2
Morocco,17/03/2007,3,0,0,0,0,0,0,3
Morocco,18/03/2007,0,0,0,0,0,0,0,0
Morocco,19/03/2007,0,0,0,0,0,0,0,0
Morocco,20/03/2007,-2,0,0,0,6,0,0,4
Morocco,21/03/2007,3,0,0,0,0,6,0,9
Morocco,22/03/2007,-10,0,0,0,18,12,0,20
Morocco,23/03/2007,2,0,0,0,0,0,0,2
Morocco,24/03/2007,0,0,0,0,0,0,0,0
Morocco,25/03/2007,0,0,0,0,0,1,0,1
Morocco,26/03/2007,0,0,0,0,0,2,0,2
Morocco,27/03/2007,3,0,0,0,3,0,0,6
Morocco,28/03/2007,0,0,0,0,0,0,0,0
Morocco,29/03/2007,8,0,0,0,6,0,0,14
Morocco,30/03/2007,18,0,0,0,-4,2,0,16
Morocco,31/03/2007,0,0,0,0,0,0,0,0
Nigeria,01/03/2007,9,2,0,0,16,0,0,27
Nigeria,02/03/2007,16,0,0,0,4,2,0,22
Nigeria,03/03/2007,3,0,0,0,3,0,0,6
Nigeria,04/03/2007,0,0,0,0,6,0,0,6
Nigeria,05/03/2007,4,0,0,0,0,0,0,4
Nigeria,06/03/2007,39,0,0,0,10,10,0,59
Nigeria,07/03/2007,9,0,0,0,10,3,0,22
Nigeria,08/03/2007,15,0,-1,0,0,0,0,14
Nigeria,09/03/2007,0,0,0,0,6,1,0,7
Nigeria,10/03/2007,16,0,0,0,36,0,0,52
Nigeria,11/03/2007,5,0,0,0,0,0,0,5
Nigeria,12/03/2007,0,0,0,0,-4,0,0,-4
Nigeria,13/03/2007,-1,0,0,0,0,0,0,-1
Nigeria,14/03/2007,5,0,0,0,19,0,0,24
Nigeria,15/03/2007,17,0,0,0,9,0,0,26
Nigeria,16/03/2007,3,0,0,0,-4,2,0,1
Nigeria,17/03/2007,0,0,0,0,3,0,0,3
Nigeria,18/03/2007,1,0,0,0,0,0,0,1
Nigeria,19/03/2007,-2,0,0,0,-2,0,0,-4
Nigeria,20/03/2007,9,0,0,0,24,0,0,33
Nigeria,21/03/2007,8,0,0,0,-2,0,0,6
Nigeria,22/03/2007,11,0,-6,0,20,1,0,26
Nigeria,23/03/2007,3,0,0,0,3,0,0,6
Nigeria,24/03/2007,-3,0,0,0,-4,0,0,-7
Nigeria,25/03/2007,-2,0,0,0,0,4,0,2
Nigeria,26/03/2007,-1,0,0,0,24,2,0,25
Nigeria,27/03/2007,17,0,0,0,9,0,0,26
Nigeria,28/03/2007,18,0,-6,0,10,0,0,22
Nigeria,29/03/2007,1,0,0,0,0,0,0,1
Nigeria,30/03/2007,3,0,-1,0,1,0,0,3
Nigeria,31/03/2007,0,0,0,0,0,0,0,0
Pakistan,01/03/2007,26,0,0,0,16,1,0,43
Pakistan,02/03/2007,55,0,0,0,4,6,0,65
Pakistan,03/03/2007,34,0,1,0,11,5,0,51
Pakistan,04/03/2007,7,0,0,0,3,4,0,14
Pakistan,05/03/2007,4,0,0,0,19,7,0,30
Pakistan,06/03/2007,59,0,0,0,21,0,0,80
Pakistan,07/03/2007,9,0,0,0,51,3,0,63
Pakistan,08/03/2007,54,0,0,0,69,1,0,124
Pakistan,09/03/2007,34,0,-4,0,31,1,0,62
Pakistan,10/03/2007,48,0,-2,0,51,4,0,101
Pakistan,11/03/2007,34,0,0,0,12,0,0,46
Pakistan,12/03/2007,35,0,0,0,4,3,0,42
Pakistan,13/03/2007,54,0,1,0,13,16,0,84
Pakistan,14/03/2007,56,0,0,0,18,8,0,82
Pakistan,15/03/2007,36,0,1,0,35,18,0,90
Pakistan,16/03/2007,41,0,0,0,44,7,0,92
Pakistan,17/03/2007,30,0,0,0,16,3,0,49
Pakistan,18/03/2007,15,0,0,0,3,0,0,18
Pakistan,19/03/2007,18,0,0,0,21,4,0,43
Pakistan,20/03/2007,54,0,3,0,11,5,0,73
Pakistan,21/03/2007,19,0,0,0,2,8,0,29
Pakistan,22/03/2007,58,0,-2,0,36,10,0,102
Pakistan,23/03/2007,40,0,0,0,13,7,0,60
Pakistan,24/03/2007,51,0,0,0,54,1,0,106
Pakistan,25/03/2007,56,0,0,0,9,7,0,72
Pakistan,26/03/2007,35,0,-1,0,62,9,0,105
Pakistan,27/03/2007,133,0,-2,0,36,16,0,183
Pakistan,28/03/2007,56,0,-2,0,30,55,0,139
Pakistan,29/03/2007,63,0,1,0,45,14,0,123
Pakistan,30/03/2007,55,0,-1,0,21,3,0,78
Pakistan,31/03/2007,24,0,0,0,2,1,0,27
Sierra Leone,01/03/2007,0,0,0,0,0,0,0,0
Sierra Leone,02/03/2007,3,0,0,0,0,0,0,3
Sierra Leone,03/03/2007,0,0,0,0,0,0,0,0
Sierra Leone,04/03/2007,0,0,0,0,0,0,0,0
Sierra Leone,05/03/2007,0,0,0,0,0,0,0,0
Sierra Leone,06/03/2007,0,0,0,0,0,0,0,0
Sierra Leone,08/03/2007,9,0,0,0,3,1,0,13
Sierra Leone,11/03/2007,0,0,0,0,0,0,0,0
Sierra Leone,12/03/2007,0,0,0,0,0,0,0,0
Sierra Leone,20/03/2007,0,0,0,0,0,0,0,0
Sierra Leone,22/03/2007,0,0,0,0,3,4,0,7
Sierra Leone,23/03/2007,0,0,0,0,0,0,0,0
Sierra Leone,26/03/2007,0,0,0,0,0,0,0,0
Sierra Leone,27/03/2007,0,0,0,0,11,4,0,15
Sierra Leone,29/03/2007,0,0,0,0,0,0,0,0
Sierra Leone,30/03/2007,1,0,0,0,0,0,0,1
Somalia,01/03/2007,0,0,0,0,0,1,0,1
Somalia,02/03/2007,11,0,0,0,0,0,0,11
Somalia,03/03/2007,-1,0,0,0,0,0,0,-1
Somalia,04/03/2007,2,0,0,0,3,0,0,5
Somalia,05/03/2007,0,0,0,0,0,0,0,0
Somalia,06/03/2007,13,0,0,0,0,2,0,15
Somalia,07/03/2007,1,0,0,0,0,0,0,1
Somalia,08/03/2007,1,0,0,0,0,0,0,1
Somalia,09/03/2007,0,0,0,0,0,0,0,0
Somalia,10/03/2007,10,0,0,0,3,0,0,13
Somalia,11/03/2007,4,0,0,0,0,0,0,4
Somalia,12/03/2007,3,4,0,0,0,0,0,7
Somalia,13/03/2007,0,0,0,0,6,0,0,6
Somalia,14/03/2007,8,0,0,0,0,0,0,8
Somalia,15/03/2007,3,0,0,0,0,0,0,3
Somalia,16/03/2007,14,0,0,0,6,0,0,20
Somalia,17/03/2007,1,0,0,0,0,0,0,1
Somalia,18/03/2007,3,0,0,0,0,0,0,3
Somalia,19/03/2007,9,0,0,0,1,1,0,11
Somalia,20/03/2007,8,0,0,0,10,1,0,19
Somalia,21/03/2007,1,0,0,0,4,1,0,6
Somalia,22/03/2007,23,0,0,0,0,6,0,29
Somalia,23/03/2007,17,0,0,0,6,0,0,23
Somalia,24/03/2007,3,0,0,0,15,1,0,19
Somalia,25/03/2007,2,0,0,0,0,6,0,8
Somalia,26/03/2007,21,0,0,0,15,0,0,36
Somalia,27/03/2007,14,0,0,0,3,6,0,23
Somalia,28/03/2007,0,0,0,0,6,0,0,6
Somalia,29/03/2007,0,0,0,0,0,0,0,0
Somalia,30/03/2007,8,0,0,0,0,0,0,8
Somalia,31/03/2007,0,0,0,0,3,0,0,3
Syria,01/03/2007,9,0,0,0,-1,8,0,16
Syria,02/03/2007,11,0,0,0,3,0,0,14
Syria,03/03/2007,15,0,0,0,0,1,0,16
Syria,04/03/2007,6,0,0,0,0,0,0,6
Syria,05/03/2007,15,0,0,0,9,0,0,24
Syria,06/03/2007,22,0,-4,0,19,6,0,43
Syria,07/03/2007,32,0,1,0,21,4,0,58
Syria,08/03/2007,22,0,0,0,27,0,0,49
Syria,09/03/2007,16,0,0,0,33,8,0,57
Syria,10/03/2007,36,0,0,0,15,12,0,63
Syria,11/03/2007,2,0,0,0,0,0,0,2
Syria,12/03/2007,18,0,2,0,2,4,0,26
Syria,13/03/2007,10,0,0,0,9,0,0,19
Syria,14/03/2007,8,0,0,0,15,0,0,23
Syria,15/03/2007,4,0,0,0,6,10,0,20
Syria,16/03/2007,17,0,0,0,18,6,0,41
Syria,17/03/2007,17,0,0,0,3,2,0,22
Syria,18/03/2007,7,0,0,0,6,0,0,13
Syria,19/03/2007,4,0,0,0,12,3,0,19
Syria,20/03/2007,11,0,-2,0,6,4,0,19
Syria,21/03/2007,9,2,0,0,11,3,0,25
Syria,22/03/2007,28,0,0,0,30,9,0,67
Syria,23/03/2007,23,0,0,0,12,0,0,35
Syria,24/03/2007,40,0,0,0,-2,6,0,44
Syria,25/03/2007,36,0,0,0,3,3,0,42
Syria,26/03/2007,27,0,0,0,30,1,0,58
Syria,27/03/2007,34,0,-4,0,9,11,0,50
Syria,28/03/2007,22,0,0,0,9,-6,0,25
Syria,29/03/2007,31,0,0,0,30,6,0,67
Syria,30/03/2007,28,0,0,0,28,0,0,56
Syria,31/03/2007,-1,0,0,0,0,0,0,-1
Yemen,01/03/2007,11,0,0,0,0,0,0,11
Yemen,02/03/2007,1,0,0,0,0,0,0,1
Yemen,03/03/2007,0,0,0,0,0,0,0,0
Yemen,04/03/2007,24,0,0,0,0,1,0,25
Yemen,05/03/2007,0,0,0,0,0,0,0,0
Yemen,06/03/2007,4,0,1,0,6,0,0,11
Yemen,07/03/2007,0,0,0,0,0,0,0,0
Yemen,08/03/2007,2,0,1,0,0,3,0,6
Yemen,09/03/2007,1,0,0,0,-2,0,0,-1
Yemen,10/03/2007,0,0,0,0,0,0,0,0
Yemen,11/03/2007,0,0,0,0,0,0,0,0
Yemen,12/03/2007,12,0,0,0,0,0,0,12
Yemen,13/03/2007,0,0,0,0,0,0,0,0
Yemen,14/03/2007,-5,0,0,0,0,8,0,3
Yemen,15/03/2007,0,0,0,0,9,1,0,10
Yemen,16/03/2007,0,0,0,0,0,0,0,0
Yemen,18/03/2007,12,0,0,0,0,0,0,12
Yemen,19/03/2007,34,0,0,0,0,6,0,40
Yemen,20/03/2007,21,0,0,0,0,0,0,21
Yemen,21/03/2007,0,0,0,0,0,6,0,6
Yemen,22/03/2007,-6,0,0,0,0,2,0,-4
Yemen,23/03/2007,-1,0,0,0,3,0,0,2
Yemen,24/03/2007,4,0,0,0,3,0,0,7
Yemen,25/03/2007,5,0,0,0,0,3,0,8
Yemen,26/03/2007,8,0,0,0,5,1,0,14
Yemen,27/03/2007,7,0,0,0,6,0,0,13
Yemen,28/03/2007,23,0,0,0,3,2,0,28
Yemen,29/03/2007,9,0,0,0,3,6,0,18
Yemen,30/03/2007,2,0,0,0,32,6,0,40
Yemen,31/03/2007,2,0,0,0,12,0,0,14
Afghanistan,01/01/2007,32,0,0,0,6,4,0,42
Afghanistan,02/01/2007,21,0,-1,0,12,2,0,34
Afghanistan,03/01/2007,53,2,0,0,12,2,0,69
Afghanistan,04/01/2007,28,0,0,0,4,2,0,34
Afghanistan,05/01/2007,48,0,0,0,24,0,0,72
Afghanistan,06/01/2007,39,0,0,0,9,4,0,52
Afghanistan,07/01/2007,44,0,0,0,10,0,0,54
Afghanistan,08/01/2007,29,4,0,0,9,2,0,44
Afghanistan,09/01/2007,53,2,0,0,21,7,0,83
Afghanistan,10/01/2007,80,0,0,0,12,3,0,95
Afghanistan,11/01/2007,101,0,0,0,33,24,0,158
Afghanistan,12/01/2007,144,0,0,0,40,7,0,191
Afghanistan,13/01/2007,68,0,0,0,0,6,0,74
Afghanistan,14/01/2007,42,0,0,0,0,7,0,49
Afghanistan,15/01/2007,51,0,-1,0,-1,22,0,71
Afghanistan,16/01/2007,85,0,0,0,15,6,0,106
Afghanistan,17/01/2007,53,0,-4,0,21,45,0,115
Afghanistan,18/01/2007,64,0,0,0,14,3,0,81
Afghanistan,19/01/2007,95,0,0,0,8,3,0,106
Afghanistan,20/01/2007,32,0,0,0,25,13,0,70
Afghanistan,21/01/2007,26,0,0,0,24,11,0,61
Afghanistan,22/01/2007,27,4,4,0,24,12,0,71
Afghanistan,23/01/2007,29,0,0,0,6,8,0,43
Afghanistan,24/01/2007,76,0,-2,0,8,4,0,86
Afghanistan,25/01/2007,95,0,0,0,36,5,0,136
Afghanistan,26/01/2007,144,6,-6,0,36,12,0,192
Afghanistan,27/01/2007,55,0,-2,0,9,0,0,62
Afghanistan,28/01/2007,71,0,1,0,11,2,0,85
Afghanistan,29/01/2007,75,0,0,0,11,5,0,91
Afghanistan,30/01/2007,112,0,-1,0,12,4,0,127
Afghanistan,31/01/2007,130,0,0,0,43,12,0,185
Albania,01/01/2007,-3,0,0,0,0,0,0,-3
Albania,02/01/2007,8,0,0,0,0,0,0,8
Albania,03/01/2007,2,0,0,0,0,1,0,3
Albania,04/01/2007,2,0,-2,0,0,0,0,0
Albania,05/01/2007,6,0,1,0,3,0,0,10
Albania,06/01/2007,3,0,0,0,0,1,0,4
Albania,07/01/2007,-4,2,-2,0,0,0,0,-4
Albania,08/01/2007,17,0,0,0,0,0,0,17
Albania,09/01/2007,28,0,1,0,7,0,0,36
Albania,10/01/2007,21,0,0,0,3,-2,0,22
Albania,11/01/2007,4,0,0,0,0,2,0,6
Albania,12/01/2007,9,0,-1,0,-4,3,0,7
Albania,13/01/2007,-1,0,0,0,0,0,0,-1
Albania,14/01/2007,-3,0,0,0,0,2,0,-1
Albania,15/01/2007,6,0,-1,0,0,0,0,5
Albania,16/01/2007,2,0,0,0,0,0,0,2
Albania,17/01/2007,0,0,-4,0,0,0,0,-4
Albania,18/01/2007,20,0,-2,0,3,0,0,21
Albania,19/01/2007,21,0,-2,0,15,0,0,34
Albania,20/01/2007,0,0,0,0,0,0,0,0
Albania,21/01/2007,15,0,0,0,0,11,0,26
Albania,22/01/2007,35,0,-10,0,13,4,0,42
Albania,23/01/2007,4,0,-3,0,0,0,0,1
Albania,24/01/2007,3,0,-1,0,18,0,0,20
Albania,25/01/2007,16,0,-2,0,4,1,0,19
Albania,26/01/2007,19,0,0,0,7,10,0,36
Albania,27/01/2007,0,0,0,0,6,0,0,6
Albania,28/01/2007,0,0,0,0,0,0,0,0
Albania,29/01/2007,11,0,0,0,-3,5,0,13
Albania,30/01/2007,12,0,-1,0,3,1,0,15
Albania,31/01/2007,2,0,-2,0,3,2,0,5
Algeria,01/01/2007,0,0,0,0,0,0,0,0
Algeria,02/01/2007,23,0,0,0,0,0,0,23
Algeria,04/01/2007,0,0,0,0,0,0,0,0
Algeria,05/01/2007,0,0,0,0,0,0,0,0
Algeria,07/01/2007,0,0,0,0,0,0,0,0
Algeria,08/01/2007,0,0,0,0,0,0,0,0
Algeria,09/01/2007,6,0,0,0,3,0,0,9
Algeria,10/01/2007,0,0,0,0,3,2,0,5
Algeria,11/01/2007,11,0,0,0,7,0,0,18
Algeria,12/01/2007,33,0,0,0,3,0,0,36
Algeria,13/01/2007,0,0,0,0,3,0,0,3
Algeria,14/01/2007,-3,0,0,0,6,0,0,3
Algeria,15/01/2007,-2,0,0,0,0,0,0,-2
Algeria,16/01/2007,-2,0,0,0,12,1,0,11
Algeria,17/01/2007,6,0,0,0,-6,0,0,0
Algeria,18/01/2007,0,0,0,0,7,4,0,11
Algeria,19/01/2007,4,0,0,0,30,0,0,34
Algeria,20/01/2007,6,0,0,0,9,0,0,15
Algeria,21/01/2007,6,0,0,0,1,2,0,9
Algeria,22/01/2007,5,0,0,0,0,0,0,5
Algeria,23/01/2007,5,0,0,0,0,0,0,5
Algeria,24/01/2007,4,0,0,0,6,0,0,10
Algeria,25/01/2007,0,0,0,0,0,0,0,0
Algeria,26/01/2007,15,0,0,0,-2,0,0,13
Algeria,27/01/2007,0,0,0,0,3,0,0,3
Algeria,28/01/2007,4,0,0,0,0,0,0,4
Algeria,29/01/2007,5,0,0,0,3,0,0,8
Algeria,30/01/2007,7,0,0,0,6,0,0,13
Algeria,31/01/2007,9,0,0,0,4,0,0,13
Bangladesh,01/01/2007,0,0,0,0,0,0,0,0
Bangladesh,02/01/2007,1,0,0,0,0,0,0,1
Bangladesh,03/01/2007,7,0,-4,0,0,3,0,6
Bangladesh,04/01/2007,0,0,0,0,3,2,0,5
Bangladesh,05/01/2007,1,0,0,0,9,1,0,11
Bangladesh,06/01/2007,10,0,0,0,0,0,0,10
Bangladesh,07/01/2007,0,0,0,0,0,1,0,1
Bangladesh,08/01/2007,4,0,0,0,-12,0,0,-8
Bangladesh,09/01/2007,10,0,0,0,6,3,0,19
Bangladesh,10/01/2007,6,0,0,0,6,1,0,13
Bangladesh,11/01/2007,24,0,-6,0,15,2,0,35
Bangladesh,12/01/2007,31,0,-8,0,10,12,0,45
Bangladesh,13/01/2007,13,0,1,0,-1,8,0,21
Bangladesh,14/01/2007,13,0,0,0,2,2,0,17
Bangladesh,15/01/2007,15,0,-2,0,0,0,0,13
Bangladesh,16/01/2007,4,0,0,0,0,0,0,4
Bangladesh,17/01/2007,15,0,-2,0,0,0,0,13
Bangladesh,18/01/2007,3,0,-2,0,4,0,0,5
Bangladesh,19/01/2007,10,0,0,0,0,0,0,10
Bangladesh,20/01/2007,9,0,-2,0,1,0,0,8
Bangladesh,21/01/2007,4,0,-2,0,-1,0,0,1
Bangladesh,22/01/2007,2,0,-2,0,0,1,0,1
Bangladesh,23/01/2007,20,0,1,0,10,2,0,33
Bangladesh,24/01/2007,8,0,2,0,0,0,0,10
Bangladesh,25/01/2007,5,0,0,0,-2,0,0,3
Bangladesh,26/01/2007,35,0,0,0,4,0,0,39
Bangladesh,27/01/2007,20,0,0,0,3,2,0,25
Bangladesh,28/01/2007,17,0,0,0,1,0,0,18
Bangladesh,29/01/2007,3,0,-4,0,7,1,0,7
Bangladesh,30/01/2007,11,0,-2,0,3,0,0,12
Bangladesh,31/01/2007,1,0,-4,0,0,0,0,-3
Cameroon,05/01/2007,0,0,0,0,0,4,0,4
Cameroon,09/01/2007,0,0,0,0,0,0,0,0
Cameroon,12/01/2007,3,0,0,0,15,0,0,18
Cameroon,14/01/2007,0,0,0,0,-2,0,0,-2
Cameroon,19/01/2007,9,0,0,0,0,0,0,9
Cameroon,21/01/2007,9,0,0,0,0,0,0,9
Cameroon,23/01/2007,1,0,0,0,0,0,0,1
Cameroon,24/01/2007,-6,0,0,0,0,0,0,-6
Cameroon,25/01/2007,0,0,0,0,0,0,0,0
Cameroon,27/01/2007,0,0,0,0,0,0,0,0
Cameroon,28/01/2007,0,0,0,0,0,0,0,0
Cameroon,29/01/2007,0,0,0,0,0,0,0,0
Cameroon,30/01/2007,0,0,0,0,0,0,0,0
Cameroon,31/01/2007,0,0,0,0,0,0,0,0
China,01/01/2007,11,0,1,0,21,0,0,33
China,02/01/2007,31,2,-2,0,7,1,0,39
China,03/01/2007,34,0,0,0,5,4,0,43
China,04/01/2007,31,0,-1,0,5,0,0,35
China,05/01/2007,46,0,-7,0,51,16,0,106
China,06/01/2007,10,0,1,0,12,3,0,26
China,07/01/2007,17,0,0,0,-8,8,0,17
China,08/01/2007,8,6,0,0,-9,0,0,5
China,09/01/2007,34,6,-2,0,39,1,0,78
China,10/01/2007,57,0,0,0,40,12,0,109
China,11/01/2007,84,4,-1,0,4,1,0,92
China,12/01/2007,5,0,1,0,11,14,0,31
China,13/01/2007,71,0,0,0,4,1,0,76
China,14/01/2007,41,0,0,0,4,13,0,58
China,15/01/2007,22,0,0,0,12,2,0,36
China,16/01/2007,23,0,0,0,28,5,0,56
China,17/01/2007,18,0,0,0,21,5,0,44
China,18/01/2007,56,0,0,0,-12,4,0,48
China,19/01/2007,115,2,-1,0,30,9,0,155
China,20/01/2007,46,0,0,0,11,0,0,57
China,21/01/2007,41,0,-5,0,31,0,0,67
China,22/01/2007,61,0,-2,0,21,7,0,87
China,23/01/2007,79,2,-2,0,36,8,0,123
China,24/01/2007,81,0,-2,0,39,2,0,120
China,25/01/2007,52,0,2,0,100,9,0,163
China,26/01/2007,52,0,0,0,45,3,0,100
China,27/01/2007,54,0,-4,0,36,0,0,86
China,28/01/2007,4,4,0,0,-5,5,0,8
China,29/01/2007,36,0,0,0,8,11,0,55
China,30/01/2007,24,0,-2,0,8,10,0,40
China,31/01/2007,111,0,-8,0,38,4,0,145
Egypt,01/01/2007,26,0,0,0,-2,1,0,25
Egypt,02/01/2007,18,0,0,0,-12,0,0,6
Egypt,03/01/2007,22,0,0,0,0,4,0,26
Egypt,04/01/2007,63,0,0,0,-9,3,0,57
Egypt,05/01/2007,35,0,1,0,-13,1,0,24
Egypt,06/01/2007,15,0,0,0,0,0,0,15
Egypt,07/01/2007,24,0,1,0,0,0,0,25
Egypt,08/01/2007,28,0,0,0,9,4,0,41
Egypt,09/01/2007,5,0,0,0,6,1,0,12
Egypt,10/01/2007,11,0,2,0,24,0,0,37
Egypt,11/01/2007,-4,0,1,0,15,4,0,16
Egypt,12/01/2007,23,0,0,0,3,0,0,26
Egypt,13/01/2007,5,0,0,0,6,4,0,15
Egypt,14/01/2007,44,0,0,0,5,0,0,49
Egypt,15/01/2007,29,0,0,0,18,4,0,51
Egypt,16/01/2007,23,0,0,0,2,4,0,29
Egypt,17/01/2007,35,0,-8,0,3,1,0,31
Egypt,18/01/2007,26,0,-4,0,36,0,0,58
Egypt,19/01/2007,20,0,0,0,6,0,0,26
Egypt,20/01/2007,23,0,0,0,0,0,0,23
Egypt,21/01/2007,8,0,0,0,13,3,0,24
Egypt,22/01/2007,0,0,0,0,-1,0,0,-1
Egypt,23/01/2007,10,0,0,0,25,16,0,51
Egypt,24/01/2007,1,0,0,0,-4,0,0,-3
Egypt,25/01/2007,3,0,0,0,3,1,0,7
Egypt,26/01/2007,10,0,0,0,0,0,0,10
Egypt,27/01/2007,14,0,0,0,12,0,0,26
Egypt,28/01/2007,18,0,0,0,9,0,0,27
Egypt,29/01/2007,43,0,0,0,0,19,0,62
Egypt,30/01/2007,10,0,-4,0,8,10,0,24
Egypt,31/01/2007,28,0,1,0,15,6,0,50
Eritrea,01/01/2007,1,0,0,0,0,0,0,1
Eritrea,02/01/2007,0,0,0,0,0,0,0,0
Eritrea,03/01/2007,21,0,0,0,0,0,0,21
Eritrea,04/01/2007,0,0,0,0,0,0,0,0
Eritrea,05/01/2007,0,0,0,0,0,0,0,0
Eritrea,07/01/2007,0,0,0,0,0,0,0,0
Eritrea,09/01/2007,3,0,0,0,6,0,0,9
Eritrea,10/01/2007,0,0,0,0,0,0,0,0
Eritrea,11/01/2007,2,0,0,0,0,0,0,2
Eritrea,12/01/2007,12,0,0,0,0,7,0,19
Eritrea,13/01/2007,0,0,0,0,0,9,0,9
Eritrea,14/01/2007,48,0,0,0,3,0,0,51
Eritrea,15/01/2007,99,0,0,0,6,0,0,105
Eritrea,16/01/2007,0,0,0,0,0,0,0,0
Eritrea,17/01/2007,9,0,0,0,0,0,0,9
Eritrea,18/01/2007,8,0,0,0,0,0,0,8
Eritrea,19/01/2007,4,0,0,0,0,0,0,4
Eritrea,20/01/2007,14,0,0,0,0,0,0,14
Eritrea,21/01/2007,0,0,0,0,0,0,0,0
Eritrea,22/01/2007,0,0,0,0,0,0,0,0
Eritrea,24/01/2007,11,0,0,0,0,0,0,11
Eritrea,25/01/2007,12,0,0,0,0,0,0,12
Eritrea,26/01/2007,2,0,0,0,0,0,0,2
Eritrea,28/01/2007,2,0,0,0,0,0,0,2
Eritrea,29/01/2007,0,0,0,0,-2,0,0,-2
Eritrea,30/01/2007,-1,0,0,0,4,0,0,3
Eritrea,31/01/2007,5,0,0,0,8,0,0,13
Georgia,02/01/2007,4,0,0,0,0,0,0,4
Georgia,03/01/2007,0,0,0,0,0,0,0,0
Georgia,04/01/2007,3,0,0,0,0,0,0,3
Georgia,05/01/2007,0,0,0,0,0,0,0,0
Georgia,06/01/2007,9,0,0,0,0,0,0,9
Georgia,07/01/2007,0,0,0,0,0,0,0,0
Georgia,08/01/2007,0,0,0,0,0,0,0,0
Georgia,09/01/2007,9,0,0,0,4,0,0,13
Georgia,10/01/2007,0,0,0,0,0,2,0,2
Georgia,11/01/2007,0,0,0,0,0,0,0,0
Georgia,12/01/2007,0,0,0,0,0,0,0,0
Georgia,13/01/2007,0,0,0,0,0,0,0,0
Georgia,14/01/2007,0,0,0,0,0,0,0,0
Georgia,15/01/2007,0,0,0,0,0,0,0,0
Georgia,16/01/2007,3,0,0,0,0,0,0,3
Georgia,17/01/2007,2,0,0,0,0,0,0,2
Georgia,18/01/2007,2,0,0,0,6,0,0,8
Georgia,19/01/2007,0,0,0,0,3,0,0,3
Georgia,20/01/2007,1,0,0,0,0,0,0,1
Georgia,21/01/2007,8,0,0,0,-2,0,0,6
Georgia,22/01/2007,0,0,-4,0,0,1,0,-3
Georgia,23/01/2007,2,0,0,0,1,0,0,3
Georgia,24/01/2007,2,0,0,0,0,2,0,4
Georgia,25/01/2007,-2,0,0,0,6,0,0,4
Georgia,26/01/2007,-2,0,0,0,3,0,0,1
Georgia,28/01/2007,0,0,0,0,9,0,0,9
Georgia,29/01/2007,8,0,0,0,3,0,0,11
Georgia,30/01/2007,4,0,0,0,6,0,0,10
Georgia,31/01/2007,0,0,0,0,0,1,0,1
India,01/01/2007,2,0,-6,0,0,1,0,-3
India,02/01/2007,14,0,0,0,0,0,0,14
India,03/01/2007,15,0,0,0,9,0,0,24
India,04/01/2007,8,0,0,0,9,4,0,21
India,05/01/2007,68,0,-3,0,3,2,0,70
India,06/01/2007,52,0,0,0,6,8,0,66
India,07/01/2007,-2,0,-2,0,0,4,0,0
India,08/01/2007,2,0,-2,0,5,2,0,7
India,09/01/2007,18,0,0,0,0,1,0,19
India,10/01/2007,28,0,0,0,-3,1,0,26
India,11/01/2007,17,0,0,0,12,0,0,29
India,12/01/2007,26,0,-2,0,10,0,0,34
India,13/01/2007,42,0,0,0,0,4,0,46
India,14/01/2007,11,0,0,0,0,0,0,11
India,15/01/2007,16,0,-2,0,4,1,0,19
India,16/01/2007,12,0,-1,0,1,3,0,15
India,17/01/2007,9,0,0,0,0,4,0,13
India,18/01/2007,18,0,-4,0,3,0,0,17
India,19/01/2007,16,0,0,0,0,5,0,21
India,20/01/2007,20,0,0,0,-5,0,0,15
India,21/01/2007,4,0,0,0,-4,1,0,1
India,22/01/2007,38,0,0,0,-1,8,0,45
India,23/01/2007,14,0,0,0,1,0,0,15
India,24/01/2007,34,0,0,0,0,7,0,41
India,25/01/2007,42,0,1,0,25,3,0,71
India,26/01/2007,66,0,0,0,25,8,0,99
India,27/01/2007,52,0,0,0,2,4,0,58
India,28/01/2007,26,0,0,0,9,0,0,35
India,29/01/2007,26,0,2,0,10,4,0,42
India,30/01/2007,42,0,-1,0,15,0,0,56
India,31/01/2007,14,0,0,0,1,0,0,15
Iran,01/01/2007,16,0,0,0,0,0,0,16
Iran,02/01/2007,16,0,0,0,-2,0,0,14
Iran,03/01/2007,28,0,0,0,18,2,0,48
Iran,04/01/2007,25,0,0,0,0,-1,0,24
Iran,05/01/2007,25,0,0,0,6,5,0,36
Iran,06/01/2007,6,0,0,0,3,4,0,13
Iran,07/01/2007,33,0,3,0,22,0,0,58
Iran,08/01/2007,36,0,1,0,21,2,0,60
Iran,09/01/2007,21,0,0,0,9,0,0,30
Iran,10/01/2007,33,0,0,0,11,5,0,49
Iran,11/01/2007,165,0,0,0,114,6,0,285
Iran,12/01/2007,44,0,-6,0,36,14,0,88
Iran,13/01/2007,46,0,0,0,19,18,0,83
Iran,14/01/2007,80,0,0,0,19,10,0,109
Iran,15/01/2007,36,2,-2,0,17,2,0,55
Iran,16/01/2007,75,0,0,0,21,3,0,99
Iran,17/01/2007,29,0,1,0,9,4,0,43
Iran,18/01/2007,49,0,0,0,16,3,0,68
Iran,19/01/2007,43,4,2,0,15,2,0,66
Iran,20/01/2007,48,0,1,0,-2,5,0,52
Iran,21/01/2007,34,0,0,0,5,1,0,40
Iran,22/01/2007,50,2,0,0,1,7,0,60
Iran,23/01/2007,39,0,-4,0,5,0,0,40
Iran,24/01/2007,28,0,-7,0,12,3,0,36
Iran,25/01/2007,45,0,-2,0,8,10,0,61
Iran,26/01/2007,47,0,0,0,14,6,0,67
Iran,27/01/2007,101,0,0,0,3,3,0,107
Iran,28/01/2007,64,0,0,0,16,16,0,96
Iran,29/01/2007,28,0,0,0,15,9,0,52
Iran,30/01/2007,135,0,2,0,-3,21,0,155
Iran,31/01/2007,54,0,0,0,5,3,0,62
Iraq,01/01/2007,74,2,-1,0,10,6,0,91
Iraq,02/01/2007,55,0,1,0,20,12,0,88
Iraq,03/01/2007,118,0,4,0,73,5,0,200
Iraq,04/01/2007,136,6,-11,0,53,16,0,200
Iraq,05/01/2007,136,4,-17,0,56,15,0,194
Iraq,06/01/2007,93,0,-4,0,38,6,0,133
Iraq,07/01/2007,62,0,-1,0,52,5,0,118
Iraq,08/01/2007,105,2,6,0,50,8,0,171
Iraq,09/01/2007,113,2,-3,0,102,12,0,226
Iraq,10/01/2007,141,0,0,0,26,22,0,189
Iraq,11/01/2007,248,4,4,0,73,18,0,347
Iraq,12/01/2007,120,8,4,0,38,16,0,186
Iraq,13/01/2007,81,0,0,0,31,25,0,137
Iraq,14/01/2007,122,28,4,0,3,4,0,161
Iraq,15/01/2007,152,8,-2,0,31,5,0,194
Iraq,16/01/2007,173,4,4,0,74,9,0,264
Iraq,17/01/2007,125,4,-2,0,44,19,0,190
Iraq,18/01/2007,209,8,-5,0,29,27,0,268
Iraq,19/01/2007,125,0,0,0,26,9,0,160
Iraq,20/01/2007,96,0,-2,0,20,5,0,119
Iraq,21/01/2007,118,0,-5,0,9,19,0,141
Iraq,22/01/2007,155,0,0,0,31,20,0,206
Iraq,23/01/2007,143,0,0,0,9,4,0,156
Iraq,24/01/2007,222,0,0,0,55,11,0,288
Iraq,25/01/2007,115,0,0,0,20,8,0,143
Iraq,26/01/2007,120,0,3,0,33,8,0,164
Iraq,27/01/2007,86,2,0,0,14,18,0,120
Iraq,28/01/2007,154,0,1,0,17,20,0,192
Iraq,29/01/2007,148,2,0,0,21,16,0,187
Iraq,30/01/2007,147,2,1,0,25,21,0,196
Iraq,31/01/2007,142,0,-2,0,46,3,0,189
Morocco,02/01/2007,4,0,0,0,0,0,0,4
Morocco,03/01/2007,0,0,0,0,-2,0,0,-2
Morocco,04/01/2007,0,0,0,0,0,0,0,0
Morocco,05/01/2007,11,0,0,0,27,5,0,43
Morocco,06/01/2007,5,0,0,0,0,1,0,6
Morocco,07/01/2007,3,0,0,0,3,0,0,6
Morocco,08/01/2007,4,0,0,0,33,0,0,37
Morocco,09/01/2007,9,0,2,0,41,0,0,52
Morocco,10/01/2007,11,0,0,0,3,0,0,14
Morocco,11/01/2007,0,0,0,0,3,0,0,3
Morocco,12/01/2007,16,0,0,0,12,0,0,28
Morocco,13/01/2007,0,0,0,0,0,0,0,0
Morocco,14/01/2007,1,0,0,0,0,0,0,1
Morocco,15/01/2007,0,0,0,0,0,0,0,0
Morocco,16/01/2007,4,0,0,0,12,0,0,16
Morocco,17/01/2007,2,0,0,0,0,0,0,2
Morocco,18/01/2007,2,0,0,0,24,0,0,26
Morocco,19/01/2007,2,0,0,0,0,0,0,2
Morocco,20/01/2007,-1,0,0,0,0,0,0,-1
Morocco,21/01/2007,0,0,0,0,0,0,0,0
Morocco,22/01/2007,3,0,0,0,-1,0,0,2
Morocco,23/01/2007,6,0,0,0,12,0,0,18
Morocco,24/01/2007,1,0,0,0,0,0,0,1
Morocco,25/01/2007,0,0,0,0,0,2,0,2
Morocco,26/01/2007,7,0,0,0,0,0,0,7
Morocco,28/01/2007,0,0,0,0,0,0,0,0
Morocco,29/01/2007,0,0,0,0,0,0,0,0
Morocco,30/01/2007,0,0,0,0,15,0,0,15
Morocco,31/01/2007,3,0,0,0,0,0,0,3
Nigeria,01/01/2007,-1,0,0,0,-2,0,0,-3
Nigeria,02/01/2007,0,0,0,0,0,0,0,0
Nigeria,03/01/2007,6,0,-3,0,6,0,0,9
Nigeria,04/01/2007,0,0,0,0,3,0,0,3
Nigeria,05/01/2007,2,0,-8,0,5,0,0,-1
Nigeria,06/01/2007,10,0,0,0,9,0,0,19
Nigeria,07/01/2007,0,0,0,0,0,0,0,0
Nigeria,08/01/2007,-6,0,0,0,0,0,0,-6
Nigeria,09/01/2007,3,0,0,0,0,0,0,3
Nigeria,10/01/2007,6,0,0,0,23,0,0,29
Nigeria,11/01/2007,6,0,-2,0,0,7,0,11
Nigeria,12/01/2007,4,0,-2,0,6,4,0,12
Nigeria,13/01/2007,0,0,-2,0,-2,0,0,-4
Nigeria,14/01/2007,18,0,0,0,0,0,0,18
Nigeria,15/01/2007,10,0,0,0,0,0,0,10
Nigeria,16/01/2007,6,0,0,0,12,0,0,18
Nigeria,17/01/2007,1,0,0,0,12,0,0,13
Nigeria,18/01/2007,15,0,6,0,0,0,0,21
Nigeria,19/01/2007,15,0,-1,0,15,0,0,29
Nigeria,21/01/2007,0,0,0,0,0,0,0,0
Nigeria,22/01/2007,13,0,0,0,3,3,0,19
Nigeria,23/01/2007,9,0,0,0,18,0,0,27
Nigeria,24/01/2007,6,0,0,0,-3,0,0,3
Nigeria,25/01/2007,17,0,4,0,0,0,0,21
Nigeria,26/01/2007,19,0,0,0,24,2,0,45
Nigeria,27/01/2007,10,0,0,0,30,1,0,41
Nigeria,28/01/2007,11,0,0,0,12,0,0,23
Nigeria,29/01/2007,14,0,-2,0,15,3,0,30
Nigeria,30/01/2007,-9,0,0,0,0,3,0,-6
Nigeria,31/01/2007,9,0,0,0,0,0,0,9
Pakistan,01/01/2007,6,0,0,0,3,8,0,17
Pakistan,02/01/2007,20,0,0,0,24,1,0,45
Pakistan,03/01/2007,24,0,0,0,0,2,0,26
Pakistan,04/01/2007,52,0,0,0,6,2,0,60
Pakistan,05/01/2007,0,0,0,0,6,0,0,6
Pakistan,06/01/2007,23,0,0,0,0,5,0,28
Pakistan,07/01/2007,33,0,-3,0,9,7,0,46
Pakistan,08/01/2007,27,2,-1,0,15,10,0,53
Pakistan,09/01/2007,87,0,0,0,19,6,0,112
Pakistan,10/01/2007,39,0,0,0,6,0,0,45
Pakistan,11/01/2007,64,0,0,0,-3,6,0,67
Pakistan,12/01/2007,39,0,0,0,12,6,0,57
Pakistan,13/01/2007,13,0,0,0,-2,1,0,12
Pakistan,14/01/2007,18,0,-4,0,3,0,0,17
Pakistan,15/01/2007,24,0,0,0,4,5,0,33
Pakistan,16/01/2007,29,0,0,0,19,2,0,50
Pakistan,17/01/2007,32,0,0,0,75,2,0,109
Pakistan,18/01/2007,14,0,0,0,41,1,0,56
Pakistan,19/01/2007,7,0,0,0,4,0,0,11
Pakistan,20/01/2007,39,0,0,0,15,3,0,57
Pakistan,21/01/2007,22,0,0,0,4,0,0,26
Pakistan,22/01/2007,39,0,-4,0,8,0,0,43
Pakistan,23/01/2007,25,0,0,0,28,3,0,56
Pakistan,24/01/2007,38,0,-4,0,24,9,0,67
Pakistan,25/01/2007,34,0,0,0,10,1,0,45
Pakistan,26/01/2007,112,0,0,0,34,7,0,153
Pakistan,27/01/2007,11,0,0,0,41,3,0,55
Pakistan,28/01/2007,13,0,0,0,6,0,0,19
Pakistan,29/01/2007,58,6,-1,0,43,4,0,110
Pakistan,30/01/2007,50,0,-1,0,84,5,0,138
Pakistan,31/01/2007,54,0,0,0,43,19,0,116
Sierra Leone,04/01/2007,0,0,0,0,0,0,0,0
Sierra Leone,05/01/2007,0,0,0,0,3,0,0,3
Sierra Leone,09/01/2007,10,0,0,0,0,0,0,10
Sierra Leone,10/01/2007,0,2,0,0,3,0,0,5
Sierra Leone,11/01/2007,2,0,0,0,0,0,0,2
Sierra Leone,12/01/2007,12,0,0,0,0,0,0,12
Sierra Leone,14/01/2007,6,0,0,0,0,0,0,6
Sierra Leone,15/01/2007,0,0,0,0,0,1,0,1
Sierra Leone,16/01/2007,0,0,0,0,0,2,0,2
Sierra Leone,17/01/2007,0,0,0,0,2,0,0,2
Sierra Leone,18/01/2007,0,0,0,0,3,2,0,5
Sierra Leone,19/01/2007,0,0,0,0,0,5,0,5
Sierra Leone,22/01/2007,0,0,0,0,0,0,0,0
Sierra Leone,23/01/2007,0,0,0,0,0,0,0,0
Sierra Leone,24/01/2007,0,0,0,0,0,0,0,0
Sierra Leone,25/01/2007,0,0,0,0,0,0,0,0
Sierra Leone,26/01/2007,3,0,0,0,3,0,0,6
Sierra Leone,27/01/2007,2,0,0,0,0,0,0,2
Sierra Leone,28/01/2007,0,0,0,0,0,0,0,0
Sierra Leone,29/01/2007,0,0,0,0,0,0,0,0
Sierra Leone,31/01/2007,2,0,0,0,6,0,0,8
Somalia,01/01/2007,6,0,0,0,0,0,0,6
Somalia,02/01/2007,14,0,0,0,6,1,0,21
Somalia,03/01/2007,40,0,0,0,13,0,0,53
Somalia,04/01/2007,63,0,0,0,3,10,0,76
Somalia,05/01/2007,49,0,-2,0,2,4,0,53
Somalia,06/01/2007,23,0,0,0,3,0,0,26
Somalia,07/01/2007,18,0,0,0,0,0,0,18
Somalia,08/01/2007,29,0,0,0,-2,0,0,27
Somalia,09/01/2007,176,0,-8,0,26,5,0,199
Somalia,10/01/2007,146,0,2,0,1,26,0,175
Somalia,11/01/2007,84,0,4,0,15,3,0,106
Somalia,12/01/2007,17,0,0,0,6,2,0,25
Somalia,13/01/2007,39,0,0,0,18,2,0,59
Somalia,14/01/2007,14,0,0,0,0,3,0,17
Somalia,15/01/2007,18,0,0,0,9,4,0,31
Somalia,16/01/2007,18,0,0,0,9,0,0,27
Somalia,17/01/2007,-9,0,-2,0,24,0,0,13
Somalia,18/01/2007,1,0,0,0,9,0,0,10
Somalia,19/01/2007,19,0,0,0,3,4,0,26
Somalia,20/01/2007,4,0,0,0,3,0,0,7
Somalia,21/01/2007,2,0,0,0,0,0,0,2
Somalia,22/01/2007,11,0,0,0,-1,0,0,10
Somalia,23/01/2007,15,0,0,0,17,0,0,32
Somalia,24/01/2007,15,0,0,0,6,6,0,27
Somalia,25/01/2007,13,0,0,0,21,2,0,36
Somalia,26/01/2007,17,0,-2,0,6,0,0,21
Somalia,27/01/2007,4,0,-1,0,0,0,0,3
Somalia,28/01/2007,0,0,0,0,4,0,0,4
Somalia,29/01/2007,20,0,-2,0,3,0,0,21
Somalia,30/01/2007,10,0,0,0,-1,2,0,11
Somalia,31/01/2007,9,0,0,0,30,7,0,46
Syria,01/01/2007,9,0,-2,0,0,0,0,7
Syria,02/01/2007,-6,0,-2,0,0,0,0,-8
Syria,03/01/2007,15,0,0,0,9,5,0,29
Syria,04/01/2007,8,0,0,0,6,8,0,22
Syria,05/01/2007,24,0,1,0,16,0,0,41
Syria,06/01/2007,2,0,0,0,0,6,0,8
Syria,07/01/2007,0,0,-12,0,0,0,0,-12
Syria,08/01/2007,-16,2,0,0,12,2,0,0
Syria,09/01/2007,69,0,2,0,97,3,0,171
Syria,10/01/2007,33,0,0,0,24,4,0,61
Syria,11/01/2007,57,0,-1,0,4,2,0,62
Syria,12/01/2007,20,0,-2,0,21,0,0,39
Syria,13/01/2007,15,0,0,0,0,4,0,19
Syria,14/01/2007,33,0,0,0,-5,3,0,31
Syria,15/01/2007,18,0,1,0,0,6,0,25
Syria,16/01/2007,0,2,0,0,6,4,0,12
Syria,17/01/2007,20,0,-2,0,40,0,0,58
Syria,18/01/2007,16,0,0,0,15,4,0,35
Syria,19/01/2007,30,4,2,0,-8,2,0,30
Syria,20/01/2007,27,4,2,0,6,1,0,40
Syria,21/01/2007,2,0,0,0,9,0,0,11
Syria,22/01/2007,10,0,0,0,5,0,0,15
Syria,23/01/2007,57,0,-18,0,15,2,0,56
Syria,24/01/2007,19,0,2,0,-2,4,0,23
Syria,25/01/2007,24,0,0,0,7,10,0,41
Syria,26/01/2007,89,0,0,0,5,8,0,102
Syria,27/01/2007,29,0,0,0,7,0,0,36
Syria,28/01/2007,10,4,0,0,0,7,0,21
Syria,29/01/2007,1,0,0,0,11,3,0,15
Syria,30/01/2007,0,0,0,0,0,0,0,0
Syria,31/01/2007,20,0,0,0,3,0,0,23
Yemen,01/01/2007,3,0,0,0,6,0,0,9
Yemen,02/01/2007,5,0,0,0,0,0,0,5
Yemen,03/01/2007,0,0,0,0,0,0,0,0
Yemen,04/01/2007,0,0,0,0,0,0,0,0
Yemen,05/01/2007,0,0,0,0,3,0,0,3
Yemen,06/01/2007,0,0,0,0,0,0,0,0
Yemen,07/01/2007,3,0,0,0,0,0,0,3
Yemen,08/01/2007,7,0,0,0,9,2,0,18
Yemen,09/01/2007,19,0,0,0,6,0,0,25
Yemen,10/01/2007,8,0,0,0,0,0,0,8
Yemen,11/01/2007,5,0,0,0,0,0,0,5
Yemen,12/01/2007,0,0,0,0,0,0,0,0
Yemen,13/01/2007,5,0,0,0,0,0,0,5
Yemen,14/01/2007,0,0,0,0,0,0,0,0
Yemen,15/01/2007,3,0,0,0,0,0,0,3
Yemen,17/01/2007,6,0,0,0,6,0,0,12
Yemen,18/01/2007,0,0,0,0,-34,0,0,-34
Yemen,19/01/2007,8,0,0,0,-2,0,0,6
Yemen,22/01/2007,6,0,0,0,0,0,0,6
Yemen,23/01/2007,0,0,0,0,0,0,0,0
Yemen,24/01/2007,0,0,0,0,0,0,0,0
Yemen,26/01/2007,-1,0,0,0,-12,0,0,-13
Yemen,27/01/2007,3,0,0,0,6,0,0,9
Yemen,28/01/2007,23,0,0,0,-4,0,0,19
Yemen,29/01/2007,32,0,0,0,6,0,0,38
Yemen,30/01/2007,2,0,0,0,6,0,0,8
Yemen,31/01/2007,8,0,0,0,0,5,0,13
Afghanistan,01/08/2012,140,0,0,0,57,13,0,210
Afghanistan,02/08/2012,83,0,2,0,37,10,0,132
Afghanistan,03/08/2012,165,2,-4,0,13,3,0,179
Afghanistan,04/08/2012,184,0,0,0,24,3,0,211
Afghanistan,05/08/2012,255,2,-1,0,18,36,0,310
Afghanistan,06/08/2012,144,2,-2,0,34,21,0,199
Afghanistan,07/08/2012,253,0,-20,0,43,20,0,296
Afghanistan,08/08/2012,270,0,-11,0,18,50,0,327
Afghanistan,09/08/2012,272,4,0,0,15,53,0,344
Afghanistan,10/08/2012,358,2,0,0,30,56,0,446
Afghanistan,11/08/2012,288,0,0,0,32,42,0,362
Afghanistan,12/08/2012,154,0,-2,0,31,24,0,207
Afghanistan,13/08/2012,262,0,-13,0,49,28,0,326
Afghanistan,14/08/2012,356,0,0,0,67,35,0,458
Afghanistan,15/08/2012,97,0,0,0,-1,9,0,105
Afghanistan,16/08/2012,410,0,-8,0,19,40,0,461
Afghanistan,17/08/2012,477,2,-6,0,22,24,0,519
Afghanistan,18/08/2012,370,4,-8,0,5,38,0,409
Afghanistan,19/08/2012,390,2,-3,0,14,65,0,468
Afghanistan,20/08/2012,284,0,0,0,-3,4,0,285
Afghanistan,21/08/2012,249,0,-18,0,-4,4,0,231
Afghanistan,22/08/2012,266,4,3,0,63,19,0,355
Afghanistan,23/08/2012,308,4,4,0,98,11,0,425
Afghanistan,24/08/2012,250,0,4,0,49,16,0,319
Afghanistan,25/08/2012,86,0,1,0,15,0,0,102
Afghanistan,26/08/2012,290,2,-1,0,3,9,0,303
Afghanistan,27/08/2012,407,0,-2,0,94,30,0,529
Afghanistan,28/08/2012,353,2,-4,0,79,20,0,450
Afghanistan,29/08/2012,159,0,-8,0,19,5,0,175
Afghanistan,30/08/2012,408,0,-6,0,130,36,0,568
Afghanistan,31/08/2012,278,0,1,0,44,32,0,355
Albania,01/08/2012,5,0,0,0,8,0,0,13
Albania,02/08/2012,2,0,0,0,-6,0,0,-4
Albania,03/08/2012,12,0,0,0,6,4,0,22
Albania,04/08/2012,6,0,0,0,3,0,0,9
Albania,06/08/2012,4,0,0,0,0,0,0,4
Albania,07/08/2012,1,0,0,0,9,0,0,10
Albania,08/08/2012,-1,0,0,0,0,0,0,-1
Albania,09/08/2012,4,0,0,0,0,0,0,4
Albania,10/08/2012,0,0,0,0,0,0,0,0
Albania,12/08/2012,4,0,0,0,0,1,0,5
Albania,13/08/2012,0,0,0,0,0,0,0,0
Albania,14/08/2012,13,0,0,0,0,0,0,13
Albania,15/08/2012,10,0,0,0,3,0,0,13
Albania,16/08/2012,5,0,0,0,6,1,0,12
Albania,17/08/2012,8,0,0,0,0,1,0,9
Albania,18/08/2012,0,0,0,0,0,0,0,0
Albania,19/08/2012,1,0,0,0,0,0,0,1
Albania,20/08/2012,3,0,0,0,9,0,0,12
Albania,21/08/2012,6,0,-8,0,0,0,0,-2
Albania,22/08/2012,21,4,-3,0,0,0,0,22
Albania,23/08/2012,2,0,0,0,0,0,0,2
Albania,24/08/2012,-4,0,0,0,0,0,0,-4
Albania,26/08/2012,0,0,0,0,0,0,0,0
Albania,27/08/2012,8,0,1,0,6,0,0,15
Albania,28/08/2012,6,0,0,0,6,2,0,14
Albania,29/08/2012,1,0,0,0,0,0,0,1
Albania,30/08/2012,0,0,0,0,6,0,0,6
Albania,31/08/2012,4,0,0,0,0,0,0,4
Algeria,01/08/2012,8,0,0,0,3,0,0,11
Algeria,02/08/2012,3,0,0,0,0,0,0,3
Algeria,03/08/2012,7,0,-2,0,0,0,0,5
Algeria,04/08/2012,12,0,0,0,0,2,0,14
Algeria,05/08/2012,11,0,0,0,9,0,0,20
Algeria,06/08/2012,17,0,0,0,3,2,0,22
Algeria,07/08/2012,3,0,0,0,0,1,0,4
Algeria,08/08/2012,9,0,0,0,1,3,0,13
Algeria,09/08/2012,9,0,0,0,3,1,0,13
Algeria,10/08/2012,18,0,-6,0,3,3,0,18
Algeria,11/08/2012,17,0,0,0,0,5,0,22
Algeria,12/08/2012,19,0,0,0,0,5,0,24
Algeria,13/08/2012,38,0,-6,0,0,0,0,32
Algeria,14/08/2012,6,0,0,0,0,1,0,7
Algeria,15/08/2012,-1,0,0,0,0,2,0,1
Algeria,16/08/2012,28,0,-18,0,0,2,0,12
Algeria,17/08/2012,33,0,-16,0,4,1,0,22
Algeria,18/08/2012,104,0,-14,0,13,0,0,103
Algeria,19/08/2012,80,0,-10,0,-2,-4,0,64
Algeria,20/08/2012,34,0,-22,0,3,1,0,16
Algeria,21/08/2012,3,0,-4,0,0,1,0,0
Algeria,22/08/2012,2,0,0,0,3,0,0,5
Algeria,23/08/2012,7,0,0,0,0,0,0,7
Algeria,24/08/2012,13,0,-4,0,0,4,0,13
Algeria,25/08/2012,0,0,-4,0,0,0,0,-4
Algeria,26/08/2012,36,12,-2,0,21,1,0,68
Algeria,27/08/2012,1,0,-3,0,25,0,0,23
Algeria,28/08/2012,33,2,-2,0,13,2,0,48
Algeria,29/08/2012,8,0,0,0,4,0,0,12
Algeria,30/08/2012,3,0,1,0,0,0,0,4
Algeria,31/08/2012,6,0,0,0,6,0,0,12
Bangladesh,01/08/2012,80,0,0,0,25,7,0,112
Bangladesh,02/08/2012,16,0,0,0,6,3,0,25
Bangladesh,03/08/2012,66,0,-1,0,15,4,0,84
Bangladesh,04/08/2012,25,0,0,0,12,6,0,43
Bangladesh,05/08/2012,20,0,0,0,24,7,0,51
Bangladesh,06/08/2012,47,0,0,0,33,2,0,82
Bangladesh,07/08/2012,45,0,-2,0,6,2,0,51
Bangladesh,08/08/2012,65,0,0,0,16,6,0,87
Bangladesh,09/08/2012,36,6,-1,0,13,4,0,58
Bangladesh,10/08/2012,7,0,-1,0,9,0,0,15
Bangladesh,11/08/2012,53,0,-2,0,5,6,0,62
Bangladesh,12/08/2012,73,0,0,0,17,4,0,94
Bangladesh,13/08/2012,82,0,-1,0,34,1,0,116
Bangladesh,14/08/2012,35,2,1,0,10,8,0,56
Bangladesh,15/08/2012,16,2,0,0,-4,5,0,19
Bangladesh,16/08/2012,84,0,0,0,-1,13,0,96
Bangladesh,17/08/2012,94,2,0,0,46,8,0,150
Bangladesh,18/08/2012,24,0,1,0,18,1,0,44
Bangladesh,19/08/2012,80,0,0,0,5,6,0,91
Bangladesh,20/08/2012,46,0,0,0,0,10,0,56
Bangladesh,21/08/2012,46,0,3,0,15,4,0,68
Bangladesh,22/08/2012,36,0,1,0,27,4,0,68
Bangladesh,23/08/2012,50,0,-4,0,14,7,0,67
Bangladesh,24/08/2012,37,0,0,0,18,3,0,58
Bangladesh,25/08/2012,14,0,0,0,12,4,0,30
Bangladesh,26/08/2012,7,0,-2,0,6,2,0,13
Bangladesh,27/08/2012,44,0,0,0,11,0,0,55
Bangladesh,28/08/2012,23,0,0,0,22,2,0,47
Bangladesh,29/08/2012,9,0,0,0,0,0,0,9
Bangladesh,30/08/2012,21,0,-4,0,22,9,0,48
Bangladesh,31/08/2012,17,0,-4,0,42,6,0,61
Cameroon,01/08/2012,0,0,0,0,0,0,0,0
Cameroon,02/08/2012,0,0,0,0,2,0,0,2
Cameroon,03/08/2012,0,0,0,0,0,0,0,0
Cameroon,04/08/2012,1,0,0,0,0,0,0,1
Cameroon,05/08/2012,0,0,0,0,0,1,0,1
Cameroon,06/08/2012,0,0,0,0,0,0,0,0
Cameroon,07/08/2012,3,0,0,0,0,0,0,3
Cameroon,08/08/2012,-1,0,0,0,3,0,0,2
Cameroon,09/08/2012,0,0,0,0,0,0,0,0
Cameroon,10/08/2012,3,0,-1,0,0,0,0,2
Cameroon,11/08/2012,0,0,0,0,0,0,0,0
Cameroon,13/08/2012,4,0,0,0,15,0,0,19
Cameroon,14/08/2012,1,0,0,0,12,1,0,14
Cameroon,16/08/2012,0,0,0,0,0,0,0,0
Cameroon,17/08/2012,1,0,0,0,9,1,0,11
Cameroon,18/08/2012,2,0,0,0,0,0,0,2
Cameroon,19/08/2012,0,0,0,0,0,0,0,0
Cameroon,20/08/2012,3,0,0,0,6,0,0,9
Cameroon,21/08/2012,6,0,2,0,4,0,0,12
Cameroon,22/08/2012,0,0,0,0,0,0,0,0
Cameroon,23/08/2012,0,0,0,0,0,0,0,0
Cameroon,24/08/2012,17,0,0,0,3,3,0,23
Cameroon,25/08/2012,3,0,0,0,0,0,0,3
Cameroon,26/08/2012,3,0,0,0,6,0,0,9
Cameroon,27/08/2012,3,0,0,0,9,0,0,12
Cameroon,28/08/2012,0,0,0,0,-6,0,0,-6
Cameroon,30/08/2012,1,0,-2,0,0,0,0,-1
Cameroon,31/08/2012,9,0,0,0,3,0,0,12
China,01/08/2012,172,0,17,0,119,8,0,316
China,02/08/2012,92,2,1,0,53,6,0,154
China,03/08/2012,145,12,-9,0,74,20,0,242
China,04/08/2012,113,0,-4,0,31,15,0,155
China,05/08/2012,139,0,-4,0,61,16,0,212
China,06/08/2012,240,2,-10,0,175,25,0,432
China,07/08/2012,190,0,-2,0,92,24,0,304
China,08/08/2012,200,2,-2,0,61,18,0,279
China,09/08/2012,163,4,-2,0,53,17,0,235
China,10/08/2012,142,4,-9,0,55,11,0,203
China,11/08/2012,102,0,1,0,-10,21,0,114
China,12/08/2012,73,0,1,0,20,3,0,97
China,13/08/2012,209,2,-6,0,108,34,0,347
China,14/08/2012,166,0,-10,0,74,32,0,262
China,15/08/2012,34,0,-4,0,36,8,0,74
China,16/08/2012,231,0,-2,0,104,40,0,373
China,17/08/2012,176,0,-1,0,99,33,0,307
China,18/08/2012,90,0,2,0,40,13,0,145
China,19/08/2012,112,0,0,0,19,17,0,148
China,20/08/2012,144,0,3,0,57,13,0,217
China,21/08/2012,166,0,1,0,37,18,0,222
China,22/08/2012,150,2,-10,0,69,25,0,236
China,23/08/2012,221,0,-2,0,94,29,0,342
China,24/08/2012,198,6,-3,0,62,31,0,294
China,25/08/2012,5,0,0,0,3,3,0,11
China,26/08/2012,90,8,3,0,22,8,0,131
China,27/08/2012,187,0,-1,0,76,23,0,285
China,28/08/2012,144,6,-10,0,41,11,0,192
China,29/08/2012,32,4,2,0,-2,9,0,45
China,30/08/2012,159,10,-5,0,69,19,0,252
China,31/08/2012,65,0,-2,0,42,22,0,127
Egypt,01/08/2012,119,0,0,0,40,11,0,170
Egypt,02/08/2012,28,0,-4,0,16,2,0,42
Egypt,03/08/2012,69,0,3,0,21,8,0,101
Egypt,04/08/2012,49,0,-4,0,47,8,0,100
Egypt,05/08/2012,307,2,1,0,21,13,0,344
Egypt,06/08/2012,624,0,0,0,74,70,0,768
Egypt,07/08/2012,273,0,1,0,64,30,0,368
Egypt,08/08/2012,346,0,-1,0,31,30,0,406
Egypt,09/08/2012,241,0,-1,0,34,27,0,301
Egypt,10/08/2012,78,0,0,0,39,14,0,131
Egypt,11/08/2012,36,0,0,0,30,13,0,79
Egypt,12/08/2012,190,0,-27,0,32,9,0,204
Egypt,13/08/2012,193,0,-12,0,53,11,0,245
Egypt,14/08/2012,178,4,-8,0,39,15,0,228
Egypt,15/08/2012,46,0,1,0,18,3,0,68
Egypt,16/08/2012,158,0,-4,0,44,13,0,211
Egypt,17/08/2012,91,0,-5,0,51,5,0,142
Egypt,18/08/2012,64,0,-2,0,26,7,0,95
Egypt,19/08/2012,99,0,-4,0,18,17,0,130
Egypt,20/08/2012,97,0,0,0,18,12,0,127
Egypt,21/08/2012,97,0,-2,0,20,20,0,135
Egypt,22/08/2012,101,4,-4,0,5,11,0,117
Egypt,23/08/2012,82,12,-2,0,71,20,0,183
Egypt,24/08/2012,88,0,0,0,26,12,0,126
Egypt,25/08/2012,0,0,2,0,13,0,0,15
Egypt,26/08/2012,195,2,-4,0,38,9,0,240
Egypt,27/08/2012,96,0,-6,0,2,24,0,116
Egypt,28/08/2012,88,10,0,0,-16,3,0,85
Egypt,29/08/2012,25,0,1,0,12,3,0,41
Egypt,30/08/2012,99,0,-13,0,-4,19,0,101
Egypt,31/08/2012,131,0,3,0,31,9,0,174
Eritrea,01/08/2012,2,0,0,0,3,0,0,5
Eritrea,02/08/2012,11,0,0,0,12,0,0,23
Eritrea,03/08/2012,0,0,0,0,3,0,0,3
Eritrea,04/08/2012,0,0,0,0,0,0,0,0
Eritrea,07/08/2012,0,0,0,0,0,0,0,0
Eritrea,08/08/2012,0,0,0,0,6,0,0,6
Eritrea,09/08/2012,0,0,0,0,3,2,0,5
Eritrea,10/08/2012,4,0,-4,0,0,1,0,1
Eritrea,11/08/2012,2,0,-4,0,0,0,0,-2
Eritrea,13/08/2012,0,0,0,0,0,0,0,0
Eritrea,14/08/2012,1,0,0,0,-1,0,0,0
Eritrea,15/08/2012,3,0,0,0,6,0,0,9
Eritrea,16/08/2012,2,0,0,0,6,5,0,13
Eritrea,17/08/2012,5,0,0,0,0,0,0,5
Eritrea,18/08/2012,1,0,0,0,0,0,0,1
Eritrea,19/08/2012,1,0,0,0,0,0,0,1
Eritrea,20/08/2012,0,0,0,0,-1,0,0,-1
Eritrea,21/08/2012,43,0,0,0,0,0,0,43
Eritrea,22/08/2012,8,0,0,0,0,2,0,10
Eritrea,23/08/2012,7,0,0,0,0,0,0,7
Eritrea,24/08/2012,8,0,0,0,0,4,0,12
Eritrea,25/08/2012,8,0,0,0,0,0,0,8
Eritrea,26/08/2012,4,0,0,0,0,1,0,5
Eritrea,27/08/2012,6,0,0,0,1,1,0,8
Eritrea,28/08/2012,3,0,0,0,-12,0,0,-9
Eritrea,29/08/2012,3,0,0,0,0,0,0,3
Eritrea,30/08/2012,15,0,0,0,79,0,0,94
Eritrea,31/08/2012,0,0,0,0,0,2,0,2
Georgia,01/08/2012,1,0,0,0,3,0,0,4
Georgia,02/08/2012,0,0,0,0,0,0,0,0
Georgia,03/08/2012,0,0,0,0,0,0,0,0
Georgia,04/08/2012,2,0,0,0,0,0,0,2
Georgia,05/08/2012,2,0,0,0,0,0,0,2
Georgia,08/08/2012,1,0,0,0,0,0,0,1
Georgia,09/08/2012,0,0,0,0,0,0,0,0
Georgia,10/08/2012,-1,0,0,0,0,0,0,-1
Georgia,11/08/2012,0,0,0,0,-2,0,0,-2
Georgia,12/08/2012,1,0,0,0,0,0,0,1
Georgia,13/08/2012,0,0,0,0,0,0,0,0
Georgia,14/08/2012,1,0,-2,0,0,0,0,-1
Georgia,15/08/2012,0,0,0,0,0,0,0,0
Georgia,16/08/2012,2,0,0,0,1,0,0,3
Georgia,18/08/2012,0,0,0,0,0,0,0,0
Georgia,19/08/2012,0,0,0,0,0,0,0,0
Georgia,20/08/2012,4,0,0,0,0,0,0,4
Georgia,21/08/2012,0,0,1,0,0,0,0,1
Georgia,22/08/2012,0,0,0,0,0,0,0,0
Georgia,23/08/2012,2,0,0,0,0,0,0,2
Georgia,24/08/2012,2,0,0,0,0,0,0,2
Georgia,26/08/2012,0,0,0,0,0,0,0,0
Georgia,28/08/2012,-1,0,0,0,0,0,0,-1
Georgia,29/08/2012,2,0,0,0,0,0,0,2
Georgia,30/08/2012,4,0,0,0,0,0,0,4
Georgia,31/08/2012,0,0,0,0,0,0,0,0
India,01/08/2012,72,0,0,0,23,12,0,107
India,02/08/2012,28,0,-2,0,16,7,0,49
India,03/08/2012,76,2,-1,0,17,6,0,100
India,04/08/2012,56,2,-2,0,4,2,0,62
India,05/08/2012,294,2,0,0,65,34,0,395
India,06/08/2012,181,0,-2,0,9,13,0,201
India,07/08/2012,147,2,1,0,36,3,0,189
India,08/08/2012,139,4,-11,0,34,14,0,180
India,09/08/2012,129,2,-1,0,51,21,0,202
India,10/08/2012,115,2,-1,0,17,9,0,142
India,11/08/2012,56,10,0,0,13,3,0,82
India,12/08/2012,81,4,-3,0,17,1,0,100
India,13/08/2012,69,8,0,0,19,8,0,104
India,14/08/2012,103,6,2,0,31,9,0,151
India,15/08/2012,31,2,0,0,5,1,0,39
India,16/08/2012,94,6,-2,0,20,9,0,127
India,17/08/2012,104,2,-5,0,66,23,0,190
India,18/08/2012,49,0,1,0,18,5,0,73
India,19/08/2012,54,0,-1,0,21,7,0,81
India,20/08/2012,34,2,-7,0,16,11,0,56
India,21/08/2012,98,2,-5,0,52,21,0,168
India,22/08/2012,72,2,-20,0,28,25,0,107
India,23/08/2012,73,4,-11,0,33,15,0,114
India,24/08/2012,123,0,-4,0,26,15,0,160
India,25/08/2012,-1,0,-2,0,-2,3,0,-2
India,26/08/2012,88,0,-1,0,31,7,0,125
India,27/08/2012,104,4,-9,0,22,7,0,128
India,28/08/2012,57,0,-10,0,34,26,0,107
India,29/08/2012,22,0,-1,0,14,2,0,37
India,30/08/2012,126,0,-6,0,47,16,0,183
India,31/08/2012,104,0,-8,0,38,10,0,144
Iran,01/08/2012,196,6,13,0,48,28,0,291
Iran,02/08/2012,77,0,4,0,26,8,0,115
Iran,03/08/2012,139,2,1,0,19,15,0,176
Iran,04/08/2012,202,0,0,0,141,35,0,378
Iran,05/08/2012,202,0,4,0,133,35,0,374
Iran,06/08/2012,238,6,-3,0,113,26,0,380
Iran,07/08/2012,307,16,-7,0,141,22,0,479
Iran,08/08/2012,214,14,-2,0,96,8,0,330
Iran,09/08/2012,180,2,-5,0,48,17,0,242
Iran,10/08/2012,101,0,-1,0,15,8,0,123
Iran,11/08/2012,68,0,-1,0,23,4,0,94
Iran,12/08/2012,123,0,-2,0,43,8,0,172
Iran,13/08/2012,185,6,2,0,54,15,0,262
Iran,14/08/2012,281,4,2,0,55,29,0,371
Iran,15/08/2012,103,0,0,0,30,14,0,147
Iran,16/08/2012,225,12,1,0,37,13,0,288
Iran,17/08/2012,152,6,-2,0,20,29,0,205
Iran,18/08/2012,146,0,1,0,50,19,0,216
Iran,19/08/2012,89,0,-1,0,38,14,0,140
Iran,20/08/2012,107,0,0,0,46,11,0,164
Iran,21/08/2012,140,0,0,0,36,12,0,188
Iran,22/08/2012,91,4,4,0,25,7,0,131
Iran,23/08/2012,133,0,4,0,82,23,0,242
Iran,24/08/2012,125,2,0,0,47,7,0,181
Iran,25/08/2012,30,0,-2,0,6,0,0,34
Iran,26/08/2012,144,2,5,0,35,6,0,192
Iran,27/08/2012,198,0,-1,0,55,11,0,263
Iran,28/08/2012,103,0,1,0,74,6,0,184
Iran,29/08/2012,51,0,0,0,12,3,0,66
Iran,30/08/2012,274,6,3,0,15,30,0,328
Iran,31/08/2012,132,0,2,0,2,13,0,149
Iraq,01/08/2012,162,4,0,0,16,8,0,190
Iraq,02/08/2012,54,0,1,0,-4,3,0,54
Iraq,03/08/2012,89,0,0,0,-18,5,0,76
Iraq,04/08/2012,39,0,0,0,5,1,0,45
Iraq,05/08/2012,221,0,-10,0,-2,2,0,211
Iraq,06/08/2012,176,0,0,0,27,6,0,209
Iraq,07/08/2012,100,2,0,0,31,16,0,149
Iraq,08/08/2012,58,0,2,0,32,17,0,109
Iraq,09/08/2012,137,10,10,0,47,4,0,208
Iraq,10/08/2012,70,12,3,0,8,6,0,99
Iraq,11/08/2012,54,0,0,0,33,3,0,90
Iraq,12/08/2012,30,0,0,0,34,14,0,78
Iraq,13/08/2012,150,0,0,0,33,5,0,188
Iraq,14/08/2012,123,0,2,0,34,19,0,178
Iraq,15/08/2012,54,0,4,0,10,5,0,73
Iraq,16/08/2012,125,0,-4,0,67,15,0,203
Iraq,17/08/2012,96,0,0,0,27,7,0,130
Iraq,18/08/2012,79,2,0,0,34,7,0,122
Iraq,19/08/2012,52,8,1,0,42,5,0,108
Iraq,20/08/2012,47,0,0,0,12,17,0,76
Iraq,21/08/2012,173,2,0,0,30,6,0,211
Iraq,22/08/2012,153,2,0,0,61,7,0,223
Iraq,23/08/2012,224,0,1,0,105,10,0,340
Iraq,24/08/2012,128,2,-2,0,13,22,0,163
Iraq,25/08/2012,1,0,0,0,0,4,0,5
Iraq,26/08/2012,66,2,-1,0,12,10,0,89
Iraq,27/08/2012,82,2,-27,0,13,14,0,84
Iraq,28/08/2012,66,2,-5,0,24,11,0,98
Iraq,29/08/2012,5,0,-2,0,-5,5,0,3
Iraq,30/08/2012,113,0,-4,0,87,16,0,212
Iraq,31/08/2012,149,2,3,0,59,13,0,226
Morocco,01/08/2012,5,0,0,0,11,0,0,16
Morocco,02/08/2012,6,0,0,0,42,5,0,53
Morocco,03/08/2012,25,0,0,0,3,8,0,36
Morocco,04/08/2012,0,0,0,0,-2,0,0,-2
Morocco,05/08/2012,2,0,0,0,-2,2,0,2
Morocco,06/08/2012,6,0,0,0,0,0,0,6
Morocco,07/08/2012,8,0,-2,0,0,0,0,6
Morocco,08/08/2012,2,0,0,0,0,0,0,2
Morocco,09/08/2012,1,4,0,0,9,2,0,16
Morocco,10/08/2012,0,0,0,0,3,0,0,3
Morocco,11/08/2012,34,0,0,0,0,0,0,34
Morocco,12/08/2012,29,0,0,0,6,0,0,35
Morocco,13/08/2012,10,0,0,0,6,0,0,16
Morocco,14/08/2012,16,0,0,0,3,4,0,23
Morocco,15/08/2012,4,0,0,0,3,0,0,7
Morocco,16/08/2012,12,0,0,0,-4,4,0,12
Morocco,17/08/2012,7,0,0,0,0,4,0,11
Morocco,18/08/2012,11,0,0,0,3,0,0,14
Morocco,19/08/2012,33,0,0,0,-10,0,0,23
Morocco,20/08/2012,0,0,1,0,40,0,0,41
Morocco,21/08/2012,1,0,0,0,19,0,0,20
Morocco,22/08/2012,24,0,0,0,6,0,0,30
Morocco,23/08/2012,12,0,0,0,3,0,0,15
Morocco,24/08/2012,18,0,0,0,8,8,0,34
Morocco,25/08/2012,0,0,-2,0,0,0,0,-2
Morocco,26/08/2012,33,0,-2,0,22,2,0,55
Morocco,27/08/2012,7,0,0,0,0,0,0,7
Morocco,28/08/2012,11,0,0,0,11,1,0,23
Morocco,29/08/2012,0,0,0,0,0,3,0,3
Morocco,30/08/2012,17,0,0,0,3,1,0,21
Morocco,31/08/2012,9,0,0,0,12,3,0,24
Nigeria,01/08/2012,15,0,0,0,14,2,0,31
Nigeria,02/08/2012,4,0,0,0,25,0,0,29
Nigeria,03/08/2012,25,0,-1,0,5,2,0,31
Nigeria,04/08/2012,62,0,0,0,68,3,0,133
Nigeria,05/08/2012,22,0,-4,0,3,4,0,25
Nigeria,06/08/2012,7,0,0,0,12,1,0,20
Nigeria,07/08/2012,20,0,1,0,3,0,0,24
Nigeria,08/08/2012,28,0,-2,0,-1,6,0,31
Nigeria,09/08/2012,32,0,-1,0,-9,3,0,25
Nigeria,10/08/2012,20,0,1,0,6,0,0,27
Nigeria,11/08/2012,0,0,0,0,4,0,0,4
Nigeria,12/08/2012,12,0,0,0,3,3,0,18
Nigeria,13/08/2012,19,2,1,0,16,2,0,40
Nigeria,14/08/2012,37,0,0,0,25,2,0,64
Nigeria,15/08/2012,8,0,0,0,15,2,0,25
Nigeria,16/08/2012,1,0,1,0,-10,5,0,-3
Nigeria,17/08/2012,11,0,0,0,2,2,0,15
Nigeria,18/08/2012,36,0,0,0,15,2,0,53
Nigeria,19/08/2012,36,0,1,0,4,1,0,42
Nigeria,20/08/2012,33,0,0,0,27,0,0,60
Nigeria,21/08/2012,19,0,2,0,42,2,0,65
Nigeria,22/08/2012,49,0,0,0,15,6,0,70
Nigeria,23/08/2012,50,2,0,0,23,3,0,78
Nigeria,24/08/2012,74,0,0,0,6,10,0,90
Nigeria,25/08/2012,6,0,0,0,0,0,0,6
Nigeria,26/08/2012,43,0,4,0,16,4,0,67
Nigeria,27/08/2012,36,0,2,0,0,1,0,39
Nigeria,28/08/2012,48,0,-2,0,10,13,0,69
Nigeria,29/08/2012,2,0,0,0,3,0,0,5
Nigeria,30/08/2012,48,0,-5,0,-2,4,0,45
Nigeria,31/08/2012,43,0,-2,0,8,1,0,50
Pakistan,01/08/2012,102,0,0,0,-4,11,0,109
Pakistan,02/08/2012,56,0,0,0,44,0,0,100
Pakistan,03/08/2012,171,0,0,0,120,6,0,297
Pakistan,04/08/2012,178,0,0,0,97,4,0,279
Pakistan,05/08/2012,150,2,-1,0,46,22,0,219
Pakistan,06/08/2012,166,0,0,0,23,6,0,195
Pakistan,07/08/2012,104,0,-4,0,29,20,0,149
Pakistan,08/08/2012,185,0,-4,0,82,7,0,270
Pakistan,09/08/2012,76,2,-4,0,10,16,0,100
Pakistan,10/08/2012,45,0,2,0,5,7,0,59
Pakistan,11/08/2012,72,0,-1,0,1,2,0,74
Pakistan,12/08/2012,36,0,0,0,44,15,0,95
Pakistan,13/08/2012,140,0,-4,0,40,9,0,185
Pakistan,14/08/2012,244,0,-2,0,38,32,0,312
Pakistan,15/08/2012,118,0,0,0,31,39,0,188
Pakistan,16/08/2012,254,6,-6,0,34,15,0,303
Pakistan,17/08/2012,143,0,0,0,5,7,0,155
Pakistan,18/08/2012,52,0,3,0,10,29,0,94
Pakistan,19/08/2012,178,0,0,0,2,21,0,201
Pakistan,20/08/2012,71,0,0,0,29,13,0,113
Pakistan,21/08/2012,61,2,0,0,28,14,0,105
Pakistan,22/08/2012,38,0,0,0,13,12,0,63
Pakistan,23/08/2012,85,0,0,0,38,9,0,132
Pakistan,24/08/2012,140,0,-2,0,34,12,0,184
Pakistan,25/08/2012,41,0,-4,0,9,0,0,46
Pakistan,26/08/2012,123,2,0,0,40,6,0,171
Pakistan,27/08/2012,144,0,1,0,65,6,0,216
Pakistan,28/08/2012,76,0,0,0,18,1,0,95
Pakistan,29/08/2012,125,8,9,0,44,9,0,195
Pakistan,30/08/2012,200,2,3,0,71,9,0,285
Pakistan,31/08/2012,106,0,4,0,54,14,0,178
Sierra Leone,01/08/2012,-4,0,0,0,9,1,0,6
Sierra Leone,02/08/2012,0,0,0,0,0,0,0,0
Sierra Leone,03/08/2012,8,0,0,0,0,0,0,8
Sierra Leone,04/08/2012,0,0,0,0,0,0,0,0
Sierra Leone,05/08/2012,9,0,0,0,0,0,0,9
Sierra Leone,06/08/2012,0,0,0,0,3,1,0,4
Sierra Leone,07/08/2012,2,0,0,0,6,0,0,8
Sierra Leone,08/08/2012,2,0,0,0,9,0,0,11
Sierra Leone,09/08/2012,11,0,0,0,0,0,0,11
Sierra Leone,10/08/2012,3,0,0,0,0,0,0,3
Sierra Leone,11/08/2012,4,0,0,0,3,0,0,7
Sierra Leone,12/08/2012,3,0,0,0,3,0,0,6
Sierra Leone,13/08/2012,0,0,0,0,0,0,0,0
Sierra Leone,14/08/2012,0,0,0,0,0,0,0,0
Sierra Leone,15/08/2012,0,0,0,0,0,0,0,0
Sierra Leone,16/08/2012,2,0,0,0,0,0,0,2
Sierra Leone,17/08/2012,1,0,0,0,0,0,0,1
Sierra Leone,18/08/2012,9,0,0,0,9,0,0,18
Sierra Leone,19/08/2012,3,0,0,0,0,0,0,3
Sierra Leone,20/08/2012,3,0,0,0,0,0,0,3
Sierra Leone,21/08/2012,2,0,0,0,0,0,0,2
Sierra Leone,22/08/2012,0,0,0,0,-1,0,0,-1
Sierra Leone,23/08/2012,3,0,0,0,3,0,0,6
Sierra Leone,24/08/2012,7,0,0,0,3,0,0,10
Sierra Leone,26/08/2012,0,0,0,0,0,2,0,2
Sierra Leone,27/08/2012,3,0,0,0,0,0,0,3
Sierra Leone,28/08/2012,23,2,0,0,0,1,0,26
Sierra Leone,29/08/2012,5,0,0,0,0,0,0,5
Sierra Leone,30/08/2012,8,0,0,0,0,0,0,8
Sierra Leone,31/08/2012,1,0,0,0,3,0,0,4
Somalia,01/08/2012,106,0,-5,0,44,31,0,176
Somalia,02/08/2012,44,0,-10,0,15,7,0,56
Somalia,03/08/2012,94,0,-5,0,17,17,0,123
Somalia,04/08/2012,103,0,0,0,15,20,0,138
Somalia,05/08/2012,121,0,0,0,24,5,0,150
Somalia,06/08/2012,86,0,-2,0,18,5,0,107
Somalia,07/08/2012,63,0,-9,0,34,3,0,91
Somalia,08/08/2012,113,4,-5,0,53,6,0,171
Somalia,09/08/2012,75,0,-4,0,49,12,0,132
Somalia,10/08/2012,27,0,0,0,9,17,0,53
Somalia,11/08/2012,42,0,-1,0,0,7,0,48
Somalia,12/08/2012,85,0,0,0,52,7,0,144
Somalia,13/08/2012,141,0,0,0,97,10,0,248
Somalia,14/08/2012,192,4,1,0,58,23,0,278
Somalia,15/08/2012,75,0,-2,0,25,7,0,105
Somalia,16/08/2012,117,0,-2,0,59,9,0,183
Somalia,17/08/2012,71,0,-1,0,46,5,0,121
Somalia,18/08/2012,28,0,0,0,5,4,0,37
Somalia,19/08/2012,51,0,0,0,12,11,0,74
Somalia,20/08/2012,50,0,0,0,27,16,0,93
Somalia,21/08/2012,160,0,0,0,32,6,0,198
Somalia,22/08/2012,136,2,-2,0,17,2,0,155
Somalia,23/08/2012,106,4,2,0,33,8,0,153
Somalia,24/08/2012,85,2,0,0,-1,16,0,102
Somalia,26/08/2012,69,0,-1,0,16,5,0,89
Somalia,27/08/2012,229,2,-6,0,26,17,0,268
Somalia,28/08/2012,252,0,-2,0,64,37,0,351
Somalia,29/08/2012,63,0,1,0,15,5,0,84
Somalia,30/08/2012,142,0,1,0,53,16,0,212
Somalia,31/08/2012,64,0,-6,0,36,2,0,96
Syria,01/08/2012,388,2,-11,0,17,22,0,418
Syria,02/08/2012,258,0,-38,0,30,26,0,276
Syria,03/08/2012,522,22,-27,0,16,14,0,547
Syria,04/08/2012,171,4,-9,0,42,1,0,209
Syria,05/08/2012,297,0,0,0,73,16,0,386
Syria,06/08/2012,595,2,-14,0,71,39,0,693
Syria,07/08/2012,501,0,-4,0,89,26,0,612
Syria,08/08/2012,302,0,-7,0,56,31,0,382
Syria,09/08/2012,276,8,-13,0,98,19,0,388
Syria,10/08/2012,209,2,-18,0,39,17,0,249
Syria,11/08/2012,340,2,-10,0,52,21,0,405
Syria,12/08/2012,265,0,-10,0,78,25,0,358
Syria,13/08/2012,504,2,-7,0,41,9,0,549
Syria,14/08/2012,543,8,-5,0,159,28,0,733
Syria,15/08/2012,187,0,-1,0,56,20,0,262
Syria,16/08/2012,475,4,-8,0,212,51,0,734
Syria,17/08/2012,377,2,-24,0,100,53,0,508
Syria,18/08/2012,229,0,-8,0,37,16,0,274
Syria,19/08/2012,107,0,-22,0,12,11,0,108
Syria,20/08/2012,326,4,-20,0,32,29,0,371
Syria,21/08/2012,571,0,-38,0,90,27,0,650
Syria,22/08/2012,535,6,-1,0,21,39,0,600
Syria,23/08/2012,447,4,-5,0,41,16,0,503
Syria,24/08/2012,556,4,-9,0,57,15,0,623
Syria,25/08/2012,45,0,-6,0,23,1,0,63
Syria,26/08/2012,307,10,-5,0,25,18,0,355
Syria,27/08/2012,287,32,-8,0,24,2,0,337
Syria,28/08/2012,293,8,-5,0,92,48,0,436
Syria,29/08/2012,132,4,0,0,22,33,0,191
Syria,30/08/2012,395,24,6,0,53,41,0,519
Syria,31/08/2012,293,12,4,0,28,28,0,365
Yemen,01/08/2012,56,0,0,0,22,0,0,78
Yemen,02/08/2012,3,0,0,0,3,1,0,7
Yemen,03/08/2012,13,0,0,0,1,1,0,15
Yemen,04/08/2012,26,0,0,0,9,8,0,43
Yemen,05/08/2012,105,0,0,0,6,15,0,126
Yemen,06/08/2012,17,0,0,0,10,5,0,32
Yemen,07/08/2012,27,0,0,0,2,3,0,32
Yemen,08/08/2012,14,0,0,0,-1,5,0,18
Yemen,09/08/2012,5,0,0,0,-1,0,0,4
Yemen,10/08/2012,32,2,0,0,3,1,0,38
Yemen,11/08/2012,6,2,0,0,15,2,0,25
Yemen,12/08/2012,38,0,0,0,10,2,0,50
Yemen,13/08/2012,7,0,0,0,32,0,0,39
Yemen,14/08/2012,24,0,0,0,4,8,0,36
Yemen,15/08/2012,22,0,0,0,30,0,0,52
Yemen,16/08/2012,34,0,0,0,8,0,0,42
Yemen,17/08/2012,-1,0,0,0,12,3,0,14
Yemen,18/08/2012,55,0,0,0,3,3,0,61
Yemen,19/08/2012,26,0,-2,0,27,23,0,74
Yemen,20/08/2012,16,0,2,0,-2,4,0,20
Yemen,21/08/2012,0,0,0,0,18,3,0,21
Yemen,22/08/2012,20,0,0,0,6,0,0,26
Yemen,23/08/2012,47,0,0,0,15,4,0,66
Yemen,24/08/2012,7,0,0,0,12,0,0,19
Yemen,26/08/2012,18,0,0,0,0,0,0,18
Yemen,27/08/2012,15,0,0,0,0,0,0,15
Yemen,28/08/2012,14,0,0,0,2,1,0,17
Yemen,29/08/2012,0,0,1,0,6,0,0,7
Yemen,30/08/2012,36,0,1,0,45,0,0,82
Yemen,31/08/2012,43,0,0,0,10,0,0,53
Afghanistan,01/04/2007,64,2,0,0,-4,18,0,80
Afghanistan,02/04/2007,71,2,0,0,14,11,0,98
Afghanistan,03/04/2007,74,0,1,0,31,12,0,118
Afghanistan,04/04/2007,76,0,0,0,38,21,0,135
Afghanistan,05/04/2007,71,0,1,0,45,16,0,133
Afghanistan,06/04/2007,79,0,0,0,29,2,0,110
Afghanistan,07/04/2007,66,2,0,0,32,1,0,101
Afghanistan,08/04/2007,91,2,0,0,40,12,0,145
Afghanistan,09/04/2007,130,0,1,0,44,21,0,196
Afghanistan,10/04/2007,166,0,-1,0,6,18,0,189
Afghanistan,11/04/2007,128,0,1,0,21,7,0,157
Afghanistan,12/04/2007,382,4,0,0,23,38,0,447
Afghanistan,13/04/2007,89,0,-6,0,21,4,0,108
Afghanistan,14/04/2007,69,0,0,0,23,17,0,109
Afghanistan,15/04/2007,49,0,1,0,33,5,0,88
Afghanistan,16/04/2007,104,0,1,0,46,12,0,163
Afghanistan,17/04/2007,81,0,-1,0,59,17,0,156
Afghanistan,18/04/2007,72,0,1,0,26,8,0,107
Afghanistan,19/04/2007,140,0,0,0,48,25,0,213
Afghanistan,20/04/2007,82,0,2,0,20,9,0,113
Afghanistan,21/04/2007,59,0,0,0,26,5,0,90
Afghanistan,22/04/2007,60,4,0,0,7,0,0,71
Afghanistan,23/04/2007,59,0,-1,0,55,3,0,116
Afghanistan,24/04/2007,122,0,-1,0,124,19,0,264
Afghanistan,25/04/2007,109,0,-1,0,66,9,0,183
Afghanistan,26/04/2007,19,0,0,0,23,2,0,44
Afghanistan,27/04/2007,65,0,1,0,26,3,0,95
Afghanistan,28/04/2007,151,0,0,0,-13,25,0,163
Afghanistan,29/04/2007,134,0,0,0,-19,22,0,137
Afghanistan,30/04/2007,110,2,0,0,-8,1,0,105
Albania,01/04/2007,9,0,-2,0,3,3,0,13
Albania,02/04/2007,14,0,-12,0,-4,10,0,8
Albania,03/04/2007,11,0,-4,0,1,2,0,10
Albania,04/04/2007,4,0,0,0,0,5,0,9
Albania,05/04/2007,10,0,-3,0,6,7,0,20
Albania,06/04/2007,4,0,0,0,0,6,0,10
Albania,07/04/2007,6,0,0,0,3,1,0,10
Albania,08/04/2007,3,0,0,0,0,0,0,3
Albania,09/04/2007,0,0,0,0,0,0,0,0
Albania,10/04/2007,12,0,1,0,18,4,0,35
Albania,11/04/2007,5,0,0,0,12,0,0,17
Albania,12/04/2007,-5,0,0,0,15,0,0,10
Albania,13/04/2007,19,0,-1,0,17,0,0,35
Albania,14/04/2007,8,0,0,0,-7,0,0,1
Albania,15/04/2007,0,0,2,0,14,0,0,16
Albania,16/04/2007,66,0,-2,0,42,2,0,108
Albania,17/04/2007,28,0,0,0,21,10,0,59
Albania,18/04/2007,6,0,-1,0,3,2,0,10
Albania,19/04/2007,2,0,-10,0,0,1,0,-7
Albania,20/04/2007,21,0,-1,0,12,0,0,32
Albania,21/04/2007,0,0,0,0,0,2,0,2
Albania,22/04/2007,0,0,0,0,0,0,0,0
Albania,23/04/2007,-4,0,0,0,1,0,0,-3
Albania,24/04/2007,27,0,-7,0,2,8,0,30
Albania,25/04/2007,2,0,-5,0,-2,0,0,-5
Albania,26/04/2007,3,0,0,0,18,2,0,23
Albania,27/04/2007,10,0,0,0,3,6,0,19
Albania,28/04/2007,18,6,0,0,0,1,0,25
Albania,29/04/2007,30,0,0,0,0,0,0,30
Albania,30/04/2007,9,0,-3,0,0,0,0,6
Algeria,01/04/2007,0,0,0,0,0,0,0,0
Algeria,02/04/2007,6,0,-2,0,0,0,0,4
Algeria,03/04/2007,0,0,0,0,4,0,0,4
Algeria,04/04/2007,-2,0,0,0,0,0,0,-2
Algeria,05/04/2007,7,0,-4,0,12,0,0,15
Algeria,06/04/2007,11,4,-2,0,21,0,0,34
Algeria,08/04/2007,8,0,0,0,0,0,0,8
Algeria,09/04/2007,5,0,0,0,0,1,0,6
Algeria,10/04/2007,10,0,0,0,0,3,0,13
Algeria,11/04/2007,36,0,0,0,0,6,0,42
Algeria,12/04/2007,20,2,0,0,-8,17,0,31
Algeria,13/04/2007,10,0,0,0,12,4,0,26
Algeria,14/04/2007,7,0,0,0,0,6,0,13
Algeria,15/04/2007,10,0,0,0,12,26,0,48
Algeria,16/04/2007,-1,0,0,0,3,15,0,17
Algeria,17/04/2007,2,0,0,0,12,2,0,16
Algeria,18/04/2007,16,0,0,0,0,1,0,17
Algeria,19/04/2007,5,0,0,0,1,0,0,6
Algeria,20/04/2007,4,0,0,0,0,0,0,4
Algeria,21/04/2007,0,0,0,0,0,0,0,0
Algeria,22/04/2007,1,0,0,0,0,0,0,1
Algeria,23/04/2007,0,0,0,0,0,0,0,0
Algeria,24/04/2007,1,0,0,0,6,0,0,7
Algeria,25/04/2007,0,0,0,0,0,0,0,0
Algeria,26/04/2007,6,0,0,0,0,0,0,6
Algeria,27/04/2007,8,0,0,0,15,0,0,23
Algeria,28/04/2007,6,0,0,0,0,0,0,6
Algeria,29/04/2007,0,0,0,0,0,0,0,0
Algeria,30/04/2007,0,0,0,0,0,0,0,0
Bangladesh,01/04/2007,33,0,0,0,23,3,0,59
Bangladesh,02/04/2007,15,0,0,0,1,1,0,17
Bangladesh,03/04/2007,8,0,0,0,6,0,0,14
Bangladesh,04/04/2007,6,0,0,0,6,1,0,13
Bangladesh,05/04/2007,9,0,-5,0,6,0,0,10
Bangladesh,06/04/2007,2,0,0,0,0,0,0,2
Bangladesh,07/04/2007,0,0,0,0,-1,0,0,-1
Bangladesh,08/04/2007,6,0,0,0,6,0,0,12
Bangladesh,09/04/2007,5,0,0,0,26,0,0,31
Bangladesh,10/04/2007,10,0,0,0,6,0,0,16
Bangladesh,11/04/2007,47,0,0,0,23,0,0,70
Bangladesh,12/04/2007,49,0,1,0,24,0,0,74
Bangladesh,13/04/2007,15,0,0,0,2,0,0,17
Bangladesh,14/04/2007,5,0,0,0,0,1,0,6
Bangladesh,15/04/2007,4,0,-2,0,6,2,0,10
Bangladesh,16/04/2007,12,2,0,0,10,0,0,24
Bangladesh,17/04/2007,17,0,0,0,6,0,0,23
Bangladesh,18/04/2007,34,0,0,0,41,0,0,75
Bangladesh,19/04/2007,26,0,0,0,4,0,0,30
Bangladesh,20/04/2007,-2,0,4,0,6,1,0,9
Bangladesh,21/04/2007,14,0,0,0,15,0,0,29
Bangladesh,22/04/2007,27,0,0,0,21,0,0,48
Bangladesh,23/04/2007,3,0,0,0,4,2,0,9
Bangladesh,24/04/2007,-1,0,0,0,6,1,0,6
Bangladesh,25/04/2007,19,0,2,0,9,0,0,30
Bangladesh,26/04/2007,7,0,0,0,12,1,0,20
Bangladesh,27/04/2007,13,0,0,0,15,0,0,28
Bangladesh,28/04/2007,0,0,0,0,6,0,0,6
Bangladesh,29/04/2007,20,0,0,0,16,4,0,40
Bangladesh,30/04/2007,7,0,0,0,4,1,0,12
Cameroon,02/04/2007,0,0,1,0,0,0,0,1
Cameroon,03/04/2007,0,0,0,0,0,0,0,0
Cameroon,04/04/2007,13,0,0,0,0,0,0,13
Cameroon,05/04/2007,16,0,0,0,0,0,0,16
Cameroon,06/04/2007,0,0,0,0,4,0,0,4
Cameroon,09/04/2007,0,0,0,0,0,0,0,0
Cameroon,10/04/2007,0,0,0,0,0,0,0,0
Cameroon,11/04/2007,1,0,0,0,7,0,0,8
Cameroon,12/04/2007,-1,0,0,0,6,0,0,5
Cameroon,13/04/2007,0,0,0,0,0,0,0,0
Cameroon,15/04/2007,0,0,0,0,0,0,0,0
Cameroon,16/04/2007,4,0,0,0,0,0,0,4
Cameroon,17/04/2007,0,2,0,0,0,0,0,2
Cameroon,18/04/2007,0,0,0,0,0,0,0,0
Cameroon,19/04/2007,0,0,0,0,0,0,0,0
Cameroon,20/04/2007,1,0,0,0,0,0,0,1
Cameroon,21/04/2007,0,0,0,0,0,0,0,0
Cameroon,23/04/2007,4,0,0,0,0,0,0,4
Cameroon,24/04/2007,0,0,0,0,0,0,0,0
Cameroon,26/04/2007,9,0,0,0,3,0,0,12
Cameroon,27/04/2007,0,0,0,0,0,0,0,0
Cameroon,30/04/2007,0,0,0,0,0,0,0,0
China,01/04/2007,19,0,0,0,31,3,0,53
China,02/04/2007,58,8,-1,0,74,14,0,153
China,03/04/2007,57,0,1,0,47,13,0,118
China,04/04/2007,41,2,1,0,54,18,0,116
China,05/04/2007,48,0,0,0,19,12,0,79
China,06/04/2007,66,2,0,0,50,2,0,120
China,07/04/2007,30,0,-2,0,31,8,0,67
China,08/04/2007,35,0,1,0,11,9,0,56
China,09/04/2007,42,0,1,0,18,3,0,64
China,10/04/2007,70,0,-6,0,15,5,0,84
China,11/04/2007,66,0,0,0,23,3,0,92
China,12/04/2007,99,0,-3,0,71,22,0,189
China,13/04/2007,42,0,-6,0,33,6,0,75
China,14/04/2007,19,0,-1,0,18,0,0,36
China,15/04/2007,57,0,0,0,6,1,0,64
China,16/04/2007,7,2,0,0,31,7,0,47
China,17/04/2007,104,2,0,0,28,14,0,148
China,18/04/2007,51,0,-6,0,49,4,0,98
China,19/04/2007,51,0,-7,0,78,6,0,128
China,20/04/2007,54,0,-1,0,20,6,0,79
China,21/04/2007,49,0,0,0,25,6,0,80
China,22/04/2007,36,0,0,0,1,4,0,41
China,23/04/2007,29,0,-4,0,-3,4,0,26
China,24/04/2007,93,0,-1,0,18,17,0,127
China,25/04/2007,156,0,1,0,25,9,0,191
China,26/04/2007,54,0,2,0,15,15,0,86
China,27/04/2007,87,4,-1,0,24,3,0,117
China,28/04/2007,42,0,1,0,8,6,0,57
China,29/04/2007,55,0,1,0,-20,11,0,47
China,30/04/2007,95,0,-1,0,13,13,0,120
Egypt,01/04/2007,9,0,0,0,0,0,0,9
Egypt,02/04/2007,20,0,0,0,3,1,0,24
Egypt,03/04/2007,6,0,0,0,36,0,0,42
Egypt,04/04/2007,9,0,0,0,6,0,0,15
Egypt,05/04/2007,4,0,0,0,0,3,0,7
Egypt,06/04/2007,17,0,0,0,-23,0,0,-6
Egypt,07/04/2007,46,0,0,0,-9,0,0,37
Egypt,08/04/2007,15,0,0,0,5,6,0,26
Egypt,09/04/2007,20,0,0,0,-11,1,0,10
Egypt,10/04/2007,17,0,-1,0,8,0,0,24
Egypt,11/04/2007,9,0,0,0,19,2,0,30
Egypt,12/04/2007,27,0,0,0,12,0,0,39
Egypt,13/04/2007,9,0,0,0,6,0,0,15
Egypt,14/04/2007,9,0,0,0,-9,0,0,0
Egypt,15/04/2007,27,0,0,0,6,0,0,33
Egypt,16/04/2007,25,2,0,0,4,1,0,32
Egypt,17/04/2007,7,0,0,0,42,2,0,51
Egypt,18/04/2007,5,0,-1,0,13,0,0,17
Egypt,19/04/2007,11,0,0,0,17,0,0,28
Egypt,20/04/2007,19,0,0,0,0,0,0,19
Egypt,21/04/2007,21,0,0,0,21,4,0,46
Egypt,22/04/2007,27,0,0,0,3,6,0,36
Egypt,23/04/2007,15,0,-2,0,3,0,0,16
Egypt,24/04/2007,32,0,1,0,6,3,0,42
Egypt,25/04/2007,50,0,0,0,3,0,0,53
Egypt,26/04/2007,50,0,0,0,17,6,0,73
Egypt,27/04/2007,34,0,0,0,14,5,0,53
Egypt,28/04/2007,1,0,0,0,0,0,0,1
Egypt,29/04/2007,7,0,0,0,11,1,0,19
Egypt,30/04/2007,48,0,0,0,6,0,0,54
Eritrea,01/04/2007,6,0,0,0,-2,0,0,4
Eritrea,02/04/2007,-15,0,0,0,0,0,0,-15
Eritrea,03/04/2007,-12,0,0,0,0,0,0,-12
Eritrea,04/04/2007,4,0,0,0,-5,0,0,-1
Eritrea,05/04/2007,9,0,0,0,8,1,0,18
Eritrea,06/04/2007,3,0,0,0,0,0,0,3
Eritrea,07/04/2007,9,0,0,0,-2,0,0,7
Eritrea,08/04/2007,3,0,0,0,0,0,0,3
Eritrea,09/04/2007,0,0,0,0,6,0,0,6
Eritrea,10/04/2007,-17,0,0,0,3,2,0,-12
Eritrea,11/04/2007,2,0,0,0,0,0,0,2
Eritrea,12/04/2007,14,0,0,0,6,0,0,20
Eritrea,13/04/2007,6,0,0,0,-2,0,0,4
Eritrea,14/04/2007,2,0,0,0,0,0,0,2
Eritrea,15/04/2007,3,0,0,0,0,0,0,3
Eritrea,16/04/2007,10,0,0,0,-2,0,0,8
Eritrea,17/04/2007,-3,0,0,0,0,0,0,-3
Eritrea,18/04/2007,33,0,0,0,3,0,0,36
Eritrea,19/04/2007,0,0,0,0,0,0,0,0
Eritrea,20/04/2007,2,0,0,0,0,0,0,2
Eritrea,21/04/2007,3,0,0,0,0,0,0,3
Eritrea,22/04/2007,34,0,0,0,-7,0,0,27
Eritrea,23/04/2007,24,0,-3,0,-6,0,0,15
Eritrea,24/04/2007,15,0,0,0,5,2,0,22
Eritrea,25/04/2007,58,0,0,0,6,22,0,86
Eritrea,26/04/2007,13,0,0,0,3,0,0,16
Eritrea,27/04/2007,4,0,0,0,3,0,0,7
Eritrea,28/04/2007,16,0,0,0,0,2,0,18
Eritrea,29/04/2007,6,0,0,0,0,0,0,6
Eritrea,30/04/2007,4,0,0,0,0,0,0,4
Georgia,01/04/2007,5,0,0,0,-4,2,0,3
Georgia,02/04/2007,-1,0,0,0,3,0,0,2
Georgia,03/04/2007,22,0,0,0,1,4,0,27
Georgia,04/04/2007,21,0,3,0,12,2,0,38
Georgia,05/04/2007,1,0,-1,0,-1,0,0,-1
Georgia,06/04/2007,4,0,0,0,6,0,0,10
Georgia,07/04/2007,0,0,0,0,0,0,0,0
Georgia,08/04/2007,4,0,0,0,0,0,0,4
Georgia,09/04/2007,0,0,0,0,6,0,0,6
Georgia,10/04/2007,2,0,0,0,3,0,0,5
Georgia,11/04/2007,4,0,0,0,3,0,0,7
Georgia,12/04/2007,2,0,0,0,0,1,0,3
Georgia,13/04/2007,6,0,0,0,-2,0,0,4
Georgia,14/04/2007,0,0,0,0,0,2,0,2
Georgia,15/04/2007,5,0,0,0,3,0,0,8
Georgia,16/04/2007,1,0,0,0,0,2,0,3
Georgia,17/04/2007,9,0,0,0,-1,0,0,8
Georgia,18/04/2007,19,0,0,0,1,6,0,26
Georgia,19/04/2007,26,0,0,0,3,3,0,32
Georgia,20/04/2007,3,0,0,0,0,0,0,3
Georgia,21/04/2007,13,0,0,0,0,0,0,13
Georgia,22/04/2007,-3,0,0,0,0,0,0,-3
Georgia,23/04/2007,2,0,0,0,0,1,0,3
Georgia,24/04/2007,6,0,0,0,0,0,0,6
Georgia,25/04/2007,3,0,0,0,2,1,0,6
Georgia,26/04/2007,2,0,0,0,0,1,0,3
Georgia,27/04/2007,4,0,0,0,2,0,0,6
Georgia,28/04/2007,1,0,0,0,0,0,0,1
Georgia,29/04/2007,13,0,0,0,3,0,0,16
Georgia,30/04/2007,6,0,0,0,-2,0,0,4
India,01/04/2007,20,0,-2,0,13,3,0,34
India,02/04/2007,30,0,0,0,6,2,0,38
India,03/04/2007,18,0,0,0,12,3,0,33
India,04/04/2007,36,0,-3,0,15,13,0,61
India,05/04/2007,4,0,1,0,5,2,0,12
India,06/04/2007,19,0,0,0,13,3,0,35
India,07/04/2007,18,0,0,0,9,2,0,29
India,08/04/2007,22,0,-2,0,-1,1,0,20
India,09/04/2007,14,0,-1,0,2,4,0,19
India,10/04/2007,7,0,1,0,-8,0,0,0
India,11/04/2007,14,0,0,0,15,10,0,39
India,12/04/2007,34,0,0,0,13,11,0,58
India,13/04/2007,9,0,-3,0,3,1,0,10
India,14/04/2007,4,0,0,0,6,0,0,10
India,15/04/2007,2,0,-4,0,6,0,0,4
India,16/04/2007,41,0,-4,0,3,4,0,44
India,17/04/2007,33,0,0,0,9,3,0,45
India,18/04/2007,23,0,1,0,7,6,0,37
India,19/04/2007,28,0,-2,0,11,6,0,43
India,20/04/2007,50,0,0,0,2,1,0,53
India,21/04/2007,39,0,0,0,9,0,0,48
India,22/04/2007,35,0,-3,0,-2,1,0,31
India,23/04/2007,25,0,-1,0,8,5,0,37
India,24/04/2007,38,0,0,0,39,0,0,77
India,25/04/2007,42,2,0,0,10,0,0,54
India,26/04/2007,16,0,1,0,13,4,0,34
India,27/04/2007,13,0,2,0,12,1,0,28
India,28/04/2007,21,0,-4,0,1,6,0,24
India,29/04/2007,8,0,0,0,-3,1,0,6
India,30/04/2007,32,0,-1,0,9,6,0,46
Iran,01/04/2007,26,0,2,0,49,8,0,85
Iran,02/04/2007,96,2,0,0,44,8,0,150
Iran,03/04/2007,138,2,5,0,52,9,0,206
Iran,04/04/2007,154,0,1,0,46,4,0,205
Iran,05/04/2007,107,2,-1,0,24,14,0,146
Iran,06/04/2007,93,0,-3,0,-25,11,0,76
Iran,07/04/2007,80,0,0,0,33,4,0,117
Iran,08/04/2007,107,0,4,0,22,8,0,141
Iran,09/04/2007,107,0,3,0,61,13,0,184
Iran,10/04/2007,96,2,-1,0,22,18,0,137
Iran,11/04/2007,104,0,-2,0,54,6,0,162
Iran,12/04/2007,65,0,0,0,46,24,0,135
Iran,13/04/2007,62,0,-2,0,-1,3,0,62
Iran,14/04/2007,91,0,0,0,-18,5,0,78
Iran,15/04/2007,66,0,1,0,17,36,0,120
Iran,16/04/2007,52,1,1,0,48,15,0,117
Iran,17/04/2007,70,0,0,0,51,1,0,122
Iran,18/04/2007,88,6,0,0,40,5,0,139
Iran,19/04/2007,112,0,5,0,3,10,0,130
Iran,20/04/2007,34,0,0,0,7,3,0,44
Iran,21/04/2007,30,0,0,0,8,0,0,38
Iran,22/04/2007,36,0,0,0,3,1,0,40
Iran,23/04/2007,71,2,-9,0,37,91,0,192
Iran,24/04/2007,66,0,-2,0,26,96,0,186
Iran,25/04/2007,25,4,0,0,14,11,0,54
Iran,26/04/2007,44,0,0,0,18,4,0,66
Iran,27/04/2007,56,0,1,0,29,7,0,93
Iran,28/04/2007,20,0,0,0,12,5,0,37
Iran,29/04/2007,51,0,0,0,29,10,0,90
Iran,30/04/2007,69,0,0,0,21,3,0,93
Iraq,01/04/2007,90,0,-13,0,50,6,0,133
Iraq,02/04/2007,124,0,-5,0,123,31,0,273
Iraq,03/04/2007,150,0,0,0,33,10,0,193
Iraq,04/04/2007,106,0,2,0,30,4,0,142
Iraq,05/04/2007,165,4,5,0,13,11,0,198
Iraq,06/04/2007,226,0,1,0,78,8,0,313
Iraq,07/04/2007,150,0,-2,0,11,18,0,177
Iraq,08/04/2007,145,2,-6,0,32,22,0,195
Iraq,09/04/2007,161,2,0,0,21,14,0,198
Iraq,10/04/2007,143,0,-1,0,19,14,0,175
Iraq,11/04/2007,238,0,-1,0,42,10,0,289
Iraq,12/04/2007,429,0,-13,0,16,54,0,486
Iraq,13/04/2007,227,0,4,0,26,33,0,290
Iraq,14/04/2007,119,0,0,0,24,10,0,153
Iraq,15/04/2007,138,0,1,0,-7,12,0,144
Iraq,16/04/2007,177,8,-6,0,18,16,0,213
Iraq,17/04/2007,159,20,-10,0,71,28,0,268
Iraq,18/04/2007,105,0,5,0,37,12,0,159
Iraq,19/04/2007,175,2,-4,0,50,6,0,229
Iraq,20/04/2007,109,0,2,0,44,13,0,168
Iraq,21/04/2007,111,0,0,0,33,13,0,157
Iraq,22/04/2007,123,2,2,0,23,23,0,173
Iraq,23/04/2007,144,2,-5,0,53,14,0,208
Iraq,24/04/2007,114,4,3,0,50,13,0,184
Iraq,25/04/2007,160,4,3,0,69,29,0,265
Iraq,26/04/2007,161,0,12,0,70,18,0,261
Iraq,27/04/2007,156,2,1,0,72,39,0,270
Iraq,28/04/2007,193,0,1,0,30,23,0,247
Iraq,29/04/2007,92,0,1,0,20,16,0,129
Iraq,30/04/2007,240,2,4,0,124,10,0,380
Morocco,01/04/2007,-2,0,0,0,0,2,0,0
Morocco,02/04/2007,4,0,1,0,0,0,0,5
Morocco,03/04/2007,2,0,0,0,12,1,0,15
Morocco,04/04/2007,0,0,0,0,0,0,0,0
Morocco,05/04/2007,9,0,0,0,2,0,0,11
Morocco,06/04/2007,0,0,0,0,-2,0,0,-2
Morocco,07/04/2007,0,0,0,0,-1,0,0,-1
Morocco,08/04/2007,2,0,0,0,0,0,0,2
Morocco,09/04/2007,2,0,0,0,0,0,0,2
Morocco,10/04/2007,3,0,0,0,0,0,0,3
Morocco,11/04/2007,18,0,0,0,15,6,0,39
Morocco,12/04/2007,25,0,0,0,6,0,0,31
Morocco,13/04/2007,7,0,0,0,0,0,0,7
Morocco,14/04/2007,1,0,0,0,6,3,0,10
Morocco,15/04/2007,1,0,0,0,6,0,0,7
Morocco,16/04/2007,6,0,0,0,0,0,0,6
Morocco,17/04/2007,4,0,0,0,22,2,0,28
Morocco,18/04/2007,3,0,0,0,9,0,0,12
Morocco,19/04/2007,-3,0,0,0,0,0,0,-3
Morocco,20/04/2007,3,0,0,0,6,0,0,9
Morocco,21/04/2007,-15,0,0,0,0,0,0,-15
Morocco,22/04/2007,0,0,0,0,3,0,0,3
Morocco,23/04/2007,16,0,0,0,9,0,0,25
Morocco,24/04/2007,1,0,0,0,0,0,0,1
Morocco,25/04/2007,0,0,0,0,0,0,0,0
Morocco,26/04/2007,0,0,0,0,0,1,0,1
Morocco,27/04/2007,3,0,0,0,0,3,0,6
Morocco,28/04/2007,0,0,0,0,0,0,0,0
Morocco,29/04/2007,0,0,0,0,0,0,0,0
Morocco,30/04/2007,7,0,0,0,3,0,0,10
Nigeria,01/04/2007,-1,0,0,0,7,0,0,6
Nigeria,02/04/2007,12,0,0,0,-2,4,0,14
Nigeria,03/04/2007,3,0,0,0,30,0,0,33
Nigeria,04/04/2007,8,0,-2,0,22,0,0,28
Nigeria,05/04/2007,13,0,0,0,18,6,0,37
Nigeria,06/04/2007,3,0,0,0,0,0,0,3
Nigeria,07/04/2007,0,0,0,0,6,0,0,6
Nigeria,08/04/2007,15,0,0,0,0,0,0,15
Nigeria,09/04/2007,21,0,0,0,1,0,0,22
Nigeria,10/04/2007,9,0,0,0,3,2,0,14
Nigeria,11/04/2007,9,0,-2,0,3,4,0,14
Nigeria,12/04/2007,14,0,0,0,20,0,0,34
Nigeria,13/04/2007,4,0,-2,0,12,0,0,14
Nigeria,14/04/2007,18,0,-2,0,9,6,0,31
Nigeria,15/04/2007,1,0,0,0,6,0,0,7
Nigeria,16/04/2007,50,0,0,0,27,2,0,79
Nigeria,17/04/2007,24,0,-2,0,3,3,0,28
Nigeria,18/04/2007,33,0,2,0,6,0,0,41
Nigeria,19/04/2007,0,0,1,0,0,2,0,3
Nigeria,20/04/2007,8,2,-4,0,5,0,0,11
Nigeria,21/04/2007,16,0,-2,0,0,1,0,15
Nigeria,22/04/2007,16,0,-9,0,7,1,0,15
Nigeria,23/04/2007,83,0,0,0,-10,4,0,77
Nigeria,24/04/2007,57,0,0,0,46,2,0,105
Nigeria,25/04/2007,18,0,8,0,21,2,0,49
Nigeria,26/04/2007,11,0,-4,0,34,2,0,43
Nigeria,27/04/2007,16,0,-1,0,4,1,0,20
Nigeria,28/04/2007,15,0,0,0,0,6,0,21
Nigeria,29/04/2007,1,0,0,0,3,6,0,10
Nigeria,30/04/2007,4,0,0,0,6,4,0,14
Pakistan,01/04/2007,53,0,0,0,13,2,0,68
Pakistan,02/04/2007,24,2,1,0,6,4,0,37
Pakistan,03/04/2007,74,0,0,0,26,11,0,111
Pakistan,04/04/2007,45,0,0,0,-8,0,0,37
Pakistan,05/04/2007,60,0,0,0,27,9,0,96
Pakistan,06/04/2007,44,2,0,0,23,1,0,70
Pakistan,07/04/2007,10,0,0,0,12,0,0,22
Pakistan,08/04/2007,3,0,0,0,6,1,0,10
Pakistan,09/04/2007,15,0,0,0,0,1,0,16
Pakistan,10/04/2007,37,0,0,0,-6,4,0,35
Pakistan,11/04/2007,2,0,0,0,7,0,0,9
Pakistan,12/04/2007,28,0,0,0,6,3,0,37
Pakistan,13/04/2007,20,2,0,0,0,3,0,25
Pakistan,14/04/2007,12,0,-2,0,-5,3,0,8
Pakistan,15/04/2007,30,0,0,0,32,0,0,62
Pakistan,16/04/2007,54,0,0,0,9,10,0,73
Pakistan,17/04/2007,57,0,0,0,13,0,0,70
Pakistan,18/04/2007,20,0,0,0,17,4,0,41
Pakistan,19/04/2007,60,0,0,0,15,5,0,80
Pakistan,20/04/2007,14,0,0,0,3,1,0,18
Pakistan,21/04/2007,35,0,0,0,16,3,0,54
Pakistan,22/04/2007,39,0,0,0,18,2,0,59
Pakistan,23/04/2007,23,0,0,0,0,5,0,28
Pakistan,24/04/2007,97,0,0,0,6,1,0,104
Pakistan,25/04/2007,63,0,0,0,18,3,0,84
Pakistan,26/04/2007,56,0,0,0,19,0,0,75
Pakistan,27/04/2007,56,0,-4,0,6,10,0,68
Pakistan,28/04/2007,65,0,0,0,9,2,0,76
Pakistan,29/04/2007,42,0,-1,0,1,15,0,57
Pakistan,30/04/2007,108,0,-2,0,85,8,0,199
Sierra Leone,01/04/2007,4,0,0,0,0,0,0,4
Sierra Leone,02/04/2007,0,0,0,0,0,0,0,0
Sierra Leone,03/04/2007,0,0,0,0,6,0,0,6
Sierra Leone,04/04/2007,3,0,0,0,3,2,0,8
Sierra Leone,05/04/2007,0,0,0,0,0,0,0,0
Sierra Leone,06/04/2007,-1,0,0,0,0,0,0,-1
Sierra Leone,07/04/2007,0,0,0,0,0,0,0,0
Sierra Leone,08/04/2007,0,0,0,0,0,0,0,0
Sierra Leone,09/04/2007,2,0,0,0,0,0,0,2
Sierra Leone,10/04/2007,2,0,0,0,6,0,0,8
Sierra Leone,11/04/2007,0,0,0,0,0,0,0,0
Sierra Leone,12/04/2007,1,0,0,0,0,0,0,1
Sierra Leone,13/04/2007,3,0,0,0,0,0,0,3
Sierra Leone,14/04/2007,3,0,0,0,0,0,0,3
Sierra Leone,15/04/2007,0,0,0,0,0,0,0,0
Sierra Leone,16/04/2007,1,0,0,0,0,0,0,1
Sierra Leone,17/04/2007,0,0,0,0,0,0,0,0
Sierra Leone,18/04/2007,2,0,0,0,0,7,0,9
Sierra Leone,19/04/2007,0,0,0,0,3,4,0,7
Sierra Leone,20/04/2007,2,0,0,0,0,0,0,2
Sierra Leone,23/04/2007,0,0,0,0,9,0,0,9
Sierra Leone,24/04/2007,1,0,0,0,3,0,0,4
Sierra Leone,25/04/2007,-4,0,0,0,9,0,0,5
Sierra Leone,26/04/2007,0,0,0,0,6,0,0,6
Sierra Leone,27/04/2007,0,0,0,0,0,0,0,0
Sierra Leone,28/04/2007,0,0,0,0,0,0,0,0
Sierra Leone,29/04/2007,-2,0,0,0,6,4,0,8
Sierra Leone,30/04/2007,0,0,0,0,0,0,0,0
Somalia,01/04/2007,3,0,0,0,9,0,0,12
Somalia,02/04/2007,5,0,0,0,5,0,0,10
Somalia,03/04/2007,18,0,0,0,16,0,0,34
Somalia,04/04/2007,3,0,0,0,32,0,0,35
Somalia,05/04/2007,12,0,0,0,9,0,0,21
Somalia,06/04/2007,7,0,0,0,28,0,0,35
Somalia,07/04/2007,0,0,0,0,-14,0,0,-14
Somalia,08/04/2007,4,0,0,0,15,4,0,23
Somalia,09/04/2007,18,0,1,0,-2,2,0,19
Somalia,10/04/2007,20,0,0,0,28,0,0,48
Somalia,11/04/2007,-1,0,0,0,16,2,0,17
Somalia,12/04/2007,14,0,0,0,0,0,0,14
Somalia,13/04/2007,4,0,0,0,3,0,0,7
Somalia,14/04/2007,9,0,0,0,3,0,0,12
Somalia,15/04/2007,5,0,0,0,6,0,0,11
Somalia,16/04/2007,20,0,0,0,12,3,0,35
Somalia,17/04/2007,16,0,0,0,0,0,0,16
Somalia,18/04/2007,7,0,0,0,3,0,0,10
Somalia,19/04/2007,3,0,0,0,18,0,0,21
Somalia,20/04/2007,7,0,0,0,0,0,0,7
Somalia,21/04/2007,3,0,0,0,36,0,0,39
Somalia,22/04/2007,3,0,0,0,26,2,0,31
Somalia,23/04/2007,39,0,0,0,0,0,0,39
Somalia,24/04/2007,24,2,0,0,21,2,0,49
Somalia,25/04/2007,46,0,0,0,29,0,0,75
Somalia,26/04/2007,17,0,0,0,29,0,0,46
Somalia,27/04/2007,6,0,0,0,0,0,0,6
Somalia,28/04/2007,0,0,0,0,6,3,0,9
Somalia,29/04/2007,32,0,0,0,-26,0,0,6
Somalia,30/04/2007,2,0,-2,0,-8,2,0,-6
Syria,01/04/2007,41,0,-4,0,9,0,0,46
Syria,02/04/2007,23,0,0,0,9,0,0,32
Syria,03/04/2007,33,0,-4,0,7,2,0,38
Syria,04/04/2007,28,0,1,0,9,0,0,38
Syria,05/04/2007,10,0,0,0,-22,0,0,-12
Syria,06/04/2007,20,0,-4,0,0,0,0,16
Syria,07/04/2007,6,0,0,0,-1,0,0,5
Syria,08/04/2007,17,0,-14,0,4,0,0,7
Syria,09/04/2007,15,0,-4,0,0,0,0,11
Syria,10/04/2007,-8,0,0,0,3,0,0,-5
Syria,11/04/2007,4,0,0,0,-2,5,0,7
Syria,12/04/2007,-2,0,0,0,3,1,0,2
Syria,13/04/2007,12,0,0,0,1,0,0,13
Syria,14/04/2007,-3,0,0,0,6,6,0,9
Syria,15/04/2007,6,0,0,0,0,0,0,6
Syria,16/04/2007,13,0,0,0,0,4,0,17
Syria,17/04/2007,0,6,0,0,9,0,0,15
Syria,18/04/2007,11,6,0,0,15,6,0,38
Syria,19/04/2007,21,0,-4,0,4,12,0,33
Syria,20/04/2007,23,0,-1,0,0,3,0,25
Syria,21/04/2007,8,0,0,0,0,1,0,9
Syria,22/04/2007,16,0,0,0,3,0,0,19
Syria,23/04/2007,17,0,-2,0,13,0,0,28
Syria,24/04/2007,12,0,0,0,13,1,0,26
Syria,25/04/2007,26,0,-2,0,33,6,0,63
Syria,26/04/2007,26,0,-1,0,9,4,0,38
Syria,27/04/2007,31,0,0,0,15,2,0,48
Syria,28/04/2007,8,0,0,0,12,6,0,26
Syria,29/04/2007,4,0,0,0,9,0,0,13
Syria,30/04/2007,9,0,0,0,0,0,0,9
Yemen,01/04/2007,13,0,0,0,1,0,0,14
Yemen,02/04/2007,2,0,0,0,6,0,0,8
Yemen,03/04/2007,0,0,0,0,6,0,0,6
Yemen,04/04/2007,12,0,0,0,3,6,0,21
Yemen,05/04/2007,2,0,0,0,6,0,0,8
Yemen,06/04/2007,4,0,0,0,0,0,0,4
Yemen,07/04/2007,8,0,0,0,0,4,0,12
Yemen,08/04/2007,9,0,0,0,0,2,0,11
Yemen,09/04/2007,4,0,2,0,21,4,0,31
Yemen,10/04/2007,19,0,2,0,21,1,0,43
Yemen,12/04/2007,12,0,0,0,0,0,0,12
Yemen,13/04/2007,10,0,0,0,0,0,0,10
Yemen,14/04/2007,3,0,0,0,0,0,0,3
Yemen,15/04/2007,3,0,0,0,0,3,0,6
Yemen,16/04/2007,4,0,0,0,13,0,0,17
Yemen,17/04/2007,1,0,0,0,6,2,0,9
Yemen,18/04/2007,0,0,0,0,0,1,0,1
Yemen,19/04/2007,0,0,0,0,0,0,0,0
Yemen,20/04/2007,0,0,0,0,0,0,0,0
Yemen,21/04/2007,0,0,0,0,0,0,0,0
Yemen,22/04/2007,3,0,0,0,3,0,0,6
Yemen,24/04/2007,0,0,0,0,0,0,0,0
Yemen,25/04/2007,1,0,0,0,12,0,0,13
Yemen,26/04/2007,4,0,0,0,-2,0,0,2
Yemen,28/04/2007,7,0,0,0,0,1,0,8
Yemen,29/04/2007,-1,0,0,0,0,0,0,-1
Yemen,30/04/2007,9,0,0,0,0,1,0,10
Afghanistan,01/10/2007,46,0,0,0,18,0,0,64
Afghanistan,02/10/2007,114,0,0,0,15,20,0,149
Afghanistan,03/10/2007,89,2,1,0,-5,16,0,103
Afghanistan,04/10/2007,62,0,0,0,22,10,0,94
Afghanistan,05/10/2007,60,0,0,0,7,13,0,80
Afghanistan,06/10/2007,165,0,0,0,11,18,0,194
Afghanistan,07/10/2007,277,0,0,0,30,14,0,321
Afghanistan,08/10/2007,240,2,2,0,9,22,0,275
Afghanistan,09/10/2007,270,0,1,0,35,38,0,344
Afghanistan,10/10/2007,159,0,-4,0,16,15,0,186
Afghanistan,11/10/2007,93,0,0,0,17,5,0,115
Afghanistan,12/10/2007,170,0,2,0,14,8,0,194
Afghanistan,13/10/2007,72,0,0,0,21,4,0,97
Afghanistan,14/10/2007,46,0,0,0,-10,3,0,39
Afghanistan,15/10/2007,52,2,-2,0,9,10,0,71
Afghanistan,16/10/2007,37,0,0,0,10,5,0,52
Afghanistan,17/10/2007,141,0,0,0,8,4,0,153
Afghanistan,18/10/2007,91,6,0,0,12,6,0,115
Afghanistan,19/10/2007,151,4,0,0,-3,13,0,165
Afghanistan,20/10/2007,71,0,0,0,6,7,0,84
Afghanistan,21/10/2007,115,4,0,0,4,5,0,128
Afghanistan,22/10/2007,122,6,0,0,13,4,0,145
Afghanistan,23/10/2007,140,6,0,0,55,7,0,208
Afghanistan,24/10/2007,178,2,0,0,56,9,0,245
Afghanistan,25/10/2007,140,0,1,0,119,16,0,276
Afghanistan,26/10/2007,77,2,0,0,18,3,0,100
Afghanistan,27/10/2007,146,2,0,0,61,8,0,217
Afghanistan,28/10/2007,117,6,0,0,27,4,0,154
Afghanistan,29/10/2007,41,2,0,0,33,20,0,96
Afghanistan,30/10/2007,80,0,-3,0,24,2,0,103
Afghanistan,31/10/2007,180,0,-1,0,15,11,0,205
Albania,01/10/2007,0,0,1,0,0,0,0,1
Albania,02/10/2007,28,0,0,0,9,1,0,38
Albania,03/10/2007,8,0,0,0,-1,0,0,7
Albania,04/10/2007,24,0,-2,0,12,1,0,35
Albania,05/10/2007,12,0,-1,0,0,0,0,11
Albania,06/10/2007,10,0,0,0,0,0,0,10
Albania,07/10/2007,12,0,0,0,0,1,0,13
Albania,08/10/2007,6,0,0,0,6,0,0,12
Albania,09/10/2007,6,0,0,0,5,4,0,15
Albania,10/10/2007,10,0,-1,0,1,4,0,14
Albania,11/10/2007,3,0,-2,0,0,2,0,3
Albania,12/10/2007,13,0,-5,0,0,0,0,8
Albania,13/10/2007,6,0,0,0,0,0,0,6
Albania,14/10/2007,37,0,-4,0,-2,1,0,32
Albania,15/10/2007,65,0,-3,0,2,0,0,64
Albania,16/10/2007,44,0,0,0,13,15,0,72
Albania,17/10/2007,16,0,-4,0,18,6,0,36
Albania,18/10/2007,19,0,-1,0,0,0,0,18
Albania,19/10/2007,22,0,-2,0,36,5,0,61
Albania,20/10/2007,17,0,0,0,0,1,0,18
Albania,21/10/2007,2,0,-3,0,0,0,0,-1
Albania,22/10/2007,10,0,-9,0,3,0,0,4
Albania,23/10/2007,6,0,-2,0,0,0,0,4
Albania,24/10/2007,14,0,-2,0,6,2,0,20
Albania,25/10/2007,6,0,-1,0,3,0,0,8
Albania,26/10/2007,4,0,0,0,0,0,0,4
Albania,27/10/2007,2,0,0,0,0,0,0,2
Albania,28/10/2007,3,0,0,0,12,0,0,15
Albania,29/10/2007,6,0,0,0,3,1,0,10
Albania,30/10/2007,1,0,0,0,9,0,0,10
Albania,31/10/2007,1,0,0,0,5,0,0,6
Algeria,01/10/2007,0,0,0,0,0,0,0,0
Algeria,02/10/2007,5,0,0,0,6,0,0,11
Algeria,03/10/2007,27,0,0,0,3,0,0,30
Algeria,04/10/2007,0,0,0,0,6,0,0,6
Algeria,05/10/2007,3,0,0,0,0,0,0,3
Algeria,06/10/2007,7,0,0,0,0,1,0,8
Algeria,07/10/2007,13,0,-6,0,6,5,0,18
Algeria,08/10/2007,-2,0,0,0,9,0,0,7
Algeria,09/10/2007,0,0,0,0,0,0,0,0
Algeria,10/10/2007,23,0,0,0,24,0,0,47
Algeria,11/10/2007,8,0,0,0,6,0,0,14
Algeria,12/10/2007,16,0,0,0,0,0,0,16
Algeria,14/10/2007,4,0,0,0,0,0,0,4
Algeria,15/10/2007,10,0,0,0,3,0,0,13
Algeria,16/10/2007,0,0,0,0,18,1,0,19
Algeria,17/10/2007,4,0,0,0,6,0,0,10
Algeria,18/10/2007,3,0,0,0,7,0,0,10
Algeria,19/10/2007,3,0,0,0,3,0,0,6
Algeria,20/10/2007,0,0,0,0,0,3,0,3
Algeria,21/10/2007,0,0,0,0,0,0,0,0
Algeria,22/10/2007,0,0,0,0,-2,0,0,-2
Algeria,23/10/2007,1,0,0,0,0,0,0,1
Algeria,24/10/2007,8,0,0,0,26,0,0,34
Algeria,25/10/2007,0,0,0,0,0,0,0,0
Algeria,26/10/2007,0,0,0,0,3,0,0,3
Algeria,27/10/2007,1,0,0,0,15,0,0,16
Algeria,28/10/2007,6,0,0,0,6,0,0,12
Algeria,29/10/2007,-1,0,1,0,27,0,0,27
Algeria,30/10/2007,0,0,0,0,0,0,0,0
Algeria,31/10/2007,3,0,0,0,12,0,0,15
Bangladesh,01/10/2007,4,0,0,0,30,0,0,34
Bangladesh,02/10/2007,4,0,0,0,12,4,0,20
Bangladesh,03/10/2007,12,0,0,0,1,0,0,13
Bangladesh,04/10/2007,-4,0,0,0,17,6,0,19
Bangladesh,05/10/2007,9,0,0,0,6,1,0,16
Bangladesh,06/10/2007,7,0,0,0,-1,0,0,6
Bangladesh,07/10/2007,11,0,-2,0,11,1,0,21
Bangladesh,08/10/2007,0,0,-1,0,57,0,0,56
Bangladesh,09/10/2007,9,0,1,0,14,1,0,25
Bangladesh,10/10/2007,10,0,0,0,0,0,0,10
Bangladesh,11/10/2007,11,0,0,0,6,0,0,17
Bangladesh,12/10/2007,12,0,0,0,12,0,0,24
Bangladesh,13/10/2007,1,0,0,0,0,1,0,2
Bangladesh,14/10/2007,0,0,0,0,0,3,0,3
Bangladesh,15/10/2007,13,2,0,0,0,0,0,15
Bangladesh,16/10/2007,0,0,0,0,6,0,0,6
Bangladesh,17/10/2007,17,2,0,0,0,2,0,21
Bangladesh,18/10/2007,7,0,0,0,6,6,0,19
Bangladesh,19/10/2007,12,0,0,0,4,0,0,16
Bangladesh,20/10/2007,4,0,0,0,3,0,0,7
Bangladesh,21/10/2007,4,0,0,0,-1,0,0,3
Bangladesh,22/10/2007,1,0,-2,0,9,0,0,8
Bangladesh,23/10/2007,-3,0,0,0,9,0,0,6
Bangladesh,24/10/2007,1,0,0,0,-1,1,0,1
Bangladesh,25/10/2007,0,0,0,0,-2,0,0,-2
Bangladesh,26/10/2007,6,0,0,0,18,18,0,42
Bangladesh,27/10/2007,3,0,0,0,0,0,0,3
Bangladesh,28/10/2007,1,0,0,0,3,6,0,10
Bangladesh,29/10/2007,11,0,0,0,24,4,0,39
Bangladesh,30/10/2007,8,0,0,0,66,4,0,78
Bangladesh,31/10/2007,16,0,0,0,3,0,0,19
Cameroon,01/10/2007,1,0,0,0,6,0,0,7
Cameroon,02/10/2007,6,0,0,0,3,1,0,10
Cameroon,03/10/2007,6,0,0,0,0,0,0,6
Cameroon,04/10/2007,8,0,0,0,16,4,0,28
Cameroon,05/10/2007,0,0,0,0,0,0,0,0
Cameroon,06/10/2007,0,0,0,0,0,0,0,0
Cameroon,08/10/2007,0,0,0,0,0,0,0,0
Cameroon,09/10/2007,4,0,0,0,0,0,0,4
Cameroon,10/10/2007,0,0,0,0,3,2,0,5
Cameroon,11/10/2007,0,0,0,0,0,0,0,0
Cameroon,12/10/2007,0,0,0,0,6,0,0,6
Cameroon,13/10/2007,0,0,0,0,0,0,0,0
Cameroon,14/10/2007,0,0,0,0,3,0,0,3
Cameroon,15/10/2007,0,0,0,0,0,0,0,0
Cameroon,18/10/2007,0,0,0,0,0,0,0,0
Cameroon,19/10/2007,3,0,0,0,0,2,0,5
Cameroon,22/10/2007,3,0,0,0,0,0,0,3
Cameroon,23/10/2007,0,0,0,0,0,1,0,1
Cameroon,24/10/2007,0,0,0,0,0,0,0,0
Cameroon,26/10/2007,0,0,0,0,0,0,0,0
Cameroon,27/10/2007,0,0,0,0,0,0,0,0
Cameroon,28/10/2007,0,0,0,0,0,0,0,0
Cameroon,29/10/2007,2,0,0,0,0,0,0,2
Cameroon,30/10/2007,2,0,0,0,0,0,0,2
Cameroon,31/10/2007,0,0,0,0,0,0,0,0
China,01/10/2007,25,0,0,0,10,3,0,38
China,02/10/2007,130,2,-10,0,15,28,0,165
China,03/10/2007,86,0,2,0,52,8,0,148
China,04/10/2007,97,0,1,0,16,18,0,132
China,05/10/2007,92,0,1,0,22,6,0,121
China,06/10/2007,81,0,-1,0,9,6,0,95
China,07/10/2007,59,0,0,0,-4,3,0,58
China,08/10/2007,86,0,0,0,5,15,0,106
China,09/10/2007,46,0,0,0,5,12,0,63
China,10/10/2007,74,0,0,0,48,1,0,123
China,11/10/2007,60,2,-8,0,26,3,0,83
China,12/10/2007,84,2,-1,0,9,8,0,102
China,13/10/2007,17,0,0,0,21,1,0,39
China,14/10/2007,37,0,-4,0,19,4,0,56
China,15/10/2007,39,0,2,0,33,14,0,88
China,16/10/2007,15,8,0,0,10,1,0,34
China,17/10/2007,66,2,2,0,23,9,0,102
China,18/10/2007,71,0,-3,0,35,10,0,113
China,19/10/2007,97,0,-5,0,3,14,0,109
China,20/10/2007,36,0,0,0,3,7,0,46
China,21/10/2007,49,0,-1,0,13,9,0,70
China,22/10/2007,52,8,-4,0,33,14,0,103
China,23/10/2007,72,0,-1,0,14,5,0,90
China,24/10/2007,99,0,-1,0,27,7,0,132
China,25/10/2007,11,0,-6,0,6,0,0,11
China,26/10/2007,21,4,0,0,1,0,0,26
China,27/10/2007,26,0,1,0,16,15,0,58
China,28/10/2007,33,0,-5,0,16,3,0,47
China,29/10/2007,48,0,7,0,18,30,0,103
China,30/10/2007,44,0,3,0,34,10,0,91
China,31/10/2007,86,4,-1,0,16,4,0,109
Egypt,01/10/2007,0,0,0,0,3,0,0,3
Egypt,02/10/2007,3,0,0,0,24,2,0,29
Egypt,03/10/2007,32,0,4,0,10,5,0,51
Egypt,04/10/2007,17,0,0,0,6,0,0,23
Egypt,05/10/2007,5,0,0,0,4,2,0,11
Egypt,06/10/2007,11,0,0,0,24,4,0,39
Egypt,07/10/2007,19,0,0,0,15,0,0,34
Egypt,08/10/2007,39,0,0,0,18,1,0,58
Egypt,09/10/2007,7,0,0,0,11,2,0,20
Egypt,10/10/2007,11,0,0,0,57,0,0,68
Egypt,11/10/2007,37,0,0,0,18,2,0,57
Egypt,12/10/2007,19,0,0,0,-7,2,0,14
Egypt,13/10/2007,-4,0,0,0,0,2,0,-2
Egypt,14/10/2007,18,0,0,0,-2,2,0,18
Egypt,15/10/2007,39,0,0,0,18,1,0,58
Egypt,16/10/2007,10,0,0,0,24,0,0,34
Egypt,17/10/2007,9,0,0,0,22,2,0,33
Egypt,18/10/2007,83,0,0,0,31,2,0,116
Egypt,19/10/2007,64,0,0,0,9,0,0,73
Egypt,20/10/2007,20,0,-8,0,6,2,0,20
Egypt,21/10/2007,10,0,0,0,-1,0,0,9
Egypt,22/10/2007,29,0,0,0,6,2,0,37
Egypt,23/10/2007,25,0,0,0,-11,2,0,16
Egypt,24/10/2007,16,0,0,0,-10,4,0,10
Egypt,25/10/2007,-1,0,1,0,3,0,0,3
Egypt,26/10/2007,11,0,0,0,6,0,0,17
Egypt,27/10/2007,5,0,0,0,6,2,0,13
Egypt,28/10/2007,0,0,-2,0,3,2,0,3
Egypt,29/10/2007,6,0,0,0,18,1,0,25
Egypt,30/10/2007,21,0,1,0,19,2,0,43
Egypt,31/10/2007,2,0,0,0,79,11,0,92
Eritrea,02/10/2007,-2,0,0,0,0,0,0,-2
Eritrea,03/10/2007,9,0,0,0,3,0,0,12
Eritrea,04/10/2007,12,0,0,0,0,0,0,12
Eritrea,05/10/2007,3,0,0,0,0,0,0,3
Eritrea,06/10/2007,0,0,0,0,0,0,0,0
Eritrea,07/10/2007,0,0,0,0,0,0,0,0
Eritrea,08/10/2007,2,0,0,0,0,0,0,2
Eritrea,09/10/2007,0,0,0,0,0,0,0,0
Eritrea,10/10/2007,4,0,0,0,7,0,0,11
Eritrea,11/10/2007,3,6,0,0,-4,1,0,6
Eritrea,12/10/2007,16,0,0,0,0,0,0,16
Eritrea,13/10/2007,23,0,0,0,0,0,0,23
Eritrea,14/10/2007,5,0,0,0,6,0,0,11
Eritrea,15/10/2007,0,0,0,0,0,0,0,0
Eritrea,17/10/2007,7,0,0,0,4,4,0,15
Eritrea,18/10/2007,6,0,0,0,0,0,0,6
Eritrea,19/10/2007,22,0,0,0,3,0,0,25
Eritrea,20/10/2007,13,0,0,0,0,0,0,13
Eritrea,21/10/2007,6,0,0,0,0,0,0,6
Eritrea,23/10/2007,0,0,0,0,0,0,0,0
Eritrea,24/10/2007,2,0,0,0,0,0,0,2
Eritrea,25/10/2007,0,0,0,0,0,0,0,0
Eritrea,26/10/2007,2,0,0,0,0,0,0,2
Eritrea,27/10/2007,8,0,0,0,5,0,0,13
Eritrea,28/10/2007,-3,0,0,0,0,0,0,-3
Eritrea,29/10/2007,0,0,0,0,0,0,0,0
Eritrea,30/10/2007,1,0,0,0,-4,0,0,-3
Eritrea,31/10/2007,-4,0,0,0,0,0,0,-4
Georgia,01/10/2007,7,0,0,0,0,0,0,7
Georgia,02/10/2007,4,0,0,0,9,2,0,15
Georgia,03/10/2007,4,0,0,0,12,0,0,16
Georgia,04/10/2007,-2,0,1,0,6,0,0,5
Georgia,05/10/2007,0,0,0,0,3,0,0,3
Georgia,06/10/2007,1,0,0,0,0,0,0,1
Georgia,07/10/2007,0,0,0,0,0,0,0,0
Georgia,08/10/2007,4,0,0,0,-3,3,0,4
Georgia,09/10/2007,5,0,0,0,12,1,0,18
Georgia,10/10/2007,0,0,0,0,4,0,0,4
Georgia,11/10/2007,10,0,0,0,-4,0,0,6
Georgia,12/10/2007,8,0,0,0,-2,0,0,6
Georgia,13/10/2007,9,0,0,0,0,1,0,10
Georgia,14/10/2007,0,0,0,0,6,0,0,6
Georgia,15/10/2007,1,0,-2,0,3,2,0,4
Georgia,16/10/2007,3,0,0,0,6,2,0,11
Georgia,17/10/2007,22,0,0,0,12,4,0,38
Georgia,18/10/2007,28,0,0,0,1,0,0,29
Georgia,19/10/2007,11,0,0,0,3,2,0,16
Georgia,20/10/2007,6,0,0,0,18,0,0,24
Georgia,21/10/2007,8,2,0,0,9,6,0,25
Georgia,22/10/2007,3,4,1,0,9,0,0,17
Georgia,23/10/2007,14,0,1,0,7,1,0,23
Georgia,24/10/2007,25,0,0,0,0,7,0,32
Georgia,25/10/2007,0,0,0,0,3,1,0,4
Georgia,26/10/2007,4,0,0,0,0,0,0,4
Georgia,27/10/2007,0,0,1,0,17,1,0,19
Georgia,28/10/2007,2,0,0,0,1,0,0,3
Georgia,29/10/2007,8,0,0,0,3,0,0,11
Georgia,30/10/2007,7,0,0,0,3,1,0,11
Georgia,31/10/2007,7,0,0,0,3,2,0,12
India,01/10/2007,0,0,1,0,-2,0,0,-1
India,02/10/2007,50,0,1,0,27,13,0,91
India,03/10/2007,40,8,0,0,9,4,0,61
India,04/10/2007,49,0,-4,0,-1,7,0,51
India,05/10/2007,30,0,0,0,4,-4,0,30
India,06/10/2007,11,0,0,0,-2,1,0,10
India,07/10/2007,16,0,0,0,1,0,0,17
India,08/10/2007,52,4,1,0,4,3,0,64
India,09/10/2007,21,0,-4,0,1,0,0,18
India,10/10/2007,5,0,-1,0,1,2,0,7
India,11/10/2007,29,0,-2,0,6,3,0,36
India,12/10/2007,22,0,0,0,2,4,0,28
India,13/10/2007,16,0,0,0,10,1,0,27
India,14/10/2007,19,2,0,0,0,0,0,21
India,15/10/2007,17,0,0,0,0,0,0,17
India,16/10/2007,6,0,0,0,0,2,0,8
India,17/10/2007,35,0,-1,0,7,4,0,45
India,18/10/2007,29,0,-3,0,25,4,0,55
India,19/10/2007,61,0,-2,0,27,6,0,92
India,20/10/2007,38,0,0,0,10,6,0,54
India,21/10/2007,8,0,0,0,-5,1,0,4
India,22/10/2007,38,0,0,0,4,11,0,53
India,23/10/2007,19,0,0,0,9,4,0,32
India,24/10/2007,25,0,-1,0,10,6,0,40
India,25/10/2007,6,0,0,0,0,1,0,7
India,26/10/2007,6,0,0,0,-1,0,0,5
India,27/10/2007,32,0,-4,0,6,10,0,44
India,28/10/2007,33,0,0,0,0,4,0,37
India,29/10/2007,43,0,0,0,16,0,0,59
India,30/10/2007,45,0,-3,0,27,12,0,81
India,31/10/2007,31,0,-4,0,-5,7,0,29
Iran,01/10/2007,20,0,0,0,12,2,0,34
Iran,02/10/2007,106,2,3,0,46,12,0,169
Iran,03/10/2007,61,2,0,0,0,4,0,67
Iran,04/10/2007,61,0,-3,0,4,5,0,67
Iran,05/10/2007,95,0,0,0,9,13,0,117
Iran,06/10/2007,52,0,0,0,4,6,0,62
Iran,07/10/2007,63,0,0,0,33,6,0,102
Iran,08/10/2007,56,0,1,0,19,14,0,90
Iran,09/10/2007,51,0,0,0,26,1,0,78
Iran,10/10/2007,28,2,8,0,21,11,0,70
Iran,11/10/2007,73,0,4,0,43,3,0,123
Iran,12/10/2007,83,0,3,0,40,2,0,128
Iran,13/10/2007,69,0,1,0,9,6,0,85
Iran,14/10/2007,27,0,0,0,-4,8,0,31
Iran,15/10/2007,49,4,1,0,22,9,0,85
Iran,16/10/2007,18,0,-2,0,-4,0,0,12
Iran,17/10/2007,78,0,-2,0,15,4,0,95
Iran,18/10/2007,53,0,2,0,61,4,0,120
Iran,19/10/2007,45,0,1,0,27,3,0,76
Iran,20/10/2007,54,0,-12,0,9,3,0,54
Iran,21/10/2007,81,0,-2,0,15,9,0,103
Iran,22/10/2007,95,0,-4,0,39,2,0,132
Iran,23/10/2007,130,2,0,0,25,7,0,164
Iran,24/10/2007,72,0,-16,0,-1,4,0,59
Iran,25/10/2007,17,0,1,0,6,0,0,24
Iran,26/10/2007,103,0,0,0,0,6,0,109
Iran,27/10/2007,88,0,1,0,-2,10,0,97
Iran,28/10/2007,69,0,0,0,12,7,0,88
Iran,29/10/2007,25,4,0,0,9,11,0,49
Iran,30/10/2007,29,0,-7,0,25,9,0,56
Iran,31/10/2007,85,0,0,0,19,15,0,119
Iraq,01/10/2007,9,0,0,0,7,18,0,34
Iraq,02/10/2007,363,12,-7,0,50,29,0,447
Iraq,03/10/2007,173,0,6,0,25,5,0,209
Iraq,04/10/2007,265,0,4,0,63,19,0,351
Iraq,05/10/2007,113,0,0,0,10,3,0,126
Iraq,06/10/2007,96,2,-2,0,18,7,0,121
Iraq,07/10/2007,48,0,-1,0,28,15,0,90
Iraq,08/10/2007,212,0,2,0,27,12,0,253
Iraq,09/10/2007,281,0,1,0,64,20,0,366
Iraq,10/10/2007,231,0,-10,0,49,12,0,282
Iraq,11/10/2007,281,0,-3,0,14,9,0,301
Iraq,12/10/2007,163,0,5,0,21,13,0,202
Iraq,13/10/2007,101,0,2,0,17,12,0,132
Iraq,14/10/2007,168,2,0,0,23,5,0,198
Iraq,15/10/2007,188,0,-1,0,37,3,0,227
Iraq,16/10/2007,110,0,-1,0,-29,1,0,81
Iraq,17/10/2007,406,2,1,0,49,19,0,477
Iraq,18/10/2007,181,4,3,0,47,17,0,252
Iraq,19/10/2007,128,6,2,0,30,9,0,175
Iraq,20/10/2007,95,0,1,0,30,9,0,135
Iraq,21/10/2007,405,0,0,0,42,26,0,473
Iraq,22/10/2007,486,6,4,0,73,29,0,598
Iraq,23/10/2007,295,6,4,0,46,19,0,370
Iraq,24/10/2007,288,8,-7,0,46,22,0,357
Iraq,25/10/2007,219,0,-8,0,55,9,0,275
Iraq,26/10/2007,110,8,-8,0,20,5,0,135
Iraq,27/10/2007,152,0,2,0,34,25,0,213
Iraq,28/10/2007,304,0,0,0,31,42,0,377
Iraq,29/10/2007,216,0,-6,0,54,27,0,291
Iraq,30/10/2007,152,4,2,0,46,16,0,220
Iraq,31/10/2007,244,8,3,0,85,26,0,366
Morocco,01/10/2007,0,0,0,0,6,0,0,6
Morocco,02/10/2007,0,0,0,0,1,2,0,3
Morocco,03/10/2007,2,0,0,0,0,0,0,2
Morocco,04/10/2007,0,0,0,0,0,0,0,0
Morocco,05/10/2007,4,0,0,0,9,0,0,13
Morocco,06/10/2007,0,0,0,0,3,2,0,5
Morocco,07/10/2007,4,0,0,0,0,0,0,4
Morocco,08/10/2007,5,0,0,0,0,0,0,5
Morocco,09/10/2007,2,0,0,0,12,0,0,14
Morocco,10/10/2007,9,0,0,0,-2,1,0,8
Morocco,11/10/2007,9,0,0,0,6,2,0,17
Morocco,12/10/2007,0,0,0,0,-4,0,0,-4
Morocco,13/10/2007,3,0,0,0,0,0,0,3
Morocco,14/10/2007,5,0,0,0,0,0,0,5
Morocco,15/10/2007,28,0,0,0,18,0,0,46
Morocco,16/10/2007,12,0,2,0,6,0,0,20
Morocco,17/10/2007,9,0,0,0,6,2,0,17
Morocco,18/10/2007,17,2,0,0,4,2,0,25
Morocco,19/10/2007,5,0,0,0,6,6,0,17
Morocco,20/10/2007,4,0,0,0,3,3,0,10
Morocco,21/10/2007,6,0,0,0,3,4,0,13
Morocco,22/10/2007,13,0,0,0,15,0,0,28
Morocco,23/10/2007,4,0,0,0,9,3,0,16
Morocco,24/10/2007,1,0,0,0,12,0,0,13
Morocco,25/10/2007,-2,0,0,0,3,0,0,1
Morocco,26/10/2007,1,0,0,0,6,0,0,7
Morocco,27/10/2007,0,0,0,0,0,0,0,0
Morocco,28/10/2007,2,0,0,0,0,0,0,2
Morocco,29/10/2007,6,0,0,0,24,0,0,30
Morocco,30/10/2007,2,0,0,0,-1,0,0,1
Morocco,31/10/2007,18,0,0,0,90,1,0,109
Nigeria,01/10/2007,2,0,0,0,0,3,0,5
Nigeria,02/10/2007,63,2,0,0,19,2,0,86
Nigeria,03/10/2007,21,0,-6,0,6,2,0,23
Nigeria,04/10/2007,26,0,-2,0,0,3,0,27
Nigeria,05/10/2007,6,0,2,0,12,1,0,21
Nigeria,06/10/2007,3,4,0,0,0,0,0,7
Nigeria,07/10/2007,10,0,0,0,3,0,0,13
Nigeria,08/10/2007,24,0,0,0,8,2,0,34
Nigeria,09/10/2007,6,0,0,0,-4,1,0,3
Nigeria,10/10/2007,1,0,0,0,0,1,0,2
Nigeria,11/10/2007,5,0,2,0,12,0,0,19
Nigeria,12/10/2007,1,0,0,0,4,0,0,5
Nigeria,13/10/2007,0,0,0,0,17,0,0,17
Nigeria,14/10/2007,0,0,0,0,0,0,0,0
Nigeria,15/10/2007,7,0,0,0,3,-2,0,8
Nigeria,16/10/2007,20,0,-10,0,17,0,0,27
Nigeria,17/10/2007,5,0,-4,0,-1,1,0,1
Nigeria,18/10/2007,9,0,0,0,15,0,0,24
Nigeria,19/10/2007,0,0,0,0,16,2,0,18
Nigeria,20/10/2007,4,2,0,0,0,2,0,8
Nigeria,21/10/2007,2,0,0,0,0,0,0,2
Nigeria,22/10/2007,15,0,-2,0,9,0,0,22
Nigeria,23/10/2007,15,0,0,0,0,0,0,15
Nigeria,24/10/2007,7,0,-8,0,15,0,0,14
Nigeria,25/10/2007,2,2,-2,0,6,0,0,8
Nigeria,26/10/2007,18,0,0,0,0,0,0,18
Nigeria,27/10/2007,0,0,0,0,0,0,0,0
Nigeria,28/10/2007,3,0,0,0,0,1,0,4
Nigeria,29/10/2007,2,0,0,0,8,0,0,10
Nigeria,30/10/2007,18,0,0,0,0,0,0,18
Nigeria,31/10/2007,0,0,0,0,6,1,0,7
Pakistan,01/10/2007,8,0,0,0,9,0,0,17
Pakistan,02/10/2007,71,4,-7,0,12,3,0,83
Pakistan,03/10/2007,93,0,-4,0,23,4,0,116
Pakistan,04/10/2007,58,0,-5,0,20,2,0,75
Pakistan,05/10/2007,52,0,-1,0,28,20,0,99
Pakistan,06/10/2007,31,0,0,0,8,6,0,45
Pakistan,07/10/2007,40,0,-2,0,0,9,0,47
Pakistan,08/10/2007,34,0,0,0,5,3,0,42
Pakistan,09/10/2007,36,0,0,0,1,3,0,40
Pakistan,10/10/2007,19,0,-4,0,1,1,0,17
Pakistan,11/10/2007,80,0,0,0,23,3,0,106
Pakistan,12/10/2007,31,0,0,0,24,4,0,59
Pakistan,13/10/2007,17,0,0,0,7,9,0,33
Pakistan,14/10/2007,32,0,0,0,7,2,0,41
Pakistan,15/10/2007,36,0,0,0,12,3,0,51
Pakistan,16/10/2007,22,0,0,0,-8,6,0,20
Pakistan,17/10/2007,20,0,0,0,15,6,0,41
Pakistan,18/10/2007,66,0,-8,0,30,20,0,108
Pakistan,19/10/2007,74,0,-1,0,21,13,0,107
Pakistan,20/10/2007,27,0,0,0,8,2,0,37
Pakistan,21/10/2007,35,0,0,0,-6,6,0,35
Pakistan,22/10/2007,24,2,0,0,15,0,0,41
Pakistan,23/10/2007,33,0,0,0,9,0,0,42
Pakistan,24/10/2007,24,0,0,0,31,3,0,58
Pakistan,25/10/2007,48,0,0,0,8,5,0,61
Pakistan,26/10/2007,21,0,0,0,21,2,0,44
Pakistan,27/10/2007,11,0,0,0,33,5,0,49
Pakistan,28/10/2007,12,0,0,0,0,0,0,12
Pakistan,29/10/2007,38,0,0,0,5,11,0,54
Pakistan,30/10/2007,43,0,0,0,30,15,0,88
Pakistan,31/10/2007,34,0,0,0,48,0,0,82
Sierra Leone,01/10/2007,6,0,0,0,0,0,0,6
Sierra Leone,02/10/2007,-1,0,0,0,0,0,0,-1
Sierra Leone,03/10/2007,0,0,0,0,0,0,0,0
Sierra Leone,04/10/2007,0,0,0,0,0,0,0,0
Sierra Leone,05/10/2007,0,0,0,0,0,0,0,0
Sierra Leone,06/10/2007,0,0,0,0,0,0,0,0
Sierra Leone,08/10/2007,0,0,0,0,0,0,0,0
Sierra Leone,09/10/2007,14,0,0,0,33,0,0,47
Sierra Leone,10/10/2007,9,0,0,0,3,0,0,12
Sierra Leone,11/10/2007,4,0,-6,0,6,5,0,9
Sierra Leone,12/10/2007,0,0,0,0,0,0,0,0
Sierra Leone,13/10/2007,3,0,0,0,0,0,0,3
Sierra Leone,14/10/2007,0,0,0,0,0,0,0,0
Sierra Leone,15/10/2007,3,0,0,0,0,0,0,3
Sierra Leone,17/10/2007,-2,0,0,0,3,0,0,1
Sierra Leone,18/10/2007,6,0,0,0,15,0,0,21
Sierra Leone,19/10/2007,0,0,0,0,-11,0,0,-11
Sierra Leone,22/10/2007,7,0,1,0,3,0,0,11
Sierra Leone,23/10/2007,1,0,0,0,0,0,0,1
Sierra Leone,24/10/2007,1,0,0,0,0,0,0,1
Sierra Leone,27/10/2007,4,0,0,0,0,0,0,4
Sierra Leone,28/10/2007,0,0,0,0,0,0,0,0
Sierra Leone,29/10/2007,0,0,0,0,0,0,0,0
Sierra Leone,30/10/2007,4,0,0,0,0,0,0,4
Sierra Leone,31/10/2007,0,0,0,0,-2,0,0,-2
Somalia,01/10/2007,0,0,0,0,0,0,0,0
Somalia,02/10/2007,36,0,0,0,3,0,0,39
Somalia,03/10/2007,15,0,0,0,0,0,0,15
Somalia,04/10/2007,11,0,0,0,6,4,0,21
Somalia,05/10/2007,40,0,0,0,0,0,0,40
Somalia,06/10/2007,9,0,0,0,0,0,0,9
Somalia,07/10/2007,6,0,0,0,3,2,0,11
Somalia,09/10/2007,0,0,0,0,3,0,0,3
Somalia,10/10/2007,6,0,0,0,11,4,0,21
Somalia,11/10/2007,6,0,-8,0,0,2,0,0
Somalia,12/10/2007,2,4,1,0,-6,0,0,1
Somalia,13/10/2007,0,0,0,0,0,0,0,0
Somalia,14/10/2007,1,0,0,0,-2,0,0,-1
Somalia,15/10/2007,8,0,-4,0,18,0,0,22
Somalia,16/10/2007,3,0,-4,0,0,0,0,-1
Somalia,17/10/2007,38,0,0,0,0,0,0,38
Somalia,18/10/2007,6,0,0,0,0,0,0,6
Somalia,19/10/2007,3,0,-2,0,-4,0,0,-3
Somalia,20/10/2007,5,0,-2,0,0,0,0,3
Somalia,21/10/2007,11,0,0,0,0,0,0,11
Somalia,22/10/2007,15,0,0,0,12,0,0,27
Somalia,23/10/2007,9,0,0,0,-2,0,0,7
Somalia,24/10/2007,-2,0,0,0,0,1,0,-1
Somalia,25/10/2007,0,0,0,0,0,0,0,0
Somalia,26/10/2007,3,6,0,0,0,2,0,11
Somalia,27/10/2007,0,0,0,0,0,0,0,0
Somalia,28/10/2007,15,0,0,0,0,0,0,15
Somalia,29/10/2007,20,0,-22,0,21,1,0,20
Somalia,30/10/2007,6,2,-2,0,-2,0,0,4
Somalia,31/10/2007,46,0,0,0,2,3,0,51
Syria,01/10/2007,10,0,0,0,0,0,0,10
Syria,02/10/2007,26,0,3,0,81,2,0,112
Syria,03/10/2007,33,0,3,0,19,3,0,58
Syria,04/10/2007,37,0,0,0,6,6,0,49
Syria,05/10/2007,43,0,-2,0,4,1,0,46
Syria,06/10/2007,9,0,0,0,3,0,0,12
Syria,07/10/2007,7,0,0,0,18,0,0,25
Syria,08/10/2007,11,0,0,0,10,2,0,23
Syria,09/10/2007,16,0,0,0,15,1,0,32
Syria,10/10/2007,8,0,0,0,12,0,0,20
Syria,11/10/2007,50,0,0,0,15,0,0,65
Syria,12/10/2007,40,0,0,0,24,0,0,64
Syria,13/10/2007,25,0,1,0,5,0,0,31
Syria,14/10/2007,73,0,3,0,10,5,0,91
Syria,15/10/2007,15,0,0,0,1,4,0,20
Syria,16/10/2007,34,0,0,0,36,0,0,70
Syria,17/10/2007,51,0,0,0,18,5,0,74
Syria,18/10/2007,45,6,-2,0,37,8,0,94
Syria,19/10/2007,47,0,-2,0,13,0,0,58
Syria,20/10/2007,10,0,0,0,14,6,0,30
Syria,21/10/2007,21,0,-2,0,15,7,0,41
Syria,22/10/2007,35,0,0,0,24,14,0,73
Syria,23/10/2007,7,0,0,0,10,0,0,17
Syria,24/10/2007,15,0,0,0,37,1,0,53
Syria,25/10/2007,11,0,-22,0,6,0,0,-5
Syria,26/10/2007,11,0,1,0,12,0,0,24
Syria,27/10/2007,3,0,0,0,18,0,0,21
Syria,28/10/2007,56,0,0,0,0,2,0,58
Syria,29/10/2007,44,0,0,0,3,2,0,49
Syria,30/10/2007,14,0,0,0,6,4,0,24
Syria,31/10/2007,50,0,0,0,7,0,0,57
Yemen,01/10/2007,6,0,0,0,3,0,0,9
Yemen,02/10/2007,3,0,0,0,3,0,0,6
Yemen,03/10/2007,3,0,0,0,3,0,0,6
Yemen,04/10/2007,0,0,0,0,0,0,0,0
Yemen,05/10/2007,6,0,0,0,0,0,0,6
Yemen,06/10/2007,0,0,0,0,0,1,0,1
Yemen,07/10/2007,0,0,0,0,-2,1,0,-1
Yemen,08/10/2007,5,0,0,0,0,2,0,7
Yemen,09/10/2007,-2,0,0,0,0,0,0,-2
Yemen,10/10/2007,-1,0,0,0,0,0,0,-1
Yemen,11/10/2007,0,0,0,0,0,0,0,0
Yemen,12/10/2007,3,0,0,0,-3,0,0,0
Yemen,13/10/2007,0,0,0,0,0,0,0,0
Yemen,14/10/2007,4,0,0,0,0,0,0,4
Yemen,15/10/2007,0,0,0,0,0,0,0,0
Yemen,16/10/2007,12,0,0,0,0,0,0,12
Yemen,17/10/2007,0,0,0,0,6,0,0,6
Yemen,19/10/2007,0,0,0,0,0,0,0,0
Yemen,20/10/2007,0,0,0,0,0,0,0,0
Yemen,21/10/2007,5,0,0,0,0,0,0,5
Yemen,23/10/2007,2,0,0,0,0,0,0,2
Yemen,24/10/2007,0,0,0,0,0,0,0,0
Yemen,26/10/2007,-4,0,0,0,6,0,0,2
Yemen,27/10/2007,0,0,0,0,-2,0,0,-2
Yemen,28/10/2007,0,0,0,0,0,0,0,0
Yemen,29/10/2007,0,2,0,0,-1,1,0,2
Yemen,30/10/2007,-4,0,0,0,32,0,0,28
Yemen,31/10/2007,2,0,0,0,9,0,0,11
Afghanistan,01/11/2007,169,6,4,0,22,9,0,210
Afghanistan,02/11/2007,101,6,2,0,13,1,0,123
Afghanistan,03/11/2007,95,0,0,0,28,2,0,125
Afghanistan,04/11/2007,83,4,-2,0,2,3,0,90
Afghanistan,05/11/2007,50,0,0,0,42,1,0,93
Afghanistan,06/11/2007,171,0,8,0,60,25,0,264
Afghanistan,07/11/2007,32,0,-1,0,2,4,0,37
Afghanistan,08/11/2007,93,0,0,0,39,1,0,133
Afghanistan,09/11/2007,114,0,0,0,42,19,0,175
Afghanistan,10/11/2007,123,0,0,0,7,26,0,156
Afghanistan,11/11/2007,136,0,0,0,-2,16,0,150
Afghanistan,12/11/2007,134,0,0,0,12,10,0,156
Afghanistan,13/11/2007,156,0,-5,0,86,12,0,249
Afghanistan,14/11/2007,96,4,1,0,23,2,0,126
Afghanistan,15/11/2007,81,0,0,0,12,0,0,93
Afghanistan,16/11/2007,74,0,0,0,41,10,0,125
Afghanistan,17/11/2007,152,0,0,0,5,26,0,183
Afghanistan,18/11/2007,98,6,0,0,15,14,0,133
Afghanistan,19/11/2007,42,0,0,0,17,6,0,65
Afghanistan,20/11/2007,29,0,-1,0,12,3,0,43
Afghanistan,21/11/2007,98,0,0,0,27,0,0,125
Afghanistan,22/11/2007,81,0,0,0,18,2,0,101
Afghanistan,23/11/2007,74,0,0,0,6,11,0,91
Afghanistan,24/11/2007,37,0,0,0,8,1,0,46
Afghanistan,25/11/2007,63,0,0,0,-4,4,0,63
Afghanistan,26/11/2007,78,0,0,0,-2,2,0,78
Afghanistan,27/11/2007,35,0,2,0,0,2,0,39
Afghanistan,28/11/2007,35,2,0,0,17,0,0,54
Afghanistan,29/11/2007,170,0,3,0,-6,11,0,178
Afghanistan,30/11/2007,60,0,1,0,2,10,0,73
Albania,01/11/2007,25,0,0,0,9,0,0,34
Albania,02/11/2007,7,0,0,0,17,0,0,24
Albania,03/11/2007,2,0,0,0,-2,0,0,0
Albania,04/11/2007,3,0,-3,0,9,2,0,11
Albania,05/11/2007,20,0,-4,0,3,1,0,20
Albania,06/11/2007,19,0,0,0,-2,0,0,17
Albania,07/11/2007,59,0,0,0,26,2,0,87
Albania,08/11/2007,62,0,0,0,12,0,0,74
Albania,09/11/2007,25,0,-7,0,0,0,0,18
Albania,10/11/2007,2,0,-1,0,0,0,0,1
Albania,11/11/2007,6,0,0,0,0,0,0,6
Albania,12/11/2007,2,0,0,0,7,2,0,11
Albania,13/11/2007,18,0,0,0,2,1,0,21
Albania,14/11/2007,13,0,-11,0,-2,6,0,6
Albania,15/11/2007,14,0,-11,0,0,12,0,15
Albania,16/11/2007,4,0,0,0,6,3,0,13
Albania,17/11/2007,25,0,-12,0,0,13,0,26
Albania,18/11/2007,26,0,-15,0,4,25,0,40
Albania,19/11/2007,31,0,-9,0,6,9,0,37
Albania,20/11/2007,64,0,-11,0,0,0,0,53
Albania,21/11/2007,43,0,-7,0,9,3,0,48
Albania,22/11/2007,26,0,-9,0,6,0,0,23
Albania,23/11/2007,0,0,-1,0,0,0,0,-1
Albania,24/11/2007,8,0,-1,0,0,0,0,7
Albania,25/11/2007,1,0,0,0,0,2,0,3
Albania,26/11/2007,19,0,-3,0,0,0,0,16
Albania,27/11/2007,17,0,-8,0,6,0,0,15
Albania,28/11/2007,42,0,-6,0,0,1,0,37
Albania,29/11/2007,21,0,-2,0,1,0,0,20
Albania,30/11/2007,6,0,-2,0,7,0,0,11
Algeria,01/11/2007,8,0,0,0,6,0,0,14
Algeria,02/11/2007,3,0,0,0,6,2,0,11
Algeria,03/11/2007,2,0,0,0,42,3,0,47
Algeria,04/11/2007,0,0,0,0,9,4,0,13
Algeria,05/11/2007,46,0,1,0,3,3,0,53
Algeria,06/11/2007,88,0,0,0,15,3,0,106
Algeria,07/11/2007,0,0,0,0,-6,2,0,-4
Algeria,08/11/2007,8,0,0,0,0,2,0,10
Algeria,09/11/2007,0,0,0,0,0,0,0,0
Algeria,10/11/2007,0,0,0,0,0,0,0,0
Algeria,11/11/2007,-3,0,0,0,9,0,0,6
Algeria,12/11/2007,-1,0,0,0,18,0,0,17
Algeria,13/11/2007,5,0,0,0,23,0,0,28
Algeria,14/11/2007,3,0,0,0,3,2,0,8
Algeria,15/11/2007,12,0,0,0,0,0,0,12
Algeria,16/11/2007,0,0,0,0,0,4,0,4
Algeria,17/11/2007,0,0,0,0,0,0,0,0
Algeria,18/11/2007,0,0,0,0,-3,1,0,-2
Algeria,19/11/2007,4,0,0,0,7,0,0,11
Algeria,20/11/2007,1,0,0,0,3,0,0,4
Algeria,21/11/2007,0,0,0,0,6,0,0,6
Algeria,22/11/2007,0,0,0,0,0,0,0,0
Algeria,23/11/2007,0,0,0,0,0,0,0,0
Algeria,24/11/2007,4,0,0,0,0,0,0,4
Algeria,25/11/2007,6,0,0,0,16,0,0,22
Algeria,26/11/2007,5,0,1,0,13,4,0,23
Algeria,27/11/2007,0,0,1,0,6,4,0,11
Algeria,28/11/2007,6,0,0,0,6,0,0,12
Algeria,29/11/2007,7,0,0,0,12,2,0,21
Algeria,30/11/2007,21,0,2,0,39,1,0,63
Bangladesh,01/11/2007,12,0,1,0,3,0,0,16
Bangladesh,02/11/2007,2,0,0,0,-2,1,0,1
Bangladesh,03/11/2007,12,0,0,0,3,0,0,15
Bangladesh,04/11/2007,5,0,2,0,9,2,0,18
Bangladesh,05/11/2007,0,0,0,0,45,0,0,45
Bangladesh,06/11/2007,2,0,0,0,12,0,0,14
Bangladesh,07/11/2007,0,0,0,0,0,0,0,0
Bangladesh,08/11/2007,8,0,0,0,6,4,0,18
Bangladesh,09/11/2007,0,0,0,0,15,0,0,15
Bangladesh,10/11/2007,2,0,0,0,0,0,0,2
Bangladesh,11/11/2007,1,0,1,0,-3,1,0,0
Bangladesh,12/11/2007,8,0,0,0,3,0,0,11
Bangladesh,13/11/2007,23,0,0,0,-2,0,0,21
Bangladesh,14/11/2007,-2,0,0,0,3,0,0,1
Bangladesh,15/11/2007,0,0,0,0,6,0,0,6
Bangladesh,16/11/2007,26,4,0,0,3,1,0,34
Bangladesh,17/11/2007,6,0,0,0,0,0,0,6
Bangladesh,18/11/2007,16,4,0,0,6,2,0,28
Bangladesh,19/11/2007,15,2,0,0,1,0,0,18
Bangladesh,20/11/2007,13,0,0,0,9,0,0,22
Bangladesh,21/11/2007,38,0,1,0,38,17,0,94
Bangladesh,22/11/2007,28,2,0,0,-2,10,0,38
Bangladesh,23/11/2007,23,2,0,0,20,4,0,49
Bangladesh,24/11/2007,26,0,0,0,4,6,0,36
Bangladesh,25/11/2007,23,0,0,0,46,3,0,72
Bangladesh,26/11/2007,31,0,-2,0,17,7,0,53
Bangladesh,27/11/2007,18,0,0,0,-3,12,0,27
Bangladesh,28/11/2007,14,0,4,0,12,4,0,34
Bangladesh,29/11/2007,7,0,3,0,9,2,0,21
Bangladesh,30/11/2007,0,0,0,0,0,1,0,1
Cameroon,01/11/2007,0,0,0,0,0,0,0,0
Cameroon,03/11/2007,0,0,0,0,0,0,0,0
Cameroon,05/11/2007,-2,0,0,0,0,0,0,-2
Cameroon,06/11/2007,0,0,0,0,0,0,0,0
Cameroon,08/11/2007,2,0,0,0,0,0,0,2
Cameroon,12/11/2007,0,0,0,0,6,0,0,6
Cameroon,13/11/2007,0,0,0,0,12,0,0,12
Cameroon,14/11/2007,-1,0,0,0,0,3,0,2
Cameroon,16/11/2007,2,0,-2,0,0,0,0,0
Cameroon,17/11/2007,0,0,0,0,0,0,0,0
Cameroon,18/11/2007,0,0,0,0,0,0,0,0
Cameroon,19/11/2007,1,0,0,0,0,0,0,1
Cameroon,20/11/2007,2,0,0,0,0,0,0,2
Cameroon,21/11/2007,2,0,0,0,0,0,0,2
Cameroon,22/11/2007,0,0,0,0,3,1,0,4
Cameroon,25/11/2007,3,0,0,0,0,0,0,3
Cameroon,26/11/2007,0,0,0,0,0,0,0,0
Cameroon,27/11/2007,0,0,0,0,3,0,0,3
Cameroon,28/11/2007,0,0,0,0,9,0,0,9
Cameroon,30/11/2007,2,0,0,0,0,0,0,2
China,01/11/2007,84,2,-7,0,25,3,0,107
China,02/11/2007,58,0,2,0,30,6,0,96
China,03/11/2007,19,2,2,0,19,6,0,48
China,04/11/2007,35,0,-2,0,11,4,0,48
China,05/11/2007,13,0,-11,0,56,5,0,63
China,06/11/2007,41,0,2,0,62,7,0,112
China,07/11/2007,10,2,1,0,4,2,0,19
China,08/11/2007,46,2,0,0,25,10,0,83
China,09/11/2007,81,0,-1,0,35,22,0,137
China,10/11/2007,21,0,0,0,24,9,0,54
China,11/11/2007,39,0,-5,0,9,4,0,47
China,12/11/2007,16,6,0,0,13,7,0,42
China,13/11/2007,78,2,3,0,43,7,0,133
China,14/11/2007,76,0,0,0,91,12,0,179
China,15/11/2007,14,0,-1,0,4,3,0,20
China,16/11/2007,59,0,0,0,34,2,0,95
China,17/11/2007,44,0,-2,0,1,2,0,45
China,18/11/2007,55,0,4,0,35,6,0,100
China,19/11/2007,92,2,-1,0,50,3,0,146
China,20/11/2007,100,0,3,0,41,6,0,150
China,21/11/2007,58,0,1,0,3,4,0,66
China,22/11/2007,62,0,0,0,36,10,0,108
China,23/11/2007,-12,0,-2,0,5,4,0,-5
China,24/11/2007,49,0,0,0,6,2,0,57
China,25/11/2007,27,0,0,0,50,9,0,86
China,26/11/2007,72,0,-4,0,29,14,0,111
China,27/11/2007,68,0,0,0,20,7,0,95
China,28/11/2007,63,0,1,0,33,9,0,106
China,29/11/2007,81,0,1,0,22,8,0,112
China,30/11/2007,87,2,-9,0,34,17,0,131
Egypt,01/11/2007,37,0,0,0,39,1,0,77
Egypt,02/11/2007,30,0,0,0,36,0,0,66
Egypt,03/11/2007,9,0,0,0,16,0,0,25
Egypt,04/11/2007,10,8,0,0,3,2,0,23
Egypt,05/11/2007,14,2,-1,0,30,6,0,51
Egypt,06/11/2007,-2,0,0,0,25,0,0,23
Egypt,07/11/2007,9,0,0,0,-2,1,0,8
Egypt,08/11/2007,8,0,0,0,0,0,0,8
Egypt,09/11/2007,8,0,0,0,16,0,0,24
Egypt,10/11/2007,14,0,0,0,-8,0,0,6
Egypt,11/11/2007,17,0,0,0,9,0,0,26
Egypt,12/11/2007,65,0,0,0,1,10,0,76
Egypt,13/11/2007,4,0,0,0,-7,6,0,3
Egypt,14/11/2007,13,0,-1,0,-2,1,0,11
Egypt,15/11/2007,3,0,0,0,0,0,0,3
Egypt,16/11/2007,11,0,-1,0,18,0,0,28
Egypt,17/11/2007,10,0,-2,0,0,0,0,8
Egypt,18/11/2007,14,0,-2,0,9,3,0,24
Egypt,19/11/2007,11,0,0,0,3,0,0,14
Egypt,20/11/2007,5,0,0,0,3,1,0,9
Egypt,21/11/2007,8,0,0,0,-4,0,0,4
Egypt,22/11/2007,16,0,-8,0,24,2,0,34
Egypt,23/11/2007,8,0,0,0,0,2,0,10
Egypt,24/11/2007,2,0,0,0,3,0,0,5
Egypt,25/11/2007,6,0,0,0,0,0,0,6
Egypt,26/11/2007,9,0,-2,0,0,0,0,7
Egypt,27/11/2007,16,0,0,0,21,0,0,37
Egypt,28/11/2007,17,0,0,0,4,0,0,21
Egypt,29/11/2007,10,0,0,0,6,0,0,16
Egypt,30/11/2007,-9,0,0,0,21,1,0,13
Eritrea,01/11/2007,14,0,0,0,12,0,0,26
Eritrea,02/11/2007,14,0,0,0,6,0,0,20
Eritrea,03/11/2007,2,0,0,0,0,0,0,2
Eritrea,04/11/2007,6,0,0,0,0,0,0,6
Eritrea,05/11/2007,6,0,0,0,0,0,0,6
Eritrea,06/11/2007,8,0,0,0,3,0,0,11
Eritrea,08/11/2007,4,0,0,0,-4,0,0,0
Eritrea,09/11/2007,1,0,0,0,0,0,0,1
Eritrea,10/11/2007,6,0,0,0,3,0,0,9
Eritrea,11/11/2007,0,0,0,0,3,0,0,3
Eritrea,12/11/2007,2,0,0,0,0,0,0,2
Eritrea,13/11/2007,0,0,0,0,0,0,0,0
Eritrea,14/11/2007,0,0,0,0,3,0,0,3
Eritrea,16/11/2007,7,0,0,0,6,0,0,13
Eritrea,17/11/2007,2,0,0,0,0,0,0,2
Eritrea,18/11/2007,6,0,0,0,0,0,0,6
Eritrea,19/11/2007,1,0,0,0,0,0,0,1
Eritrea,20/11/2007,0,0,0,0,0,0,0,0
Eritrea,21/11/2007,6,0,0,0,0,0,0,6
Eritrea,23/11/2007,0,0,0,0,6,0,0,6
Eritrea,24/11/2007,0,0,0,0,0,0,0,0
Eritrea,25/11/2007,0,0,0,0,0,0,0,0
Eritrea,26/11/2007,-1,0,0,0,0,0,0,-1
Eritrea,27/11/2007,0,0,0,0,0,0,0,0
Eritrea,28/11/2007,0,0,0,0,0,0,0,0
Eritrea,29/11/2007,15,0,0,0,0,0,0,15
Eritrea,30/11/2007,0,0,0,0,0,0,0,0
Georgia,01/11/2007,10,0,0,0,10,2,0,22
Georgia,02/11/2007,19,0,0,0,7,6,0,32
Georgia,03/11/2007,7,0,0,0,0,6,0,13
Georgia,04/11/2007,4,0,0,0,0,2,0,6
Georgia,05/11/2007,8,0,0,0,0,1,0,9
Georgia,06/11/2007,12,0,1,0,-4,3,0,12
Georgia,07/11/2007,6,0,0,0,0,0,0,6
Georgia,08/11/2007,13,0,2,0,6,0,0,21
Georgia,09/11/2007,24,0,2,0,18,4,0,48
Georgia,10/11/2007,6,0,0,0,-2,0,0,4
Georgia,11/11/2007,0,0,0,0,0,0,0,0
Georgia,12/11/2007,5,0,0,0,2,5,0,12
Georgia,13/11/2007,9,0,0,0,3,1,0,13
Georgia,14/11/2007,5,0,1,0,6,2,0,14
Georgia,15/11/2007,3,0,0,0,3,0,0,6
Georgia,16/11/2007,-5,0,1,0,0,3,0,-1
Georgia,17/11/2007,-1,0,0,0,1,0,0,0
Georgia,18/11/2007,6,0,1,0,6,0,0,13
Georgia,19/11/2007,5,0,-8,0,3,0,0,0
Georgia,20/11/2007,4,0,0,0,-2,2,0,4
Georgia,21/11/2007,6,0,0,0,9,2,0,17
Georgia,22/11/2007,3,0,0,0,0,1,0,4
Georgia,23/11/2007,0,0,0,0,3,1,0,4
Georgia,24/11/2007,0,0,0,0,3,0,0,3
Georgia,25/11/2007,9,0,0,0,3,0,0,12
Georgia,26/11/2007,6,0,0,0,3,1,0,10
Georgia,27/11/2007,9,0,0,0,-2,3,0,10
Georgia,28/11/2007,2,0,0,0,12,1,0,15
Georgia,29/11/2007,4,0,0,0,21,0,0,25
Georgia,30/11/2007,5,0,0,0,3,0,0,8
India,01/11/2007,17,0,0,0,9,3,0,29
India,02/11/2007,35,0,0,0,9,2,0,46
India,03/11/2007,43,4,0,0,-4,3,0,46
India,04/11/2007,8,0,0,0,-3,1,0,6
India,05/11/2007,41,0,-4,0,16,6,0,59
India,06/11/2007,31,0,3,0,9,9,0,52
India,07/11/2007,2,0,0,0,15,0,0,17
India,08/11/2007,-1,2,1,0,2,3,0,7
India,09/11/2007,20,0,1,0,10,1,0,32
India,10/11/2007,0,0,0,0,-1,4,0,3
India,11/11/2007,8,0,0,0,6,1,0,15
India,12/11/2007,7,2,0,0,0,7,0,16
India,13/11/2007,21,0,-4,0,9,3,0,29
India,14/11/2007,28,0,0,0,7,0,0,35
India,15/11/2007,20,0,0,0,12,0,0,32
India,16/11/2007,45,0,0,0,1,1,0,47
India,17/11/2007,7,0,-1,0,9,2,0,17
India,18/11/2007,14,0,-4,0,0,1,0,11
India,19/11/2007,18,2,-4,0,8,10,0,34
India,20/11/2007,22,0,-4,0,-3,4,0,19
India,21/11/2007,42,2,0,0,5,2,0,51
India,22/11/2007,66,0,-3,0,3,1,0,67
India,23/11/2007,29,0,0,0,6,4,0,39
India,24/11/2007,18,0,-3,0,0,0,0,15
India,25/11/2007,6,0,1,0,28,5,0,40
India,26/11/2007,2,0,0,0,3,0,0,5
India,27/11/2007,34,0,-2,0,-3,0,0,29
India,28/11/2007,17,0,-3,0,6,3,0,23
India,29/11/2007,24,0,0,0,-3,7,0,28
India,30/11/2007,31,0,0,0,14,4,0,49
Iran,01/11/2007,70,2,0,0,10,14,0,96
Iran,02/11/2007,75,0,0,0,10,1,0,86
Iran,03/11/2007,24,0,0,0,6,7,0,37
Iran,04/11/2007,37,8,-4,0,15,6,0,62
Iran,05/11/2007,36,0,-4,0,-2,3,0,33
Iran,06/11/2007,66,6,3,0,5,12,0,92
Iran,07/11/2007,56,0,1,0,38,4,0,99
Iran,08/11/2007,44,0,0,0,-11,0,0,33
Iran,09/11/2007,67,0,0,0,51,3,0,121
Iran,10/11/2007,62,0,1,0,3,1,0,67
Iran,11/11/2007,45,0,-2,0,0,4,0,47
Iran,12/11/2007,76,0,0,0,18,9,0,103
Iran,13/11/2007,77,0,0,0,14,8,0,99
Iran,14/11/2007,33,0,0,0,15,4,0,52
Iran,15/11/2007,17,0,2,0,-7,0,0,12
Iran,16/11/2007,44,0,0,0,2,1,0,47
Iran,17/11/2007,30,0,0,0,16,3,0,49
Iran,18/11/2007,30,0,0,0,0,6,0,36
Iran,19/11/2007,47,0,1,0,6,7,0,61
Iran,20/11/2007,40,0,1,0,15,0,0,56
Iran,21/11/2007,12,0,2,0,9,0,0,23
Iran,22/11/2007,40,0,-2,0,9,4,0,51
Iran,23/11/2007,48,0,0,0,17,6,0,71
Iran,24/11/2007,25,0,-4,0,-11,12,0,22
Iran,25/11/2007,20,0,0,0,-1,4,0,23
Iran,26/11/2007,53,0,0,0,9,3,0,65
Iran,27/11/2007,53,0,0,0,13,10,0,76
Iran,28/11/2007,39,0,-4,0,1,0,0,36
Iran,29/11/2007,29,0,3,0,9,5,0,46
Iran,30/11/2007,29,0,1,0,15,3,0,48
Iraq,01/11/2007,213,0,-2,0,48,11,0,270
Iraq,02/11/2007,155,0,5,0,18,4,0,182
Iraq,03/11/2007,75,0,1,0,7,6,0,89
Iraq,04/11/2007,103,0,0,0,-50,23,0,76
Iraq,05/11/2007,165,0,0,0,37,13,0,215
Iraq,06/11/2007,154,2,-2,0,90,23,0,267
Iraq,07/11/2007,51,2,0,0,11,7,0,71
Iraq,08/11/2007,97,0,-3,0,67,9,0,170
Iraq,09/11/2007,113,0,-5,0,41,4,0,153
Iraq,10/11/2007,97,0,-2,0,16,13,0,124
Iraq,11/11/2007,97,0,2,0,49,20,0,168
Iraq,12/11/2007,60,0,0,0,51,16,0,127
Iraq,13/11/2007,170,8,4,0,6,9,0,197
Iraq,14/11/2007,143,4,7,0,38,16,0,208
Iraq,15/11/2007,74,0,-2,0,-2,12,0,82
Iraq,16/11/2007,106,0,8,0,100,5,0,219
Iraq,17/11/2007,88,0,-3,0,49,13,0,147
Iraq,18/11/2007,85,0,0,0,-4,18,0,99
Iraq,19/11/2007,89,0,2,0,51,5,0,147
Iraq,20/11/2007,78,0,0,0,27,7,0,112
Iraq,21/11/2007,94,0,0,0,20,11,0,125
Iraq,22/11/2007,66,2,2,0,8,6,0,84
Iraq,23/11/2007,73,2,-6,0,67,14,0,150
Iraq,24/11/2007,54,0,-13,0,36,4,0,81
Iraq,25/11/2007,54,0,0,0,3,10,0,67
Iraq,26/11/2007,82,2,-2,0,27,6,0,115
Iraq,27/11/2007,84,0,0,0,4,4,0,92
Iraq,28/11/2007,27,0,1,0,11,3,0,42
Iraq,29/11/2007,117,2,3,0,33,5,0,160
Iraq,30/11/2007,68,0,1,0,10,14,0,93
Morocco,01/11/2007,0,0,0,0,21,3,0,24
Morocco,02/11/2007,12,0,1,0,24,7,0,44
Morocco,03/11/2007,-3,0,1,0,9,1,0,8
Morocco,04/11/2007,3,0,0,0,12,0,0,15
Morocco,05/11/2007,5,0,0,0,15,0,0,20
Morocco,06/11/2007,20,0,1,0,12,5,0,38
Morocco,07/11/2007,0,0,0,0,0,0,0,0
Morocco,08/11/2007,10,0,0,0,9,0,0,19
Morocco,09/11/2007,29,0,0,0,2,1,0,32
Morocco,10/11/2007,7,2,0,0,0,1,0,10
Morocco,11/11/2007,2,0,0,0,0,0,0,2
Morocco,12/11/2007,0,0,0,0,0,0,0,0
Morocco,13/11/2007,0,0,0,0,9,0,0,9
Morocco,14/11/2007,0,0,0,0,6,0,0,6
Morocco,15/11/2007,0,0,0,0,0,0,0,0
Morocco,16/11/2007,20,0,0,0,39,0,0,59
Morocco,17/11/2007,0,0,0,0,0,1,0,1
Morocco,18/11/2007,0,0,0,0,0,0,0,0
Morocco,19/11/2007,0,0,0,0,6,0,0,6
Morocco,20/11/2007,10,0,0,0,0,0,0,10
Morocco,21/11/2007,0,0,0,0,6,10,0,16
Morocco,22/11/2007,0,0,0,0,0,5,0,5
Morocco,23/11/2007,11,0,0,0,0,0,0,11
Morocco,24/11/2007,2,0,0,0,3,0,0,5
Morocco,25/11/2007,0,0,0,0,0,0,0,0
Morocco,26/11/2007,-2,0,0,0,3,2,0,3
Morocco,27/11/2007,0,0,0,0,6,0,0,6
Morocco,28/11/2007,0,0,0,0,0,0,0,0
Morocco,29/11/2007,7,0,0,0,0,0,0,7
Morocco,30/11/2007,4,0,0,0,0,0,0,4
Nigeria,01/11/2007,4,0,0,0,6,0,0,10
Nigeria,02/11/2007,8,0,0,0,9,0,0,17
Nigeria,03/11/2007,7,0,0,0,6,0,0,13
Nigeria,04/11/2007,4,0,0,0,9,2,0,15
Nigeria,05/11/2007,-3,0,1,0,6,0,0,4
Nigeria,06/11/2007,1,0,1,0,3,1,0,6
Nigeria,07/11/2007,2,0,2,0,8,0,0,12
Nigeria,08/11/2007,11,0,0,0,0,0,0,11
Nigeria,09/11/2007,22,0,0,0,-2,1,0,21
Nigeria,10/11/2007,0,0,0,0,0,2,0,2
Nigeria,11/11/2007,3,0,0,0,0,0,0,3
Nigeria,12/11/2007,6,0,0,0,2,0,0,8
Nigeria,13/11/2007,22,0,0,0,0,0,0,22
Nigeria,14/11/2007,14,0,0,0,-3,0,0,11
Nigeria,15/11/2007,3,0,0,0,0,0,0,3
Nigeria,16/11/2007,19,0,0,0,0,0,0,19
Nigeria,17/11/2007,8,0,2,0,1,4,0,15
Nigeria,18/11/2007,6,0,0,0,12,0,0,18
Nigeria,19/11/2007,19,0,4,0,3,4,0,30
Nigeria,20/11/2007,13,0,1,0,6,1,0,21
Nigeria,21/11/2007,12,0,1,0,12,1,0,26
Nigeria,22/11/2007,8,0,0,0,3,16,0,27
Nigeria,23/11/2007,18,0,0,0,3,8,0,29
Nigeria,24/11/2007,2,0,0,0,0,1,0,3
Nigeria,25/11/2007,3,0,0,0,6,0,0,9
Nigeria,26/11/2007,7,0,0,0,0,2,0,9
Nigeria,27/11/2007,9,0,0,0,3,1,0,13
Nigeria,28/11/2007,5,0,0,0,0,2,0,7
Nigeria,29/11/2007,6,0,0,0,0,1,0,7
Nigeria,30/11/2007,16,0,0,0,0,0,0,16
Pakistan,01/11/2007,67,0,-2,0,21,7,0,93
Pakistan,02/11/2007,47,0,0,0,3,12,0,62
Pakistan,03/11/2007,174,0,-1,0,107,3,0,283
Pakistan,04/11/2007,130,0,5,0,98,20,0,253
Pakistan,05/11/2007,159,0,3,0,90,28,0,280
Pakistan,06/11/2007,171,0,-3,0,47,15,0,230
Pakistan,07/11/2007,57,0,4,0,28,12,0,101
Pakistan,08/11/2007,77,2,-3,0,59,11,0,146
Pakistan,09/11/2007,68,0,0,0,75,9,0,152
Pakistan,10/11/2007,86,0,-2,0,57,22,0,163
Pakistan,11/11/2007,106,0,-10,0,31,10,0,137
Pakistan,12/11/2007,126,0,-4,0,86,20,0,228
Pakistan,13/11/2007,85,8,-5,0,60,-1,0,147
Pakistan,14/11/2007,76,2,-9,0,94,6,0,169
Pakistan,15/11/2007,20,0,-6,0,36,13,0,63
Pakistan,16/11/2007,53,0,-6,0,62,14,0,123
Pakistan,17/11/2007,67,0,-5,0,45,3,0,110
Pakistan,18/11/2007,99,0,-3,0,9,9,0,114
Pakistan,19/11/2007,138,0,-5,0,34,13,0,180
Pakistan,20/11/2007,94,0,-8,0,34,11,0,131
Pakistan,21/11/2007,117,0,-8,0,43,33,0,185
Pakistan,22/11/2007,95,0,-6,0,79,9,0,177
Pakistan,23/11/2007,111,2,-12,0,100,6,0,207
Pakistan,24/11/2007,45,2,-2,0,16,20,0,81
Pakistan,25/11/2007,50,0,0,0,30,11,0,91
Pakistan,26/11/2007,67,0,-2,0,35,4,0,104
Pakistan,27/11/2007,111,0,-7,0,71,8,0,183
Pakistan,28/11/2007,79,2,-6,0,61,1,0,137
Pakistan,29/11/2007,153,0,-17,0,101,18,0,255
Pakistan,30/11/2007,49,0,-6,0,41,5,0,89
Sierra Leone,01/11/2007,2,0,0,0,-1,5,0,6
Sierra Leone,03/11/2007,0,0,0,0,0,0,0,0
Sierra Leone,04/11/2007,0,0,0,0,0,0,0,0
Sierra Leone,05/11/2007,0,0,0,0,3,0,0,3
Sierra Leone,06/11/2007,0,0,0,0,6,0,0,6
Sierra Leone,08/11/2007,0,0,0,0,0,0,0,0
Sierra Leone,09/11/2007,8,0,4,0,0,0,0,12
Sierra Leone,12/11/2007,0,0,0,0,6,0,0,6
Sierra Leone,13/11/2007,10,0,2,0,18,0,0,30
Sierra Leone,14/11/2007,10,0,0,0,1,0,0,11
Sierra Leone,16/11/2007,0,0,0,0,0,0,0,0
Sierra Leone,18/11/2007,0,0,0,0,3,0,0,3
Sierra Leone,19/11/2007,0,0,0,0,0,0,0,0
Sierra Leone,21/11/2007,2,0,0,0,9,0,0,11
Sierra Leone,22/11/2007,0,0,0,0,6,0,0,6
Sierra Leone,23/11/2007,17,0,0,0,3,4,0,24
Sierra Leone,26/11/2007,-2,0,0,0,0,0,0,-2
Sierra Leone,27/11/2007,0,0,0,0,0,0,0,0
Sierra Leone,28/11/2007,0,0,0,0,-2,0,0,-2
Sierra Leone,29/11/2007,0,0,0,0,0,0,0,0
Sierra Leone,30/11/2007,0,0,-2,0,0,0,0,-2
Somalia,01/11/2007,59,0,0,0,36,5,0,100
Somalia,02/11/2007,66,0,0,0,21,0,0,87
Somalia,03/11/2007,21,0,0,0,3,14,0,38
Somalia,04/11/2007,6,0,0,0,5,5,0,16
Somalia,05/11/2007,20,0,1,0,15,1,0,37
Somalia,06/11/2007,27,0,0,0,-5,1,0,23
Somalia,07/11/2007,6,0,-2,0,-8,0,0,-4
Somalia,08/11/2007,6,0,0,0,18,0,0,24
Somalia,09/11/2007,12,0,0,0,0,0,0,12
Somalia,10/11/2007,0,0,-2,0,-2,0,0,-4
Somalia,11/11/2007,5,0,0,0,0,0,0,5
Somalia,12/11/2007,4,0,0,0,3,0,0,7
Somalia,13/11/2007,18,0,0,0,-3,0,0,15
Somalia,14/11/2007,10,0,0,0,5,2,0,17
Somalia,15/11/2007,10,0,0,0,1,0,0,11
Somalia,16/11/2007,27,0,0,0,3,0,0,30
Somalia,17/11/2007,10,0,0,0,-1,6,0,15
Somalia,18/11/2007,20,0,0,0,-4,0,0,16
Somalia,19/11/2007,19,0,0,0,0,0,0,19
Somalia,20/11/2007,10,0,0,0,9,0,0,19
Somalia,21/11/2007,7,0,0,0,0,0,0,7
Somalia,22/11/2007,11,0,0,0,12,2,0,25
Somalia,23/11/2007,15,0,0,0,1,0,0,16
Somalia,24/11/2007,0,0,0,0,0,0,0,0
Somalia,25/11/2007,14,0,0,0,0,0,0,14
Somalia,26/11/2007,5,0,0,0,0,0,0,5
Somalia,27/11/2007,14,0,0,0,30,0,0,44
Somalia,28/11/2007,48,0,0,0,36,0,0,84
Somalia,29/11/2007,16,0,-2,0,9,2,0,25
Somalia,30/11/2007,3,0,0,0,3,0,0,6
Syria,01/11/2007,9,0,0,0,6,0,0,15
Syria,02/11/2007,6,0,0,0,0,0,0,6
Syria,03/11/2007,12,0,0,0,12,3,0,27
Syria,04/11/2007,31,0,0,0,15,0,0,46
Syria,05/11/2007,-4,0,-14,0,3,1,0,-14
Syria,06/11/2007,11,0,-5,0,27,0,0,33
Syria,07/11/2007,6,0,0,0,0,0,0,6
Syria,08/11/2007,4,0,-2,0,3,0,0,5
Syria,09/11/2007,2,0,-2,0,-9,0,0,-9
Syria,10/11/2007,2,0,0,0,0,0,0,2
Syria,11/11/2007,19,0,2,0,3,1,0,25
Syria,12/11/2007,45,0,0,0,6,4,0,55
Syria,13/11/2007,40,0,0,0,-5,3,0,38
Syria,14/11/2007,14,0,2,0,15,0,0,31
Syria,15/11/2007,0,0,0,0,0,0,0,0
Syria,16/11/2007,4,0,0,0,13,2,0,19
Syria,17/11/2007,2,0,0,0,0,0,0,2
Syria,18/11/2007,15,0,-4,0,-2,0,0,9
Syria,19/11/2007,28,0,0,0,4,6,0,38
Syria,20/11/2007,24,0,-10,0,-1,2,0,15
Syria,21/11/2007,25,0,0,0,4,0,0,29
Syria,22/11/2007,21,0,-7,0,-15,2,0,1
Syria,23/11/2007,73,0,-19,0,-9,2,0,47
Syria,24/11/2007,54,0,-9,0,6,14,0,65
Syria,25/11/2007,51,0,-12,0,6,10,0,55
Syria,26/11/2007,18,0,1,0,0,1,0,20
Syria,27/11/2007,25,0,0,0,-7,1,0,19
Syria,28/11/2007,7,0,-4,0,-1,1,0,3
Syria,29/11/2007,-4,0,-2,0,2,0,0,-4
Syria,30/11/2007,9,2,0,0,0,2,0,13
Yemen,01/11/2007,24,0,0,0,6,0,0,30
Yemen,02/11/2007,5,0,0,0,0,0,0,5
Yemen,03/11/2007,4,0,0,0,0,2,0,6
Yemen,04/11/2007,0,0,0,0,-6,0,0,-6
Yemen,05/11/2007,3,2,0,0,-4,0,0,1
Yemen,06/11/2007,0,0,0,0,0,0,0,0
Yemen,07/11/2007,0,0,0,0,3,0,0,3
Yemen,08/11/2007,14,0,0,0,18,0,0,32
Yemen,09/11/2007,5,0,0,0,12,1,0,18
Yemen,10/11/2007,3,0,0,0,0,2,0,5
Yemen,11/11/2007,0,0,0,0,-4,0,0,-4
Yemen,12/11/2007,5,0,0,0,6,1,0,12
Yemen,13/11/2007,10,0,0,0,12,0,0,22
Yemen,14/11/2007,0,0,0,0,0,0,0,0
Yemen,15/11/2007,0,0,0,0,12,0,0,12
Yemen,16/11/2007,15,0,2,0,11,0,0,28
Yemen,17/11/2007,0,0,0,0,3,0,0,3
Yemen,18/11/2007,0,0,0,0,0,0,0,0
Yemen,19/11/2007,0,0,0,0,0,0,0,0
Yemen,20/11/2007,2,0,0,0,0,0,0,2
Yemen,21/11/2007,0,0,0,0,0,0,0,0
Yemen,22/11/2007,0,0,0,0,0,0,0,0
Yemen,23/11/2007,-1,0,0,0,0,0,0,-1
Yemen,25/11/2007,-3,0,0,0,0,0,0,-3
Yemen,26/11/2007,2,0,0,0,0,0,0,2
Yemen,27/11/2007,0,0,0,0,0,0,0,0
Yemen,29/11/2007,5,0,0,0,0,0,0,5
Yemen,30/11/2007,0,0,0,0,3,0,0,3
Afghanistan,01/05/2007,143,0,-1,0,33,3,0,178
Afghanistan,02/05/2007,93,6,0,0,8,6,0,113
Afghanistan,03/05/2007,93,0,0,0,-9,13,0,97
Afghanistan,04/05/2007,49,0,0,0,6,7,0,62
Afghanistan,05/05/2007,104,0,1,0,7,31,0,143
Afghanistan,06/05/2007,84,0,-1,0,6,23,0,112
Afghanistan,07/05/2007,82,0,0,0,22,4,0,108
Afghanistan,08/05/2007,181,0,0,0,24,12,0,217
Afghanistan,09/05/2007,136,0,0,0,16,2,0,154
Afghanistan,10/05/2007,98,0,-2,0,35,9,0,140
Afghanistan,11/05/2007,113,0,3,0,12,6,0,134
Afghanistan,12/05/2007,46,0,0,0,10,9,0,65
Afghanistan,13/05/2007,349,0,0,0,46,27,0,422
Afghanistan,14/05/2007,317,0,0,0,43,13,0,373
Afghanistan,15/05/2007,252,0,0,0,43,37,0,332
Afghanistan,16/05/2007,258,0,-4,0,7,31,0,292
Afghanistan,17/05/2007,135,0,-3,0,20,35,0,187
Afghanistan,18/05/2007,88,2,0,0,33,27,0,150
Afghanistan,19/05/2007,76,0,-2,0,51,16,0,141
Afghanistan,20/05/2007,65,0,0,0,78,14,0,157
Afghanistan,21/05/2007,104,0,0,0,38,11,0,153
Afghanistan,22/05/2007,107,0,0,0,8,3,0,118
Afghanistan,23/05/2007,112,0,1,0,59,20,0,192
Afghanistan,24/05/2007,61,4,0,0,29,0,0,94
Afghanistan,25/05/2007,67,0,0,0,20,9,0,96
Afghanistan,26/05/2007,59,0,0,0,6,6,0,71
Afghanistan,27/05/2007,89,2,0,0,-2,6,0,95
Afghanistan,28/05/2007,124,0,0,0,8,13,0,145
Afghanistan,29/05/2007,76,0,0,0,43,31,0,150
Afghanistan,30/05/2007,62,0,0,0,24,2,0,88
Afghanistan,31/05/2007,100,0,-4,0,31,23,0,150
Albania,01/05/2007,4,0,-6,0,0,0,0,-2
Albania,02/05/2007,-2,0,0,0,30,2,0,30
Albania,03/05/2007,5,0,0,0,6,0,0,11
Albania,04/05/2007,4,0,0,0,0,0,0,4
Albania,05/05/2007,8,0,-2,0,-2,2,0,6
Albania,06/05/2007,3,0,0,0,-4,0,0,-1
Albania,07/05/2007,24,0,0,0,6,2,0,32
Albania,08/05/2007,32,0,0,0,17,1,0,50
Albania,09/05/2007,28,0,0,0,18,0,0,46
Albania,10/05/2007,13,0,-2,0,3,2,0,16
Albania,11/05/2007,32,0,-4,0,7,4,0,39
Albania,12/05/2007,8,0,0,0,0,1,0,9
Albania,13/05/2007,25,0,0,0,0,0,0,25
Albania,14/05/2007,43,0,-2,0,-1,0,0,40
Albania,15/05/2007,5,0,2,0,24,13,0,44
Albania,16/05/2007,3,0,0,0,12,0,0,15
Albania,17/05/2007,18,0,0,0,7,1,0,26
Albania,18/05/2007,2,0,0,0,9,0,0,11
Albania,19/05/2007,11,0,0,0,3,0,0,14
Albania,20/05/2007,5,0,0,0,6,0,0,11
Albania,21/05/2007,15,0,0,0,16,2,0,33
Albania,22/05/2007,5,0,-6,0,0,1,0,0
Albania,23/05/2007,11,0,0,0,18,11,0,40
Albania,24/05/2007,10,0,-2,0,0,0,0,8
Albania,25/05/2007,3,0,0,0,0,1,0,4
Albania,26/05/2007,3,0,0,0,0,0,0,3
Albania,27/05/2007,5,0,0,0,0,0,0,5
Albania,28/05/2007,4,0,0,0,0,0,0,4
Albania,29/05/2007,8,0,0,0,9,0,0,17
Albania,30/05/2007,10,0,0,0,0,-4,0,6
Albania,31/05/2007,25,0,-2,0,0,0,0,23
Algeria,01/05/2007,1,0,0,0,0,0,0,1
Algeria,02/05/2007,3,0,0,0,0,0,0,3
Algeria,03/05/2007,2,0,0,0,0,0,0,2
Algeria,04/05/2007,0,0,0,0,3,0,0,3
Algeria,05/05/2007,0,0,0,0,0,0,0,0
Algeria,06/05/2007,6,0,0,0,3,2,0,11
Algeria,07/05/2007,0,0,0,0,12,0,0,12
Algeria,08/05/2007,9,0,-8,0,15,0,0,16
Algeria,09/05/2007,6,0,0,0,-4,3,0,5
Algeria,10/05/2007,3,0,0,0,3,0,0,6
Algeria,11/05/2007,14,0,0,0,24,0,0,38
Algeria,12/05/2007,13,0,0,0,7,0,0,20
Algeria,13/05/2007,2,0,0,0,12,6,0,20
Algeria,14/05/2007,1,0,0,0,-4,14,0,11
Algeria,15/05/2007,-7,0,0,0,0,0,0,-7
Algeria,16/05/2007,7,0,0,0,0,3,0,10
Algeria,17/05/2007,0,0,1,0,1,3,0,5
Algeria,18/05/2007,7,0,0,0,18,3,0,28
Algeria,19/05/2007,0,0,0,0,0,1,0,1
Algeria,20/05/2007,2,0,0,0,0,0,0,2
Algeria,21/05/2007,25,0,0,0,0,0,0,25
Algeria,22/05/2007,19,0,3,0,3,0,0,25
Algeria,23/05/2007,12,0,0,0,12,0,0,24
Algeria,24/05/2007,15,0,-2,0,3,0,0,16
Algeria,25/05/2007,5,0,0,0,3,0,0,8
Algeria,26/05/2007,4,0,0,0,0,0,0,4
Algeria,27/05/2007,3,0,0,0,0,0,0,3
Algeria,28/05/2007,4,0,0,0,3,0,0,7
Algeria,29/05/2007,4,0,0,0,0,0,0,4
Algeria,30/05/2007,0,0,0,0,6,1,0,7
Algeria,31/05/2007,2,0,0,0,0,0,0,2
Bangladesh,01/05/2007,15,0,0,0,6,0,0,21
Bangladesh,02/05/2007,3,0,0,0,6,0,0,9
Bangladesh,03/05/2007,3,0,0,0,0,2,0,5
Bangladesh,04/05/2007,5,0,0,0,4,0,0,9
Bangladesh,05/05/2007,9,0,0,0,0,0,0,9
Bangladesh,06/05/2007,9,2,0,0,0,1,0,12
Bangladesh,07/05/2007,2,0,-2,0,3,0,0,3
Bangladesh,08/05/2007,18,0,2,0,5,2,0,27
Bangladesh,09/05/2007,1,0,-1,0,3,1,0,4
Bangladesh,10/05/2007,14,0,-2,0,3,2,0,17
Bangladesh,11/05/2007,11,0,0,0,3,0,0,14
Bangladesh,12/05/2007,2,0,0,0,6,0,0,8
Bangladesh,13/05/2007,2,0,0,0,16,1,0,19
Bangladesh,14/05/2007,6,0,0,0,24,0,0,30
Bangladesh,15/05/2007,0,0,0,0,3,0,0,3
Bangladesh,16/05/2007,0,0,-2,0,7,0,0,5
Bangladesh,17/05/2007,5,0,0,0,6,0,0,11
Bangladesh,18/05/2007,0,0,0,0,9,0,0,9
Bangladesh,19/05/2007,3,0,0,0,-1,0,0,2
Bangladesh,20/05/2007,0,0,0,0,3,0,0,3
Bangladesh,21/05/2007,9,0,0,0,12,0,0,21
Bangladesh,22/05/2007,19,0,0,0,0,1,0,20
Bangladesh,23/05/2007,10,0,2,0,6,5,0,23
Bangladesh,24/05/2007,0,0,0,0,6,0,0,6
Bangladesh,25/05/2007,3,0,0,0,3,1,0,7
Bangladesh,26/05/2007,7,0,0,0,0,0,0,7
Bangladesh,27/05/2007,11,0,-6,0,0,0,0,5
Bangladesh,28/05/2007,4,0,0,0,9,0,0,13
Bangladesh,29/05/2007,12,0,-4,0,15,1,0,24
Bangladesh,30/05/2007,8,0,0,0,6,2,0,16
Bangladesh,31/05/2007,-1,0,0,0,3,0,0,2
Cameroon,01/05/2007,1,0,0,0,0,0,0,1
Cameroon,03/05/2007,-1,0,0,0,0,0,0,-1
Cameroon,04/05/2007,-1,0,0,0,0,0,0,-1
Cameroon,05/05/2007,0,0,0,0,0,0,0,0
Cameroon,06/05/2007,0,0,0,0,-2,0,0,-2
Cameroon,07/05/2007,15,0,0,0,3,1,0,19
Cameroon,08/05/2007,0,0,0,0,0,0,0,0
Cameroon,09/05/2007,6,0,0,0,0,1,0,7
Cameroon,10/05/2007,0,0,0,0,0,0,0,0
Cameroon,11/05/2007,0,0,0,0,3,0,0,3
Cameroon,12/05/2007,0,0,0,0,0,0,0,0
Cameroon,14/05/2007,-2,0,0,0,0,0,0,-2
Cameroon,15/05/2007,0,0,0,0,0,0,0,0
Cameroon,16/05/2007,2,0,0,0,0,0,0,2
Cameroon,17/05/2007,1,0,0,0,0,0,0,1
Cameroon,18/05/2007,0,0,0,0,0,0,0,0
Cameroon,19/05/2007,0,0,0,0,3,1,0,4
Cameroon,20/05/2007,0,0,0,0,3,1,0,4
Cameroon,21/05/2007,12,0,0,0,3,0,0,15
Cameroon,22/05/2007,3,0,0,0,0,0,0,3
Cameroon,23/05/2007,0,0,0,0,12,12,0,24
Cameroon,24/05/2007,2,0,0,0,0,0,0,2
Cameroon,25/05/2007,1,0,0,0,6,0,0,7
Cameroon,27/05/2007,1,0,0,0,0,0,0,1
Cameroon,28/05/2007,2,0,0,0,0,0,0,2
Cameroon,29/05/2007,1,0,0,0,0,0,0,1
Cameroon,30/05/2007,0,0,0,0,0,0,0,0
Cameroon,31/05/2007,15,0,0,0,-1,0,0,14
China,01/05/2007,72,0,0,0,37,15,0,124
China,02/05/2007,41,0,0,0,26,6,0,73
China,03/05/2007,69,0,-1,0,55,1,0,124
China,04/05/2007,36,0,0,0,19,2,0,57
China,05/05/2007,40,0,0,0,3,0,0,43
China,06/05/2007,-6,0,0,0,-1,1,0,-6
China,07/05/2007,39,0,2,0,9,2,0,52
China,08/05/2007,42,0,-1,0,39,3,0,83
China,09/05/2007,15,0,0,0,27,2,0,44
China,10/05/2007,12,0,2,0,18,6,0,38
China,11/05/2007,48,0,1,0,9,4,0,62
China,12/05/2007,51,0,-4,0,21,1,0,69
China,13/05/2007,41,2,-4,0,17,0,0,56
China,14/05/2007,35,0,-2,0,16,9,0,58
China,15/05/2007,47,0,-2,0,-17,8,0,36
China,16/05/2007,55,0,-4,0,23,6,0,80
China,17/05/2007,65,0,0,0,45,9,0,119
China,18/05/2007,43,0,-2,0,26,2,0,69
China,19/05/2007,17,0,0,0,4,2,0,23
China,20/05/2007,67,0,0,0,4,4,0,75
China,21/05/2007,36,0,1,0,0,8,0,45
China,22/05/2007,40,6,3,0,48,5,0,102
China,23/05/2007,75,0,0,0,28,8,0,111
China,24/05/2007,91,2,-2,0,62,6,0,159
China,25/05/2007,68,0,0,0,49,6,0,123
China,26/05/2007,27,0,0,0,13,4,0,44
China,27/05/2007,51,0,0,0,5,4,0,60
China,28/05/2007,23,0,1,0,8,17,0,49
China,29/05/2007,62,0,3,0,67,5,0,137
China,30/05/2007,53,0,1,0,43,10,0,107
China,31/05/2007,94,0,-2,0,35,7,0,134
Egypt,01/05/2007,69,0,0,0,12,4,0,85
Egypt,02/05/2007,47,0,0,0,31,3,0,81
Egypt,03/05/2007,31,0,0,0,3,0,0,34
Egypt,04/05/2007,86,0,0,0,2,4,0,92
Egypt,05/05/2007,50,0,0,0,1,2,0,53
Egypt,06/05/2007,6,0,0,0,0,0,0,6
Egypt,07/05/2007,8,0,0,0,3,0,0,11
Egypt,08/05/2007,16,0,-2,0,17,4,0,35
Egypt,09/05/2007,28,0,0,0,28,0,0,56
Egypt,10/05/2007,1,0,0,0,6,0,0,7
Egypt,11/05/2007,6,0,0,0,0,0,0,6
Egypt,12/05/2007,0,8,0,0,0,0,0,8
Egypt,13/05/2007,18,0,-2,0,9,2,0,27
Egypt,14/05/2007,41,0,-4,0,6,6,0,49
Egypt,15/05/2007,72,0,-4,0,3,3,0,74
Egypt,16/05/2007,105,0,-3,0,8,2,0,112
Egypt,17/05/2007,56,0,-2,0,10,0,0,64
Egypt,18/05/2007,22,2,0,0,6,0,0,30
Egypt,19/05/2007,45,0,0,0,2,0,0,47
Egypt,20/05/2007,19,0,2,0,3,0,0,24
Egypt,21/05/2007,47,0,4,0,28,0,0,79
Egypt,22/05/2007,33,0,0,0,3,1,0,37
Egypt,23/05/2007,21,0,0,0,9,1,0,31
Egypt,24/05/2007,21,0,0,0,8,4,0,33
Egypt,25/05/2007,6,0,0,0,-6,4,0,4
Egypt,26/05/2007,62,0,0,0,-4,9,0,67
Egypt,27/05/2007,24,0,0,0,-2,7,0,29
Egypt,28/05/2007,10,0,0,0,4,0,0,14
Egypt,29/05/2007,14,0,0,0,18,2,0,34
Egypt,30/05/2007,-3,0,-2,0,5,0,0,0
Egypt,31/05/2007,8,0,-2,0,36,0,0,42
Eritrea,01/05/2007,-1,0,0,0,0,0,0,-1
Eritrea,02/05/2007,14,0,0,0,-4,0,0,10
Eritrea,03/05/2007,-1,0,0,0,12,0,0,11
Eritrea,04/05/2007,2,0,0,0,0,0,0,2
Eritrea,05/05/2007,0,0,0,0,0,0,0,0
Eritrea,06/05/2007,0,0,0,0,0,0,0,0
Eritrea,07/05/2007,0,0,0,0,0,0,0,0
Eritrea,08/05/2007,8,2,0,0,0,0,0,10
Eritrea,09/05/2007,0,0,-2,0,-4,0,0,-6
Eritrea,10/05/2007,5,0,-2,0,-1,3,0,5
Eritrea,11/05/2007,4,0,0,0,0,0,0,4
Eritrea,14/05/2007,1,0,0,0,3,0,0,4
Eritrea,15/05/2007,0,0,0,0,3,0,0,3
Eritrea,16/05/2007,0,0,0,0,0,0,0,0
Eritrea,17/05/2007,0,0,0,0,0,0,0,0
Eritrea,19/05/2007,21,0,0,0,0,0,0,21
Eritrea,23/05/2007,-1,0,0,0,24,0,0,23
Eritrea,24/05/2007,3,0,0,0,0,2,0,5
Eritrea,25/05/2007,0,0,0,0,0,0,0,0
Eritrea,26/05/2007,0,0,0,0,0,0,0,0
Eritrea,28/05/2007,2,0,0,0,0,3,0,5
Eritrea,29/05/2007,15,0,0,0,3,0,0,18
Eritrea,30/05/2007,2,0,0,0,3,0,0,5
Eritrea,31/05/2007,0,0,0,0,0,0,0,0
Georgia,01/05/2007,7,0,0,0,1,4,0,12
Georgia,02/05/2007,7,0,0,0,3,1,0,11
Georgia,03/05/2007,5,0,0,0,0,0,0,5
Georgia,04/05/2007,0,0,0,0,-2,0,0,-2
Georgia,05/05/2007,6,0,0,0,-2,0,0,4
Georgia,06/05/2007,0,0,0,0,0,0,0,0
Georgia,07/05/2007,3,0,0,0,0,0,0,3
Georgia,08/05/2007,-1,0,-2,0,0,3,0,0
Georgia,09/05/2007,0,0,0,0,0,0,0,0
Georgia,10/05/2007,2,0,0,0,10,0,0,12
Georgia,11/05/2007,27,0,0,0,0,0,0,27
Georgia,12/05/2007,1,0,0,0,0,2,0,3
Georgia,13/05/2007,0,0,0,0,0,0,0,0
Georgia,14/05/2007,9,0,0,0,6,0,0,15
Georgia,15/05/2007,2,0,0,0,9,0,0,11
Georgia,16/05/2007,4,0,0,0,6,0,0,10
Georgia,17/05/2007,12,0,0,0,6,0,0,18
Georgia,18/05/2007,12,0,0,0,0,0,0,12
Georgia,19/05/2007,2,0,0,0,0,0,0,2
Georgia,20/05/2007,6,0,0,0,-2,0,0,4
Georgia,21/05/2007,9,0,0,0,0,0,0,9
Georgia,22/05/2007,7,0,0,0,4,0,0,11
Georgia,23/05/2007,6,0,0,0,3,0,0,9
Georgia,24/05/2007,4,0,0,0,6,0,0,10
Georgia,25/05/2007,4,0,0,0,0,0,0,4
Georgia,26/05/2007,0,0,0,0,0,0,0,0
Georgia,27/05/2007,0,0,0,0,0,0,0,0
Georgia,28/05/2007,3,0,0,0,0,0,0,3
Georgia,29/05/2007,5,0,0,0,0,1,0,6
Georgia,30/05/2007,9,0,0,0,0,0,0,9
Georgia,31/05/2007,7,0,0,0,15,0,0,22
India,01/05/2007,16,0,0,0,9,18,0,43
India,02/05/2007,18,0,0,0,0,2,0,20
India,03/05/2007,48,0,0,0,6,12,0,66
India,04/05/2007,62,0,0,0,9,0,0,71
India,05/05/2007,20,0,0,0,3,1,0,24
India,06/05/2007,6,0,1,0,6,0,0,13
India,07/05/2007,41,0,0,0,5,2,0,48
India,08/05/2007,46,0,0,0,17,3,0,66
India,09/05/2007,14,2,-1,0,6,1,0,22
India,10/05/2007,8,0,0,0,4,1,0,13
India,11/05/2007,4,2,0,0,3,8,0,17
India,12/05/2007,7,2,0,0,6,2,0,17
India,13/05/2007,18,0,0,0,-2,2,0,18
India,14/05/2007,46,0,0,0,-2,3,0,47
India,15/05/2007,30,0,-2,0,2,8,0,38
India,16/05/2007,34,0,-1,0,33,3,0,69
India,17/05/2007,30,0,0,0,2,4,0,36
India,18/05/2007,23,0,1,0,11,3,0,38
India,19/05/2007,16,0,0,0,3,7,0,26
India,20/05/2007,9,0,0,0,5,4,0,18
India,21/05/2007,8,0,0,0,3,6,0,17
India,22/05/2007,15,0,0,0,20,2,0,37
India,23/05/2007,34,0,1,0,17,5,0,57
India,24/05/2007,21,0,2,0,27,6,0,56
India,25/05/2007,19,4,-2,0,-2,5,0,24
India,26/05/2007,12,0,0,0,0,0,0,12
India,27/05/2007,12,0,0,0,-6,1,0,7
India,28/05/2007,37,0,-2,0,6,7,0,48
India,29/05/2007,30,0,2,0,12,6,0,50
India,30/05/2007,15,0,1,0,-2,1,0,15
India,31/05/2007,31,0,-1,0,1,0,0,31
Iran,01/05/2007,33,0,0,0,-1,18,0,50
Iran,02/05/2007,59,4,2,0,19,0,0,84
Iran,03/05/2007,46,0,0,0,22,7,0,75
Iran,04/05/2007,97,4,-2,0,56,6,0,161
Iran,05/05/2007,46,0,0,0,29,5,0,80
Iran,06/05/2007,51,0,0,0,4,1,0,56
Iran,07/05/2007,43,0,0,0,37,9,0,89
Iran,08/05/2007,45,0,2,0,14,3,0,64
Iran,09/05/2007,47,0,0,0,5,11,0,63
Iran,10/05/2007,63,0,-2,0,22,11,0,94
Iran,11/05/2007,40,0,-3,0,12,4,0,53
Iran,12/05/2007,55,0,0,0,6,6,0,67
Iran,13/05/2007,58,2,0,0,24,3,0,87
Iran,14/05/2007,65,0,-2,0,40,2,0,105
Iran,15/05/2007,40,0,-2,0,10,0,0,48
Iran,16/05/2007,38,0,0,0,4,1,0,43
Iran,17/05/2007,24,0,-3,0,29,0,0,50
Iran,18/05/2007,44,0,1,0,12,2,0,59
Iran,19/05/2007,108,2,2,0,15,15,0,142
Iran,20/05/2007,17,0,0,0,13,0,0,30
Iran,21/05/2007,53,0,0,0,23,7,0,83
Iran,22/05/2007,20,0,-3,0,5,0,0,22
Iran,23/05/2007,86,0,1,0,21,9,0,117
Iran,24/05/2007,73,0,0,0,11,5,0,89
Iran,25/05/2007,93,0,2,0,33,0,0,128
Iran,26/05/2007,37,0,7,0,32,5,0,81
Iran,27/05/2007,56,0,0,0,11,0,0,67
Iran,28/05/2007,49,0,0,0,21,9,0,79
Iran,29/05/2007,36,0,-1,0,56,4,0,95
Iran,30/05/2007,54,0,0,0,-2,4,0,56
Iran,31/05/2007,80,0,2,0,52,1,0,135
Iraq,01/05/2007,320,2,-14,0,58,18,0,384
Iraq,02/05/2007,259,2,-29,0,45,18,0,295
Iraq,03/05/2007,235,4,5,0,36,17,0,297
Iraq,04/05/2007,187,6,2,0,24,11,0,230
Iraq,05/05/2007,130,2,1,0,20,6,0,159
Iraq,06/05/2007,54,2,-17,0,18,14,0,71
Iraq,07/05/2007,106,8,0,0,37,9,0,160
Iraq,08/05/2007,144,4,-11,0,38,12,0,187
Iraq,09/05/2007,174,0,-9,0,65,21,0,251
Iraq,10/05/2007,192,0,-32,0,58,17,0,235
Iraq,11/05/2007,163,0,-16,0,27,18,0,192
Iraq,12/05/2007,103,0,-13,0,36,4,0,130
Iraq,13/05/2007,183,0,-9,0,22,4,0,200
Iraq,14/05/2007,120,0,-8,0,55,12,0,179
Iraq,15/05/2007,139,0,-12,0,25,13,0,165
Iraq,16/05/2007,234,0,-4,0,24,20,0,274
Iraq,17/05/2007,173,4,-7,0,4,28,0,202
Iraq,18/05/2007,142,12,-5,0,14,20,0,183
Iraq,19/05/2007,83,2,-8,0,3,3,0,83
Iraq,20/05/2007,42,6,-10,0,21,5,0,64
Iraq,21/05/2007,254,0,-2,0,73,15,0,340
Iraq,22/05/2007,221,6,1,0,64,29,0,321
Iraq,23/05/2007,189,10,-2,0,83,47,0,327
Iraq,24/05/2007,146,2,-6,0,26,10,0,178
Iraq,25/05/2007,169,4,18,0,44,66,0,301
Iraq,26/05/2007,129,0,9,0,32,22,0,192
Iraq,27/05/2007,72,2,0,0,13,34,0,121
Iraq,28/05/2007,100,0,0,0,56,53,0,209
Iraq,29/05/2007,139,2,-6,0,41,17,0,193
Iraq,30/05/2007,145,2,-1,0,48,4,0,198
Iraq,31/05/2007,74,6,-2,0,55,7,0,140
Morocco,01/05/2007,10,0,0,0,2,0,0,12
Morocco,02/05/2007,8,0,0,0,9,1,0,18
Morocco,03/05/2007,20,0,0,0,3,0,0,23
Morocco,04/05/2007,3,0,0,0,7,0,0,10
Morocco,05/05/2007,0,0,0,0,3,0,0,3
Morocco,06/05/2007,6,0,0,0,0,0,0,6
Morocco,07/05/2007,2,0,0,0,0,0,0,2
Morocco,08/05/2007,8,0,0,0,-4,7,0,11
Morocco,09/05/2007,10,0,0,0,2,3,0,15
Morocco,10/05/2007,7,0,0,0,3,0,0,10
Morocco,11/05/2007,15,0,0,0,33,5,0,53
Morocco,12/05/2007,0,0,0,0,3,0,0,3
Morocco,13/05/2007,0,0,0,0,0,0,0,0
Morocco,14/05/2007,0,0,0,0,0,0,0,0
Morocco,15/05/2007,3,0,0,0,1,0,0,4
Morocco,16/05/2007,1,0,0,0,9,1,0,11
Morocco,17/05/2007,4,0,0,0,6,0,0,10
Morocco,18/05/2007,3,0,0,0,6,0,0,9
Morocco,19/05/2007,5,0,0,0,0,0,0,5
Morocco,20/05/2007,4,0,0,0,6,0,0,10
Morocco,21/05/2007,20,0,0,0,9,2,0,31
Morocco,22/05/2007,16,0,0,0,6,0,0,22
Morocco,23/05/2007,1,0,0,0,3,0,0,4
Morocco,24/05/2007,1,0,0,0,9,6,0,16
Morocco,25/05/2007,8,0,0,0,12,0,0,20
Morocco,26/05/2007,0,0,0,0,6,0,0,6
Morocco,27/05/2007,0,0,0,0,-2,0,0,-2
Morocco,28/05/2007,0,0,0,0,33,2,0,35
Morocco,29/05/2007,0,0,0,0,27,0,0,27
Morocco,30/05/2007,3,0,0,0,4,0,0,7
Morocco,31/05/2007,-8,0,0,0,6,0,0,-2
Nigeria,01/05/2007,21,0,0,0,15,8,0,44
Nigeria,02/05/2007,20,0,0,0,11,4,0,35
Nigeria,03/05/2007,5,0,-4,0,16,1,0,18
Nigeria,04/05/2007,8,0,-2,0,12,0,0,18
Nigeria,05/05/2007,4,0,0,0,9,1,0,14
Nigeria,06/05/2007,4,0,0,0,9,1,0,14
Nigeria,07/05/2007,15,0,-8,0,8,2,0,17
Nigeria,08/05/2007,5,0,0,0,3,3,0,11
Nigeria,09/05/2007,8,0,0,0,3,4,0,15
Nigeria,10/05/2007,6,0,0,0,-2,0,0,4
Nigeria,11/05/2007,0,0,0,0,33,0,0,33
Nigeria,12/05/2007,3,2,0,0,0,0,0,5
Nigeria,13/05/2007,6,0,0,0,-12,0,0,-6
Nigeria,14/05/2007,33,0,0,0,19,6,0,58
Nigeria,15/05/2007,1,0,-2,0,1,4,0,4
Nigeria,16/05/2007,18,0,0,0,-12,2,0,8
Nigeria,17/05/2007,11,0,1,0,0,2,0,14
Nigeria,18/05/2007,4,0,-2,0,-2,0,0,0
Nigeria,19/05/2007,0,2,0,0,0,0,0,2
Nigeria,20/05/2007,1,0,0,0,3,0,0,4
Nigeria,21/05/2007,12,0,-8,0,4,0,0,8
Nigeria,22/05/2007,2,0,-2,0,5,2,0,7
Nigeria,23/05/2007,7,0,0,0,9,4,0,20
Nigeria,24/05/2007,8,0,0,0,13,2,0,23
Nigeria,25/05/2007,9,0,0,0,9,1,0,19
Nigeria,26/05/2007,8,0,0,0,-4,0,0,4
Nigeria,27/05/2007,3,0,0,0,0,0,0,3
Nigeria,28/05/2007,25,0,0,0,12,7,0,44
Nigeria,29/05/2007,-2,0,0,0,-2,1,0,-3
Nigeria,30/05/2007,9,0,0,0,4,1,0,14
Nigeria,31/05/2007,0,0,0,0,0,0,0,0
Pakistan,01/05/2007,74,0,0,0,55,14,0,143
Pakistan,02/05/2007,19,2,0,0,30,5,0,56
Pakistan,03/05/2007,30,0,0,0,15,0,0,45
Pakistan,04/05/2007,30,0,-2,0,15,0,0,43
Pakistan,05/05/2007,20,0,0,0,-4,5,0,21
Pakistan,06/05/2007,8,0,0,0,8,0,0,16
Pakistan,07/05/2007,41,0,0,0,3,4,0,48
Pakistan,08/05/2007,70,0,0,0,72,0,0,142
Pakistan,09/05/2007,41,0,0,0,47,2,0,90
Pakistan,10/05/2007,33,0,0,0,13,10,0,56
Pakistan,11/05/2007,25,2,0,0,66,0,0,93
Pakistan,12/05/2007,23,0,0,0,15,3,0,41
Pakistan,13/05/2007,184,0,0,0,48,10,0,242
Pakistan,14/05/2007,173,0,0,0,11,12,0,196
Pakistan,15/05/2007,93,0,0,0,44,2,0,139
Pakistan,16/05/2007,69,0,0,0,58,13,0,140
Pakistan,17/05/2007,80,0,-1,0,5,12,0,96
Pakistan,18/05/2007,59,0,0,0,13,16,0,88
Pakistan,19/05/2007,127,0,0,0,9,9,0,145
Pakistan,20/05/2007,24,0,1,0,6,3,0,34
Pakistan,21/05/2007,46,0,0,0,6,0,0,52
Pakistan,22/05/2007,132,0,1,0,33,20,0,186
Pakistan,23/05/2007,123,0,-1,0,13,19,0,154
Pakistan,24/05/2007,31,0,-1,0,14,7,0,51
Pakistan,25/05/2007,29,0,0,0,13,0,0,42
Pakistan,26/05/2007,21,0,-2,0,42,3,0,64
Pakistan,27/05/2007,1,0,0,0,10,1,0,12
Pakistan,28/05/2007,35,0,0,0,23,2,0,60
Pakistan,29/05/2007,40,0,-2,0,39,3,0,80
Pakistan,30/05/2007,48,0,-2,0,1,2,0,49
Pakistan,31/05/2007,70,0,0,0,11,7,0,88
Sierra Leone,01/05/2007,3,0,0,0,3,0,0,6
Sierra Leone,02/05/2007,0,0,0,0,3,0,0,3
Sierra Leone,03/05/2007,0,0,0,0,21,0,0,21
Sierra Leone,04/05/2007,2,0,0,0,3,0,0,5
Sierra Leone,05/05/2007,6,0,0,0,3,0,0,9
Sierra Leone,07/05/2007,2,0,0,0,6,0,0,8
Sierra Leone,08/05/2007,0,0,0,0,6,0,0,6
Sierra Leone,09/05/2007,0,0,0,0,0,0,0,0
Sierra Leone,10/05/2007,2,0,0,0,0,0,0,2
Sierra Leone,11/05/2007,1,0,0,0,0,0,0,1
Sierra Leone,14/05/2007,0,0,0,0,0,0,0,0
Sierra Leone,15/05/2007,0,12,0,0,0,0,0,12
Sierra Leone,16/05/2007,0,0,0,0,0,0,0,0
Sierra Leone,19/05/2007,0,0,0,0,3,0,0,3
Sierra Leone,21/05/2007,0,0,0,0,0,0,0,0
Sierra Leone,23/05/2007,0,0,0,0,21,22,0,43
Sierra Leone,24/05/2007,0,0,0,0,0,0,0,0
Sierra Leone,25/05/2007,0,0,0,0,0,0,0,0
Sierra Leone,26/05/2007,10,0,0,0,0,0,0,10
Sierra Leone,27/05/2007,0,0,0,0,0,0,0,0
Sierra Leone,28/05/2007,0,0,0,0,0,0,0,0
Sierra Leone,29/05/2007,2,0,-6,0,-4,2,0,-6
Sierra Leone,30/05/2007,6,0,0,0,9,0,0,15
Sierra Leone,31/05/2007,7,0,0,0,9,0,0,16
Somalia,01/05/2007,19,0,0,0,0,0,0,19
Somalia,02/05/2007,30,0,0,0,-2,0,0,28
Somalia,03/05/2007,19,0,0,0,12,0,0,31
Somalia,04/05/2007,4,0,0,0,2,0,0,6
Somalia,05/05/2007,0,0,0,0,6,0,0,6
Somalia,06/05/2007,8,0,0,0,6,2,0,16
Somalia,07/05/2007,4,0,0,0,12,0,0,16
Somalia,08/05/2007,15,0,0,0,0,1,0,16
Somalia,09/05/2007,6,0,0,0,0,1,0,7
Somalia,10/05/2007,4,0,0,0,0,2,0,6
Somalia,11/05/2007,15,0,0,0,0,3,0,18
Somalia,12/05/2007,-2,0,0,0,0,0,0,-2
Somalia,13/05/2007,2,0,0,0,1,0,0,3
Somalia,14/05/2007,0,0,0,0,7,0,0,7
Somalia,15/05/2007,27,0,0,0,18,0,0,45
Somalia,16/05/2007,86,0,0,0,36,19,0,141
Somalia,17/05/2007,5,0,0,0,20,0,0,25
Somalia,18/05/2007,4,0,0,0,18,5,0,27
Somalia,19/05/2007,20,0,0,0,-2,12,0,30
Somalia,20/05/2007,14,0,-2,0,1,0,0,13
Somalia,21/05/2007,15,0,0,0,0,0,0,15
Somalia,22/05/2007,14,0,0,0,21,0,0,35
Somalia,23/05/2007,4,0,0,0,10,1,0,15
Somalia,24/05/2007,7,0,0,0,0,0,0,7
Somalia,25/05/2007,8,0,0,0,6,0,0,14
Somalia,26/05/2007,3,0,0,0,9,0,0,12
Somalia,27/05/2007,4,0,0,0,36,0,0,40
Somalia,28/05/2007,4,0,0,0,3,0,0,7
Somalia,29/05/2007,1,0,0,0,0,0,0,1
Somalia,30/05/2007,15,2,0,0,21,6,0,44
Somalia,31/05/2007,5,2,0,0,9,0,0,16
Syria,01/05/2007,17,0,0,0,3,0,0,20
Syria,02/05/2007,26,0,0,0,0,0,0,26
Syria,03/05/2007,26,0,0,0,23,0,0,49
Syria,04/05/2007,42,0,2,0,7,2,0,53
Syria,05/05/2007,21,0,1,0,15,0,0,37
Syria,06/05/2007,19,0,-6,0,-6,0,0,7
Syria,07/05/2007,21,0,0,0,5,0,0,26
Syria,08/05/2007,10,2,1,0,0,12,0,25
Syria,09/05/2007,11,2,0,0,4,3,0,20
Syria,10/05/2007,22,0,0,0,2,1,0,25
Syria,11/05/2007,16,0,0,0,-4,2,0,14
Syria,12/05/2007,24,0,-2,0,-2,4,0,24
Syria,13/05/2007,0,0,0,0,27,0,0,27
Syria,14/05/2007,15,0,0,0,20,3,0,38
Syria,15/05/2007,22,0,-10,0,12,1,0,25
Syria,16/05/2007,33,0,0,0,9,0,0,42
Syria,17/05/2007,15,0,0,0,3,0,0,18
Syria,18/05/2007,10,0,0,0,15,0,0,25
Syria,19/05/2007,2,0,0,0,6,0,0,8
Syria,20/05/2007,71,0,-2,0,30,7,0,106
Syria,21/05/2007,112,0,0,0,15,29,0,156
Syria,22/05/2007,51,0,1,0,5,6,0,63
Syria,23/05/2007,56,4,0,0,33,2,0,95
Syria,24/05/2007,64,2,0,0,39,0,0,105
Syria,25/05/2007,35,0,0,0,3,6,0,44
Syria,26/05/2007,23,0,7,0,9,0,0,39
Syria,27/05/2007,27,0,3,0,2,2,0,34
Syria,28/05/2007,18,0,1,0,27,0,0,46
Syria,29/05/2007,30,0,0,0,8,3,0,41
Syria,30/05/2007,27,0,-2,0,38,8,0,71
Syria,31/05/2007,67,0,-9,0,44,8,0,110
Yemen,01/05/2007,2,0,0,0,0,0,0,2
Yemen,02/05/2007,5,0,0,0,3,0,0,8
Yemen,03/05/2007,12,0,0,0,3,0,0,15
Yemen,04/05/2007,1,0,0,0,0,3,0,4
Yemen,05/05/2007,21,0,0,0,9,0,0,30
Yemen,06/05/2007,0,0,0,0,0,0,0,0
Yemen,07/05/2007,0,0,0,0,0,0,0,0
Yemen,08/05/2007,0,0,0,0,12,0,0,12
Yemen,09/05/2007,5,0,0,0,6,0,0,11
Yemen,10/05/2007,7,0,0,0,11,2,0,20
Yemen,11/05/2007,11,0,0,0,9,0,0,20
Yemen,13/05/2007,0,0,0,0,3,0,0,3
Yemen,14/05/2007,0,0,0,0,-6,0,0,-6
Yemen,15/05/2007,0,0,0,0,0,0,0,0
Yemen,16/05/2007,1,0,0,0,0,0,0,1
Yemen,17/05/2007,0,0,0,0,3,0,0,3
Yemen,18/05/2007,39,0,0,0,-1,0,0,38
Yemen,19/05/2007,25,0,0,0,12,0,0,37
Yemen,21/05/2007,13,0,0,0,0,0,0,13
Yemen,22/05/2007,3,0,0,0,0,0,0,3
Yemen,23/05/2007,3,0,2,0,11,0,0,16
Yemen,24/05/2007,8,0,0,0,0,0,0,8
Yemen,25/05/2007,0,0,0,0,0,0,0,0
Yemen,26/05/2007,6,0,0,0,0,0,0,6
Yemen,27/05/2007,1,0,0,0,0,0,0,1
Yemen,28/05/2007,0,0,0,0,-4,0,0,-4
Yemen,29/05/2007,1,0,0,0,-6,0,0,-5
Yemen,30/05/2007,3,0,0,0,3,0,0,6
Yemen,31/05/2007,16,0,0,0,54,2,0,72
Afghanistan,01/09/2012,237,0,0,0,42,16,0,295
Afghanistan,02/09/2012,247,0,0,0,24,16,0,287
Afghanistan,03/09/2012,199,0,0,0,26,77,0,302
Afghanistan,04/09/2012,40,0,0,0,-2,6,0,44
Afghanistan,05/09/2012,238,0,0,0,96,28,0,362
Afghanistan,06/09/2012,119,0,0,0,69,11,0,199
Afghanistan,07/09/2012,260,0,1,0,42,4,0,307
Afghanistan,08/09/2012,85,0,0,0,13,15,0,113
Afghanistan,09/09/2012,134,4,0,0,20,19,0,177
Afghanistan,10/09/2012,273,4,3,0,47,39,0,366
Afghanistan,11/09/2012,315,6,1,0,42,30,0,394
Afghanistan,12/09/2012,496,2,4,0,84,57,0,643
Afghanistan,13/09/2012,256,2,2,0,90,32,0,382
Afghanistan,14/09/2012,377,4,2,0,98,58,0,539
Afghanistan,15/09/2012,484,2,6,0,8,51,0,551
Afghanistan,16/09/2012,418,0,1,0,40,27,0,486
Afghanistan,17/09/2012,338,4,4,0,33,53,0,432
Afghanistan,18/09/2012,427,0,3,0,86,74,0,590
Afghanistan,19/09/2012,223,4,1,0,59,46,0,333
Afghanistan,20/09/2012,170,2,7,0,41,39,0,259
Afghanistan,21/09/2012,140,0,5,0,44,11,0,200
Afghanistan,22/09/2012,114,0,0,0,25,19,0,158
Afghanistan,23/09/2012,105,0,1,0,-5,15,0,116
Afghanistan,24/09/2012,123,0,3,0,53,18,0,197
Afghanistan,25/09/2012,202,2,1,0,34,30,0,269
Afghanistan,26/09/2012,146,0,-1,0,57,24,0,226
Afghanistan,27/09/2012,122,0,1,0,34,9,0,166
Afghanistan,28/09/2012,167,2,6,0,23,11,0,209
Afghanistan,29/09/2012,108,0,1,0,94,8,0,211
Afghanistan,30/09/2012,253,0,2,0,62,21,0,338
Albania,01/09/2012,0,0,0,0,0,0,0,0
Albania,02/09/2012,0,0,0,0,3,0,0,3
Albania,03/09/2012,13,0,0,0,0,0,0,13
Albania,04/09/2012,1,0,0,0,0,0,0,1
Albania,05/09/2012,2,0,-1,0,3,0,0,4
Albania,06/09/2012,0,0,0,0,0,0,0,0
Albania,07/09/2012,23,0,2,0,3,6,0,34
Albania,09/09/2012,0,0,0,0,0,0,0,0
Albania,10/09/2012,40,0,-1,0,6,0,0,45
Albania,11/09/2012,14,0,-1,0,3,0,0,16
Albania,12/09/2012,1,0,0,0,0,0,0,1
Albania,13/09/2012,-1,0,0,0,-4,0,0,-5
Albania,14/09/2012,5,0,0,0,0,0,0,5
Albania,15/09/2012,0,0,0,0,0,0,0,0
Albania,16/09/2012,0,0,0,0,0,0,0,0
Albania,17/09/2012,1,0,0,0,3,0,0,4
Albania,18/09/2012,0,0,0,0,0,0,0,0
Albania,19/09/2012,-2,0,0,0,12,0,0,10
Albania,20/09/2012,2,0,0,0,9,0,0,11
Albania,21/09/2012,0,0,-2,0,0,0,0,-2
Albania,22/09/2012,0,0,0,0,6,1,0,7
Albania,23/09/2012,0,0,0,0,0,0,0,0
Albania,24/09/2012,0,0,0,0,3,0,0,3
Albania,25/09/2012,0,0,0,0,-2,2,0,0
Albania,26/09/2012,1,0,0,0,0,1,0,2
Albania,27/09/2012,-5,0,0,0,0,0,0,-5
Albania,28/09/2012,-5,0,0,0,10,2,0,7
Albania,29/09/2012,0,0,0,0,0,0,0,0
Albania,30/09/2012,0,0,0,0,0,0,0,0
Algeria,01/09/2012,24,0,-6,0,0,2,0,20
Algeria,02/09/2012,14,0,0,0,39,4,0,57
Algeria,03/09/2012,50,0,-22,0,3,1,0,32
Algeria,04/09/2012,9,0,-4,0,6,0,0,11
Algeria,05/09/2012,6,0,0,0,9,0,0,15
Algeria,06/09/2012,7,0,0,0,0,0,0,7
Algeria,07/09/2012,2,0,0,0,0,0,0,2
Algeria,08/09/2012,1,0,0,0,0,0,0,1
Algeria,09/09/2012,30,0,-28,0,18,0,0,20
Algeria,10/09/2012,37,0,-18,0,9,0,0,28
Algeria,11/09/2012,0,0,0,0,-6,2,0,-4
Algeria,12/09/2012,13,0,-6,0,3,5,0,15
Algeria,13/09/2012,3,0,-4,0,0,0,0,-1
Algeria,14/09/2012,12,0,0,0,0,0,0,12
Algeria,15/09/2012,7,0,0,0,0,4,0,11
Algeria,16/09/2012,17,0,0,0,15,1,0,33
Algeria,17/09/2012,25,0,0,0,18,5,0,48
Algeria,18/09/2012,33,0,0,0,21,3,0,57
Algeria,19/09/2012,12,0,0,0,6,3,0,21
Algeria,20/09/2012,21,0,0,0,12,4,0,37
Algeria,21/09/2012,11,0,0,0,-2,1,0,10
Algeria,22/09/2012,0,0,0,0,0,0,0,0
Algeria,23/09/2012,6,0,0,0,7,0,0,13
Algeria,24/09/2012,4,0,-4,0,1,0,0,1
Algeria,25/09/2012,8,0,0,0,0,4,0,12
Algeria,26/09/2012,-1,0,0,0,0,0,0,-1
Algeria,27/09/2012,10,0,0,0,7,0,0,17
Algeria,28/09/2012,25,0,-2,0,1,1,0,25
Algeria,29/09/2012,1,0,0,0,1,5,0,7
Algeria,30/09/2012,0,0,0,0,6,0,0,6
Bangladesh,01/09/2012,24,0,-2,0,22,0,0,44
Bangladesh,02/09/2012,59,0,-5,0,42,5,0,101
Bangladesh,03/09/2012,16,0,0,0,2,6,0,24
Bangladesh,04/09/2012,3,0,0,0,0,0,0,3
Bangladesh,05/09/2012,20,0,0,0,29,5,0,54
Bangladesh,06/09/2012,31,0,-1,0,9,0,0,39
Bangladesh,07/09/2012,18,0,0,0,7,1,0,26
Bangladesh,08/09/2012,31,0,0,0,9,3,0,43
Bangladesh,09/09/2012,43,0,-2,0,18,1,0,60
Bangladesh,10/09/2012,21,0,0,0,7,5,0,33
Bangladesh,11/09/2012,95,0,-2,0,13,1,0,107
Bangladesh,12/09/2012,43,0,-3,0,29,5,0,74
Bangladesh,13/09/2012,38,0,0,0,11,19,0,68
Bangladesh,14/09/2012,27,0,-2,0,12,86,0,123
Bangladesh,15/09/2012,19,0,0,0,6,9,0,34
Bangladesh,16/09/2012,25,0,0,0,12,9,0,46
Bangladesh,17/09/2012,16,0,-2,0,6,8,0,28
Bangladesh,18/09/2012,57,0,1,0,51,39,0,148
Bangladesh,19/09/2012,37,0,0,0,7,29,0,73
Bangladesh,20/09/2012,6,0,0,0,34,8,0,48
Bangladesh,21/09/2012,26,0,0,0,8,8,0,42
Bangladesh,22/09/2012,36,0,0,0,28,9,0,73
Bangladesh,23/09/2012,27,0,1,0,21,15,0,64
Bangladesh,24/09/2012,24,0,0,0,18,7,0,49
Bangladesh,25/09/2012,28,0,0,0,11,8,0,47
Bangladesh,26/09/2012,23,0,2,0,12,3,0,40
Bangladesh,27/09/2012,10,0,1,0,0,2,0,13
Bangladesh,28/09/2012,29,0,-6,0,3,3,0,29
Bangladesh,29/09/2012,29,0,-6,0,9,9,0,41
Bangladesh,30/09/2012,57,0,0,0,33,47,0,137
Cameroon,01/09/2012,5,0,0,0,0,0,0,5
Cameroon,02/09/2012,0,0,0,0,0,0,0,0
Cameroon,03/09/2012,17,0,0,0,0,0,0,17
Cameroon,05/09/2012,0,0,0,0,0,0,0,0
Cameroon,07/09/2012,0,0,0,0,0,0,0,0
Cameroon,08/09/2012,0,0,0,0,0,0,0,0
Cameroon,09/09/2012,0,0,0,0,6,0,0,6
Cameroon,10/09/2012,2,0,0,0,18,1,0,21
Cameroon,11/09/2012,4,0,0,0,-4,0,0,0
Cameroon,12/09/2012,0,0,0,0,0,0,0,0
Cameroon,13/09/2012,0,0,0,0,6,0,0,6
Cameroon,14/09/2012,0,0,0,0,0,0,0,0
Cameroon,15/09/2012,0,0,0,0,0,0,0,0
Cameroon,16/09/2012,0,0,0,0,0,0,0,0
Cameroon,17/09/2012,0,0,0,0,-2,0,0,-2
Cameroon,18/09/2012,2,0,0,0,0,0,0,2
Cameroon,19/09/2012,3,0,0,0,0,0,0,3
Cameroon,20/09/2012,0,0,0,0,0,0,0,0
Cameroon,21/09/2012,-1,0,0,0,3,0,0,2
Cameroon,22/09/2012,0,0,0,0,9,0,0,9
Cameroon,23/09/2012,0,0,0,0,9,0,0,9
Cameroon,24/09/2012,0,0,0,0,3,0,0,3
Cameroon,25/09/2012,0,0,0,0,0,0,0,0
Cameroon,26/09/2012,0,0,0,0,0,0,0,0
Cameroon,27/09/2012,3,0,0,0,0,2,0,5
Cameroon,28/09/2012,1,0,0,0,0,0,0,1
Cameroon,30/09/2012,0,0,0,0,0,0,0,0
China,01/09/2012,95,2,3,0,55,7,0,162
China,02/09/2012,98,2,-1,0,44,4,0,147
China,03/09/2012,116,2,-7,0,29,10,0,150
China,04/09/2012,62,4,0,0,8,1,0,75
China,05/09/2012,246,6,-8,0,37,16,0,297
China,06/09/2012,159,12,3,0,45,34,0,253
China,07/09/2012,126,8,-9,0,37,11,0,173
China,08/09/2012,101,2,-2,0,4,19,0,124
China,09/09/2012,128,2,0,0,16,13,0,159
China,10/09/2012,133,0,0,0,95,25,0,253
China,11/09/2012,139,6,5,0,25,22,0,197
China,12/09/2012,162,0,-2,0,35,38,0,233
China,13/09/2012,94,6,0,0,46,24,0,170
China,14/09/2012,172,0,4,0,57,25,0,258
China,15/09/2012,94,0,1,0,16,10,0,121
China,16/09/2012,112,0,-2,0,24,21,0,155
China,17/09/2012,247,10,1,0,112,39,0,409
China,18/09/2012,237,4,1,0,7,49,0,298
China,19/09/2012,91,4,-4,0,40,9,0,140
China,20/09/2012,166,8,-5,0,64,23,0,256
China,21/09/2012,164,2,-19,0,59,28,0,234
China,22/09/2012,63,0,2,0,7,12,0,84
China,23/09/2012,96,0,-2,0,5,7,0,106
China,24/09/2012,188,12,-4,0,76,29,0,301
China,25/09/2012,162,4,-7,0,79,22,0,260
China,26/09/2012,300,6,0,0,87,46,0,439
China,27/09/2012,183,4,2,0,53,23,0,265
China,28/09/2012,272,2,2,0,74,15,0,365
China,29/09/2012,149,4,2,0,27,13,0,195
China,30/09/2012,59,0,-3,0,37,15,0,108
Egypt,01/09/2012,84,0,-1,0,68,10,0,161
Egypt,02/09/2012,66,0,-1,0,32,5,0,102
Egypt,03/09/2012,-4,4,0,0,59,15,0,74
Egypt,04/09/2012,30,2,2,0,12,5,0,51
Egypt,05/09/2012,119,0,1,0,19,0,0,139
Egypt,06/09/2012,80,0,0,0,30,10,0,120
Egypt,07/09/2012,26,0,-8,0,1,9,0,28
Egypt,08/09/2012,99,0,-3,0,35,3,0,134
Egypt,09/09/2012,96,2,0,0,56,3,0,157
Egypt,10/09/2012,54,0,-4,0,38,5,0,93
Egypt,11/09/2012,60,0,-2,0,0,23,0,81
Egypt,12/09/2012,200,4,-1,0,26,64,0,293
Egypt,13/09/2012,236,0,-2,0,61,98,0,393
Egypt,14/09/2012,330,4,1,0,94,108,0,537
Egypt,15/09/2012,389,0,7,0,105,129,0,630
Egypt,16/09/2012,362,2,8,0,66,69,0,507
Egypt,17/09/2012,206,0,0,0,117,64,0,387
Egypt,18/09/2012,380,0,-2,0,148,96,0,622
Egypt,19/09/2012,114,0,-1,0,95,35,0,243
Egypt,20/09/2012,162,0,-3,0,42,20,0,221
Egypt,21/09/2012,261,0,-1,0,66,41,0,367
Egypt,22/09/2012,144,0,-2,0,75,30,0,247
Egypt,23/09/2012,180,0,0,0,33,32,0,245
Egypt,24/09/2012,153,0,4,0,107,19,0,283
Egypt,25/09/2012,192,0,-2,0,36,10,0,236
Egypt,26/09/2012,147,0,6,0,41,35,0,229
Egypt,27/09/2012,83,0,-3,0,119,14,0,213
Egypt,28/09/2012,55,0,2,0,76,13,0,146
Egypt,29/09/2012,82,0,0,0,29,23,0,134
Egypt,30/09/2012,41,0,-4,0,19,17,0,73
Eritrea,01/09/2012,6,0,0,0,3,0,0,9
Eritrea,02/09/2012,11,0,0,0,3,0,0,14
Eritrea,03/09/2012,8,0,0,0,0,0,0,8
Eritrea,05/09/2012,19,0,0,0,22,0,0,41
Eritrea,06/09/2012,34,4,0,0,-5,0,0,33
Eritrea,07/09/2012,6,0,0,0,9,1,0,16
Eritrea,08/09/2012,0,0,0,0,-2,0,0,-2
Eritrea,09/09/2012,3,2,0,0,0,0,0,5
Eritrea,10/09/2012,5,0,0,0,4,0,0,9
Eritrea,11/09/2012,-1,0,0,0,0,0,0,-1
Eritrea,12/09/2012,0,0,0,0,1,0,0,1
Eritrea,13/09/2012,6,0,0,0,6,2,0,14
Eritrea,14/09/2012,5,0,0,0,0,0,0,5
Eritrea,15/09/2012,0,0,0,0,0,0,0,0
Eritrea,17/09/2012,0,0,0,0,0,0,0,0
Eritrea,18/09/2012,10,0,0,0,-2,0,0,8
Eritrea,19/09/2012,2,0,0,0,1,0,0,3
Eritrea,20/09/2012,1,0,2,0,3,0,0,6
Eritrea,21/09/2012,5,0,0,0,0,0,0,5
Eritrea,22/09/2012,3,0,0,0,0,0,0,3
Eritrea,23/09/2012,5,0,0,0,21,0,0,26
Eritrea,24/09/2012,3,0,0,0,0,0,0,3
Eritrea,25/09/2012,3,0,0,0,12,0,0,15
Eritrea,27/09/2012,0,0,0,0,0,0,0,0
Georgia,01/09/2012,0,0,0,0,0,0,0,0
Georgia,02/09/2012,0,0,0,0,0,0,0,0
Georgia,03/09/2012,0,0,0,0,0,0,0,0
Georgia,05/09/2012,0,0,1,0,0,0,0,1
Georgia,06/09/2012,0,0,0,0,0,0,0,0
Georgia,07/09/2012,0,0,0,0,0,0,0,0
Georgia,08/09/2012,0,0,0,0,0,0,0,0
Georgia,09/09/2012,0,0,0,0,0,0,0,0
Georgia,10/09/2012,2,0,0,0,0,0,0,2
Georgia,11/09/2012,2,0,0,0,0,0,0,2
Georgia,12/09/2012,0,0,0,0,0,0,0,0
Georgia,14/09/2012,0,0,0,0,0,0,0,0
Georgia,15/09/2012,0,0,0,0,0,0,0,0
Georgia,17/09/2012,2,0,0,0,2,0,0,4
Georgia,18/09/2012,0,0,0,0,0,0,0,0
Georgia,19/09/2012,0,0,0,0,0,0,0,0
Georgia,20/09/2012,7,0,0,0,0,0,0,7
Georgia,21/09/2012,6,0,0,0,0,0,0,6
Georgia,22/09/2012,0,0,0,0,0,0,0,0
Georgia,23/09/2012,3,0,0,0,3,1,0,7
Georgia,24/09/2012,2,0,0,0,15,0,0,17
Georgia,25/09/2012,0,0,1,0,0,0,0,1
Georgia,26/09/2012,0,0,0,0,-2,0,0,-2
Georgia,27/09/2012,5,0,0,0,0,0,0,5
Georgia,28/09/2012,-5,0,0,0,0,0,0,-5
Georgia,30/09/2012,0,0,0,0,9,0,0,9
India,01/09/2012,46,0,0,0,39,8,0,93
India,02/09/2012,74,0,-6,0,7,12,0,87
India,03/09/2012,81,2,-5,0,22,21,0,121
India,04/09/2012,30,0,-2,0,2,2,0,32
India,05/09/2012,88,2,-1,0,41,3,0,133
India,06/09/2012,88,2,-1,0,51,21,0,161
India,07/09/2012,62,0,-12,0,4,7,0,61
India,08/09/2012,69,0,1,0,22,15,0,107
India,09/09/2012,66,0,1,0,8,5,0,80
India,10/09/2012,81,0,0,0,9,7,0,97
India,11/09/2012,68,2,-1,0,7,6,0,82
India,12/09/2012,88,2,2,0,5,16,0,113
India,13/09/2012,81,0,-2,0,32,9,0,120
India,14/09/2012,77,0,-7,0,29,14,0,113
India,15/09/2012,41,2,-13,0,28,10,0,68
India,16/09/2012,67,0,-6,0,23,7,0,91
India,17/09/2012,77,0,-2,0,37,20,0,132
India,18/09/2012,116,0,0,0,27,24,0,167
India,19/09/2012,51,0,-11,0,27,17,0,84
India,20/09/2012,74,0,-11,0,54,19,0,136
India,21/09/2012,31,4,-20,0,39,21,0,75
India,22/09/2012,32,2,-12,0,10,11,0,43
India,23/09/2012,55,0,-10,0,22,17,0,84
India,24/09/2012,64,2,-4,0,62,15,0,139
India,25/09/2012,82,2,-10,0,37,12,0,123
India,26/09/2012,52,0,-2,0,42,22,0,114
India,27/09/2012,97,0,-2,0,31,5,0,131
India,28/09/2012,59,0,0,0,14,9,0,82
India,29/09/2012,50,2,0,0,23,11,0,86
India,30/09/2012,42,2,-2,0,13,11,0,66
Iran,01/09/2012,91,0,0,0,27,5,0,123
Iran,02/09/2012,118,0,2,0,43,10,0,173
Iran,03/09/2012,98,0,0,0,15,12,0,125
Iran,04/09/2012,42,0,0,0,-4,0,0,38
Iran,05/09/2012,162,2,1,0,51,8,0,224
Iran,06/09/2012,99,0,-2,0,16,7,0,120
Iran,07/09/2012,121,0,-5,0,82,19,0,217
Iran,08/09/2012,45,0,-3,0,13,15,0,70
Iran,09/09/2012,95,2,0,0,26,17,0,140
Iran,10/09/2012,122,0,-4,0,29,6,0,153
Iran,11/09/2012,217,0,2,0,33,5,0,257
Iran,12/09/2012,143,0,3,0,31,16,0,193
Iran,13/09/2012,99,0,3,0,37,34,0,173
Iran,14/09/2012,160,2,3,0,9,31,0,205
Iran,15/09/2012,48,0,3,0,15,25,0,91
Iran,16/09/2012,178,2,2,0,35,18,0,235
Iran,17/09/2012,156,2,0,0,25,39,0,222
Iran,18/09/2012,145,0,-4,0,0,20,0,161
Iran,19/09/2012,181,0,-7,0,70,16,0,260
Iran,20/09/2012,126,0,-2,0,51,17,0,192
Iran,21/09/2012,154,0,0,0,32,26,0,212
Iran,22/09/2012,127,0,1,0,49,12,0,189
Iran,23/09/2012,176,0,0,0,91,15,0,282
Iran,24/09/2012,225,6,-3,0,158,27,0,413
Iran,25/09/2012,297,2,2,0,117,44,0,462
Iran,26/09/2012,430,2,-9,0,161,71,0,655
Iran,27/09/2012,420,6,2,0,150,56,0,634
Iran,28/09/2012,323,0,-1,0,61,32,0,415
Iran,29/09/2012,155,0,11,0,100,22,0,288
Iran,30/09/2012,244,0,-1,0,60,91,0,394
Iraq,01/09/2012,92,0,4,0,22,8,0,126
Iraq,02/09/2012,97,0,0,0,41,9,0,147
Iraq,03/09/2012,139,0,2,0,31,12,0,184
Iraq,04/09/2012,12,0,0,0,-1,3,0,14
Iraq,05/09/2012,133,8,2,0,64,11,0,218
Iraq,06/09/2012,180,0,-2,0,47,9,0,234
Iraq,07/09/2012,331,0,-1,0,39,19,0,388
Iraq,08/09/2012,131,0,0,0,4,7,0,142
Iraq,09/09/2012,163,0,0,0,100,9,0,272
Iraq,10/09/2012,215,0,4,0,127,18,0,364
Iraq,11/09/2012,255,0,-2,0,119,44,0,416
Iraq,12/09/2012,215,0,-1,0,21,21,0,256
Iraq,13/09/2012,170,0,2,0,12,28,0,212
Iraq,14/09/2012,203,6,2,0,32,46,0,289
Iraq,15/09/2012,87,0,3,0,12,42,0,144
Iraq,16/09/2012,88,4,0,0,21,20,0,133
Iraq,17/09/2012,253,2,0,0,26,37,0,318
Iraq,18/09/2012,70,0,0,0,14,13,0,97
Iraq,19/09/2012,107,0,2,0,18,26,0,153
Iraq,20/09/2012,112,2,-3,0,34,14,0,159
Iraq,21/09/2012,117,6,0,0,30,94,0,247
Iraq,22/09/2012,60,0,0,0,37,43,0,140
Iraq,23/09/2012,62,0,-2,0,22,4,0,86
Iraq,24/09/2012,68,2,0,0,23,11,0,104
Iraq,25/09/2012,106,4,0,0,12,15,0,137
Iraq,26/09/2012,79,8,0,0,20,13,0,120
Iraq,27/09/2012,107,8,0,0,1,18,0,134
Iraq,28/09/2012,203,38,-2,0,33,14,0,286
Iraq,29/09/2012,81,0,3,0,12,11,0,107
Iraq,30/09/2012,83,0,-6,0,3,2,0,82
Morocco,01/09/2012,10,0,0,0,12,2,0,24
Morocco,02/09/2012,0,0,0,0,21,0,0,21
Morocco,03/09/2012,664,4,-5,0,109,50,0,822
Morocco,04/09/2012,5,0,2,0,-2,0,0,5
Morocco,05/09/2012,19,0,0,0,37,0,0,56
Morocco,06/09/2012,7,0,0,0,3,7,0,17
Morocco,07/09/2012,4,0,0,0,3,4,0,11
Morocco,08/09/2012,2,0,0,0,0,0,0,2
Morocco,09/09/2012,6,0,0,0,0,2,0,8
Morocco,10/09/2012,1,6,0,0,12,0,0,19
Morocco,11/09/2012,0,0,0,0,6,2,0,8
Morocco,12/09/2012,19,0,0,0,21,15,0,55
Morocco,13/09/2012,167,0,-2,0,107,92,0,364
Morocco,14/09/2012,39,0,1,0,33,38,0,111
Morocco,15/09/2012,27,0,0,0,33,10,0,70
Morocco,16/09/2012,15,0,0,0,0,0,0,15
Morocco,17/09/2012,12,0,0,0,6,4,0,22
Morocco,18/09/2012,11,0,0,0,9,5,0,25
Morocco,19/09/2012,6,0,0,0,15,0,0,21
Morocco,20/09/2012,10,0,0,0,6,0,0,16
Morocco,21/09/2012,2,0,0,0,0,3,0,5
Morocco,22/09/2012,4,0,0,0,0,0,0,4
Morocco,23/09/2012,-1,2,0,0,3,0,0,4
Morocco,24/09/2012,7,0,0,0,9,3,0,19
Morocco,25/09/2012,6,0,0,0,22,5,0,33
Morocco,26/09/2012,12,0,0,0,0,0,0,12
Morocco,27/09/2012,0,0,0,0,3,0,0,3
Morocco,28/09/2012,3,0,0,0,3,0,0,6
Morocco,29/09/2012,3,0,0,0,-3,0,0,0
Morocco,30/09/2012,-1,0,0,0,0,0,0,-1
Nigeria,01/09/2012,28,0,0,0,3,3,0,34
Nigeria,02/09/2012,39,0,-6,0,-4,1,0,30
Nigeria,03/09/2012,16,0,1,0,20,2,0,39
Nigeria,04/09/2012,3,0,0,0,0,0,0,3
Nigeria,05/09/2012,31,4,0,0,24,5,0,64
Nigeria,06/09/2012,21,0,1,0,10,9,0,41
Nigeria,07/09/2012,38,0,3,0,21,4,0,66
Nigeria,08/09/2012,13,0,-2,0,13,0,0,24
Nigeria,09/09/2012,9,0,0,0,-6,0,0,3
Nigeria,10/09/2012,6,0,0,0,19,1,0,26
Nigeria,11/09/2012,30,0,0,0,1,4,0,35
Nigeria,12/09/2012,23,0,0,0,4,4,0,31
Nigeria,13/09/2012,22,0,1,0,16,2,0,41
Nigeria,14/09/2012,52,0,2,0,47,35,0,136
Nigeria,15/09/2012,41,0,0,0,15,10,0,66
Nigeria,16/09/2012,61,2,-2,0,21,2,0,84
Nigeria,17/09/2012,41,0,1,0,40,1,0,83
Nigeria,18/09/2012,31,2,-4,0,3,5,0,37
Nigeria,19/09/2012,38,0,0,0,19,8,0,65
Nigeria,20/09/2012,61,0,0,0,10,5,0,76
Nigeria,21/09/2012,29,0,-2,0,16,18,0,61
Nigeria,22/09/2012,37,0,0,0,-3,10,0,44
Nigeria,23/09/2012,28,0,1,0,7,15,0,51
Nigeria,24/09/2012,22,0,0,0,8,7,0,37
Nigeria,25/09/2012,24,2,1,0,15,4,0,46
Nigeria,26/09/2012,39,0,0,0,32,8,0,79
Nigeria,27/09/2012,53,0,-3,0,37,9,0,96
Nigeria,28/09/2012,7,0,4,0,35,0,0,46
Nigeria,29/09/2012,7,0,0,0,24,3,0,34
Nigeria,30/09/2012,20,0,0,0,6,9,0,35
Pakistan,01/09/2012,46,0,0,0,11,7,0,64
Pakistan,02/09/2012,82,0,0,0,68,6,0,156
Pakistan,03/09/2012,79,0,0,0,54,18,0,151
Pakistan,04/09/2012,38,0,0,0,21,1,0,60
Pakistan,05/09/2012,107,0,-2,0,28,19,0,152
Pakistan,06/09/2012,123,2,0,0,37,10,0,172
Pakistan,07/09/2012,146,6,1,0,14,16,0,183
Pakistan,08/09/2012,91,4,0,0,2,4,0,101
Pakistan,09/09/2012,54,0,-2,0,31,5,0,88
Pakistan,10/09/2012,53,0,0,0,11,6,0,70
Pakistan,11/09/2012,177,10,-2,0,50,13,0,248
Pakistan,12/09/2012,81,8,0,0,17,5,0,111
Pakistan,13/09/2012,163,0,1,0,53,16,0,233
Pakistan,14/09/2012,100,6,0,0,82,37,0,225
Pakistan,15/09/2012,96,0,0,0,38,20,0,154
Pakistan,16/09/2012,117,0,1,0,28,18,0,164
Pakistan,17/09/2012,120,0,3,0,45,39,0,207
Pakistan,18/09/2012,116,0,2,0,83,18,0,219
Pakistan,19/09/2012,145,0,-1,0,75,21,0,240
Pakistan,20/09/2012,118,0,-13,0,102,43,0,250
Pakistan,21/09/2012,102,0,1,0,97,41,0,241
Pakistan,22/09/2012,58,0,0,0,75,42,0,175
Pakistan,23/09/2012,79,10,2,0,85,44,0,220
Pakistan,24/09/2012,167,0,2,0,86,57,0,312
Pakistan,25/09/2012,167,0,1,0,46,23,0,237
Pakistan,26/09/2012,159,0,-4,0,33,11,0,199
Pakistan,27/09/2012,111,0,0,0,75,35,0,221
Pakistan,28/09/2012,135,2,0,0,49,6,0,192
Pakistan,29/09/2012,99,0,0,0,25,7,0,131
Pakistan,30/09/2012,52,0,0,0,20,12,0,84
Sierra Leone,01/09/2012,0,0,0,0,3,0,0,3
Sierra Leone,02/09/2012,6,0,0,0,0,0,0,6
Sierra Leone,03/09/2012,2,0,0,0,0,0,0,2
Sierra Leone,04/09/2012,2,0,0,0,0,0,0,2
Sierra Leone,05/09/2012,15,0,0,0,6,4,0,25
Sierra Leone,06/09/2012,3,4,0,0,18,5,0,30
Sierra Leone,07/09/2012,0,0,0,0,0,1,0,1
Sierra Leone,08/09/2012,3,0,0,0,0,0,0,3
Sierra Leone,09/09/2012,15,0,0,0,0,0,0,15
Sierra Leone,10/09/2012,0,0,0,0,0,0,0,0
Sierra Leone,11/09/2012,4,0,0,0,12,0,0,16
Sierra Leone,12/09/2012,4,0,0,0,1,0,0,5
Sierra Leone,13/09/2012,7,0,2,0,9,2,0,20
Sierra Leone,14/09/2012,3,0,0,0,0,1,0,4
Sierra Leone,15/09/2012,0,0,0,0,0,0,0,0
Sierra Leone,16/09/2012,0,0,0,0,0,0,0,0
Sierra Leone,17/09/2012,5,2,0,0,9,7,0,23
Sierra Leone,18/09/2012,4,0,0,0,0,3,0,7
Sierra Leone,19/09/2012,-11,0,0,0,0,0,0,-11
Sierra Leone,20/09/2012,2,0,0,0,9,0,0,11
Sierra Leone,21/09/2012,-9,0,0,0,0,0,0,-9
Sierra Leone,22/09/2012,0,0,0,0,0,0,0,0
Sierra Leone,23/09/2012,0,0,0,0,0,0,0,0
Sierra Leone,24/09/2012,0,0,0,0,0,0,0,0
Sierra Leone,25/09/2012,0,0,0,0,0,1,0,1
Sierra Leone,26/09/2012,2,0,0,0,9,0,0,11
Sierra Leone,27/09/2012,0,2,0,0,12,1,0,15
Sierra Leone,28/09/2012,0,0,0,0,0,0,0,0
Sierra Leone,29/09/2012,0,0,0,0,0,0,0,0
Sierra Leone,30/09/2012,0,0,0,0,0,0,0,0
Somalia,01/09/2012,29,0,0,0,9,1,0,39
Somalia,02/09/2012,73,0,-2,0,25,0,0,96
Somalia,03/09/2012,79,0,-4,0,13,11,0,99
Somalia,04/09/2012,25,2,0,0,12,2,0,41
Somalia,05/09/2012,85,0,-2,0,27,9,0,119
Somalia,06/09/2012,99,0,-2,0,40,12,0,149
Somalia,07/09/2012,155,0,-2,0,68,10,0,231
Somalia,08/09/2012,47,0,-1,0,8,6,0,60
Somalia,09/09/2012,53,0,0,0,26,3,0,82
Somalia,10/09/2012,73,2,2,0,55,17,0,149
Somalia,11/09/2012,99,0,2,0,25,17,0,143
Somalia,12/09/2012,120,0,0,0,5,14,0,139
Somalia,13/09/2012,60,0,0,0,29,11,0,100
Somalia,14/09/2012,107,0,1,0,47,14,0,169
Somalia,15/09/2012,61,0,0,0,7,19,0,87
Somalia,16/09/2012,38,0,0,0,18,5,0,61
Somalia,17/09/2012,102,0,-2,0,47,13,0,160
Somalia,18/09/2012,102,2,0,0,18,10,0,132
Somalia,19/09/2012,66,0,3,0,25,4,0,98
Somalia,20/09/2012,48,0,0,0,41,10,0,99
Somalia,21/09/2012,101,0,1,0,27,9,0,138
Somalia,22/09/2012,33,0,-4,0,35,1,0,65
Somalia,23/09/2012,29,0,2,0,26,13,0,70
Somalia,24/09/2012,111,4,-4,0,27,6,0,144
Somalia,25/09/2012,78,0,0,0,27,11,0,116
Somalia,26/09/2012,63,0,0,0,30,2,0,95
Somalia,27/09/2012,72,0,-7,0,13,9,0,87
Somalia,28/09/2012,78,0,-1,0,59,2,0,138
Somalia,29/09/2012,62,2,0,0,24,10,0,98
Somalia,30/09/2012,60,0,0,0,7,13,0,80
Syria,01/09/2012,221,28,1,0,45,27,0,322
Syria,02/09/2012,164,0,2,0,76,21,0,263
Syria,03/09/2012,547,2,0,0,50,50,0,649
Syria,04/09/2012,44,2,0,0,-7,5,0,44
Syria,05/09/2012,341,6,-5,0,44,57,0,443
Syria,06/09/2012,272,4,-8,0,11,33,0,312
Syria,07/09/2012,688,10,-1,0,180,70,0,947
Syria,08/09/2012,232,4,1,0,82,17,0,336
Syria,09/09/2012,162,0,-10,0,15,35,0,202
Syria,10/09/2012,269,0,-1,0,71,19,0,358
Syria,11/09/2012,261,14,0,0,55,34,0,364
Syria,12/09/2012,190,2,0,0,1,23,0,216
Syria,13/09/2012,236,16,-4,0,13,34,0,295
Syria,14/09/2012,201,16,-2,0,53,19,0,287
Syria,15/09/2012,94,0,-2,0,7,4,0,103
Syria,16/09/2012,201,4,-2,0,-1,12,0,214
Syria,17/09/2012,294,0,-9,0,24,41,0,350
Syria,18/09/2012,341,2,-7,0,24,61,0,421
Syria,19/09/2012,196,0,6,0,75,24,0,301
Syria,20/09/2012,309,0,-4,0,26,23,0,354
Syria,21/09/2012,853,6,-18,0,250,165,0,1256
Syria,22/09/2012,196,0,-3,0,14,4,0,211
Syria,23/09/2012,116,0,-1,0,11,7,0,133
Syria,24/09/2012,290,20,2,0,29,34,0,375
Syria,25/09/2012,427,0,-9,0,26,67,0,511
Syria,26/09/2012,292,0,-1,0,54,52,0,397
Syria,27/09/2012,415,36,-11,0,-12,30,0,458
Syria,28/09/2012,213,24,-6,0,21,20,0,272
Syria,29/09/2012,117,0,1,0,1,12,0,131
Syria,30/09/2012,127,0,-3,0,12,27,0,163
Yemen,01/09/2012,16,0,0,0,9,0,0,25
Yemen,02/09/2012,25,0,0,0,21,0,0,46
Yemen,03/09/2012,48,0,0,0,11,2,0,61
Yemen,04/09/2012,11,0,-3,0,0,0,0,8
Yemen,05/09/2012,60,4,-2,0,9,2,0,73
Yemen,06/09/2012,26,0,-2,0,10,1,0,35
Yemen,07/09/2012,11,0,1,0,12,10,0,34
Yemen,08/09/2012,51,0,0,0,6,5,0,62
Yemen,09/09/2012,22,0,-2,0,6,0,0,26
Yemen,10/09/2012,209,0,-2,0,6,1,0,214
Yemen,11/09/2012,170,0,1,0,54,18,0,243
Yemen,12/09/2012,61,0,1,0,55,16,0,133
Yemen,13/09/2012,139,0,6,0,45,79,0,269
Yemen,14/09/2012,274,0,-2,0,42,105,0,419
Yemen,15/09/2012,256,0,2,0,39,44,0,341
Yemen,16/09/2012,138,0,0,0,24,35,0,197
Yemen,17/09/2012,140,0,0,0,22,31,0,193
Yemen,18/09/2012,151,0,1,0,18,19,0,189
Yemen,19/09/2012,54,0,0,0,23,13,0,90
Yemen,20/09/2012,21,0,0,0,27,3,0,51
Yemen,21/09/2012,46,0,0,0,17,4,0,67
Yemen,22/09/2012,100,0,-2,0,7,3,0,108
Yemen,23/09/2012,6,0,0,0,0,2,0,8
Yemen,24/09/2012,36,0,2,0,40,4,0,82
Yemen,25/09/2012,67,4,3,0,2,7,0,83
Yemen,26/09/2012,43,0,0,0,17,6,0,66
Yemen,27/09/2012,13,0,0,0,6,1,0,20
Yemen,28/09/2012,23,0,0,0,3,4,0,30
Yemen,29/09/2012,6,0,0,0,-5,19,0,20
Yemen,30/09/2012,19,0,-2,0,3,4,0,24
Afghanistan,01/09/2010,501,0,-5,0,41,49,0,586
Afghanistan,02/09/2010,461,14,1,0,63,27,0,566
Afghanistan,03/09/2010,269,2,1,0,8,87,0,367
Afghanistan,04/09/2010,198,2,0,0,31,7,0,238
Afghanistan,05/09/2010,233,0,14,0,20,30,0,297
Afghanistan,06/09/2010,292,0,-8,0,2,29,0,315
Afghanistan,07/09/2010,310,0,-17,0,17,50,0,360
Afghanistan,08/09/2010,535,4,-3,0,25,41,0,602
Afghanistan,09/09/2010,495,0,2,0,128,126,0,751
Afghanistan,10/09/2010,436,12,-1,0,47,116,0,610
Afghanistan,11/09/2010,307,0,-5,0,31,75,0,408
Afghanistan,12/09/2010,203,0,3,0,24,36,0,266
Afghanistan,13/09/2010,167,2,0,0,19,23,0,211
Afghanistan,14/09/2010,142,0,-1,0,62,23,0,226
Afghanistan,15/09/2010,367,10,0,0,87,27,0,491
Afghanistan,16/09/2010,246,12,1,0,64,18,0,341
Afghanistan,17/09/2010,167,4,1,0,16,7,0,195
Afghanistan,18/09/2010,244,4,0,0,41,15,0,304
Afghanistan,19/09/2010,245,0,-1,0,20,21,0,285
Afghanistan,20/09/2010,418,8,-2,0,-11,45,0,458
Afghanistan,21/09/2010,323,0,1,0,92,56,0,472
Afghanistan,22/09/2010,428,0,4,0,84,23,0,539
Afghanistan,23/09/2010,329,2,-2,0,133,18,0,480
Afghanistan,24/09/2010,214,0,-4,0,121,23,0,354
Afghanistan,25/09/2010,222,4,-2,0,58,11,0,293
Afghanistan,26/09/2010,305,6,-4,0,63,20,0,390
Afghanistan,27/09/2010,599,2,7,0,92,48,0,748
Afghanistan,28/09/2010,490,0,-2,0,37,43,0,568
Afghanistan,29/09/2010,383,0,-2,0,46,24,0,451
Afghanistan,30/09/2010,336,2,-4,0,68,20,0,422
Albania,01/09/2010,6,0,0,0,-2,0,0,4
Albania,02/09/2010,-1,0,0,0,9,0,0,8
Albania,03/09/2010,10,0,0,0,3,0,0,13
Albania,04/09/2010,-2,0,0,0,3,0,0,1
Albania,05/09/2010,8,0,0,0,0,0,0,8
Albania,06/09/2010,8,0,0,0,0,0,0,8
Albania,07/09/2010,13,0,0,0,0,4,0,17
Albania,08/09/2010,20,0,0,0,0,0,0,20
Albania,09/09/2010,5,0,-1,0,0,0,0,4
Albania,10/09/2010,16,0,-2,0,0,0,0,14
Albania,11/09/2010,11,0,-1,0,27,3,0,40
Albania,12/09/2010,8,0,0,0,15,2,0,25
Albania,13/09/2010,4,0,-4,0,-1,0,0,-1
Albania,14/09/2010,-2,0,0,0,0,0,0,-2
Albania,15/09/2010,2,0,0,0,0,1,0,3
Albania,16/09/2010,-15,0,0,0,3,0,0,-12
Albania,17/09/2010,2,0,0,0,3,0,0,5
Albania,18/09/2010,16,0,0,0,6,1,0,23
Albania,19/09/2010,1,0,0,0,0,0,0,1
Albania,20/09/2010,0,4,0,0,0,0,0,4
Albania,21/09/2010,8,0,0,0,-2,0,0,6
Albania,22/09/2010,10,0,1,0,-2,0,0,9
Albania,23/09/2010,5,0,0,0,3,2,0,10
Albania,24/09/2010,0,0,-2,0,2,1,0,1
Albania,25/09/2010,0,0,-3,0,3,0,0,0
Albania,26/09/2010,14,0,-3,0,0,2,0,13
Albania,27/09/2010,12,0,-11,0,0,0,0,1
Albania,28/09/2010,0,0,0,0,0,0,0,0
Albania,29/09/2010,7,0,0,0,0,0,0,7
Albania,30/09/2010,2,0,0,0,0,1,0,3
Algeria,01/09/2010,5,0,0,0,3,0,0,8
Algeria,02/09/2010,7,0,0,0,-2,0,0,5
Algeria,03/09/2010,3,0,0,0,0,0,0,3
Algeria,04/09/2010,1,0,0,0,21,0,0,22
Algeria,05/09/2010,0,0,0,0,12,1,0,13
Algeria,06/09/2010,4,0,0,0,0,0,0,4
Algeria,07/09/2010,11,2,0,0,1,0,0,14
Algeria,08/09/2010,-3,0,0,0,3,0,0,0
Algeria,09/09/2010,5,2,0,0,3,0,0,10
Algeria,10/09/2010,6,0,0,0,6,0,0,12
Algeria,11/09/2010,12,0,0,0,0,0,0,12
Algeria,12/09/2010,10,0,0,0,6,0,0,16
Algeria,13/09/2010,3,0,0,0,9,0,0,12
Algeria,14/09/2010,9,0,-4,0,12,1,0,18
Algeria,15/09/2010,2,0,0,0,23,0,0,25
Algeria,16/09/2010,9,0,0,0,12,3,0,24
Algeria,17/09/2010,40,0,0,0,27,2,0,69
Algeria,18/09/2010,54,0,0,0,9,19,0,82
Algeria,19/09/2010,23,0,0,0,4,6,0,33
Algeria,20/09/2010,1,0,0,0,-2,6,0,5
Algeria,21/09/2010,6,0,0,0,12,3,0,21
Algeria,22/09/2010,17,0,0,0,21,0,0,38
Algeria,23/09/2010,7,0,0,0,6,0,0,13
Algeria,24/09/2010,5,0,0,0,2,0,0,7
Algeria,25/09/2010,1,0,0,0,6,7,0,14
Algeria,26/09/2010,2,0,0,0,6,0,0,8
Algeria,27/09/2010,12,6,0,0,6,0,0,24
Algeria,28/09/2010,18,0,0,0,3,0,0,21
Algeria,29/09/2010,21,0,4,0,22,15,0,62
Algeria,30/09/2010,33,0,0,0,2,6,0,41
Bangladesh,01/09/2010,5,0,0,0,27,0,0,32
Bangladesh,02/09/2010,3,0,0,0,6,0,0,9
Bangladesh,03/09/2010,24,0,-2,0,6,0,0,28
Bangladesh,04/09/2010,4,0,0,0,1,0,0,5
Bangladesh,05/09/2010,24,0,1,0,1,1,0,27
Bangladesh,06/09/2010,8,0,0,0,22,0,0,30
Bangladesh,07/09/2010,8,4,0,0,27,0,0,39
Bangladesh,08/09/2010,16,2,0,0,1,2,0,21
Bangladesh,09/09/2010,26,2,-2,0,16,2,0,44
Bangladesh,10/09/2010,7,0,0,0,12,2,0,21
Bangladesh,11/09/2010,0,0,0,0,0,0,0,0
Bangladesh,12/09/2010,18,0,0,0,0,2,0,20
Bangladesh,13/09/2010,8,0,0,0,1,2,0,11
Bangladesh,14/09/2010,10,0,0,0,3,2,0,15
Bangladesh,15/09/2010,32,0,-6,0,16,4,0,46
Bangladesh,16/09/2010,10,0,0,0,-6,0,0,4
Bangladesh,17/09/2010,0,0,0,0,-5,0,0,-5
Bangladesh,18/09/2010,10,2,0,0,0,1,0,13
Bangladesh,19/09/2010,13,0,0,0,-2,1,0,12
Bangladesh,20/09/2010,2,0,0,0,30,1,0,33
Bangladesh,21/09/2010,6,0,2,0,13,4,0,25
Bangladesh,22/09/2010,19,0,0,0,-11,4,0,12
Bangladesh,23/09/2010,14,0,0,0,3,1,0,18
Bangladesh,24/09/2010,3,0,0,0,3,2,0,8
Bangladesh,25/09/2010,28,0,-2,0,8,4,0,38
Bangladesh,26/09/2010,36,0,0,0,13,0,0,49
Bangladesh,27/09/2010,20,0,0,0,25,8,0,53
Bangladesh,28/09/2010,27,0,3,0,2,3,0,35
Bangladesh,29/09/2010,51,0,0,0,11,0,0,62
Bangladesh,30/09/2010,20,0,0,0,-2,0,0,18
Cameroon,01/09/2010,3,0,0,0,0,0,0,3
Cameroon,02/09/2010,0,0,0,0,0,0,0,0
Cameroon,03/09/2010,0,0,0,0,0,0,0,0
Cameroon,04/09/2010,-2,0,0,0,0,0,0,-2
Cameroon,05/09/2010,6,0,0,0,0,0,0,6
Cameroon,06/09/2010,2,0,0,0,0,0,0,2
Cameroon,07/09/2010,6,0,0,0,0,2,0,8
Cameroon,08/09/2010,3,0,0,0,0,0,0,3
Cameroon,09/09/2010,6,0,0,0,3,0,0,9
Cameroon,10/09/2010,0,0,0,0,-1,0,0,-1
Cameroon,11/09/2010,0,0,0,0,0,0,0,0
Cameroon,12/09/2010,0,0,0,0,0,0,0,0
Cameroon,13/09/2010,0,0,0,0,-1,0,0,-1
Cameroon,14/09/2010,0,0,0,0,0,0,0,0
Cameroon,15/09/2010,0,0,0,0,0,0,0,0
Cameroon,16/09/2010,3,0,0,0,0,0,0,3
Cameroon,17/09/2010,2,0,0,0,0,0,0,2
Cameroon,18/09/2010,0,0,0,0,0,0,0,0
Cameroon,19/09/2010,4,0,0,0,17,0,0,21
Cameroon,20/09/2010,0,0,0,0,12,0,0,12
Cameroon,21/09/2010,0,0,0,0,0,0,0,0
Cameroon,22/09/2010,1,0,0,0,4,0,0,5
Cameroon,23/09/2010,3,0,0,0,0,0,0,3
Cameroon,24/09/2010,0,0,0,0,3,0,0,3
Cameroon,25/09/2010,4,0,0,0,0,0,0,4
Cameroon,26/09/2010,0,0,0,0,0,0,0,0
Cameroon,27/09/2010,0,0,0,0,0,0,0,0
Cameroon,28/09/2010,2,0,0,0,0,0,0,2
Cameroon,29/09/2010,18,0,-2,0,6,0,0,22
Cameroon,30/09/2010,6,0,0,0,0,0,0,6
China,01/09/2010,161,6,-4,0,42,11,0,216
China,02/09/2010,167,0,-3,0,8,19,0,191
China,03/09/2010,181,4,-13,0,25,8,0,205
China,04/09/2010,45,0,-15,0,9,2,0,41
China,05/09/2010,60,4,0,0,7,6,0,77
China,06/09/2010,88,4,-8,0,18,17,0,119
China,07/09/2010,125,4,-13,0,7,28,0,151
China,08/09/2010,170,0,-13,0,52,28,0,237
China,09/09/2010,88,2,-2,0,59,13,0,160
China,10/09/2010,110,6,-3,0,41,33,0,187
China,11/09/2010,54,0,-2,0,19,5,0,76
China,12/09/2010,43,8,-19,0,17,5,0,54
China,13/09/2010,153,8,1,0,-7,17,0,172
China,14/09/2010,78,6,-1,0,-15,5,0,73
China,15/09/2010,170,8,-9,0,97,8,0,274
China,16/09/2010,116,0,-8,0,6,22,0,136
China,17/09/2010,221,0,2,0,-4,17,0,236
China,18/09/2010,67,0,3,0,-2,15,0,83
China,19/09/2010,95,0,-2,0,53,11,0,157
China,20/09/2010,117,2,-5,0,24,9,0,147
China,21/09/2010,171,8,0,0,73,20,0,272
China,22/09/2010,201,2,-7,0,100,23,0,319
China,23/09/2010,168,0,-2,0,41,25,0,232
China,24/09/2010,138,2,-12,0,40,18,0,186
China,25/09/2010,74,0,-5,0,29,19,0,117
China,26/09/2010,62,6,-7,0,30,6,0,97
China,27/09/2010,158,0,-2,0,38,14,0,208
China,28/09/2010,175,4,1,0,32,14,0,226
China,29/09/2010,151,2,-7,0,50,11,0,207
China,30/09/2010,186,8,-18,0,28,12,0,216
Egypt,01/09/2010,55,4,0,0,7,10,0,76
Egypt,02/09/2010,26,0,0,0,29,9,0,64
Egypt,03/09/2010,53,0,0,0,3,11,0,67
Egypt,04/09/2010,23,2,2,0,0,5,0,32
Egypt,05/09/2010,85,0,1,0,55,7,0,148
Egypt,06/09/2010,105,0,1,0,25,20,0,151
Egypt,07/09/2010,45,0,5,0,6,30,0,86
Egypt,08/09/2010,63,0,-2,0,14,9,0,84
Egypt,09/09/2010,44,2,0,0,43,15,0,104
Egypt,10/09/2010,11,0,0,0,0,8,0,19
Egypt,11/09/2010,31,0,1,0,4,3,0,39
Egypt,12/09/2010,57,0,0,0,22,7,0,86
Egypt,13/09/2010,53,2,0,0,21,8,0,84
Egypt,14/09/2010,19,0,0,0,12,4,0,35
Egypt,15/09/2010,49,0,-1,0,70,3,0,121
Egypt,16/09/2010,78,0,1,0,13,11,0,103
Egypt,17/09/2010,76,4,-2,0,31,9,0,118
Egypt,18/09/2010,24,0,0,0,3,-4,0,23
Egypt,19/09/2010,32,0,0,0,5,3,0,40
Egypt,20/09/2010,46,2,0,0,-22,0,0,26
Egypt,21/09/2010,76,0,0,0,7,2,0,85
Egypt,22/09/2010,9,0,-2,0,8,3,0,18
Egypt,23/09/2010,0,0,-1,0,15,-2,0,12
Egypt,24/09/2010,46,0,0,0,-1,3,0,48
Egypt,25/09/2010,27,0,-2,0,7,3,0,35
Egypt,26/09/2010,51,0,-2,0,15,4,0,68
Egypt,27/09/2010,16,0,0,0,26,10,0,52
Egypt,28/09/2010,91,0,0,0,18,7,0,116
Egypt,29/09/2010,43,0,0,0,17,4,0,64
Egypt,30/09/2010,29,0,3,0,10,7,0,49
Eritrea,01/09/2010,3,0,0,0,3,0,0,6
Eritrea,02/09/2010,0,0,0,0,0,0,0,0
Eritrea,03/09/2010,3,0,0,0,0,0,0,3
Eritrea,04/09/2010,3,0,0,0,0,0,0,3
Eritrea,05/09/2010,0,0,0,0,3,0,0,3
Eritrea,06/09/2010,-3,0,0,0,-8,0,0,-11
Eritrea,07/09/2010,-2,0,0,0,-6,1,0,-7
Eritrea,08/09/2010,-1,0,0,0,0,0,0,-1
Eritrea,09/09/2010,6,0,0,0,2,0,0,8
Eritrea,10/09/2010,3,0,0,0,0,0,0,3
Eritrea,11/09/2010,2,0,1,0,3,0,0,6
Eritrea,12/09/2010,3,0,1,0,-2,0,0,2
Eritrea,13/09/2010,2,0,0,0,0,0,0,2
Eritrea,14/09/2010,27,0,0,0,0,0,0,27
Eritrea,15/09/2010,15,0,-1,0,0,0,0,14
Eritrea,16/09/2010,11,0,0,0,0,0,0,11
Eritrea,17/09/2010,0,0,0,0,0,0,0,0
Eritrea,18/09/2010,0,0,0,0,0,0,0,0
Eritrea,19/09/2010,11,0,1,0,1,0,0,13
Eritrea,21/09/2010,29,0,0,0,0,3,0,32
Eritrea,22/09/2010,32,0,0,0,0,8,0,40
Eritrea,23/09/2010,4,0,0,0,0,0,0,4
Eritrea,24/09/2010,4,0,0,0,0,0,0,4
Eritrea,25/09/2010,11,0,0,0,0,0,0,11
Eritrea,26/09/2010,0,0,0,0,12,0,0,12
Eritrea,27/09/2010,12,0,0,0,0,0,0,12
Eritrea,28/09/2010,0,0,0,0,0,0,0,0
Eritrea,29/09/2010,10,0,0,0,0,0,0,10
Eritrea,30/09/2010,2,0,0,0,-2,0,0,0
Georgia,01/09/2010,68,0,0,0,28,14,0,110
Georgia,02/09/2010,53,0,1,0,20,1,0,75
Georgia,03/09/2010,16,4,0,0,36,4,0,60
Georgia,04/09/2010,20,0,0,0,31,3,0,54
Georgia,05/09/2010,9,0,-2,0,6,1,0,14
Georgia,06/09/2010,22,4,-2,0,2,0,0,26
Georgia,07/09/2010,27,0,0,0,-4,5,0,28
Georgia,08/09/2010,60,4,0,0,17,3,0,84
Georgia,09/09/2010,57,4,1,0,8,1,0,71
Georgia,10/09/2010,33,0,0,0,5,0,0,38
Georgia,11/09/2010,13,0,0,0,-4,0,0,9
Georgia,12/09/2010,5,0,0,0,3,1,0,9
Georgia,13/09/2010,20,0,2,0,8,6,0,36
Georgia,14/09/2010,40,0,0,0,1,1,0,42
Georgia,15/09/2010,40,0,-1,0,39,6,0,84
Georgia,16/09/2010,44,4,0,0,12,10,0,70
Georgia,17/09/2010,37,4,-5,0,14,6,0,56
Georgia,18/09/2010,13,0,0,0,2,2,0,17
Georgia,19/09/2010,9,2,1,0,9,0,0,21
Georgia,20/09/2010,60,4,0,0,29,3,0,96
Georgia,21/09/2010,72,0,-2,0,25,6,0,101
Georgia,22/09/2010,25,0,0,0,46,0,0,71
Georgia,23/09/2010,38,2,1,0,34,3,0,78
Georgia,24/09/2010,47,4,-4,0,9,5,0,61
Georgia,25/09/2010,12,0,-2,0,3,3,0,16
Georgia,26/09/2010,35,0,-6,0,2,1,0,32
Georgia,27/09/2010,33,0,1,0,-1,6,0,39
Georgia,28/09/2010,34,2,1,0,-3,4,0,38
Georgia,29/09/2010,33,0,-10,0,44,11,0,78
Georgia,30/09/2010,27,0,-1,0,10,11,0,47
India,01/09/2010,70,0,3,0,20,11,0,104
India,02/09/2010,96,2,0,0,17,6,0,121
India,03/09/2010,112,2,-2,0,7,5,0,124
India,04/09/2010,41,0,-3,0,13,3,0,54
India,05/09/2010,75,0,-1,0,18,1,0,93
India,06/09/2010,95,0,-2,0,-3,16,0,106
India,07/09/2010,78,4,-9,0,2,21,0,96
India,08/09/2010,109,2,0,0,47,19,0,177
India,09/09/2010,41,0,-5,0,54,10,0,100
India,10/09/2010,80,0,0,0,49,30,0,159
India,11/09/2010,53,0,-4,0,16,24,0,89
India,12/09/2010,77,0,-1,0,37,16,0,129
India,13/09/2010,109,4,2,0,9,33,0,157
India,14/09/2010,56,2,-3,0,19,12,0,86
India,15/09/2010,84,0,-1,0,15,16,0,114
India,16/09/2010,75,0,-2,0,18,11,0,102
India,17/09/2010,57,0,-4,0,42,13,0,108
India,18/09/2010,62,0,2,0,43,14,0,121
India,19/09/2010,88,6,2,0,61,22,0,179
India,20/09/2010,61,4,-4,0,30,21,0,112
India,21/09/2010,73,10,0,0,20,10,0,113
India,22/09/2010,93,0,1,0,39,13,0,146
India,23/09/2010,106,2,2,0,30,14,0,154
India,24/09/2010,89,4,1,0,70,8,0,172
India,25/09/2010,26,2,-3,0,20,6,0,51
India,26/09/2010,51,2,0,0,29,11,0,93
India,27/09/2010,88,0,-1,0,11,1,0,99
India,28/09/2010,109,2,-4,0,8,5,0,120
India,29/09/2010,68,4,0,0,42,7,0,121
India,30/09/2010,97,2,-8,0,11,8,0,110
Iran,01/09/2010,108,4,2,0,44,22,0,180
Iran,02/09/2010,89,0,-1,0,97,5,0,190
Iran,03/09/2010,97,0,0,0,66,14,0,177
Iran,04/09/2010,114,0,0,0,36,4,0,154
Iran,05/09/2010,89,0,0,0,36,10,0,135
Iran,06/09/2010,101,0,0,0,34,27,0,162
Iran,07/09/2010,108,2,-2,0,68,22,0,198
Iran,08/09/2010,92,0,3,0,79,19,0,193
Iran,09/09/2010,103,0,-8,0,22,32,0,149
Iran,10/09/2010,87,0,-1,0,-8,17,0,95
Iran,11/09/2010,57,0,-9,0,0,10,0,58
Iran,12/09/2010,65,0,0,0,10,11,0,86
Iran,13/09/2010,183,0,-11,0,55,22,0,249
Iran,14/09/2010,186,0,-9,0,46,29,0,252
Iran,15/09/2010,111,2,-1,0,115,14,0,241
Iran,16/09/2010,103,2,-4,0,77,14,0,192
Iran,17/09/2010,55,2,0,0,20,15,0,92
Iran,18/09/2010,31,0,0,0,38,3,0,72
Iran,19/09/2010,129,0,2,0,53,71,0,255
Iran,20/09/2010,78,0,0,0,54,23,0,155
Iran,21/09/2010,125,0,0,0,55,25,0,205
Iran,22/09/2010,243,0,1,0,96,31,0,371
Iran,23/09/2010,185,0,3,0,155,51,0,394
Iran,24/09/2010,130,0,0,0,103,23,0,256
Iran,25/09/2010,117,0,2,0,42,15,0,176
Iran,26/09/2010,78,2,0,0,39,10,0,129
Iran,27/09/2010,103,1,0,0,59,9,0,172
Iran,28/09/2010,155,4,0,0,157,20,0,336
Iran,29/09/2010,109,2,2,0,129,10,0,252
Iran,30/09/2010,91,14,0,0,91,8,0,204
Iraq,01/09/2010,605,12,-3,0,89,65,0,768
Iraq,02/09/2010,318,4,-3,0,24,20,0,363
Iraq,03/09/2010,197,0,1,0,29,20,0,247
Iraq,04/09/2010,127,0,0,0,19,29,0,175
Iraq,05/09/2010,171,0,6,0,28,17,0,222
Iraq,06/09/2010,175,0,1,0,48,22,0,246
Iraq,07/09/2010,217,0,-10,0,44,22,0,273
Iraq,08/09/2010,186,0,1,0,50,18,0,255
Iraq,09/09/2010,189,0,4,0,131,38,0,362
Iraq,10/09/2010,218,2,1,0,68,33,0,322
Iraq,11/09/2010,131,0,-1,0,29,10,0,169
Iraq,12/09/2010,110,0,0,0,34,10,0,154
Iraq,13/09/2010,105,0,0,0,92,10,0,207
Iraq,14/09/2010,165,0,0,0,39,11,0,215
Iraq,15/09/2010,163,0,2,0,16,34,0,215
Iraq,16/09/2010,175,0,0,0,14,17,0,206
Iraq,17/09/2010,119,0,-4,0,46,11,0,172
Iraq,18/09/2010,60,0,0,0,58,4,0,122
Iraq,19/09/2010,148,0,-1,0,163,38,0,348
Iraq,20/09/2010,73,2,-1,0,44,22,0,140
Iraq,21/09/2010,111,0,-1,0,29,17,0,156
Iraq,22/09/2010,228,2,-2,0,70,19,0,317
Iraq,23/09/2010,170,2,1,0,23,10,0,206
Iraq,24/09/2010,164,0,3,0,10,8,0,185
Iraq,25/09/2010,92,2,2,0,16,11,0,123
Iraq,26/09/2010,144,16,0,0,29,21,0,210
Iraq,27/09/2010,197,2,3,0,41,20,0,263
Iraq,28/09/2010,148,0,1,0,32,18,0,199
Iraq,29/09/2010,161,0,-9,0,41,11,0,204
Iraq,30/09/2010,172,2,-3,0,53,21,0,245
Morocco,01/09/2010,1,0,0,0,9,0,0,10
Morocco,02/09/2010,13,0,0,0,30,5,0,48
Morocco,03/09/2010,3,0,0,0,6,0,0,9
Morocco,04/09/2010,1,0,0,0,-2,0,0,-1
Morocco,05/09/2010,0,0,0,0,0,0,0,0
Morocco,06/09/2010,0,0,0,0,0,0,0,0
Morocco,07/09/2010,4,0,0,0,0,1,0,5
Morocco,08/09/2010,20,0,-1,0,0,0,0,19
Morocco,09/09/2010,0,0,0,0,3,0,0,3
Morocco,10/09/2010,12,0,0,0,0,0,0,12
Morocco,11/09/2010,4,0,0,0,0,0,0,4
Morocco,12/09/2010,6,0,0,0,0,0,0,6
Morocco,13/09/2010,1,0,0,0,0,0,0,1
Morocco,14/09/2010,1,0,1,0,9,0,0,11
Morocco,15/09/2010,3,0,0,0,3,0,0,6
Morocco,16/09/2010,20,0,0,0,2,1,0,23
Morocco,17/09/2010,0,0,3,0,3,0,0,6
Morocco,18/09/2010,0,0,0,0,0,0,0,0
Morocco,19/09/2010,6,0,2,0,0,0,0,8
Morocco,20/09/2010,0,0,0,0,12,0,0,12
Morocco,21/09/2010,9,2,0,0,9,1,0,21
Morocco,22/09/2010,11,0,0,0,4,10,0,25
Morocco,23/09/2010,-3,0,0,0,3,0,0,0
Morocco,24/09/2010,9,0,0,0,-2,0,0,7
Morocco,25/09/2010,6,0,0,0,-1,0,0,5
Morocco,26/09/2010,-3,0,0,0,24,0,0,21
Morocco,27/09/2010,7,0,0,0,9,2,0,18
Morocco,28/09/2010,-1,0,0,0,1,0,0,0
Morocco,29/09/2010,6,0,-1,0,12,6,0,23
Morocco,30/09/2010,8,0,0,0,6,0,0,14
Nigeria,01/09/2010,36,0,0,0,38,3,0,77
Nigeria,02/09/2010,16,0,0,0,21,5,0,42
Nigeria,03/09/2010,21,0,0,0,27,4,0,52
Nigeria,04/09/2010,23,0,0,0,11,4,0,38
Nigeria,05/09/2010,16,0,0,0,8,3,0,27
Nigeria,06/09/2010,4,0,0,0,39,2,0,45
Nigeria,07/09/2010,12,0,-4,0,1,0,0,9
Nigeria,08/09/2010,55,0,1,0,21,3,0,80
Nigeria,09/09/2010,36,2,-4,0,21,8,0,63
Nigeria,10/09/2010,73,0,-3,0,17,7,0,94
Nigeria,11/09/2010,12,0,1,0,3,4,0,20
Nigeria,12/09/2010,46,0,0,0,0,8,0,54
Nigeria,13/09/2010,67,4,1,0,28,25,0,125
Nigeria,14/09/2010,24,0,0,0,23,9,0,56
Nigeria,15/09/2010,20,0,1,0,15,4,0,40
Nigeria,16/09/2010,111,0,0,0,4,2,0,117
Nigeria,17/09/2010,7,0,-6,0,7,2,0,10
Nigeria,18/09/2010,27,0,0,0,3,0,0,30
Nigeria,19/09/2010,56,0,3,0,19,10,0,88
Nigeria,20/09/2010,25,0,-2,0,7,8,0,38
Nigeria,21/09/2010,30,0,2,0,12,2,0,46
Nigeria,22/09/2010,27,0,0,0,55,9,0,91
Nigeria,23/09/2010,13,0,-3,0,63,7,0,80
Nigeria,24/09/2010,13,2,-2,0,13,4,0,30
Nigeria,25/09/2010,4,0,1,0,5,4,0,14
Nigeria,26/09/2010,7,0,-1,0,8,0,0,14
Nigeria,27/09/2010,38,0,0,0,12,1,0,51
Nigeria,28/09/2010,13,0,0,0,38,2,0,53
Nigeria,29/09/2010,29,0,0,0,20,0,0,49
Nigeria,30/09/2010,49,0,0,0,6,9,0,64
Pakistan,01/09/2010,170,16,0,0,67,11,0,264
Pakistan,02/09/2010,184,4,-1,0,25,13,0,225
Pakistan,03/09/2010,181,6,0,0,8,23,0,218
Pakistan,04/09/2010,75,14,-2,0,9,8,0,104
Pakistan,05/09/2010,91,4,0,0,3,14,0,112
Pakistan,06/09/2010,57,2,-3,0,13,18,0,87
Pakistan,07/09/2010,110,24,0,0,6,23,0,163
Pakistan,08/09/2010,165,14,-2,0,8,36,0,221
Pakistan,09/09/2010,119,8,0,0,23,32,0,182
Pakistan,10/09/2010,138,16,0,0,32,40,0,226
Pakistan,11/09/2010,113,6,-6,0,21,23,0,157
Pakistan,12/09/2010,91,0,0,0,16,20,0,127
Pakistan,13/09/2010,110,18,-3,0,8,14,0,147
Pakistan,14/09/2010,89,6,-2,0,17,9,0,119
Pakistan,15/09/2010,232,6,-1,0,80,24,0,341
Pakistan,16/09/2010,132,2,2,0,37,11,0,184
Pakistan,17/09/2010,102,10,2,0,27,10,0,151
Pakistan,18/09/2010,116,10,0,0,21,10,0,157
Pakistan,19/09/2010,137,18,0,0,30,21,0,206
Pakistan,20/09/2010,126,28,1,0,30,7,0,192
Pakistan,21/09/2010,108,16,1,0,51,7,0,183
Pakistan,22/09/2010,197,2,1,0,16,3,0,219
Pakistan,23/09/2010,108,4,0,0,119,10,0,241
Pakistan,24/09/2010,130,2,-9,0,69,15,0,207
Pakistan,25/09/2010,109,2,-4,0,1,7,0,115
Pakistan,26/09/2010,131,0,-10,0,35,14,0,170
Pakistan,27/09/2010,393,0,-1,0,40,24,0,456
Pakistan,28/09/2010,322,0,10,0,88,28,0,448
Pakistan,29/09/2010,369,0,1,0,51,29,0,450
Pakistan,30/09/2010,311,0,0,0,73,32,0,416
Sierra Leone,01/09/2010,5,0,0,0,0,0,0,5
Sierra Leone,02/09/2010,0,0,0,0,12,0,0,12
Sierra Leone,03/09/2010,8,0,0,0,0,0,0,8
Sierra Leone,04/09/2010,0,0,0,0,0,0,0,0
Sierra Leone,06/09/2010,0,0,0,0,0,0,0,0
Sierra Leone,07/09/2010,2,0,0,0,-2,1,0,1
Sierra Leone,08/09/2010,-3,0,-2,0,6,0,0,1
Sierra Leone,09/09/2010,-1,2,0,0,-2,0,0,-1
Sierra Leone,10/09/2010,0,0,0,0,0,0,0,0
Sierra Leone,11/09/2010,0,0,0,0,0,0,0,0
Sierra Leone,12/09/2010,5,0,0,0,-2,0,0,3
Sierra Leone,13/09/2010,-4,0,2,0,0,0,0,-2
Sierra Leone,14/09/2010,3,0,0,0,0,0,0,3
Sierra Leone,15/09/2010,10,0,0,0,0,5,0,15
Sierra Leone,16/09/2010,22,0,0,0,6,3,0,31
Sierra Leone,17/09/2010,-10,0,0,0,0,0,0,-10
Sierra Leone,19/09/2010,4,0,0,0,0,0,0,4
Sierra Leone,20/09/2010,-6,0,-6,0,0,0,0,-12
Sierra Leone,21/09/2010,0,0,0,0,6,0,0,6
Sierra Leone,22/09/2010,11,0,0,0,0,0,0,11
Sierra Leone,23/09/2010,-2,0,0,0,0,0,0,-2
Sierra Leone,24/09/2010,3,0,0,0,3,0,0,6
Sierra Leone,25/09/2010,0,0,0,0,-4,0,0,-4
Sierra Leone,26/09/2010,0,0,0,0,0,0,0,0
Sierra Leone,27/09/2010,0,0,-4,0,-10,1,0,-13
Sierra Leone,28/09/2010,14,0,-6,0,-6,0,0,2
Sierra Leone,29/09/2010,29,0,-4,0,6,-1,0,30
Sierra Leone,30/09/2010,11,0,-2,0,-2,-2,0,5
Somalia,01/09/2010,58,0,0,0,12,2,0,72
Somalia,02/09/2010,32,0,0,0,6,0,0,38
Somalia,03/09/2010,29,0,1,0,27,0,0,57
Somalia,04/09/2010,29,0,0,0,-1,0,0,28
Somalia,05/09/2010,26,0,0,0,0,0,0,26
Somalia,06/09/2010,11,0,0,0,12,5,0,28
Somalia,07/09/2010,23,0,0,0,55,7,0,85
Somalia,08/09/2010,25,0,0,0,35,6,0,66
Somalia,09/09/2010,92,0,0,0,-9,11,0,94
Somalia,10/09/2010,59,0,0,0,28,12,0,99
Somalia,11/09/2010,17,0,0,0,9,3,0,29
Somalia,12/09/2010,10,0,0,0,-2,3,0,11
Somalia,13/09/2010,31,0,0,0,3,2,0,36
Somalia,14/09/2010,51,0,0,0,-1,0,0,50
Somalia,15/09/2010,32,0,-2,0,21,0,0,51
Somalia,16/09/2010,33,0,0,0,13,1,0,47
Somalia,17/09/2010,40,0,-2,0,7,3,0,48
Somalia,18/09/2010,0,0,0,0,42,6,0,48
Somalia,19/09/2010,45,0,0,0,49,1,0,95
Somalia,20/09/2010,9,0,-4,0,24,6,0,35
Somalia,21/09/2010,31,0,-22,0,9,7,0,25
Somalia,22/09/2010,35,0,-4,0,56,14,0,101
Somalia,23/09/2010,45,2,-10,0,43,2,0,82
Somalia,24/09/2010,21,0,-18,0,45,0,0,48
Somalia,25/09/2010,38,0,-8,0,23,4,0,57
Somalia,26/09/2010,14,0,0,0,16,4,0,34
Somalia,27/09/2010,79,0,0,0,12,6,0,97
Somalia,28/09/2010,64,0,0,0,42,13,0,119
Somalia,29/09/2010,66,0,-2,0,40,4,0,108
Somalia,30/09/2010,21,0,1,0,17,5,0,44
Syria,01/09/2010,19,0,0,0,-2,0,0,17
Syria,02/09/2010,9,0,1,0,33,0,0,43
Syria,03/09/2010,9,0,0,0,-6,0,0,3
Syria,04/09/2010,10,0,0,0,7,0,0,17
Syria,05/09/2010,5,0,0,0,6,2,0,13
Syria,06/09/2010,45,0,1,0,3,0,0,49
Syria,07/09/2010,3,0,-2,0,13,3,0,17
Syria,08/09/2010,33,0,0,0,6,2,0,41
Syria,09/09/2010,12,0,0,0,4,3,0,19
Syria,10/09/2010,3,0,0,0,-3,0,0,0
Syria,11/09/2010,0,0,0,0,2,14,0,16
Syria,12/09/2010,15,0,0,0,-7,28,0,36
Syria,13/09/2010,18,0,0,0,20,11,0,49
Syria,14/09/2010,20,0,-1,0,-2,5,0,22
Syria,15/09/2010,27,0,0,0,7,0,0,34
Syria,16/09/2010,31,6,0,0,24,2,0,63
Syria,17/09/2010,8,0,0,0,37,1,0,46
Syria,18/09/2010,17,0,0,0,30,0,0,47
Syria,19/09/2010,17,0,0,0,9,2,0,28
Syria,20/09/2010,28,0,1,0,5,1,0,35
Syria,21/09/2010,33,0,0,0,22,5,0,60
Syria,22/09/2010,34,0,0,0,56,9,0,99
Syria,23/09/2010,14,0,0,0,31,6,0,51
Syria,24/09/2010,23,0,-2,0,18,5,0,44
Syria,25/09/2010,4,0,0,0,0,0,0,4
Syria,26/09/2010,11,0,0,0,3,0,0,14
Syria,27/09/2010,15,0,0,0,21,0,0,36
Syria,28/09/2010,17,0,0,0,3,6,0,26
Syria,29/09/2010,56,0,-1,0,12,0,0,67
Syria,30/09/2010,9,0,1,0,6,2,0,18
Yemen,01/09/2010,52,0,0,0,14,2,0,68
Yemen,02/09/2010,29,0,0,0,13,0,0,42
Yemen,03/09/2010,3,0,0,0,0,0,0,3
Yemen,04/09/2010,12,0,0,0,3,2,0,17
Yemen,05/09/2010,18,0,0,0,3,2,0,23
Yemen,06/09/2010,33,0,0,0,1,0,0,34
Yemen,07/09/2010,0,0,0,0,6,0,0,6
Yemen,08/09/2010,11,0,0,0,16,0,0,27
Yemen,09/09/2010,50,0,0,0,16,1,0,67
Yemen,10/09/2010,10,0,0,0,0,0,0,10
Yemen,11/09/2010,9,0,0,0,0,0,0,9
Yemen,12/09/2010,13,0,0,0,3,4,0,20
Yemen,13/09/2010,25,0,0,0,20,6,0,51
Yemen,14/09/2010,3,0,0,0,9,3,0,15
Yemen,15/09/2010,24,0,0,0,6,5,0,35
Yemen,16/09/2010,22,0,0,0,-5,4,0,21
Yemen,17/09/2010,15,0,0,0,0,3,0,18
Yemen,18/09/2010,7,0,0,0,3,0,0,10
Yemen,19/09/2010,4,0,0,0,26,0,0,30
Yemen,20/09/2010,41,0,0,0,16,0,0,57
Yemen,21/09/2010,35,0,-4,0,15,4,0,50
Yemen,22/09/2010,51,0,0,0,-3,2,0,50
Yemen,23/09/2010,23,0,0,0,3,1,0,27
Yemen,24/09/2010,45,0,0,0,9,6,0,60
Yemen,25/09/2010,12,0,0,0,0,13,0,25
Yemen,26/09/2010,15,0,0,0,6,5,0,26
Yemen,27/09/2010,9,0,0,0,12,6,0,27
Yemen,28/09/2010,26,0,0,0,0,1,0,27
Yemen,29/09/2010,36,0,0,0,7,10,0,53
Yemen,30/09/2010,17,0,0,0,0,2,0,19
Afghanistan,01/08/2009,263,2,0,0,50,26,0,341
Afghanistan,02/08/2009,284,4,0,0,50,27,0,365
Afghanistan,03/08/2009,291,12,-2,0,53,25,0,379
Afghanistan,04/08/2009,236,4,2,0,42,5,0,289
Afghanistan,05/08/2009,292,0,0,0,59,21,0,372
Afghanistan,06/08/2009,430,0,2,0,8,30,0,470
Afghanistan,07/08/2009,585,4,1,0,28,37,0,655
Afghanistan,08/08/2009,193,12,2,0,50,3,0,260
Afghanistan,09/08/2009,263,0,2,0,40,32,0,337
Afghanistan,10/08/2009,261,0,-2,0,72,37,0,368
Afghanistan,11/08/2009,295,6,2,0,66,38,0,407
Afghanistan,12/08/2009,264,2,-3,0,66,26,0,355
Afghanistan,13/08/2009,321,2,1,0,42,5,0,371
Afghanistan,14/08/2009,185,2,-2,0,59,8,0,252
Afghanistan,15/08/2009,195,0,-4,0,26,25,0,242
Afghanistan,16/08/2009,191,0,1,0,38,35,0,265
Afghanistan,17/08/2009,271,6,-1,0,28,24,0,328
Afghanistan,18/08/2009,308,0,-2,0,140,51,0,497
Afghanistan,19/08/2009,260,6,1,0,85,46,0,398
Afghanistan,20/08/2009,426,0,6,0,40,38,0,510
Afghanistan,21/08/2009,496,4,7,0,26,32,0,565
Afghanistan,22/08/2009,226,0,-3,0,34,33,0,290
Afghanistan,23/08/2009,251,2,-2,0,41,18,0,310
Afghanistan,24/08/2009,410,4,5,0,48,24,0,491
Afghanistan,25/08/2009,449,2,2,0,38,36,0,527
Afghanistan,26/08/2009,345,0,1,0,2,47,0,395
Afghanistan,27/08/2009,143,0,2,0,23,11,0,179
Afghanistan,28/08/2009,220,0,3,0,27,13,0,263
Afghanistan,29/08/2009,138,2,-4,0,8,12,0,156
Afghanistan,30/08/2009,140,0,-6,0,25,30,0,189
Afghanistan,31/08/2009,280,0,1,0,0,63,0,344
Albania,01/08/2009,5,0,0,0,3,1,0,9
Albania,02/08/2009,0,0,0,0,0,0,0,0
Albania,03/08/2009,5,0,0,0,2,7,0,14
Albania,04/08/2009,0,0,0,0,3,2,0,5
Albania,05/08/2009,0,0,-2,0,0,0,0,-2
Albania,06/08/2009,0,0,0,0,0,0,0,0
Albania,07/08/2009,4,0,0,0,3,0,0,7
Albania,08/08/2009,2,0,0,0,0,4,0,6
Albania,09/08/2009,0,0,0,0,-2,4,0,2
Albania,10/08/2009,4,0,-2,0,-2,0,0,0
Albania,11/08/2009,4,0,0,0,10,0,0,14
Albania,12/08/2009,5,0,-3,0,1,0,0,3
Albania,13/08/2009,33,0,0,0,0,6,0,39
Albania,14/08/2009,10,0,0,0,0,0,0,10
Albania,15/08/2009,9,0,0,0,0,0,0,9
Albania,16/08/2009,6,0,0,0,0,0,0,6
Albania,17/08/2009,12,0,0,0,6,3,0,21
Albania,18/08/2009,13,0,-2,0,6,10,0,27
Albania,19/08/2009,22,0,-2,0,0,3,0,23
Albania,20/08/2009,2,0,0,0,3,2,0,7
Albania,21/08/2009,0,0,0,0,6,0,0,6
Albania,22/08/2009,0,0,0,0,0,0,0,0
Albania,23/08/2009,1,0,0,0,0,2,0,3
Albania,24/08/2009,0,0,0,0,6,0,0,6
Albania,25/08/2009,102,0,-2,0,24,36,0,160
Albania,26/08/2009,20,0,0,0,9,6,0,35
Albania,27/08/2009,13,0,-1,0,6,3,0,21
Albania,28/08/2009,7,0,-2,0,12,0,0,17
Albania,29/08/2009,0,0,-1,0,9,8,0,16
Albania,30/08/2009,3,0,0,0,6,0,0,9
Albania,31/08/2009,0,0,0,0,-1,0,0,-1
Algeria,01/08/2009,6,0,0,0,3,6,0,15
Algeria,02/08/2009,32,0,0,0,3,6,0,41
Algeria,03/08/2009,7,0,0,0,5,0,0,12
Algeria,04/08/2009,15,0,0,0,3,2,0,20
Algeria,05/08/2009,2,0,0,0,6,1,0,9
Algeria,06/08/2009,0,0,0,0,0,0,0,0
Algeria,07/08/2009,13,0,0,0,3,0,0,16
Algeria,08/08/2009,0,0,0,0,0,0,0,0
Algeria,09/08/2009,2,0,0,0,-2,0,0,0
Algeria,10/08/2009,3,0,0,0,9,0,0,12
Algeria,11/08/2009,3,0,0,0,0,0,0,3
Algeria,12/08/2009,8,0,0,0,-3,0,0,5
Algeria,13/08/2009,20,0,0,0,-6,0,0,14
Algeria,14/08/2009,12,0,0,0,6,0,0,18
Algeria,15/08/2009,9,0,0,0,1,0,0,10
Algeria,16/08/2009,6,0,0,0,3,0,0,9
Algeria,17/08/2009,0,0,0,0,0,0,0,0
Algeria,18/08/2009,16,0,0,0,26,3,0,45
Algeria,19/08/2009,19,0,1,0,3,3,0,26
Algeria,20/08/2009,4,0,0,0,-2,3,0,5
Algeria,21/08/2009,9,0,0,0,9,0,0,18
Algeria,22/08/2009,3,0,0,0,0,0,0,3
Algeria,23/08/2009,9,0,0,0,0,0,0,9
Algeria,24/08/2009,10,0,0,0,3,0,0,13
Algeria,25/08/2009,3,0,0,0,0,0,0,3
Algeria,26/08/2009,21,0,0,0,4,0,0,25
Algeria,27/08/2009,4,0,0,0,6,0,0,10
Algeria,28/08/2009,10,0,0,0,6,3,0,19
Algeria,29/08/2009,0,0,0,0,15,0,0,15
Algeria,30/08/2009,3,0,0,0,6,0,0,9
Algeria,31/08/2009,25,0,0,0,3,0,0,28
Bangladesh,01/08/2009,10,0,1,0,15,0,0,26
Bangladesh,02/08/2009,11,0,0,0,2,0,0,13
Bangladesh,03/08/2009,4,0,0,0,0,0,0,4
Bangladesh,04/08/2009,14,0,1,0,12,5,0,32
Bangladesh,05/08/2009,15,0,0,0,40,6,0,61
Bangladesh,06/08/2009,13,0,0,0,3,0,0,16
Bangladesh,07/08/2009,-1,0,0,0,1,0,0,0
Bangladesh,08/08/2009,13,0,0,0,8,1,0,22
Bangladesh,09/08/2009,7,0,0,0,7,1,0,15
Bangladesh,10/08/2009,3,0,0,0,6,0,0,9
Bangladesh,11/08/2009,13,0,0,0,0,2,0,15
Bangladesh,12/08/2009,13,0,0,0,66,3,0,82
Bangladesh,13/08/2009,20,0,1,0,63,2,0,86
Bangladesh,14/08/2009,-1,0,0,0,4,0,0,3
Bangladesh,15/08/2009,11,0,0,0,3,0,0,14
Bangladesh,16/08/2009,-4,0,0,0,13,2,0,11
Bangladesh,17/08/2009,14,0,1,0,21,0,0,36
Bangladesh,18/08/2009,11,0,0,0,3,0,0,14
Bangladesh,19/08/2009,16,0,0,0,6,0,0,22
Bangladesh,20/08/2009,0,0,0,0,10,4,0,14
Bangladesh,21/08/2009,12,0,0,0,0,2,0,14
Bangladesh,22/08/2009,16,2,0,0,6,0,0,24
Bangladesh,23/08/2009,3,0,0,0,3,3,0,9
Bangladesh,24/08/2009,17,0,0,0,0,2,0,19
Bangladesh,25/08/2009,14,0,-4,0,14,2,0,26
Bangladesh,26/08/2009,4,0,0,0,14,0,0,18
Bangladesh,27/08/2009,-2,0,0,0,6,0,0,4
Bangladesh,28/08/2009,11,0,0,0,13,0,0,24
Bangladesh,29/08/2009,7,0,0,0,7,3,0,17
Bangladesh,30/08/2009,11,2,0,0,0,0,0,13
Bangladesh,31/08/2009,12,0,0,0,2,0,0,14
Cameroon,01/08/2009,6,0,0,0,6,0,0,12
Cameroon,02/08/2009,2,0,0,0,0,0,0,2
Cameroon,03/08/2009,4,0,1,0,0,0,0,5
Cameroon,04/08/2009,2,0,0,0,0,0,0,2
Cameroon,05/08/2009,5,0,0,0,0,0,0,5
Cameroon,06/08/2009,6,0,0,0,1,0,0,7
Cameroon,07/08/2009,1,0,0,0,0,0,0,1
Cameroon,08/08/2009,0,0,0,0,0,0,0,0
Cameroon,10/08/2009,0,0,0,0,0,0,0,0
Cameroon,11/08/2009,0,0,0,0,0,0,0,0
Cameroon,12/08/2009,3,0,0,0,0,0,0,3
Cameroon,13/08/2009,0,0,0,0,3,0,0,3
Cameroon,14/08/2009,0,0,0,0,6,2,0,8
Cameroon,15/08/2009,0,0,0,0,0,0,0,0
Cameroon,16/08/2009,0,0,0,0,0,0,0,0
Cameroon,17/08/2009,0,0,0,0,0,0,0,0
Cameroon,18/08/2009,8,0,0,0,9,0,0,17
Cameroon,19/08/2009,2,0,0,0,0,0,0,2
Cameroon,20/08/2009,0,0,0,0,0,0,0,0
Cameroon,21/08/2009,0,0,0,0,0,0,0,0
Cameroon,22/08/2009,6,0,0,0,0,0,0,6
Cameroon,23/08/2009,0,0,0,0,0,0,0,0
Cameroon,24/08/2009,-1,0,0,0,0,0,0,-1
Cameroon,25/08/2009,0,0,0,0,0,0,0,0
Cameroon,26/08/2009,-1,0,0,0,3,0,0,2
Cameroon,27/08/2009,0,0,0,0,0,0,0,0
Cameroon,28/08/2009,2,0,0,0,3,0,0,5
Cameroon,29/08/2009,3,0,0,0,0,0,0,3
Cameroon,30/08/2009,3,0,0,0,0,0,0,3
Cameroon,31/08/2009,1,0,0,0,0,0,0,1
China,01/08/2009,40,2,-2,0,32,8,0,80
China,02/08/2009,100,0,0,0,41,22,0,163
China,03/08/2009,106,2,0,0,121,28,0,257
China,04/08/2009,198,4,-1,0,207,60,0,468
China,05/08/2009,188,2,1,0,156,21,0,368
China,06/08/2009,124,6,0,0,81,11,0,222
China,07/08/2009,92,4,-4,0,47,12,0,151
China,08/08/2009,75,6,-4,0,41,15,0,133
China,09/08/2009,139,6,-2,0,31,19,0,193
China,10/08/2009,111,2,4,0,40,11,0,168
China,11/08/2009,134,4,1,0,140,22,0,301
China,12/08/2009,107,0,-2,0,84,9,0,198
China,13/08/2009,90,6,2,0,71,27,0,196
China,14/08/2009,83,2,-3,0,28,18,0,128
China,15/08/2009,26,0,-1,0,12,9,0,46
China,16/08/2009,40,12,-1,0,10,26,0,87
China,17/08/2009,121,4,-15,0,16,26,0,152
China,18/08/2009,133,0,-17,0,48,17,0,181
China,19/08/2009,95,0,-13,0,57,7,0,146
China,20/08/2009,113,2,2,0,72,7,0,196
China,21/08/2009,147,0,-3,0,27,13,0,184
China,22/08/2009,77,6,0,0,10,10,0,103
China,23/08/2009,84,4,1,0,32,19,0,140
China,24/08/2009,145,0,2,0,71,16,0,234
China,25/08/2009,130,0,-2,0,69,16,0,213
China,26/08/2009,161,0,-2,0,53,24,0,236
China,27/08/2009,68,0,0,0,43,9,0,120
China,28/08/2009,70,0,-1,0,27,21,0,117
China,29/08/2009,51,0,1,0,10,10,0,72
China,30/08/2009,88,0,-11,0,53,10,0,140
China,31/08/2009,117,6,-10,0,53,11,0,177
Egypt,01/08/2009,11,0,0,0,7,0,0,18
Egypt,02/08/2009,11,0,0,0,15,2,0,28
Egypt,03/08/2009,20,0,0,0,4,1,0,25
Egypt,04/08/2009,46,0,0,0,22,2,0,70
Egypt,05/08/2009,33,0,0,0,18,9,0,60
Egypt,06/08/2009,3,0,0,0,19,0,0,22
Egypt,07/08/2009,13,0,0,0,30,1,0,44
Egypt,08/08/2009,15,0,0,0,-2,6,0,19
Egypt,09/08/2009,18,0,0,0,3,0,0,21
Egypt,10/08/2009,35,0,0,0,5,0,0,40
Egypt,11/08/2009,17,0,0,0,25,0,0,42
Egypt,12/08/2009,16,0,0,0,18,0,0,34
Egypt,13/08/2009,11,0,1,0,1,0,0,13
Egypt,14/08/2009,138,0,1,0,8,13,0,160
Egypt,15/08/2009,335,0,2,0,2,26,0,365
Egypt,16/08/2009,37,0,0,0,6,6,0,49
Egypt,17/08/2009,74,0,3,0,3,3,0,83
Egypt,18/08/2009,29,2,0,0,16,4,0,51
Egypt,19/08/2009,38,0,0,0,10,0,0,48
Egypt,20/08/2009,9,0,2,0,1,4,0,16
Egypt,21/08/2009,23,0,0,0,12,0,0,35
Egypt,22/08/2009,5,0,0,0,9,2,0,16
Egypt,23/08/2009,25,0,0,0,-3,5,0,27
Egypt,24/08/2009,39,0,0,0,1,3,0,43
Egypt,25/08/2009,77,6,0,0,7,2,0,92
Egypt,26/08/2009,27,0,0,0,5,2,0,34
Egypt,27/08/2009,1,4,0,0,-2,1,0,4
Egypt,28/08/2009,20,0,0,0,15,1,0,36
Egypt,29/08/2009,36,0,0,0,3,0,0,39
Egypt,30/08/2009,8,0,0,0,1,2,0,11
Egypt,31/08/2009,7,0,0,0,17,1,0,25
Eritrea,01/08/2009,6,0,0,0,15,1,0,22
Eritrea,02/08/2009,0,0,0,0,-2,0,0,-2
Eritrea,03/08/2009,0,0,0,0,0,1,0,1
Eritrea,04/08/2009,3,0,0,0,0,0,0,3
Eritrea,05/08/2009,7,0,0,0,0,0,0,7
Eritrea,06/08/2009,27,0,0,0,6,0,0,33
Eritrea,07/08/2009,22,0,0,0,0,0,0,22
Eritrea,08/08/2009,24,0,0,0,6,0,0,30
Eritrea,09/08/2009,23,0,0,0,3,0,0,26
Eritrea,10/08/2009,12,0,0,0,0,0,0,12
Eritrea,11/08/2009,0,0,0,0,0,0,0,0
Eritrea,12/08/2009,3,0,0,0,0,0,0,3
Eritrea,13/08/2009,0,0,0,0,0,0,0,0
Eritrea,14/08/2009,0,0,0,0,0,0,0,0
Eritrea,15/08/2009,2,0,0,0,0,0,0,2
Eritrea,17/08/2009,8,0,0,0,0,0,0,8
Eritrea,18/08/2009,10,0,0,0,3,0,0,13
Eritrea,19/08/2009,0,0,0,0,0,0,0,0
Eritrea,20/08/2009,8,0,0,0,0,0,0,8
Eritrea,21/08/2009,7,0,0,0,1,0,0,8
Eritrea,22/08/2009,2,0,0,0,9,0,0,11
Eritrea,23/08/2009,2,0,0,0,-2,4,0,4
Eritrea,24/08/2009,1,0,0,0,7,0,0,8
Eritrea,25/08/2009,3,0,0,0,1,0,0,4
Eritrea,26/08/2009,3,0,0,0,0,0,0,3
Eritrea,28/08/2009,9,0,0,0,0,0,0,9
Eritrea,29/08/2009,0,0,0,0,0,0,0,0
Eritrea,30/08/2009,0,0,0,0,0,0,0,0
Eritrea,31/08/2009,4,0,0,0,0,0,0,4
Georgia,01/08/2009,-2,2,0,0,9,0,0,9
Georgia,02/08/2009,13,0,0,0,3,0,0,16
Georgia,03/08/2009,32,0,0,0,18,2,0,52
Georgia,04/08/2009,19,0,0,0,17,0,0,36
Georgia,05/08/2009,40,0,0,0,20,2,0,62
Georgia,06/08/2009,43,0,0,0,12,3,0,58
Georgia,07/08/2009,52,0,1,0,11,4,0,68
Georgia,08/08/2009,30,0,0,0,0,1,0,31
Georgia,09/08/2009,23,0,0,0,-1,2,0,24
Georgia,10/08/2009,4,0,0,0,-2,0,0,2
Georgia,11/08/2009,22,2,1,0,19,2,0,46
Georgia,12/08/2009,34,4,0,0,44,7,0,89
Georgia,13/08/2009,31,0,-1,0,40,5,0,75
Georgia,14/08/2009,24,0,0,0,21,3,0,48
Georgia,15/08/2009,5,0,0,0,3,4,0,12
Georgia,16/08/2009,7,0,0,0,0,0,0,7
Georgia,17/08/2009,31,0,1,0,60,3,0,95
Georgia,18/08/2009,42,0,0,0,49,9,0,100
Georgia,19/08/2009,30,0,-8,0,3,3,0,28
Georgia,20/08/2009,35,0,0,0,25,2,0,62
Georgia,21/08/2009,42,2,-4,0,42,6,0,88
Georgia,22/08/2009,18,0,2,0,39,4,0,63
Georgia,23/08/2009,3,0,0,0,12,0,0,15
Georgia,24/08/2009,21,0,0,0,17,3,0,41
Georgia,25/08/2009,11,0,0,0,-3,2,0,10
Georgia,26/08/2009,23,0,0,0,18,0,0,41
Georgia,27/08/2009,14,0,0,0,-1,0,0,13
Georgia,28/08/2009,13,0,0,0,29,2,0,44
Georgia,29/08/2009,17,0,1,0,-2,4,0,20
Georgia,30/08/2009,52,0,0,0,9,10,0,71
Georgia,31/08/2009,89,0,1,0,6,14,0,110
India,01/08/2009,37,0,0,0,3,13,0,53
India,02/08/2009,46,0,0,0,26,10,0,82
India,03/08/2009,51,0,-1,0,25,9,0,84
India,04/08/2009,56,2,0,0,4,2,0,64
India,05/08/2009,42,2,-1,0,6,1,0,50
India,06/08/2009,72,0,-3,0,9,4,0,82
India,07/08/2009,54,2,1,0,34,7,0,98
India,08/08/2009,35,8,-3,0,11,8,0,59
India,09/08/2009,45,0,0,0,-8,11,0,48
India,10/08/2009,25,6,0,0,-9,5,0,27
India,11/08/2009,64,0,0,0,46,9,0,119
India,12/08/2009,70,0,-2,0,34,6,0,108
India,13/08/2009,79,0,-1,0,7,5,0,90
India,14/08/2009,65,0,-1,0,14,4,0,82
India,15/08/2009,63,0,0,0,6,8,0,77
India,16/08/2009,41,0,-1,0,15,10,0,65
India,17/08/2009,37,2,0,0,13,6,0,58
India,18/08/2009,79,2,-7,0,6,4,0,84
India,19/08/2009,73,2,-2,0,29,5,0,107
India,20/08/2009,50,2,0,0,29,6,0,87
India,21/08/2009,77,0,-1,0,41,9,0,126
India,22/08/2009,42,0,0,0,11,7,0,60
India,23/08/2009,33,0,1,0,-1,9,0,42
India,24/08/2009,50,8,-3,0,-4,11,0,62
India,25/08/2009,48,0,-2,0,0,11,0,57
India,26/08/2009,54,2,1,0,18,15,0,90
India,27/08/2009,28,0,0,0,0,4,0,32
India,28/08/2009,56,2,-4,0,12,-1,0,65
India,29/08/2009,32,2,0,0,1,7,0,42
India,30/08/2009,55,0,4,0,1,4,0,64
India,31/08/2009,83,2,-1,0,18,17,0,119
Iran,01/08/2009,101,4,-1,0,208,8,0,320
Iran,02/08/2009,71,0,-2,0,308,9,0,386
Iran,03/08/2009,153,0,0,0,204,14,0,371
Iran,04/08/2009,162,0,2,0,121,19,0,304
Iran,05/08/2009,51,2,1,0,132,10,0,196
Iran,06/08/2009,63,0,-1,0,52,7,0,121
Iran,07/08/2009,48,0,-2,0,83,22,0,151
Iran,08/08/2009,11,0,2,0,3,1,0,17
Iran,09/08/2009,45,0,1,0,21,5,0,72
Iran,10/08/2009,39,0,4,0,45,10,0,98
Iran,11/08/2009,47,0,3,0,68,5,0,123
Iran,12/08/2009,39,0,-1,0,54,20,0,112
Iran,13/08/2009,69,0,1,0,50,10,0,130
Iran,14/08/2009,63,0,2,0,97,11,0,173
Iran,15/08/2009,88,0,1,0,119,10,0,218
Iran,16/08/2009,44,2,2,0,59,13,0,120
Iran,17/08/2009,51,0,3,0,20,1,0,75
Iran,18/08/2009,92,0,0,0,41,25,0,158
Iran,19/08/2009,150,0,0,0,34,28,0,212
Iran,20/08/2009,106,0,0,0,39,9,0,154
Iran,21/08/2009,75,0,0,0,22,4,0,101
Iran,22/08/2009,42,0,-2,0,15,3,0,58
Iran,23/08/2009,87,0,0,0,13,15,0,115
Iran,24/08/2009,100,0,2,0,47,16,0,165
Iran,25/08/2009,64,2,0,0,63,21,0,150
Iran,26/08/2009,75,0,-2,0,63,11,0,147
Iran,27/08/2009,24,0,1,0,18,1,0,44
Iran,28/08/2009,19,0,6,0,29,8,0,62
Iran,29/08/2009,73,0,0,0,24,1,0,98
Iran,30/08/2009,81,0,-1,0,16,4,0,100
Iran,31/08/2009,80,0,-4,0,2,8,0,86
Iraq,01/08/2009,97,0,1,0,110,9,0,217
Iraq,02/08/2009,113,0,0,0,83,7,0,203
Iraq,03/08/2009,181,0,2,0,51,10,0,244
Iraq,04/08/2009,160,2,1,0,65,2,0,230
Iraq,05/08/2009,125,0,-2,0,70,7,0,200
Iraq,06/08/2009,109,0,1,0,37,14,0,161
Iraq,07/08/2009,101,2,3,0,36,68,0,210
Iraq,08/08/2009,69,2,-2,0,20,10,0,99
Iraq,09/08/2009,96,2,-2,0,70,3,0,169
Iraq,10/08/2009,141,4,0,0,37,23,0,205
Iraq,11/08/2009,177,2,0,0,21,2,0,202
Iraq,12/08/2009,98,6,0,0,43,19,0,166
Iraq,13/08/2009,84,0,1,0,27,23,0,135
Iraq,14/08/2009,108,0,3,0,59,10,0,180
Iraq,15/08/2009,60,0,0,0,12,8,0,80
Iraq,16/08/2009,66,0,2,0,-2,1,0,67
Iraq,17/08/2009,110,0,0,0,9,14,0,133
Iraq,18/08/2009,42,0,0,0,24,6,0,72
Iraq,19/08/2009,145,0,-10,0,19,3,0,157
Iraq,20/08/2009,98,6,2,0,44,11,0,161
Iraq,21/08/2009,140,0,6,0,25,4,0,175
Iraq,22/08/2009,87,0,0,0,58,12,0,157
Iraq,23/08/2009,25,0,2,0,29,16,0,72
Iraq,24/08/2009,120,4,2,0,94,21,0,241
Iraq,25/08/2009,57,0,0,0,33,4,0,94
Iraq,26/08/2009,55,0,9,0,26,12,0,102
Iraq,27/08/2009,25,0,0,0,2,0,0,27
Iraq,28/08/2009,82,0,0,0,30,9,0,121
Iraq,29/08/2009,60,0,0,0,-16,10,0,54
Iraq,30/08/2009,19,0,0,0,8,21,0,48
Iraq,31/08/2009,94,2,0,0,16,7,0,119
Morocco,01/08/2009,12,0,1,0,3,0,0,16
Morocco,02/08/2009,7,0,0,0,33,0,0,40
Morocco,03/08/2009,1,0,0,0,66,0,0,67
Morocco,04/08/2009,0,0,-10,0,41,2,0,33
Morocco,05/08/2009,11,0,0,0,18,0,0,29
Morocco,06/08/2009,5,0,0,0,0,0,0,5
Morocco,07/08/2009,2,0,1,0,1,0,0,4
Morocco,08/08/2009,0,0,0,0,9,0,0,9
Morocco,09/08/2009,-5,0,0,0,12,0,0,7
Morocco,10/08/2009,3,2,0,0,59,2,0,66
Morocco,11/08/2009,0,0,0,0,9,1,0,10
Morocco,12/08/2009,5,0,0,0,3,1,0,9
Morocco,13/08/2009,2,0,0,0,21,0,0,23
Morocco,14/08/2009,2,0,0,0,-2,0,0,0
Morocco,15/08/2009,5,0,0,0,3,0,0,8
Morocco,16/08/2009,0,0,0,0,16,0,0,16
Morocco,17/08/2009,-1,0,0,0,3,0,0,2
Morocco,18/08/2009,6,0,0,0,0,1,0,7
Morocco,19/08/2009,1,0,0,0,0,3,0,4
Morocco,20/08/2009,2,0,0,0,3,1,0,6
Morocco,21/08/2009,3,0,0,0,13,1,0,17
Morocco,22/08/2009,0,0,0,0,-2,0,0,-2
Morocco,23/08/2009,0,0,0,0,9,0,0,9
Morocco,24/08/2009,0,0,0,0,3,1,0,4
Morocco,25/08/2009,-1,0,0,0,15,1,0,15
Morocco,26/08/2009,-1,0,0,0,18,0,0,17
Morocco,27/08/2009,0,0,0,0,9,0,0,9
Morocco,28/08/2009,-2,0,0,0,9,0,0,7
Morocco,29/08/2009,0,0,0,0,0,0,0,0
Morocco,30/08/2009,3,0,0,0,3,0,0,6
Morocco,31/08/2009,-3,0,0,0,24,1,0,22
Nigeria,01/08/2009,4,0,2,0,9,1,0,16
Nigeria,02/08/2009,21,0,0,0,15,-1,0,35
Nigeria,03/08/2009,34,0,-1,0,22,4,0,59
Nigeria,04/08/2009,36,0,-4,0,26,7,0,65
Nigeria,05/08/2009,37,0,0,0,24,1,0,62
Nigeria,06/08/2009,11,0,3,0,52,2,0,68
Nigeria,07/08/2009,16,0,0,0,6,0,0,22
Nigeria,08/08/2009,5,0,0,0,10,2,0,17
Nigeria,09/08/2009,11,0,-2,0,1,0,0,10
Nigeria,10/08/2009,5,0,0,0,6,4,0,15
Nigeria,11/08/2009,21,0,0,0,23,5,0,49
Nigeria,12/08/2009,24,0,-1,0,1,4,0,28
Nigeria,13/08/2009,31,0,0,0,13,15,0,59
Nigeria,14/08/2009,28,0,0,0,-11,7,0,24
Nigeria,15/08/2009,12,0,0,0,9,2,0,23
Nigeria,16/08/2009,35,0,-2,0,12,0,0,45
Nigeria,17/08/2009,30,0,0,0,34,2,0,66
Nigeria,18/08/2009,17,0,0,0,28,4,0,49
Nigeria,19/08/2009,20,0,1,0,8,4,0,33
Nigeria,20/08/2009,21,0,0,0,29,-2,0,48
Nigeria,21/08/2009,26,0,0,0,9,0,0,35
Nigeria,22/08/2009,24,2,0,0,-2,0,0,24
Nigeria,23/08/2009,11,0,0,0,11,1,0,23
Nigeria,24/08/2009,22,0,0,0,4,1,0,27
Nigeria,25/08/2009,7,2,0,0,6,14,0,29
Nigeria,26/08/2009,11,0,0,0,3,2,0,16
Nigeria,27/08/2009,1,0,0,0,-2,0,0,-1
Nigeria,28/08/2009,29,0,-1,0,20,2,0,50
Nigeria,29/08/2009,9,0,2,0,18,2,0,31
Nigeria,30/08/2009,26,0,1,0,6,0,0,33
Nigeria,31/08/2009,16,0,0,0,3,0,0,19
Pakistan,01/08/2009,99,0,0,0,46,9,0,154
Pakistan,02/08/2009,75,0,0,0,47,17,0,139
Pakistan,03/08/2009,107,0,-10,0,222,32,0,351
Pakistan,04/08/2009,110,0,-3,0,107,3,0,217
Pakistan,05/08/2009,147,0,-6,0,72,11,0,224
Pakistan,06/08/2009,105,0,1,0,76,12,0,194
Pakistan,07/08/2009,183,0,1,0,80,9,0,273
Pakistan,08/08/2009,218,0,1,0,6,10,0,235
Pakistan,09/08/2009,222,0,-1,0,50,18,0,289
Pakistan,10/08/2009,188,2,0,0,69,23,0,282
Pakistan,11/08/2009,96,0,0,0,8,12,0,116
Pakistan,12/08/2009,332,0,0,0,58,10,0,400
Pakistan,13/08/2009,82,0,-4,0,32,3,0,113
Pakistan,14/08/2009,91,0,9,0,47,6,0,153
Pakistan,15/08/2009,82,0,1,0,35,21,0,139
Pakistan,16/08/2009,55,0,2,0,12,13,0,82
Pakistan,17/08/2009,80,0,-2,0,22,7,0,107
Pakistan,18/08/2009,128,2,-2,0,58,14,0,200
Pakistan,19/08/2009,109,2,2,0,22,6,0,141
Pakistan,20/08/2009,106,0,1,0,24,7,0,138
Pakistan,21/08/2009,103,2,0,0,4,12,0,121
Pakistan,22/08/2009,41,0,0,0,17,4,0,62
Pakistan,23/08/2009,64,2,0,0,27,9,0,102
Pakistan,24/08/2009,134,4,0,0,67,12,0,217
Pakistan,25/08/2009,127,6,-5,0,68,6,0,202
Pakistan,26/08/2009,141,0,1,0,39,8,0,189
Pakistan,27/08/2009,25,0,-1,0,6,2,0,32
Pakistan,28/08/2009,134,2,-1,0,23,14,0,172
Pakistan,29/08/2009,73,2,0,0,26,5,0,106
Pakistan,30/08/2009,57,0,-1,0,11,24,0,91
Pakistan,31/08/2009,130,2,-2,0,25,16,0,171
Sierra Leone,01/08/2009,2,0,0,0,0,0,0,2
Sierra Leone,02/08/2009,0,0,0,0,0,0,0,0
Sierra Leone,03/08/2009,0,0,0,0,0,0,0,0
Sierra Leone,04/08/2009,0,0,0,0,-2,4,0,2
Sierra Leone,05/08/2009,2,0,0,0,3,2,0,7
Sierra Leone,06/08/2009,2,0,0,0,3,0,0,5
Sierra Leone,07/08/2009,0,0,0,0,2,0,0,2
Sierra Leone,08/08/2009,2,0,0,0,9,0,0,11
Sierra Leone,10/08/2009,2,0,0,0,0,1,0,3
Sierra Leone,11/08/2009,7,0,0,0,1,0,0,8
Sierra Leone,12/08/2009,11,0,0,0,-2,0,0,9
Sierra Leone,13/08/2009,11,0,0,0,0,0,0,11
Sierra Leone,14/08/2009,0,0,0,0,0,2,0,2
Sierra Leone,15/08/2009,0,0,0,0,0,0,0,0
Sierra Leone,16/08/2009,3,0,-2,0,0,1,0,2
Sierra Leone,17/08/2009,0,2,0,0,3,0,0,5
Sierra Leone,18/08/2009,-1,2,0,0,-4,0,0,-3
Sierra Leone,19/08/2009,3,2,-2,0,9,1,0,13
Sierra Leone,20/08/2009,3,0,0,0,-2,0,0,1
Sierra Leone,21/08/2009,3,0,0,0,-2,0,0,1
Sierra Leone,22/08/2009,0,0,0,0,0,0,0,0
Sierra Leone,23/08/2009,5,0,-4,0,3,2,0,6
Sierra Leone,24/08/2009,3,0,0,0,6,0,0,9
Sierra Leone,25/08/2009,1,0,0,0,0,0,0,1
Sierra Leone,26/08/2009,8,0,0,0,0,0,0,8
Sierra Leone,27/08/2009,0,0,0,0,0,0,0,0
Sierra Leone,28/08/2009,0,0,0,0,0,0,0,0
Sierra Leone,29/08/2009,0,0,0,0,0,0,0,0
Sierra Leone,30/08/2009,2,0,0,0,6,0,0,8
Sierra Leone,31/08/2009,1,0,0,0,0,0,0,1
Somalia,01/08/2009,30,0,0,0,9,5,0,44
Somalia,02/08/2009,14,0,0,0,4,3,0,21
Somalia,03/08/2009,140,0,-2,0,14,2,0,154
Somalia,04/08/2009,135,4,-4,0,75,9,0,219
Somalia,05/08/2009,61,0,0,0,40,3,0,104
Somalia,06/08/2009,164,0,2,0,20,8,0,194
Somalia,07/08/2009,75,4,0,0,21,15,0,115
Somalia,08/08/2009,7,0,0,0,31,0,0,38
Somalia,09/08/2009,9,0,0,0,11,0,0,20
Somalia,10/08/2009,30,2,0,0,-42,0,0,-10
Somalia,11/08/2009,46,0,0,0,12,4,0,62
Somalia,12/08/2009,74,2,0,0,56,6,0,138
Somalia,13/08/2009,49,0,0,0,80,9,0,138
Somalia,14/08/2009,44,0,1,0,51,0,0,96
Somalia,15/08/2009,37,0,0,0,-2,0,0,35
Somalia,16/08/2009,28,0,0,0,25,0,0,53
Somalia,17/08/2009,52,2,0,0,12,7,0,73
Somalia,18/08/2009,86,0,0,0,15,0,0,101
Somalia,19/08/2009,76,0,0,0,34,4,0,114
Somalia,20/08/2009,40,0,0,0,13,0,0,53
Somalia,21/08/2009,37,0,0,0,17,0,0,54
Somalia,22/08/2009,23,0,0,0,3,0,0,26
Somalia,23/08/2009,36,0,0,0,17,28,0,81
Somalia,24/08/2009,22,0,-1,0,20,8,0,49
Somalia,25/08/2009,16,0,0,0,29,2,0,47
Somalia,26/08/2009,39,0,0,0,18,0,0,57
Somalia,27/08/2009,39,0,-2,0,0,0,0,37
Somalia,28/08/2009,19,0,0,0,21,3,0,43
Somalia,29/08/2009,28,0,0,0,0,6,0,34
Somalia,30/08/2009,4,0,0,0,27,1,0,32
Somalia,31/08/2009,14,2,0,0,11,6,0,33
Syria,01/08/2009,1,0,2,0,16,0,0,19
Syria,02/08/2009,9,0,1,0,3,0,0,13
Syria,03/08/2009,-22,0,-3,0,12,1,0,-12
Syria,04/08/2009,22,0,0,0,3,0,0,25
Syria,05/08/2009,-2,0,0,0,8,8,0,14
Syria,06/08/2009,17,0,0,0,6,0,0,23
Syria,07/08/2009,4,0,0,0,3,0,0,7
Syria,08/08/2009,13,0,0,0,6,1,0,20
Syria,09/08/2009,44,0,0,0,-4,0,0,40
Syria,10/08/2009,12,0,0,0,-8,0,0,4
Syria,11/08/2009,21,0,0,0,-10,3,0,14
Syria,12/08/2009,29,0,0,0,6,5,0,40
Syria,13/08/2009,37,0,0,0,9,0,0,46
Syria,14/08/2009,22,0,0,0,0,5,0,27
Syria,15/08/2009,171,0,0,0,3,7,0,181
Syria,16/08/2009,53,0,0,0,0,0,0,53
Syria,17/08/2009,21,0,0,0,-9,3,0,15
Syria,18/08/2009,8,0,1,0,6,0,0,15
Syria,19/08/2009,33,0,0,0,11,0,0,44
Syria,20/08/2009,14,0,1,0,15,3,0,33
Syria,21/08/2009,0,0,1,0,-1,0,0,0
Syria,22/08/2009,6,0,1,0,12,0,0,19
Syria,23/08/2009,7,0,0,0,-6,0,0,1
Syria,24/08/2009,4,0,0,0,12,0,0,16
Syria,25/08/2009,24,0,1,0,6,3,0,34
Syria,26/08/2009,75,0,1,0,28,3,0,107
Syria,27/08/2009,4,0,0,0,0,0,0,4
Syria,28/08/2009,22,0,0,0,0,1,0,23
Syria,29/08/2009,51,0,0,0,0,2,0,53
Syria,30/08/2009,33,0,0,0,-3,3,0,33
Syria,31/08/2009,12,0,0,0,27,1,0,40
Yemen,01/08/2009,0,0,0,0,1,0,0,1
Yemen,02/08/2009,0,0,0,0,-1,3,0,2
Yemen,03/08/2009,22,0,0,0,8,0,0,30
Yemen,04/08/2009,22,2,0,0,12,0,0,36
Yemen,05/08/2009,0,0,0,0,0,0,0,0
Yemen,06/08/2009,22,0,0,0,0,0,0,22
Yemen,07/08/2009,16,0,0,0,37,1,0,54
Yemen,08/08/2009,-2,0,0,0,15,0,0,13
Yemen,09/08/2009,1,0,0,0,-2,0,0,-1
Yemen,10/08/2009,12,0,0,0,9,0,0,21
Yemen,11/08/2009,38,0,0,0,19,1,0,58
Yemen,12/08/2009,29,0,0,0,12,0,0,41
Yemen,13/08/2009,6,0,0,0,-3,2,0,5
Yemen,14/08/2009,14,0,0,0,11,2,0,27
Yemen,15/08/2009,14,0,0,0,-5,2,0,11
Yemen,16/08/2009,9,0,0,0,0,1,0,10
Yemen,17/08/2009,37,0,0,0,9,0,0,46
Yemen,18/08/2009,16,0,0,0,-1,2,0,17
Yemen,19/08/2009,18,0,0,0,43,7,0,68
Yemen,20/08/2009,9,0,0,0,2,0,0,11
Yemen,21/08/2009,13,0,0,0,-1,17,0,29
Yemen,22/08/2009,-4,0,0,0,-3,24,0,17
Yemen,23/08/2009,25,0,0,0,-5,9,0,29
Yemen,24/08/2009,31,0,0,0,-14,0,0,17
Yemen,25/08/2009,19,0,0,0,5,0,0,24
Yemen,26/08/2009,40,0,0,0,-2,2,0,40
Yemen,27/08/2009,65,0,0,0,2,5,0,72
Yemen,28/08/2009,58,0,0,0,9,22,0,89
Yemen,29/08/2009,6,0,0,0,0,14,0,20
Yemen,30/08/2009,16,0,0,0,2,12,0,30
Yemen,31/08/2009,26,0,0,0,1,0,0,27
Afghanistan,01/07/2007,124,0,0,0,26,7,0,157
Afghanistan,02/07/2007,235,2,0,0,16,16,0,269
Afghanistan,03/07/2007,162,0,1,0,43,10,0,216
Afghanistan,04/07/2007,321,0,0,0,94,27,0,442
Afghanistan,05/07/2007,125,6,0,0,61,14,0,206
Afghanistan,06/07/2007,89,0,0,0,10,19,0,118
Afghanistan,07/07/2007,105,0,0,0,13,38,0,156
Afghanistan,08/07/2007,100,0,0,0,19,23,0,142
Afghanistan,09/07/2007,131,0,0,0,13,7,0,151
Afghanistan,10/07/2007,100,0,0,0,11,14,0,125
Afghanistan,11/07/2007,120,2,-2,0,4,9,0,133
Afghanistan,12/07/2007,104,0,0,0,15,21,0,140
Afghanistan,13/07/2007,113,2,-2,0,54,10,0,177
Afghanistan,14/07/2007,170,0,-3,0,24,47,0,238
Afghanistan,15/07/2007,196,0,0,0,-4,30,0,222
Afghanistan,16/07/2007,121,0,0,0,12,6,0,139
Afghanistan,17/07/2007,129,0,-8,0,-4,19,0,136
Afghanistan,18/07/2007,103,0,0,0,8,28,0,139
Afghanistan,19/07/2007,77,2,-3,0,18,4,0,98
Afghanistan,20/07/2007,112,6,0,0,92,32,0,242
Afghanistan,21/07/2007,150,0,1,0,18,3,0,172
Afghanistan,22/07/2007,107,0,0,0,-3,0,0,104
Afghanistan,23/07/2007,169,0,0,0,24,3,0,196
Afghanistan,24/07/2007,205,0,1,0,31,20,0,257
Afghanistan,25/07/2007,247,0,1,0,10,9,0,267
Afghanistan,26/07/2007,199,0,-1,0,36,4,0,238
Afghanistan,27/07/2007,125,0,2,0,30,11,0,168
Afghanistan,28/07/2007,88,0,1,0,18,10,0,117
Afghanistan,29/07/2007,100,0,-2,0,-6,14,0,106
Afghanistan,30/07/2007,221,0,-3,0,67,12,0,297
Afghanistan,31/07/2007,102,4,1,0,94,17,0,218
Albania,01/07/2007,2,0,0,0,0,0,0,2
Albania,02/07/2007,26,0,0,0,0,3,0,29
Albania,03/07/2007,27,0,0,0,1,4,0,32
Albania,04/07/2007,23,0,-1,0,-2,1,0,21
Albania,05/07/2007,0,0,0,0,-1,4,0,3
Albania,06/07/2007,10,0,-1,0,0,1,0,10
Albania,07/07/2007,2,0,-1,0,9,0,0,10
Albania,08/07/2007,17,0,-4,0,6,0,0,19
Albania,09/07/2007,35,0,-5,0,22,2,0,54
Albania,10/07/2007,5,0,-5,0,6,3,0,9
Albania,11/07/2007,27,0,-2,0,0,0,0,25
Albania,12/07/2007,41,0,0,0,0,2,0,43
Albania,13/07/2007,9,0,-1,0,6,3,0,17
Albania,14/07/2007,23,0,-1,0,0,4,0,26
Albania,15/07/2007,2,0,0,0,0,4,0,6
Albania,16/07/2007,10,0,-3,0,3,0,0,10
Albania,17/07/2007,33,0,-5,0,7,0,0,35
Albania,18/07/2007,23,0,-4,0,18,0,0,37
Albania,19/07/2007,20,0,-1,0,3,0,0,22
Albania,20/07/2007,41,0,-15,0,-3,0,0,23
Albania,21/07/2007,15,0,0,0,0,-6,0,9
Albania,22/07/2007,2,0,0,0,0,0,0,2
Albania,23/07/2007,0,0,0,0,0,0,0,0
Albania,24/07/2007,14,0,-4,0,0,0,0,10
Albania,25/07/2007,5,0,-3,0,0,2,0,4
Albania,26/07/2007,8,0,0,0,0,1,0,9
Albania,27/07/2007,8,0,-2,0,-2,0,0,4
Albania,28/07/2007,8,0,1,0,3,0,0,12
Albania,29/07/2007,0,0,0,0,0,0,0,0
Albania,30/07/2007,7,0,-3,0,0,0,0,4
Albania,31/07/2007,1,0,0,0,16,8,0,25
Algeria,01/07/2007,5,0,0,0,6,0,0,11
Algeria,02/07/2007,5,0,0,0,12,1,0,18
Algeria,03/07/2007,3,0,-1,0,6,0,0,8
Algeria,04/07/2007,2,0,0,0,0,0,0,2
Algeria,05/07/2007,22,0,0,0,8,1,0,31
Algeria,06/07/2007,0,0,0,0,6,0,0,6
Algeria,07/07/2007,2,0,0,0,0,0,0,2
Algeria,08/07/2007,4,0,0,0,-1,0,0,3
Algeria,09/07/2007,7,0,0,0,6,0,0,13
Algeria,10/07/2007,11,0,0,0,3,3,0,17
Algeria,11/07/2007,17,0,-1,0,0,0,0,16
Algeria,12/07/2007,6,0,0,0,0,0,0,6
Algeria,13/07/2007,12,0,0,0,24,1,0,37
Algeria,14/07/2007,0,0,0,0,0,0,0,0
Algeria,15/07/2007,0,0,0,0,0,0,0,0
Algeria,16/07/2007,2,2,0,0,0,0,0,4
Algeria,17/07/2007,2,0,0,0,0,3,0,5
Algeria,18/07/2007,2,0,0,0,0,0,0,2
Algeria,19/07/2007,15,0,0,0,1,0,0,16
Algeria,20/07/2007,0,0,0,0,0,0,0,0
Algeria,21/07/2007,0,0,0,0,0,0,0,0
Algeria,22/07/2007,0,0,0,0,0,0,0,0
Algeria,23/07/2007,15,0,0,0,0,3,0,18
Algeria,24/07/2007,12,0,0,0,0,6,0,18
Algeria,25/07/2007,0,0,0,0,0,3,0,3
Algeria,26/07/2007,0,0,0,0,6,0,0,6
Algeria,27/07/2007,3,0,0,0,6,0,0,9
Algeria,28/07/2007,1,0,0,0,0,0,0,1
Algeria,29/07/2007,6,0,0,0,0,0,0,6
Algeria,30/07/2007,8,0,0,0,9,3,0,20
Algeria,31/07/2007,4,0,0,0,0,1,0,5
Bangladesh,01/07/2007,10,0,-2,0,-4,0,0,4
Bangladesh,02/07/2007,3,0,0,0,0,1,0,4
Bangladesh,03/07/2007,9,0,0,0,12,0,0,21
Bangladesh,04/07/2007,-1,4,0,0,31,3,0,37
Bangladesh,05/07/2007,2,0,0,0,23,0,0,25
Bangladesh,06/07/2007,1,0,0,0,1,0,0,2
Bangladesh,07/07/2007,2,0,0,0,3,0,0,5
Bangladesh,08/07/2007,0,0,0,0,0,2,0,2
Bangladesh,09/07/2007,0,0,0,0,0,0,0,0
Bangladesh,10/07/2007,7,4,0,0,3,0,0,14
Bangladesh,11/07/2007,2,0,0,0,12,0,0,14
Bangladesh,12/07/2007,11,0,0,0,3,0,0,14
Bangladesh,13/07/2007,3,0,0,0,0,0,0,3
Bangladesh,14/07/2007,9,0,0,0,6,1,0,16
Bangladesh,15/07/2007,6,0,-4,0,6,3,0,11
Bangladesh,16/07/2007,21,0,0,0,18,1,0,40
Bangladesh,17/07/2007,10,0,-4,0,12,2,0,20
Bangladesh,18/07/2007,4,0,0,0,-4,0,0,0
Bangladesh,19/07/2007,5,0,2,0,-1,2,0,8
Bangladesh,20/07/2007,6,0,0,0,0,0,0,6
Bangladesh,21/07/2007,2,0,0,0,7,9,0,18
Bangladesh,22/07/2007,8,0,0,0,24,1,0,33
Bangladesh,23/07/2007,4,0,0,0,0,0,0,4
Bangladesh,24/07/2007,4,0,0,0,0,0,0,4
Bangladesh,25/07/2007,9,0,2,0,15,0,0,26
Bangladesh,26/07/2007,18,0,0,0,21,6,0,45
Bangladesh,27/07/2007,5,0,0,0,18,0,0,23
Bangladesh,28/07/2007,-3,0,0,0,9,0,0,6
Bangladesh,29/07/2007,3,0,0,0,12,0,0,15
Bangladesh,30/07/2007,1,0,0,0,23,0,0,24
Bangladesh,31/07/2007,4,0,0,0,-2,1,0,3
Cameroon,01/07/2007,0,2,0,0,0,0,0,2
Cameroon,02/07/2007,7,0,0,0,6,0,0,13
Cameroon,03/07/2007,0,0,0,0,0,0,0,0
Cameroon,04/07/2007,0,0,0,0,0,0,0,0
Cameroon,05/07/2007,0,0,0,0,0,0,0,0
Cameroon,09/07/2007,0,0,0,0,0,0,0,0
Cameroon,11/07/2007,0,0,0,0,0,0,0,0
Cameroon,12/07/2007,1,0,0,0,0,0,0,1
Cameroon,13/07/2007,0,0,0,0,0,0,0,0
Cameroon,15/07/2007,0,0,0,0,3,0,0,3
Cameroon,16/07/2007,0,0,0,0,0,0,0,0
Cameroon,17/07/2007,24,0,0,0,0,0,0,24
Cameroon,21/07/2007,0,0,0,0,-2,0,0,-2
Cameroon,23/07/2007,0,0,0,0,0,0,0,0
Cameroon,24/07/2007,0,0,0,0,0,1,0,1
Cameroon,25/07/2007,0,0,0,0,0,0,0,0
Cameroon,26/07/2007,2,0,0,0,0,0,0,2
Cameroon,27/07/2007,1,0,0,0,0,1,0,2
Cameroon,30/07/2007,0,0,0,0,0,0,0,0
China,01/07/2007,51,4,0,0,7,3,0,65
China,02/07/2007,34,2,0,0,30,2,0,68
China,03/07/2007,114,0,-3,0,42,26,0,179
China,04/07/2007,37,0,-4,0,29,8,0,70
China,05/07/2007,124,0,0,0,51,11,0,186
China,06/07/2007,63,0,-1,0,54,18,0,134
China,07/07/2007,21,0,0,0,16,6,0,43
China,08/07/2007,117,0,0,0,15,3,0,135
China,09/07/2007,152,0,2,0,38,5,0,197
China,10/07/2007,113,2,0,0,24,8,0,147
China,11/07/2007,96,0,-4,0,3,21,0,116
China,12/07/2007,135,0,0,0,57,6,0,198
China,13/07/2007,66,0,0,0,20,10,0,96
China,14/07/2007,27,0,0,0,12,0,0,39
China,15/07/2007,29,0,-2,0,3,7,0,37
China,16/07/2007,40,0,6,0,-9,3,0,40
China,17/07/2007,27,2,0,0,35,13,0,77
China,18/07/2007,12,2,1,0,24,8,0,47
China,19/07/2007,214,0,0,0,16,54,0,284
China,20/07/2007,123,0,0,0,24,25,0,172
China,21/07/2007,48,0,0,0,6,9,0,63
China,22/07/2007,23,0,0,0,6,9,0,38
China,23/07/2007,33,0,0,0,0,12,0,45
China,24/07/2007,256,0,1,0,5,7,0,269
China,25/07/2007,54,0,0,0,23,3,0,80
China,26/07/2007,83,0,1,0,27,10,0,121
China,27/07/2007,91,12,-8,0,18,41,0,154
China,28/07/2007,31,0,0,0,6,5,0,42
China,29/07/2007,4,0,-4,0,1,0,0,1
China,30/07/2007,38,0,-8,0,2,5,0,37
China,31/07/2007,49,4,-1,0,22,5,0,79
Egypt,01/07/2007,22,0,0,0,-14,1,0,9
Egypt,02/07/2007,52,4,0,0,19,1,0,76
Egypt,03/07/2007,24,0,0,0,3,0,0,27
Egypt,04/07/2007,7,0,0,0,5,0,0,12
Egypt,05/07/2007,22,0,0,0,11,0,0,33
Egypt,06/07/2007,9,0,0,0,16,1,0,26
Egypt,07/07/2007,7,0,0,0,-6,0,0,1
Egypt,08/07/2007,15,0,0,0,-13,0,0,2
Egypt,09/07/2007,23,0,0,0,-13,0,0,10
Egypt,10/07/2007,42,0,0,0,20,7,0,69
Egypt,11/07/2007,27,0,0,0,18,0,0,45
Egypt,12/07/2007,8,0,0,0,16,0,0,24
Egypt,13/07/2007,8,0,0,0,9,1,0,18
Egypt,14/07/2007,1,0,0,0,9,1,0,11
Egypt,15/07/2007,9,0,0,0,9,0,0,18
Egypt,16/07/2007,4,0,0,0,6,8,0,18
Egypt,17/07/2007,29,0,0,0,5,2,0,36
Egypt,18/07/2007,2,0,0,0,12,6,0,20
Egypt,19/07/2007,27,0,2,0,4,5,0,38
Egypt,20/07/2007,5,0,0,0,7,0,0,12
Egypt,21/07/2007,-1,0,0,0,-4,1,0,-4
Egypt,22/07/2007,25,0,0,0,10,6,0,41
Egypt,23/07/2007,30,0,0,0,4,0,0,34
Egypt,24/07/2007,4,4,0,0,1,0,0,9
Egypt,25/07/2007,12,0,0,0,0,0,0,12
Egypt,26/07/2007,30,0,0,0,-2,4,0,32
Egypt,27/07/2007,24,0,-2,0,0,1,0,23
Egypt,28/07/2007,39,0,2,0,6,2,0,49
Egypt,29/07/2007,3,0,0,0,0,0,0,3
Egypt,30/07/2007,77,6,-1,0,16,10,0,108
Egypt,31/07/2007,9,0,0,0,3,1,0,13
Eritrea,01/07/2007,8,0,0,0,0,0,0,8
Eritrea,02/07/2007,6,0,0,0,12,1,0,19
Eritrea,03/07/2007,0,0,0,0,0,1,0,1
Eritrea,05/07/2007,3,0,0,0,6,0,0,9
Eritrea,06/07/2007,3,0,0,0,-2,0,0,1
Eritrea,07/07/2007,0,0,0,0,0,0,0,0
Eritrea,09/07/2007,0,0,0,0,15,0,0,15
Eritrea,10/07/2007,1,0,0,0,6,0,0,7
Eritrea,11/07/2007,2,0,0,0,18,0,0,20
Eritrea,12/07/2007,6,0,0,0,12,0,0,18
Eritrea,13/07/2007,0,0,0,0,3,0,0,3
Eritrea,14/07/2007,2,0,0,0,0,2,0,4
Eritrea,15/07/2007,3,0,0,0,0,0,0,3
Eritrea,16/07/2007,5,0,0,0,3,2,0,10
Eritrea,17/07/2007,3,0,0,0,0,0,0,3
Eritrea,18/07/2007,14,0,0,0,0,0,0,14
Eritrea,19/07/2007,0,0,0,0,0,0,0,0
Eritrea,20/07/2007,0,0,0,0,0,0,0,0
Eritrea,21/07/2007,2,0,0,0,0,0,0,2
Eritrea,22/07/2007,0,0,0,0,3,0,0,3
Eritrea,24/07/2007,-8,0,0,0,0,0,0,-8
Eritrea,25/07/2007,2,0,0,0,0,0,0,2
Eritrea,26/07/2007,4,0,0,0,0,0,0,4
Eritrea,27/07/2007,12,0,0,0,-2,0,0,10
Eritrea,30/07/2007,11,0,0,0,0,0,0,11
Eritrea,31/07/2007,1,0,0,0,0,0,0,1
Georgia,01/07/2007,1,0,0,0,3,0,0,4
Georgia,02/07/2007,8,0,0,0,12,0,0,20
Georgia,03/07/2007,12,0,0,0,15,0,0,27
Georgia,04/07/2007,0,0,0,0,0,0,0,0
Georgia,05/07/2007,6,0,0,0,0,0,0,6
Georgia,06/07/2007,5,0,0,0,3,0,0,8
Georgia,07/07/2007,1,0,0,0,3,1,0,5
Georgia,08/07/2007,0,0,0,0,0,0,0,0
Georgia,09/07/2007,1,0,0,0,0,0,0,1
Georgia,10/07/2007,1,0,0,0,1,1,0,3
Georgia,11/07/2007,11,0,0,0,-4,0,0,7
Georgia,12/07/2007,3,0,0,0,6,0,0,9
Georgia,13/07/2007,4,0,0,0,3,0,0,7
Georgia,14/07/2007,17,0,0,0,0,1,0,18
Georgia,15/07/2007,6,2,0,0,3,0,0,11
Georgia,16/07/2007,27,0,0,0,3,1,0,31
Georgia,17/07/2007,6,0,0,0,6,1,0,13
Georgia,18/07/2007,1,0,0,0,6,0,0,7
Georgia,19/07/2007,0,0,0,0,1,0,0,1
Georgia,20/07/2007,2,0,0,0,8,0,0,10
Georgia,21/07/2007,4,0,0,0,1,2,0,7
Georgia,24/07/2007,2,0,0,0,3,0,0,5
Georgia,25/07/2007,1,0,0,0,6,2,0,9
Georgia,26/07/2007,2,0,0,0,3,6,0,11
Georgia,27/07/2007,1,0,0,0,-1,0,0,0
Georgia,28/07/2007,0,0,0,0,0,0,0,0
Georgia,29/07/2007,0,0,0,0,0,0,0,0
Georgia,30/07/2007,0,0,0,0,1,3,0,4
Georgia,31/07/2007,3,0,0,0,-2,2,0,3
India,01/07/2007,26,0,0,0,8,5,0,39
India,02/07/2007,26,0,0,0,3,4,0,33
India,03/07/2007,29,0,1,0,29,7,0,66
India,04/07/2007,18,0,0,0,32,3,0,53
India,05/07/2007,18,0,0,0,18,2,0,38
India,06/07/2007,37,0,0,0,16,2,0,55
India,07/07/2007,41,0,1,0,15,3,0,60
India,08/07/2007,10,0,1,0,-2,1,0,10
India,09/07/2007,29,2,1,0,22,2,0,56
India,10/07/2007,19,0,0,0,13,3,0,35
India,11/07/2007,15,0,1,0,27,9,0,52
India,12/07/2007,16,2,0,0,11,2,0,31
India,13/07/2007,24,0,0,0,53,6,0,83
India,14/07/2007,12,0,0,0,26,12,0,50
India,15/07/2007,14,0,0,0,26,3,0,43
India,16/07/2007,15,0,0,0,23,5,0,43
India,17/07/2007,20,0,0,0,16,3,0,39
India,18/07/2007,2,0,0,0,3,0,0,5
India,19/07/2007,25,2,0,0,2,6,0,35
India,20/07/2007,11,0,1,0,22,9,0,43
India,21/07/2007,23,0,0,0,3,0,0,26
India,22/07/2007,29,0,0,0,9,0,0,38
India,23/07/2007,3,0,0,0,9,2,0,14
India,24/07/2007,22,0,2,0,7,1,0,32
India,25/07/2007,19,0,-2,0,9,4,0,30
India,26/07/2007,52,0,0,0,30,15,0,97
India,27/07/2007,58,4,0,0,33,8,0,103
India,28/07/2007,16,2,-2,0,30,3,0,49
India,29/07/2007,16,0,1,0,9,0,0,26
India,30/07/2007,31,0,0,0,9,2,0,42
India,31/07/2007,18,0,1,0,14,2,0,35
Iran,01/07/2007,43,2,0,0,3,4,0,52
Iran,02/07/2007,60,0,-2,0,10,0,0,68
Iran,03/07/2007,31,0,-2,0,27,5,0,61
Iran,04/07/2007,26,0,1,0,40,2,0,69
Iran,05/07/2007,29,0,1,0,12,0,0,42
Iran,06/07/2007,41,0,0,0,6,15,0,62
Iran,07/07/2007,70,0,0,0,37,27,0,134
Iran,08/07/2007,66,0,0,0,15,3,0,84
Iran,09/07/2007,42,0,0,0,13,0,0,55
Iran,10/07/2007,29,2,0,0,35,13,0,79
Iran,11/07/2007,33,0,0,0,15,4,0,52
Iran,12/07/2007,29,0,0,0,12,0,0,41
Iran,13/07/2007,54,0,0,0,6,0,0,60
Iran,14/07/2007,23,0,0,0,4,1,0,28
Iran,15/07/2007,26,0,0,0,6,6,0,38
Iran,16/07/2007,38,2,0,0,37,4,0,81
Iran,17/07/2007,84,0,0,0,34,35,0,153
Iran,18/07/2007,22,0,0,0,4,12,0,38
Iran,19/07/2007,29,0,0,0,27,0,0,56
Iran,20/07/2007,21,0,1,0,13,3,0,38
Iran,21/07/2007,30,0,0,0,9,3,0,42
Iran,22/07/2007,36,0,0,0,20,1,0,57
Iran,23/07/2007,35,0,0,0,18,5,0,58
Iran,24/07/2007,34,0,-4,0,57,4,0,91
Iran,25/07/2007,32,0,0,0,9,13,0,54
Iran,26/07/2007,-4,0,1,0,13,6,0,16
Iran,27/07/2007,31,0,0,0,18,9,0,58
Iran,28/07/2007,7,0,0,0,6,0,0,13
Iran,29/07/2007,19,0,0,0,6,2,0,27
Iran,30/07/2007,36,0,0,0,42,2,0,80
Iran,31/07/2007,31,0,3,0,24,4,0,62
Iraq,01/07/2007,48,0,-2,0,29,20,0,95
Iraq,02/07/2007,173,4,0,0,111,17,0,305
Iraq,03/07/2007,158,4,-4,0,150,49,0,357
Iraq,04/07/2007,77,0,4,0,68,18,0,167
Iraq,05/07/2007,139,4,1,0,58,12,0,214
Iraq,06/07/2007,138,0,-2,0,112,9,0,257
Iraq,07/07/2007,67,4,-4,0,84,9,0,160
Iraq,08/07/2007,137,0,-2,0,49,11,0,195
Iraq,09/07/2007,201,2,-5,0,135,27,0,360
Iraq,10/07/2007,205,8,-10,0,56,21,0,280
Iraq,11/07/2007,204,0,-5,0,111,15,0,325
Iraq,12/07/2007,253,8,5,0,85,31,0,382
Iraq,13/07/2007,207,0,-3,0,85,19,0,308
Iraq,14/07/2007,77,4,-1,0,37,13,0,130
Iraq,15/07/2007,147,0,0,0,26,17,0,190
Iraq,16/07/2007,131,2,-3,0,24,24,0,178
Iraq,17/07/2007,195,0,-12,0,62,13,0,258
Iraq,18/07/2007,119,4,0,0,57,9,0,189
Iraq,19/07/2007,257,0,-2,0,53,17,0,325
Iraq,20/07/2007,188,0,-5,0,32,11,0,226
Iraq,21/07/2007,171,40,3,0,32,6,0,252
Iraq,22/07/2007,133,0,4,0,49,7,0,193
Iraq,23/07/2007,39,0,8,0,0,1,0,48
Iraq,24/07/2007,136,4,7,0,69,35,0,251
Iraq,25/07/2007,81,0,-1,0,63,5,0,148
Iraq,26/07/2007,280,12,1,0,-7,44,0,330
Iraq,27/07/2007,124,2,5,0,6,3,0,140
Iraq,28/07/2007,21,0,0,0,6,8,0,35
Iraq,29/07/2007,39,4,-2,0,14,5,0,60
Iraq,30/07/2007,143,2,-3,0,32,9,0,183
Iraq,31/07/2007,173,4,-2,0,6,13,0,194
Morocco,01/07/2007,0,0,0,0,0,0,0,0
Morocco,02/07/2007,21,0,-2,0,21,6,0,46
Morocco,03/07/2007,7,0,0,0,2,2,0,11
Morocco,04/07/2007,8,0,0,0,0,3,0,11
Morocco,05/07/2007,16,0,0,0,24,0,0,40
Morocco,06/07/2007,9,0,0,0,15,0,0,24
Morocco,07/07/2007,0,2,0,0,0,0,0,2
Morocco,08/07/2007,0,0,0,0,0,0,0,0
Morocco,09/07/2007,0,0,0,0,-2,0,0,-2
Morocco,10/07/2007,10,0,0,0,0,0,0,10
Morocco,11/07/2007,6,0,-2,0,6,2,0,12
Morocco,12/07/2007,3,0,0,0,3,0,0,6
Morocco,13/07/2007,5,0,0,0,15,0,0,20
Morocco,14/07/2007,11,0,0,0,4,0,0,15
Morocco,15/07/2007,24,0,0,0,0,0,0,24
Morocco,16/07/2007,0,0,0,0,0,0,0,0
Morocco,17/07/2007,0,0,1,0,-2,0,0,-1
Morocco,18/07/2007,10,0,0,0,9,1,0,20
Morocco,19/07/2007,0,0,0,0,12,0,0,12
Morocco,20/07/2007,2,0,0,0,0,0,0,2
Morocco,21/07/2007,6,0,0,0,45,0,0,51
Morocco,22/07/2007,5,0,0,0,30,0,0,35
Morocco,23/07/2007,2,0,0,0,0,0,0,2
Morocco,24/07/2007,4,0,0,0,6,0,0,10
Morocco,25/07/2007,13,0,0,0,8,0,0,21
Morocco,26/07/2007,0,0,0,0,9,0,0,9
Morocco,27/07/2007,6,0,0,0,0,0,0,6
Morocco,28/07/2007,3,0,0,0,0,0,0,3
Morocco,29/07/2007,0,0,0,0,0,0,0,0
Morocco,30/07/2007,0,0,0,0,12,0,0,12
Morocco,31/07/2007,0,0,0,0,6,0,0,6
Nigeria,01/07/2007,2,0,1,0,0,0,0,3
Nigeria,02/07/2007,10,0,0,0,3,0,0,13
Nigeria,03/07/2007,6,0,0,0,-4,4,0,6
Nigeria,04/07/2007,10,0,0,0,9,0,0,19
Nigeria,05/07/2007,1,0,0,0,27,0,0,28
Nigeria,06/07/2007,15,0,0,0,7,2,0,24
Nigeria,07/07/2007,8,0,0,0,2,0,0,10
Nigeria,08/07/2007,0,0,0,0,8,0,0,8
Nigeria,09/07/2007,6,0,0,0,18,1,0,25
Nigeria,10/07/2007,9,0,0,0,12,0,0,21
Nigeria,11/07/2007,10,0,0,0,9,0,0,19
Nigeria,12/07/2007,3,6,-4,0,6,0,0,11
Nigeria,13/07/2007,4,4,-2,0,21,0,0,27
Nigeria,14/07/2007,5,0,0,0,12,0,0,17
Nigeria,15/07/2007,1,0,1,0,3,0,0,5
Nigeria,16/07/2007,5,0,-1,0,0,5,0,9
Nigeria,17/07/2007,8,0,0,0,1,3,0,12
Nigeria,18/07/2007,0,0,0,0,0,0,0,0
Nigeria,19/07/2007,7,0,0,0,6,0,0,13
Nigeria,20/07/2007,24,0,0,0,9,8,0,41
Nigeria,21/07/2007,12,0,-2,0,0,0,0,10
Nigeria,22/07/2007,8,0,0,0,-2,0,0,6
Nigeria,23/07/2007,0,0,0,0,6,0,0,6
Nigeria,24/07/2007,33,0,0,0,21,0,0,54
Nigeria,25/07/2007,19,0,0,0,9,7,0,35
Nigeria,26/07/2007,2,0,0,0,13,0,0,15
Nigeria,27/07/2007,6,0,0,0,-2,0,0,4
Nigeria,28/07/2007,5,0,0,0,0,0,0,5
Nigeria,29/07/2007,7,0,0,0,3,0,0,10
Nigeria,30/07/2007,10,0,0,0,0,0,0,10
Nigeria,31/07/2007,6,0,0,0,-8,0,0,-2
Pakistan,01/07/2007,15,0,0,0,15,0,0,30
Pakistan,02/07/2007,26,0,-3,0,28,0,0,51
Pakistan,03/07/2007,37,0,1,0,16,2,0,56
Pakistan,04/07/2007,28,10,0,0,16,1,0,55
Pakistan,05/07/2007,109,0,0,0,51,6,0,166
Pakistan,06/07/2007,57,0,0,0,21,3,0,81
Pakistan,07/07/2007,63,0,3,0,-13,4,0,57
Pakistan,08/07/2007,20,0,4,0,3,2,0,29
Pakistan,09/07/2007,71,0,2,0,29,14,0,116
Pakistan,10/07/2007,165,0,0,0,2,23,0,190
Pakistan,11/07/2007,62,0,1,0,45,15,0,123
Pakistan,12/07/2007,52,0,0,0,9,1,0,62
Pakistan,13/07/2007,62,0,0,0,41,9,0,112
Pakistan,14/07/2007,73,0,0,0,18,12,0,103
Pakistan,15/07/2007,45,0,0,0,5,1,0,51
Pakistan,16/07/2007,36,0,0,0,21,0,0,57
Pakistan,17/07/2007,64,0,0,0,1,2,0,67
Pakistan,18/07/2007,7,0,0,0,9,3,0,19
Pakistan,19/07/2007,77,0,2,0,24,8,0,111
Pakistan,20/07/2007,26,0,0,0,18,0,0,44
Pakistan,21/07/2007,67,0,-2,0,18,1,0,84
Pakistan,22/07/2007,26,0,-1,0,29,1,0,55
Pakistan,23/07/2007,30,0,0,0,6,10,0,46
Pakistan,24/07/2007,16,0,0,0,30,0,0,46
Pakistan,25/07/2007,55,0,1,0,12,0,0,68
Pakistan,26/07/2007,30,0,2,0,14,0,0,46
Pakistan,27/07/2007,62,0,0,0,27,11,0,100
Pakistan,28/07/2007,66,0,0,0,9,6,0,81
Pakistan,29/07/2007,23,0,0,0,-2,0,0,21
Pakistan,30/07/2007,17,0,0,0,0,0,0,17
Pakistan,31/07/2007,26,0,0,0,12,6,0,44
Sierra Leone,02/07/2007,2,0,0,0,6,0,0,8
Sierra Leone,03/07/2007,6,0,0,0,9,3,0,18
Sierra Leone,04/07/2007,3,0,0,0,-3,0,0,0
Sierra Leone,05/07/2007,0,0,0,0,0,0,0,0
Sierra Leone,06/07/2007,3,0,0,0,0,0,0,3
Sierra Leone,08/07/2007,0,0,0,0,0,0,0,0
Sierra Leone,09/07/2007,17,0,0,0,0,0,0,17
Sierra Leone,10/07/2007,0,0,0,0,6,0,0,6
Sierra Leone,11/07/2007,3,0,0,0,0,0,0,3
Sierra Leone,12/07/2007,0,0,0,0,3,0,0,3
Sierra Leone,13/07/2007,26,0,0,0,6,0,0,32
Sierra Leone,14/07/2007,0,0,0,0,9,0,0,9
Sierra Leone,15/07/2007,0,0,0,0,6,0,0,6
Sierra Leone,16/07/2007,0,0,0,0,-3,0,0,-3
Sierra Leone,17/07/2007,0,0,0,0,0,0,0,0
Sierra Leone,18/07/2007,0,0,0,0,0,0,0,0
Sierra Leone,19/07/2007,0,0,0,0,9,0,0,9
Sierra Leone,20/07/2007,10,0,0,0,3,0,0,13
Sierra Leone,21/07/2007,1,0,0,0,3,0,0,4
Sierra Leone,22/07/2007,0,0,0,0,0,0,0,0
Sierra Leone,23/07/2007,4,0,0,0,0,0,0,4
Sierra Leone,24/07/2007,0,2,0,0,0,0,0,2
Sierra Leone,25/07/2007,0,0,0,0,0,0,0,0
Sierra Leone,26/07/2007,0,0,0,0,6,1,0,7
Sierra Leone,27/07/2007,0,2,0,0,0,0,0,2
Sierra Leone,28/07/2007,0,0,0,0,0,0,0,0
Sierra Leone,29/07/2007,0,0,0,0,0,0,0,0
Sierra Leone,30/07/2007,15,2,0,0,21,3,0,41
Sierra Leone,31/07/2007,3,0,0,0,9,0,0,12
Somalia,01/07/2007,0,0,0,0,0,0,0,0
Somalia,02/07/2007,-1,0,0,0,0,0,0,-1
Somalia,03/07/2007,21,14,0,0,0,0,0,35
Somalia,04/07/2007,7,0,0,0,24,0,0,31
Somalia,05/07/2007,0,0,0,0,0,0,0,0
Somalia,06/07/2007,0,0,2,0,0,0,0,2
Somalia,07/07/2007,2,0,0,0,6,0,0,8
Somalia,08/07/2007,1,0,0,0,0,0,0,1
Somalia,09/07/2007,2,0,0,0,27,0,0,29
Somalia,10/07/2007,28,0,0,0,10,0,0,38
Somalia,11/07/2007,7,0,0,0,3,0,0,10
Somalia,12/07/2007,17,0,0,0,7,0,0,24
Somalia,13/07/2007,10,0,0,0,0,0,0,10
Somalia,14/07/2007,3,0,0,0,0,0,0,3
Somalia,15/07/2007,3,0,0,0,0,0,0,3
Somalia,16/07/2007,3,0,0,0,0,0,0,3
Somalia,17/07/2007,-1,0,0,0,0,0,0,-1
Somalia,18/07/2007,1,0,0,0,0,0,0,1
Somalia,19/07/2007,9,0,0,0,0,0,0,9
Somalia,20/07/2007,29,0,0,0,30,2,0,61
Somalia,21/07/2007,3,0,0,0,12,0,0,15
Somalia,22/07/2007,3,0,0,0,15,1,0,19
Somalia,23/07/2007,0,0,0,0,6,1,0,7
Somalia,24/07/2007,10,0,0,0,0,0,0,10
Somalia,25/07/2007,11,0,0,0,13,0,0,24
Somalia,26/07/2007,21,0,0,0,6,0,0,27
Somalia,27/07/2007,53,0,0,0,0,0,0,53
Somalia,28/07/2007,5,0,0,0,0,0,0,5
Somalia,29/07/2007,0,0,0,0,0,0,0,0
Somalia,30/07/2007,16,0,0,0,3,0,0,19
Somalia,31/07/2007,5,0,0,0,0,0,0,5
Syria,01/07/2007,2,0,0,0,9,0,0,11
Syria,02/07/2007,53,0,0,0,4,0,0,57
Syria,03/07/2007,6,0,0,0,3,0,0,9
Syria,04/07/2007,8,0,0,0,-5,0,0,3
Syria,05/07/2007,15,0,0,0,0,9,0,24
Syria,06/07/2007,8,0,-8,0,8,0,0,8
Syria,07/07/2007,25,0,0,0,3,9,0,37
Syria,08/07/2007,8,0,-2,0,0,0,0,6
Syria,09/07/2007,81,0,2,0,3,1,0,87
Syria,10/07/2007,42,0,-3,0,3,0,0,42
Syria,11/07/2007,61,0,0,0,1,4,0,66
Syria,12/07/2007,42,0,-2,0,3,2,0,45
Syria,13/07/2007,61,0,0,0,9,2,0,72
Syria,14/07/2007,43,0,0,0,3,0,0,46
Syria,15/07/2007,23,0,0,0,33,2,0,58
Syria,16/07/2007,9,6,0,0,8,0,0,23
Syria,17/07/2007,18,4,0,0,-1,2,0,23
Syria,18/07/2007,17,0,0,0,3,0,0,20
Syria,19/07/2007,26,0,0,0,12,0,0,38
Syria,20/07/2007,25,2,0,0,0,0,0,27
Syria,21/07/2007,8,0,0,0,3,0,0,11
Syria,22/07/2007,-2,0,3,0,3,0,0,4
Syria,23/07/2007,6,0,0,0,0,0,0,6
Syria,24/07/2007,19,0,0,0,0,0,0,19
Syria,25/07/2007,9,0,0,0,15,0,0,24
Syria,26/07/2007,3,2,1,0,15,5,0,26
Syria,27/07/2007,10,0,0,0,0,2,0,12
Syria,28/07/2007,20,0,-4,0,0,16,0,32
Syria,29/07/2007,27,4,0,0,0,4,0,35
Syria,30/07/2007,49,0,-2,0,3,0,0,50
Syria,31/07/2007,21,0,0,0,0,0,0,21
Yemen,01/07/2007,6,0,0,0,0,5,0,11
Yemen,02/07/2007,21,0,0,0,3,24,0,48
Yemen,03/07/2007,23,0,0,0,1,15,0,39
Yemen,04/07/2007,1,0,0,0,6,3,0,10
Yemen,05/07/2007,-3,0,2,0,18,0,0,17
Yemen,06/07/2007,5,0,0,0,3,2,0,10
Yemen,07/07/2007,3,0,0,0,6,1,0,10
Yemen,08/07/2007,0,0,0,0,0,0,0,0
Yemen,09/07/2007,2,0,0,0,0,0,0,2
Yemen,10/07/2007,7,0,0,0,1,0,0,8
Yemen,12/07/2007,6,0,0,0,0,0,0,6
Yemen,15/07/2007,3,0,0,0,0,0,0,3
Yemen,16/07/2007,0,0,0,0,0,0,0,0
Yemen,17/07/2007,0,0,0,0,9,0,0,9
Yemen,18/07/2007,2,0,0,0,0,0,0,2
Yemen,19/07/2007,0,0,0,0,0,0,0,0
Yemen,20/07/2007,3,0,0,0,0,0,0,3
Yemen,21/07/2007,10,0,0,0,2,0,0,12
Yemen,22/07/2007,0,0,0,0,0,0,0,0
Yemen,23/07/2007,-4,0,0,0,0,0,0,-4
Yemen,24/07/2007,8,0,0,0,-2,0,0,6
Yemen,25/07/2007,5,0,0,0,0,2,0,7
Yemen,26/07/2007,0,0,0,0,0,0,0,0
Yemen,28/07/2007,0,0,0,0,0,0,0,0
Yemen,30/07/2007,2,0,0,0,0,0,0,2
Yemen,31/07/2007,0,0,0,0,0,0,0,0
Afghanistan,01/06/2007,93,2,0,0,23,0,0,118
Afghanistan,02/06/2007,51,0,0,0,18,5,0,74
Afghanistan,03/06/2007,37,0,0,0,9,4,0,50
Afghanistan,04/06/2007,129,0,0,0,110,10,0,249
Afghanistan,05/06/2007,176,0,0,0,138,6,0,320
Afghanistan,06/06/2007,116,0,-1,0,19,10,0,144
Afghanistan,07/06/2007,72,0,-4,0,45,14,0,127
Afghanistan,08/06/2007,47,0,1,0,17,5,0,70
Afghanistan,09/06/2007,57,0,0,0,46,0,0,103
Afghanistan,10/06/2007,84,0,0,0,15,6,0,105
Afghanistan,11/06/2007,78,0,0,0,17,5,0,100
Afghanistan,12/06/2007,126,4,0,0,54,14,0,198
Afghanistan,13/06/2007,152,2,-1,0,51,4,0,208
Afghanistan,14/06/2007,133,0,0,0,32,13,0,178
Afghanistan,15/06/2007,87,0,0,0,7,5,0,99
Afghanistan,16/06/2007,67,0,-2,0,7,11,0,83
Afghanistan,17/06/2007,91,0,0,0,-2,6,0,95
Afghanistan,18/06/2007,44,0,-2,0,38,4,0,84
Afghanistan,19/06/2007,164,0,0,0,20,20,0,204
Afghanistan,20/06/2007,172,0,0,0,59,17,0,248
Afghanistan,21/06/2007,150,2,0,0,4,5,0,161
Afghanistan,22/06/2007,134,0,-2,0,51,11,0,194
Afghanistan,23/06/2007,203,0,-4,0,19,31,0,249
Afghanistan,24/06/2007,84,0,-2,0,9,2,0,93
Afghanistan,25/06/2007,138,0,0,0,1,8,0,147
Afghanistan,26/06/2007,124,0,1,0,19,2,0,146
Afghanistan,27/06/2007,106,0,-2,0,20,4,0,128
Afghanistan,28/06/2007,52,0,-2,0,23,10,0,83
Afghanistan,29/06/2007,110,2,0,0,49,6,0,167
Afghanistan,30/06/2007,176,0,0,0,6,13,0,195
Albania,01/06/2007,22,0,-2,0,15,0,0,35
Albania,02/06/2007,3,0,1,0,6,1,0,11
Albania,03/06/2007,2,0,0,0,0,0,0,2
Albania,04/06/2007,2,0,0,0,0,1,0,3
Albania,05/06/2007,18,0,-7,0,4,6,0,21
Albania,06/06/2007,5,0,0,0,1,0,0,6
Albania,07/06/2007,7,0,0,0,6,5,0,18
Albania,08/06/2007,24,0,-1,0,6,1,0,30
Albania,09/06/2007,17,0,0,0,8,0,0,25
Albania,10/06/2007,5,0,-1,0,-2,3,0,5
Albania,11/06/2007,13,0,-3,0,1,5,0,16
Albania,12/06/2007,11,0,-3,0,1,8,0,17
Albania,13/06/2007,24,0,0,0,-1,0,0,23
Albania,14/06/2007,0,0,0,0,3,1,0,4
Albania,15/06/2007,4,0,0,0,0,0,0,4
Albania,16/06/2007,0,0,0,0,0,0,0,0
Albania,17/06/2007,12,0,0,0,30,0,0,42
Albania,18/06/2007,28,0,-7,0,5,0,0,26
Albania,19/06/2007,9,0,0,0,10,3,0,22
Albania,20/06/2007,17,0,0,0,30,7,0,54
Albania,21/06/2007,28,0,0,0,33,7,0,68
Albania,22/06/2007,13,0,0,0,11,0,0,24
Albania,23/06/2007,0,0,0,0,0,0,0,0
Albania,24/06/2007,3,0,-2,0,0,0,0,1
Albania,25/06/2007,17,0,-2,0,-2,0,0,13
Albania,26/06/2007,4,0,0,0,6,0,0,10
Albania,27/06/2007,3,0,-7,0,3,0,0,-1
Albania,28/06/2007,14,4,0,0,6,0,0,24
Albania,29/06/2007,7,0,-2,0,0,0,0,5
Albania,30/06/2007,10,0,-8,0,2,4,0,8
Algeria,01/06/2007,20,0,-2,0,0,0,0,18
Algeria,02/06/2007,6,0,-2,0,0,1,0,5
Algeria,03/06/2007,-2,0,0,0,0,3,0,1
Algeria,04/06/2007,0,0,0,0,0,0,0,0
Algeria,05/06/2007,4,0,0,0,0,0,0,4
Algeria,06/06/2007,2,0,-1,0,-2,0,0,-1
Algeria,07/06/2007,7,0,0,0,7,0,0,14
Algeria,08/06/2007,12,0,0,0,18,0,0,30
Algeria,09/06/2007,0,0,0,0,0,1,0,1
Algeria,10/06/2007,1,0,0,0,0,0,0,1
Algeria,11/06/2007,0,0,0,0,6,0,0,6
Algeria,12/06/2007,0,0,0,0,0,0,0,0
Algeria,13/06/2007,1,0,0,0,12,0,0,13
Algeria,14/06/2007,2,0,0,0,0,6,0,8
Algeria,15/06/2007,0,0,0,0,0,1,0,1
Algeria,16/06/2007,0,0,0,0,0,0,0,0
Algeria,17/06/2007,1,0,0,0,3,0,0,4
Algeria,18/06/2007,0,0,3,0,8,0,0,11
Algeria,19/06/2007,5,0,-2,0,0,3,0,6
Algeria,20/06/2007,3,0,-5,0,9,0,0,7
Algeria,21/06/2007,3,0,0,0,-4,0,0,-1
Algeria,22/06/2007,2,0,0,0,0,0,0,2
Algeria,23/06/2007,3,0,0,0,0,0,0,3
Algeria,24/06/2007,0,0,0,0,0,0,0,0
Algeria,25/06/2007,0,0,0,0,3,0,0,3
Algeria,26/06/2007,14,0,0,0,3,10,0,27
Algeria,27/06/2007,14,0,0,0,18,0,0,32
Algeria,28/06/2007,6,0,0,0,3,0,0,9
Algeria,29/06/2007,4,0,0,0,0,0,0,4
Algeria,30/06/2007,0,0,0,0,10,0,0,10
Bangladesh,01/06/2007,0,0,0,0,9,0,0,9
Bangladesh,02/06/2007,14,0,0,0,39,0,0,53
Bangladesh,03/06/2007,3,0,-4,0,-2,0,0,-3
Bangladesh,04/06/2007,0,0,-2,0,9,0,0,7
Bangladesh,05/06/2007,7,0,-2,0,0,0,0,5
Bangladesh,06/06/2007,1,0,0,0,3,0,0,4
Bangladesh,07/06/2007,8,0,-4,0,19,0,0,23
Bangladesh,08/06/2007,2,0,0,0,15,2,0,19
Bangladesh,09/06/2007,-1,0,0,0,2,0,0,1
Bangladesh,10/06/2007,2,0,0,0,6,0,0,8
Bangladesh,11/06/2007,-5,0,-2,0,6,2,0,1
Bangladesh,12/06/2007,7,0,0,0,7,3,0,17
Bangladesh,13/06/2007,17,0,0,0,9,1,0,27
Bangladesh,14/06/2007,9,0,-2,0,12,0,0,19
Bangladesh,15/06/2007,2,0,0,0,16,0,0,18
Bangladesh,16/06/2007,5,0,0,0,9,0,0,14
Bangladesh,17/06/2007,6,0,0,0,4,2,0,12
Bangladesh,18/06/2007,11,0,0,0,0,0,0,11
Bangladesh,19/06/2007,0,0,1,0,-2,0,0,-1
Bangladesh,20/06/2007,28,0,0,0,10,1,0,39
Bangladesh,21/06/2007,3,0,0,0,15,0,0,18
Bangladesh,22/06/2007,1,0,0,0,6,0,0,7
Bangladesh,23/06/2007,4,0,0,0,9,3,0,16
Bangladesh,24/06/2007,4,0,0,0,6,0,0,10
Bangladesh,25/06/2007,-2,0,-1,0,12,0,0,9
Bangladesh,26/06/2007,8,0,-6,0,9,0,0,11
Bangladesh,27/06/2007,26,0,-3,0,-2,0,0,21
Bangladesh,28/06/2007,16,0,0,0,7,1,0,24
Bangladesh,29/06/2007,5,0,0,0,3,0,0,8
Bangladesh,30/06/2007,1,0,-16,0,0,0,0,-15
Cameroon,01/06/2007,0,0,0,0,0,0,0,0
Cameroon,03/06/2007,1,0,0,0,4,0,0,5
Cameroon,04/06/2007,9,0,0,0,12,0,0,21
Cameroon,05/06/2007,5,0,0,0,0,0,0,5
Cameroon,06/06/2007,2,0,0,0,0,1,0,3
Cameroon,07/06/2007,0,0,0,0,0,0,0,0
Cameroon,08/06/2007,0,0,0,0,0,0,0,0
Cameroon,09/06/2007,3,0,0,0,0,0,0,3
Cameroon,11/06/2007,0,0,0,0,0,0,0,0
Cameroon,12/06/2007,1,0,0,0,0,0,0,1
Cameroon,13/06/2007,4,0,0,0,0,0,0,4
Cameroon,14/06/2007,0,0,0,0,6,0,0,6
Cameroon,18/06/2007,1,0,0,0,0,0,0,1
Cameroon,19/06/2007,0,0,0,0,0,0,0,0
Cameroon,20/06/2007,0,0,0,0,0,0,0,0
Cameroon,21/06/2007,0,0,0,0,0,0,0,0
Cameroon,22/06/2007,0,0,0,0,0,0,0,0
Cameroon,23/06/2007,3,0,0,0,0,0,0,3
Cameroon,25/06/2007,-2,0,0,0,0,0,0,-2
Cameroon,26/06/2007,2,0,0,0,0,0,0,2
Cameroon,27/06/2007,0,0,0,0,0,0,0,0
Cameroon,28/06/2007,0,0,0,0,9,0,0,9
Cameroon,29/06/2007,0,0,0,0,6,0,0,6
China,01/06/2007,42,0,0,0,24,7,0,73
China,02/06/2007,31,2,0,0,15,3,0,51
China,03/06/2007,46,4,0,0,29,16,0,95
China,04/06/2007,79,4,2,0,73,8,0,166
China,05/06/2007,40,8,-1,0,-1,6,0,52
China,06/06/2007,86,2,-1,0,24,3,0,114
China,07/06/2007,53,4,-13,0,0,3,0,47
China,08/06/2007,85,2,-3,0,28,6,0,118
China,09/06/2007,12,0,-1,0,40,3,0,54
China,10/06/2007,12,0,-1,0,-2,2,0,11
China,11/06/2007,62,0,0,0,37,7,0,106
China,12/06/2007,58,0,1,0,26,8,0,93
China,13/06/2007,51,0,-6,0,25,10,0,80
China,14/06/2007,93,0,0,0,46,1,0,140
China,15/06/2007,26,0,1,0,20,3,0,50
China,16/06/2007,28,0,0,0,-2,2,0,28
China,17/06/2007,18,0,1,0,9,3,0,31
China,18/06/2007,41,0,-3,0,2,4,0,44
China,19/06/2007,54,4,2,0,37,9,0,106
China,20/06/2007,26,0,0,0,29,7,0,62
China,21/06/2007,61,0,-1,0,22,5,0,87
China,22/06/2007,43,6,1,0,45,7,0,102
China,23/06/2007,51,8,0,0,3,4,0,66
China,24/06/2007,30,8,0,0,40,10,0,88
China,25/06/2007,67,8,-2,0,29,7,0,109
China,26/06/2007,28,4,-6,0,5,5,0,36
China,27/06/2007,47,0,2,0,28,8,0,85
China,28/06/2007,63,0,-5,0,27,7,0,92
China,29/06/2007,69,0,0,0,16,4,0,89
China,30/06/2007,35,4,0,0,48,5,0,92
Egypt,01/06/2007,19,0,0,0,3,3,0,25
Egypt,02/06/2007,3,0,0,0,-1,2,0,4
Egypt,03/06/2007,18,0,0,0,9,0,0,27
Egypt,04/06/2007,32,0,0,0,35,1,0,68
Egypt,05/06/2007,35,0,0,0,-4,0,0,31
Egypt,06/06/2007,7,0,0,0,31,0,0,38
Egypt,07/06/2007,21,0,0,0,18,11,0,50
Egypt,08/06/2007,53,0,3,0,27,1,0,84
Egypt,09/06/2007,48,0,0,0,26,3,0,77
Egypt,10/06/2007,59,0,0,0,2,7,0,68
Egypt,11/06/2007,66,0,1,0,15,9,0,91
Egypt,12/06/2007,57,0,0,0,6,12,0,75
Egypt,13/06/2007,127,0,-1,0,5,16,0,147
Egypt,14/06/2007,120,2,0,0,9,8,0,139
Egypt,15/06/2007,80,4,0,0,29,10,0,123
Egypt,16/06/2007,32,0,-1,0,2,6,0,39
Egypt,17/06/2007,21,0,0,0,4,0,0,25
Egypt,18/06/2007,51,0,0,0,0,1,0,52
Egypt,19/06/2007,48,0,0,0,0,0,0,48
Egypt,20/06/2007,24,0,0,0,0,3,0,27
Egypt,21/06/2007,41,0,0,0,20,4,0,65
Egypt,22/06/2007,15,0,3,0,6,2,0,26
Egypt,23/06/2007,50,0,0,0,-6,2,0,46
Egypt,24/06/2007,70,0,0,0,6,0,0,76
Egypt,25/06/2007,57,2,0,0,-10,0,0,49
Egypt,26/06/2007,30,2,0,0,-47,1,0,-14
Egypt,27/06/2007,22,0,1,0,6,15,0,44
Egypt,28/06/2007,44,0,0,0,15,10,0,69
Egypt,29/06/2007,27,0,0,0,16,4,0,47
Egypt,30/06/2007,42,0,0,0,27,0,0,69
Eritrea,01/06/2007,2,0,0,0,0,0,0,2
Eritrea,02/06/2007,3,0,0,0,0,0,0,3
Eritrea,03/06/2007,5,0,0,0,0,0,0,5
Eritrea,04/06/2007,0,0,0,0,0,0,0,0
Eritrea,05/06/2007,0,0,0,0,0,0,0,0
Eritrea,06/06/2007,0,0,0,0,0,0,0,0
Eritrea,08/06/2007,0,0,0,0,9,0,0,9
Eritrea,09/06/2007,0,0,0,0,0,0,0,0
Eritrea,10/06/2007,0,0,0,0,0,0,0,0
Eritrea,11/06/2007,4,0,0,0,3,0,0,7
Eritrea,12/06/2007,0,0,0,0,0,0,0,0
Eritrea,14/06/2007,4,0,0,0,6,1,0,11
Eritrea,15/06/2007,0,0,0,0,0,0,0,0
Eritrea,16/06/2007,0,0,0,0,0,0,0,0
Eritrea,17/06/2007,0,0,0,0,0,2,0,2
Eritrea,18/06/2007,0,0,0,0,0,0,0,0
Eritrea,19/06/2007,0,0,0,0,0,0,0,0
Eritrea,20/06/2007,0,0,0,0,0,0,0,0
Eritrea,21/06/2007,0,0,0,0,0,0,0,0
Eritrea,23/06/2007,0,0,0,0,0,1,0,1
Eritrea,24/06/2007,0,0,0,0,0,0,0,0
Eritrea,25/06/2007,0,0,0,0,0,0,0,0
Eritrea,26/06/2007,0,0,0,0,6,0,0,6
Eritrea,27/06/2007,0,0,0,0,3,0,0,3
Eritrea,28/06/2007,17,0,0,0,18,3,0,38
Eritrea,29/06/2007,2,0,0,0,0,0,0,2
Eritrea,30/06/2007,8,0,0,0,0,0,0,8
Georgia,01/06/2007,8,0,0,0,2,3,0,13
Georgia,02/06/2007,4,0,0,0,3,0,0,7
Georgia,03/06/2007,0,0,0,0,0,0,0,0
Georgia,04/06/2007,3,2,0,0,0,0,0,5
Georgia,05/06/2007,12,0,0,0,0,0,0,12
Georgia,06/06/2007,3,0,0,0,12,4,0,19
Georgia,07/06/2007,2,0,0,0,6,0,0,8
Georgia,08/06/2007,15,0,0,0,0,2,0,17
Georgia,09/06/2007,4,0,0,0,0,0,0,4
Georgia,10/06/2007,0,0,0,0,0,2,0,2
Georgia,11/06/2007,12,0,0,0,0,0,0,12
Georgia,12/06/2007,10,0,0,0,-5,1,0,6
Georgia,13/06/2007,2,0,-2,0,7,0,0,7
Georgia,14/06/2007,6,0,0,0,1,0,0,7
Georgia,15/06/2007,4,0,0,0,-2,0,0,2
Georgia,16/06/2007,0,0,0,0,0,0,0,0
Georgia,17/06/2007,2,0,0,0,0,0,0,2
Georgia,18/06/2007,8,2,0,0,0,0,0,10
Georgia,19/06/2007,3,0,0,0,-2,0,0,1
Georgia,20/06/2007,2,0,0,0,0,4,0,6
Georgia,21/06/2007,13,0,0,0,6,0,0,19
Georgia,22/06/2007,4,0,0,0,-1,0,0,3
Georgia,23/06/2007,0,0,0,0,0,0,0,0
Georgia,24/06/2007,0,0,0,0,0,0,0,0
Georgia,25/06/2007,-2,0,0,0,0,1,0,-1
Georgia,26/06/2007,7,0,0,0,15,0,0,22
Georgia,27/06/2007,9,0,0,0,21,2,0,32
Georgia,28/06/2007,6,0,0,0,3,1,0,10
Georgia,29/06/2007,5,0,0,0,0,1,0,6
Georgia,30/06/2007,3,0,0,0,0,0,0,3
India,01/06/2007,22,0,-2,0,11,11,0,42
India,02/06/2007,16,0,0,0,7,5,0,28
India,03/06/2007,14,0,0,0,0,0,0,14
India,04/06/2007,14,0,0,0,9,0,0,23
India,05/06/2007,17,0,0,0,-2,3,0,18
India,06/06/2007,12,0,-2,0,12,4,0,26
India,07/06/2007,19,0,0,0,14,1,0,34
India,08/06/2007,23,0,1,0,27,3,0,54
India,09/06/2007,24,0,-2,0,3,4,0,29
India,10/06/2007,17,0,1,0,6,1,0,25
India,11/06/2007,17,4,0,0,4,2,0,27
India,12/06/2007,20,0,0,0,14,3,0,37
India,13/06/2007,60,0,0,0,12,0,0,72
India,14/06/2007,56,2,2,0,13,4,0,77
India,15/06/2007,18,0,1,0,13,2,0,34
India,16/06/2007,7,0,2,0,11,1,0,21
India,17/06/2007,16,0,0,0,0,8,0,24
India,18/06/2007,54,4,0,0,1,3,0,62
India,19/06/2007,16,4,-1,0,3,0,0,22
India,20/06/2007,46,0,4,0,14,9,0,73
India,21/06/2007,25,4,-1,0,1,4,0,33
India,22/06/2007,34,2,2,0,13,8,0,59
India,23/06/2007,39,0,0,0,-2,4,0,41
India,24/06/2007,11,0,-3,0,2,0,0,10
India,25/06/2007,21,0,0,0,1,6,0,28
India,26/06/2007,20,6,-2,0,15,14,0,53
India,27/06/2007,42,0,0,0,19,5,0,66
India,28/06/2007,11,6,-8,0,12,2,0,23
India,29/06/2007,10,0,0,0,1,3,0,14
India,30/06/2007,15,0,0,0,1,2,0,18
Iran,01/06/2007,46,0,2,0,2,4,0,54
Iran,02/06/2007,88,0,0,0,39,5,0,132
Iran,03/06/2007,51,0,1,0,38,1,0,91
Iran,04/06/2007,95,0,0,0,35,3,0,133
Iran,05/06/2007,89,0,0,0,95,11,0,195
Iran,06/06/2007,96,0,0,0,67,6,0,169
Iran,07/06/2007,66,0,0,0,21,3,0,90
Iran,08/06/2007,35,0,0,0,25,1,0,61
Iran,09/06/2007,55,0,2,0,-2,6,0,61
Iran,10/06/2007,62,0,0,0,33,10,0,105
Iran,11/06/2007,85,0,0,0,5,6,0,96
Iran,12/06/2007,89,0,1,0,25,0,0,115
Iran,13/06/2007,44,0,1,0,27,61,0,133
Iran,14/06/2007,61,2,0,0,30,6,0,99
Iran,15/06/2007,62,0,0,0,23,9,0,94
Iran,16/06/2007,43,0,2,0,12,0,0,57
Iran,17/06/2007,50,0,2,0,14,3,0,69
Iran,18/06/2007,86,0,0,0,15,10,0,111
Iran,19/06/2007,108,0,1,0,23,8,0,140
Iran,20/06/2007,61,0,-2,0,31,5,0,95
Iran,21/06/2007,82,0,4,0,45,3,0,134
Iran,22/06/2007,46,0,3,0,13,6,0,68
Iran,23/06/2007,29,0,0,0,29,4,0,62
Iran,24/06/2007,39,0,0,0,45,1,0,85
Iran,25/06/2007,67,0,-8,0,-6,5,0,58
Iran,26/06/2007,68,0,-3,0,15,1,0,81
Iran,27/06/2007,52,0,-1,0,20,6,0,77
Iran,28/06/2007,44,0,-3,0,6,6,0,53
Iran,29/06/2007,55,0,0,0,0,4,0,59
Iran,30/06/2007,59,0,0,0,12,9,0,80
Iraq,01/06/2007,115,0,-2,0,15,13,0,141
Iraq,02/06/2007,128,0,-1,0,13,10,0,150
Iraq,03/06/2007,136,0,0,0,16,4,0,156
Iraq,04/06/2007,225,0,3,0,65,18,0,311
Iraq,05/06/2007,127,4,1,0,150,19,0,301
Iraq,06/06/2007,229,4,-1,0,96,9,0,337
Iraq,07/06/2007,155,0,4,0,80,3,0,242
Iraq,08/06/2007,228,0,0,0,54,26,0,308
Iraq,09/06/2007,180,0,-9,0,71,23,0,265
Iraq,10/06/2007,206,0,0,0,34,28,0,268
Iraq,11/06/2007,242,2,-13,0,43,29,0,303
Iraq,12/06/2007,213,2,-3,0,41,24,0,277
Iraq,13/06/2007,188,0,-4,0,91,18,0,293
Iraq,14/06/2007,233,0,8,0,129,16,0,386
Iraq,15/06/2007,127,0,-4,0,31,26,0,180
Iraq,16/06/2007,89,0,-2,0,23,12,0,122
Iraq,17/06/2007,77,0,-6,0,12,15,0,98
Iraq,18/06/2007,194,0,-1,0,29,11,0,233
Iraq,19/06/2007,165,2,3,0,30,7,0,207
Iraq,20/06/2007,217,0,-4,0,27,17,0,257
Iraq,21/06/2007,124,0,-4,0,28,20,0,168
Iraq,22/06/2007,149,0,-8,0,13,3,0,157
Iraq,23/06/2007,79,0,-18,0,12,9,0,82
Iraq,24/06/2007,145,0,-6,0,136,12,0,287
Iraq,25/06/2007,105,0,-6,0,30,4,0,133
Iraq,26/06/2007,253,0,-9,0,14,14,0,272
Iraq,27/06/2007,222,2,-23,0,39,26,0,266
Iraq,28/06/2007,141,0,-6,0,10,36,0,181
Iraq,29/06/2007,210,0,-1,0,47,12,0,268
Iraq,30/06/2007,88,2,0,0,21,21,0,132
Morocco,01/06/2007,6,2,0,0,2,0,0,10
Morocco,02/06/2007,-4,0,0,0,-4,0,0,-8
Morocco,03/06/2007,4,0,0,0,0,0,0,4
Morocco,04/06/2007,63,0,0,0,6,0,0,69
Morocco,05/06/2007,27,0,0,0,0,0,0,27
Morocco,06/06/2007,-4,0,-2,0,0,8,0,2
Morocco,07/06/2007,-1,0,0,0,3,0,0,2
Morocco,08/06/2007,12,0,0,0,21,0,0,33
Morocco,09/06/2007,-2,0,0,0,12,0,0,10
Morocco,10/06/2007,0,0,0,0,3,0,0,3
Morocco,11/06/2007,0,0,0,0,5,0,0,5
Morocco,12/06/2007,2,0,0,0,9,0,0,11
Morocco,13/06/2007,22,0,0,0,0,0,0,22
Morocco,14/06/2007,4,0,0,0,-2,0,0,2
Morocco,15/06/2007,2,0,0,0,0,0,0,2
Morocco,16/06/2007,0,0,0,0,0,0,0,0
Morocco,17/06/2007,0,0,0,0,0,0,0,0
Morocco,18/06/2007,0,0,0,0,0,2,0,2
Morocco,19/06/2007,5,0,0,0,0,0,0,5
Morocco,20/06/2007,2,0,0,0,0,0,0,2
Morocco,21/06/2007,1,0,0,0,9,0,0,10
Morocco,22/06/2007,0,0,0,0,3,1,0,4
Morocco,23/06/2007,3,0,0,0,0,1,0,4
Morocco,24/06/2007,3,0,0,0,0,1,0,4
Morocco,25/06/2007,3,0,0,0,0,1,0,4
Morocco,26/06/2007,8,0,0,0,18,6,0,32
Morocco,27/06/2007,5,0,0,0,12,0,0,17
Morocco,28/06/2007,9,0,0,0,6,0,0,15
Morocco,29/06/2007,13,0,0,0,12,3,0,28
Morocco,30/06/2007,5,0,0,0,0,0,0,5
Nigeria,01/06/2007,12,0,0,0,0,2,0,14
Nigeria,02/06/2007,17,0,0,0,-4,0,0,13
Nigeria,03/06/2007,19,0,0,0,10,3,0,32
Nigeria,04/06/2007,12,0,2,0,106,3,0,123
Nigeria,05/06/2007,7,0,0,0,30,0,0,37
Nigeria,06/06/2007,3,0,2,0,13,0,0,18
Nigeria,07/06/2007,6,0,0,0,9,0,0,15
Nigeria,08/06/2007,17,0,-2,0,6,0,0,21
Nigeria,09/06/2007,16,0,0,0,9,2,0,27
Nigeria,10/06/2007,11,0,0,0,3,1,0,15
Nigeria,11/06/2007,10,0,1,0,4,1,0,16
Nigeria,12/06/2007,9,6,-2,0,1,0,0,14
Nigeria,13/06/2007,14,0,0,0,8,2,0,24
Nigeria,14/06/2007,9,0,0,0,7,2,0,18
Nigeria,15/06/2007,7,0,0,0,9,4,0,20
Nigeria,16/06/2007,2,0,0,0,13,0,0,15
Nigeria,17/06/2007,2,0,0,0,15,-1,0,16
Nigeria,18/06/2007,22,0,0,0,12,3,0,37
Nigeria,19/06/2007,19,0,-4,0,6,2,0,23
Nigeria,20/06/2007,24,0,0,0,11,4,0,39
Nigeria,21/06/2007,5,0,0,0,3,0,0,8
Nigeria,22/06/2007,0,0,0,0,0,3,0,3
Nigeria,23/06/2007,0,0,0,0,0,0,0,0
Nigeria,24/06/2007,1,0,0,0,0,0,0,1
Nigeria,25/06/2007,4,0,0,0,0,0,0,4
Nigeria,26/06/2007,0,0,0,0,3,0,0,3
Nigeria,27/06/2007,6,0,0,0,3,0,0,9
Nigeria,28/06/2007,13,0,0,0,9,1,0,23
Nigeria,29/06/2007,1,0,0,0,0,0,0,1
Nigeria,30/06/2007,3,0,0,0,0,0,0,3
Pakistan,01/06/2007,23,0,3,0,5,3,0,34
Pakistan,02/06/2007,36,0,0,0,12,1,0,49
Pakistan,03/06/2007,74,0,0,0,6,3,0,83
Pakistan,04/06/2007,109,0,0,0,15,10,0,134
Pakistan,05/06/2007,63,0,0,0,44,2,0,109
Pakistan,06/06/2007,47,4,0,0,31,3,0,85
Pakistan,07/06/2007,45,2,0,0,52,19,0,118
Pakistan,08/06/2007,18,2,1,0,25,2,0,48
Pakistan,09/06/2007,18,0,2,0,15,1,0,36
Pakistan,10/06/2007,5,0,-2,0,6,0,0,9
Pakistan,11/06/2007,53,0,0,0,14,3,0,70
Pakistan,12/06/2007,148,0,-2,0,19,13,0,178
Pakistan,13/06/2007,63,0,-8,0,9,6,0,70
Pakistan,14/06/2007,62,0,0,0,72,7,0,141
Pakistan,15/06/2007,80,0,0,0,12,1,0,93
Pakistan,16/06/2007,87,0,0,0,12,12,0,111
Pakistan,17/06/2007,90,0,0,0,4,25,0,119
Pakistan,18/06/2007,49,0,-1,0,12,18,0,78
Pakistan,19/06/2007,17,0,-1,0,3,1,0,20
Pakistan,20/06/2007,17,0,0,0,21,48,0,86
Pakistan,21/06/2007,39,0,2,0,18,48,0,107
Pakistan,22/06/2007,66,0,-4,0,29,5,0,96
Pakistan,23/06/2007,97,0,0,0,20,9,0,126
Pakistan,24/06/2007,54,0,0,0,6,12,0,72
Pakistan,25/06/2007,70,0,0,0,20,14,0,104
Pakistan,26/06/2007,24,0,1,0,5,0,0,30
Pakistan,27/06/2007,25,0,0,0,15,3,0,43
Pakistan,28/06/2007,47,0,0,0,9,2,0,58
Pakistan,29/06/2007,16,0,0,0,5,3,0,24
Pakistan,30/06/2007,22,0,-2,0,-8,0,0,12
Sierra Leone,01/06/2007,2,0,0,0,3,0,0,5
Sierra Leone,02/06/2007,0,0,0,0,3,0,0,3
Sierra Leone,03/06/2007,12,0,0,0,21,0,0,33
Sierra Leone,04/06/2007,42,0,4,0,67,5,0,118
Sierra Leone,05/06/2007,6,0,0,0,3,1,0,10
Sierra Leone,06/06/2007,0,0,0,0,0,0,0,0
Sierra Leone,07/06/2007,9,0,0,0,0,0,0,9
Sierra Leone,08/06/2007,2,0,0,0,12,2,0,16
Sierra Leone,09/06/2007,0,0,0,0,0,0,0,0
Sierra Leone,10/06/2007,4,0,0,0,0,0,0,4
Sierra Leone,11/06/2007,2,0,0,0,3,0,0,5
Sierra Leone,12/06/2007,0,0,0,0,3,0,0,3
Sierra Leone,13/06/2007,1,0,0,0,0,0,0,1
Sierra Leone,14/06/2007,0,0,0,0,-2,1,0,-1
Sierra Leone,15/06/2007,0,0,0,0,0,6,0,6
Sierra Leone,16/06/2007,0,0,0,0,0,0,0,0
Sierra Leone,18/06/2007,4,0,0,0,0,1,0,5
Sierra Leone,19/06/2007,12,0,0,0,15,3,0,30
Sierra Leone,20/06/2007,4,0,0,0,12,1,0,17
Sierra Leone,21/06/2007,4,0,-2,0,6,0,0,8
Sierra Leone,22/06/2007,0,0,0,0,-2,0,0,-2
Sierra Leone,25/06/2007,13,0,0,0,21,0,0,34
Sierra Leone,26/06/2007,3,0,0,0,9,0,0,12
Sierra Leone,28/06/2007,0,0,0,0,0,0,0,0
Sierra Leone,29/06/2007,0,0,0,0,0,0,0,0
Sierra Leone,30/06/2007,3,0,0,0,3,1,0,7
Somalia,01/06/2007,6,0,0,0,0,0,0,6
Somalia,02/06/2007,3,0,0,0,0,0,0,3
Somalia,03/06/2007,62,0,0,0,6,6,0,74
Somalia,04/06/2007,3,0,0,0,9,3,0,15
Somalia,05/06/2007,0,0,0,0,4,1,0,5
Somalia,06/06/2007,19,0,0,0,0,0,0,19
Somalia,07/06/2007,14,0,0,0,1,0,0,15
Somalia,08/06/2007,5,0,0,0,6,0,0,11
Somalia,09/06/2007,3,0,0,0,6,0,0,9
Somalia,10/06/2007,6,0,0,0,3,0,0,9
Somalia,11/06/2007,20,0,0,0,0,1,0,21
Somalia,12/06/2007,5,2,0,0,6,0,0,13
Somalia,13/06/2007,22,0,0,0,-2,4,0,24
Somalia,14/06/2007,35,0,0,0,21,3,0,59
Somalia,15/06/2007,8,0,0,0,0,1,0,9
Somalia,16/06/2007,16,0,0,0,4,3,0,23
Somalia,17/06/2007,13,0,0,0,3,0,0,16
Somalia,18/06/2007,-1,0,-2,0,0,2,0,-1
Somalia,19/06/2007,26,0,-1,0,3,0,0,28
Somalia,20/06/2007,45,0,-1,0,6,0,0,50
Somalia,21/06/2007,9,0,0,0,7,0,0,16
Somalia,22/06/2007,5,0,0,0,0,0,0,5
Somalia,23/06/2007,15,0,0,0,0,0,0,15
Somalia,24/06/2007,3,0,0,0,0,0,0,3
Somalia,25/06/2007,16,0,0,0,12,6,0,34
Somalia,26/06/2007,1,0,0,0,0,0,0,1
Somalia,27/06/2007,8,0,0,0,12,0,0,20
Somalia,28/06/2007,7,0,0,0,0,0,0,7
Somalia,29/06/2007,0,0,0,0,0,0,0,0
Syria,01/06/2007,26,0,0,0,0,0,0,26
Syria,02/06/2007,25,0,-1,0,3,1,0,28
Syria,03/06/2007,34,0,0,0,0,0,0,34
Syria,04/06/2007,38,0,0,0,6,0,0,44
Syria,05/06/2007,18,0,0,0,7,4,0,29
Syria,06/06/2007,37,0,0,0,11,0,0,48
Syria,07/06/2007,60,0,-2,0,13,21,0,92
Syria,08/06/2007,89,0,0,0,87,3,0,179
Syria,09/06/2007,20,0,0,0,18,3,0,41
Syria,10/06/2007,19,0,0,0,9,0,0,28
Syria,11/06/2007,21,0,0,0,6,0,0,27
Syria,12/06/2007,32,0,0,0,0,3,0,35
Syria,13/06/2007,99,0,0,0,26,3,0,128
Syria,14/06/2007,72,0,-6,0,44,3,0,113
Syria,15/06/2007,64,0,-3,0,24,3,0,88
Syria,16/06/2007,25,0,-2,0,0,14,0,37
Syria,17/06/2007,7,0,0,0,-4,2,0,5
Syria,18/06/2007,33,0,0,0,21,5,0,59
Syria,19/06/2007,23,2,1,0,-6,0,0,20
Syria,20/06/2007,64,0,-15,0,11,0,0,60
Syria,21/06/2007,60,0,-2,0,24,8,0,90
Syria,22/06/2007,40,0,0,0,5,0,0,45
Syria,23/06/2007,11,0,-8,0,12,0,0,15
Syria,24/06/2007,37,2,0,0,0,1,0,40
Syria,25/06/2007,4,0,0,0,0,4,0,8
Syria,26/06/2007,29,0,-10,0,6,0,0,25
Syria,27/06/2007,21,0,0,0,3,1,0,25
Syria,28/06/2007,6,0,0,0,0,0,0,6
Syria,29/06/2007,19,0,-3,0,30,0,0,46
Syria,30/06/2007,12,0,2,0,10,2,0,26
Yemen,01/06/2007,14,0,3,0,12,0,0,29
Yemen,02/06/2007,3,0,1,0,9,0,0,13
Yemen,03/06/2007,13,0,1,0,24,0,0,38
Yemen,04/06/2007,21,0,0,0,36,0,0,57
Yemen,05/06/2007,58,0,0,0,27,2,0,87
Yemen,06/06/2007,29,0,0,0,6,0,0,35
Yemen,07/06/2007,6,0,0,0,3,0,0,9
Yemen,08/06/2007,22,0,0,0,21,0,0,43
Yemen,09/06/2007,17,0,0,0,0,0,0,17
Yemen,10/06/2007,3,0,0,0,0,0,0,3
Yemen,11/06/2007,2,0,0,0,3,0,0,5
Yemen,12/06/2007,0,0,0,0,6,0,0,6
Yemen,13/06/2007,45,0,0,0,9,0,0,54
Yemen,14/06/2007,2,0,0,0,0,0,0,2
Yemen,16/06/2007,2,0,0,0,-2,0,0,0
Yemen,17/06/2007,1,0,0,0,0,0,0,1
Yemen,18/06/2007,4,0,0,0,0,0,0,4
Yemen,19/06/2007,7,0,0,0,6,0,0,13
Yemen,20/06/2007,-1,0,0,0,12,2,0,13
Yemen,21/06/2007,6,0,0,0,9,0,0,15
Yemen,22/06/2007,15,0,0,0,-1,0,0,14
Yemen,23/06/2007,12,0,0,0,0,0,0,12
Yemen,24/06/2007,6,0,0,0,6,0,0,12
Yemen,25/06/2007,30,0,0,0,0,0,0,30
Yemen,26/06/2007,0,0,0,0,0,2,0,2
Yemen,27/06/2007,0,0,0,0,0,0,0,0
Yemen,29/06/2007,12,0,0,0,0,2,0,14
Yemen,30/06/2007,2,0,0,0,0,2,0,4
Afghanistan,01/12/2007,60,0,1,0,14,2,0,77
Afghanistan,02/12/2007,92,6,-6,0,2,12,0,106
Afghanistan,03/12/2007,116,0,0,0,33,10,0,159
Afghanistan,04/12/2007,126,0,1,0,47,21,0,195
Afghanistan,05/12/2007,56,0,0,0,37,6,0,99
Afghanistan,06/12/2007,51,2,-4,0,33,4,0,86
Afghanistan,07/12/2007,63,0,2,0,46,4,0,115
Afghanistan,08/12/2007,61,2,0,0,12,0,0,75
Afghanistan,09/12/2007,58,0,0,0,10,6,0,74
Afghanistan,10/12/2007,78,0,1,0,25,2,0,106
Afghanistan,11/12/2007,46,2,0,0,18,8,0,74
Afghanistan,12/12/2007,138,0,0,0,10,24,0,172
Afghanistan,13/12/2007,82,0,1,0,14,7,0,104
Afghanistan,14/12/2007,46,2,-4,0,28,9,0,81
Afghanistan,15/12/2007,28,2,0,0,3,8,0,41
Afghanistan,16/12/2007,35,4,0,0,8,16,0,63
Afghanistan,17/12/2007,76,2,0,0,59,6,0,143
Afghanistan,18/12/2007,94,0,0,0,42,18,0,154
Afghanistan,19/12/2007,94,0,0,0,76,18,0,188
Afghanistan,20/12/2007,133,0,1,0,46,2,0,182
Afghanistan,21/12/2007,92,0,0,0,29,5,0,126
Afghanistan,22/12/2007,99,0,0,0,25,5,0,129
Afghanistan,23/12/2007,67,0,0,0,11,30,0,108
Afghanistan,24/12/2007,59,2,0,0,10,30,0,101
Afghanistan,25/12/2007,53,0,0,0,72,2,0,127
Afghanistan,26/12/2007,94,0,-4,0,25,2,0,117
Afghanistan,27/12/2007,45,0,0,0,39,13,0,97
Afghanistan,28/12/2007,42,0,0,0,8,2,0,52
Afghanistan,29/12/2007,26,0,0,0,4,0,0,30
Afghanistan,30/12/2007,94,0,0,0,10,18,0,122
Afghanistan,31/12/2007,52,0,0,0,10,1,0,63
Albania,01/12/2007,11,0,-13,0,6,0,0,4
Albania,02/12/2007,24,0,-1,0,0,0,0,23
Albania,03/12/2007,-1,0,-1,0,0,0,0,-2
Albania,04/12/2007,14,0,-6,0,6,0,0,14
Albania,05/12/2007,16,0,-5,0,6,5,0,22
Albania,06/12/2007,16,0,-1,0,0,1,0,16
Albania,07/12/2007,25,0,-13,0,9,1,0,22
Albania,08/12/2007,8,0,-4,0,0,0,0,4
Albania,09/12/2007,13,6,-1,0,12,0,0,30
Albania,10/12/2007,27,0,-11,0,12,2,0,30
Albania,11/12/2007,10,0,-4,0,0,8,0,14
Albania,12/12/2007,10,0,-5,0,13,1,0,19
Albania,13/12/2007,15,0,-2,0,0,0,0,13
Albania,14/12/2007,-6,0,-2,0,0,1,0,-7
Albania,15/12/2007,11,0,0,0,0,2,0,13
Albania,16/12/2007,11,0,-5,0,0,4,0,10
Albania,17/12/2007,4,0,0,0,21,5,0,30
Albania,18/12/2007,6,0,-3,0,3,0,0,6
Albania,19/12/2007,19,0,-10,0,0,0,0,9
Albania,20/12/2007,19,0,-8,0,21,0,0,32
Albania,21/12/2007,10,0,-1,0,0,6,0,15
Albania,22/12/2007,8,0,0,0,-1,1,0,8
Albania,23/12/2007,1,0,-1,0,0,3,0,3
Albania,24/12/2007,7,0,0,0,-1,1,0,7
Albania,25/12/2007,-3,0,0,0,3,0,0,0
Albania,26/12/2007,6,0,-3,0,9,0,0,12
Albania,27/12/2007,5,0,-4,0,0,0,0,1
Albania,28/12/2007,-1,0,0,0,0,1,0,0
Albania,29/12/2007,3,0,-6,0,-2,0,0,-5
Albania,30/12/2007,0,0,0,0,6,1,0,7
Albania,31/12/2007,3,0,0,0,0,0,0,3
Algeria,01/12/2007,6,0,0,0,19,0,0,25
Algeria,02/12/2007,2,0,-4,0,9,0,0,7
Algeria,03/12/2007,6,0,0,0,4,2,0,12
Algeria,04/12/2007,13,0,0,0,-2,4,0,15
Algeria,05/12/2007,22,0,0,0,17,9,0,48
Algeria,06/12/2007,46,0,1,0,17,0,0,64
Algeria,07/12/2007,5,0,0,0,21,0,0,26
Algeria,08/12/2007,2,0,0,0,5,0,0,7
Algeria,09/12/2007,11,0,0,0,6,0,0,17
Algeria,10/12/2007,2,0,0,0,0,0,0,2
Algeria,11/12/2007,71,0,-2,0,9,13,0,91
Algeria,12/12/2007,1,0,0,0,11,0,0,12
Algeria,13/12/2007,24,0,0,0,-4,0,0,20
Algeria,14/12/2007,2,0,0,0,3,0,0,5
Algeria,15/12/2007,9,0,0,0,6,0,0,15
Algeria,16/12/2007,0,0,0,0,12,2,0,14
Algeria,17/12/2007,0,0,0,0,3,0,0,3
Algeria,18/12/2007,14,0,0,0,0,0,0,14
Algeria,19/12/2007,7,0,0,0,4,0,0,11
Algeria,20/12/2007,12,0,0,0,12,0,0,24
Algeria,21/12/2007,3,0,0,0,0,0,0,3
Algeria,22/12/2007,3,0,0,0,3,0,0,6
Algeria,23/12/2007,12,0,0,0,-1,0,0,11
Algeria,24/12/2007,0,0,0,0,-2,0,0,-2
Algeria,25/12/2007,2,0,0,0,-6,0,0,-4
Algeria,26/12/2007,4,0,0,0,8,0,0,12
Algeria,27/12/2007,0,0,0,0,-2,0,0,-2
Algeria,28/12/2007,6,0,0,0,6,8,0,20
Algeria,29/12/2007,6,0,0,0,3,2,0,11
Algeria,30/12/2007,10,0,0,0,-8,0,0,2
Algeria,31/12/2007,12,0,0,0,0,0,0,12
Bangladesh,01/12/2007,5,0,0,0,-1,0,0,4
Bangladesh,02/12/2007,2,0,0,0,0,0,0,2
Bangladesh,03/12/2007,1,0,0,0,9,2,0,12
Bangladesh,04/12/2007,18,4,0,0,3,5,0,30
Bangladesh,05/12/2007,4,4,-4,0,-2,5,0,7
Bangladesh,06/12/2007,9,0,0,0,6,0,0,15
Bangladesh,07/12/2007,2,0,-2,0,3,0,0,3
Bangladesh,08/12/2007,6,0,1,0,-3,0,0,4
Bangladesh,09/12/2007,2,0,0,0,7,0,0,9
Bangladesh,10/12/2007,12,0,0,0,0,11,0,23
Bangladesh,11/12/2007,-3,0,0,0,3,4,0,4
Bangladesh,12/12/2007,4,0,0,0,-10,2,0,-4
Bangladesh,13/12/2007,0,0,0,0,0,0,0,0
Bangladesh,14/12/2007,13,0,0,0,-1,0,0,12
Bangladesh,15/12/2007,2,0,0,0,0,0,0,2
Bangladesh,16/12/2007,1,0,0,0,0,2,0,3
Bangladesh,17/12/2007,1,0,0,0,0,2,0,3
Bangladesh,18/12/2007,14,0,0,0,0,0,0,14
Bangladesh,19/12/2007,-11,0,0,0,3,0,0,-8
Bangladesh,20/12/2007,14,0,0,0,12,0,0,26
Bangladesh,21/12/2007,17,0,0,0,20,0,0,37
Bangladesh,22/12/2007,12,0,0,0,24,2,0,38
Bangladesh,23/12/2007,2,0,0,0,0,0,0,2
Bangladesh,24/12/2007,1,0,0,0,-4,0,0,-3
Bangladesh,25/12/2007,-16,0,0,0,13,1,0,-2
Bangladesh,26/12/2007,10,0,2,0,-4,0,0,8
Bangladesh,27/12/2007,22,0,0,0,22,0,0,44
Bangladesh,28/12/2007,2,0,0,0,0,0,0,2
Bangladesh,29/12/2007,0,0,0,0,16,0,0,16
Bangladesh,30/12/2007,29,2,0,0,0,0,0,31
Bangladesh,31/12/2007,3,0,0,0,0,0,0,3
Cameroon,04/12/2007,0,0,0,0,0,0,0,0
Cameroon,05/12/2007,6,0,0,0,3,0,0,9
Cameroon,06/12/2007,0,0,0,0,9,0,0,9
Cameroon,07/12/2007,0,0,0,0,9,0,0,9
Cameroon,08/12/2007,0,0,0,0,0,0,0,0
Cameroon,10/12/2007,0,0,0,0,0,0,0,0
Cameroon,11/12/2007,3,0,0,0,-4,0,0,-1
Cameroon,12/12/2007,3,0,0,0,6,0,0,9
Cameroon,13/12/2007,0,0,0,0,0,0,0,0
Cameroon,14/12/2007,2,0,0,0,0,1,0,3
Cameroon,17/12/2007,0,0,0,0,0,0,0,0
Cameroon,18/12/2007,0,0,0,0,0,0,0,0
Cameroon,19/12/2007,0,0,0,0,0,0,0,0
Cameroon,20/12/2007,2,0,0,0,0,0,0,2
Cameroon,21/12/2007,0,0,0,0,0,0,0,0
Cameroon,27/12/2007,0,0,0,0,0,0,0,0
China,01/12/2007,31,2,0,0,42,1,0,76
China,02/12/2007,15,2,4,0,24,2,0,47
China,03/12/2007,102,0,1,0,15,4,0,122
China,04/12/2007,82,0,-2,0,76,8,0,164
China,05/12/2007,62,0,-4,0,45,19,0,122
China,06/12/2007,52,2,-9,0,59,13,0,117
China,07/12/2007,76,2,-3,0,19,12,0,106
China,08/12/2007,38,0,0,0,21,5,0,64
China,09/12/2007,52,0,0,0,10,11,0,73
China,10/12/2007,48,0,0,0,31,7,0,86
China,11/12/2007,23,0,0,0,17,7,0,47
China,12/12/2007,79,2,3,0,14,6,0,104
China,13/12/2007,62,0,0,0,19,4,0,85
China,14/12/2007,28,0,0,0,7,8,0,43
China,15/12/2007,41,0,-1,0,26,1,0,67
China,16/12/2007,30,0,0,0,13,20,0,63
China,17/12/2007,91,0,-1,0,23,5,0,118
China,18/12/2007,95,0,0,0,10,7,0,112
China,19/12/2007,79,4,0,0,22,6,0,111
China,20/12/2007,56,2,0,0,9,3,0,70
China,21/12/2007,56,0,-1,0,15,10,0,80
China,22/12/2007,50,0,-1,0,31,4,0,84
China,23/12/2007,28,0,0,0,6,7,0,41
China,24/12/2007,34,0,1,0,21,6,0,62
China,25/12/2007,53,0,0,0,17,7,0,77
China,26/12/2007,40,0,0,0,12,16,0,68
China,27/12/2007,28,0,0,0,29,1,0,58
China,28/12/2007,3,0,0,0,6,0,0,9
China,29/12/2007,1,0,0,0,6,0,0,7
China,30/12/2007,3,0,0,0,-4,0,0,-1
China,31/12/2007,6,0,0,0,-2,0,0,4
Egypt,01/12/2007,-4,0,0,0,15,2,0,13
Egypt,02/12/2007,35,0,0,0,11,0,0,46
Egypt,03/12/2007,39,0,3,0,6,0,0,48
Egypt,04/12/2007,19,0,3,0,6,5,0,33
Egypt,05/12/2007,46,4,0,0,81,8,0,139
Egypt,06/12/2007,9,0,0,0,30,0,0,39
Egypt,07/12/2007,24,0,0,0,6,0,0,30
Egypt,08/12/2007,2,0,0,0,-4,0,0,-2
Egypt,09/12/2007,3,0,0,0,3,2,0,8
Egypt,10/12/2007,7,0,0,0,9,5,0,21
Egypt,11/12/2007,19,0,0,0,14,1,0,34
Egypt,12/12/2007,3,0,0,0,13,0,0,16
Egypt,13/12/2007,3,0,0,0,10,1,0,14
Egypt,14/12/2007,18,0,0,0,12,2,0,32
Egypt,15/12/2007,2,0,0,0,0,0,0,2
Egypt,16/12/2007,9,0,0,0,8,5,0,22
Egypt,17/12/2007,18,0,9,0,6,8,0,41
Egypt,18/12/2007,22,0,1,0,-2,0,0,21
Egypt,19/12/2007,32,0,0,0,15,2,0,49
Egypt,20/12/2007,10,0,0,0,7,3,0,20
Egypt,21/12/2007,14,0,0,0,12,1,0,27
Egypt,22/12/2007,17,0,0,0,3,0,0,20
Egypt,23/12/2007,26,0,0,0,-2,0,0,24
Egypt,24/12/2007,34,0,0,0,0,5,0,39
Egypt,25/12/2007,13,0,0,0,1,0,0,14
Egypt,26/12/2007,47,0,0,0,13,5,0,65
Egypt,27/12/2007,40,0,0,0,2,8,0,50
Egypt,28/12/2007,13,0,0,0,6,0,0,19
Egypt,29/12/2007,4,0,0,0,-4,0,0,0
Egypt,30/12/2007,0,0,0,0,6,0,0,6
Egypt,31/12/2007,40,0,1,0,3,2,0,46
Eritrea,01/12/2007,4,0,0,0,0,0,0,4
Eritrea,02/12/2007,1,0,0,0,0,0,0,1
Eritrea,03/12/2007,-1,2,0,0,1,0,0,2
Eritrea,04/12/2007,0,0,0,0,0,0,0,0
Eritrea,05/12/2007,20,0,0,0,6,2,0,28
Eritrea,06/12/2007,14,0,0,0,10,0,0,24
Eritrea,07/12/2007,6,0,0,0,3,3,0,12
Eritrea,08/12/2007,0,0,0,0,0,0,0,0
Eritrea,09/12/2007,13,0,0,0,0,0,0,13
Eritrea,10/12/2007,11,0,0,0,17,0,0,28
Eritrea,12/12/2007,0,0,0,0,0,0,0,0
Eritrea,14/12/2007,2,0,0,0,-2,0,0,0
Eritrea,15/12/2007,3,0,0,0,0,0,0,3
Eritrea,16/12/2007,0,0,0,0,0,2,0,2
Eritrea,18/12/2007,6,0,0,0,0,0,0,6
Eritrea,19/12/2007,0,0,0,0,0,1,0,1
Eritrea,21/12/2007,0,0,0,0,3,0,0,3
Eritrea,22/12/2007,2,0,0,0,6,0,0,8
Eritrea,23/12/2007,9,0,0,0,0,0,0,9
Eritrea,24/12/2007,3,0,0,0,0,0,0,3
Eritrea,25/12/2007,18,0,0,0,0,12,0,30
Eritrea,26/12/2007,0,0,0,0,0,6,0,6
Eritrea,27/12/2007,0,0,0,0,0,0,0,0
Georgia,01/12/2007,8,0,0,0,-2,1,0,7
Georgia,02/12/2007,2,0,0,0,0,0,0,2
Georgia,03/12/2007,-3,0,0,0,0,1,0,-2
Georgia,04/12/2007,-3,0,0,0,7,0,0,4
Georgia,05/12/2007,18,0,1,0,-2,0,0,17
Georgia,06/12/2007,2,0,0,0,3,0,0,5
Georgia,07/12/2007,5,0,0,0,12,1,0,18
Georgia,08/12/2007,3,0,0,0,20,0,0,23
Georgia,09/12/2007,1,0,-2,0,-2,0,0,-3
Georgia,10/12/2007,4,0,0,0,3,0,0,7
Georgia,11/12/2007,4,0,1,0,15,0,0,20
Georgia,12/12/2007,20,0,0,0,19,2,0,41
Georgia,13/12/2007,9,0,0,0,0,0,0,9
Georgia,14/12/2007,5,0,0,0,6,0,0,11
Georgia,15/12/2007,0,0,0,0,0,0,0,0
Georgia,16/12/2007,10,0,0,0,-2,0,0,8
Georgia,17/12/2007,8,0,0,0,0,1,0,9
Georgia,18/12/2007,4,0,0,0,0,0,0,4
Georgia,19/12/2007,4,0,0,0,0,0,0,4
Georgia,20/12/2007,0,0,0,0,10,0,0,10
Georgia,21/12/2007,0,0,0,0,0,0,0,0
Georgia,22/12/2007,12,0,0,0,10,0,0,22
Georgia,23/12/2007,0,0,0,0,0,0,0,0
Georgia,24/12/2007,14,0,0,0,9,2,0,25
Georgia,25/12/2007,1,0,2,0,3,0,0,6
Georgia,26/12/2007,18,0,0,0,6,2,0,26
Georgia,27/12/2007,0,0,0,0,6,0,0,6
Georgia,30/12/2007,0,0,0,0,0,0,0,0
Georgia,31/12/2007,-1,0,0,0,0,0,0,-1
India,01/12/2007,15,0,-2,0,10,5,0,28
India,02/12/2007,22,0,-4,0,18,0,0,36
India,03/12/2007,24,0,1,0,-1,3,0,27
India,04/12/2007,18,0,1,0,6,7,0,32
India,05/12/2007,30,0,0,0,0,3,0,33
India,06/12/2007,19,0,-1,0,1,0,0,19
India,07/12/2007,27,0,0,0,7,4,0,38
India,08/12/2007,12,0,0,0,8,2,0,22
India,09/12/2007,22,2,0,0,3,2,0,29
India,10/12/2007,31,0,0,0,19,8,0,58
India,11/12/2007,27,0,2,0,23,12,0,64
India,12/12/2007,34,0,0,0,4,2,0,40
India,13/12/2007,28,0,0,0,3,3,0,34
India,14/12/2007,35,0,0,0,12,21,0,68
India,15/12/2007,32,0,0,0,14,5,0,51
India,16/12/2007,11,0,1,0,22,2,0,36
India,17/12/2007,15,0,1,0,3,3,0,22
India,18/12/2007,21,0,0,0,-5,2,0,18
India,19/12/2007,46,0,0,0,20,1,0,67
India,20/12/2007,11,0,0,0,-2,1,0,10
India,21/12/2007,27,4,-2,0,6,5,0,40
India,22/12/2007,23,0,0,0,0,3,0,26
India,23/12/2007,24,0,0,0,7,5,0,36
India,24/12/2007,30,0,1,0,3,2,0,36
India,25/12/2007,25,0,0,0,9,2,0,36
India,26/12/2007,25,0,0,0,9,8,0,42
India,27/12/2007,32,4,2,0,11,9,0,58
India,28/12/2007,20,0,0,0,0,0,0,20
India,29/12/2007,9,0,-4,0,0,0,0,5
India,30/12/2007,6,0,0,0,0,2,0,8
India,31/12/2007,2,0,0,0,0,1,0,3
Iran,01/12/2007,54,2,1,0,25,0,0,82
Iran,02/12/2007,31,2,-10,0,50,5,0,78
Iran,03/12/2007,33,0,-16,0,-4,2,0,15
Iran,04/12/2007,143,0,-4,0,23,11,0,173
Iran,05/12/2007,66,0,5,0,8,15,0,94
Iran,06/12/2007,63,2,-11,0,4,4,0,62
Iran,07/12/2007,31,0,1,0,-4,8,0,36
Iran,08/12/2007,38,0,-2,0,6,0,0,42
Iran,09/12/2007,41,0,-4,0,4,2,0,43
Iran,10/12/2007,26,0,0,0,25,4,0,55
Iran,11/12/2007,43,4,0,0,22,2,0,71
Iran,12/12/2007,46,0,0,0,14,0,0,60
Iran,13/12/2007,54,0,-2,0,13,4,0,69
Iran,14/12/2007,40,0,3,0,9,1,0,53
Iran,15/12/2007,42,2,0,0,-4,1,0,41
Iran,16/12/2007,34,0,0,0,22,0,0,56
Iran,17/12/2007,23,0,0,0,0,2,0,25
Iran,18/12/2007,89,0,-1,0,17,16,0,121
Iran,19/12/2007,72,0,0,0,3,0,0,75
Iran,20/12/2007,24,0,0,0,22,2,0,48
Iran,21/12/2007,7,0,0,0,16,2,0,25
Iran,22/12/2007,18,0,0,0,2,2,0,22
Iran,23/12/2007,39,0,5,0,15,2,0,61
Iran,24/12/2007,-2,0,0,0,9,18,0,25
Iran,25/12/2007,41,0,0,0,37,7,0,85
Iran,26/12/2007,25,0,0,0,30,0,0,55
Iran,27/12/2007,51,0,0,0,0,6,0,57
Iran,28/12/2007,23,0,0,0,10,2,0,35
Iran,29/12/2007,7,0,0,0,0,0,0,7
Iran,30/12/2007,11,0,0,0,3,0,0,14
Iran,31/12/2007,23,0,0,0,4,0,0,27
Iraq,01/12/2007,173,0,1,0,11,5,0,190
Iraq,02/12/2007,142,0,1,0,2,4,0,149
Iraq,03/12/2007,133,0,-1,0,12,8,0,152
Iraq,04/12/2007,187,0,-1,0,68,16,0,270
Iraq,05/12/2007,121,0,1,0,8,22,0,152
Iraq,06/12/2007,92,4,-1,0,29,14,0,138
Iraq,07/12/2007,57,0,-6,0,51,24,0,126
Iraq,08/12/2007,40,0,0,0,39,6,0,85
Iraq,09/12/2007,103,0,0,0,17,8,0,128
Iraq,10/12/2007,61,0,1,0,31,6,0,99
Iraq,11/12/2007,72,20,-1,0,21,14,0,126
Iraq,12/12/2007,113,0,0,0,15,23,0,151
Iraq,13/12/2007,112,2,6,0,44,3,0,167
Iraq,14/12/2007,50,6,1,0,25,11,0,93
Iraq,15/12/2007,49,10,0,0,7,3,0,69
Iraq,16/12/2007,289,8,0,0,-32,17,0,282
Iraq,17/12/2007,205,2,-2,0,26,5,0,236
Iraq,18/12/2007,177,2,-2,0,61,14,0,252
Iraq,19/12/2007,245,0,3,0,39,31,0,318
Iraq,20/12/2007,197,2,0,0,43,41,0,283
Iraq,21/12/2007,72,4,-2,0,16,8,0,98
Iraq,22/12/2007,84,0,1,0,-4,4,0,85
Iraq,23/12/2007,96,2,0,0,-3,0,0,95
Iraq,24/12/2007,110,0,0,0,-6,1,0,105
Iraq,25/12/2007,162,0,0,0,13,35,0,210
Iraq,26/12/2007,204,0,0,0,38,13,0,255
Iraq,27/12/2007,74,2,0,0,11,14,0,101
Iraq,28/12/2007,70,0,0,0,14,2,0,86
Iraq,29/12/2007,51,0,-2,0,9,5,0,63
Iraq,30/12/2007,28,0,2,0,3,2,0,35
Iraq,31/12/2007,35,0,-6,0,6,2,0,37
Morocco,01/12/2007,0,0,0,0,0,0,0,0
Morocco,02/12/2007,0,0,0,0,0,0,0,0
Morocco,03/12/2007,9,0,0,0,3,0,0,12
Morocco,04/12/2007,1,0,0,0,0,0,0,1
Morocco,05/12/2007,15,0,0,0,15,0,0,30
Morocco,06/12/2007,7,0,0,0,3,0,0,10
Morocco,07/12/2007,8,0,0,0,0,0,0,8
Morocco,08/12/2007,1,0,0,0,8,0,0,9
Morocco,09/12/2007,3,0,0,0,3,0,0,6
Morocco,10/12/2007,22,0,0,0,45,0,0,67
Morocco,11/12/2007,32,0,0,0,18,4,0,54
Morocco,12/12/2007,12,0,0,0,3,0,0,15
Morocco,13/12/2007,7,0,0,0,0,0,0,7
Morocco,14/12/2007,0,0,0,0,12,0,0,12
Morocco,15/12/2007,0,0,0,0,0,0,0,0
Morocco,16/12/2007,0,0,0,0,3,0,0,3
Morocco,17/12/2007,0,0,0,0,9,0,0,9
Morocco,18/12/2007,8,0,0,0,1,0,0,9
Morocco,19/12/2007,6,0,0,0,0,0,0,6
Morocco,20/12/2007,1,0,0,0,3,0,0,4
Morocco,21/12/2007,1,0,0,0,-2,0,0,-1
Morocco,23/12/2007,2,0,0,0,0,0,0,2
Morocco,24/12/2007,-3,0,0,0,0,0,0,-3
Morocco,25/12/2007,0,0,0,0,0,0,0,0
Morocco,26/12/2007,1,0,0,0,0,0,0,1
Morocco,27/12/2007,1,0,0,0,0,0,0,1
Morocco,30/12/2007,12,0,0,0,0,0,0,12
Nigeria,01/12/2007,-1,0,0,0,6,0,0,5
Nigeria,02/12/2007,3,2,0,0,0,0,0,5
Nigeria,03/12/2007,34,0,0,0,1,0,0,35
Nigeria,04/12/2007,12,0,1,0,3,0,0,16
Nigeria,05/12/2007,13,0,-8,0,12,1,0,18
Nigeria,06/12/2007,22,0,-1,0,10,0,0,31
Nigeria,07/12/2007,-2,0,0,0,3,0,0,1
Nigeria,08/12/2007,-1,0,0,0,9,0,0,8
Nigeria,09/12/2007,2,0,0,0,0,0,0,2
Nigeria,10/12/2007,4,0,0,0,6,2,0,12
Nigeria,11/12/2007,0,0,0,0,3,2,0,5
Nigeria,12/12/2007,8,0,0,0,2,0,0,10
Nigeria,13/12/2007,13,0,0,0,-2,0,0,11
Nigeria,14/12/2007,22,0,0,0,0,0,0,22
Nigeria,15/12/2007,12,0,0,0,-2,0,0,10
Nigeria,16/12/2007,0,0,0,0,-2,0,0,-2
Nigeria,17/12/2007,5,0,0,0,6,0,0,11
Nigeria,18/12/2007,8,0,0,0,12,6,0,26
Nigeria,19/12/2007,-5,0,0,0,9,0,0,4
Nigeria,20/12/2007,5,0,0,0,3,2,0,10
Nigeria,21/12/2007,9,0,0,0,1,1,0,11
Nigeria,22/12/2007,10,0,0,0,1,0,0,11
Nigeria,23/12/2007,-1,0,0,0,0,0,0,-1
Nigeria,24/12/2007,7,0,0,0,5,1,0,13
Nigeria,25/12/2007,0,0,0,0,0,0,0,0
Nigeria,26/12/2007,0,0,0,0,0,0,0,0
Nigeria,27/12/2007,0,0,0,0,0,0,0,0
Nigeria,28/12/2007,0,0,0,0,0,0,0,0
Nigeria,29/12/2007,0,0,0,0,6,0,0,6
Nigeria,31/12/2007,0,0,2,0,0,0,0,2
Pakistan,01/12/2007,29,0,-4,0,0,5,0,30
Pakistan,02/12/2007,33,0,0,0,0,8,0,41
Pakistan,03/12/2007,52,0,0,0,63,7,0,122
Pakistan,04/12/2007,33,0,0,0,11,5,0,49
Pakistan,05/12/2007,29,2,-4,0,29,7,0,63
Pakistan,06/12/2007,36,0,1,0,25,3,0,65
Pakistan,07/12/2007,37,0,0,0,21,6,0,64
Pakistan,08/12/2007,20,0,0,0,-3,0,0,17
Pakistan,09/12/2007,42,0,0,0,9,23,0,74
Pakistan,10/12/2007,82,0,0,0,5,6,0,93
Pakistan,11/12/2007,100,2,1,0,74,6,0,183
Pakistan,12/12/2007,93,0,0,0,52,12,0,157
Pakistan,13/12/2007,36,0,1,0,19,1,0,57
Pakistan,14/12/2007,71,0,1,0,24,4,0,100
Pakistan,15/12/2007,42,2,1,0,14,12,0,71
Pakistan,16/12/2007,23,0,1,0,22,1,0,47
Pakistan,17/12/2007,30,0,0,0,24,11,0,65
Pakistan,18/12/2007,62,0,1,0,16,17,0,96
Pakistan,19/12/2007,59,2,0,0,25,6,0,92
Pakistan,20/12/2007,26,0,0,0,61,1,0,88
Pakistan,21/12/2007,64,0,0,0,22,17,0,103
Pakistan,22/12/2007,10,0,0,0,6,18,0,34
Pakistan,23/12/2007,95,0,0,0,1,6,0,102
Pakistan,24/12/2007,40,2,0,0,27,3,0,72
Pakistan,25/12/2007,24,0,0,0,27,8,0,59
Pakistan,26/12/2007,30,0,2,0,2,3,0,37
Pakistan,27/12/2007,141,0,-5,0,10,30,0,176
Pakistan,28/12/2007,116,0,2,0,9,22,0,149
Pakistan,29/12/2007,56,0,-4,0,0,16,0,68
Pakistan,30/12/2007,17,0,5,0,3,3,0,28
Pakistan,31/12/2007,18,0,0,0,6,4,0,28
Sierra Leone,03/12/2007,0,0,0,0,0,0,0,0
Sierra Leone,04/12/2007,0,0,0,0,0,0,0,0
Sierra Leone,05/12/2007,0,0,0,0,0,0,0,0
Sierra Leone,06/12/2007,6,2,0,0,0,0,0,8
Sierra Leone,07/12/2007,0,0,0,0,0,0,0,0
Sierra Leone,08/12/2007,0,0,0,0,1,0,0,1
Sierra Leone,10/12/2007,2,0,0,0,6,0,0,8
Sierra Leone,11/12/2007,0,0,0,0,0,0,0,0
Sierra Leone,12/12/2007,0,0,0,0,6,0,0,6
Sierra Leone,13/12/2007,0,0,0,0,0,0,0,0
Sierra Leone,14/12/2007,1,0,0,0,3,0,0,4
Sierra Leone,16/12/2007,-3,0,0,0,0,0,0,-3
Sierra Leone,17/12/2007,4,0,0,0,0,0,0,4
Sierra Leone,18/12/2007,0,0,0,0,0,0,0,0
Sierra Leone,19/12/2007,0,0,0,0,0,0,0,0
Sierra Leone,20/12/2007,0,0,0,0,0,3,0,3
Sierra Leone,21/12/2007,0,0,0,0,0,2,0,2
Sierra Leone,22/12/2007,0,0,0,0,0,0,0,0
Sierra Leone,26/12/2007,0,0,0,0,0,0,0,0
Sierra Leone,27/12/2007,0,0,0,0,0,0,0,0
Sierra Leone,29/12/2007,0,0,0,0,0,0,0,0
Somalia,01/12/2007,14,0,0,0,0,0,0,14
Somalia,02/12/2007,6,0,0,0,0,0,0,6
Somalia,03/12/2007,4,2,-4,0,-5,0,0,-3
Somalia,04/12/2007,25,2,-18,0,-9,2,0,2
Somalia,05/12/2007,76,0,-16,0,0,3,0,63
Somalia,06/12/2007,20,2,-4,0,0,0,0,18
Somalia,07/12/2007,72,0,-8,0,12,2,0,78
Somalia,08/12/2007,59,0,0,0,3,1,0,63
Somalia,09/12/2007,12,0,0,0,0,0,0,12
Somalia,10/12/2007,11,0,0,0,16,6,0,33
Somalia,11/12/2007,40,0,-4,0,29,0,0,65
Somalia,12/12/2007,35,0,0,0,-19,0,0,16
Somalia,13/12/2007,15,0,0,0,0,0,0,15
Somalia,14/12/2007,11,0,-1,0,9,0,0,19
Somalia,15/12/2007,6,0,0,0,6,0,0,12
Somalia,16/12/2007,4,0,0,0,0,1,0,5
Somalia,17/12/2007,17,0,-4,0,0,9,0,22
Somalia,18/12/2007,30,0,0,0,9,9,0,48
Somalia,19/12/2007,14,0,0,0,6,9,0,29
Somalia,20/12/2007,11,2,0,0,0,4,0,17
Somalia,21/12/2007,14,0,0,0,1,4,0,19
Somalia,22/12/2007,4,0,0,0,0,0,0,4
Somalia,24/12/2007,24,0,0,0,0,0,0,24
Somalia,25/12/2007,1,0,0,0,-16,0,0,-15
Somalia,26/12/2007,9,0,0,0,24,6,0,39
Somalia,27/12/2007,3,0,0,0,-4,0,0,-1
Somalia,28/12/2007,0,0,0,0,6,0,0,6
Somalia,31/12/2007,5,0,0,0,0,0,0,5
Syria,01/12/2007,-2,0,0,0,15,0,0,13
Syria,02/12/2007,3,0,-4,0,6,4,0,9
Syria,03/12/2007,18,0,1,0,-8,3,0,14
Syria,04/12/2007,76,0,-11,0,10,0,0,75
Syria,05/12/2007,51,18,0,0,46,6,0,121
Syria,06/12/2007,35,0,-2,0,19,3,0,55
Syria,07/12/2007,14,0,-9,0,9,0,0,14
Syria,08/12/2007,11,0,-4,0,-4,0,0,3
Syria,09/12/2007,7,0,0,0,3,2,0,12
Syria,10/12/2007,2,0,-2,0,6,0,0,6
Syria,11/12/2007,33,0,0,0,2,0,0,35
Syria,12/12/2007,71,0,-10,0,3,36,0,100
Syria,13/12/2007,29,0,-2,0,13,7,0,47
Syria,14/12/2007,27,0,1,0,3,0,0,31
Syria,15/12/2007,7,0,-8,0,0,0,0,-1
Syria,16/12/2007,28,0,-4,0,3,0,0,27
Syria,17/12/2007,0,0,-8,0,-3,0,0,-11
Syria,18/12/2007,20,0,-4,0,4,11,0,31
Syria,19/12/2007,2,0,0,0,3,0,0,5
Syria,20/12/2007,6,0,0,0,0,0,0,6
Syria,21/12/2007,7,0,0,0,0,0,0,7
Syria,22/12/2007,6,0,4,0,0,0,0,10
Syria,23/12/2007,16,0,0,0,0,0,0,16
Syria,24/12/2007,26,0,0,0,21,2,0,49
Syria,25/12/2007,6,0,0,0,7,1,0,14
Syria,26/12/2007,3,0,0,0,1,0,0,4
Syria,27/12/2007,0,0,0,0,0,0,0,0
Syria,28/12/2007,1,0,-2,0,0,0,0,-1
Syria,29/12/2007,51,0,0,0,0,0,0,51
Syria,30/12/2007,26,0,0,0,10,0,0,36
Syria,31/12/2007,-1,0,0,0,4,0,0,3
Yemen,01/12/2007,5,0,0,0,0,0,0,5
Yemen,02/12/2007,4,0,0,0,0,0,0,4
Yemen,03/12/2007,12,0,0,0,0,0,0,12
Yemen,04/12/2007,2,0,0,0,6,2,0,10
Yemen,05/12/2007,11,0,0,0,17,0,0,28
Yemen,06/12/2007,5,0,0,0,3,0,0,8
Yemen,07/12/2007,8,0,0,0,0,0,0,8
Yemen,08/12/2007,4,0,0,0,3,0,0,7
Yemen,09/12/2007,0,0,0,0,0,0,0,0
Yemen,10/12/2007,1,0,0,0,9,0,0,10
Yemen,11/12/2007,0,0,0,0,6,0,0,6
Yemen,12/12/2007,9,0,0,0,3,0,0,12
Yemen,13/12/2007,1,0,0,0,0,0,0,1
Yemen,14/12/2007,-1,0,0,0,0,0,0,-1
Yemen,15/12/2007,10,0,0,0,2,0,0,12
Yemen,16/12/2007,13,0,0,0,7,6,0,26
Yemen,17/12/2007,0,0,0,0,1,0,0,1
Yemen,18/12/2007,16,0,0,0,12,0,0,28
Yemen,19/12/2007,11,0,0,0,3,0,0,14
Yemen,20/12/2007,-2,0,0,0,19,2,0,19
Yemen,21/12/2007,18,0,0,0,1,0,0,19
Yemen,22/12/2007,6,0,0,0,12,2,0,20
Yemen,23/12/2007,1,0,0,0,0,0,0,1
Yemen,24/12/2007,0,0,0,0,3,0,0,3
Yemen,25/12/2007,-2,0,0,0,3,0,0,1
Yemen,26/12/2007,0,0,0,0,3,0,0,3
Yemen,27/12/2007,0,0,0,0,18,0,0,18
Yemen,31/12/2007,9,0,0,0,0,0,0,9
Afghanistan,01/09/2009,303,0,4,0,18,23,0,348
Afghanistan,02/09/2009,232,4,8,0,61,20,0,325
Afghanistan,03/09/2009,302,0,-11,0,83,25,0,399
Afghanistan,04/09/2009,653,2,-16,0,48,44,0,731
Afghanistan,05/09/2009,401,0,-10,0,1,72,0,464
Afghanistan,06/09/2009,335,0,0,0,26,38,0,399
Afghanistan,07/09/2009,308,0,1,0,48,56,0,413
Afghanistan,08/09/2009,379,2,-1,0,-5,34,0,409
Afghanistan,09/09/2009,447,2,-3,0,31,36,0,513
Afghanistan,10/09/2009,377,4,-1,0,58,20,0,458
Afghanistan,11/09/2009,428,10,-3,0,185,39,0,659
Afghanistan,12/09/2009,235,4,3,0,56,20,0,318
Afghanistan,13/09/2009,336,4,1,0,11,80,0,432
Afghanistan,14/09/2009,461,6,4,0,93,25,0,589
Afghanistan,15/09/2009,346,0,-6,0,55,14,0,409
Afghanistan,16/09/2009,535,2,-1,0,39,28,0,603
Afghanistan,17/09/2009,397,0,0,0,45,49,0,491
Afghanistan,18/09/2009,439,0,2,0,53,49,0,543
Afghanistan,19/09/2009,286,0,2,0,35,34,0,357
Afghanistan,20/09/2009,299,2,0,0,78,23,0,402
Afghanistan,21/09/2009,321,12,1,0,84,18,0,436
Afghanistan,22/09/2009,412,12,2,0,124,30,0,580
Afghanistan,23/09/2009,375,0,-6,0,39,21,0,429
Afghanistan,24/09/2009,410,0,1,0,170,42,0,623
Afghanistan,25/09/2009,417,2,-1,0,134,23,0,575
Afghanistan,26/09/2009,315,0,1,0,115,68,0,499
Afghanistan,27/09/2009,257,8,1,0,75,44,0,385
Afghanistan,28/09/2009,415,4,1,0,33,60,0,513
Afghanistan,29/09/2009,543,6,-4,0,103,37,0,685
Afghanistan,30/09/2009,458,0,-6,0,124,15,0,591
Albania,01/09/2009,7,0,1,0,0,0,0,8
Albania,02/09/2009,8,0,0,0,17,12,0,37
Albania,03/09/2009,21,0,0,0,6,6,0,33
Albania,04/09/2009,27,0,0,0,13,0,0,40
Albania,05/09/2009,4,0,0,0,6,1,0,11
Albania,06/09/2009,4,0,0,0,6,2,0,12
Albania,07/09/2009,-2,0,0,0,6,5,0,9
Albania,08/09/2009,14,0,0,0,15,4,0,33
Albania,09/09/2009,5,0,0,0,6,1,0,12
Albania,10/09/2009,4,0,0,0,1,1,0,6
Albania,11/09/2009,-2,0,0,0,3,8,0,9
Albania,12/09/2009,9,0,0,0,0,1,0,10
Albania,13/09/2009,0,0,0,0,0,1,0,1
Albania,14/09/2009,8,0,0,0,0,4,0,12
Albania,15/09/2009,-2,0,0,0,0,0,0,-2
Albania,16/09/2009,11,0,0,0,0,1,0,12
Albania,17/09/2009,13,0,0,0,0,6,0,19
Albania,18/09/2009,4,0,0,0,0,0,0,4
Albania,19/09/2009,0,0,0,0,0,0,0,0
Albania,20/09/2009,6,0,0,0,0,0,0,6
Albania,21/09/2009,6,0,0,0,0,0,0,6
Albania,22/09/2009,7,0,1,0,4,1,0,13
Albania,23/09/2009,23,0,-2,0,49,28,0,98
Albania,24/09/2009,0,0,-2,0,6,0,0,4
Albania,25/09/2009,1,0,0,0,0,0,0,1
Albania,26/09/2009,3,0,-6,0,0,0,0,-3
Albania,27/09/2009,-3,0,0,0,0,2,0,-1
Albania,28/09/2009,0,0,0,0,3,6,0,9
Albania,29/09/2009,0,0,0,0,0,0,0,0
Albania,30/09/2009,8,0,0,0,-3,0,0,5
Algeria,01/09/2009,14,0,0,0,11,0,0,25
Algeria,02/09/2009,13,0,0,0,7,0,0,20
Algeria,03/09/2009,11,0,0,0,0,6,0,17
Algeria,04/09/2009,2,0,0,0,0,0,0,2
Algeria,05/09/2009,3,0,0,0,6,2,0,11
Algeria,06/09/2009,4,0,0,0,-6,0,0,-2
Algeria,07/09/2009,7,0,0,0,0,0,0,7
Algeria,08/09/2009,6,0,0,0,3,0,0,9
Algeria,09/09/2009,-3,0,0,0,-3,0,0,-6
Algeria,10/09/2009,0,0,0,0,8,0,0,8
Algeria,11/09/2009,3,0,0,0,4,0,0,7
Algeria,12/09/2009,0,0,0,0,-4,0,0,-4
Algeria,13/09/2009,0,0,0,0,-2,0,0,-2
Algeria,14/09/2009,0,0,0,0,30,1,0,31
Algeria,15/09/2009,13,0,0,0,15,0,0,28
Algeria,16/09/2009,11,0,0,0,6,1,0,18
Algeria,17/09/2009,6,0,0,0,-2,0,0,4
Algeria,18/09/2009,8,0,0,0,0,0,0,8
Algeria,19/09/2009,2,0,0,0,0,0,0,2
Algeria,20/09/2009,2,0,0,0,0,0,0,2
Algeria,21/09/2009,8,0,2,0,18,1,0,29
Algeria,22/09/2009,0,0,0,0,8,0,0,8
Algeria,23/09/2009,0,0,0,0,0,0,0,0
Algeria,24/09/2009,2,0,0,0,3,0,0,5
Algeria,25/09/2009,7,0,0,0,0,0,0,7
Algeria,26/09/2009,1,0,0,0,3,2,0,6
Algeria,27/09/2009,0,0,0,0,0,0,0,0
Algeria,28/09/2009,0,0,0,0,-3,0,0,-3
Algeria,29/09/2009,4,0,0,0,-3,0,0,1
Algeria,30/09/2009,0,0,0,0,0,0,0,0
Bangladesh,01/09/2009,17,0,2,0,7,2,0,28
Bangladesh,02/09/2009,21,0,0,0,5,3,0,29
Bangladesh,03/09/2009,17,2,0,0,7,0,0,26
Bangladesh,04/09/2009,5,0,-1,0,-4,0,0,0
Bangladesh,05/09/2009,10,0,1,0,1,2,0,14
Bangladesh,06/09/2009,8,0,0,0,-1,4,0,11
Bangladesh,07/09/2009,19,0,0,0,11,0,0,30
Bangladesh,08/09/2009,25,0,0,0,0,1,0,26
Bangladesh,09/09/2009,16,0,0,0,-16,1,0,1
Bangladesh,10/09/2009,23,0,0,0,9,4,0,36
Bangladesh,11/09/2009,6,0,0,0,3,3,0,12
Bangladesh,12/09/2009,10,0,0,0,1,2,0,13
Bangladesh,13/09/2009,18,0,1,0,3,0,0,22
Bangladesh,14/09/2009,27,0,0,0,3,1,0,31
Bangladesh,15/09/2009,7,0,0,0,12,3,0,22
Bangladesh,16/09/2009,30,0,0,0,15,2,0,47
Bangladesh,17/09/2009,8,0,0,0,-2,0,0,6
Bangladesh,18/09/2009,3,0,0,0,10,0,0,13
Bangladesh,19/09/2009,5,0,0,0,6,0,0,11
Bangladesh,20/09/2009,5,0,0,0,0,4,0,9
Bangladesh,21/09/2009,5,2,0,0,4,0,0,11
Bangladesh,22/09/2009,-1,0,0,0,3,0,0,2
Bangladesh,23/09/2009,8,0,0,0,12,4,0,24
Bangladesh,24/09/2009,14,0,0,0,21,0,0,35
Bangladesh,25/09/2009,16,0,0,0,12,3,0,31
Bangladesh,26/09/2009,-5,0,0,0,9,2,0,6
Bangladesh,27/09/2009,5,2,0,0,1,0,0,8
Bangladesh,28/09/2009,19,0,0,0,6,1,0,26
Bangladesh,29/09/2009,4,0,0,0,3,1,0,8
Bangladesh,30/09/2009,8,0,-6,0,3,7,0,12
Cameroon,01/09/2009,3,0,0,0,0,0,0,3
Cameroon,02/09/2009,2,0,0,0,0,0,0,2
Cameroon,03/09/2009,6,0,0,0,0,0,0,6
Cameroon,04/09/2009,2,0,0,0,0,0,0,2
Cameroon,05/09/2009,0,0,0,0,-2,0,0,-2
Cameroon,06/09/2009,0,0,0,0,0,0,0,0
Cameroon,07/09/2009,0,0,0,0,0,0,0,0
Cameroon,08/09/2009,0,0,0,0,-2,0,0,-2
Cameroon,09/09/2009,2,0,0,0,-2,0,0,0
Cameroon,10/09/2009,0,0,0,0,0,0,0,0
Cameroon,12/09/2009,0,0,0,0,0,0,0,0
Cameroon,13/09/2009,3,0,0,0,0,0,0,3
Cameroon,14/09/2009,0,0,0,0,0,0,0,0
Cameroon,15/09/2009,0,0,0,0,0,0,0,0
Cameroon,16/09/2009,4,0,0,0,0,0,0,4
Cameroon,17/09/2009,10,0,0,0,0,0,0,10
Cameroon,18/09/2009,0,0,0,0,0,0,0,0
Cameroon,19/09/2009,1,0,0,0,0,0,0,1
Cameroon,20/09/2009,2,0,0,0,0,0,0,2
Cameroon,21/09/2009,3,0,0,0,-2,0,0,1
Cameroon,22/09/2009,1,0,0,0,-1,2,0,2
Cameroon,23/09/2009,0,0,0,0,-3,1,0,-2
Cameroon,24/09/2009,0,0,0,0,4,0,0,4
Cameroon,25/09/2009,1,0,0,0,0,0,0,1
Cameroon,26/09/2009,0,0,0,0,0,0,0,0
Cameroon,27/09/2009,0,0,0,0,3,0,0,3
Cameroon,28/09/2009,0,0,0,0,0,0,0,0
Cameroon,29/09/2009,-2,0,0,0,0,0,0,-2
Cameroon,30/09/2009,0,0,0,0,-2,0,0,-2
China,01/09/2009,133,4,4,0,64,38,0,243
China,02/09/2009,126,2,-6,0,89,18,0,229
China,03/09/2009,196,2,-9,0,83,51,0,323
China,04/09/2009,192,2,-29,0,83,45,0,293
China,05/09/2009,88,0,1,0,58,20,0,167
China,06/09/2009,103,2,-8,0,26,25,0,148
China,07/09/2009,206,0,1,0,94,8,0,309
China,08/09/2009,162,4,-1,0,57,15,0,237
China,09/09/2009,114,0,-11,0,125,25,0,253
China,10/09/2009,65,2,-1,0,49,15,0,130
China,11/09/2009,66,0,2,0,86,43,0,197
China,12/09/2009,68,0,1,0,33,20,0,122
China,13/09/2009,80,0,0,0,33,18,0,131
China,14/09/2009,74,0,-1,0,41,11,0,125
China,15/09/2009,49,0,-12,0,19,16,0,72
China,16/09/2009,150,2,-1,0,24,11,0,186
China,17/09/2009,177,0,2,0,74,34,0,287
China,18/09/2009,133,2,3,0,45,14,0,197
China,19/09/2009,98,0,-3,0,5,9,0,109
China,20/09/2009,80,0,2,0,-6,2,0,78
China,21/09/2009,146,0,0,0,26,13,0,185
China,22/09/2009,191,2,-3,0,46,11,0,247
China,23/09/2009,235,10,-11,0,127,27,0,388
China,24/09/2009,98,2,-1,0,47,18,0,164
China,25/09/2009,111,0,8,0,109,36,0,264
China,26/09/2009,75,4,0,0,27,15,0,121
China,27/09/2009,53,0,-6,0,30,15,0,92
China,28/09/2009,108,6,-10,0,31,8,0,143
China,29/09/2009,118,2,-2,0,31,8,0,157
China,30/09/2009,92,2,-2,0,43,11,0,146
Egypt,01/09/2009,20,0,0,0,23,0,0,43
Egypt,02/09/2009,36,0,2,0,12,0,0,50
Egypt,03/09/2009,14,0,2,0,13,2,0,31
Egypt,04/09/2009,3,0,0,0,9,5,0,17
Egypt,05/09/2009,15,0,2,0,-4,2,0,15
Egypt,06/09/2009,-4,0,0,0,21,0,0,17
Egypt,07/09/2009,13,0,0,0,15,0,0,28
Egypt,08/09/2009,25,0,0,0,22,2,0,49
Egypt,09/09/2009,52,0,1,0,10,2,0,65
Egypt,10/09/2009,47,0,-2,0,2,10,0,57
Egypt,11/09/2009,29,0,0,0,9,1,0,39
Egypt,12/09/2009,45,0,0,0,6,3,0,54
Egypt,13/09/2009,7,0,-1,0,12,0,0,18
Egypt,14/09/2009,61,0,0,0,15,0,0,76
Egypt,15/09/2009,30,0,0,0,12,0,0,42
Egypt,16/09/2009,42,0,-2,0,36,8,0,84
Egypt,17/09/2009,9,0,0,0,30,3,0,42
Egypt,18/09/2009,40,0,-6,0,-2,0,0,32
Egypt,19/09/2009,29,0,0,0,18,4,0,51
Egypt,20/09/2009,14,0,0,0,9,1,0,24
Egypt,21/09/2009,4,0,-4,0,2,2,0,4
Egypt,22/09/2009,35,4,-2,0,4,6,0,47
Egypt,23/09/2009,69,0,1,0,30,3,0,103
Egypt,24/09/2009,34,0,-2,0,18,4,0,54
Egypt,25/09/2009,18,0,0,0,3,6,0,27
Egypt,26/09/2009,61,0,0,0,-19,4,0,46
Egypt,27/09/2009,29,0,0,0,19,3,0,51
Egypt,28/09/2009,37,0,0,0,32,5,0,74
Egypt,29/09/2009,44,0,0,0,5,5,0,54
Egypt,30/09/2009,67,0,1,0,-19,11,0,60
Eritrea,01/09/2009,12,0,0,0,3,0,0,15
Eritrea,02/09/2009,0,0,0,0,0,0,0,0
Eritrea,03/09/2009,3,0,0,0,6,0,0,9
Eritrea,04/09/2009,8,0,0,0,2,0,0,10
Eritrea,05/09/2009,0,0,0,0,0,0,0,0
Eritrea,06/09/2009,2,0,0,0,-5,0,0,-3
Eritrea,07/09/2009,3,0,0,0,7,0,0,10
Eritrea,08/09/2009,-2,0,0,0,6,0,0,4
Eritrea,09/09/2009,20,0,0,0,0,0,0,20
Eritrea,10/09/2009,14,0,0,0,-2,0,0,12
Eritrea,11/09/2009,0,0,0,0,0,0,0,0
Eritrea,12/09/2009,0,0,0,0,6,0,0,6
Eritrea,13/09/2009,-10,0,0,0,3,0,0,-7
Eritrea,14/09/2009,-11,0,0,0,9,0,0,-2
Eritrea,15/09/2009,-4,0,1,0,0,0,0,-3
Eritrea,16/09/2009,4,0,0,0,3,0,0,7
Eritrea,17/09/2009,3,0,0,0,0,0,0,3
Eritrea,18/09/2009,0,0,0,0,-1,0,0,-1
Eritrea,19/09/2009,2,0,0,0,10,3,0,15
Eritrea,20/09/2009,14,0,0,0,0,0,0,14
Eritrea,21/09/2009,33,0,0,0,3,0,0,36
Eritrea,22/09/2009,3,0,0,0,4,0,0,7
Eritrea,23/09/2009,15,0,0,0,0,0,0,15
Eritrea,24/09/2009,3,0,0,0,9,0,0,12
Eritrea,25/09/2009,2,0,0,0,0,0,0,2
Eritrea,26/09/2009,0,0,0,0,0,0,0,0
Eritrea,27/09/2009,2,0,0,0,0,0,0,2
Eritrea,28/09/2009,5,0,0,0,6,0,0,11
Eritrea,29/09/2009,-2,0,0,0,15,0,0,13
Eritrea,30/09/2009,6,0,0,0,3,0,0,9
Georgia,01/09/2009,38,6,0,0,10,13,0,67
Georgia,02/09/2009,30,0,-2,0,17,4,0,49
Georgia,03/09/2009,17,0,-1,0,33,3,0,52
Georgia,04/09/2009,35,2,-4,0,11,3,0,47
Georgia,05/09/2009,20,0,0,0,16,1,0,37
Georgia,06/09/2009,24,0,0,0,3,0,0,27
Georgia,07/09/2009,47,0,0,0,5,1,0,53
Georgia,08/09/2009,21,0,0,0,15,7,0,43
Georgia,09/09/2009,18,0,2,0,12,4,0,36
Georgia,10/09/2009,18,0,5,0,6,1,0,30
Georgia,11/09/2009,31,0,0,0,36,6,0,73
Georgia,12/09/2009,32,2,0,0,0,6,0,40
Georgia,13/09/2009,17,0,0,0,0,2,0,19
Georgia,14/09/2009,19,0,0,0,13,3,0,35
Georgia,15/09/2009,22,0,0,0,12,3,0,37
Georgia,16/09/2009,39,2,2,0,20,4,0,67
Georgia,17/09/2009,38,0,-2,0,28,1,0,65
Georgia,18/09/2009,33,0,-4,0,15,4,0,48
Georgia,19/09/2009,14,0,0,0,8,1,0,23
Georgia,20/09/2009,5,0,0,0,3,0,0,8
Georgia,21/09/2009,15,2,3,0,21,5,0,46
Georgia,22/09/2009,24,0,0,0,-4,7,0,27
Georgia,23/09/2009,18,2,-1,0,17,5,0,41
Georgia,24/09/2009,25,0,-2,0,7,5,0,35
Georgia,25/09/2009,23,2,0,0,5,5,0,35
Georgia,26/09/2009,15,0,2,0,-2,3,0,18
Georgia,27/09/2009,12,0,0,0,1,0,0,13
Georgia,28/09/2009,14,0,1,0,3,2,0,20
Georgia,29/09/2009,20,0,0,0,46,6,0,72
Georgia,30/09/2009,47,0,-8,0,10,7,0,56
India,01/09/2009,51,0,-15,0,19,8,0,63
India,02/09/2009,60,2,-6,0,18,12,0,86
India,03/09/2009,56,0,-6,0,10,11,0,71
India,04/09/2009,49,0,-4,0,15,5,0,65
India,05/09/2009,31,0,0,0,16,4,0,51
India,06/09/2009,50,2,-1,0,21,7,0,79
India,07/09/2009,24,0,-3,0,8,14,0,43
India,08/09/2009,57,0,-2,0,18,17,0,90
India,09/09/2009,46,0,0,0,18,11,0,75
India,10/09/2009,28,0,0,0,-2,16,0,42
India,11/09/2009,49,0,0,0,7,7,0,63
India,12/09/2009,57,0,-3,0,6,10,0,70
India,13/09/2009,57,0,0,0,18,4,0,79
India,14/09/2009,67,0,-4,0,5,8,0,76
India,15/09/2009,37,0,-2,0,-9,6,0,32
India,16/09/2009,71,0,-3,0,12,12,0,92
India,17/09/2009,53,0,2,0,3,3,0,61
India,18/09/2009,67,0,-4,0,25,6,0,94
India,19/09/2009,69,0,1,0,3,3,0,76
India,20/09/2009,61,0,-17,0,19,8,0,71
India,21/09/2009,36,0,-3,0,1,1,0,35
India,22/09/2009,56,8,0,0,1,0,0,65
India,23/09/2009,86,0,-2,0,18,4,0,106
India,24/09/2009,73,0,0,0,7,7,0,87
India,25/09/2009,65,2,1,0,23,11,0,102
India,26/09/2009,61,0,0,0,3,8,0,72
India,27/09/2009,45,0,-1,0,7,4,0,55
India,28/09/2009,48,2,-3,0,19,3,0,69
India,29/09/2009,74,0,-1,0,7,13,0,93
India,30/09/2009,62,2,0,0,7,8,0,79
Iran,01/09/2009,102,0,-8,0,18,6,0,118
Iran,02/09/2009,71,0,5,0,59,7,0,142
Iran,03/09/2009,118,0,0,0,54,13,0,185
Iran,04/09/2009,14,0,0,0,10,4,0,28
Iran,05/09/2009,28,0,-4,0,34,5,0,63
Iran,06/09/2009,45,0,-4,0,18,2,0,61
Iran,07/09/2009,73,0,1,0,28,2,0,104
Iran,08/09/2009,147,0,-2,0,31,4,0,180
Iran,09/09/2009,106,0,0,0,31,4,0,141
Iran,10/09/2009,91,2,2,0,19,10,0,124
Iran,11/09/2009,82,0,-22,0,7,2,0,69
Iran,12/09/2009,72,8,1,0,25,31,0,137
Iran,13/09/2009,65,0,1,0,-3,8,0,71
Iran,14/09/2009,73,0,3,0,72,13,0,161
Iran,15/09/2009,62,0,0,0,24,3,0,89
Iran,16/09/2009,102,0,3,0,26,2,0,133
Iran,17/09/2009,268,0,0,0,64,14,0,346
Iran,18/09/2009,286,0,0,0,47,26,0,359
Iran,19/09/2009,162,0,1,0,17,4,0,184
Iran,20/09/2009,185,0,4,0,21,9,0,219
Iran,21/09/2009,117,0,-1,0,12,10,0,138
Iran,22/09/2009,121,0,1,0,56,10,0,188
Iran,23/09/2009,169,2,-6,0,181,50,0,396
Iran,24/09/2009,204,0,4,0,87,32,0,327
Iran,25/09/2009,184,6,4,0,19,19,0,232
Iran,26/09/2009,80,2,4,0,-2,12,0,96
Iran,27/09/2009,164,0,1,0,20,7,0,192
Iran,28/09/2009,185,0,2,0,28,6,0,221
Iran,29/09/2009,137,0,-3,0,46,10,0,190
Iran,30/09/2009,127,0,-2,0,31,9,0,165
Iraq,01/09/2009,82,2,0,0,24,8,0,116
Iraq,02/09/2009,91,2,-9,0,1,14,0,99
Iraq,03/09/2009,184,0,-3,0,19,5,0,205
Iraq,04/09/2009,85,0,1,0,41,12,0,139
Iraq,05/09/2009,33,0,0,0,13,2,0,48
Iraq,06/09/2009,45,2,0,0,12,3,0,62
Iraq,07/09/2009,105,0,0,0,37,18,0,160
Iraq,08/09/2009,138,4,-4,0,20,3,0,161
Iraq,09/09/2009,107,0,0,0,-4,11,0,114
Iraq,10/09/2009,228,0,-2,0,61,24,0,311
Iraq,11/09/2009,193,0,-1,0,50,16,0,258
Iraq,12/09/2009,121,0,0,0,13,15,0,149
Iraq,13/09/2009,77,2,0,0,17,22,0,118
Iraq,14/09/2009,121,0,0,0,20,16,0,157
Iraq,15/09/2009,103,0,1,0,18,34,0,156
Iraq,16/09/2009,120,0,0,0,27,27,0,174
Iraq,17/09/2009,132,0,0,0,1,13,0,146
Iraq,18/09/2009,75,2,0,0,41,5,0,123
Iraq,19/09/2009,70,0,-2,0,37,13,0,118
Iraq,20/09/2009,98,0,0,0,28,16,0,142
Iraq,21/09/2009,133,0,9,0,75,14,0,231
Iraq,22/09/2009,89,0,0,0,12,16,0,117
Iraq,23/09/2009,146,2,-2,0,74,7,0,227
Iraq,24/09/2009,136,0,2,0,37,20,0,195
Iraq,25/09/2009,146,0,6,0,48,9,0,209
Iraq,26/09/2009,87,0,3,0,11,7,0,108
Iraq,27/09/2009,71,0,4,0,-4,15,0,86
Iraq,28/09/2009,103,0,0,0,-4,3,0,102
Iraq,29/09/2009,90,0,0,0,38,7,0,135
Iraq,30/09/2009,52,0,-7,0,20,-2,0,63
Morocco,01/09/2009,10,0,0,0,1,1,0,12
Morocco,02/09/2009,3,0,0,0,12,1,0,16
Morocco,03/09/2009,9,0,-4,0,6,4,0,15
Morocco,04/09/2009,5,0,-8,0,0,7,0,4
Morocco,05/09/2009,2,0,0,0,0,12,0,14
Morocco,06/09/2009,2,0,0,0,3,0,0,5
Morocco,07/09/2009,5,0,0,0,-4,0,0,1
Morocco,08/09/2009,7,0,0,0,0,3,0,10
Morocco,09/09/2009,2,0,0,0,15,6,0,23
Morocco,10/09/2009,4,0,0,0,15,3,0,22
Morocco,11/09/2009,0,0,0,0,48,1,0,49
Morocco,12/09/2009,2,0,0,0,-2,0,0,0
Morocco,13/09/2009,0,0,0,0,-2,0,0,-2
Morocco,14/09/2009,0,0,0,0,7,0,0,7
Morocco,15/09/2009,0,0,0,0,3,0,0,3
Morocco,16/09/2009,1,0,0,0,0,0,0,1
Morocco,17/09/2009,1,0,0,0,0,0,0,1
Morocco,18/09/2009,3,0,0,0,1,1,0,5
Morocco,19/09/2009,0,0,0,0,0,0,0,0
Morocco,20/09/2009,3,0,0,0,1,0,0,4
Morocco,21/09/2009,1,0,0,0,24,0,0,25
Morocco,22/09/2009,2,0,-2,0,30,0,0,30
Morocco,23/09/2009,-7,0,-2,0,12,3,0,6
Morocco,24/09/2009,5,0,0,0,11,0,0,16
Morocco,25/09/2009,12,0,0,0,0,0,0,12
Morocco,26/09/2009,5,2,0,0,0,1,0,8
Morocco,27/09/2009,0,0,0,0,0,0,0,0
Morocco,28/09/2009,9,0,0,0,10,3,0,22
Morocco,29/09/2009,8,0,0,0,15,0,0,23
Morocco,30/09/2009,-1,0,0,0,0,0,0,-1
Nigeria,01/09/2009,16,0,0,0,9,4,0,29
Nigeria,02/09/2009,34,0,0,0,-1,9,0,42
Nigeria,03/09/2009,16,0,0,0,19,12,0,47
Nigeria,04/09/2009,6,0,0,0,22,5,0,33
Nigeria,05/09/2009,12,0,0,0,0,2,0,14
Nigeria,06/09/2009,16,0,3,0,4,1,0,24
Nigeria,07/09/2009,15,0,1,0,1,1,0,18
Nigeria,08/09/2009,20,0,0,0,0,2,0,22
Nigeria,09/09/2009,15,0,0,0,16,1,0,32
Nigeria,10/09/2009,18,0,0,0,11,0,0,29
Nigeria,11/09/2009,1,2,0,0,8,0,0,11
Nigeria,12/09/2009,2,0,0,0,3,2,0,7
Nigeria,13/09/2009,14,0,1,0,5,1,0,21
Nigeria,14/09/2009,25,0,0,0,25,0,0,50
Nigeria,15/09/2009,7,0,0,0,0,0,0,7
Nigeria,16/09/2009,6,0,-1,0,-4,2,0,3
Nigeria,17/09/2009,32,1,0,0,-1,0,0,32
Nigeria,18/09/2009,15,0,1,0,-2,0,0,14
Nigeria,19/09/2009,4,0,0,0,3,2,0,9
Nigeria,20/09/2009,8,0,0,0,3,3,0,14
Nigeria,21/09/2009,23,0,-1,0,33,0,0,55
Nigeria,22/09/2009,24,0,0,0,88,0,0,112
Nigeria,23/09/2009,36,2,0,0,6,3,0,47
Nigeria,24/09/2009,7,0,0,0,17,0,0,24
Nigeria,25/09/2009,10,0,0,0,26,0,0,36
Nigeria,26/09/2009,11,0,0,0,24,1,0,36
Nigeria,27/09/2009,13,0,0,0,9,8,0,30
Nigeria,28/09/2009,14,0,0,0,9,1,0,24
Nigeria,29/09/2009,59,0,0,0,7,24,0,90
Nigeria,30/09/2009,19,0,0,0,8,7,0,34
Pakistan,01/09/2009,55,2,-4,0,50,15,0,118
Pakistan,02/09/2009,101,0,0,0,21,13,0,135
Pakistan,03/09/2009,55,10,-2,0,31,8,0,102
Pakistan,04/09/2009,54,0,2,0,30,6,0,92
Pakistan,05/09/2009,82,0,1,0,3,1,0,87
Pakistan,06/09/2009,78,0,0,0,29,7,0,114
Pakistan,07/09/2009,74,0,-2,0,90,7,0,169
Pakistan,08/09/2009,248,0,-3,0,51,12,0,308
Pakistan,09/09/2009,154,0,0,0,21,5,0,180
Pakistan,10/09/2009,87,2,-2,0,62,10,0,159
Pakistan,11/09/2009,110,0,0,0,112,10,0,232
Pakistan,12/09/2009,148,0,1,0,33,23,0,205
Pakistan,13/09/2009,61,0,0,0,27,8,0,96
Pakistan,14/09/2009,118,0,0,0,71,1,0,190
Pakistan,15/09/2009,77,2,0,0,36,5,0,120
Pakistan,16/09/2009,110,0,1,0,33,10,0,154
Pakistan,17/09/2009,82,2,-1,0,5,12,0,100
Pakistan,18/09/2009,137,0,-4,0,12,15,0,160
Pakistan,19/09/2009,58,2,0,0,24,18,0,102
Pakistan,20/09/2009,85,0,6,0,75,8,0,174
Pakistan,21/09/2009,99,0,2,0,93,5,0,199
Pakistan,22/09/2009,92,6,1,0,42,10,0,151
Pakistan,23/09/2009,171,2,4,0,24,3,0,204
Pakistan,24/09/2009,130,2,3,0,50,2,0,187
Pakistan,25/09/2009,148,4,4,0,40,7,0,203
Pakistan,26/09/2009,43,0,0,0,30,7,0,80
Pakistan,27/09/2009,20,2,1,0,29,4,0,56
Pakistan,28/09/2009,149,0,3,0,34,15,0,201
Pakistan,29/09/2009,108,0,-3,0,25,8,0,138
Pakistan,30/09/2009,142,2,2,0,31,7,0,184
Sierra Leone,01/09/2009,5,0,0,0,3,1,0,9
Sierra Leone,02/09/2009,1,0,0,0,0,0,0,1
Sierra Leone,03/09/2009,0,0,0,0,0,0,0,0
Sierra Leone,04/09/2009,0,0,0,0,0,0,0,0
Sierra Leone,05/09/2009,0,0,0,0,6,0,0,6
Sierra Leone,06/09/2009,2,0,0,0,6,0,0,8
Sierra Leone,07/09/2009,0,0,0,0,-2,0,0,-2
Sierra Leone,08/09/2009,0,0,0,0,0,0,0,0
Sierra Leone,09/09/2009,46,0,0,0,6,0,0,52
Sierra Leone,10/09/2009,3,0,0,0,-2,1,0,2
Sierra Leone,11/09/2009,6,2,0,0,-3,1,0,6
Sierra Leone,12/09/2009,0,0,0,0,0,0,0,0
Sierra Leone,13/09/2009,0,0,0,0,0,0,0,0
Sierra Leone,14/09/2009,1,0,0,0,0,0,0,1
Sierra Leone,15/09/2009,-3,0,0,0,8,0,0,5
Sierra Leone,16/09/2009,4,0,0,0,0,0,0,4
Sierra Leone,17/09/2009,3,0,0,0,-4,1,0,0
Sierra Leone,18/09/2009,2,0,0,0,0,0,0,2
Sierra Leone,19/09/2009,0,0,0,0,0,0,0,0
Sierra Leone,20/09/2009,0,0,0,0,0,0,0,0
Sierra Leone,21/09/2009,-1,0,0,0,0,0,0,-1
Sierra Leone,22/09/2009,4,0,0,0,0,0,0,4
Sierra Leone,23/09/2009,9,0,0,0,0,1,0,10
Sierra Leone,24/09/2009,4,0,0,0,0,0,0,4
Sierra Leone,25/09/2009,1,0,0,0,3,0,0,4
Sierra Leone,26/09/2009,0,0,0,0,0,0,0,0
Sierra Leone,27/09/2009,0,0,0,0,0,0,0,0
Sierra Leone,28/09/2009,3,0,0,0,0,0,0,3
Sierra Leone,29/09/2009,7,0,0,0,0,0,0,7
Sierra Leone,30/09/2009,1,0,0,0,0,3,0,4
Somalia,01/09/2009,21,0,0,0,3,0,0,24
Somalia,02/09/2009,24,0,-4,0,19,0,0,39
Somalia,03/09/2009,7,0,0,0,2,2,0,11
Somalia,04/09/2009,18,0,1,0,8,2,0,29
Somalia,05/09/2009,7,0,0,0,3,1,0,11
Somalia,06/09/2009,5,0,0,0,7,6,0,18
Somalia,07/09/2009,16,0,0,0,15,0,0,31
Somalia,08/09/2009,36,0,0,0,23,0,0,59
Somalia,09/09/2009,54,0,0,0,-8,7,0,53
Somalia,10/09/2009,27,0,0,0,6,4,0,37
Somalia,11/09/2009,19,2,1,0,21,10,0,53
Somalia,12/09/2009,7,0,0,0,12,0,0,19
Somalia,13/09/2009,17,0,2,0,0,0,0,19
Somalia,14/09/2009,59,0,0,0,4,2,0,65
Somalia,15/09/2009,109,0,2,0,15,5,0,131
Somalia,16/09/2009,57,2,0,0,31,17,0,107
Somalia,17/09/2009,67,2,0,0,12,38,0,119
Somalia,18/09/2009,82,0,0,0,16,7,0,105
Somalia,19/09/2009,16,0,0,0,9,9,0,34
Somalia,20/09/2009,25,0,0,0,0,3,0,28
Somalia,21/09/2009,98,0,0,0,16,3,0,117
Somalia,22/09/2009,53,0,0,0,25,7,0,85
Somalia,23/09/2009,60,0,0,0,27,1,0,88
Somalia,24/09/2009,24,0,0,0,31,0,0,55
Somalia,25/09/2009,-2,0,0,0,6,0,0,4
Somalia,26/09/2009,31,0,0,0,27,0,0,58
Somalia,27/09/2009,15,0,0,0,18,0,0,33
Somalia,28/09/2009,43,0,0,0,10,7,0,60
Somalia,29/09/2009,34,0,0,0,30,3,0,67
Somalia,30/09/2009,51,0,-1,0,19,5,0,74
Syria,01/09/2009,12,0,0,0,3,0,0,15
Syria,02/09/2009,23,0,0,0,6,0,0,29
Syria,03/09/2009,34,2,0,0,6,0,0,42
Syria,04/09/2009,23,0,0,0,-5,4,0,22
Syria,05/09/2009,18,0,0,0,0,0,0,18
Syria,06/09/2009,42,2,0,0,34,3,0,81
Syria,07/09/2009,21,0,0,0,17,6,0,44
Syria,08/09/2009,54,0,-9,0,0,4,0,49
Syria,09/09/2009,25,0,-1,0,2,3,0,29
Syria,10/09/2009,28,0,0,0,3,2,0,33
Syria,11/09/2009,13,0,-1,0,0,0,0,12
Syria,12/09/2009,3,0,0,0,15,0,0,18
Syria,13/09/2009,0,0,0,0,6,1,0,7
Syria,14/09/2009,11,0,-6,0,25,1,0,31
Syria,15/09/2009,34,0,0,0,-14,0,0,20
Syria,16/09/2009,35,0,-6,0,13,1,0,43
Syria,17/09/2009,9,0,0,0,13,0,0,22
Syria,18/09/2009,34,0,0,0,27,9,0,70
Syria,19/09/2009,6,0,0,0,6,1,0,13
Syria,20/09/2009,2,0,0,0,1,2,0,5
Syria,21/09/2009,5,0,0,0,0,0,0,5
Syria,22/09/2009,5,0,0,0,9,2,0,16
Syria,23/09/2009,4,0,0,0,9,1,0,14
Syria,24/09/2009,22,0,0,0,3,4,0,29
Syria,25/09/2009,37,0,0,0,9,1,0,47
Syria,26/09/2009,16,0,0,0,15,2,0,33
Syria,27/09/2009,17,0,1,0,0,2,0,20
Syria,28/09/2009,22,0,0,0,3,2,0,27
Syria,29/09/2009,24,0,0,0,6,4,0,34
Syria,30/09/2009,23,0,1,0,6,1,0,31
Yemen,01/09/2009,15,2,0,0,0,10,0,27
Yemen,02/09/2009,55,14,0,0,22,9,0,100
Yemen,03/09/2009,14,0,0,0,4,0,0,18
Yemen,04/09/2009,47,2,0,0,0,1,0,50
Yemen,05/09/2009,9,0,0,0,3,0,0,12
Yemen,06/09/2009,7,0,0,0,7,0,0,14
Yemen,07/09/2009,49,0,0,0,-3,0,0,46
Yemen,08/09/2009,49,0,0,0,6,0,0,55
Yemen,09/09/2009,6,0,0,0,0,0,0,6
Yemen,10/09/2009,14,0,1,0,9,6,0,30
Yemen,11/09/2009,28,0,0,0,1,1,0,30
Yemen,12/09/2009,5,0,0,0,-1,0,0,4
Yemen,13/09/2009,2,0,0,0,13,0,0,15
Yemen,14/09/2009,16,0,0,0,10,0,0,26
Yemen,15/09/2009,32,0,0,0,4,0,0,36
Yemen,16/09/2009,6,0,0,0,0,1,0,7
Yemen,17/09/2009,77,0,0,0,-2,0,0,75
Yemen,18/09/2009,110,0,0,0,3,2,0,115
Yemen,19/09/2009,35,0,0,0,0,3,0,38
Yemen,20/09/2009,25,0,0,0,0,0,0,25
Yemen,21/09/2009,90,0,0,0,0,0,0,90
Yemen,22/09/2009,19,2,0,0,3,1,0,25
Yemen,23/09/2009,3,0,0,0,0,18,0,21
Yemen,24/09/2009,21,0,0,0,0,11,0,32
Yemen,25/09/2009,11,0,0,0,2,0,0,13
Yemen,26/09/2009,40,0,0,0,13,0,0,53
Yemen,27/09/2009,18,2,0,0,13,2,0,35
Yemen,28/09/2009,27,0,0,0,12,1,0,40
Yemen,29/09/2009,29,0,0,0,-3,1,0,27
Yemen,30/09/2009,37,0,0,0,19,8,0,64
Afghanistan,01/08/2010,218,0,-2,0,40,27,0,283
Afghanistan,02/08/2010,233,0,2,0,49,23,0,307
Afghanistan,03/08/2010,320,0,5,0,84,49,0,458
Afghanistan,04/08/2010,284,10,0,0,63,27,0,384
Afghanistan,05/08/2010,227,2,1,0,39,11,0,280
Afghanistan,06/08/2010,281,4,1,0,41,19,0,346
Afghanistan,07/08/2010,213,6,-1,0,13,17,0,248
Afghanistan,08/08/2010,255,8,1,0,36,24,0,324
Afghanistan,09/08/2010,327,8,0,0,96,18,0,449
Afghanistan,10/08/2010,345,12,0,0,120,42,0,519
Afghanistan,11/08/2010,259,18,0,0,71,11,0,359
Afghanistan,12/08/2010,354,12,2,0,164,56,0,588
Afghanistan,13/08/2010,236,0,-1,0,51,8,0,294
Afghanistan,14/08/2010,30,0,0,0,19,4,0,53
Afghanistan,15/08/2010,118,0,1,0,5,15,0,139
Afghanistan,16/08/2010,156,0,-22,0,26,18,0,178
Afghanistan,17/08/2010,235,4,-3,0,93,47,0,376
Afghanistan,18/08/2010,246,2,-2,0,36,14,0,296
Afghanistan,19/08/2010,179,0,0,0,4,7,0,190
Afghanistan,20/08/2010,135,0,0,0,15,3,0,153
Afghanistan,21/08/2010,277,4,1,0,99,86,0,467
Afghanistan,22/08/2010,207,4,2,0,77,38,0,328
Afghanistan,23/08/2010,334,6,1,0,69,48,0,458
Afghanistan,24/08/2010,320,6,1,0,47,29,0,403
Afghanistan,25/08/2010,405,2,1,0,62,40,0,510
Afghanistan,26/08/2010,321,4,2,0,82,40,0,449
Afghanistan,27/08/2010,244,0,-13,0,82,11,0,324
Afghanistan,28/08/2010,284,0,-3,0,47,16,0,344
Afghanistan,29/08/2010,256,0,1,0,47,13,0,317
Afghanistan,30/08/2010,323,0,-2,0,53,12,0,386
Afghanistan,31/08/2010,455,0,-1,0,27,8,0,489
Albania,01/08/2010,2,0,0,0,0,1,0,3
Albania,02/08/2010,3,0,0,0,-3,0,0,0
Albania,03/08/2010,9,0,-3,0,22,0,0,28
Albania,04/08/2010,1,0,-2,0,8,0,0,7
Albania,05/08/2010,11,0,0,0,4,0,0,15
Albania,06/08/2010,2,0,0,0,0,0,0,2
Albania,07/08/2010,0,0,0,0,9,0,0,9
Albania,08/08/2010,0,0,0,0,0,0,0,0
Albania,09/08/2010,5,0,0,0,6,0,0,11
Albania,10/08/2010,-7,0,0,0,10,0,0,3
Albania,11/08/2010,3,0,-3,0,6,0,0,6
Albania,12/08/2010,0,0,-2,0,0,0,0,-2
Albania,13/08/2010,3,0,0,0,0,0,0,3
Albania,14/08/2010,0,0,0,0,0,0,0,0
Albania,15/08/2010,0,0,0,0,0,0,0,0
Albania,16/08/2010,3,0,0,0,-4,0,0,-1
Albania,17/08/2010,3,0,0,0,0,0,0,3
Albania,18/08/2010,4,0,0,0,12,8,0,24
Albania,19/08/2010,6,0,-1,0,3,0,0,8
Albania,20/08/2010,2,0,0,0,0,0,0,2
Albania,21/08/2010,10,0,-1,0,7,0,0,16
Albania,22/08/2010,0,0,0,0,0,0,0,0
Albania,23/08/2010,17,0,0,0,13,0,0,30
Albania,24/08/2010,23,0,0,0,21,2,0,46
Albania,25/08/2010,21,0,-2,0,12,2,0,33
Albania,26/08/2010,5,0,0,0,3,1,0,9
Albania,27/08/2010,11,0,0,0,3,0,0,14
Albania,28/08/2010,-1,0,0,0,3,3,0,5
Albania,30/08/2010,0,0,0,0,-2,6,0,4
Albania,31/08/2010,8,0,0,0,12,0,0,20
Algeria,01/08/2010,3,0,0,0,0,0,0,3
Algeria,02/08/2010,10,0,0,0,9,0,0,19
Algeria,03/08/2010,2,0,0,0,0,0,0,2
Algeria,04/08/2010,5,0,0,0,0,0,0,5
Algeria,05/08/2010,2,0,0,0,0,0,0,2
Algeria,06/08/2010,9,0,0,0,9,1,0,19
Algeria,07/08/2010,0,0,0,0,3,0,0,3
Algeria,08/08/2010,5,0,0,0,18,6,0,29
Algeria,09/08/2010,7,0,0,0,0,2,0,9
Algeria,10/08/2010,1,0,0,0,0,0,0,1
Algeria,11/08/2010,4,0,0,0,3,0,0,7
Algeria,12/08/2010,12,0,0,0,3,0,0,15
Algeria,13/08/2010,18,0,0,0,0,0,0,18
Algeria,14/08/2010,0,0,0,0,0,0,0,0
Algeria,15/08/2010,2,0,0,0,0,0,0,2
Algeria,16/08/2010,16,0,0,0,34,1,0,51
Algeria,17/08/2010,5,0,0,0,-4,3,0,4
Algeria,18/08/2010,8,0,-2,0,-1,6,0,11
Algeria,19/08/2010,5,0,0,0,0,0,0,5
Algeria,20/08/2010,-1,0,0,0,3,0,0,2
Algeria,21/08/2010,14,0,-1,0,3,0,0,16
Algeria,22/08/2010,4,0,0,0,0,0,0,4
Algeria,23/08/2010,22,0,0,0,27,2,0,51
Algeria,24/08/2010,4,0,-1,0,0,0,0,3
Algeria,25/08/2010,26,0,0,0,3,19,0,48
Algeria,26/08/2010,17,0,0,0,6,0,0,23
Algeria,27/08/2010,4,0,0,0,0,0,0,4
Algeria,28/08/2010,9,0,0,0,6,0,0,15
Algeria,29/08/2010,6,0,0,0,0,0,0,6
Algeria,30/08/2010,0,0,0,0,0,0,0,0
Algeria,31/08/2010,44,0,0,0,3,0,0,47
Bangladesh,01/08/2010,5,2,1,0,6,0,0,14
Bangladesh,02/08/2010,4,0,0,0,12,2,0,18
Bangladesh,03/08/2010,22,2,0,0,16,3,0,43
Bangladesh,04/08/2010,26,0,0,0,30,0,0,56
Bangladesh,05/08/2010,23,0,-4,0,16,4,0,39
Bangladesh,06/08/2010,4,0,0,0,1,2,0,7
Bangladesh,07/08/2010,3,2,-1,0,18,1,0,23
Bangladesh,08/08/2010,9,0,0,0,-2,0,0,7
Bangladesh,09/08/2010,36,0,0,0,45,5,0,86
Bangladesh,10/08/2010,13,0,0,0,55,1,0,69
Bangladesh,11/08/2010,22,0,-6,0,7,0,0,23
Bangladesh,12/08/2010,8,0,0,0,14,0,0,22
Bangladesh,13/08/2010,2,0,0,0,15,1,0,18
Bangladesh,14/08/2010,1,0,0,0,0,0,0,1
Bangladesh,15/08/2010,12,0,0,0,3,0,0,15
Bangladesh,16/08/2010,12,0,0,0,3,2,0,17
Bangladesh,17/08/2010,14,2,0,0,7,6,0,29
Bangladesh,18/08/2010,29,2,0,0,25,4,0,60
Bangladesh,19/08/2010,16,0,0,0,40,1,0,57
Bangladesh,20/08/2010,-2,0,0,0,3,1,0,2
Bangladesh,21/08/2010,34,0,4,0,23,1,0,62
Bangladesh,22/08/2010,16,0,0,0,15,0,0,31
Bangladesh,23/08/2010,33,0,0,0,19,2,0,54
Bangladesh,24/08/2010,19,0,0,0,9,1,0,29
Bangladesh,25/08/2010,16,0,0,0,21,3,0,40
Bangladesh,26/08/2010,39,0,0,0,60,7,0,106
Bangladesh,27/08/2010,37,0,0,0,25,2,0,64
Bangladesh,28/08/2010,6,0,0,0,3,2,0,11
Bangladesh,29/08/2010,10,2,1,0,37,2,0,52
Bangladesh,30/08/2010,1,0,0,0,13,3,0,17
Bangladesh,31/08/2010,5,0,0,0,9,2,0,16
Cameroon,01/08/2010,0,0,0,0,0,0,0,0
Cameroon,02/08/2010,2,0,0,0,9,3,0,14
Cameroon,03/08/2010,0,0,0,0,3,0,0,3
Cameroon,04/08/2010,0,0,0,0,0,0,0,0
Cameroon,05/08/2010,2,0,0,0,6,0,0,8
Cameroon,06/08/2010,0,0,0,0,3,0,0,3
Cameroon,08/08/2010,5,0,0,0,3,0,0,8
Cameroon,09/08/2010,0,0,0,0,0,0,0,0
Cameroon,10/08/2010,0,0,0,0,0,0,0,0
Cameroon,11/08/2010,5,0,0,0,0,0,0,5
Cameroon,12/08/2010,5,2,0,0,-4,0,0,3
Cameroon,13/08/2010,1,0,0,0,0,0,0,1
Cameroon,15/08/2010,0,0,0,0,0,1,0,1
Cameroon,16/08/2010,0,0,0,0,3,1,0,4
Cameroon,17/08/2010,0,0,0,0,0,1,0,1
Cameroon,18/08/2010,0,0,0,0,0,0,0,0
Cameroon,19/08/2010,6,0,0,0,6,0,0,12
Cameroon,20/08/2010,0,0,0,0,0,0,0,0
Cameroon,21/08/2010,3,0,0,0,3,0,0,6
Cameroon,22/08/2010,0,0,0,0,3,1,0,4
Cameroon,23/08/2010,3,0,0,0,-5,0,0,-2
Cameroon,24/08/2010,5,0,0,0,0,0,0,5
Cameroon,25/08/2010,6,0,0,0,0,0,0,6
Cameroon,26/08/2010,5,0,0,0,0,0,0,5
Cameroon,27/08/2010,5,0,0,0,0,0,0,5
Cameroon,29/08/2010,0,0,0,0,0,0,0,0
Cameroon,30/08/2010,0,0,0,0,0,0,0,0
Cameroon,31/08/2010,0,0,0,0,3,0,0,3
China,01/08/2010,60,0,-1,0,49,12,0,120
China,02/08/2010,70,0,3,0,23,29,0,125
China,03/08/2010,142,0,-2,0,79,15,0,234
China,04/08/2010,136,2,-11,0,63,28,0,218
China,05/08/2010,124,0,-4,0,38,13,0,171
China,06/08/2010,165,0,-3,0,45,9,0,216
China,07/08/2010,58,4,0,0,25,9,0,96
China,08/08/2010,53,0,-1,0,97,8,0,157
China,09/08/2010,135,6,8,0,203,16,0,368
China,10/08/2010,159,2,-5,0,221,32,0,409
China,11/08/2010,158,2,-4,0,58,24,0,238
China,12/08/2010,125,4,-11,0,27,14,0,159
China,13/08/2010,95,0,-6,0,47,15,0,151
China,14/08/2010,12,0,0,0,6,0,0,18
China,15/08/2010,89,2,4,0,32,8,0,135
China,16/08/2010,164,0,1,0,31,13,0,209
China,17/08/2010,176,6,2,0,37,21,0,242
China,18/08/2010,180,2,0,0,59,23,0,264
China,19/08/2010,172,0,-5,0,44,15,0,226
China,20/08/2010,91,2,1,0,37,11,0,142
China,21/08/2010,89,2,0,0,71,13,0,175
China,22/08/2010,39,0,2,0,30,15,0,86
China,23/08/2010,252,0,-5,0,140,43,0,430
China,24/08/2010,230,0,-6,0,91,43,0,358
China,25/08/2010,255,4,-11,0,126,23,0,397
China,26/08/2010,166,0,4,0,34,16,0,220
China,27/08/2010,225,6,-5,0,62,19,0,307
China,28/08/2010,121,4,0,0,54,7,0,186
China,29/08/2010,99,6,0,0,51,5,0,161
China,30/08/2010,169,2,1,0,89,25,0,286
China,31/08/2010,182,6,3,0,36,24,0,251
Egypt,01/08/2010,86,0,0,0,3,2,0,91
Egypt,02/08/2010,227,0,0,0,7,16,0,250
Egypt,03/08/2010,73,0,0,0,34,0,0,107
Egypt,04/08/2010,239,0,2,0,18,15,0,274
Egypt,05/08/2010,63,0,0,0,7,3,0,73
Egypt,06/08/2010,43,0,1,0,4,4,0,52
Egypt,07/08/2010,33,0,0,0,6,4,0,43
Egypt,08/08/2010,37,0,0,0,6,0,0,43
Egypt,09/08/2010,62,0,0,0,16,5,0,83
Egypt,10/08/2010,50,0,1,0,31,3,0,85
Egypt,11/08/2010,40,0,2,0,3,1,0,46
Egypt,12/08/2010,25,0,-1,0,24,1,0,49
Egypt,13/08/2010,41,0,0,0,12,0,0,53
Egypt,14/08/2010,7,0,0,0,0,2,0,9
Egypt,15/08/2010,57,0,0,0,11,0,0,68
Egypt,16/08/2010,9,0,0,0,15,5,0,29
Egypt,17/08/2010,24,0,0,0,48,2,0,74
Egypt,18/08/2010,77,0,1,0,13,1,0,92
Egypt,19/08/2010,28,0,0,0,10,5,0,43
Egypt,20/08/2010,2,0,0,0,9,0,0,11
Egypt,21/08/2010,-14,0,-2,0,21,1,0,6
Egypt,22/08/2010,12,0,0,0,9,2,0,23
Egypt,23/08/2010,37,0,0,0,8,3,0,48
Egypt,24/08/2010,43,0,0,0,22,5,0,70
Egypt,25/08/2010,26,2,0,0,19,2,0,49
Egypt,26/08/2010,25,0,0,0,2,13,0,40
Egypt,27/08/2010,3,0,0,0,14,4,0,21
Egypt,28/08/2010,16,0,0,0,108,2,0,126
Egypt,29/08/2010,26,0,-1,0,-4,0,0,21
Egypt,30/08/2010,30,0,1,0,22,1,0,54
Egypt,31/08/2010,37,0,0,0,1,3,0,41
Eritrea,01/08/2010,5,0,0,0,0,5,0,10
Eritrea,02/08/2010,2,0,0,0,-2,1,0,1
Eritrea,03/08/2010,-2,0,0,0,0,0,0,-2
Eritrea,04/08/2010,0,0,0,0,6,0,0,6
Eritrea,05/08/2010,14,0,0,0,0,0,0,14
Eritrea,06/08/2010,1,0,0,0,-4,0,0,-3
Eritrea,07/08/2010,1,0,0,0,0,2,0,3
Eritrea,08/08/2010,2,0,0,0,-4,0,0,-2
Eritrea,09/08/2010,0,0,0,0,0,0,0,0
Eritrea,10/08/2010,20,0,0,0,-4,0,0,16
Eritrea,11/08/2010,11,0,0,0,0,1,0,12
Eritrea,12/08/2010,-1,0,-2,0,0,1,0,-2
Eritrea,13/08/2010,6,0,0,0,9,0,0,15
Eritrea,14/08/2010,51,0,0,0,0,2,0,53
Eritrea,15/08/2010,63,0,0,0,-2,4,0,65
Eritrea,16/08/2010,21,0,0,0,0,0,0,21
Eritrea,17/08/2010,2,2,0,0,2,1,0,7
Eritrea,18/08/2010,3,0,2,0,27,2,0,34
Eritrea,19/08/2010,2,0,0,0,0,0,0,2
Eritrea,20/08/2010,7,0,0,0,0,0,0,7
Eritrea,21/08/2010,6,0,0,0,0,0,0,6
Eritrea,22/08/2010,0,0,0,0,3,0,0,3
Eritrea,23/08/2010,3,0,0,0,0,0,0,3
Eritrea,24/08/2010,15,0,2,0,17,5,0,39
Eritrea,25/08/2010,-2,0,0,0,0,0,0,-2
Eritrea,26/08/2010,0,0,0,0,3,0,0,3
Eritrea,27/08/2010,-4,4,0,0,0,0,0,0
Eritrea,28/08/2010,2,0,0,0,45,0,0,47
Eritrea,29/08/2010,0,0,0,0,0,0,0,0
Eritrea,30/08/2010,16,0,0,0,-2,0,0,14
Eritrea,31/08/2010,0,0,0,0,12,0,0,12
Georgia,01/08/2010,9,0,1,0,0,2,0,12
Georgia,02/08/2010,21,4,0,0,3,0,0,28
Georgia,03/08/2010,37,18,0,0,9,4,0,68
Georgia,04/08/2010,56,0,-4,0,42,9,0,103
Georgia,05/08/2010,37,2,-2,0,29,1,0,67
Georgia,06/08/2010,31,2,0,0,45,14,0,92
Georgia,07/08/2010,11,0,0,0,6,11,0,28
Georgia,08/08/2010,19,0,0,0,-1,4,0,22
Georgia,09/08/2010,42,0,-6,0,16,6,0,58
Georgia,10/08/2010,45,0,0,0,30,15,0,90
Georgia,11/08/2010,53,0,1,0,18,4,0,76
Georgia,12/08/2010,41,0,-2,0,29,2,0,70
Georgia,13/08/2010,6,0,0,0,2,5,0,13
Georgia,15/08/2010,13,0,1,0,2,0,0,16
Georgia,16/08/2010,29,0,-1,0,37,4,0,69
Georgia,17/08/2010,71,0,4,0,9,4,0,88
Georgia,18/08/2010,51,0,1,0,13,5,0,70
Georgia,19/08/2010,59,0,1,0,28,3,0,91
Georgia,20/08/2010,29,0,0,0,19,3,0,51
Georgia,21/08/2010,12,0,0,0,0,1,0,13
Georgia,22/08/2010,11,0,0,0,0,2,0,13
Georgia,23/08/2010,41,0,1,0,0,3,0,45
Georgia,24/08/2010,108,0,0,0,20,8,0,136
Georgia,25/08/2010,64,2,-2,0,24,9,0,97
Georgia,26/08/2010,13,0,0,0,25,1,0,39
Georgia,27/08/2010,3,0,0,0,9,3,0,15
Georgia,28/08/2010,24,0,0,0,-4,1,0,21
Georgia,29/08/2010,12,4,0,0,16,0,0,32
Georgia,30/08/2010,47,0,0,0,12,5,0,64
Georgia,31/08/2010,52,2,1,0,9,8,0,72
India,01/08/2010,100,0,-1,0,37,13,0,149
India,02/08/2010,88,0,-1,0,22,34,0,143
India,03/08/2010,112,0,-3,0,29,11,0,149
India,04/08/2010,146,0,2,0,54,48,0,250
India,05/08/2010,117,2,2,0,31,25,0,177
India,06/08/2010,97,12,-3,0,45,20,0,171
India,07/08/2010,85,8,-1,0,48,4,0,144
India,08/08/2010,94,4,-5,0,122,16,0,231
India,09/08/2010,76,6,-8,0,25,4,0,103
India,10/08/2010,137,8,-7,0,30,13,0,181
India,11/08/2010,77,4,-3,0,14,6,0,98
India,12/08/2010,107,2,-4,0,18,11,0,134
India,13/08/2010,43,2,-6,0,14,5,0,58
India,14/08/2010,5,0,0,0,0,0,0,5
India,15/08/2010,58,0,0,0,9,3,0,70
India,16/08/2010,50,0,0,0,4,9,0,63
India,17/08/2010,79,2,-2,0,11,7,0,97
India,18/08/2010,148,0,-1,0,29,9,0,185
India,19/08/2010,82,8,1,0,31,7,0,129
India,20/08/2010,65,8,-2,0,23,7,0,101
India,21/08/2010,70,2,-3,0,46,14,0,129
India,22/08/2010,50,2,0,0,12,16,0,80
India,23/08/2010,65,0,-1,0,38,9,0,111
India,24/08/2010,91,0,0,0,1,8,0,100
India,25/08/2010,148,2,-1,0,29,23,0,201
India,26/08/2010,51,2,-2,0,35,7,0,93
India,27/08/2010,53,2,0,0,18,3,0,76
India,28/08/2010,61,2,2,0,16,7,0,88
India,29/08/2010,64,0,1,0,30,19,0,114
India,30/08/2010,79,0,0,0,46,4,0,129
India,31/08/2010,110,6,0,0,-4,10,0,122
Iran,01/08/2010,119,0,-4,0,35,17,0,167
Iran,02/08/2010,93,0,3,0,102,14,0,212
Iran,03/08/2010,141,0,0,0,162,17,0,320
Iran,04/08/2010,141,2,3,0,76,43,0,265
Iran,05/08/2010,106,0,0,0,17,8,0,131
Iran,06/08/2010,63,0,-4,0,19,10,0,88
Iran,07/08/2010,67,0,0,0,28,26,0,121
Iran,08/08/2010,74,0,-2,0,67,14,0,153
Iran,09/08/2010,67,2,1,0,13,13,0,96
Iran,10/08/2010,86,0,4,0,24,8,0,122
Iran,11/08/2010,80,0,2,0,43,2,0,127
Iran,12/08/2010,60,0,3,0,80,9,0,152
Iran,13/08/2010,49,0,0,0,46,8,0,103
Iran,14/08/2010,23,0,-2,0,3,0,0,24
Iran,15/08/2010,77,4,-6,0,22,5,0,102
Iran,16/08/2010,98,0,-15,0,43,53,0,179
Iran,17/08/2010,117,2,1,0,51,16,0,187
Iran,18/08/2010,121,2,0,0,35,11,0,169
Iran,19/08/2010,89,0,0,0,41,14,0,144
Iran,20/08/2010,41,0,0,0,13,3,0,57
Iran,21/08/2010,61,0,-1,0,34,4,0,98
Iran,22/08/2010,74,2,-4,0,15,2,0,89
Iran,23/08/2010,95,0,0,0,36,17,0,148
Iran,24/08/2010,122,10,0,0,38,16,0,186
Iran,25/08/2010,99,2,-2,0,35,24,0,158
Iran,26/08/2010,87,2,-2,0,90,11,0,188
Iran,27/08/2010,82,4,0,0,161,1,0,248
Iran,28/08/2010,97,0,1,0,142,3,0,243
Iran,29/08/2010,89,0,0,0,9,4,0,102
Iran,30/08/2010,43,0,0,0,14,12,0,69
Iran,31/08/2010,130,2,3,0,20,17,0,172
Iraq,01/08/2010,162,0,0,0,40,9,0,211
Iraq,02/08/2010,123,0,4,0,35,9,0,171
Iraq,03/08/2010,94,2,-1,0,50,10,0,155
Iraq,04/08/2010,70,8,-2,0,8,3,0,87
Iraq,05/08/2010,109,0,1,0,29,16,0,155
Iraq,06/08/2010,186,0,-3,0,24,9,0,216
Iraq,07/08/2010,68,0,0,0,-1,9,0,76
Iraq,08/08/2010,70,2,1,0,36,2,0,111
Iraq,09/08/2010,133,0,1,0,22,17,0,173
Iraq,10/08/2010,127,0,-2,0,7,14,0,146
Iraq,11/08/2010,190,0,-3,0,19,18,0,224
Iraq,12/08/2010,130,0,0,0,43,6,0,179
Iraq,13/08/2010,87,0,0,0,35,13,0,135
Iraq,14/08/2010,5,0,0,0,0,0,0,5
Iraq,15/08/2010,69,0,0,0,20,5,0,94
Iraq,16/08/2010,158,0,-4,0,26,15,0,195
Iraq,17/08/2010,147,12,-4,0,50,18,0,223
Iraq,18/08/2010,202,0,1,0,23,9,0,235
Iraq,19/08/2010,304,2,0,0,31,23,0,360
Iraq,20/08/2010,123,0,1,0,17,11,0,152
Iraq,21/08/2010,192,0,1,0,29,27,0,249
Iraq,22/08/2010,219,14,0,0,53,37,0,323
Iraq,23/08/2010,219,4,0,0,19,16,0,258
Iraq,24/08/2010,190,0,-2,0,1,10,0,199
Iraq,25/08/2010,258,0,3,0,54,13,0,328
Iraq,26/08/2010,235,2,0,0,30,25,0,292
Iraq,27/08/2010,135,0,4,0,67,12,0,218
Iraq,28/08/2010,107,0,2,0,63,13,0,185
Iraq,29/08/2010,151,0,-2,0,6,23,0,178
Iraq,30/08/2010,258,0,4,0,21,28,0,311
Iraq,31/08/2010,665,0,3,0,46,50,0,764
Morocco,01/08/2010,8,0,0,0,0,0,0,8
Morocco,02/08/2010,2,0,-2,0,-2,0,0,-2
Morocco,03/08/2010,3,0,-2,0,1,0,0,2
Morocco,04/08/2010,4,0,0,0,6,0,0,10
Morocco,05/08/2010,7,0,0,0,-4,0,0,3
Morocco,06/08/2010,10,0,2,0,0,0,0,12
Morocco,07/08/2010,0,0,0,0,0,0,0,0
Morocco,08/08/2010,0,0,0,0,0,0,0,0
Morocco,09/08/2010,7,0,0,0,9,0,0,16
Morocco,10/08/2010,4,0,0,0,0,2,0,6
Morocco,11/08/2010,0,0,0,0,0,0,0,0
Morocco,12/08/2010,24,0,2,0,3,6,0,35
Morocco,13/08/2010,4,0,0,0,6,0,0,10
Morocco,15/08/2010,7,0,0,0,0,2,0,9
Morocco,16/08/2010,3,0,0,0,0,0,0,3
Morocco,17/08/2010,3,0,0,0,0,1,0,4
Morocco,18/08/2010,14,0,0,0,12,8,0,34
Morocco,19/08/2010,12,0,-1,0,6,1,0,18
Morocco,20/08/2010,7,0,0,0,-4,0,0,3
Morocco,21/08/2010,9,0,0,0,0,3,0,12
Morocco,22/08/2010,0,0,0,0,0,0,0,0
Morocco,23/08/2010,23,0,0,0,42,3,0,68
Morocco,24/08/2010,9,0,0,0,24,0,0,33
Morocco,25/08/2010,9,0,0,0,3,0,0,12
Morocco,26/08/2010,3,0,0,0,3,0,0,6
Morocco,27/08/2010,3,0,0,0,0,0,0,3
Morocco,28/08/2010,-1,0,0,0,0,0,0,-1
Morocco,29/08/2010,0,0,-1,0,36,3,0,38
Morocco,30/08/2010,13,0,0,0,23,2,0,38
Morocco,31/08/2010,16,0,0,0,27,3,0,46
Nigeria,01/08/2010,7,0,2,0,7,6,0,22
Nigeria,02/08/2010,14,0,-2,0,20,7,0,39
Nigeria,03/08/2010,41,2,1,0,19,6,0,69
Nigeria,04/08/2010,20,0,-1,0,13,2,0,34
Nigeria,05/08/2010,21,4,0,0,10,1,0,36
Nigeria,06/08/2010,36,0,-4,0,17,0,0,49
Nigeria,07/08/2010,6,0,-4,0,6,0,0,8
Nigeria,08/08/2010,26,0,0,0,13,2,0,41
Nigeria,09/08/2010,30,2,0,0,6,5,0,43
Nigeria,10/08/2010,18,0,0,0,6,7,0,31
Nigeria,11/08/2010,34,0,0,0,21,6,0,61
Nigeria,12/08/2010,43,0,-1,0,2,6,0,50
Nigeria,13/08/2010,10,0,0,0,16,2,0,28
Nigeria,14/08/2010,5,0,0,0,-2,0,0,3
Nigeria,15/08/2010,27,2,-4,0,12,2,0,39
Nigeria,16/08/2010,45,0,-2,0,8,4,0,55
Nigeria,17/08/2010,9,0,0,0,57,3,0,69
Nigeria,18/08/2010,32,0,0,0,21,5,0,58
Nigeria,19/08/2010,55,0,1,0,8,2,0,66
Nigeria,20/08/2010,17,0,-3,0,-6,0,0,8
Nigeria,21/08/2010,29,0,-3,0,12,5,0,43
Nigeria,22/08/2010,17,2,0,0,6,8,0,33
Nigeria,23/08/2010,13,0,1,0,11,3,0,28
Nigeria,24/08/2010,30,0,0,0,49,0,0,79
Nigeria,25/08/2010,21,0,-2,0,4,4,0,27
Nigeria,26/08/2010,33,0,0,0,10,0,0,43
Nigeria,27/08/2010,21,0,0,0,18,2,0,41
Nigeria,28/08/2010,25,0,-1,0,22,0,0,46
Nigeria,29/08/2010,56,0,0,0,19,3,0,78
Nigeria,30/08/2010,39,0,0,0,14,4,0,57
Nigeria,31/08/2010,28,0,0,0,28,2,0,58
Pakistan,01/08/2010,132,0,0,0,58,12,0,202
Pakistan,02/08/2010,171,4,-3,0,49,57,0,278
Pakistan,03/08/2010,218,6,4,0,24,28,0,280
Pakistan,04/08/2010,226,0,1,0,116,23,0,366
Pakistan,05/08/2010,169,10,0,0,93,12,0,284
Pakistan,06/08/2010,180,10,-1,0,51,9,0,249
Pakistan,07/08/2010,232,54,-2,0,38,17,0,339
Pakistan,08/08/2010,220,22,2,0,33,9,0,286
Pakistan,09/08/2010,180,12,0,0,44,11,0,247
Pakistan,10/08/2010,182,10,0,0,68,16,0,276
Pakistan,11/08/2010,197,42,-1,0,77,16,0,331
Pakistan,12/08/2010,198,34,0,0,63,13,0,308
Pakistan,13/08/2010,167,18,0,0,4,9,0,198
Pakistan,14/08/2010,26,8,0,0,6,2,0,42
Pakistan,15/08/2010,83,26,2,0,23,6,0,140
Pakistan,16/08/2010,86,20,-2,0,-6,5,0,103
Pakistan,17/08/2010,98,26,6,0,27,19,0,176
Pakistan,18/08/2010,168,42,-2,0,5,14,0,227
Pakistan,19/08/2010,240,62,0,0,36,12,0,350
Pakistan,20/08/2010,108,44,-3,0,15,5,0,169
Pakistan,21/08/2010,128,16,1,0,14,6,0,165
Pakistan,22/08/2010,128,16,0,0,33,11,0,188
Pakistan,23/08/2010,128,28,1,0,13,5,0,175
Pakistan,24/08/2010,137,34,-3,0,5,10,0,183
Pakistan,25/08/2010,162,20,-2,0,19,34,0,233
Pakistan,26/08/2010,212,14,-3,0,80,29,0,332
Pakistan,27/08/2010,139,14,5,0,22,17,0,197
Pakistan,28/08/2010,121,4,3,0,54,46,0,228
Pakistan,29/08/2010,90,16,0,0,51,25,0,182
Pakistan,30/08/2010,138,18,0,0,20,28,0,204
Pakistan,31/08/2010,249,20,3,0,14,27,0,313
Sierra Leone,01/08/2010,0,2,0,0,9,0,0,11
Sierra Leone,02/08/2010,17,0,-2,0,12,2,0,29
Sierra Leone,03/08/2010,34,0,0,0,13,2,0,49
Sierra Leone,04/08/2010,60,0,0,0,1,6,0,67
Sierra Leone,05/08/2010,112,8,0,0,64,12,0,196
Sierra Leone,06/08/2010,46,4,0,0,14,11,0,75
Sierra Leone,07/08/2010,6,0,0,0,-3,1,0,4
Sierra Leone,08/08/2010,13,0,0,0,0,0,0,13
Sierra Leone,09/08/2010,63,2,5,0,-6,7,0,71
Sierra Leone,10/08/2010,42,0,7,0,8,8,0,65
Sierra Leone,11/08/2010,29,0,0,0,20,6,0,55
Sierra Leone,12/08/2010,19,0,0,0,24,9,0,52
Sierra Leone,13/08/2010,5,0,1,0,10,2,0,18
Sierra Leone,15/08/2010,0,0,0,0,3,1,0,4
Sierra Leone,16/08/2010,1,0,0,0,0,0,0,1
Sierra Leone,17/08/2010,8,0,0,0,0,1,0,9
Sierra Leone,18/08/2010,14,0,0,0,-1,1,0,14
Sierra Leone,19/08/2010,7,0,-16,0,6,0,0,-3
Sierra Leone,20/08/2010,7,0,0,0,13,0,0,20
Sierra Leone,21/08/2010,6,0,0,0,-5,2,0,3
Sierra Leone,22/08/2010,0,0,-4,0,-2,1,0,-5
Sierra Leone,23/08/2010,1,0,0,0,0,0,0,1
Sierra Leone,24/08/2010,3,0,0,0,6,1,0,10
Sierra Leone,25/08/2010,11,0,0,0,0,0,0,11
Sierra Leone,26/08/2010,15,0,0,0,3,0,0,18
Sierra Leone,27/08/2010,0,0,0,0,0,0,0,0
Sierra Leone,28/08/2010,0,0,0,0,0,0,0,0
Sierra Leone,29/08/2010,0,0,0,0,3,0,0,3
Sierra Leone,30/08/2010,4,0,0,0,3,0,0,7
Sierra Leone,31/08/2010,2,0,0,0,3,0,0,5
Somalia,01/08/2010,16,2,0,0,3,1,0,22
Somalia,02/08/2010,65,0,0,0,1,0,0,66
Somalia,03/08/2010,41,0,0,0,12,1,0,54
Somalia,04/08/2010,60,2,0,0,24,0,0,86
Somalia,05/08/2010,72,22,0,0,134,2,0,230
Somalia,06/08/2010,81,14,0,0,73,0,0,168
Somalia,07/08/2010,22,0,0,0,0,12,0,34
Somalia,08/08/2010,17,6,0,0,-16,2,0,9
Somalia,09/08/2010,50,2,0,0,48,2,0,102
Somalia,10/08/2010,30,6,0,0,48,3,0,87
Somalia,11/08/2010,33,6,0,0,3,0,0,42
Somalia,12/08/2010,19,0,0,0,17,0,0,36
Somalia,13/08/2010,29,0,0,0,-9,0,0,20
Somalia,14/08/2010,3,0,0,0,6,0,0,9
Somalia,15/08/2010,45,0,0,0,12,0,0,57
Somalia,16/08/2010,42,0,0,0,9,7,0,58
Somalia,17/08/2010,19,4,0,0,36,7,0,66
Somalia,18/08/2010,11,0,0,0,24,9,0,44
Somalia,19/08/2010,9,0,0,0,9,4,0,22
Somalia,20/08/2010,9,2,0,0,4,0,0,15
Somalia,21/08/2010,3,0,0,0,1,0,0,4
Somalia,22/08/2010,3,0,0,0,31,0,0,34
Somalia,23/08/2010,3,0,0,0,14,8,0,25
Somalia,24/08/2010,45,0,0,0,4,23,0,72
Somalia,25/08/2010,62,0,1,0,13,5,0,81
Somalia,26/08/2010,37,0,0,0,21,10,0,68
Somalia,27/08/2010,68,2,-1,0,27,5,0,101
Somalia,28/08/2010,67,0,3,0,12,0,0,82
Somalia,29/08/2010,17,0,0,0,1,1,0,19
Somalia,30/08/2010,39,0,0,0,11,6,0,56
Somalia,31/08/2010,19,0,0,0,4,5,0,28
Syria,01/08/2010,23,0,0,0,18,6,0,47
Syria,02/08/2010,22,0,0,0,15,1,0,38
Syria,03/08/2010,81,0,0,0,12,5,0,98
Syria,04/08/2010,49,0,0,0,16,0,0,65
Syria,05/08/2010,22,0,0,0,13,1,0,36
Syria,06/08/2010,16,0,0,0,18,1,0,35
Syria,07/08/2010,6,4,0,0,1,0,0,11
Syria,08/08/2010,20,4,0,0,3,0,0,27
Syria,09/08/2010,14,0,0,0,4,7,0,25
Syria,10/08/2010,14,4,0,0,6,2,0,26
Syria,11/08/2010,6,0,0,0,0,0,0,6
Syria,12/08/2010,14,0,0,0,6,0,0,20
Syria,13/08/2010,0,0,0,0,-1,0,0,-1
Syria,14/08/2010,0,0,0,0,0,0,0,0
Syria,15/08/2010,15,0,0,0,1,5,0,21
Syria,16/08/2010,15,0,0,0,8,0,0,23
Syria,17/08/2010,5,0,0,0,6,2,0,13
Syria,18/08/2010,29,0,0,0,-2,0,0,27
Syria,19/08/2010,29,0,0,0,0,-2,0,27
Syria,20/08/2010,19,0,0,0,-2,0,0,17
Syria,21/08/2010,14,0,0,0,6,0,0,20
Syria,22/08/2010,15,0,0,0,4,1,0,20
Syria,23/08/2010,28,0,0,0,3,0,0,31
Syria,24/08/2010,18,0,0,0,9,6,0,33
Syria,25/08/2010,63,0,0,0,10,4,0,77
Syria,26/08/2010,32,0,0,0,8,2,0,42
Syria,27/08/2010,19,0,0,0,21,0,0,40
Syria,28/08/2010,9,0,0,0,3,0,0,12
Syria,29/08/2010,7,0,1,0,-4,4,0,8
Syria,30/08/2010,34,0,0,0,20,4,0,58
Syria,31/08/2010,7,0,0,0,0,2,0,9
Yemen,01/08/2010,26,0,0,0,-2,0,0,24
Yemen,02/08/2010,7,0,0,0,0,0,0,7
Yemen,03/08/2010,32,0,-1,0,7,24,0,62
Yemen,04/08/2010,13,0,0,0,0,2,0,15
Yemen,05/08/2010,20,0,0,0,6,0,0,26
Yemen,06/08/2010,34,0,0,0,18,4,0,56
Yemen,07/08/2010,17,0,0,0,24,3,0,44
Yemen,08/08/2010,5,0,0,0,-2,0,0,3
Yemen,09/08/2010,16,0,0,0,-2,6,0,20
Yemen,10/08/2010,18,0,0,0,10,0,0,28
Yemen,11/08/2010,12,0,0,0,0,4,0,16
Yemen,12/08/2010,15,0,0,0,1,0,0,16
Yemen,13/08/2010,3,0,0,0,-2,0,0,1
Yemen,14/08/2010,0,0,0,0,0,0,0,0
Yemen,15/08/2010,7,0,0,0,0,2,0,9
Yemen,16/08/2010,5,0,0,0,-3,2,0,4
Yemen,17/08/2010,15,0,0,0,2,0,0,17
Yemen,18/08/2010,3,0,0,0,18,7,0,28
Yemen,19/08/2010,12,0,0,0,6,1,0,19
Yemen,20/08/2010,15,0,0,0,1,0,0,16
Yemen,21/08/2010,70,0,0,0,1,0,0,71
Yemen,22/08/2010,53,0,0,0,0,0,0,53
Yemen,23/08/2010,19,0,0,0,3,0,0,22
Yemen,24/08/2010,30,0,0,0,46,0,0,76
Yemen,25/08/2010,67,0,1,0,20,14,0,102
Yemen,26/08/2010,58,0,0,0,2,9,0,69
Yemen,27/08/2010,61,0,0,0,24,8,0,93
Yemen,28/08/2010,31,2,0,0,3,0,0,36
Yemen,29/08/2010,18,0,0,0,3,0,0,21
Yemen,30/08/2010,33,0,0,0,31,4,0,68
Yemen,31/08/2010,49,0,0,0,57,2,0,108