country,year_month,Conflict,Economic,Governance,Political,Social,push_factor_index
Afghanistan,2010-05-01,128,0,1,19,17,165
Afghanistan,2010-05-01,197,0,-8,24,39,252
Afghanistan,2010-05-01,303,0,0,16,31,350
Afghanistan,2010-05-01,159,2,1,52,39,253
Afghanistan,2010-05-01,153,0,-2,28,8,187
Afghanistan,2010-05-01,27,0,0,6,1,34
Afghanistan,2010-05-01,7,0,0,6,1,14
Afghanistan,2010-05-01,34,0,1,12,0,47
Afghanistan,2010-05-01,59,0,0,9,0,68
Afghanistan,2010-05-01,74,0,0,21,10,105
Afghanistan,2010-05-01,147,0,1,49,8,205
Afghanistan,2010-05-01,158,0,0,24,31,213
Afghanistan,2010-05-01,27,0,0,1,8,36
Afghanistan,2010-05-01,39,0,0,5,0,44
Afghanistan,2010-05-01,48,4,2,16,0,70
Afghanistan,2010-05-01,74,2,0,18,2,96
Afghanistan,2010-05-01,95,0,0,29,5,129
Afghanistan,2010-05-01,67,2,-5,9,17,90
Afghanistan,2010-05-01,112,0,1,12,16,141
Afghanistan,2010-05-01,20,0,0,-3,2,19
Afghanistan,2010-05-01,53,0,0,12,7,72
Afghanistan,2010-05-01,110,0,0,15,0,125
Afghanistan,2010-05-01,213,2,0,54,11,280
Afghanistan,2010-05-01,39,0,0,1,1,41
Afghanistan,2010-05-01,150,2,0,6,17,175
Afghanistan,2010-05-01,164,0,1,11,24,200
Afghanistan,2010-05-01,129,0,4,9,9,151
Afghanistan,2010-05-01,91,2,0,9,2,104
Afghanistan,2010-05-01,193,2,0,21,11,227
Afghanistan,2010-05-01,94,0,0,41,16,151
Afghanistan,2010-05-01,54,0,1,6,2,63
Albania,2010-05-01,2,0,0,3,8,13
Albania,2010-05-01,0,0,0,18,0,18
Albania,2010-05-01,5,0,0,3,0,8
Albania,2010-05-01,2,0,-2,0,0,0
Albania,2010-05-01,2,0,-1,0,0,1
Albania,2010-05-01,0,0,0,0,4,4
Albania,2010-05-01,0,0,-4,0,2,-2
Albania,2010-05-01,51,0,-2,12,1,62
Albania,2010-05-01,26,0,0,6,0,32
Albania,2010-05-01,56,0,0,6,0,62
Albania,2010-05-01,8,0,1,0,3,12
Albania,2010-05-01,3,0,0,0,0,3
Albania,2010-05-01,0,0,0,0,0,0
Albania,2010-05-01,7,0,0,0,0,7
Albania,2010-05-01,4,0,-6,6,5,9
Albania,2010-05-01,29,0,1,9,2,41
Albania,2010-05-01,12,0,0,4,4,20
Albania,2010-05-01,1,0,0,0,2,3
Albania,2010-05-01,5,0,0,3,0,8
Albania,2010-05-01,5,0,0,6,0,11
Albania,2010-05-01,5,0,1,0,0,6
Albania,2010-05-01,3,0,0,0,0,3
Albania,2010-05-01,0,0,0,0,0,0
Albania,2010-05-01,0,0,0,0,0,0
Albania,2010-05-01,32,0,0,3,17,52
Albania,2010-05-01,0,0,0,0,0,0
Algeria,2010-05-01,18,0,0,6,0,24
Algeria,2010-05-01,17,0,0,0,0,17
Algeria,2010-05-01,4,0,1,21,0,26
Algeria,2010-05-01,2,0,-1,0,0,1
Algeria,2010-05-01,0,0,0,0,0,0
Algeria,2010-05-01,0,0,0,0,0,0
Algeria,2010-05-01,0,0,0,0,0,0
Algeria,2010-05-01,0,0,0,0,0,0
Algeria,2010-05-01,0,0,0,1,0,1
Algeria,2010-05-01,-1,0,0,1,0,0
Algeria,2010-05-01,4,0,0,0,0,4
Algeria,2010-05-01,0,0,0,9,0,9
Algeria,2010-05-01,0,0,0,-6,0,-6
Algeria,2010-05-01,1,0,0,16,0,17
Algeria,2010-05-01,0,0,0,0,0,0
Algeria,2010-05-01,0,0,0,-4,0,-4
Algeria,2010-05-01,0,0,0,7,0,7
Algeria,2010-05-01,1,0,0,12,0,13
Algeria,2010-05-01,1,0,0,9,0,10
Algeria,2010-05-01,2,0,0,0,0,2
Algeria,2010-05-01,5,0,0,0,1,6
Algeria,2010-05-01,0,0,0,0,1,1
Algeria,2010-05-01,5,0,0,-1,0,4
Algeria,2010-05-01,0,0,0,0,0,0
Algeria,2010-05-01,0,0,0,9,0,9
Algeria,2010-05-01,2,0,0,1,0,3
Algeria,2010-05-01,4,0,0,0,0,4
Algeria,2010-05-01,1,0,0,0,0,1
Algeria,2010-05-01,0,0,0,3,0,3
Algeria,2010-05-01,3,0,0,0,0,3
Algeria,2010-05-01,32,0,0,0,2,34
Bangladesh,2010-05-01,11,0,-3,2,0,10
Bangladesh,2010-05-01,18,0,0,4,0,22
Bangladesh,2010-05-01,28,0,-2,0,5,31
Bangladesh,2010-05-01,1,0,0,3,1,5
Bangladesh,2010-05-01,5,4,-4,21,1,27
Bangladesh,2010-05-01,0,0,0,-3,0,-3
Bangladesh,2010-05-01,3,0,0,0,0,3
Bangladesh,2010-05-01,0,0,0,0,0,0
Bangladesh,2010-05-01,-1,0,0,0,0,-1
Bangladesh,2010-05-01,4,0,0,12,0,16
Bangladesh,2010-05-01,6,0,0,1,0,7
Bangladesh,2010-05-01,3,0,0,0,0,3
Bangladesh,2010-05-01,4,0,0,0,0,4
Bangladesh,2010-05-01,0,0,0,0,0,0
Bangladesh,2010-05-01,2,0,0,-1,0,1
Bangladesh,2010-05-01,26,0,0,3,0,29
Bangladesh,2010-05-01,6,0,0,-1,0,5
Bangladesh,2010-05-01,-2,0,0,0,0,-2
Bangladesh,2010-05-01,3,0,0,3,0,6
Bangladesh,2010-05-01,6,0,0,0,0,6
Bangladesh,2010-05-01,2,0,0,0,0,2
Bangladesh,2010-05-01,3,0,0,0,0,3
Bangladesh,2010-05-01,2,0,0,0,1,3
Bangladesh,2010-05-01,1,0,0,2,0,3
Bangladesh,2010-05-01,2,0,0,-4,0,-2
Bangladesh,2010-05-01,2,0,0,-2,2,2
Bangladesh,2010-05-01,6,0,0,15,5,26
Bangladesh,2010-05-01,3,0,0,7,0,10
Bangladesh,2010-05-01,19,0,2,22,0,43
Bangladesh,2010-05-01,10,0,3,25,9,47
Bangladesh,2010-05-01,0,0,0,0,0,0
Cameroon,2010-05-01,3,0,0,0,0,3
Cameroon,2010-05-01,3,0,0,6,0,9
Cameroon,2010-05-01,0,0,0,0,0,0
Cameroon,2010-05-01,0,0,0,0,0,0
Cameroon,2010-05-01,0,0,0,0,0,0
Cameroon,2010-05-01,0,0,0,0,0,0
Cameroon,2010-05-01,2,0,0,0,0,2
Cameroon,2010-05-01,5,0,0,1,0,6
Cameroon,2010-05-01,0,0,0,0,0,0
Cameroon,2010-05-01,0,0,0,4,0,4
Cameroon,2010-05-01,0,0,0,6,0,6
Cameroon,2010-05-01,2,0,0,0,0,2
Cameroon,2010-05-01,2,0,0,3,0,5
Cameroon,2010-05-01,3,0,0,0,0,3
Cameroon,2010-05-01,0,0,0,0,0,0
Cameroon,2010-05-01,0,0,0,0,0,0
Cameroon,2010-05-01,0,0,0,0,0,0
China,2010-05-01,44,2,0,10,12,68
China,2010-05-01,92,0,-2,13,7,110
China,2010-05-01,55,2,-4,47,25,125
China,2010-05-01,32,0,0,47,7,86
China,2010-05-01,67,0,-2,39,22,126
China,2010-05-01,13,0,0,5,0,18
China,2010-05-01,12,0,0,15,0,27
China,2010-05-01,5,0,0,12,0,17
China,2010-05-01,-4,0,0,3,2,1
China,2010-05-01,12,0,1,-1,3,15
China,2010-05-01,43,0,-1,5,8,55
China,2010-05-01,58,4,0,4,20,86
China,2010-05-01,23,0,0,15,4,42
China,2010-05-01,37,0,0,14,3,54
China,2010-05-01,44,2,0,70,2,118
China,2010-05-01,8,0,0,21,1,30
China,2010-05-01,43,0,1,21,5,70
China,2010-05-01,50,0,0,32,8,90
China,2010-05-01,77,2,-1,27,3,108
China,2010-05-01,40,0,0,2,2,44
China,2010-05-01,14,0,-1,12,9,34
China,2010-05-01,51,2,3,24,4,84
China,2010-05-01,26,0,2,20,2,50
China,2010-05-01,5,0,1,17,2,25
China,2010-05-01,25,0,0,11,12,48
China,2010-05-01,82,0,0,15,5,102
China,2010-05-01,13,0,0,-1,4,16
China,2010-05-01,30,2,0,23,6,61
China,2010-05-01,69,0,0,-6,2,65
China,2010-05-01,70,0,0,16,0,86
China,2010-05-01,-8,0,0,6,4,2
Egypt,2010-05-01,54,0,0,10,4,68
Egypt,2010-05-01,56,0,0,4,6,66
Egypt,2010-05-01,29,0,-1,18,6,52
Egypt,2010-05-01,19,0,1,21,0,41
Egypt,2010-05-01,13,0,0,27,0,40
Egypt,2010-05-01,6,0,0,0,0,6
Egypt,2010-05-01,9,0,0,2,18,29
Egypt,2010-05-01,10,0,0,3,4,17
Egypt,2010-05-01,8,0,0,12,0,20
Egypt,2010-05-01,22,0,0,15,0,37
Egypt,2010-05-01,19,0,0,-2,0,17
Egypt,2010-05-01,12,0,0,-5,5,12
Egypt,2010-05-01,9,0,0,15,14,38
Egypt,2010-05-01,21,0,1,21,0,43
Egypt,2010-05-01,22,0,0,3,0,25
Egypt,2010-05-01,17,0,0,0,0,17
Egypt,2010-05-01,21,0,0,18,2,41
Egypt,2010-05-01,30,0,0,0,0,30
Egypt,2010-05-01,12,0,0,8,6,26
Egypt,2010-05-01,14,0,0,4,5,23
Egypt,2010-05-01,6,0,0,9,5,20
Egypt,2010-05-01,19,0,0,3,1,23
Egypt,2010-05-01,17,0,1,9,0,27
Egypt,2010-05-01,6,0,0,3,0,9
Egypt,2010-05-01,11,0,0,-5,1,7
Egypt,2010-05-01,17,2,-3,3,2,21
Egypt,2010-05-01,11,0,0,6,0,17
Egypt,2010-05-01,15,0,0,0,0,15
Egypt,2010-05-01,37,0,0,3,6,46
Egypt,2010-05-01,35,0,0,-2,3,36
Egypt,2010-05-01,62,0,-6,3,0,59
Eritrea,2010-05-01,0,0,0,3,0,3
Eritrea,2010-05-01,1,0,0,12,0,13
Eritrea,2010-05-01,0,0,0,22,2,24
Eritrea,2010-05-01,0,0,0,6,0,6
Eritrea,2010-05-01,4,0,0,15,0,19
Eritrea,2010-05-01,0,0,0,0,0,0
Eritrea,2010-05-01,-2,0,0,0,0,-2
Eritrea,2010-05-01,1,0,0,6,0,7
Eritrea,2010-05-01,0,8,0,0,0,8
Eritrea,2010-05-01,3,8,0,0,0,11
Eritrea,2010-05-01,0,0,0,0,0,0
Eritrea,2010-05-01,0,0,0,-8,0,-8
Eritrea,2010-05-01,6,0,0,0,0,6
Eritrea,2010-05-01,0,0,0,0,0,0
Eritrea,2010-05-01,-3,0,0,0,0,-3
Eritrea,2010-05-01,0,0,0,3,0,3
Eritrea,2010-05-01,0,0,0,0,0,0
Eritrea,2010-05-01,3,0,0,0,0,3
Eritrea,2010-05-01,20,0,0,3,2,25
Eritrea,2010-05-01,12,0,0,0,0,12
Eritrea,2010-05-01,0,0,0,0,0,0
Eritrea,2010-05-01,0,0,0,0,0,0
Eritrea,2010-05-01,3,0,0,0,0,3
Eritrea,2010-05-01,0,0,0,6,0,6
Eritrea,2010-05-01,0,0,0,0,0,0
Eritrea,2010-05-01,0,0,0,0,0,0
Eritrea,2010-05-01,1,0,0,0,0,1
Georgia,2010-05-01,13,0,0,4,1,18
Georgia,2010-05-01,6,0,0,3,0,9
Georgia,2010-05-01,23,0,3,17,3,46
Georgia,2010-05-01,10,2,0,0,0,12
Georgia,2010-05-01,1,0,0,13,2,16
Georgia,2010-05-01,0,0,0,0,0,0
Georgia,2010-05-01,7,0,0,6,0,13
Georgia,2010-05-01,3,0,0,0,0,3
Georgia,2010-05-01,3,0,0,0,1,4
Georgia,2010-05-01,2,0,0,0,0,2
Georgia,2010-05-01,1,0,0,6,1,8
Georgia,2010-05-01,8,4,0,9,3,24
Georgia,2010-05-01,14,0,1,-1,0,14
Georgia,2010-05-01,3,0,-4,-2,0,-3
Georgia,2010-05-01,1,0,0,-2,0,-1
Georgia,2010-05-01,0,0,0,0,0,0
Georgia,2010-05-01,3,0,0,0,0,3
Georgia,2010-05-01,6,0,0,9,0,15
Georgia,2010-05-01,6,0,0,4,4,14
Georgia,2010-05-01,0,0,0,0,0,0
Georgia,2010-05-01,5,0,0,3,2,10
Georgia,2010-05-01,34,0,0,4,1,39
Georgia,2010-05-01,2,0,0,0,0,2
Georgia,2010-05-01,0,0,0,1,0,1
Georgia,2010-05-01,-1,0,0,-1,0,-2
Georgia,2010-05-01,21,0,0,7,2,30
Georgia,2010-05-01,2,0,0,3,0,5
Georgia,2010-05-01,10,0,0,6,0,16
Georgia,2010-05-01,16,0,0,6,1,23
Georgia,2010-05-01,9,0,0,7,0,16
Georgia,2010-05-01,3,0,0,0,0,3
India,2010-05-01,48,0,-1,1,4,52
India,2010-05-01,55,0,1,7,5,68
India,2010-05-01,60,0,-4,15,3,74
India,2010-05-01,15,0,-2,2,1,16
India,2010-05-01,51,0,0,9,2,62
India,2010-05-01,2,0,-1,0,0,1
India,2010-05-01,28,2,0,0,1,31
India,2010-05-01,4,0,0,0,0,4
India,2010-05-01,23,0,0,12,0,35
India,2010-05-01,25,0,0,3,0,28
India,2010-05-01,13,0,0,-4,1,10
India,2010-05-01,4,0,0,6,2,12
India,2010-05-01,17,0,0,3,3,23
India,2010-05-01,23,0,0,10,3,36
India,2010-05-01,25,0,0,3,2,30
India,2010-05-01,28,2,-1,9,0,38
India,2010-05-01,51,0,-1,0,3,53
India,2010-05-01,41,0,-4,16,2,55
India,2010-05-01,6,0,0,-2,0,4
India,2010-05-01,21,0,-2,-4,1,16
India,2010-05-01,47,0,-1,13,1,60
India,2010-05-01,52,0,0,5,2,59
India,2010-05-01,6,0,-5,9,2,12
India,2010-05-01,15,0,-12,13,7,23
India,2010-05-01,36,0,0,3,0,39
India,2010-05-01,27,0,-1,13,2,41
India,2010-05-01,29,0,-2,-2,5,30
India,2010-05-01,45,0,0,4,5,54
India,2010-05-01,13,0,-3,1,0,11
India,2010-05-01,4,0,-4,6,6,12
Iran,2010-05-01,71,0,2,45,9,127
Iran,2010-05-01,75,2,1,34,8,120
Iran,2010-05-01,158,2,-2,45,11,214
Iran,2010-05-01,79,0,-3,36,14,126
Iran,2010-05-01,95,6,4,21,17,143
Iran,2010-05-01,7,0,0,1,0,8
Iran,2010-05-01,19,0,0,4,0,23
Iran,2010-05-01,27,0,0,21,0,48
Iran,2010-05-01,14,0,0,7,0,21
Iran,2010-05-01,54,4,0,22,0,80
Iran,2010-05-01,12,0,0,22,0,34
Iran,2010-05-01,37,0,0,15,5,57
Iran,2010-05-01,17,0,0,10,11,38
Iran,2010-05-01,16,0,0,16,0,32
Iran,2010-05-01,20,0,0,20,5,45
Iran,2010-05-01,3,0,0,9,4,16
Iran,2010-05-01,21,0,0,10,3,34
Iran,2010-05-01,19,0,-2,47,9,73
Iran,2010-05-01,126,0,0,81,22,229
Iran,2010-05-01,27,0,0,14,16,57
Iran,2010-05-01,10,2,0,14,6,32
Iran,2010-05-01,44,0,0,19,5,68
Iran,2010-05-01,52,0,0,-11,2,43
Iran,2010-05-01,11,0,0,6,0,17
Iran,2010-05-01,60,0,-2,15,3,76
Iran,2010-05-01,22,0,0,8,4,34
Iran,2010-05-01,12,0,0,-5,2,9
Iran,2010-05-01,23,0,-1,-4,2,20
Iran,2010-05-01,34,0,0,9,5,48
Iran,2010-05-01,31,0,0,1,1,33
Iran,2010-05-01,24,0,0,2,1,27
Iraq,2010-05-01,62,0,1,12,33,108
Iraq,2010-05-01,68,0,0,22,32,122
Iraq,2010-05-01,121,4,1,23,8,157
Iraq,2010-05-01,25,2,2,22,3,54
Iraq,2010-05-01,76,0,0,19,9,104
Iraq,2010-05-01,4,0,0,4,2,10
Iraq,2010-05-01,17,0,0,6,7,30
Iraq,2010-05-01,36,0,0,0,0,36
Iraq,2010-05-01,26,0,0,3,2,31
Iraq,2010-05-01,17,0,0,6,3,26
Iraq,2010-05-01,14,0,0,12,10,36
Iraq,2010-05-01,14,0,0,15,8,37
Iraq,2010-05-01,16,0,0,3,2,21
Iraq,2010-05-01,18,0,0,0,2,20
Iraq,2010-05-01,38,2,1,-3,2,40
Iraq,2010-05-01,11,0,0,1,0,12
Iraq,2010-05-01,21,0,0,3,4,28
Iraq,2010-05-01,17,0,0,11,3,31
Iraq,2010-05-01,44,0,0,49,0,93
Iraq,2010-05-01,87,0,0,0,3,90
Iraq,2010-05-01,50,0,0,9,0,59
Iraq,2010-05-01,111,0,2,40,2,155
Iraq,2010-05-01,34,0,0,37,4,75
Iraq,2010-05-01,35,0,0,16,6,57
Iraq,2010-05-01,104,0,0,23,10,137
Iraq,2010-05-01,107,0,0,-1,12,118
Iraq,2010-05-01,58,0,0,15,0,73
Iraq,2010-05-01,43,0,0,5,2,50
Iraq,2010-05-01,92,0,0,50,3,145
Iraq,2010-05-01,77,0,0,14,3,94
Iraq,2010-05-01,32,2,2,0,0,36
Morocco,2010-05-01,16,0,0,1,0,17
Morocco,2010-05-01,0,0,0,0,0,0
Morocco,2010-05-01,-5,0,0,1,2,-2
Morocco,2010-05-01,-1,0,0,0,1,0
Morocco,2010-05-01,6,0,0,0,0,6
Morocco,2010-05-01,0,0,0,0,0,0
Morocco,2010-05-01,0,0,0,3,0,3
Morocco,2010-05-01,0,0,0,0,0,0
Morocco,2010-05-01,-3,0,0,0,0,-3
Morocco,2010-05-01,0,0,0,0,0,0
Morocco,2010-05-01,16,0,0,6,0,22
Morocco,2010-05-01,1,0,0,0,0,1
Morocco,2010-05-01,0,0,0,0,0,0
Morocco,2010-05-01,0,0,0,0,0,0
Morocco,2010-05-01,3,0,0,3,0,6
Morocco,2010-05-01,11,0,0,12,0,23
Morocco,2010-05-01,14,0,0,3,0,17
Morocco,2010-05-01,2,0,0,15,0,17
Morocco,2010-05-01,0,0,0,6,0,6
Morocco,2010-05-01,2,0,0,9,0,11
Morocco,2010-05-01,0,0,0,3,0,3
Morocco,2010-05-01,0,0,0,0,0,0
Morocco,2010-05-01,0,0,0,0,0,0
Morocco,2010-05-01,3,0,0,3,1,7
Morocco,2010-05-01,0,0,0,9,1,10
Morocco,2010-05-01,2,0,0,0,0,2
Morocco,2010-05-01,8,0,-2,6,0,12
Morocco,2010-05-01,9,0,0,0,0,9
Morocco,2010-05-01,3,0,0,0,0,3
Morocco,2010-05-01,0,0,0,3,0,3
Nigeria,2010-05-01,10,0,0,10,1,21
Nigeria,2010-05-01,4,0,0,15,0,19
Nigeria,2010-05-01,29,0,0,40,4,73
Nigeria,2010-05-01,16,0,0,22,0,38
Nigeria,2010-05-01,34,0,-1,19,1,53
Nigeria,2010-05-01,3,0,0,0,0,3
Nigeria,2010-05-01,0,0,0,0,-2,-2
Nigeria,2010-05-01,0,0,0,0,0,0
Nigeria,2010-05-01,0,0,0,3,0,3
Nigeria,2010-05-01,8,0,-3,6,0,11
Nigeria,2010-05-01,7,0,0,4,2,13
Nigeria,2010-05-01,6,0,0,0,0,6
Nigeria,2010-05-01,4,0,0,-4,0,0
Nigeria,2010-05-01,6,0,0,6,0,12
Nigeria,2010-05-01,2,0,0,-2,0,0
Nigeria,2010-05-01,7,0,0,9,2,18
Nigeria,2010-05-01,2,0,1,3,0,6
Nigeria,2010-05-01,1,0,0,0,3,4
Nigeria,2010-05-01,9,0,0,2,1,12
Nigeria,2010-05-01,3,0,0,-2,0,1
Nigeria,2010-05-01,6,0,1,3,2,12
Nigeria,2010-05-01,6,0,0,-2,0,4
Nigeria,2010-05-01,17,0,-1,9,0,25
Nigeria,2010-05-01,0,0,0,0,0,0
Nigeria,2010-05-01,6,0,0,15,2,23
Nigeria,2010-05-01,5,2,0,3,0,10
Nigeria,2010-05-01,2,0,0,0,0,2
Nigeria,2010-05-01,1,0,0,1,0,2
Nigeria,2010-05-01,0,0,0,-2,1,-1
Nigeria,2010-05-01,1,0,0,1,1,3
Nigeria,2010-05-01,0,0,0,6,0,6
Pakistan,2010-05-01,45,0,-1,30,3,77
Pakistan,2010-05-01,146,0,1,27,4,178
Pakistan,2010-05-01,327,0,0,322,44,693
Pakistan,2010-05-01,184,0,2,78,11,275
Pakistan,2010-05-01,93,0,0,70,17,180
Pakistan,2010-05-01,41,0,0,16,0,57
Pakistan,2010-05-01,53,0,0,18,0,71
Pakistan,2010-05-01,35,0,0,12,8,55
Pakistan,2010-05-01,13,0,0,19,0,32
Pakistan,2010-05-01,88,0,0,10,19,117
Pakistan,2010-05-01,61,2,-2,30,8,99
Pakistan,2010-05-01,46,2,0,6,26,80
Pakistan,2010-05-01,14,0,0,8,12,34
Pakistan,2010-05-01,74,0,0,45,6,125
Pakistan,2010-05-01,47,0,0,15,4,66
Pakistan,2010-05-01,26,0,0,28,6,60
Pakistan,2010-05-01,61,0,0,4,8,73
Pakistan,2010-05-01,57,0,0,43,9,109
Pakistan,2010-05-01,97,0,3,68,29,197
Pakistan,2010-05-01,43,0,0,23,16,82
Pakistan,2010-05-01,74,0,-2,43,5,120
Pakistan,2010-05-01,75,0,0,59,11,145
Pakistan,2010-05-01,13,0,0,14,2,29
Pakistan,2010-05-01,27,0,1,10,10,48
Pakistan,2010-05-01,37,2,0,11,0,50
Pakistan,2010-05-01,73,0,0,27,6,106
Pakistan,2010-05-01,21,0,0,24,0,45
Pakistan,2010-05-01,31,0,0,48,3,82
Pakistan,2010-05-01,129,0,1,40,23,193
Pakistan,2010-05-01,45,0,0,38,11,94
Pakistan,2010-05-01,19,0,1,-3,0,17
Sierra Leone,2010-05-01,0,0,0,6,0,6
Sierra Leone,2010-05-01,0,0,0,0,0,0
Sierra Leone,2010-05-01,1,0,0,0,4,5
Sierra Leone,2010-05-01,0,0,0,9,0,9
Sierra Leone,2010-05-01,0,0,0,0,0,0
Sierra Leone,2010-05-01,28,0,0,0,0,28
Sierra Leone,2010-05-01,0,0,0,0,10,10
Sierra Leone,2010-05-01,0,0,0,0,2,2
Sierra Leone,2010-05-01,3,0,0,0,0,3
Sierra Leone,2010-05-01,0,0,0,0,0,0
Sierra Leone,2010-05-01,0,2,0,0,0,2
Sierra Leone,2010-05-01,0,0,0,0,0,0
Sierra Leone,2010-05-01,3,0,0,0,0,3
Sierra Leone,2010-05-01,1,0,0,0,0,1
Sierra Leone,2010-05-01,3,0,0,3,1,7
Sierra Leone,2010-05-01,2,0,0,0,0,2
Sierra Leone,2010-05-01,0,0,0,-1,0,-1
Sierra Leone,2010-05-01,0,0,0,0,0,0
Sierra Leone,2010-05-01,0,0,-6,0,4,-2
Sierra Leone,2010-05-01,1,0,0,0,0,1
Sierra Leone,2010-05-01,3,0,1,0,0,4
Sierra Leone,2010-05-01,4,0,0,9,0,13
Sierra Leone,2010-05-01,0,0,0,0,0,0
Somalia,2010-05-01,11,0,-1,39,3,52
Somalia,2010-05-01,42,2,0,19,3,66
Somalia,2010-05-01,32,0,0,21,5,58
Somalia,2010-05-01,6,0,0,7,0,13
Somalia,2010-05-01,66,0,0,11,0,77
Somalia,2010-05-01,45,0,0,-14,0,31
Somalia,2010-05-01,13,0,0,0,0,13
Somalia,2010-05-01,6,0,0,24,0,30
Somalia,2010-05-01,14,0,0,15,0,29
Somalia,2010-05-01,12,2,0,15,4,33
Somalia,2010-05-01,0,0,0,11,6,17
Somalia,2010-05-01,29,0,0,11,0,40
Somalia,2010-05-01,7,0,0,-9,0,-2
Somalia,2010-05-01,5,0,-2,-8,4,-1
Somalia,2010-05-01,8,0,0,-4,2,6
Somalia,2010-05-01,5,0,0,21,0,26
Somalia,2010-05-01,14,0,0,-3,0,11
Somalia,2010-05-01,12,0,0,20,0,32
Somalia,2010-05-01,52,0,0,5,4,61
Somalia,2010-05-01,5,0,0,0,0,5
Somalia,2010-05-01,22,0,0,41,0,63
Somalia,2010-05-01,34,4,0,4,2,44
Somalia,2010-05-01,25,0,0,-6,4,23
Somalia,2010-05-01,4,2,0,-1,0,5
Somalia,2010-05-01,29,0,0,12,1,42
Somalia,2010-05-01,6,0,0,12,2,20
Somalia,2010-05-01,17,0,0,-3,0,14
Somalia,2010-05-01,26,0,0,0,0,26
Somalia,2010-05-01,11,0,-2,-1,0,8
Somalia,2010-05-01,0,0,0,19,0,19
Somalia,2010-05-01,9,0,0,1,0,10
Syria,2010-05-01,21,0,0,3,0,24
Syria,2010-05-01,20,0,5,13,0,38
Syria,2010-05-01,6,2,3,3,4,18
Syria,2010-05-01,8,0,1,0,0,9
Syria,2010-05-01,5,0,0,0,1,6
Syria,2010-05-01,-2,0,0,0,0,-2
Syria,2010-05-01,7,0,0,3,0,10
Syria,2010-05-01,7,0,0,0,0,7
Syria,2010-05-01,2,0,0,15,3,20
Syria,2010-05-01,7,0,0,9,0,16
Syria,2010-05-01,5,0,0,2,0,7
Syria,2010-05-01,15,0,0,11,0,26
Syria,2010-05-01,0,0,0,7,0,7
Syria,2010-05-01,0,0,0,0,0,0
Syria,2010-05-01,13,0,0,11,0,24
Syria,2010-05-01,2,0,0,1,1,4
Syria,2010-05-01,0,0,0,-2,2,0
Syria,2010-05-01,11,0,0,0,0,11
Syria,2010-05-01,13,0,0,10,0,23
Syria,2010-05-01,0,0,0,0,0,0
Syria,2010-05-01,10,0,0,12,0,22
Syria,2010-05-01,3,0,0,20,4,27
Syria,2010-05-01,25,0,1,14,0,40
Syria,2010-05-01,8,0,0,0,0,8
Syria,2010-05-01,17,0,-1,3,0,19
Syria,2010-05-01,0,0,0,3,0,3
Syria,2010-05-01,0,0,0,6,0,6
Syria,2010-05-01,6,0,0,9,0,15
Syria,2010-05-01,2,0,0,4,0,6
Syria,2010-05-01,8,0,0,6,0,14
Syria,2010-05-01,6,0,0,0,0,6
Yemen,2010-05-01,26,0,0,26,5,57
Yemen,2010-05-01,1,0,-4,9,2,8
Yemen,2010-05-01,16,0,0,12,1,29
Yemen,2010-05-01,19,0,0,-2,2,19
Yemen,2010-05-01,1,0,0,0,0,1
Yemen,2010-05-01,0,0,0,0,0,0
Yemen,2010-05-01,3,0,0,0,0,3
Yemen,2010-05-01,0,0,0,0,0,0
Yemen,2010-05-01,2,0,0,6,0,8
Yemen,2010-05-01,5,0,0,9,0,14
Yemen,2010-05-01,4,0,0,0,3,7
Yemen,2010-05-01,0,0,0,3,9,12
Yemen,2010-05-01,1,0,0,3,5,9
Yemen,2010-05-01,3,0,0,21,0,24
Yemen,2010-05-01,3,0,0,9,6,18
Yemen,2010-05-01,0,0,0,9,0,9
Yemen,2010-05-01,3,0,0,3,0,6
Yemen,2010-05-01,15,0,1,32,2,50
Yemen,2010-05-01,9,0,0,15,1,25
Yemen,2010-05-01,2,0,0,9,3,14
Yemen,2010-05-01,15,0,-5,-10,0,0
Yemen,2010-05-01,12,0,0,6,0,18
Yemen,2010-05-01,57,0,0,26,7,90
Yemen,2010-05-01,0,0,0,6,0,6
Yemen,2010-05-01,5,0,0,-4,2,3
Yemen,2010-05-01,2,2,0,-2,0,2
Yemen,2010-05-01,0,0,0,9,0,9
Yemen,2010-05-01,7,0,0,0,2,9
Yemen,2010-05-01,11,0,0,-2,2,11
Yemen,2010-05-01,0,0,0,2,0,2
Yemen,2010-05-01,0,0,0,6,0,6
Afghanistan,2010-11-01,194,0,2,88,55,339
Afghanistan,2010-11-01,198,2,-7,62,22,277
Afghanistan,2010-11-01,394,4,2,31,17,448
Afghanistan,2010-11-01,318,0,-2,106,32,454
Afghanistan,2010-11-01,306,2,1,64,48,421
Afghanistan,2010-11-01,212,0,-1,44,35,290
Afghanistan,2010-11-01,288,2,3,19,14,326
Afghanistan,2010-11-01,210,0,0,15,16,241
Afghanistan,2010-11-01,281,0,-4,50,24,351
Afghanistan,2010-11-01,340,0,-2,16,17,371
Afghanistan,2010-11-01,431,2,1,41,41,516
Afghanistan,2010-11-01,210,2,0,40,19,271
Afghanistan,2010-11-01,70,0,-2,17,5,90
Afghanistan,2010-11-01,260,2,-1,-14,27,274
Afghanistan,2010-11-01,340,4,3,0,30,377
Afghanistan,2010-11-01,220,4,-1,21,40,284
Afghanistan,2010-11-01,245,6,-1,39,33,322
Afghanistan,2010-11-01,165,4,-1,38,21,227
Afghanistan,2010-11-01,-1,0,1,-6,0,-6
Afghanistan,2010-11-01,488,4,-7,27,35,547
Afghanistan,2010-11-01,289,0,0,-4,12,297
Afghanistan,2010-11-01,301,0,2,2,27,332
Afghanistan,2010-11-01,238,0,2,79,14,333
Afghanistan,2010-11-01,178,0,0,78,8,264
Afghanistan,2010-11-01,124,2,0,17,19,162
Afghanistan,2010-11-01,120,4,2,39,17,182
Afghanistan,2010-11-01,119,0,0,45,17,181
Afghanistan,2010-11-01,114,2,1,5,20,142
Afghanistan,2010-11-01,332,0,2,80,31,445
Afghanistan,2010-11-01,376,0,1,58,36,471
Albania,2010-11-01,3,0,0,0,1,4
Albania,2010-11-01,4,0,-9,0,0,-5
Albania,2010-11-01,7,0,0,0,0,7
Albania,2010-11-01,3,0,0,0,0,3
Albania,2010-11-01,-3,0,0,0,0,-3
Albania,2010-11-01,0,0,0,3,0,3
Albania,2010-11-01,2,0,0,-2,0,0
Albania,2010-11-01,0,0,0,-4,0,-4
Albania,2010-11-01,10,0,0,-6,2,6
Albania,2010-11-01,21,0,0,11,1,33
Albania,2010-11-01,11,0,1,-4,2,10
Albania,2010-11-01,18,0,0,21,0,39
Albania,2010-11-01,10,0,0,9,0,19
Albania,2010-11-01,3,0,0,0,6,9
Albania,2010-11-01,1,0,-1,9,3,12
Albania,2010-11-01,2,0,0,0,1,3
Albania,2010-11-01,0,0,0,6,0,6
Albania,2010-11-01,3,0,0,0,0,3
Albania,2010-11-01,0,0,-4,0,0,-4
Albania,2010-11-01,2,0,0,0,0,2
Albania,2010-11-01,1,0,0,0,0,1
Albania,2010-11-01,0,0,0,0,0,0
Albania,2010-11-01,0,0,0,0,0,0
Albania,2010-11-01,10,0,0,6,0,16
Albania,2010-11-01,0,0,0,0,0,0
Albania,2010-11-01,3,0,0,0,0,3
Albania,2010-11-01,0,0,0,-2,0,-2
Albania,2010-11-01,4,0,0,3,0,7
Albania,2010-11-01,6,0,0,2,0,8
Albania,2010-11-01,0,0,0,3,0,3
Algeria,2010-11-01,6,0,0,3,4,13
Algeria,2010-11-01,5,0,0,18,1,24
Algeria,2010-11-01,7,0,0,-1,1,7
Algeria,2010-11-01,4,0,0,0,0,4
Algeria,2010-11-01,6,0,0,18,1,25
Algeria,2010-11-01,6,0,0,0,0,6
Algeria,2010-11-01,0,0,0,3,0,3
Algeria,2010-11-01,32,0,-2,6,4,40
Algeria,2010-11-01,23,0,0,12,0,35
Algeria,2010-11-01,11,0,0,12,0,23
Algeria,2010-11-01,17,0,0,-2,2,17
Algeria,2010-11-01,3,0,0,0,0,3
Algeria,2010-11-01,0,0,0,0,0,0
Algeria,2010-11-01,3,0,0,0,4,7
Algeria,2010-11-01,1,0,0,0,0,1
Algeria,2010-11-01,1,0,0,0,0,1
Algeria,2010-11-01,2,0,0,30,2,34
Algeria,2010-11-01,7,0,0,0,7,14
Algeria,2010-11-01,8,0,0,0,0,8
Algeria,2010-11-01,6,0,0,0,0,6
Algeria,2010-11-01,1,0,0,0,0,1
Algeria,2010-11-01,-1,0,0,6,0,5
Algeria,2010-11-01,17,0,0,6,0,23
Algeria,2010-11-01,11,0,0,0,0,11
Algeria,2010-11-01,-1,0,0,9,0,8
Algeria,2010-11-01,11,0,0,7,4,22
Algeria,2010-11-01,10,0,0,15,0,25
Algeria,2010-11-01,6,0,0,0,0,6
Algeria,2010-11-01,18,0,0,-2,0,16
Algeria,2010-11-01,0,0,0,6,0,6
Bangladesh,2010-11-01,7,0,0,9,0,16
Bangladesh,2010-11-01,26,2,0,6,1,35
Bangladesh,2010-11-01,22,2,0,-1,6,29
Bangladesh,2010-11-01,13,2,0,-16,6,5
Bangladesh,2010-11-01,10,0,0,13,5,28
Bangladesh,2010-11-01,2,0,0,-2,0,0
Bangladesh,2010-11-01,12,0,0,3,12,27
Bangladesh,2010-11-01,18,0,0,10,3,31
Bangladesh,2010-11-01,-31,0,0,22,2,-7
Bangladesh,2010-11-01,10,0,0,3,7,20
Bangladesh,2010-11-01,15,0,-2,6,1,20
Bangladesh,2010-11-01,4,0,0,0,1,5
Bangladesh,2010-11-01,6,0,0,6,0,12
Bangladesh,2010-11-01,4,0,0,5,9,18
Bangladesh,2010-11-01,19,0,0,16,0,35
Bangladesh,2010-11-01,34,0,0,0,1,35
Bangladesh,2010-11-01,5,0,0,0,0,5
Bangladesh,2010-11-01,11,0,2,2,6,21
Bangladesh,2010-11-01,4,0,0,0,4,8
Bangladesh,2010-11-01,17,0,-6,-6,4,9
Bangladesh,2010-11-01,10,2,0,3,0,15
Bangladesh,2010-11-01,8,0,1,9,0,18
Bangladesh,2010-11-01,8,0,-8,5,2,7
Bangladesh,2010-11-01,8,0,-8,6,2,8
Bangladesh,2010-11-01,8,0,-1,17,1,25
Bangladesh,2010-11-01,25,0,0,25,4,54
Bangladesh,2010-11-01,4,0,2,16,7,29
Bangladesh,2010-11-01,20,0,-4,7,5,28
Bangladesh,2010-11-01,16,0,1,7,0,24
Bangladesh,2010-11-01,14,2,0,11,5,32
Cameroon,2010-11-01,0,0,0,0,0,0
Cameroon,2010-11-01,11,0,0,0,0,11
Cameroon,2010-11-01,3,0,0,-2,0,1
Cameroon,2010-11-01,8,0,0,6,1,15
Cameroon,2010-11-01,5,0,0,3,1,9
Cameroon,2010-11-01,0,0,0,0,0,0
Cameroon,2010-11-01,0,0,0,0,0,0
Cameroon,2010-11-01,5,0,0,1,1,7
Cameroon,2010-11-01,3,0,0,0,0,3
Cameroon,2010-11-01,-2,0,0,0,0,-2
Cameroon,2010-11-01,3,0,0,9,1,13
Cameroon,2010-11-01,0,0,0,0,1,1
Cameroon,2010-11-01,-4,0,0,12,0,8
Cameroon,2010-11-01,0,0,0,0,0,0
Cameroon,2010-11-01,36,0,0,-1,1,36
Cameroon,2010-11-01,16,0,0,3,0,19
Cameroon,2010-11-01,0,0,0,9,0,9
Cameroon,2010-11-01,2,0,0,0,0,2
Cameroon,2010-11-01,1,0,0,0,0,1
Cameroon,2010-11-01,0,0,0,6,2,8
Cameroon,2010-11-01,-3,0,0,-2,0,-5
Cameroon,2010-11-01,4,0,0,9,0,13
Cameroon,2010-11-01,1,0,0,26,0,27
Cameroon,2010-11-01,2,0,0,0,0,2
Cameroon,2010-11-01,0,0,0,0,0,0
Cameroon,2010-11-01,0,0,0,1,0,1
Cameroon,2010-11-01,0,0,0,0,0,0
China,2010-11-01,125,4,1,57,20,207
China,2010-11-01,132,0,-5,58,20,205
China,2010-11-01,158,4,-3,50,14,223
China,2010-11-01,131,0,0,5,25,161
China,2010-11-01,125,6,-8,56,8,187
China,2010-11-01,69,2,-3,-17,9,60
China,2010-11-01,92,4,0,56,11,163
China,2010-11-01,241,0,-5,100,16,352
China,2010-11-01,231,2,2,35,20,290
China,2010-11-01,236,2,-4,35,22,291
China,2010-11-01,131,4,-15,35,23,178
China,2010-11-01,34,4,-1,49,3,89
China,2010-11-01,85,0,-1,-21,12,75
China,2010-11-01,100,0,-3,-17,8,88
China,2010-11-01,130,4,-7,62,18,207
China,2010-11-01,99,2,-23,59,9,146
China,2010-11-01,149,0,-24,22,25,172
China,2010-11-01,139,4,-7,66,17,219
China,2010-11-01,5,0,-2,8,2,13
China,2010-11-01,80,0,-4,44,11,131
China,2010-11-01,131,4,-1,32,4,170
China,2010-11-01,153,6,-12,24,12,183
China,2010-11-01,219,0,-5,13,14,241
China,2010-11-01,247,4,-1,-7,11,254
China,2010-11-01,176,2,-32,40,10,196
China,2010-11-01,200,0,-3,46,9,252
China,2010-11-01,122,6,-6,19,10,151
China,2010-11-01,192,8,-3,11,8,216
China,2010-11-01,259,0,-7,22,21,295
China,2010-11-01,177,2,-6,28,22,223
Egypt,2010-11-01,152,0,0,79,14,245
Egypt,2010-11-01,89,0,0,66,18,173
Egypt,2010-11-01,54,0,0,58,10,122
Egypt,2010-11-01,57,0,0,17,7,81
Egypt,2010-11-01,60,0,0,23,2,85
Egypt,2010-11-01,27,0,0,10,1,38
Egypt,2010-11-01,6,0,0,0,1,7
Egypt,2010-11-01,-2,0,0,20,15,33
Egypt,2010-11-01,38,0,-1,43,17,97
Egypt,2010-11-01,56,0,0,21,4,81
Egypt,2010-11-01,59,0,-1,16,8,82
Egypt,2010-11-01,16,0,0,24,0,40
Egypt,2010-11-01,-1,0,0,24,0,23
Egypt,2010-11-01,49,0,2,27,4,82
Egypt,2010-11-01,43,0,1,41,1,86
Egypt,2010-11-01,29,0,3,34,6,72
Egypt,2010-11-01,8,0,2,20,8,38
Egypt,2010-11-01,31,0,1,19,1,52
Egypt,2010-11-01,20,0,0,6,2,28
Egypt,2010-11-01,27,0,-4,16,0,39
Egypt,2010-11-01,70,4,0,57,4,135
Egypt,2010-11-01,37,0,1,16,2,56
Egypt,2010-11-01,34,0,0,24,5,63
Egypt,2010-11-01,52,0,2,12,13,79
Egypt,2010-11-01,62,0,-4,45,6,109
Egypt,2010-11-01,57,0,0,63,11,131
Egypt,2010-11-01,34,0,0,47,4,85
Egypt,2010-11-01,109,0,1,37,15,162
Egypt,2010-11-01,72,0,2,16,11,101
Egypt,2010-11-01,82,0,6,37,12,137
Eritrea,2010-11-01,0,0,0,0,0,0
Eritrea,2010-11-01,1,0,0,-4,0,-3
Eritrea,2010-11-01,0,0,0,0,0,0
Eritrea,2010-11-01,0,0,0,0,4,4
Eritrea,2010-11-01,2,0,0,0,0,2
Eritrea,2010-11-01,0,0,0,3,0,3
Eritrea,2010-11-01,5,0,0,3,0,8
Eritrea,2010-11-01,2,0,0,0,0,2
Eritrea,2010-11-01,0,0,0,0,0,0
Eritrea,2010-11-01,0,0,0,0,0,0
Eritrea,2010-11-01,4,0,0,3,0,7
Eritrea,2010-11-01,0,0,0,3,0,3
Eritrea,2010-11-01,0,0,0,-2,0,-2
Eritrea,2010-11-01,3,0,0,0,0,3
Eritrea,2010-11-01,0,0,0,0,0,0
Eritrea,2010-11-01,2,0,0,0,0,2
Eritrea,2010-11-01,1,0,0,0,0,1
Eritrea,2010-11-01,0,0,0,0,0,0
Eritrea,2010-11-01,-3,0,0,0,0,-3
Eritrea,2010-11-01,2,0,0,0,4,6
Eritrea,2010-11-01,3,0,0,0,0,3
Eritrea,2010-11-01,0,0,0,-2,0,-2
Eritrea,2010-11-01,3,0,0,6,2,11
Eritrea,2010-11-01,10,0,0,4,0,14
Eritrea,2010-11-01,0,0,0,0,0,0
Eritrea,2010-11-01,0,0,0,0,0,0
Eritrea,2010-11-01,0,0,0,0,0,0
Georgia,2010-11-01,74,0,0,22,12,108
Georgia,2010-11-01,50,0,0,13,23,86
Georgia,2010-11-01,30,0,0,7,4,41
Georgia,2010-11-01,52,0,0,34,8,94
Georgia,2010-11-01,57,0,0,27,6,90
Georgia,2010-11-01,19,0,1,17,3,40
Georgia,2010-11-01,2,0,0,18,1,21
Georgia,2010-11-01,39,2,0,32,6,79
Georgia,2010-11-01,32,0,-2,17,2,49
Georgia,2010-11-01,35,0,0,23,2,60
Georgia,2010-11-01,41,0,-2,17,4,60
Georgia,2010-11-01,22,0,-1,-2,2,21
Georgia,2010-11-01,2,0,1,0,1,4
Georgia,2010-11-01,19,0,1,5,0,25
Georgia,2010-11-01,65,0,-2,20,4,87
Georgia,2010-11-01,9,0,0,20,0,29
Georgia,2010-11-01,46,0,-4,33,6,81
Georgia,2010-11-01,21,2,0,34,4,61
Georgia,2010-11-01,0,0,0,0,0,0
Georgia,2010-11-01,29,4,0,7,9,49
Georgia,2010-11-01,18,0,1,4,0,23
Georgia,2010-11-01,43,4,0,40,14,101
Georgia,2010-11-01,24,0,-2,30,6,58
Georgia,2010-11-01,7,0,0,22,4,33
Georgia,2010-11-01,33,0,0,-2,2,33
Georgia,2010-11-01,36,0,0,-5,0,31
Georgia,2010-11-01,14,0,-2,8,2,22
Georgia,2010-11-01,30,0,0,12,8,50
Georgia,2010-11-01,60,2,0,15,1,78
Georgia,2010-11-01,29,2,3,41,10,85
India,2010-11-01,71,0,1,7,10,89
India,2010-11-01,38,0,-2,-1,15,50
India,2010-11-01,57,4,-3,-4,7,61
India,2010-11-01,65,2,-3,11,10,85
India,2010-11-01,62,0,-11,16,16,83
India,2010-11-01,47,2,-6,14,9,66
India,2010-11-01,83,0,2,22,14,121
India,2010-11-01,106,6,-3,25,12,146
India,2010-11-01,81,0,0,-18,4,67
India,2010-11-01,146,0,1,2,22,171
India,2010-11-01,35,0,-2,5,5,43
India,2010-11-01,55,2,-4,-3,4,54
India,2010-11-01,54,0,-2,-3,2,51
India,2010-11-01,31,4,1,-14,8,30
India,2010-11-01,73,0,-33,23,6,69
India,2010-11-01,68,0,-1,44,3,114
India,2010-11-01,43,4,-6,1,20,62
India,2010-11-01,40,0,-12,9,2,39
India,2010-11-01,15,0,-6,9,0,18
India,2010-11-01,29,2,-2,34,3,66
India,2010-11-01,59,2,-1,15,8,83
India,2010-11-01,61,0,-6,2,8,65
India,2010-11-01,70,0,-10,9,8,77
India,2010-11-01,55,0,-7,-5,8,51
India,2010-11-01,58,2,-9,3,18,72
India,2010-11-01,40,0,-1,22,3,64
India,2010-11-01,43,0,1,22,7,73
India,2010-11-01,56,2,0,-5,0,53
India,2010-11-01,76,2,-6,9,15,96
India,2010-11-01,77,4,0,16,6,103
Iran,2010-11-01,42,0,0,71,2,115
Iran,2010-11-01,54,2,1,53,1,111
Iran,2010-11-01,94,0,-3,82,86,259
Iran,2010-11-01,63,2,0,96,13,174
Iran,2010-11-01,50,0,0,19,6,75
Iran,2010-11-01,61,0,0,10,3,74
Iran,2010-11-01,78,0,0,10,6,94
Iran,2010-11-01,150,0,-1,58,114,321
Iran,2010-11-01,99,2,-8,40,25,158
Iran,2010-11-01,97,0,-3,69,9,172
Iran,2010-11-01,82,0,-9,32,13,118
Iran,2010-11-01,40,0,2,1,12,55
Iran,2010-11-01,36,0,0,4,7,47
Iran,2010-11-01,46,0,-1,35,3,83
Iran,2010-11-01,36,0,0,43,10,89
Iran,2010-11-01,84,0,3,32,8,127
Iran,2010-11-01,58,0,-2,32,16,104
Iran,2010-11-01,109,2,0,20,10,141
Iran,2010-11-01,20,0,0,4,4,28
Iran,2010-11-01,88,0,0,23,1,112
Iran,2010-11-01,84,0,0,20,8,112
Iran,2010-11-01,89,2,1,90,3,185
Iran,2010-11-01,67,0,0,56,2,125
Iran,2010-11-01,81,0,0,35,6,122
Iran,2010-11-01,50,0,0,44,17,111
Iran,2010-11-01,96,0,0,4,1,101
Iran,2010-11-01,63,2,-1,32,2,98
Iran,2010-11-01,68,0,0,37,30,135
Iran,2010-11-01,287,2,6,147,35,477
Iran,2010-11-01,175,0,7,108,33,323
Iraq,2010-11-01,176,0,0,39,17,232
Iraq,2010-11-01,194,0,0,103,29,326
Iraq,2010-11-01,162,2,0,94,11,269
Iraq,2010-11-01,202,6,-1,55,11,273
Iraq,2010-11-01,138,0,-1,42,19,198
Iraq,2010-11-01,93,0,2,10,10,115
Iraq,2010-11-01,40,2,0,27,16,85
Iraq,2010-11-01,120,0,1,23,32,176
Iraq,2010-11-01,131,14,1,46,18,210
Iraq,2010-11-01,156,14,-7,50,5,218
Iraq,2010-11-01,208,4,-5,62,11,280
Iraq,2010-11-01,81,0,1,21,7,110
Iraq,2010-11-01,10,0,0,52,2,64
Iraq,2010-11-01,161,2,0,45,7,215
Iraq,2010-11-01,145,0,0,29,10,184
Iraq,2010-11-01,118,0,1,13,20,152
Iraq,2010-11-01,229,0,1,108,23,361
Iraq,2010-11-01,175,0,0,113,38,326
Iraq,2010-11-01,4,0,0,-2,2,4
Iraq,2010-11-01,88,2,1,47,5,143
Iraq,2010-11-01,119,0,1,70,20,210
Iraq,2010-11-01,82,0,0,67,8,157
Iraq,2010-11-01,79,0,0,21,6,106
Iraq,2010-11-01,115,0,-4,30,8,149
Iraq,2010-11-01,116,0,0,1,24,141
Iraq,2010-11-01,119,2,1,10,10,142
Iraq,2010-11-01,69,0,0,19,5,93
Iraq,2010-11-01,85,0,0,47,12,144
Iraq,2010-11-01,214,0,2,155,13,384
Iraq,2010-11-01,168,0,4,109,3,284
Morocco,2010-11-01,12,0,0,-6,0,6
Morocco,2010-11-01,30,0,0,1,9,40
Morocco,2010-11-01,13,0,-1,6,2,20
Morocco,2010-11-01,5,0,0,13,1,19
Morocco,2010-11-01,10,0,0,1,0,11
Morocco,2010-11-01,0,0,0,-4,0,-4
Morocco,2010-11-01,9,0,0,1,1,11
Morocco,2010-11-01,131,0,-4,45,24,196
Morocco,2010-11-01,137,0,-2,32,18,185
Morocco,2010-11-01,179,0,-2,44,13,234
Morocco,2010-11-01,24,0,0,17,0,41
Morocco,2010-11-01,14,0,0,20,1,35
Morocco,2010-11-01,14,0,0,0,6,20
Morocco,2010-11-01,34,0,-2,15,9,56
Morocco,2010-11-01,45,0,0,-2,5,48
Morocco,2010-11-01,28,2,0,3,4,37
Morocco,2010-11-01,35,0,0,38,9,82
Morocco,2010-11-01,8,0,0,15,4,27
Morocco,2010-11-01,9,0,0,3,0,12
Morocco,2010-11-01,32,0,0,28,0,60
Morocco,2010-11-01,24,0,-2,-4,2,20
Morocco,2010-11-01,5,0,0,6,2,13
Morocco,2010-11-01,1,0,0,24,0,25
Morocco,2010-11-01,25,0,0,8,4,37
Morocco,2010-11-01,12,0,0,9,0,21
Morocco,2010-11-01,33,0,0,17,2,52
Morocco,2010-11-01,20,0,0,9,1,30
Morocco,2010-11-01,12,0,0,2,2,16
Morocco,2010-11-01,21,0,0,0,2,23
Morocco,2010-11-01,0,0,0,0,2,2
Nigeria,2010-11-01,40,0,-3,46,1,84
Nigeria,2010-11-01,31,0,1,39,6,77
Nigeria,2010-11-01,30,0,-1,13,10,52
Nigeria,2010-11-01,30,0,1,12,2,45
Nigeria,2010-11-01,10,0,0,19,3,32
Nigeria,2010-11-01,15,0,0,0,2,17
Nigeria,2010-11-01,9,2,0,6,2,19
Nigeria,2010-11-01,29,2,-2,58,5,92
Nigeria,2010-11-01,35,0,0,17,3,55
Nigeria,2010-11-01,51,0,-2,-5,-2,42
Nigeria,2010-11-01,26,0,0,17,2,45
Nigeria,2010-11-01,30,0,0,-10,0,20
Nigeria,2010-11-01,6,0,-2,3,0,7
Nigeria,2010-11-01,15,0,0,1,1,17
Nigeria,2010-11-01,26,0,0,-5,2,23
Nigeria,2010-11-01,29,0,0,12,10,51
Nigeria,2010-11-01,72,0,-3,24,2,95
Nigeria,2010-11-01,27,0,-4,-7,5,21
Nigeria,2010-11-01,-1,0,0,0,0,-1
Nigeria,2010-11-01,15,0,0,-2,5,18
Nigeria,2010-11-01,23,0,0,12,12,47
Nigeria,2010-11-01,39,2,-2,18,13,70
Nigeria,2010-11-01,31,0,0,28,5,64
Nigeria,2010-11-01,44,0,0,10,7,61
Nigeria,2010-11-01,11,0,0,3,4,18
Nigeria,2010-11-01,13,0,0,21,2,36
Nigeria,2010-11-01,25,0,0,21,1,47
Nigeria,2010-11-01,4,0,0,7,0,11
Nigeria,2010-11-01,16,2,0,8,5,31
Nigeria,2010-11-01,29,0,0,0,0,29
Pakistan,2010-11-01,123,4,-2,23,19,167
Pakistan,2010-11-01,67,0,1,15,12,95
Pakistan,2010-11-01,70,0,2,23,6,101
Pakistan,2010-11-01,122,0,-4,91,8,217
Pakistan,2010-11-01,110,0,0,29,60,199
Pakistan,2010-11-01,103,2,-4,22,28,151
Pakistan,2010-11-01,135,0,0,6,14,155
Pakistan,2010-11-01,171,4,14,31,28,248
Pakistan,2010-11-01,132,2,-3,46,7,184
Pakistan,2010-11-01,142,2,0,64,4,212
Pakistan,2010-11-01,88,2,-2,47,0,135
Pakistan,2010-11-01,51,0,-1,-5,1,46
Pakistan,2010-11-01,83,0,0,33,10,126
Pakistan,2010-11-01,41,2,0,1,11,55
Pakistan,2010-11-01,75,0,-1,75,25,174
Pakistan,2010-11-01,90,0,0,48,11,149
Pakistan,2010-11-01,108,0,-8,127,6,233
Pakistan,2010-11-01,63,4,0,64,3,134
Pakistan,2010-11-01,14,0,0,6,0,20
Pakistan,2010-11-01,99,0,1,68,18,186
Pakistan,2010-11-01,81,2,0,5,8,96
Pakistan,2010-11-01,96,2,0,44,10,152
Pakistan,2010-11-01,106,0,0,55,13,174
Pakistan,2010-11-01,99,0,2,29,4,134
Pakistan,2010-11-01,94,2,1,15,7,119
Pakistan,2010-11-01,101,6,0,50,14,171
Pakistan,2010-11-01,89,2,0,53,33,177
Pakistan,2010-11-01,81,0,0,20,23,124
Pakistan,2010-11-01,75,2,0,33,21,131
Pakistan,2010-11-01,109,0,-1,61,15,184
Sierra Leone,2010-11-01,1,0,0,15,0,16
Sierra Leone,2010-11-01,15,0,0,9,0,24
Sierra Leone,2010-11-01,6,0,-2,0,0,4
Sierra Leone,2010-11-01,9,0,0,-1,0,8
Sierra Leone,2010-11-01,7,0,0,0,0,7
Sierra Leone,2010-11-01,0,0,0,-2,0,-2
Sierra Leone,2010-11-01,0,0,0,-4,0,-4
Sierra Leone,2010-11-01,4,0,0,0,0,4
Sierra Leone,2010-11-01,8,0,0,9,1,18
Sierra Leone,2010-11-01,-2,0,0,0,0,-2
Sierra Leone,2010-11-01,0,0,0,3,0,3
Sierra Leone,2010-11-01,1,0,0,3,0,4
Sierra Leone,2010-11-01,4,0,0,0,0,4
Sierra Leone,2010-11-01,0,0,0,0,0,0
Sierra Leone,2010-11-01,3,0,0,9,0,12
Sierra Leone,2010-11-01,3,0,0,9,0,12
Sierra Leone,2010-11-01,15,0,-2,9,1,23
Sierra Leone,2010-11-01,13,0,0,0,0,13
Sierra Leone,2010-11-01,3,0,0,-8,0,-5
Sierra Leone,2010-11-01,6,0,0,12,0,18
Sierra Leone,2010-11-01,2,0,0,3,0,5
Sierra Leone,2010-11-01,6,0,0,0,1,7
Sierra Leone,2010-11-01,0,0,0,0,1,1
Sierra Leone,2010-11-01,1,0,0,-2,0,-1
Sierra Leone,2010-11-01,3,0,0,4,0,7
Sierra Leone,2010-11-01,0,0,0,0,0,0
Sierra Leone,2010-11-01,1,0,0,0,0,1
Sierra Leone,2010-11-01,4,0,0,0,1,5
Sierra Leone,2010-11-01,0,0,0,3,1,4
Somalia,2010-11-01,21,0,0,54,6,81
Somalia,2010-11-01,70,0,-2,35,7,110
Somalia,2010-11-01,57,0,0,44,10,111
Somalia,2010-11-01,12,0,0,46,2,60
Somalia,2010-11-01,35,6,0,66,3,110
Somalia,2010-11-01,25,0,0,-21,5,9
Somalia,2010-11-01,52,0,0,-16,7,43
Somalia,2010-11-01,45,2,0,97,14,158
Somalia,2010-11-01,65,0,-2,158,6,227
Somalia,2010-11-01,38,0,0,91,3,132
Somalia,2010-11-01,78,0,0,14,9,101
Somalia,2010-11-01,68,0,0,9,2,79
Somalia,2010-11-01,38,2,0,16,0,56
Somalia,2010-11-01,75,0,0,-27,1,49
Somalia,2010-11-01,45,4,1,-2,2,50
Somalia,2010-11-01,24,0,-4,17,1,38
Somalia,2010-11-01,22,0,0,21,8,51
Somalia,2010-11-01,29,0,0,25,8,62
Somalia,2010-11-01,6,0,0,0,0,6
Somalia,2010-11-01,14,0,0,16,0,30
Somalia,2010-11-01,20,0,0,35,4,59
Somalia,2010-11-01,47,0,0,104,16,167
Somalia,2010-11-01,31,0,0,69,9,109
Somalia,2010-11-01,71,0,0,134,7,212
Somalia,2010-11-01,60,0,0,60,10,130
Somalia,2010-11-01,32,0,0,64,6,102
Somalia,2010-11-01,93,0,-6,84,30,201
Somalia,2010-11-01,92,0,0,54,35,181
Somalia,2010-11-01,114,2,0,105,38,259
Somalia,2010-11-01,61,2,0,43,13,119
Syria,2010-11-01,46,0,0,15,2,63
Syria,2010-11-01,32,0,1,12,0,45
Syria,2010-11-01,22,0,0,7,3,32
Syria,2010-11-01,25,0,0,28,4,57
Syria,2010-11-01,14,2,0,14,13,43
Syria,2010-11-01,50,0,1,25,6,82
Syria,2010-11-01,16,0,3,7,5,31
Syria,2010-11-01,35,0,0,10,7,52
Syria,2010-11-01,72,0,0,22,11,105
Syria,2010-11-01,40,0,0,45,3,88
Syria,2010-11-01,66,0,0,18,10,94
Syria,2010-11-01,51,0,0,57,0,108
Syria,2010-11-01,21,0,0,15,0,36
Syria,2010-11-01,57,0,0,43,0,100
Syria,2010-11-01,63,0,0,79,2,144
Syria,2010-11-01,52,0,0,61,3,116
Syria,2010-11-01,26,0,0,3,5,34
Syria,2010-11-01,29,0,0,20,0,49
Syria,2010-11-01,10,0,0,9,0,19
Syria,2010-11-01,16,0,0,12,0,28
Syria,2010-11-01,7,0,0,24,0,31
Syria,2010-11-01,44,0,1,15,2,62
Syria,2010-11-01,11,0,0,0,2,13
Syria,2010-11-01,29,0,0,47,0,76
Syria,2010-11-01,15,0,0,3,0,18
Syria,2010-11-01,15,6,0,15,0,36
Syria,2010-11-01,6,0,-2,7,5,16
Syria,2010-11-01,36,0,-1,6,0,41
Syria,2010-11-01,39,0,0,14,1,54
Syria,2010-11-01,15,0,0,7,2,24
Yemen,2010-11-01,208,0,0,171,34,413
Yemen,2010-11-01,180,0,0,306,27,513
Yemen,2010-11-01,137,2,0,89,10,238
Yemen,2010-11-01,140,10,-1,46,19,214
Yemen,2010-11-01,82,4,0,70,5,161
Yemen,2010-11-01,102,0,0,62,13,177
Yemen,2010-11-01,69,0,0,39,4,112
Yemen,2010-11-01,187,0,1,60,32,280
Yemen,2010-11-01,128,6,0,137,2,273
Yemen,2010-11-01,67,2,0,62,6,137
Yemen,2010-11-01,74,0,-1,46,4,123
Yemen,2010-11-01,7,0,0,6,0,13
Yemen,2010-11-01,24,0,0,20,0,44
Yemen,2010-11-01,22,0,0,19,2,43
Yemen,2010-11-01,22,0,0,8,2,32
Yemen,2010-11-01,14,0,0,7,1,22
Yemen,2010-11-01,30,0,0,4,0,34
Yemen,2010-11-01,26,0,0,-5,4,25
Yemen,2010-11-01,0,0,0,0,0,0
Yemen,2010-11-01,6,0,0,12,2,20
Yemen,2010-11-01,50,0,0,-2,0,48
Yemen,2010-11-01,36,0,0,0,6,42
Yemen,2010-11-01,22,0,0,3,8,33
Yemen,2010-11-01,43,0,0,9,23,75
Yemen,2010-11-01,34,0,0,3,9,46
Yemen,2010-11-01,58,0,0,120,3,181
Yemen,2010-11-01,20,0,0,41,6,67
Yemen,2010-11-01,38,0,0,13,25,76
Yemen,2010-11-01,55,0,0,29,16,100
Yemen,2010-11-01,39,0,0,-6,1,34
Afghanistan,2012-07-01,256,2,0,4,15,277
Afghanistan,2012-07-01,499,0,-4,13,26,534
Afghanistan,2012-07-01,398,4,-2,19,35,454
Afghanistan,2012-07-01,325,6,0,34,16,381
Afghanistan,2012-07-01,326,0,-4,84,16,422
Afghanistan,2012-07-01,223,2,5,57,19,306
Afghanistan,2012-07-01,184,0,5,83,18,290
Afghanistan,2012-07-01,215,8,-2,39,28,288
Afghanistan,2012-07-01,265,2,-2,41,47,353
Afghanistan,2012-07-01,214,2,0,34,30,280
Afghanistan,2012-07-01,164,6,-4,-14,23,175
Afghanistan,2012-07-01,130,4,-2,74,13,219
Afghanistan,2012-07-01,144,8,0,27,6,185
Afghanistan,2012-07-01,235,4,-4,66,106,407
Afghanistan,2012-07-01,105,0,0,18,25,148
Afghanistan,2012-07-01,157,2,0,55,14,228
Afghanistan,2012-07-01,190,2,0,61,31,284
Afghanistan,2012-07-01,82,0,-4,17,18,113
Afghanistan,2012-07-01,132,0,-4,14,19,161
Afghanistan,2012-07-01,112,0,-6,30,12,148
Afghanistan,2012-07-01,163,8,-1,42,46,258
Afghanistan,2012-07-01,140,2,1,30,32,205
Afghanistan,2012-07-01,201,2,2,21,9,235
Afghanistan,2012-07-01,314,4,4,90,17,429
Afghanistan,2012-07-01,233,2,4,110,9,358
Afghanistan,2012-07-01,235,0,-1,97,18,349
Afghanistan,2012-07-01,169,2,-4,44,6,217
Afghanistan,2012-07-01,191,2,-1,65,8,265
Afghanistan,2012-07-01,204,0,1,46,10,261
Afghanistan,2012-07-01,209,2,0,52,2,265
Afghanistan,2012-07-01,160,0,0,78,12,250
Albania,2012-07-01,2,0,0,0,0,2
Albania,2012-07-01,12,0,0,0,1,13
Albania,2012-07-01,4,6,0,-4,2,8
Albania,2012-07-01,5,2,0,6,0,13
Albania,2012-07-01,13,0,0,0,2,15
Albania,2012-07-01,7,0,0,15,1,23
Albania,2012-07-01,6,0,0,0,0,6
Albania,2012-07-01,2,4,0,0,1,7
Albania,2012-07-01,22,0,1,27,8,58
Albania,2012-07-01,15,0,-2,0,2,15
Albania,2012-07-01,16,0,0,-6,1,11
Albania,2012-07-01,-1,0,-6,0,6,-1
Albania,2012-07-01,7,0,-2,0,1,6
Albania,2012-07-01,0,0,0,0,0,0
Albania,2012-07-01,18,0,0,9,2,29
Albania,2012-07-01,6,0,0,0,0,6
Albania,2012-07-01,2,0,0,3,0,5
Albania,2012-07-01,1,0,0,0,0,1
Albania,2012-07-01,-1,0,0,0,0,-1
Albania,2012-07-01,0,0,0,0,0,0
Albania,2012-07-01,0,0,0,0,1,1
Albania,2012-07-01,1,0,-1,3,0,3
Albania,2012-07-01,4,0,0,3,0,7
Albania,2012-07-01,1,0,0,6,0,7
Albania,2012-07-01,5,0,0,0,0,5
Albania,2012-07-01,0,0,0,0,0,0
Albania,2012-07-01,0,0,0,0,0,0
Albania,2012-07-01,12,0,-1,0,0,11
Albania,2012-07-01,29,0,-1,6,4,38
Albania,2012-07-01,7,0,-1,3,0,9
Algeria,2012-07-01,7,0,-6,0,0,1
Algeria,2012-07-01,12,0,0,0,0,12
Algeria,2012-07-01,4,0,0,27,0,31
Algeria,2012-07-01,18,0,-2,18,0,34
Algeria,2012-07-01,56,0,0,12,2,70
Algeria,2012-07-01,21,0,0,4,3,28
Algeria,2012-07-01,12,0,0,1,0,13
Algeria,2012-07-01,1,0,0,0,0,1
Algeria,2012-07-01,7,0,1,0,0,8
Algeria,2012-07-01,10,2,0,0,0,12
Algeria,2012-07-01,13,0,1,-14,0,0
Algeria,2012-07-01,27,0,0,2,0,29
Algeria,2012-07-01,12,0,0,-12,1,1
Algeria,2012-07-01,6,0,0,-12,2,-4
Algeria,2012-07-01,5,0,0,0,0,5
Algeria,2012-07-01,13,0,0,-6,0,7
Algeria,2012-07-01,-4,0,0,-6,0,-10
Algeria,2012-07-01,4,0,0,0,6,10
Algeria,2012-07-01,-3,0,0,-3,0,-6
Algeria,2012-07-01,20,0,0,33,4,57
Algeria,2012-07-01,0,0,0,6,0,6
Algeria,2012-07-01,19,0,0,6,2,27
Algeria,2012-07-01,16,0,-16,7,1,8
Algeria,2012-07-01,7,0,0,0,0,7
Algeria,2012-07-01,14,0,0,0,0,14
Algeria,2012-07-01,15,0,0,0,1,16
Algeria,2012-07-01,1,0,0,1,0,2
Algeria,2012-07-01,3,0,0,0,1,4
Algeria,2012-07-01,0,0,0,-4,0,-4
Algeria,2012-07-01,4,0,-3,-2,1,0
Algeria,2012-07-01,14,0,0,9,2,25
Bangladesh,2012-07-01,34,2,0,-2,4,38
Bangladesh,2012-07-01,37,0,1,23,3,64
Bangladesh,2012-07-01,13,0,0,2,1,16
Bangladesh,2012-07-01,9,0,0,16,0,25
Bangladesh,2012-07-01,10,0,0,18,2,30
Bangladesh,2012-07-01,10,0,0,6,1,17
Bangladesh,2012-07-01,10,0,0,8,2,20
Bangladesh,2012-07-01,32,0,0,10,1,43
Bangladesh,2012-07-01,26,0,2,34,2,64
Bangladesh,2012-07-01,36,0,0,12,0,48
Bangladesh,2012-07-01,10,0,3,2,0,15
Bangladesh,2012-07-01,13,0,0,-2,1,12
Bangladesh,2012-07-01,15,0,-2,30,2,45
Bangladesh,2012-07-01,11,0,-2,14,1,24
Bangladesh,2012-07-01,5,0,0,2,4,11
Bangladesh,2012-07-01,28,0,-2,12,4,42
Bangladesh,2012-07-01,22,0,-12,4,2,16
Bangladesh,2012-07-01,14,0,-4,1,0,11
Bangladesh,2012-07-01,29,0,0,0,3,32
Bangladesh,2012-07-01,53,0,0,20,9,82
Bangladesh,2012-07-01,36,0,0,-5,7,38
Bangladesh,2012-07-01,3,0,1,12,3,19
Bangladesh,2012-07-01,45,0,1,6,11,63
Bangladesh,2012-07-01,52,4,-2,15,15,84
Bangladesh,2012-07-01,199,0,0,7,7,213
Bangladesh,2012-07-01,78,0,-6,9,3,84
Bangladesh,2012-07-01,76,0,-4,9,4,85
Bangladesh,2012-07-01,57,0,-4,15,7,75
Bangladesh,2012-07-01,78,0,-1,10,6,93
Bangladesh,2012-07-01,61,0,1,31,8,101
Bangladesh,2012-07-01,61,0,1,14,5,81
Cameroon,2012-07-01,0,0,0,-2,0,-2
Cameroon,2012-07-01,5,0,0,0,0,5
Cameroon,2012-07-01,4,0,0,0,0,4
Cameroon,2012-07-01,3,0,0,0,0,3
Cameroon,2012-07-01,1,0,0,0,0,1
Cameroon,2012-07-01,0,0,0,0,0,0
Cameroon,2012-07-01,3,0,0,0,0,3
Cameroon,2012-07-01,0,0,0,0,0,0
Cameroon,2012-07-01,2,0,0,0,0,2
Cameroon,2012-07-01,1,0,0,0,0,1
Cameroon,2012-07-01,2,0,0,9,0,11
Cameroon,2012-07-01,4,0,0,0,0,4
Cameroon,2012-07-01,0,0,1,0,0,1
Cameroon,2012-07-01,0,0,0,6,0,6
Cameroon,2012-07-01,12,0,0,12,2,26
Cameroon,2012-07-01,6,0,0,0,0,6
Cameroon,2012-07-01,3,0,0,0,0,3
Cameroon,2012-07-01,0,0,0,0,0,0
Cameroon,2012-07-01,2,0,0,-2,0,0
Cameroon,2012-07-01,1,6,0,0,0,7
Cameroon,2012-07-01,2,0,0,0,0,2
Cameroon,2012-07-01,7,0,0,4,0,11
Cameroon,2012-07-01,0,0,0,3,0,3
Cameroon,2012-07-01,2,0,0,0,0,2
Cameroon,2012-07-01,5,0,0,6,0,11
Cameroon,2012-07-01,0,0,0,0,0,0
Cameroon,2012-07-01,2,0,0,0,0,2
Cameroon,2012-07-01,0,0,0,0,0,0
China,2012-07-01,86,0,5,71,27,189
China,2012-07-01,162,6,2,43,16,229
China,2012-07-01,137,2,1,50,27,217
China,2012-07-01,139,2,-7,58,22,214
China,2012-07-01,259,8,1,77,14,359
China,2012-07-01,289,8,-9,80,19,387
China,2012-07-01,80,0,-6,21,9,104
China,2012-07-01,105,0,0,20,17,142
China,2012-07-01,187,0,-5,59,17,258
China,2012-07-01,166,2,-1,128,26,321
China,2012-07-01,193,2,0,77,14,286
China,2012-07-01,84,0,0,41,7,132
China,2012-07-01,233,2,-8,52,33,312
China,2012-07-01,133,0,-4,65,8,202
China,2012-07-01,175,0,-1,43,16,233
China,2012-07-01,212,2,-3,44,12,267
China,2012-07-01,251,6,1,79,18,355
China,2012-07-01,165,4,-7,23,7,192
China,2012-07-01,259,0,-7,83,51,386
China,2012-07-01,169,6,-10,50,9,224
China,2012-07-01,139,4,0,38,8,189
China,2012-07-01,94,2,-4,53,5,150
China,2012-07-01,185,0,-1,51,49,284
China,2012-07-01,191,2,3,8,31,235
China,2012-07-01,178,2,2,154,23,359
China,2012-07-01,250,8,2,147,40,447
China,2012-07-01,133,2,-12,78,25,226
China,2012-07-01,127,0,-3,13,10,147
China,2012-07-01,120,2,1,34,12,169
China,2012-07-01,189,4,0,110,26,329
China,2012-07-01,222,6,-7,134,24,379
Egypt,2012-07-01,83,2,-10,29,14,118
Egypt,2012-07-01,159,0,-11,50,22,220
Egypt,2012-07-01,143,0,-7,-9,10,137
Egypt,2012-07-01,86,0,-6,66,9,155
Egypt,2012-07-01,85,6,-22,41,15,125
Egypt,2012-07-01,92,0,-10,1,8,91
Egypt,2012-07-01,67,0,-5,19,22,103
Egypt,2012-07-01,176,0,-4,68,12,252
Egypt,2012-07-01,184,0,-9,51,22,248
Egypt,2012-07-01,157,0,17,75,17,266
Egypt,2012-07-01,149,0,-4,48,19,212
Egypt,2012-07-01,71,0,0,16,11,98
Egypt,2012-07-01,106,2,-1,24,16,147
Egypt,2012-07-01,42,0,1,36,23,102
Egypt,2012-07-01,76,0,3,46,17,142
Egypt,2012-07-01,97,0,2,52,16,167
Egypt,2012-07-01,81,0,-2,31,15,125
Egypt,2012-07-01,39,0,0,6,7,52
Egypt,2012-07-01,129,0,-13,22,3,141
Egypt,2012-07-01,91,0,-6,33,5,123
Egypt,2012-07-01,20,0,0,50,1,71
Egypt,2012-07-01,135,0,-1,23,10,167
Egypt,2012-07-01,15,0,2,12,2,31
Egypt,2012-07-01,80,2,0,3,1,86
Egypt,2012-07-01,86,0,-7,25,5,109
Egypt,2012-07-01,66,0,2,1,3,72
Egypt,2012-07-01,44,0,-6,18,5,61
Egypt,2012-07-01,55,0,-6,9,5,63
Egypt,2012-07-01,85,0,-4,4,17,102
Egypt,2012-07-01,70,0,-2,-6,7,69
Egypt,2012-07-01,65,4,-2,34,7,108
Eritrea,2012-07-01,6,0,0,3,0,9
Eritrea,2012-07-01,0,0,0,4,0,4
Eritrea,2012-07-01,6,0,0,0,2,8
Eritrea,2012-07-01,2,0,0,6,0,8
Eritrea,2012-07-01,4,0,0,12,0,16
Eritrea,2012-07-01,3,0,0,-1,2,4
Eritrea,2012-07-01,0,0,0,3,0,3
Eritrea,2012-07-01,9,0,0,3,0,12
Eritrea,2012-07-01,2,0,0,0,0,2
Eritrea,2012-07-01,2,0,0,6,0,8
Eritrea,2012-07-01,2,0,0,3,0,5
Eritrea,2012-07-01,0,0,0,0,2,2
Eritrea,2012-07-01,4,0,0,6,0,10
Eritrea,2012-07-01,9,0,0,0,0,9
Eritrea,2012-07-01,0,0,0,0,0,0
Eritrea,2012-07-01,0,0,0,0,0,0
Eritrea,2012-07-01,14,0,0,12,10,36
Eritrea,2012-07-01,15,0,0,0,0,15
Eritrea,2012-07-01,1,0,0,6,0,7
Eritrea,2012-07-01,1,0,0,0,1,2
Eritrea,2012-07-01,0,0,0,0,0,0
Eritrea,2012-07-01,0,0,0,0,0,0
Eritrea,2012-07-01,3,0,0,6,0,9
Eritrea,2012-07-01,6,0,0,0,0,6
Eritrea,2012-07-01,0,0,0,0,0,0
Eritrea,2012-07-01,14,0,0,0,0,14
Eritrea,2012-07-01,0,0,0,0,0,0
Eritrea,2012-07-01,0,0,0,3,0,3
Eritrea,2012-07-01,1,0,0,-2,1,0
Eritrea,2012-07-01,-1,0,0,0,2,1
Eritrea,2012-07-01,1,0,2,3,0,6
Georgia,2012-07-01,2,0,0,3,0,5
Georgia,2012-07-01,2,0,0,0,0,2
Georgia,2012-07-01,0,0,0,2,0,2
Georgia,2012-07-01,4,0,0,0,0,4
Georgia,2012-07-01,2,0,0,0,0,2
Georgia,2012-07-01,4,0,0,0,0,4
Georgia,2012-07-01,2,0,0,0,0,2
Georgia,2012-07-01,1,0,0,0,0,1
Georgia,2012-07-01,0,0,0,0,0,0
Georgia,2012-07-01,2,0,0,0,0,2
Georgia,2012-07-01,1,0,0,0,0,1
Georgia,2012-07-01,1,0,0,0,0,1
Georgia,2012-07-01,0,0,0,0,0,0
Georgia,2012-07-01,2,0,0,0,0,2
Georgia,2012-07-01,2,0,0,12,0,14
Georgia,2012-07-01,0,0,0,3,0,3
Georgia,2012-07-01,0,2,0,0,1,3
Georgia,2012-07-01,3,0,0,0,3,6
Georgia,2012-07-01,-1,0,0,0,0,-1
Georgia,2012-07-01,8,0,0,0,0,8
Georgia,2012-07-01,6,0,0,0,3,9
Georgia,2012-07-01,0,2,0,0,0,2
Georgia,2012-07-01,0,0,0,0,0,0
Georgia,2012-07-01,0,0,0,0,5,5
Georgia,2012-07-01,0,0,0,0,2,2
Georgia,2012-07-01,0,0,0,0,0,0
Georgia,2012-07-01,3,0,0,0,0,3
Georgia,2012-07-01,3,0,0,0,4,7
India,2012-07-01,48,0,1,19,19,87
India,2012-07-01,62,0,-4,7,11,76
India,2012-07-01,53,6,-5,30,7,91
India,2012-07-01,66,0,-2,12,10,86
India,2012-07-01,64,0,0,7,13,84
India,2012-07-01,90,0,-1,1,10,100
India,2012-07-01,44,0,-3,7,2,50
India,2012-07-01,55,0,-2,1,6,60
India,2012-07-01,85,2,-8,16,11,106
India,2012-07-01,80,2,0,42,8,132
India,2012-07-01,85,0,-2,12,12,107
India,2012-07-01,52,0,2,37,5,96
India,2012-07-01,83,2,0,46,19,150
India,2012-07-01,37,2,0,6,10,55
India,2012-07-01,51,0,-2,13,6,68
India,2012-07-01,113,0,-6,17,18,142
India,2012-07-01,78,0,-2,36,9,121
India,2012-07-01,70,0,-1,29,11,109
India,2012-07-01,104,2,3,31,27,167
India,2012-07-01,101,2,-6,21,22,140
India,2012-07-01,39,2,-7,24,32,90
India,2012-07-01,98,4,-6,24,14,134
India,2012-07-01,68,2,-4,8,11,85
India,2012-07-01,10,0,-3,10,2,19
India,2012-07-01,81,2,-2,28,10,119
India,2012-07-01,130,2,-2,14,15,159
India,2012-07-01,103,2,1,18,8,132
India,2012-07-01,67,0,1,15,7,90
India,2012-07-01,26,6,1,23,6,62
India,2012-07-01,69,2,0,76,23,170
India,2012-07-01,79,2,-1,51,6,137
Iran,2012-07-01,81,0,4,19,13,117
Iran,2012-07-01,103,2,4,55,18,182
Iran,2012-07-01,264,2,5,36,21,328
Iran,2012-07-01,171,0,3,71,10,255
Iran,2012-07-01,135,0,3,61,5,204
Iran,2012-07-01,129,0,1,21,11,162
Iran,2012-07-01,116,0,-5,48,13,172
Iran,2012-07-01,126,0,-1,45,0,170
Iran,2012-07-01,120,0,2,47,6,175
Iran,2012-07-01,99,0,0,34,6,139
Iran,2012-07-01,113,0,-2,10,6,127
Iran,2012-07-01,53,0,0,11,0,64
Iran,2012-07-01,99,2,-3,100,20,218
Iran,2012-07-01,86,0,0,81,13,180
Iran,2012-07-01,86,0,0,68,5,159
Iran,2012-07-01,141,0,1,25,17,184
Iran,2012-07-01,145,0,-4,21,12,174
Iran,2012-07-01,113,0,-4,34,10,153
Iran,2012-07-01,255,0,2,83,18,358
Iran,2012-07-01,118,2,-2,29,68,215
Iran,2012-07-01,97,0,0,27,43,167
Iran,2012-07-01,157,2,0,16,19,194
Iran,2012-07-01,159,0,0,60,20,239
Iran,2012-07-01,191,2,-7,65,31,282
Iran,2012-07-01,174,0,-5,31,29,229
Iran,2012-07-01,141,0,-3,39,17,194
Iran,2012-07-01,58,0,-2,52,14,122
Iran,2012-07-01,65,0,0,3,11,79
Iran,2012-07-01,125,0,2,21,7,155
Iran,2012-07-01,106,4,0,73,17,200
Iran,2012-07-01,194,4,-3,67,15,277
Iraq,2012-07-01,114,0,0,2,5,121
Iraq,2012-07-01,207,4,1,38,3,253
Iraq,2012-07-01,110,0,-3,24,18,149
Iraq,2012-07-01,149,10,-2,28,13,198
Iraq,2012-07-01,168,8,0,41,1,218
Iraq,2012-07-01,81,4,0,14,4,103
Iraq,2012-07-01,21,0,1,-2,0,20
Iraq,2012-07-01,48,4,0,0,2,54
Iraq,2012-07-01,81,8,0,37,5,131
Iraq,2012-07-01,72,2,0,-9,2,67
Iraq,2012-07-01,83,2,0,10,3,98
Iraq,2012-07-01,48,0,-2,2,4,52
Iraq,2012-07-01,94,0,0,21,8,123
Iraq,2012-07-01,41,4,3,2,5,55
Iraq,2012-07-01,77,0,0,17,2,96
Iraq,2012-07-01,154,0,1,30,10,195
Iraq,2012-07-01,240,2,0,39,6,287
Iraq,2012-07-01,80,0,0,14,3,97
Iraq,2012-07-01,178,2,1,24,16,221
Iraq,2012-07-01,341,2,0,40,17,400
Iraq,2012-07-01,248,0,-2,24,9,279
Iraq,2012-07-01,181,0,0,12,10,203
Iraq,2012-07-01,200,4,-27,10,16,203
Iraq,2012-07-01,167,2,6,-19,4,160
Iraq,2012-07-01,149,0,-1,-11,16,153
Iraq,2012-07-01,268,0,-2,-15,24,275
Iraq,2012-07-01,126,0,-6,7,5,132
Iraq,2012-07-01,170,0,1,-8,0,163
Iraq,2012-07-01,110,2,-1,18,3,132
Iraq,2012-07-01,104,6,0,-4,8,114
Iraq,2012-07-01,148,4,2,15,8,177
Morocco,2012-07-01,5,0,0,9,0,14
Morocco,2012-07-01,0,0,0,6,1,7
Morocco,2012-07-01,1,0,0,0,0,1
Morocco,2012-07-01,1,0,0,-2,0,-1
Morocco,2012-07-01,6,0,0,0,0,6
Morocco,2012-07-01,13,0,-4,0,3,12
Morocco,2012-07-01,0,0,0,9,0,9
Morocco,2012-07-01,7,0,-3,60,2,66
Morocco,2012-07-01,4,0,0,22,0,26
Morocco,2012-07-01,21,0,0,18,0,39
Morocco,2012-07-01,29,0,0,15,9,53
Morocco,2012-07-01,6,0,0,3,0,9
Morocco,2012-07-01,2,0,0,3,0,5
Morocco,2012-07-01,2,0,0,0,3,5
Morocco,2012-07-01,1,0,0,0,0,1
Morocco,2012-07-01,23,0,-1,6,2,30
Morocco,2012-07-01,35,0,0,15,1,51
Morocco,2012-07-01,-1,0,0,3,0,2
Morocco,2012-07-01,7,0,0,11,0,18
Morocco,2012-07-01,5,0,1,0,1,7
Morocco,2012-07-01,2,0,0,0,0,2
Morocco,2012-07-01,2,0,0,0,0,2
Morocco,2012-07-01,7,0,0,0,1,8
Morocco,2012-07-01,4,0,0,0,0,4
Morocco,2012-07-01,8,0,0,-4,2,6
Morocco,2012-07-01,13,0,0,0,1,14
Morocco,2012-07-01,8,0,0,3,0,11
Morocco,2012-07-01,1,0,0,0,0,1
Morocco,2012-07-01,4,2,0,-8,0,-2
Morocco,2012-07-01,1,0,0,0,0,1
Morocco,2012-07-01,7,0,0,0,0,7
Nigeria,2012-07-01,6,2,-1,10,6,23
Nigeria,2012-07-01,25,0,0,26,4,55
Nigeria,2012-07-01,25,2,0,28,5,60
Nigeria,2012-07-01,68,2,0,16,2,88
Nigeria,2012-07-01,18,0,0,12,4,34
Nigeria,2012-07-01,36,2,0,31,0,69
Nigeria,2012-07-01,23,0,0,1,1,25
Nigeria,2012-07-01,86,0,0,6,3,95
Nigeria,2012-07-01,95,0,7,36,4,142
Nigeria,2012-07-01,58,0,3,18,3,82
Nigeria,2012-07-01,27,0,0,12,2,41
Nigeria,2012-07-01,18,0,1,15,9,43
Nigeria,2012-07-01,17,0,1,4,3,25
Nigeria,2012-07-01,25,2,0,-2,3,28
Nigeria,2012-07-01,12,0,0,21,5,38
Nigeria,2012-07-01,26,0,1,16,6,49
Nigeria,2012-07-01,50,0,3,34,1,88
Nigeria,2012-07-01,18,0,1,12,6,37
Nigeria,2012-07-01,23,0,-5,4,6,28
Nigeria,2012-07-01,12,0,3,7,1,23
Nigeria,2012-07-01,0,0,-2,15,4,17
Nigeria,2012-07-01,26,0,0,4,1,31
Nigeria,2012-07-01,37,0,-4,10,2,45
Nigeria,2012-07-01,40,0,0,22,0,62
Nigeria,2012-07-01,27,0,0,9,5,41
Nigeria,2012-07-01,12,0,1,17,1,31
Nigeria,2012-07-01,25,2,0,14,3,44
Nigeria,2012-07-01,20,0,0,10,7,37
Nigeria,2012-07-01,17,0,0,-8,2,11
Nigeria,2012-07-01,37,0,-1,4,2,42
Nigeria,2012-07-01,33,0,0,32,6,71
Pakistan,2012-07-01,128,0,-1,33,6,166
Pakistan,2012-07-01,84,2,2,25,19,132
Pakistan,2012-07-01,174,0,-3,15,24,210
Pakistan,2012-07-01,108,0,-4,48,8,160
Pakistan,2012-07-01,102,6,0,52,5,165
Pakistan,2012-07-01,107,2,0,26,7,142
Pakistan,2012-07-01,68,0,-8,7,4,71
Pakistan,2012-07-01,161,0,0,28,12,201
Pakistan,2012-07-01,119,0,2,14,11,146
Pakistan,2012-07-01,175,0,-3,46,17,235
Pakistan,2012-07-01,66,0,-2,12,14,90
Pakistan,2012-07-01,54,0,0,10,4,68
Pakistan,2012-07-01,121,2,-13,26,15,151
Pakistan,2012-07-01,41,0,-1,20,6,66
Pakistan,2012-07-01,65,0,-2,26,5,94
Pakistan,2012-07-01,46,0,-1,30,8,83
Pakistan,2012-07-01,91,4,-1,12,5,111
Pakistan,2012-07-01,77,4,0,18,12,111
Pakistan,2012-07-01,119,0,1,68,36,224
Pakistan,2012-07-01,70,0,0,37,12,119
Pakistan,2012-07-01,76,2,-1,4,8,89
Pakistan,2012-07-01,146,0,0,28,20,194
Pakistan,2012-07-01,155,0,3,14,11,183
Pakistan,2012-07-01,62,0,5,5,11,83
Pakistan,2012-07-01,53,0,-1,45,11,108
Pakistan,2012-07-01,101,0,0,34,15,150
Pakistan,2012-07-01,55,0,0,32,8,95
Pakistan,2012-07-01,68,0,0,36,14,118
Pakistan,2012-07-01,86,0,1,40,6,133
Pakistan,2012-07-01,86,0,-2,46,4,134
Pakistan,2012-07-01,129,0,1,52,17,199
Sierra Leone,2012-07-01,6,0,0,0,2,8
Sierra Leone,2012-07-01,0,0,0,3,0,3
Sierra Leone,2012-07-01,3,0,0,0,0,3
Sierra Leone,2012-07-01,4,0,0,0,0,4
Sierra Leone,2012-07-01,3,0,0,9,0,12
Sierra Leone,2012-07-01,2,0,0,1,0,3
Sierra Leone,2012-07-01,1,0,0,12,0,13
Sierra Leone,2012-07-01,0,0,0,0,0,0
Sierra Leone,2012-07-01,3,0,0,0,0,3
Sierra Leone,2012-07-01,3,0,0,21,0,24
Sierra Leone,2012-07-01,4,0,0,0,0,4
Sierra Leone,2012-07-01,3,0,0,0,0,3
Sierra Leone,2012-07-01,3,0,0,0,0,3
Sierra Leone,2012-07-01,0,0,0,0,0,0
Sierra Leone,2012-07-01,8,6,0,0,1,15
Sierra Leone,2012-07-01,9,0,0,3,1,13
Sierra Leone,2012-07-01,0,0,0,0,0,0
Sierra Leone,2012-07-01,7,0,0,3,0,10
Sierra Leone,2012-07-01,0,0,0,27,0,27
Sierra Leone,2012-07-01,4,0,0,6,0,10
Sierra Leone,2012-07-01,0,0,0,0,0,0
Sierra Leone,2012-07-01,3,0,0,3,0,6
Sierra Leone,2012-07-01,-2,0,0,-2,0,-4
Sierra Leone,2012-07-01,1,0,0,3,0,4
Sierra Leone,2012-07-01,1,0,0,30,2,33
Sierra Leone,2012-07-01,-1,0,0,6,0,5
Sierra Leone,2012-07-01,0,0,0,0,0,0
Sierra Leone,2012-07-01,1,0,0,0,1,2
Sierra Leone,2012-07-01,0,0,0,9,0,9
Sierra Leone,2012-07-01,12,0,0,1,0,13
Somalia,2012-07-01,471,0,-4,40,34,541
Somalia,2012-07-01,202,4,0,6,28,240
Somalia,2012-07-01,112,0,-5,23,15,145
Somalia,2012-07-01,136,0,0,28,6,170
Somalia,2012-07-01,97,2,-4,37,10,142
Somalia,2012-07-01,103,0,-2,49,15,165
Somalia,2012-07-01,51,0,0,40,10,101
Somalia,2012-07-01,66,0,0,39,6,111
Somalia,2012-07-01,67,2,-4,41,5,111
Somalia,2012-07-01,64,0,4,21,8,97
Somalia,2012-07-01,69,0,3,5,17,94
Somalia,2012-07-01,45,0,-2,13,8,64
Somalia,2012-07-01,54,0,1,27,6,88
Somalia,2012-07-01,25,0,-1,30,9,63
Somalia,2012-07-01,34,0,1,18,10,63
Somalia,2012-07-01,120,0,-2,24,8,150
Somalia,2012-07-01,118,0,-2,46,2,164
Somalia,2012-07-01,57,0,0,10,15,82
Somalia,2012-07-01,79,0,3,31,14,127
Somalia,2012-07-01,78,4,-2,35,8,123
Somalia,2012-07-01,59,0,0,47,14,120
Somalia,2012-07-01,71,0,1,22,11,105
Somalia,2012-07-01,30,0,0,51,7,88
Somalia,2012-07-01,91,0,-1,-3,8,95
Somalia,2012-07-01,68,0,3,48,4,123
Somalia,2012-07-01,79,0,-2,37,6,120
Somalia,2012-07-01,56,0,-2,61,7,122
Somalia,2012-07-01,12,0,1,15,3,31
Somalia,2012-07-01,58,0,0,27,6,91
Somalia,2012-07-01,102,0,0,43,5,150
Somalia,2012-07-01,101,0,1,20,13,135
Syria,2012-07-01,330,0,-19,59,13,383
Syria,2012-07-01,695,0,-25,125,41,836
Syria,2012-07-01,481,0,-16,238,26,729
Syria,2012-07-01,553,0,-12,59,41,641
Syria,2012-07-01,494,0,-13,-26,29,484
Syria,2012-07-01,510,0,-12,41,37,576
Syria,2012-07-01,227,0,-2,30,54,309
Syria,2012-07-01,212,0,1,24,39,276
Syria,2012-07-01,376,2,-5,34,17,424
Syria,2012-07-01,337,16,0,15,27,395
Syria,2012-07-01,373,6,-6,10,42,425
Syria,2012-07-01,400,0,-18,10,16,408
Syria,2012-07-01,886,8,7,29,69,999
Syria,2012-07-01,699,4,-4,64,152,915
Syria,2012-07-01,503,0,1,53,34,591
Syria,2012-07-01,428,2,-12,75,29,522
Syria,2012-07-01,539,2,-3,65,64,667
Syria,2012-07-01,398,4,-2,45,49,494
Syria,2012-07-01,345,8,-7,34,47,427
Syria,2012-07-01,285,0,-72,91,41,345
Syria,2012-07-01,153,0,-1,-11,5,146
Syria,2012-07-01,241,0,-1,-5,13,248
Syria,2012-07-01,332,14,-7,43,18,400
Syria,2012-07-01,455,2,-23,31,29,494
Syria,2012-07-01,471,0,-4,87,35,589
Syria,2012-07-01,342,4,3,-1,43,391
Syria,2012-07-01,411,0,-2,47,35,491
Syria,2012-07-01,234,6,-1,19,18,276
Syria,2012-07-01,294,8,-2,30,29,359
Syria,2012-07-01,366,4,-6,-3,41,402
Syria,2012-07-01,234,0,-5,16,19,264
Yemen,2012-07-01,17,0,-2,6,0,21
Yemen,2012-07-01,17,0,0,-8,8,17
Yemen,2012-07-01,41,0,0,4,0,45
Yemen,2012-07-01,8,0,0,3,0,11
Yemen,2012-07-01,6,0,-2,8,0,12
Yemen,2012-07-01,45,0,0,9,3,57
Yemen,2012-07-01,39,0,0,0,1,40
Yemen,2012-07-01,24,0,0,3,2,29
Yemen,2012-07-01,15,0,-2,3,0,16
Yemen,2012-07-01,2,0,0,3,0,5
Yemen,2012-07-01,60,0,0,0,23,83
Yemen,2012-07-01,25,0,0,-4,4,25
Yemen,2012-07-01,33,0,-4,18,0,47
Yemen,2012-07-01,9,0,0,12,0,21
Yemen,2012-07-01,14,0,0,6,1,21
Yemen,2012-07-01,22,0,0,0,3,25
Yemen,2012-07-01,71,0,-8,-2,0,61
Yemen,2012-07-01,23,0,-4,6,0,25
Yemen,2012-07-01,101,0,0,31,9,141
Yemen,2012-07-01,75,0,0,12,1,88
Yemen,2012-07-01,22,0,0,6,0,28
Yemen,2012-07-01,10,0,0,10,1,21
Yemen,2012-07-01,8,0,-2,20,8,34
Yemen,2012-07-01,27,0,-2,6,0,31
Yemen,2012-07-01,8,0,0,24,1,33
Yemen,2012-07-01,10,0,0,6,3,19
Yemen,2012-07-01,21,0,0,0,2,23
Yemen,2012-07-01,8,2,0,0,0,10
Yemen,2012-07-01,16,0,0,36,0,52
Yemen,2012-07-01,114,0,-4,6,6,122
Yemen,2012-07-01,35,0,0,-2,3,36
Afghanistan,2009-10-01,420,2,2,47,32,503
Afghanistan,2009-10-01,369,2,4,37,17,429
Afghanistan,2009-10-01,242,6,1,22,30,301
Afghanistan,2009-10-01,265,0,1,22,24,312
Afghanistan,2009-10-01,400,0,1,34,68,503
Afghanistan,2009-10-01,444,4,-2,53,63,562
Afghanistan,2009-10-01,523,2,3,49,32,609
Afghanistan,2009-10-01,380,0,4,25,50,459
Afghanistan,2009-10-01,501,2,1,30,97,631
Afghanistan,2009-10-01,351,2,-3,45,55,450
Afghanistan,2009-10-01,196,0,3,35,31,265
Afghanistan,2009-10-01,455,4,2,26,61,548
Afghanistan,2009-10-01,347,6,2,92,46,493
Afghanistan,2009-10-01,340,0,1,28,21,390
Afghanistan,2009-10-01,409,4,2,98,58,571
Afghanistan,2009-10-01,187,2,-2,10,10,207
Afghanistan,2009-10-01,305,0,-2,33,26,362
Afghanistan,2009-10-01,267,6,1,47,53,374
Afghanistan,2009-10-01,383,2,10,88,47,530
Afghanistan,2009-10-01,421,10,-37,67,52,513
Afghanistan,2009-10-01,266,2,-12,67,26,349
Afghanistan,2009-10-01,385,4,-12,75,38,490
Afghanistan,2009-10-01,296,2,-3,58,74,427
Afghanistan,2009-10-01,271,0,5,81,47,404
Afghanistan,2009-10-01,199,6,-9,9,35,240
Afghanistan,2009-10-01,457,4,-4,40,45,542
Afghanistan,2009-10-01,475,0,3,52,53,583
Afghanistan,2009-10-01,404,4,1,100,35,544
Afghanistan,2009-10-01,506,4,3,113,48,674
Afghanistan,2009-10-01,378,0,-3,54,53,482
Afghanistan,2009-10-01,229,6,-8,42,26,295
Albania,2009-10-01,10,0,0,-8,3,5
Albania,2009-10-01,12,0,-2,20,1,31
Albania,2009-10-01,24,0,0,9,0,33
Albania,2009-10-01,0,0,0,0,0,0
Albania,2009-10-01,0,0,0,0,0,0
Albania,2009-10-01,0,0,-2,-4,1,-5
Albania,2009-10-01,8,0,2,-2,4,12
Albania,2009-10-01,12,0,0,6,2,20
Albania,2009-10-01,6,0,0,12,3,21
Albania,2009-10-01,1,0,0,0,1,2
Albania,2009-10-01,0,0,0,6,3,9
Albania,2009-10-01,0,0,0,0,0,0
Albania,2009-10-01,8,0,0,6,2,16
Albania,2009-10-01,19,0,-1,-2,1,17
Albania,2009-10-01,11,0,0,1,0,12
Albania,2009-10-01,0,0,0,0,2,2
Albania,2009-10-01,0,0,0,0,0,0
Albania,2009-10-01,0,0,0,0,0,0
Albania,2009-10-01,1,0,1,6,0,8
Albania,2009-10-01,10,0,0,0,0,10
Albania,2009-10-01,4,0,0,6,0,10
Albania,2009-10-01,9,0,0,3,0,12
Albania,2009-10-01,5,0,0,0,0,5
Albania,2009-10-01,2,0,0,1,0,3
Albania,2009-10-01,10,0,0,12,0,22
Albania,2009-10-01,5,0,0,6,0,11
Albania,2009-10-01,6,0,0,0,0,6
Albania,2009-10-01,6,0,0,-2,0,4
Albania,2009-10-01,9,0,0,39,0,48
Albania,2009-10-01,3,0,0,-6,0,-3
Albania,2009-10-01,0,0,0,-4,0,-4
Algeria,2009-10-01,0,0,0,0,1,1
Algeria,2009-10-01,8,0,0,0,0,8
Algeria,2009-10-01,1,0,0,0,1,2
Algeria,2009-10-01,0,0,0,0,0,0
Algeria,2009-10-01,19,0,0,0,0,19
Algeria,2009-10-01,14,0,0,0,0,14
Algeria,2009-10-01,1,0,0,1,1,3
Algeria,2009-10-01,7,0,0,6,1,14
Algeria,2009-10-01,7,0,0,27,0,34
Algeria,2009-10-01,2,0,0,-1,0,1
Algeria,2009-10-01,1,0,0,3,0,4
Algeria,2009-10-01,4,0,0,9,1,14
Algeria,2009-10-01,14,0,0,3,0,17
Algeria,2009-10-01,1,0,0,19,0,20
Algeria,2009-10-01,4,0,0,10,0,14
Algeria,2009-10-01,0,0,0,0,0,0
Algeria,2009-10-01,0,0,0,0,0,0
Algeria,2009-10-01,1,0,0,9,0,10
Algeria,2009-10-01,9,0,0,11,4,24
Algeria,2009-10-01,43,0,0,7,0,50
Algeria,2009-10-01,19,0,0,1,2,22
Algeria,2009-10-01,11,0,0,0,0,11
Algeria,2009-10-01,1,0,0,0,0,1
Algeria,2009-10-01,2,0,0,0,0,2
Algeria,2009-10-01,7,0,0,0,2,9
Algeria,2009-10-01,2,0,0,-5,3,0
Algeria,2009-10-01,47,0,0,0,0,47
Algeria,2009-10-01,28,0,0,7,0,35
Algeria,2009-10-01,8,0,0,-4,0,4
Algeria,2009-10-01,3,0,0,3,0,6
Bangladesh,2009-10-01,7,0,-1,3,1,10
Bangladesh,2009-10-01,15,0,-1,6,0,20
Bangladesh,2009-10-01,18,0,0,2,3,23
Bangladesh,2009-10-01,7,0,-1,1,2,9
Bangladesh,2009-10-01,19,0,0,1,3,23
Bangladesh,2009-10-01,9,0,0,0,0,9
Bangladesh,2009-10-01,18,0,0,9,1,28
Bangladesh,2009-10-01,16,0,1,6,1,24
Bangladesh,2009-10-01,8,0,0,0,2,10
Bangladesh,2009-10-01,10,0,-3,0,0,7
Bangladesh,2009-10-01,17,0,0,-2,2,17
Bangladesh,2009-10-01,17,0,0,-5,2,14
Bangladesh,2009-10-01,13,0,0,21,2,36
Bangladesh,2009-10-01,15,2,0,9,1,27
Bangladesh,2009-10-01,2,0,0,1,1,4
Bangladesh,2009-10-01,14,0,0,1,0,15
Bangladesh,2009-10-01,28,0,0,0,3,31
Bangladesh,2009-10-01,10,0,0,3,1,14
Bangladesh,2009-10-01,0,0,0,6,2,8
Bangladesh,2009-10-01,22,0,2,3,0,27
Bangladesh,2009-10-01,15,0,0,-1,2,16
Bangladesh,2009-10-01,15,0,-2,3,0,16
Bangladesh,2009-10-01,33,0,0,30,4,67
Bangladesh,2009-10-01,12,0,0,0,2,14
Bangladesh,2009-10-01,7,0,0,12,0,19
Bangladesh,2009-10-01,24,0,0,13,0,37
Bangladesh,2009-10-01,7,0,0,1,6,14
Bangladesh,2009-10-01,23,0,-2,3,1,25
Bangladesh,2009-10-01,17,0,0,16,0,33
Bangladesh,2009-10-01,12,6,0,12,0,30
Bangladesh,2009-10-01,6,0,0,3,3,12
Cameroon,2009-10-01,0,0,0,0,0,0
Cameroon,2009-10-01,6,0,0,0,1,7
Cameroon,2009-10-01,0,0,0,0,0,0
Cameroon,2009-10-01,1,0,2,0,0,3
Cameroon,2009-10-01,0,0,0,3,2,5
Cameroon,2009-10-01,2,0,0,0,0,2
Cameroon,2009-10-01,0,0,0,0,0,0
Cameroon,2009-10-01,4,0,0,3,0,7
Cameroon,2009-10-01,0,0,0,0,0,0
Cameroon,2009-10-01,7,0,0,5,0,12
Cameroon,2009-10-01,0,0,0,0,0,0
Cameroon,2009-10-01,0,0,0,0,0,0
Cameroon,2009-10-01,0,0,0,0,0,0
Cameroon,2009-10-01,1,0,1,6,1,9
Cameroon,2009-10-01,1,0,0,0,0,1
Cameroon,2009-10-01,0,0,0,3,2,5
Cameroon,2009-10-01,0,0,0,0,0,0
Cameroon,2009-10-01,7,0,0,0,0,7
Cameroon,2009-10-01,3,0,0,6,0,9
Cameroon,2009-10-01,0,0,0,0,0,0
Cameroon,2009-10-01,0,0,0,0,0,0
Cameroon,2009-10-01,10,0,0,0,0,10
Cameroon,2009-10-01,4,0,0,0,0,4
Cameroon,2009-10-01,2,0,0,0,0,2
Cameroon,2009-10-01,4,0,0,3,0,7
Cameroon,2009-10-01,5,0,0,0,0,5
Cameroon,2009-10-01,3,0,0,0,0,3
Cameroon,2009-10-01,8,0,0,0,0,8
Cameroon,2009-10-01,0,0,0,0,0,0
China,2009-10-01,112,0,-9,57,26,186
China,2009-10-01,131,10,-2,51,21,211
China,2009-10-01,49,2,0,16,3,70
China,2009-10-01,79,0,-12,60,18,145
China,2009-10-01,71,4,0,54,19,148
China,2009-10-01,114,4,-10,17,10,135
China,2009-10-01,117,10,-2,31,15,171
China,2009-10-01,194,2,1,56,12,265
China,2009-10-01,158,0,-2,25,12,193
China,2009-10-01,49,18,0,21,4,92
China,2009-10-01,57,8,-2,33,7,103
China,2009-10-01,195,2,0,185,32,414
China,2009-10-01,164,4,-4,95,19,278
China,2009-10-01,186,2,-9,46,18,243
China,2009-10-01,146,4,-2,97,18,263
China,2009-10-01,16,0,-4,13,5,30
China,2009-10-01,99,0,-2,39,10,146
China,2009-10-01,56,4,0,22,6,88
China,2009-10-01,138,2,-6,160,15,309
China,2009-10-01,172,2,-1,33,25,231
China,2009-10-01,154,8,2,67,40,271
China,2009-10-01,153,2,0,35,10,200
China,2009-10-01,61,0,-3,58,16,132
China,2009-10-01,47,2,-3,4,15,65
China,2009-10-01,82,2,0,6,18,108
China,2009-10-01,88,0,-4,7,21,112
China,2009-10-01,136,0,-2,60,18,212
China,2009-10-01,125,2,-8,63,7,189
China,2009-10-01,142,5,-6,93,20,254
China,2009-10-01,103,4,2,48,12,169
China,2009-10-01,144,0,0,13,7,164
Egypt,2009-10-01,55,0,0,5,4,64
Egypt,2009-10-01,56,0,-1,-7,0,48
Egypt,2009-10-01,23,0,0,-5,3,21
Egypt,2009-10-01,37,0,0,0,0,37
Egypt,2009-10-01,45,0,0,56,1,102
Egypt,2009-10-01,37,0,0,39,2,78
Egypt,2009-10-01,35,4,0,59,3,101
Egypt,2009-10-01,37,4,0,58,3,102
Egypt,2009-10-01,39,4,0,13,0,56
Egypt,2009-10-01,14,0,0,14,2,30
Egypt,2009-10-01,39,0,0,37,2,78
Egypt,2009-10-01,24,0,-2,11,8,41
Egypt,2009-10-01,66,2,-2,31,5,102
Egypt,2009-10-01,61,2,0,61,1,125
Egypt,2009-10-01,49,0,4,21,4,78
Egypt,2009-10-01,26,0,0,9,5,40
Egypt,2009-10-01,43,0,-2,-5,2,38
Egypt,2009-10-01,42,0,0,7,0,49
Egypt,2009-10-01,50,0,0,13,4,67
Egypt,2009-10-01,15,0,1,12,4,32
Egypt,2009-10-01,19,0,0,21,4,44
Egypt,2009-10-01,41,0,0,0,1,42
Egypt,2009-10-01,35,0,-2,-6,3,30
Egypt,2009-10-01,31,0,2,10,0,43
Egypt,2009-10-01,33,0,0,4,0,37
Egypt,2009-10-01,82,0,-2,66,11,157
Egypt,2009-10-01,57,0,-2,13,3,71
Egypt,2009-10-01,41,0,0,39,7,87
Egypt,2009-10-01,17,0,1,18,2,38
Egypt,2009-10-01,15,0,0,9,0,24
Egypt,2009-10-01,19,0,1,15,0,35
Eritrea,2009-10-01,-1,0,0,0,0,-1
Eritrea,2009-10-01,6,0,0,0,0,6
Eritrea,2009-10-01,-1,0,0,4,0,3
Eritrea,2009-10-01,5,0,0,0,0,5
Eritrea,2009-10-01,0,0,0,0,0,0
Eritrea,2009-10-01,1,0,0,-2,0,-1
Eritrea,2009-10-01,3,0,0,0,0,3
Eritrea,2009-10-01,2,0,0,0,0,2
Eritrea,2009-10-01,10,0,0,0,0,10
Eritrea,2009-10-01,0,0,0,0,0,0
Eritrea,2009-10-01,0,0,0,0,0,0
Eritrea,2009-10-01,2,0,0,0,0,2
Eritrea,2009-10-01,6,0,0,-2,1,5
Eritrea,2009-10-01,0,0,0,0,0,0
Eritrea,2009-10-01,3,0,0,0,0,3
Eritrea,2009-10-01,0,0,0,0,0,0
Eritrea,2009-10-01,7,0,0,-2,0,5
Eritrea,2009-10-01,0,0,0,0,0,0
Eritrea,2009-10-01,9,0,0,-6,0,3
Eritrea,2009-10-01,1,0,0,-6,0,-5
Eritrea,2009-10-01,7,0,0,0,0,7
Eritrea,2009-10-01,0,0,0,0,0,0
Eritrea,2009-10-01,8,0,0,0,0,8
Eritrea,2009-10-01,10,0,0,-2,0,8
Eritrea,2009-10-01,2,0,0,0,0,2
Eritrea,2009-10-01,0,0,0,0,0,0
Eritrea,2009-10-01,3,0,1,0,0,4
Eritrea,2009-10-01,7,0,1,6,0,14
Georgia,2009-10-01,44,4,0,20,1,69
Georgia,2009-10-01,22,0,-2,33,2,55
Georgia,2009-10-01,3,0,0,0,1,4
Georgia,2009-10-01,16,0,0,1,3,20
Georgia,2009-10-01,56,0,0,32,9,97
Georgia,2009-10-01,38,4,0,30,6,78
Georgia,2009-10-01,16,2,1,30,9,58
Georgia,2009-10-01,13,0,-2,8,10,29
Georgia,2009-10-01,15,0,0,4,4,23
Georgia,2009-10-01,3,0,0,-1,1,3
Georgia,2009-10-01,10,0,0,-8,0,2
Georgia,2009-10-01,25,0,0,8,3,36
Georgia,2009-10-01,22,0,0,3,3,28
Georgia,2009-10-01,55,2,0,11,8,76
Georgia,2009-10-01,25,2,0,21,5,53
Georgia,2009-10-01,0,0,0,9,1,10
Georgia,2009-10-01,12,0,0,14,0,26
Georgia,2009-10-01,5,0,0,-2,0,3
Georgia,2009-10-01,18,0,1,15,2,36
Georgia,2009-10-01,34,0,-2,7,4,43
Georgia,2009-10-01,14,2,0,10,4,30
Georgia,2009-10-01,16,0,0,13,9,38
Georgia,2009-10-01,18,0,-6,11,6,29
Georgia,2009-10-01,13,0,0,6,4,23
Georgia,2009-10-01,14,4,0,11,5,34
Georgia,2009-10-01,33,0,1,19,2,55
Georgia,2009-10-01,2,0,-1,9,2,12
Georgia,2009-10-01,17,0,1,30,2,50
Georgia,2009-10-01,63,0,0,48,4,115
Georgia,2009-10-01,45,2,1,32,3,83
Georgia,2009-10-01,13,0,0,10,1,24
India,2009-10-01,86,2,-2,32,15,133
India,2009-10-01,67,6,-1,-4,7,75
India,2009-10-01,58,0,-1,2,4,63
India,2009-10-01,64,2,-2,12,1,77
India,2009-10-01,83,0,-2,31,8,120
India,2009-10-01,85,0,1,-2,8,92
India,2009-10-01,63,4,-4,2,21,86
India,2009-10-01,153,0,0,23,43,219
India,2009-10-01,84,6,3,14,13,120
India,2009-10-01,69,0,0,16,19,104
India,2009-10-01,93,0,0,36,3,132
India,2009-10-01,106,0,-5,25,6,132
India,2009-10-01,92,2,0,-8,16,102
India,2009-10-01,47,0,0,12,7,66
India,2009-10-01,74,0,5,28,8,115
India,2009-10-01,23,0,0,0,1,24
India,2009-10-01,36,0,-2,23,6,63
India,2009-10-01,45,2,1,7,25,80
India,2009-10-01,85,0,0,21,12,118
India,2009-10-01,52,4,0,-1,8,63
India,2009-10-01,81,2,0,8,4,95
India,2009-10-01,76,0,0,12,10,98
India,2009-10-01,69,0,0,21,7,97
India,2009-10-01,62,0,0,19,9,90
India,2009-10-01,90,4,-1,4,4,101
India,2009-10-01,121,4,1,52,8,186
India,2009-10-01,67,4,0,-4,7,74
India,2009-10-01,56,4,0,-3,22,79
India,2009-10-01,62,6,-1,22,9,98
India,2009-10-01,27,0,-6,9,1,31
India,2009-10-01,58,0,-2,2,3,61
Iran,2009-10-01,41,0,0,24,10,75
Iran,2009-10-01,93,0,2,39,15,149
Iran,2009-10-01,73,0,-1,3,4,79
Iran,2009-10-01,31,0,0,14,10,55
Iran,2009-10-01,74,0,-1,33,9,115
Iran,2009-10-01,46,0,-1,42,3,90
Iran,2009-10-01,116,4,1,19,7,147
Iran,2009-10-01,75,0,4,38,5,122
Iran,2009-10-01,106,0,0,48,23,177
Iran,2009-10-01,54,2,2,31,15,104
Iran,2009-10-01,40,0,2,21,8,71
Iran,2009-10-01,125,0,4,39,8,176
Iran,2009-10-01,49,0,2,31,10,92
Iran,2009-10-01,90,0,0,30,5,125
Iran,2009-10-01,100,0,-2,68,9,175
Iran,2009-10-01,46,0,1,-2,3,48
Iran,2009-10-01,34,0,3,17,6,60
Iran,2009-10-01,167,2,0,15,50,234
Iran,2009-10-01,258,0,1,51,28,338
Iran,2009-10-01,98,4,0,91,20,213
Iran,2009-10-01,71,0,0,55,17,143
Iran,2009-10-01,114,0,2,43,7,166
Iran,2009-10-01,97,0,0,8,7,112
Iran,2009-10-01,49,0,0,14,7,70
Iran,2009-10-01,30,0,0,9,2,41
Iran,2009-10-01,97,0,-2,40,21,156
Iran,2009-10-01,111,0,-2,19,21,149
Iran,2009-10-01,62,4,2,23,10,101
Iran,2009-10-01,38,10,0,23,10,81
Iran,2009-10-01,44,2,1,21,2,70
Iran,2009-10-01,92,0,0,28,0,120
Iraq,2009-10-01,136,2,1,39,8,186
Iraq,2009-10-01,73,0,0,36,5,114
Iraq,2009-10-01,53,0,0,22,11,86
Iraq,2009-10-01,31,2,1,23,7,64
Iraq,2009-10-01,217,0,3,35,37,292
Iraq,2009-10-01,166,0,2,40,35,243
Iraq,2009-10-01,138,4,2,5,11,160
Iraq,2009-10-01,81,0,-2,50,9,138
Iraq,2009-10-01,193,0,4,16,35,248
Iraq,2009-10-01,78,0,-10,35,7,110
Iraq,2009-10-01,72,0,2,11,12,97
Iraq,2009-10-01,128,0,0,70,28,226
Iraq,2009-10-01,127,6,5,27,14,179
Iraq,2009-10-01,115,0,2,35,10,162
Iraq,2009-10-01,107,0,-4,26,14,143
Iraq,2009-10-01,48,0,0,-1,0,47
Iraq,2009-10-01,40,0,0,36,13,89
Iraq,2009-10-01,37,0,1,32,13,83
Iraq,2009-10-01,64,2,12,40,6,124
Iraq,2009-10-01,114,6,4,63,9,196
Iraq,2009-10-01,95,4,1,78,13,191
Iraq,2009-10-01,97,0,0,53,11,161
Iraq,2009-10-01,52,6,0,15,31,104
Iraq,2009-10-01,35,0,0,4,2,41
Iraq,2009-10-01,36,0,0,6,4,46
Iraq,2009-10-01,122,0,-8,20,18,152
Iraq,2009-10-01,142,0,-1,24,22,187
Iraq,2009-10-01,141,0,4,22,8,175
Iraq,2009-10-01,177,0,3,10,4,194
Iraq,2009-10-01,94,4,3,42,2,145
Iraq,2009-10-01,67,0,0,67,3,137
Morocco,2009-10-01,1,0,0,6,0,7
Morocco,2009-10-01,5,0,0,12,0,17
Morocco,2009-10-01,11,0,0,12,4,27
Morocco,2009-10-01,2,0,0,4,0,6
Morocco,2009-10-01,5,0,0,15,4,24
Morocco,2009-10-01,-1,0,0,3,0,2
Morocco,2009-10-01,11,0,0,5,0,16
Morocco,2009-10-01,2,0,0,12,2,16
Morocco,2009-10-01,1,0,0,0,0,1
Morocco,2009-10-01,1,0,0,1,0,2
Morocco,2009-10-01,8,0,0,6,0,14
Morocco,2009-10-01,6,0,0,4,0,10
Morocco,2009-10-01,-5,0,0,15,0,10
Morocco,2009-10-01,9,0,0,30,11,50
Morocco,2009-10-01,3,0,0,16,0,19
Morocco,2009-10-01,0,0,0,3,0,3
Morocco,2009-10-01,2,0,-5,6,2,5
Morocco,2009-10-01,0,0,0,0,1,1
Morocco,2009-10-01,10,0,0,4,0,14
Morocco,2009-10-01,3,0,0,8,0,11
Morocco,2009-10-01,7,0,0,0,4,11
Morocco,2009-10-01,6,0,0,0,0,6
Morocco,2009-10-01,7,0,0,0,0,7
Morocco,2009-10-01,5,0,0,0,0,5
Morocco,2009-10-01,11,0,0,1,0,12
Morocco,2009-10-01,9,0,0,18,0,27
Morocco,2009-10-01,2,0,0,16,1,19
Morocco,2009-10-01,3,0,0,9,0,12
Morocco,2009-10-01,7,0,0,9,0,16
Morocco,2009-10-01,26,0,0,41,0,67
Morocco,2009-10-01,13,0,0,9,0,22
Nigeria,2009-10-01,34,0,0,23,2,59
Nigeria,2009-10-01,14,0,0,23,4,41
Nigeria,2009-10-01,2,0,0,1,0,3
Nigeria,2009-10-01,24,0,0,4,0,28
Nigeria,2009-10-01,42,0,-1,57,4,102
Nigeria,2009-10-01,23,2,1,22,2,50
Nigeria,2009-10-01,56,0,1,8,3,68
Nigeria,2009-10-01,16,0,1,6,3,26
Nigeria,2009-10-01,11,0,0,12,4,27
Nigeria,2009-10-01,15,2,0,3,0,20
Nigeria,2009-10-01,1,0,0,0,3,4
Nigeria,2009-10-01,28,0,0,23,1,52
Nigeria,2009-10-01,23,0,0,1,3,27
Nigeria,2009-10-01,17,0,2,24,4,47
Nigeria,2009-10-01,23,0,-1,8,4,34
Nigeria,2009-10-01,3,0,-1,4,0,6
Nigeria,2009-10-01,14,0,-2,0,0,12
Nigeria,2009-10-01,9,0,-2,4,0,11
Nigeria,2009-10-01,30,0,-2,2,6,36
Nigeria,2009-10-01,32,0,0,2,3,37
Nigeria,2009-10-01,34,0,0,1,10,45
Nigeria,2009-10-01,16,0,0,12,3,31
Nigeria,2009-10-01,20,0,0,10,2,32
Nigeria,2009-10-01,13,0,0,1,0,14
Nigeria,2009-10-01,14,0,-1,12,1,26
Nigeria,2009-10-01,40,0,0,10,3,53
Nigeria,2009-10-01,10,0,-2,8,4,20
Nigeria,2009-10-01,25,0,0,8,3,36
Nigeria,2009-10-01,17,0,2,0,3,22
Nigeria,2009-10-01,13,2,0,9,3,27
Nigeria,2009-10-01,14,0,0,-3,7,18
Pakistan,2009-10-01,137,2,2,0,2,143
Pakistan,2009-10-01,96,2,3,16,15,132
Pakistan,2009-10-01,60,0,1,50,3,114
Pakistan,2009-10-01,210,0,-4,41,11,258
Pakistan,2009-10-01,247,0,1,100,23,371
Pakistan,2009-10-01,210,0,9,68,14,301
Pakistan,2009-10-01,319,4,10,15,19,367
Pakistan,2009-10-01,215,0,-1,23,34,271
Pakistan,2009-10-01,123,0,2,37,9,171
Pakistan,2009-10-01,132,0,0,27,13,172
Pakistan,2009-10-01,260,2,2,21,15,300
Pakistan,2009-10-01,126,2,0,17,14,159
Pakistan,2009-10-01,123,0,-1,41,18,181
Pakistan,2009-10-01,100,2,0,-3,9,108
Pakistan,2009-10-01,104,2,0,13,10,129
Pakistan,2009-10-01,32,0,0,35,0,67
Pakistan,2009-10-01,70,0,0,66,9,145
Pakistan,2009-10-01,179,0,0,220,75,474
Pakistan,2009-10-01,243,4,0,48,47,342
Pakistan,2009-10-01,201,0,0,59,32,292
Pakistan,2009-10-01,100,0,-3,11,32,140
Pakistan,2009-10-01,119,0,0,51,5,175
Pakistan,2009-10-01,63,0,0,42,8,113
Pakistan,2009-10-01,78,0,0,19,11,108
Pakistan,2009-10-01,86,0,0,19,13,118
Pakistan,2009-10-01,109,2,-4,34,27,168
Pakistan,2009-10-01,104,0,0,73,26,203
Pakistan,2009-10-01,224,0,0,23,17,264
Pakistan,2009-10-01,83,1,1,26,7,118
Pakistan,2009-10-01,55,0,0,21,11,87
Pakistan,2009-10-01,67,0,1,51,12,131
Sierra Leone,2009-10-01,0,0,0,0,0,0
Sierra Leone,2009-10-01,8,0,0,0,0,8
Sierra Leone,2009-10-01,2,0,0,2,2,6
Sierra Leone,2009-10-01,0,0,0,0,0,0
Sierra Leone,2009-10-01,0,0,0,2,0,2
Sierra Leone,2009-10-01,2,0,0,0,0,2
Sierra Leone,2009-10-01,-2,0,0,6,5,9
Sierra Leone,2009-10-01,2,0,0,0,1,3
Sierra Leone,2009-10-01,-1,0,0,-2,0,-3
Sierra Leone,2009-10-01,0,0,0,0,0,0
Sierra Leone,2009-10-01,2,0,0,0,0,2
Sierra Leone,2009-10-01,0,0,0,0,0,0
Sierra Leone,2009-10-01,0,2,0,0,0,2
Sierra Leone,2009-10-01,-1,0,0,0,0,-1
Sierra Leone,2009-10-01,0,0,0,12,0,12
Sierra Leone,2009-10-01,0,0,1,27,0,28
Sierra Leone,2009-10-01,0,0,0,0,0,0
Sierra Leone,2009-10-01,0,0,0,0,0,0
Sierra Leone,2009-10-01,0,0,0,0,0,0
Sierra Leone,2009-10-01,0,0,0,0,0,0
Sierra Leone,2009-10-01,0,0,0,3,0,3
Sierra Leone,2009-10-01,1,0,0,0,0,1
Sierra Leone,2009-10-01,1,0,0,0,0,1
Sierra Leone,2009-10-01,0,0,0,0,0,0
Sierra Leone,2009-10-01,6,0,0,15,1,22
Sierra Leone,2009-10-01,-1,0,0,-1,2,0
Sierra Leone,2009-10-01,0,0,0,0,0,0
Sierra Leone,2009-10-01,4,0,0,0,0,4
Sierra Leone,2009-10-01,6,0,0,-2,0,4
Sierra Leone,2009-10-01,12,0,1,0,0,13
Somalia,2009-10-01,49,0,-1,16,2,66
Somalia,2009-10-01,49,0,0,30,2,81
Somalia,2009-10-01,16,0,0,2,0,18
Somalia,2009-10-01,13,0,0,39,0,52
Somalia,2009-10-01,30,0,0,6,5,41
Somalia,2009-10-01,62,0,0,92,7,161
Somalia,2009-10-01,145,2,3,69,11,230
Somalia,2009-10-01,41,0,0,20,0,61
Somalia,2009-10-01,23,0,0,6,4,33
Somalia,2009-10-01,5,0,0,13,3,21
Somalia,2009-10-01,10,0,0,12,0,22
Somalia,2009-10-01,31,0,0,28,3,62
Somalia,2009-10-01,46,0,0,21,0,67
Somalia,2009-10-01,39,0,0,47,0,86
Somalia,2009-10-01,26,0,0,37,0,63
Somalia,2009-10-01,0,0,0,0,0,0
Somalia,2009-10-01,26,0,0,8,0,34
Somalia,2009-10-01,13,0,0,6,0,19
Somalia,2009-10-01,62,0,0,45,0,107
Somalia,2009-10-01,50,0,1,8,0,59
Somalia,2009-10-01,100,0,2,70,8,180
Somalia,2009-10-01,384,14,0,81,4,483
Somalia,2009-10-01,84,2,0,25,7,118
Somalia,2009-10-01,27,2,0,6,0,35
Somalia,2009-10-01,14,0,0,11,5,30
Somalia,2009-10-01,27,0,0,6,7,40
Somalia,2009-10-01,58,0,0,29,4,91
Somalia,2009-10-01,62,0,0,15,0,77
Somalia,2009-10-01,59,6,0,181,0,246
Somalia,2009-10-01,51,0,0,72,2,125
Somalia,2009-10-01,54,0,0,103,16,173
Syria,2009-10-01,11,0,0,0,0,11
Syria,2009-10-01,30,0,0,-12,0,18
Syria,2009-10-01,8,0,0,3,1,12
Syria,2009-10-01,30,0,0,6,4,40
Syria,2009-10-01,14,0,0,-1,0,13
Syria,2009-10-01,18,0,0,8,2,28
Syria,2009-10-01,21,0,-2,34,6,59
Syria,2009-10-01,6,0,0,0,0,6
Syria,2009-10-01,20,4,0,5,3,32
Syria,2009-10-01,10,0,0,15,1,26
Syria,2009-10-01,2,0,0,6,2,10
Syria,2009-10-01,19,0,2,42,0,63
Syria,2009-10-01,0,0,0,19,4,23
Syria,2009-10-01,10,0,0,9,6,25
Syria,2009-10-01,26,0,1,35,2,64
Syria,2009-10-01,37,0,0,3,6,46
Syria,2009-10-01,27,0,0,8,3,38
Syria,2009-10-01,0,0,0,3,0,3
Syria,2009-10-01,6,0,0,18,0,24
Syria,2009-10-01,17,0,0,11,2,30
Syria,2009-10-01,50,0,0,30,1,81
Syria,2009-10-01,15,0,0,29,0,44
Syria,2009-10-01,6,0,0,18,0,24
Syria,2009-10-01,40,0,0,4,2,46
Syria,2009-10-01,15,0,0,13,0,28
Syria,2009-10-01,4,0,0,9,4,17
Syria,2009-10-01,10,0,0,6,0,16
Syria,2009-10-01,-1,0,0,7,3,9
Syria,2009-10-01,11,0,0,15,-4,22
Syria,2009-10-01,24,0,0,-2,0,22
Syria,2009-10-01,13,0,2,6,0,21
Yemen,2009-10-01,33,0,0,3,0,36
Yemen,2009-10-01,41,0,0,11,4,56
Yemen,2009-10-01,6,0,0,47,2,55
Yemen,2009-10-01,35,0,0,10,0,45
Yemen,2009-10-01,52,0,0,1,3,56
Yemen,2009-10-01,38,0,0,0,9,47
Yemen,2009-10-01,12,0,0,-4,9,17
Yemen,2009-10-01,8,0,0,-2,2,8
Yemen,2009-10-01,6,0,0,-4,0,2
Yemen,2009-10-01,12,0,0,0,0,12
Yemen,2009-10-01,8,0,0,0,7,15
Yemen,2009-10-01,11,0,0,0,3,14
Yemen,2009-10-01,60,0,0,6,0,66
Yemen,2009-10-01,39,0,0,15,0,54
Yemen,2009-10-01,10,0,0,0,0,10
Yemen,2009-10-01,0,0,0,0,0,0
Yemen,2009-10-01,8,0,0,-2,0,6
Yemen,2009-10-01,44,0,0,-1,10,53
Yemen,2009-10-01,19,0,0,17,6,42
Yemen,2009-10-01,8,0,0,17,7,32
Yemen,2009-10-01,13,0,0,7,0,20
Yemen,2009-10-01,21,0,0,6,0,27
Yemen,2009-10-01,9,0,0,3,2,14
Yemen,2009-10-01,4,0,0,6,0,10
Yemen,2009-10-01,12,0,0,8,2,22
Yemen,2009-10-01,12,0,0,6,0,18
Yemen,2009-10-01,13,0,0,9,2,24
Yemen,2009-10-01,27,2,0,9,1,39
Yemen,2009-10-01,14,0,0,15,0,29
Yemen,2009-10-01,14,0,0,-2,0,12
Yemen,2009-10-01,31,2,0,66,2,101
Afghanistan,2009-04-01,548,0,1,47,40,636
Afghanistan,2009-04-01,231,2,2,97,26,358
Afghanistan,2009-04-01,380,8,-8,97,32,509
Afghanistan,2009-04-01,505,10,-2,53,99,665
Afghanistan,2009-04-01,200,2,-4,16,43,257
Afghanistan,2009-04-01,273,0,-1,41,22,335
Afghanistan,2009-04-01,142,6,0,21,15,184
Afghanistan,2009-04-01,242,0,-2,64,23,327
Afghanistan,2009-04-01,246,6,0,28,39,319
Afghanistan,2009-04-01,134,4,1,22,22,183
Afghanistan,2009-04-01,78,0,0,35,8,121
Afghanistan,2009-04-01,171,0,-3,36,25,229
Afghanistan,2009-04-01,216,4,0,60,11,291
Afghanistan,2009-04-01,144,0,-4,40,0,180
Afghanistan,2009-04-01,184,2,1,46,43,276
Afghanistan,2009-04-01,140,0,0,37,24,201
Afghanistan,2009-04-01,131,0,0,96,19,246
Afghanistan,2009-04-01,149,4,0,28,21,202
Afghanistan,2009-04-01,182,2,0,56,12,252
Afghanistan,2009-04-01,253,4,0,34,25,316
Afghanistan,2009-04-01,201,4,1,101,10,317
Afghanistan,2009-04-01,186,2,1,26,11,226
Afghanistan,2009-04-01,106,0,0,26,15,147
Afghanistan,2009-04-01,264,4,-1,53,27,347
Afghanistan,2009-04-01,171,4,-4,34,73,278
Afghanistan,2009-04-01,110,0,0,0,45,155
Afghanistan,2009-04-01,131,0,-1,26,19,175
Afghanistan,2009-04-01,246,0,-2,63,6,313
Afghanistan,2009-04-01,271,2,-3,25,13,308
Afghanistan,2009-04-01,272,10,0,40,7,329
Albania,2009-04-01,44,0,-1,0,2,45
Albania,2009-04-01,3,0,0,-2,2,3
Albania,2009-04-01,-1,0,0,-2,0,-3
Albania,2009-04-01,15,0,0,4,0,19
Albania,2009-04-01,6,0,0,-18,3,-9
Albania,2009-04-01,8,0,0,-10,0,-2
Albania,2009-04-01,4,0,0,-5,0,-1
Albania,2009-04-01,2,0,0,3,8,13
Albania,2009-04-01,6,0,0,0,0,6
Albania,2009-04-01,41,0,0,1,2,44
Albania,2009-04-01,24,0,0,-4,0,20
Albania,2009-04-01,6,0,0,3,0,9
Albania,2009-04-01,4,0,0,0,0,4
Albania,2009-04-01,6,0,0,6,0,12
Albania,2009-04-01,-3,0,0,1,0,-2
Albania,2009-04-01,3,0,0,9,2,14
Albania,2009-04-01,13,0,0,-2,0,11
Albania,2009-04-01,7,0,2,0,0,9
Albania,2009-04-01,3,0,0,0,0,3
Albania,2009-04-01,0,0,0,0,0,0
Albania,2009-04-01,3,0,2,0,1,6
Albania,2009-04-01,2,0,0,0,2,4
Albania,2009-04-01,4,0,0,18,1,23
Albania,2009-04-01,9,0,0,20,0,29
Albania,2009-04-01,12,0,0,3,0,15
Albania,2009-04-01,0,0,0,0,1,1
Albania,2009-04-01,28,0,-3,14,26,65
Albania,2009-04-01,1,0,-2,8,8,15
Albania,2009-04-01,12,0,-2,27,4,41
Albania,2009-04-01,12,0,0,9,2,23
Algeria,2009-04-01,2,0,0,0,0,2
Algeria,2009-04-01,11,0,0,4,0,15
Algeria,2009-04-01,-1,0,0,13,35,47
Algeria,2009-04-01,7,0,0,12,14,33
Algeria,2009-04-01,9,0,0,-4,0,5
Algeria,2009-04-01,14,0,2,0,4,20
Algeria,2009-04-01,2,0,0,1,1,4
Algeria,2009-04-01,9,0,-4,10,0,15
Algeria,2009-04-01,14,0,-1,4,8,25
Algeria,2009-04-01,3,0,-2,14,9,24
Algeria,2009-04-01,10,0,0,0,2,12
Algeria,2009-04-01,2,0,-2,0,3,3
Algeria,2009-04-01,14,0,0,0,0,14
Algeria,2009-04-01,15,0,0,3,0,18
Algeria,2009-04-01,13,0,0,0,0,13
Algeria,2009-04-01,0,0,0,0,0,0
Algeria,2009-04-01,0,0,0,9,0,9
Algeria,2009-04-01,1,0,0,3,0,4
Algeria,2009-04-01,1,0,0,-2,1,0
Algeria,2009-04-01,0,0,0,0,1,1
Algeria,2009-04-01,2,0,0,3,0,5
Algeria,2009-04-01,12,0,0,7,6,25
Algeria,2009-04-01,10,0,0,-3,9,16
Algeria,2009-04-01,5,0,0,10,3,18
Algeria,2009-04-01,5,0,0,0,3,8
Algeria,2009-04-01,13,0,0,24,0,37
Algeria,2009-04-01,0,0,0,-1,0,-1
Algeria,2009-04-01,-1,0,-2,3,0,0
Algeria,2009-04-01,6,0,0,-4,3,5
Algeria,2009-04-01,40,0,0,6,0,46
Bangladesh,2009-04-01,13,0,0,1,2,16
Bangladesh,2009-04-01,13,0,-4,3,11,23
Bangladesh,2009-04-01,9,0,-6,2,0,5
Bangladesh,2009-04-01,3,0,0,0,0,3
Bangladesh,2009-04-01,14,0,0,3,1,18
Bangladesh,2009-04-01,19,0,-2,-6,7,18
Bangladesh,2009-04-01,16,2,0,7,9,34
Bangladesh,2009-04-01,13,0,0,9,2,24
Bangladesh,2009-04-01,23,0,0,0,0,23
Bangladesh,2009-04-01,10,0,0,3,3,16
Bangladesh,2009-04-01,19,0,3,6,5,33
Bangladesh,2009-04-01,11,0,0,15,11,37
Bangladesh,2009-04-01,11,0,0,6,2,19
Bangladesh,2009-04-01,31,0,0,3,1,35
Bangladesh,2009-04-01,9,0,2,1,2,14
Bangladesh,2009-04-01,4,0,0,24,0,28
Bangladesh,2009-04-01,18,0,0,3,0,21
Bangladesh,2009-04-01,19,0,-2,9,4,30
Bangladesh,2009-04-01,18,0,0,6,2,26
Bangladesh,2009-04-01,3,0,0,12,0,15
Bangladesh,2009-04-01,4,0,0,0,4,8
Bangladesh,2009-04-01,6,0,0,6,0,12
Bangladesh,2009-04-01,4,0,0,3,0,7
Bangladesh,2009-04-01,13,0,0,0,4,17
Bangladesh,2009-04-01,7,0,0,4,1,12
Bangladesh,2009-04-01,12,0,1,3,0,16
Bangladesh,2009-04-01,30,0,-4,6,0,32
Bangladesh,2009-04-01,21,0,0,0,0,21
Bangladesh,2009-04-01,3,0,0,3,5,11
Bangladesh,2009-04-01,20,0,0,6,12,38
Cameroon,2009-04-01,0,0,0,0,0,0
Cameroon,2009-04-01,1,0,0,0,0,1
Cameroon,2009-04-01,1,0,0,0,0,1
Cameroon,2009-04-01,-1,0,0,0,0,-1
Cameroon,2009-04-01,0,0,0,0,0,0
Cameroon,2009-04-01,2,0,0,0,0,2
Cameroon,2009-04-01,0,0,0,0,0,0
Cameroon,2009-04-01,6,0,0,0,0,6
Cameroon,2009-04-01,2,0,0,0,0,2
Cameroon,2009-04-01,0,0,0,-2,0,-2
Cameroon,2009-04-01,0,0,0,0,0,0
Cameroon,2009-04-01,1,0,0,10,4,15
Cameroon,2009-04-01,6,0,0,-2,0,4
Cameroon,2009-04-01,0,0,0,0,0,0
Cameroon,2009-04-01,0,0,0,0,0,0
Cameroon,2009-04-01,0,0,0,0,0,0
Cameroon,2009-04-01,1,0,0,6,0,7
Cameroon,2009-04-01,1,0,0,-1,2,2
Cameroon,2009-04-01,0,0,0,0,0,0
Cameroon,2009-04-01,1,0,0,0,0,1
Cameroon,2009-04-01,0,0,0,0,0,0
Cameroon,2009-04-01,-3,0,0,0,0,-3
Cameroon,2009-04-01,0,0,0,0,0,0
Cameroon,2009-04-01,1,0,0,0,3,4
Cameroon,2009-04-01,1,0,0,0,0,1
Cameroon,2009-04-01,2,0,0,0,0,2
Cameroon,2009-04-01,-1,0,0,0,0,-1
Cameroon,2009-04-01,0,0,0,0,0,0
Cameroon,2009-04-01,0,0,0,0,0,0
China,2009-04-01,146,2,3,88,13,252
China,2009-04-01,120,4,-11,19,12,144
China,2009-04-01,101,0,-3,28,6,132
China,2009-04-01,80,0,1,59,1,141
China,2009-04-01,144,0,-3,15,6,162
China,2009-04-01,133,0,-3,13,25,168
China,2009-04-01,82,10,-11,74,24,179
China,2009-04-01,153,2,-4,61,15,227
China,2009-04-01,77,2,-3,36,6,118
China,2009-04-01,126,4,0,27,17,174
China,2009-04-01,119,0,5,23,33,180
China,2009-04-01,61,0,0,19,1,81
China,2009-04-01,76,0,-1,29,14,118
China,2009-04-01,50,0,-1,9,4,62
China,2009-04-01,108,0,-3,20,16,141
China,2009-04-01,116,0,2,41,11,170
China,2009-04-01,92,2,-3,20,14,125
China,2009-04-01,66,0,0,22,11,99
China,2009-04-01,34,0,-4,36,11,77
China,2009-04-01,89,6,1,30,18,144
China,2009-04-01,112,6,4,88,11,221
China,2009-04-01,101,0,0,32,3,136
China,2009-04-01,73,0,0,-3,3,73
China,2009-04-01,83,2,2,87,10,184
China,2009-04-01,91,0,0,32,7,130
China,2009-04-01,70,2,-5,37,9,113
China,2009-04-01,89,2,-3,33,5,126
China,2009-04-01,98,0,0,24,6,128
China,2009-04-01,76,0,-2,46,11,131
China,2009-04-01,97,10,-3,49,8,161
Egypt,2009-04-01,50,4,1,2,3,60
Egypt,2009-04-01,13,0,0,3,7,23
Egypt,2009-04-01,0,0,0,20,8,28
Egypt,2009-04-01,8,0,-1,33,5,45
Egypt,2009-04-01,8,0,0,13,1,22
Egypt,2009-04-01,19,0,-1,11,1,30
Egypt,2009-04-01,19,0,0,12,0,31
Egypt,2009-04-01,18,0,0,26,3,47
Egypt,2009-04-01,31,0,0,21,0,52
Egypt,2009-04-01,22,0,1,51,1,75
Egypt,2009-04-01,47,0,1,24,0,72
Egypt,2009-04-01,43,4,2,6,0,55
Egypt,2009-04-01,125,0,0,36,0,161
Egypt,2009-04-01,10,0,0,20,2,32
Egypt,2009-04-01,73,0,-6,91,12,170
Egypt,2009-04-01,78,0,0,33,3,114
Egypt,2009-04-01,26,0,0,18,6,50
Egypt,2009-04-01,44,0,0,32,6,82
Egypt,2009-04-01,46,0,0,26,2,74
Egypt,2009-04-01,54,0,0,-4,1,51
Egypt,2009-04-01,9,2,1,22,1,35
Egypt,2009-04-01,60,0,0,31,-8,83
Egypt,2009-04-01,44,0,0,9,0,53
Egypt,2009-04-01,35,0,1,38,2,76
Egypt,2009-04-01,20,0,0,11,5,36
Egypt,2009-04-01,15,0,1,23,1,40
Egypt,2009-04-01,18,0,-1,3,8,28
Egypt,2009-04-01,34,0,1,12,0,47
Egypt,2009-04-01,101,2,0,1,0,104
Egypt,2009-04-01,65,0,0,-3,0,62
Eritrea,2009-04-01,2,0,0,6,0,8
Eritrea,2009-04-01,3,0,0,12,0,15
Eritrea,2009-04-01,10,0,0,0,0,10
Eritrea,2009-04-01,3,0,0,6,0,9
Eritrea,2009-04-01,14,0,0,0,0,14
Eritrea,2009-04-01,38,0,1,0,0,39
Eritrea,2009-04-01,0,0,0,0,0,0
Eritrea,2009-04-01,1,0,0,0,0,1
Eritrea,2009-04-01,1,0,0,0,0,1
Eritrea,2009-04-01,1,0,0,0,0,1
Eritrea,2009-04-01,0,0,0,0,0,0
Eritrea,2009-04-01,0,0,0,3,2,5
Eritrea,2009-04-01,6,0,0,0,0,6
Eritrea,2009-04-01,0,0,0,6,0,6
Eritrea,2009-04-01,2,0,0,0,0,2
Eritrea,2009-04-01,0,0,0,-2,0,-2
Eritrea,2009-04-01,0,0,0,0,0,0
Eritrea,2009-04-01,3,0,1,-6,0,-2
Eritrea,2009-04-01,4,0,0,0,2,6
Eritrea,2009-04-01,3,0,0,0,0,3
Eritrea,2009-04-01,10,0,0,0,0,10
Eritrea,2009-04-01,14,0,0,-3,0,11
Eritrea,2009-04-01,0,0,0,0,0,0
Eritrea,2009-04-01,2,0,0,3,6,11
Eritrea,2009-04-01,1,0,0,0,0,1
Eritrea,2009-04-01,10,0,0,3,0,13
Eritrea,2009-04-01,3,0,0,3,0,6
Georgia,2009-04-01,3,0,1,0,1,5
Georgia,2009-04-01,12,0,1,10,1,24
Georgia,2009-04-01,14,0,0,-1,3,16
Georgia,2009-04-01,4,0,0,0,2,6
Georgia,2009-04-01,17,0,0,-2,0,15
Georgia,2009-04-01,24,0,0,6,3,33
Georgia,2009-04-01,6,0,-1,3,1,9
Georgia,2009-04-01,21,0,0,3,1,25
Georgia,2009-04-01,39,0,0,27,7,73
Georgia,2009-04-01,21,0,-2,6,1,26
Georgia,2009-04-01,11,0,-2,-1,9,17
Georgia,2009-04-01,9,0,0,1,0,10
Georgia,2009-04-01,8,0,0,-4,6,10
Georgia,2009-04-01,6,2,-2,0,3,9
Georgia,2009-04-01,14,2,0,2,0,18
Georgia,2009-04-01,3,0,1,1,4,9
Georgia,2009-04-01,16,0,0,6,0,22
Georgia,2009-04-01,19,0,0,9,0,28
Georgia,2009-04-01,0,0,1,0,0,1
Georgia,2009-04-01,3,0,0,9,1,13
Georgia,2009-04-01,10,0,0,7,5,22
Georgia,2009-04-01,3,0,0,7,0,10
Georgia,2009-04-01,-3,0,0,0,0,-3
Georgia,2009-04-01,30,0,0,0,3,33
Georgia,2009-04-01,58,0,0,0,1,59
Georgia,2009-04-01,60,0,0,4,2,66
Georgia,2009-04-01,37,0,-4,5,4,42
Georgia,2009-04-01,43,0,0,18,7,68
Georgia,2009-04-01,17,0,0,13,1,31
Georgia,2009-04-01,47,0,-2,24,10,79
India,2009-04-01,93,2,0,9,14,118
India,2009-04-01,75,0,-7,17,4,89
India,2009-04-01,105,0,0,-2,6,109
India,2009-04-01,30,0,0,-16,4,18
India,2009-04-01,42,0,0,-2,2,42
India,2009-04-01,88,4,-2,3,4,97
India,2009-04-01,61,0,-1,13,4,77
India,2009-04-01,30,2,-2,16,4,50
India,2009-04-01,45,0,0,19,6,70
India,2009-04-01,36,0,-1,2,5,42
India,2009-04-01,34,4,-1,10,4,51
India,2009-04-01,38,0,0,19,10,67
India,2009-04-01,82,0,0,3,2,87
India,2009-04-01,21,0,0,3,3,27
India,2009-04-01,56,2,0,14,13,85
India,2009-04-01,61,0,1,-2,7,67
India,2009-04-01,37,0,-2,7,11,53
India,2009-04-01,26,0,0,11,12,49
India,2009-04-01,31,0,-2,16,6,51
India,2009-04-01,28,0,-2,18,11,55
India,2009-04-01,34,0,-1,7,5,45
India,2009-04-01,73,0,-1,2,6,80
India,2009-04-01,18,0,1,3,3,25
India,2009-04-01,87,2,-3,6,7,99
India,2009-04-01,64,2,-2,0,0,64
India,2009-04-01,78,8,0,-10,2,78
India,2009-04-01,55,0,-1,28,7,89
India,2009-04-01,93,0,-6,42,8,137
India,2009-04-01,42,0,2,8,4,56
India,2009-04-01,60,0,5,9,3,77
Iran,2009-04-01,47,0,0,70,3,120
Iran,2009-04-01,45,0,1,16,5,67
Iran,2009-04-01,64,0,-4,13,0,73
Iran,2009-04-01,19,2,-3,-9,6,15
Iran,2009-04-01,137,2,-1,-2,13,149
Iran,2009-04-01,55,2,3,24,10,94
Iran,2009-04-01,98,0,1,31,6,136
Iran,2009-04-01,62,0,-2,59,7,126
Iran,2009-04-01,62,0,0,70,6,138
Iran,2009-04-01,63,0,2,3,5,73
Iran,2009-04-01,66,0,0,24,2,92
Iran,2009-04-01,29,0,0,30,2,61
Iran,2009-04-01,49,0,-2,29,5,81
Iran,2009-04-01,28,0,0,37,3,68
Iran,2009-04-01,72,0,0,55,4,131
Iran,2009-04-01,46,0,0,32,5,83
Iran,2009-04-01,14,0,0,19,1,34
Iran,2009-04-01,71,2,0,123,8,204
Iran,2009-04-01,112,0,1,93,7,213
Iran,2009-04-01,170,0,2,92,3,267
Iran,2009-04-01,155,6,0,29,19,209
Iran,2009-04-01,83,4,1,44,5,137
Iran,2009-04-01,38,0,0,51,1,90
Iran,2009-04-01,182,2,2,34,84,304
Iran,2009-04-01,94,0,0,39,57,190
Iran,2009-04-01,48,0,3,38,8,97
Iran,2009-04-01,70,0,0,37,6,113
Iran,2009-04-01,63,0,-3,42,14,116
Iran,2009-04-01,29,0,2,52,7,90
Iran,2009-04-01,19,4,0,3,6,32
Iraq,2009-04-01,85,6,2,21,15,129
Iraq,2009-04-01,64,2,0,1,13,80
Iraq,2009-04-01,60,2,-1,18,1,80
Iraq,2009-04-01,40,2,0,6,5,53
Iraq,2009-04-01,29,2,1,3,0,35
Iraq,2009-04-01,34,16,1,31,18,100
Iraq,2009-04-01,122,2,0,32,16,172
Iraq,2009-04-01,76,0,0,4,2,82
Iraq,2009-04-01,78,2,-5,44,15,134
Iraq,2009-04-01,151,6,0,21,17,195
Iraq,2009-04-01,64,0,0,22,27,113
Iraq,2009-04-01,104,0,1,38,7,150
Iraq,2009-04-01,156,0,2,53,13,224
Iraq,2009-04-01,42,0,0,7,9,58
Iraq,2009-04-01,155,2,-2,59,29,243
Iraq,2009-04-01,87,0,1,67,13,168
Iraq,2009-04-01,88,0,-2,10,5,101
Iraq,2009-04-01,35,0,0,13,16,64
Iraq,2009-04-01,21,0,-5,20,7,43
Iraq,2009-04-01,72,0,0,18,12,102
Iraq,2009-04-01,75,0,2,38,13,128
Iraq,2009-04-01,65,2,-3,40,13,117
Iraq,2009-04-01,38,0,0,17,5,60
Iraq,2009-04-01,94,0,0,15,12,121
Iraq,2009-04-01,134,2,0,38,27,201
Iraq,2009-04-01,128,0,2,19,28,177
Iraq,2009-04-01,226,0,3,29,14,272
Iraq,2009-04-01,135,0,3,29,5,172
Iraq,2009-04-01,125,0,0,23,28,176
Iraq,2009-04-01,217,2,-2,53,21,291
Morocco,2009-04-01,7,0,0,2,0,9
Morocco,2009-04-01,-1,0,0,9,0,8
Morocco,2009-04-01,3,0,0,-4,0,-1
Morocco,2009-04-01,7,0,0,3,2,12
Morocco,2009-04-01,0,0,0,9,2,11
Morocco,2009-04-01,0,0,0,0,0,0
Morocco,2009-04-01,0,0,0,6,0,6
Morocco,2009-04-01,12,0,0,0,14,26
Morocco,2009-04-01,8,0,0,0,1,9
Morocco,2009-04-01,3,0,0,0,0,3
Morocco,2009-04-01,5,0,6,0,0,11
Morocco,2009-04-01,0,0,0,3,0,3
Morocco,2009-04-01,0,0,0,0,0,0
Morocco,2009-04-01,0,0,0,0,0,0
Morocco,2009-04-01,27,2,0,2,2,33
Morocco,2009-04-01,8,0,0,3,1,12
Morocco,2009-04-01,-1,0,0,0,1,0
Morocco,2009-04-01,-1,0,0,3,0,2
Morocco,2009-04-01,0,0,0,0,0,0
Morocco,2009-04-01,3,0,0,3,2,8
Morocco,2009-04-01,4,0,-1,3,0,6
Morocco,2009-04-01,5,0,0,9,1,15
Morocco,2009-04-01,0,0,0,0,2,2
Morocco,2009-04-01,8,0,0,3,0,11
Morocco,2009-04-01,6,0,0,0,0,6
Morocco,2009-04-01,0,0,0,-6,0,-6
Morocco,2009-04-01,3,0,0,0,0,3
Morocco,2009-04-01,0,0,0,12,0,12
Morocco,2009-04-01,1,0,0,3,1,5
Morocco,2009-04-01,10,0,0,-2,0,8
Nigeria,2009-04-01,10,0,0,32,6,48
Nigeria,2009-04-01,5,0,0,5,0,10
Nigeria,2009-04-01,0,0,-6,0,0,-6
Nigeria,2009-04-01,5,0,0,9,0,14
Nigeria,2009-04-01,18,0,0,0,0,18
Nigeria,2009-04-01,25,0,0,46,0,71
Nigeria,2009-04-01,16,0,0,20,1,37
Nigeria,2009-04-01,5,0,0,12,1,18
Nigeria,2009-04-01,29,0,0,7,3,39
Nigeria,2009-04-01,10,0,0,15,12,37
Nigeria,2009-04-01,36,0,0,12,3,51
Nigeria,2009-04-01,4,0,0,17,5,26
Nigeria,2009-04-01,25,0,-1,-2,0,22
Nigeria,2009-04-01,0,0,0,0,0,0
Nigeria,2009-04-01,36,0,0,40,2,78
Nigeria,2009-04-01,26,0,0,28,3,57
Nigeria,2009-04-01,18,0,0,0,0,18
Nigeria,2009-04-01,5,0,0,3,0,8
Nigeria,2009-04-01,15,0,0,-15,2,2
Nigeria,2009-04-01,13,0,-4,-1,0,8
Nigeria,2009-04-01,31,0,-2,0,5,34
Nigeria,2009-04-01,35,0,0,48,6,89
Nigeria,2009-04-01,3,0,0,14,3,20
Nigeria,2009-04-01,10,2,0,17,1,30
Nigeria,2009-04-01,8,0,0,0,0,8
Nigeria,2009-04-01,10,0,1,-8,0,3
Nigeria,2009-04-01,23,2,0,13,2,40
Nigeria,2009-04-01,24,0,0,7,2,33
Nigeria,2009-04-01,12,0,0,8,4,24
Nigeria,2009-04-01,15,0,0,-8,0,7
Pakistan,2009-04-01,190,2,0,41,4,237
Pakistan,2009-04-01,85,2,-1,45,10,141
Pakistan,2009-04-01,94,0,-1,38,3,134
Pakistan,2009-04-01,163,0,-6,14,39,210
Pakistan,2009-04-01,115,0,-1,-20,53,147
Pakistan,2009-04-01,136,6,0,4,13,159
Pakistan,2009-04-01,90,2,0,25,3,120
Pakistan,2009-04-01,131,2,0,33,14,180
Pakistan,2009-04-01,152,4,-3,90,25,268
Pakistan,2009-04-01,206,4,0,79,11,300
Pakistan,2009-04-01,65,2,3,36,3,109
Pakistan,2009-04-01,88,4,-5,13,3,103
Pakistan,2009-04-01,90,0,0,28,8,126
Pakistan,2009-04-01,55,0,1,10,3,69
Pakistan,2009-04-01,125,2,0,45,9,181
Pakistan,2009-04-01,135,2,0,60,5,202
Pakistan,2009-04-01,210,2,1,106,2,321
Pakistan,2009-04-01,135,12,1,15,10,173
Pakistan,2009-04-01,113,2,-2,22,5,140
Pakistan,2009-04-01,67,4,0,57,3,131
Pakistan,2009-04-01,73,0,0,52,7,132
Pakistan,2009-04-01,153,2,3,57,6,221
Pakistan,2009-04-01,44,0,0,54,7,105
Pakistan,2009-04-01,100,2,0,53,17,172
Pakistan,2009-04-01,84,0,0,11,20,115
Pakistan,2009-04-01,83,0,0,0,9,92
Pakistan,2009-04-01,109,2,1,34,4,150
Pakistan,2009-04-01,119,2,0,126,3,250
Pakistan,2009-04-01,177,2,1,94,15,289
Pakistan,2009-04-01,119,2,2,56,8,187
Sierra Leone,2009-04-01,6,0,0,-2,1,5
Sierra Leone,2009-04-01,7,0,0,10,2,19
Sierra Leone,2009-04-01,0,0,0,6,0,6
Sierra Leone,2009-04-01,0,0,0,0,0,0
Sierra Leone,2009-04-01,3,0,0,0,0,3
Sierra Leone,2009-04-01,19,0,0,3,2,24
Sierra Leone,2009-04-01,0,0,0,1,0,1
Sierra Leone,2009-04-01,12,0,0,25,0,37
Sierra Leone,2009-04-01,1,0,0,10,0,11
Sierra Leone,2009-04-01,3,0,0,9,0,12
Sierra Leone,2009-04-01,0,0,0,0,0,0
Sierra Leone,2009-04-01,6,0,0,0,0,6
Sierra Leone,2009-04-01,2,0,0,0,0,2
Sierra Leone,2009-04-01,0,0,0,0,0,0
Sierra Leone,2009-04-01,0,0,0,33,0,33
Sierra Leone,2009-04-01,9,0,0,0,0,9
Sierra Leone,2009-04-01,0,0,0,1,0,1
Sierra Leone,2009-04-01,0,0,0,0,0,0
Sierra Leone,2009-04-01,1,0,0,0,0,1
Sierra Leone,2009-04-01,5,0,0,18,0,23
Sierra Leone,2009-04-01,0,0,0,3,0,3
Sierra Leone,2009-04-01,0,0,0,-2,0,-2
Sierra Leone,2009-04-01,0,0,0,3,0,3
Sierra Leone,2009-04-01,2,0,0,0,1,3
Sierra Leone,2009-04-01,9,0,0,0,0,9
Sierra Leone,2009-04-01,2,0,0,0,1,3
Sierra Leone,2009-04-01,8,0,0,0,0,8
Sierra Leone,2009-04-01,0,0,0,0,0,0
Somalia,2009-04-01,20,0,0,0,0,20
Somalia,2009-04-01,41,0,0,28,2,71
Somalia,2009-04-01,39,0,0,-25,6,20
Somalia,2009-04-01,24,0,0,-4,7,27
Somalia,2009-04-01,22,0,0,7,7,36
Somalia,2009-04-01,32,0,1,43,0,76
Somalia,2009-04-01,59,0,2,10,1,72
Somalia,2009-04-01,354,0,-2,135,22,509
Somalia,2009-04-01,306,6,1,247,40,600
Somalia,2009-04-01,310,6,5,279,46,646
Somalia,2009-04-01,300,0,0,463,42,805
Somalia,2009-04-01,438,2,1,269,24,734
Somalia,2009-04-01,408,0,0,199,24,631
Somalia,2009-04-01,180,0,2,144,27,353
Somalia,2009-04-01,418,6,3,210,69,706
Somalia,2009-04-01,284,0,5,68,42,399
Somalia,2009-04-01,166,2,1,75,21,265
Somalia,2009-04-01,160,6,0,84,22,272
Somalia,2009-04-01,156,2,0,132,18,308
Somalia,2009-04-01,102,2,0,-3,16,117
Somalia,2009-04-01,186,6,-2,86,13,289
Somalia,2009-04-01,119,2,0,93,12,226
Somalia,2009-04-01,71,6,-6,67,4,142
Somalia,2009-04-01,61,4,0,54,7,126
Somalia,2009-04-01,51,0,0,35,4,90
Somalia,2009-04-01,434,0,0,18,4,456
Somalia,2009-04-01,143,0,0,48,2,193
Somalia,2009-04-01,107,4,-1,70,14,194
Somalia,2009-04-01,75,0,0,97,5,177
Somalia,2009-04-01,46,0,1,52,14,113
Syria,2009-04-01,1,0,0,7,2,10
Syria,2009-04-01,18,0,0,4,0,22
Syria,2009-04-01,10,0,0,10,0,20
Syria,2009-04-01,10,0,0,3,0,13
Syria,2009-04-01,21,0,0,4,1,26
Syria,2009-04-01,14,0,0,9,2,25
Syria,2009-04-01,37,0,0,9,2,48
Syria,2009-04-01,-10,0,0,3,2,-5
Syria,2009-04-01,0,0,0,24,0,24
Syria,2009-04-01,14,0,0,7,0,21
Syria,2009-04-01,6,0,0,21,5,32
Syria,2009-04-01,5,0,0,1,0,6
Syria,2009-04-01,29,0,0,6,29,64
Syria,2009-04-01,25,0,0,3,8,36
Syria,2009-04-01,22,0,0,26,12,60
Syria,2009-04-01,18,0,1,3,0,22
Syria,2009-04-01,24,0,0,0,0,24
Syria,2009-04-01,3,0,0,6,0,9
Syria,2009-04-01,4,0,0,18,0,22
Syria,2009-04-01,34,0,0,7,0,41
Syria,2009-04-01,18,0,0,67,6,91
Syria,2009-04-01,15,2,0,7,2,26
Syria,2009-04-01,5,0,0,-3,0,2
Syria,2009-04-01,0,0,0,21,0,21
Syria,2009-04-01,7,0,0,12,0,19
Syria,2009-04-01,43,0,3,15,0,61
Syria,2009-04-01,2,0,0,19,0,21
Syria,2009-04-01,6,0,0,21,2,29
Syria,2009-04-01,37,0,0,-5,7,39
Syria,2009-04-01,51,0,0,3,0,54
Yemen,2009-04-01,14,0,0,21,0,35
Yemen,2009-04-01,8,0,0,-3,0,5
Yemen,2009-04-01,8,0,0,-2,2,8
Yemen,2009-04-01,8,0,0,6,0,14
Yemen,2009-04-01,6,0,-2,9,0,13
Yemen,2009-04-01,10,0,8,6,0,24
Yemen,2009-04-01,15,0,1,14,0,30
Yemen,2009-04-01,35,4,0,25,2,66
Yemen,2009-04-01,13,0,0,18,2,33
Yemen,2009-04-01,17,2,0,27,0,46
Yemen,2009-04-01,5,0,-4,6,0,7
Yemen,2009-04-01,10,0,0,-8,3,5
Yemen,2009-04-01,6,0,0,9,2,17
Yemen,2009-04-01,27,0,0,11,8,46
Yemen,2009-04-01,36,0,0,19,18,73
Yemen,2009-04-01,16,0,0,3,1,20
Yemen,2009-04-01,3,0,0,0,0,3
Yemen,2009-04-01,13,0,0,29,0,42
Yemen,2009-04-01,10,4,0,4,3,21
Yemen,2009-04-01,46,0,0,-22,5,29
Yemen,2009-04-01,23,0,0,-5,2,20
Yemen,2009-04-01,16,0,0,0,2,18
Yemen,2009-04-01,0,0,0,3,0,3
Yemen,2009-04-01,5,0,0,-1,1,5
Yemen,2009-04-01,1,0,0,3,0,4
Yemen,2009-04-01,49,2,0,1,6,58
Yemen,2009-04-01,31,0,0,-1,2,32
Yemen,2009-04-01,11,2,0,-4,0,9
Yemen,2009-04-01,5,0,0,-1,0,4
Yemen,2009-04-01,0,0,0,0,0,0
Afghanistan,2009-05-01,167,4,0,40,12,223
Afghanistan,2009-05-01,231,0,-1,24,10,264
Afghanistan,2009-05-01,278,0,-2,32,24,332
Afghanistan,2009-05-01,248,0,0,26,20,294
Afghanistan,2009-05-01,279,0,0,1,14,294
Afghanistan,2009-05-01,399,0,0,30,30,459
Afghanistan,2009-05-01,354,10,-5,41,34,434
Afghanistan,2009-05-01,249,10,5,24,10,298
Afghanistan,2009-05-01,254,4,-3,18,15,288
Afghanistan,2009-05-01,242,2,2,25,7,278
Afghanistan,2009-05-01,351,0,-16,91,52,478
Afghanistan,2009-05-01,349,4,-5,85,37,470
Afghanistan,2009-05-01,370,2,-1,-1,45,415
Afghanistan,2009-05-01,251,0,0,17,45,313
Afghanistan,2009-05-01,266,0,1,43,16,326
Afghanistan,2009-05-01,207,6,0,3,13,229
Afghanistan,2009-05-01,147,0,1,17,7,172
Afghanistan,2009-05-01,209,0,1,17,11,238
Afghanistan,2009-05-01,223,0,-2,56,12,289
Afghanistan,2009-05-01,171,0,-2,42,7,218
Afghanistan,2009-05-01,179,6,0,78,13,276
Afghanistan,2009-05-01,231,4,0,60,17,312
Afghanistan,2009-05-01,213,0,0,45,7,265
Afghanistan,2009-05-01,331,0,0,66,16,413
Afghanistan,2009-05-01,143,8,0,31,27,209
Afghanistan,2009-05-01,245,0,0,15,9,269
Afghanistan,2009-05-01,122,4,1,10,13,150
Afghanistan,2009-05-01,180,0,0,34,25,239
Afghanistan,2009-05-01,212,0,0,28,31,271
Afghanistan,2009-05-01,151,0,0,13,11,175
Afghanistan,2009-05-01,177,2,0,21,5,205
Albania,2009-05-01,20,0,-1,9,16,44
Albania,2009-05-01,1,0,0,0,0,1
Albania,2009-05-01,3,0,0,-2,0,1
Albania,2009-05-01,18,0,0,3,10,31
Albania,2009-05-01,0,0,0,7,3,10
Albania,2009-05-01,1,0,0,6,9,16
Albania,2009-05-01,2,0,0,38,0,40
Albania,2009-05-01,5,0,0,9,0,14
Albania,2009-05-01,2,0,0,9,0,11
Albania,2009-05-01,2,0,0,0,0,2
Albania,2009-05-01,5,0,0,15,2,22
Albania,2009-05-01,1,0,-1,6,0,6
Albania,2009-05-01,5,0,0,0,1,6
Albania,2009-05-01,0,0,0,0,3,3
Albania,2009-05-01,2,0,-2,0,0,0
Albania,2009-05-01,1,0,0,0,0,1
Albania,2009-05-01,-1,0,0,0,1,0
Albania,2009-05-01,13,0,0,-2,0,11
Albania,2009-05-01,6,0,0,-2,0,4
Albania,2009-05-01,1,0,0,3,0,4
Albania,2009-05-01,5,0,0,0,5,10
Albania,2009-05-01,3,0,0,0,0,3
Albania,2009-05-01,5,0,0,0,0,5
Albania,2009-05-01,0,0,0,0,0,0
Albania,2009-05-01,14,0,0,6,4,24
Albania,2009-05-01,13,0,0,4,0,17
Albania,2009-05-01,1,0,0,-2,0,-1
Albania,2009-05-01,5,0,0,0,4,9
Albania,2009-05-01,6,0,0,0,0,6
Albania,2009-05-01,0,0,0,0,0,0
Algeria,2009-05-01,6,0,0,9,1,16
Algeria,2009-05-01,3,0,0,4,0,7
Algeria,2009-05-01,0,0,0,-1,0,-1
Algeria,2009-05-01,6,0,0,6,0,12
Algeria,2009-05-01,2,0,0,-4,0,-2
Algeria,2009-05-01,17,0,0,3,0,20
Algeria,2009-05-01,12,0,0,1,0,13
Algeria,2009-05-01,4,0,0,0,0,4
Algeria,2009-05-01,20,0,-2,23,1,42
Algeria,2009-05-01,14,0,1,0,0,15
Algeria,2009-05-01,14,0,-2,7,0,19
Algeria,2009-05-01,21,0,0,23,0,44
Algeria,2009-05-01,5,0,0,3,0,8
Algeria,2009-05-01,11,0,0,0,0,11
Algeria,2009-05-01,46,0,-2,43,4,91
Algeria,2009-05-01,20,0,0,44,5,69
Algeria,2009-05-01,12,0,0,-1,0,11
Algeria,2009-05-01,13,0,0,19,0,32
Algeria,2009-05-01,12,0,0,12,0,24
Algeria,2009-05-01,5,0,0,39,0,44
Algeria,2009-05-01,6,0,0,53,0,59
Algeria,2009-05-01,4,0,0,8,0,12
Algeria,2009-05-01,3,0,0,7,0,10
Algeria,2009-05-01,4,0,0,3,0,7
Algeria,2009-05-01,-15,6,1,3,0,-5
Algeria,2009-05-01,8,4,0,15,0,27
Algeria,2009-05-01,16,0,0,8,0,24
Algeria,2009-05-01,8,0,0,0,0,8
Algeria,2009-05-01,4,0,0,0,1,5
Algeria,2009-05-01,0,0,0,0,0,0
Algeria,2009-05-01,4,0,0,0,0,4
Bangladesh,2009-05-01,20,2,0,0,1,23
Bangladesh,2009-05-01,9,0,0,7,1,17
Bangladesh,2009-05-01,19,0,0,-6,3,16
Bangladesh,2009-05-01,13,0,1,9,0,23
Bangladesh,2009-05-01,4,0,0,7,1,12
Bangladesh,2009-05-01,9,0,0,0,3,12
Bangladesh,2009-05-01,9,0,0,-2,1,8
Bangladesh,2009-05-01,8,0,0,-3,0,5
Bangladesh,2009-05-01,1,0,0,0,3,4
Bangladesh,2009-05-01,10,0,0,6,0,16
Bangladesh,2009-05-01,2,0,0,0,0,2
Bangladesh,2009-05-01,4,0,0,0,0,4
Bangladesh,2009-05-01,15,0,0,9,1,25
Bangladesh,2009-05-01,26,0,0,12,1,39
Bangladesh,2009-05-01,14,0,0,6,0,20
Bangladesh,2009-05-01,6,0,1,3,0,10
Bangladesh,2009-05-01,5,0,1,0,0,6
Bangladesh,2009-05-01,18,0,0,6,4,28
Bangladesh,2009-05-01,12,0,0,16,2,30
Bangladesh,2009-05-01,2,0,-3,9,2,10
Bangladesh,2009-05-01,5,0,0,12,2,19
Bangladesh,2009-05-01,21,0,0,7,4,32
Bangladesh,2009-05-01,16,0,0,4,3,23
Bangladesh,2009-05-01,3,0,0,3,3,9
Bangladesh,2009-05-01,0,0,0,3,2,5
Bangladesh,2009-05-01,20,0,0,3,6,29
Bangladesh,2009-05-01,11,0,0,31,6,48
Bangladesh,2009-05-01,6,0,1,9,8,24
Bangladesh,2009-05-01,23,0,0,0,2,25
Bangladesh,2009-05-01,13,0,0,3,2,18
Bangladesh,2009-05-01,7,0,0,0,0,7
Cameroon,2009-05-01,0,0,0,0,0,0
Cameroon,2009-05-01,0,0,0,0,0,0
Cameroon,2009-05-01,0,0,0,0,0,0
Cameroon,2009-05-01,0,4,0,-4,0,0
Cameroon,2009-05-01,0,0,0,0,0,0
Cameroon,2009-05-01,0,0,0,0,0,0
Cameroon,2009-05-01,0,0,0,6,1,7
Cameroon,2009-05-01,3,0,0,15,0,18
Cameroon,2009-05-01,-1,0,0,0,0,-1
Cameroon,2009-05-01,1,0,0,0,1,2
Cameroon,2009-05-01,-1,0,0,3,0,2
Cameroon,2009-05-01,0,0,0,0,0,0
Cameroon,2009-05-01,0,0,0,0,0,0
Cameroon,2009-05-01,1,0,0,0,4,5
Cameroon,2009-05-01,5,0,0,0,0,5
Cameroon,2009-05-01,0,0,0,0,0,0
Cameroon,2009-05-01,0,0,0,0,0,0
Cameroon,2009-05-01,1,0,0,3,0,4
Cameroon,2009-05-01,0,0,0,0,0,0
Cameroon,2009-05-01,0,0,0,0,0,0
Cameroon,2009-05-01,2,0,0,0,2,4
Cameroon,2009-05-01,0,0,0,0,0,0
Cameroon,2009-05-01,0,0,0,0,0,0
Cameroon,2009-05-01,1,0,0,0,0,1
Cameroon,2009-05-01,0,0,0,0,0,0
Cameroon,2009-05-01,9,0,0,0,0,9
Cameroon,2009-05-01,3,0,0,0,0,3
Cameroon,2009-05-01,18,0,0,3,1,22
Cameroon,2009-05-01,0,0,0,0,2,2
Cameroon,2009-05-01,-2,0,0,0,0,-2
Cameroon,2009-05-01,0,0,0,3,0,3
China,2009-05-01,108,0,-4,44,17,165
China,2009-05-01,55,0,1,36,3,95
China,2009-05-01,64,0,-8,22,4,82
China,2009-05-01,115,8,-1,30,14,166
China,2009-05-01,81,0,-9,67,17,156
China,2009-05-01,93,0,0,51,7,151
China,2009-05-01,95,0,-7,34,17,139
China,2009-05-01,96,0,0,46,13,155
China,2009-05-01,56,0,0,25,3,84
China,2009-05-01,32,0,-12,7,7,34
China,2009-05-01,75,0,1,17,5,98
China,2009-05-01,63,0,1,33,14,111
China,2009-05-01,52,2,1,92,17,164
China,2009-05-01,102,0,5,70,9,186
China,2009-05-01,64,2,2,48,9,125
China,2009-05-01,66,0,1,15,4,86
China,2009-05-01,36,0,-4,27,8,67
China,2009-05-01,115,0,-1,59,28,201
China,2009-05-01,121,2,-1,49,5,176
China,2009-05-01,86,6,0,14,29,135
China,2009-05-01,72,4,-1,35,16,126
China,2009-05-01,86,2,3,-13,9,87
China,2009-05-01,53,0,0,26,4,83
China,2009-05-01,39,0,0,20,13,72
China,2009-05-01,103,2,-2,53,22,178
China,2009-05-01,124,8,-3,23,14,166
China,2009-05-01,99,6,1,34,16,156
China,2009-05-01,88,12,4,26,7,137
China,2009-05-01,168,2,2,11,15,198
China,2009-05-01,116,0,-1,16,9,140
China,2009-05-01,78,0,0,11,7,96
Egypt,2009-05-01,63,0,0,2,4,69
Egypt,2009-05-01,88,0,0,-2,0,86
Egypt,2009-05-01,64,0,0,18,6,88
Egypt,2009-05-01,50,0,0,42,0,92
Egypt,2009-05-01,69,0,0,30,2,101
Egypt,2009-05-01,29,0,0,-9,1,21
Egypt,2009-05-01,21,0,-2,-3,4,20
Egypt,2009-05-01,20,2,0,8,3,33
Egypt,2009-05-01,37,0,1,5,1,44
Egypt,2009-05-01,15,0,0,3,0,18
Egypt,2009-05-01,30,2,0,6,2,40
Egypt,2009-05-01,15,2,0,9,3,29
Egypt,2009-05-01,41,0,0,46,7,94
Egypt,2009-05-01,41,0,0,18,3,62
Egypt,2009-05-01,150,0,0,16,0,166
Egypt,2009-05-01,77,0,0,6,0,83
Egypt,2009-05-01,33,0,0,9,1,43
Egypt,2009-05-01,17,0,-1,16,0,32
Egypt,2009-05-01,41,0,4,15,1,61
Egypt,2009-05-01,44,0,0,16,5,65
Egypt,2009-05-01,36,0,0,22,4,62
Egypt,2009-05-01,34,0,0,6,0,40
Egypt,2009-05-01,47,0,0,2,7,56
Egypt,2009-05-01,29,0,0,-2,6,33
Egypt,2009-05-01,30,2,0,18,2,52
Egypt,2009-05-01,86,0,0,19,0,105
Egypt,2009-05-01,45,2,0,6,0,53
Egypt,2009-05-01,21,0,0,7,4,32
Egypt,2009-05-01,26,0,0,7,0,33
Egypt,2009-05-01,15,0,0,-6,0,9
Egypt,2009-05-01,103,0,-1,0,0,102
Eritrea,2009-05-01,6,0,0,21,0,27
Eritrea,2009-05-01,6,0,0,18,0,24
Eritrea,2009-05-01,14,0,1,11,0,26
Eritrea,2009-05-01,15,0,0,-5,0,10
Eritrea,2009-05-01,0,0,0,0,0,0
Eritrea,2009-05-01,0,0,0,0,0,0
Eritrea,2009-05-01,2,0,0,0,0,2
Eritrea,2009-05-01,9,0,0,0,0,9
Eritrea,2009-05-01,8,0,0,0,0,8
Eritrea,2009-05-01,0,0,0,0,0,0
Eritrea,2009-05-01,3,0,0,3,0,6
Eritrea,2009-05-01,3,0,0,0,0,3
Eritrea,2009-05-01,-1,0,0,0,0,-1
Eritrea,2009-05-01,1,0,-1,0,2,2
Eritrea,2009-05-01,5,0,-1,-6,0,-2
Eritrea,2009-05-01,23,0,0,0,0,23
Eritrea,2009-05-01,40,0,0,0,0,40
Eritrea,2009-05-01,28,0,0,0,0,28
Eritrea,2009-05-01,6,0,0,3,2,11
Eritrea,2009-05-01,1,0,0,6,0,7
Eritrea,2009-05-01,29,0,0,6,0,35
Eritrea,2009-05-01,36,0,0,2,0,38
Eritrea,2009-05-01,45,0,0,3,7,55
Eritrea,2009-05-01,37,0,0,-1,3,39
Eritrea,2009-05-01,6,0,0,0,8,14
Eritrea,2009-05-01,6,0,0,3,0,9
Eritrea,2009-05-01,7,0,0,3,0,10
Eritrea,2009-05-01,2,0,0,0,0,2
Eritrea,2009-05-01,0,0,0,9,0,9
Eritrea,2009-05-01,2,0,0,-1,0,1
Eritrea,2009-05-01,0,0,0,0,0,0
Georgia,2009-05-01,56,0,0,19,6,81
Georgia,2009-05-01,16,0,0,2,2,20
Georgia,2009-05-01,10,0,0,12,0,22
Georgia,2009-05-01,17,0,0,3,3,23
Georgia,2009-05-01,36,0,1,18,12,67
Georgia,2009-05-01,53,0,0,19,8,80
Georgia,2009-05-01,20,4,0,4,1,29
Georgia,2009-05-01,28,0,0,9,0,37
Georgia,2009-05-01,26,0,0,3,0,29
Georgia,2009-05-01,29,0,0,6,1,36
Georgia,2009-05-01,4,0,-2,6,1,9
Georgia,2009-05-01,32,0,0,-4,0,28
Georgia,2009-05-01,30,6,1,4,1,42
Georgia,2009-05-01,14,4,0,4,2,24
Georgia,2009-05-01,4,0,0,9,5,18
Georgia,2009-05-01,22,0,0,-4,0,18
Georgia,2009-05-01,12,0,0,0,0,12
Georgia,2009-05-01,27,0,0,1,1,29
Georgia,2009-05-01,33,0,0,34,5,72
Georgia,2009-05-01,4,0,0,13,4,21
Georgia,2009-05-01,0,0,0,-4,1,-3
Georgia,2009-05-01,16,0,0,9,0,25
Georgia,2009-05-01,4,0,0,8,0,12
Georgia,2009-05-01,9,0,-2,1,1,9
Georgia,2009-05-01,4,0,0,-6,0,-2
Georgia,2009-05-01,12,0,1,-2,2,13
Georgia,2009-05-01,6,0,-2,3,2,9
Georgia,2009-05-01,22,2,0,7,3,34
Georgia,2009-05-01,25,0,0,4,8,37
Georgia,2009-05-01,5,0,0,8,1,14
Georgia,2009-05-01,14,0,0,6,0,20
India,2009-05-01,43,2,-1,-5,2,41
India,2009-05-01,38,0,0,-3,5,40
India,2009-05-01,64,0,-5,12,4,75
India,2009-05-01,73,0,-10,8,4,75
India,2009-05-01,88,0,-9,31,12,122
India,2009-05-01,49,0,0,18,4,71
India,2009-05-01,44,2,1,26,3,76
India,2009-05-01,92,0,-4,9,10,107
India,2009-05-01,76,0,0,9,-2,83
India,2009-05-01,41,0,-3,-1,4,41
India,2009-05-01,36,0,0,-5,0,31
India,2009-05-01,18,0,0,-3,3,18
India,2009-05-01,47,0,0,7,4,58
India,2009-05-01,35,0,0,13,3,51
India,2009-05-01,35,0,-9,21,6,53
India,2009-05-01,43,0,-3,3,10,53
India,2009-05-01,44,0,-1,13,8,64
India,2009-05-01,101,4,-1,28,2,134
India,2009-05-01,76,4,-3,28,6,111
India,2009-05-01,58,0,1,19,9,87
India,2009-05-01,75,2,0,30,3,110
India,2009-05-01,37,10,-1,12,5,63
India,2009-05-01,38,2,0,21,3,64
India,2009-05-01,117,0,1,-1,9,126
India,2009-05-01,99,0,-6,-3,3,93
India,2009-05-01,62,0,-2,3,4,67
India,2009-05-01,41,0,0,14,3,58
India,2009-05-01,72,0,0,40,8,120
India,2009-05-01,71,0,1,10,9,91
India,2009-05-01,59,0,0,37,17,113
India,2009-05-01,58,0,2,19,29,108
Iran,2009-05-01,154,4,-1,92,15,264
Iran,2009-05-01,99,0,0,54,6,159
Iran,2009-05-01,86,0,1,13,6,106
Iran,2009-05-01,84,0,0,36,18,138
Iran,2009-05-01,89,0,3,44,4,140
Iran,2009-05-01,76,0,-1,26,3,104
Iran,2009-05-01,58,0,0,29,1,88
Iran,2009-05-01,69,0,1,27,3,100
Iran,2009-05-01,39,0,0,16,1,56
Iran,2009-05-01,65,0,2,50,6,123
Iran,2009-05-01,24,0,0,-16,1,9
Iran,2009-05-01,56,0,0,20,2,78
Iran,2009-05-01,85,0,2,27,0,114
Iran,2009-05-01,44,4,1,54,13,116
Iran,2009-05-01,42,0,1,39,9,91
Iran,2009-05-01,23,2,0,1,2,28
Iran,2009-05-01,57,2,-2,12,2,71
Iran,2009-05-01,80,0,1,31,3,115
Iran,2009-05-01,48,4,1,1,5,59
Iran,2009-05-01,168,0,1,28,13,210
Iran,2009-05-01,66,0,3,28,3,100
Iran,2009-05-01,25,4,0,9,8,46
Iran,2009-05-01,30,0,3,13,1,47
Iran,2009-05-01,55,0,0,25,15,95
Iran,2009-05-01,74,0,-1,7,6,86
Iran,2009-05-01,83,0,-2,18,3,102
Iran,2009-05-01,35,0,2,-11,8,34
Iran,2009-05-01,53,0,2,41,5,101
Iran,2009-05-01,189,0,2,35,7,233
Iran,2009-05-01,69,0,0,-3,10,76
Iran,2009-05-01,50,2,0,18,10,80
Iraq,2009-05-01,120,2,-3,30,15,164
Iraq,2009-05-01,142,2,0,30,8,182
Iraq,2009-05-01,101,0,0,18,1,120
Iraq,2009-05-01,68,0,0,-2,26,92
Iraq,2009-05-01,99,0,1,14,11,125
Iraq,2009-05-01,69,0,0,30,8,107
Iraq,2009-05-01,111,6,1,40,18,176
Iraq,2009-05-01,83,2,-4,37,4,122
Iraq,2009-05-01,53,0,-2,7,5,63
Iraq,2009-05-01,115,2,0,16,2,135
Iraq,2009-05-01,133,0,-4,27,7,163
Iraq,2009-05-01,111,0,-1,54,16,180
Iraq,2009-05-01,234,0,0,19,12,265
Iraq,2009-05-01,160,0,0,22,14,196
Iraq,2009-05-01,151,0,-2,84,6,239
Iraq,2009-05-01,105,4,0,12,9,130
Iraq,2009-05-01,61,0,0,4,7,72
Iraq,2009-05-01,87,0,1,41,11,140
Iraq,2009-05-01,132,0,-2,47,3,180
Iraq,2009-05-01,124,2,1,51,0,178
Iraq,2009-05-01,63,0,2,34,7,106
Iraq,2009-05-01,54,0,0,32,10,96
Iraq,2009-05-01,95,0,-2,26,11,130
Iraq,2009-05-01,117,0,-4,16,12,141
Iraq,2009-05-01,88,2,-16,3,16,93
Iraq,2009-05-01,74,2,1,17,13,107
Iraq,2009-05-01,87,4,-32,12,10,81
Iraq,2009-05-01,134,2,2,58,21,217
Iraq,2009-05-01,153,0,0,41,11,205
Iraq,2009-05-01,48,0,0,33,1,82
Iraq,2009-05-01,63,0,0,20,18,101
Morocco,2009-05-01,18,0,0,1,0,19
Morocco,2009-05-01,2,0,0,3,0,5
Morocco,2009-05-01,1,0,0,3,0,4
Morocco,2009-05-01,4,0,0,0,0,4
Morocco,2009-05-01,3,0,0,3,0,6
Morocco,2009-05-01,-1,0,0,0,0,-1
Morocco,2009-05-01,0,0,0,-1,0,-1
Morocco,2009-05-01,2,0,0,6,0,8
Morocco,2009-05-01,2,0,0,0,0,2
Morocco,2009-05-01,8,0,0,3,4,15
Morocco,2009-05-01,0,0,0,-2,0,-2
Morocco,2009-05-01,8,0,0,13,0,21
Morocco,2009-05-01,0,0,0,2,0,2
Morocco,2009-05-01,6,0,0,0,0,6
Morocco,2009-05-01,6,0,0,0,2,8
Morocco,2009-05-01,0,0,0,3,0,3
Morocco,2009-05-01,4,0,0,6,2,12
Morocco,2009-05-01,8,0,0,3,0,11
Morocco,2009-05-01,0,0,0,6,1,7
Morocco,2009-05-01,3,0,0,0,0,3
Morocco,2009-05-01,6,0,0,12,1,19
Morocco,2009-05-01,6,0,0,3,0,9
Morocco,2009-05-01,2,0,0,9,0,11
Morocco,2009-05-01,4,0,0,1,0,5
Morocco,2009-05-01,10,0,0,3,0,13
Morocco,2009-05-01,4,0,0,3,0,7
Morocco,2009-05-01,-1,0,0,-8,2,-7
Morocco,2009-05-01,0,0,0,18,0,18
Morocco,2009-05-01,4,0,0,0,1,5
Morocco,2009-05-01,6,0,0,3,0,9
Morocco,2009-05-01,0,0,-1,0,0,-1
Nigeria,2009-05-01,20,0,2,6,0,28
Nigeria,2009-05-01,13,0,0,2,1,16
Nigeria,2009-05-01,16,0,0,-1,2,17
Nigeria,2009-05-01,13,0,-1,27,2,41
Nigeria,2009-05-01,17,0,-2,16,0,31
Nigeria,2009-05-01,10,0,0,4,3,17
Nigeria,2009-05-01,5,0,1,9,2,17
Nigeria,2009-05-01,43,0,0,21,4,68
Nigeria,2009-05-01,21,0,-1,6,8,34
Nigeria,2009-05-01,26,0,1,0,0,27
Nigeria,2009-05-01,43,8,2,10,3,66
Nigeria,2009-05-01,18,0,0,9,1,28
Nigeria,2009-05-01,16,0,0,13,5,34
Nigeria,2009-05-01,11,0,0,3,0,14
Nigeria,2009-05-01,40,0,0,8,0,48
Nigeria,2009-05-01,2,0,0,13,0,15
Nigeria,2009-05-01,11,0,0,1,2,14
Nigeria,2009-05-01,21,0,0,13,2,36
Nigeria,2009-05-01,4,0,0,9,0,13
Nigeria,2009-05-01,15,0,0,9,1,25
Nigeria,2009-05-01,26,0,0,0,0,26
Nigeria,2009-05-01,21,0,0,31,1,53
Nigeria,2009-05-01,9,0,-1,36,0,44
Nigeria,2009-05-01,0,0,0,0,0,0
Nigeria,2009-05-01,19,0,0,-3,0,16
Nigeria,2009-05-01,17,0,-1,6,2,24
Nigeria,2009-05-01,12,0,1,3,1,17
Nigeria,2009-05-01,12,0,0,24,6,42
Nigeria,2009-05-01,15,0,2,1,0,18
Nigeria,2009-05-01,8,0,0,-6,1,3
Nigeria,2009-05-01,8,0,0,0,2,10
Pakistan,2009-05-01,142,0,0,64,16,222
Pakistan,2009-05-01,139,0,-1,26,2,166
Pakistan,2009-05-01,84,2,0,16,8,110
Pakistan,2009-05-01,211,6,1,63,16,297
Pakistan,2009-05-01,227,6,-2,29,11,271
Pakistan,2009-05-01,336,0,0,18,7,361
Pakistan,2009-05-01,283,0,-1,22,21,325
Pakistan,2009-05-01,152,0,0,19,18,189
Pakistan,2009-05-01,107,12,1,17,7,144
Pakistan,2009-05-01,140,0,0,0,0,140
Pakistan,2009-05-01,126,2,0,115,16,259
Pakistan,2009-05-01,118,10,0,39,12,179
Pakistan,2009-05-01,148,26,0,34,12,220
Pakistan,2009-05-01,139,2,-2,41,18,198
Pakistan,2009-05-01,125,2,-10,43,18,178
Pakistan,2009-05-01,44,2,0,11,2,59
Pakistan,2009-05-01,58,0,1,21,10,90
Pakistan,2009-05-01,106,6,-2,74,8,192
Pakistan,2009-05-01,104,4,-3,37,14,156
Pakistan,2009-05-01,121,4,-3,39,10,171
Pakistan,2009-05-01,153,2,0,68,7,230
Pakistan,2009-05-01,144,0,-2,29,10,181
Pakistan,2009-05-01,167,2,-5,67,3,234
Pakistan,2009-05-01,110,0,-4,68,38,212
Pakistan,2009-05-01,114,0,2,48,7,171
Pakistan,2009-05-01,54,2,0,62,9,127
Pakistan,2009-05-01,68,0,1,35,6,110
Pakistan,2009-05-01,83,2,0,43,18,146
Pakistan,2009-05-01,133,0,0,55,3,191
Pakistan,2009-05-01,49,0,0,46,4,99
Pakistan,2009-05-01,76,0,0,35,12,123
Sierra Leone,2009-05-01,0,0,0,0,0,0
Sierra Leone,2009-05-01,2,0,0,0,0,2
Sierra Leone,2009-05-01,0,0,0,0,0,0
Sierra Leone,2009-05-01,8,0,0,2,2,12
Sierra Leone,2009-05-01,-1,0,0,0,0,-1
Sierra Leone,2009-05-01,0,0,0,0,0,0
Sierra Leone,2009-05-01,3,0,0,0,0,3
Sierra Leone,2009-05-01,0,0,0,1,0,1
Sierra Leone,2009-05-01,0,0,0,0,0,0
Sierra Leone,2009-05-01,0,0,0,0,0,0
Sierra Leone,2009-05-01,0,0,0,0,0,0
Sierra Leone,2009-05-01,2,0,0,0,1,3
Sierra Leone,2009-05-01,-3,0,0,3,0,0
Sierra Leone,2009-05-01,0,0,0,0,0,0
Sierra Leone,2009-05-01,-2,0,0,0,0,-2
Sierra Leone,2009-05-01,-1,0,0,0,1,0
Sierra Leone,2009-05-01,0,0,0,0,0,0
Sierra Leone,2009-05-01,0,0,0,0,2,2
Sierra Leone,2009-05-01,0,0,0,0,1,1
Sierra Leone,2009-05-01,4,0,0,0,0,4
Sierra Leone,2009-05-01,2,0,0,0,0,2
Sierra Leone,2009-05-01,0,0,0,0,0,0
Sierra Leone,2009-05-01,1,0,0,0,0,1
Sierra Leone,2009-05-01,36,0,0,0,0,36
Sierra Leone,2009-05-01,0,0,0,0,0,0
Sierra Leone,2009-05-01,10,0,0,0,0,10
Sierra Leone,2009-05-01,1,0,0,3,0,4
Sierra Leone,2009-05-01,1,0,0,0,0,1
Sierra Leone,2009-05-01,0,0,0,6,0,6
Sierra Leone,2009-05-01,0,0,0,0,0,0
Somalia,2009-05-01,42,0,0,10,2,54
Somalia,2009-05-01,122,0,2,114,0,238
Somalia,2009-05-01,58,0,1,62,8,129
Somalia,2009-05-01,75,0,1,43,5,124
Somalia,2009-05-01,21,0,1,64,4,90
Somalia,2009-05-01,21,0,0,63,1,85
Somalia,2009-05-01,57,0,2,82,1,142
Somalia,2009-05-01,54,4,2,21,0,81
Somalia,2009-05-01,20,0,0,12,2,34
Somalia,2009-05-01,57,0,0,24,2,83
Somalia,2009-05-01,32,0,0,9,4,45
Somalia,2009-05-01,36,0,0,-11,9,34
Somalia,2009-05-01,32,0,0,13,1,46
Somalia,2009-05-01,42,0,0,56,10,108
Somalia,2009-05-01,83,0,0,11,3,97
Somalia,2009-05-01,22,0,0,9,6,37
Somalia,2009-05-01,4,6,0,6,0,16
Somalia,2009-05-01,57,14,0,41,1,113
Somalia,2009-05-01,43,2,0,66,8,119
Somalia,2009-05-01,46,0,0,47,6,99
Somalia,2009-05-01,56,0,0,35,8,99
Somalia,2009-05-01,75,0,0,57,5,137
Somalia,2009-05-01,44,0,1,10,0,55
Somalia,2009-05-01,25,0,0,14,0,39
Somalia,2009-05-01,70,0,0,67,0,137
Somalia,2009-05-01,76,0,1,71,0,148
Somalia,2009-05-01,39,2,0,34,5,80
Somalia,2009-05-01,40,0,0,30,2,72
Somalia,2009-05-01,83,0,0,30,2,115
Somalia,2009-05-01,39,0,0,51,12,102
Somalia,2009-05-01,31,0,0,27,1,59
Syria,2009-05-01,4,4,0,-5,0,3
Syria,2009-05-01,26,0,0,60,0,86
Syria,2009-05-01,7,0,0,24,0,31
Syria,2009-05-01,3,0,-1,3,6,11
Syria,2009-05-01,43,0,0,21,5,69
Syria,2009-05-01,19,0,0,13,1,33
Syria,2009-05-01,9,0,0,18,0,27
Syria,2009-05-01,6,0,0,3,1,10
Syria,2009-05-01,9,0,1,3,1,14
Syria,2009-05-01,6,0,0,2,1,9
Syria,2009-05-01,20,0,0,16,1,37
Syria,2009-05-01,11,0,0,12,0,23
Syria,2009-05-01,5,0,0,12,0,17
Syria,2009-05-01,-1,0,0,10,3,12
Syria,2009-05-01,15,0,0,0,1,16
Syria,2009-05-01,-2,0,0,2,1,1
Syria,2009-05-01,5,0,0,0,0,5
Syria,2009-05-01,10,0,0,1,3,14
Syria,2009-05-01,7,0,0,4,4,15
Syria,2009-05-01,10,0,0,-8,3,5
Syria,2009-05-01,20,0,0,9,2,31
Syria,2009-05-01,35,0,0,17,4,56
Syria,2009-05-01,6,0,0,27,1,34
Syria,2009-05-01,19,0,0,15,0,34
Syria,2009-05-01,13,0,0,18,2,33
Syria,2009-05-01,46,4,1,9,1,61
Syria,2009-05-01,28,0,0,15,4,47
Syria,2009-05-01,3,0,0,18,2,23
Syria,2009-05-01,20,0,0,1,0,21
Syria,2009-05-01,13,0,0,16,0,29
Syria,2009-05-01,10,0,0,4,1,15
Yemen,2009-05-01,8,0,0,3,1,12
Yemen,2009-05-01,17,0,0,9,1,27
Yemen,2009-05-01,22,0,0,0,0,22
Yemen,2009-05-01,13,0,0,-24,0,-11
Yemen,2009-05-01,28,0,0,-12,0,16
Yemen,2009-05-01,13,0,0,33,0,46
Yemen,2009-05-01,32,0,0,9,10,51
Yemen,2009-05-01,8,0,0,0,1,9
Yemen,2009-05-01,5,0,0,0,1,6
Yemen,2009-05-01,-2,0,0,-4,0,-6
Yemen,2009-05-01,7,0,0,11,0,18
Yemen,2009-05-01,8,0,0,0,0,8
Yemen,2009-05-01,31,0,0,12,0,43
Yemen,2009-05-01,28,0,0,24,6,58
Yemen,2009-05-01,3,0,0,19,0,22
Yemen,2009-05-01,10,0,0,14,1,25
Yemen,2009-05-01,-1,0,0,6,0,5
Yemen,2009-05-01,3,0,0,42,2,47
Yemen,2009-05-01,4,0,0,5,0,9
Yemen,2009-05-01,15,0,0,14,2,31
Yemen,2009-05-01,71,0,-2,22,9,100
Yemen,2009-05-01,31,0,3,29,0,63
Yemen,2009-05-01,11,0,0,0,0,11
Yemen,2009-05-01,13,0,0,12,2,27
Yemen,2009-05-01,16,0,0,7,0,23
Yemen,2009-05-01,9,0,-3,19,4,29
Yemen,2009-05-01,3,0,0,27,0,30
Yemen,2009-05-01,5,0,0,21,0,26
Yemen,2009-05-01,6,6,0,9,0,21
Yemen,2009-05-01,0,0,0,0,1,1
Yemen,2009-05-01,29,0,0,5,6,40
Afghanistan,2009-11-01,228,2,-11,81,46,346
Afghanistan,2009-11-01,143,6,4,33,43,229
Afghanistan,2009-11-01,255,0,-2,35,37,325
Afghanistan,2009-11-01,406,0,-7,66,36,501
Afghanistan,2009-11-01,412,0,4,71,29,516
Afghanistan,2009-11-01,670,0,1,8,23,702
Afghanistan,2009-11-01,532,0,1,2,23,558
Afghanistan,2009-11-01,365,4,0,33,24,426
Afghanistan,2009-11-01,483,8,1,26,34,552
Afghanistan,2009-11-01,556,4,4,57,84,705
Afghanistan,2009-11-01,494,10,1,60,53,618
Afghanistan,2009-11-01,180,4,2,24,18,228
Afghanistan,2009-11-01,109,0,0,9,35,153
Afghanistan,2009-11-01,102,0,0,16,6,124
Afghanistan,2009-11-01,82,0,0,27,11,120
Afghanistan,2009-11-01,106,4,0,29,22,161
Afghanistan,2009-11-01,288,4,1,79,25,397
Afghanistan,2009-11-01,331,0,-4,48,19,394
Afghanistan,2009-11-01,153,0,2,43,13,211
Afghanistan,2009-11-01,210,4,1,14,37,266
Afghanistan,2009-11-01,255,0,2,17,59,333
Afghanistan,2009-11-01,218,0,-5,107,19,339
Afghanistan,2009-11-01,401,0,-1,114,27,541
Afghanistan,2009-11-01,374,10,-1,121,30,534
Afghanistan,2009-11-01,319,4,0,92,38,453
Afghanistan,2009-11-01,207,0,-23,124,35,343
Afghanistan,2009-11-01,182,4,-20,83,5,254
Afghanistan,2009-11-01,142,0,-3,31,3,173
Afghanistan,2009-11-01,234,2,0,50,29,315
Afghanistan,2009-11-01,352,2,-4,93,45,488
Albania,2009-11-01,13,0,0,0,0,13
Albania,2009-11-01,13,0,0,0,0,13
Albania,2009-11-01,18,0,0,0,0,18
Albania,2009-11-01,14,0,0,3,2,19
Albania,2009-11-01,0,0,0,0,0,0
Albania,2009-11-01,-2,0,0,0,0,-2
Albania,2009-11-01,1,0,0,0,0,1
Albania,2009-11-01,6,0,0,-2,0,4
Albania,2009-11-01,7,0,0,0,0,7
Albania,2009-11-01,3,0,0,0,0,3
Albania,2009-11-01,6,0,0,0,4,10
Albania,2009-11-01,17,0,0,0,8,25
Albania,2009-11-01,0,0,0,0,7,7
Albania,2009-11-01,12,0,0,3,11,26
Albania,2009-11-01,0,0,0,0,2,2
Albania,2009-11-01,40,0,-6,0,9,43
Albania,2009-11-01,19,0,0,0,0,19
Albania,2009-11-01,4,0,-2,-2,1,1
Albania,2009-11-01,4,0,0,0,0,4
Albania,2009-11-01,2,0,0,0,0,2
Albania,2009-11-01,0,0,0,0,0,0
Albania,2009-11-01,2,0,0,0,0,2
Albania,2009-11-01,1,0,0,5,0,6
Albania,2009-11-01,6,0,0,-2,2,6
Albania,2009-11-01,0,0,0,0,1,1
Albania,2009-11-01,11,0,0,0,0,11
Albania,2009-11-01,8,0,0,0,0,8
Albania,2009-11-01,-2,0,0,0,0,-2
Albania,2009-11-01,1,0,0,0,0,1
Albania,2009-11-01,20,0,-1,21,3,43
Algeria,2009-11-01,0,0,0,0,1,1
Algeria,2009-11-01,3,0,0,6,0,9
Algeria,2009-11-01,3,0,0,-1,0,2
Algeria,2009-11-01,2,0,0,0,0,2
Algeria,2009-11-01,8,0,0,6,0,14
Algeria,2009-11-01,3,0,0,-8,0,-5
Algeria,2009-11-01,0,0,0,3,0,3
Algeria,2009-11-01,4,0,0,6,0,10
Algeria,2009-11-01,21,0,0,3,0,24
Algeria,2009-11-01,10,0,0,0,1,11
Algeria,2009-11-01,13,0,0,10,4,27
Algeria,2009-11-01,8,0,0,3,0,11
Algeria,2009-11-01,0,0,0,0,0,0
Algeria,2009-11-01,-1,0,0,0,0,-1
Algeria,2009-11-01,0,0,0,0,0,0
Algeria,2009-11-01,-4,0,0,1,1,-2
Algeria,2009-11-01,-3,2,0,3,0,2
Algeria,2009-11-01,0,0,0,6,2,8
Algeria,2009-11-01,14,0,0,0,0,14
Algeria,2009-11-01,8,0,0,6,1,15
Algeria,2009-11-01,0,0,0,2,1,3
Algeria,2009-11-01,2,0,0,2,0,4
Algeria,2009-11-01,5,0,0,12,3,20
Algeria,2009-11-01,0,0,0,6,0,6
Algeria,2009-11-01,10,0,0,0,0,10
Algeria,2009-11-01,9,0,0,0,3,12
Algeria,2009-11-01,0,0,0,0,2,2
Algeria,2009-11-01,0,0,-2,0,0,-2
Algeria,2009-11-01,19,0,0,33,0,52
Bangladesh,2009-11-01,27,0,0,25,0,52
Bangladesh,2009-11-01,36,0,1,10,3,50
Bangladesh,2009-11-01,37,0,0,29,0,66
Bangladesh,2009-11-01,3,0,0,0,7,10
Bangladesh,2009-11-01,6,0,1,9,5,21
Bangladesh,2009-11-01,8,0,0,12,1,21
Bangladesh,2009-11-01,8,0,0,17,1,26
Bangladesh,2009-11-01,18,0,0,12,1,31
Bangladesh,2009-11-01,4,0,0,-10,4,-2
Bangladesh,2009-11-01,19,2,0,7,1,29
Bangladesh,2009-11-01,22,0,0,-2,0,20
Bangladesh,2009-11-01,3,0,0,0,0,3
Bangladesh,2009-11-01,0,0,0,0,0,0
Bangladesh,2009-11-01,1,0,0,0,0,1
Bangladesh,2009-11-01,0,0,0,3,4,7
Bangladesh,2009-11-01,11,0,0,0,0,11
Bangladesh,2009-11-01,13,4,0,9,4,30
Bangladesh,2009-11-01,16,0,0,12,0,28
Bangladesh,2009-11-01,7,0,5,11,1,24
Bangladesh,2009-11-01,1,0,4,6,0,11
Bangladesh,2009-11-01,32,0,0,16,3,51
Bangladesh,2009-11-01,23,0,0,1,5,29
Bangladesh,2009-11-01,15,0,0,35,1,51
Bangladesh,2009-11-01,23,0,-4,-1,0,18
Bangladesh,2009-11-01,21,0,0,12,0,33
Bangladesh,2009-11-01,32,0,0,0,0,32
Bangladesh,2009-11-01,1,0,-8,-2,1,-8
Bangladesh,2009-11-01,2,0,-4,-2,0,-4
Bangladesh,2009-11-01,3,0,0,-3,0,0
Bangladesh,2009-11-01,23,0,1,28,2,54
Cameroon,2009-11-01,0,0,0,0,0,0
Cameroon,2009-11-01,3,0,0,0,0,3
Cameroon,2009-11-01,4,0,0,0,0,4
Cameroon,2009-11-01,0,0,0,0,0,0
Cameroon,2009-11-01,0,0,0,0,0,0
Cameroon,2009-11-01,3,0,0,12,0,15
Cameroon,2009-11-01,0,0,0,0,0,0
Cameroon,2009-11-01,0,0,0,0,0,0
Cameroon,2009-11-01,0,0,0,0,0,0
Cameroon,2009-11-01,9,0,0,0,1,10
Cameroon,2009-11-01,5,0,0,3,0,8
Cameroon,2009-11-01,0,0,0,0,0,0
Cameroon,2009-11-01,2,0,0,0,0,2
Cameroon,2009-11-01,0,0,0,0,0,0
Cameroon,2009-11-01,9,0,0,50,2,61
Cameroon,2009-11-01,8,0,0,30,0,38
Cameroon,2009-11-01,0,0,0,0,0,0
Cameroon,2009-11-01,0,0,0,-1,0,-1
Cameroon,2009-11-01,0,0,0,0,0,0
Cameroon,2009-11-01,-1,0,0,3,0,2
Cameroon,2009-11-01,0,0,0,0,2,2
Cameroon,2009-11-01,0,0,0,0,0,0
Cameroon,2009-11-01,8,0,0,0,0,8
Cameroon,2009-11-01,0,0,0,0,0,0
Cameroon,2009-11-01,0,0,0,0,1,1
Cameroon,2009-11-01,0,0,0,3,0,3
Cameroon,2009-11-01,0,0,0,0,0,0
China,2009-11-01,97,0,-2,14,2,111
China,2009-11-01,96,0,-1,-9,9,95
China,2009-11-01,65,6,5,27,19,122
China,2009-11-01,146,4,-6,28,23,195
China,2009-11-01,178,0,0,17,21,216
China,2009-11-01,99,0,3,14,8,124
China,2009-11-01,56,4,0,30,3,93
China,2009-11-01,119,0,2,21,7,149
China,2009-11-01,168,2,-3,94,13,274
China,2009-11-01,118,2,1,49,13,183
China,2009-11-01,108,0,-8,44,9,153
China,2009-11-01,53,2,0,32,9,96
China,2009-11-01,20,0,-1,13,3,35
China,2009-11-01,33,0,0,7,0,40
China,2009-11-01,30,0,0,4,13,47
China,2009-11-01,23,0,0,6,6,35
China,2009-11-01,138,4,-7,29,15,179
China,2009-11-01,170,0,-3,17,15,199
China,2009-11-01,33,0,1,5,2,41
China,2009-11-01,46,8,-1,11,12,76
China,2009-11-01,101,0,-1,47,6,153
China,2009-11-01,80,10,1,33,10,134
China,2009-11-01,169,0,-3,40,8,214
China,2009-11-01,141,6,-3,69,27,240
China,2009-11-01,149,0,-23,29,48,203
China,2009-11-01,117,0,-3,103,37,254
China,2009-11-01,55,2,-48,56,13,78
China,2009-11-01,48,0,0,19,10,77
China,2009-11-01,71,2,-4,24,31,124
China,2009-11-01,166,2,1,13,14,196
Egypt,2009-11-01,31,0,0,3,6,40
Egypt,2009-11-01,50,4,-3,12,11,74
Egypt,2009-11-01,56,4,0,26,8,94
Egypt,2009-11-01,105,4,0,57,14,180
Egypt,2009-11-01,34,0,-2,30,1,63
Egypt,2009-11-01,59,0,-2,16,1,74
Egypt,2009-11-01,22,0,-8,7,0,21
Egypt,2009-11-01,26,0,0,21,0,47
Egypt,2009-11-01,57,0,-1,21,3,80
Egypt,2009-11-01,35,0,0,39,5,79
Egypt,2009-11-01,144,0,-3,194,20,355
Egypt,2009-11-01,20,0,0,24,6,50
Egypt,2009-11-01,12,0,0,0,0,12
Egypt,2009-11-01,8,0,2,3,0,13
Egypt,2009-11-01,18,0,0,0,6,24
Egypt,2009-11-01,24,0,0,15,5,44
Egypt,2009-11-01,30,0,0,22,3,55
Egypt,2009-11-01,16,0,0,19,3,38
Egypt,2009-11-01,33,0,-8,14,0,39
Egypt,2009-11-01,26,0,-6,7,1,28
Egypt,2009-11-01,47,0,0,0,-2,45
Egypt,2009-11-01,51,0,0,4,6,61
Egypt,2009-11-01,26,0,1,-2,2,27
Egypt,2009-11-01,18,0,1,7,0,26
Egypt,2009-11-01,20,0,-4,-4,1,13
Egypt,2009-11-01,40,0,-8,-5,1,28
Egypt,2009-11-01,40,0,0,-1,2,41
Egypt,2009-11-01,4,0,-6,0,1,-1
Egypt,2009-11-01,33,0,-2,39,2,72
Egypt,2009-11-01,42,0,-1,24,4,69
Eritrea,2009-11-01,1,0,0,0,0,1
Eritrea,2009-11-01,1,0,0,0,0,1
Eritrea,2009-11-01,0,0,0,0,0,0
Eritrea,2009-11-01,0,0,0,0,0,0
Eritrea,2009-11-01,8,0,0,0,0,8
Eritrea,2009-11-01,2,0,0,0,0,2
Eritrea,2009-11-01,2,0,0,0,0,2
Eritrea,2009-11-01,2,0,0,0,0,2
Eritrea,2009-11-01,2,0,0,0,0,2
Eritrea,2009-11-01,9,0,0,2,0,11
Eritrea,2009-11-01,0,0,0,0,0,0
Eritrea,2009-11-01,0,0,0,0,0,0
Eritrea,2009-11-01,0,0,0,0,0,0
Eritrea,2009-11-01,0,0,0,0,0,0
Eritrea,2009-11-01,21,0,0,-2,0,19
Eritrea,2009-11-01,0,0,0,0,0,0
Eritrea,2009-11-01,1,0,0,-2,0,-1
Eritrea,2009-11-01,-3,0,0,0,0,-3
Eritrea,2009-11-01,0,0,2,0,0,2
Eritrea,2009-11-01,0,0,0,10,0,10
Eritrea,2009-11-01,0,0,0,0,2,2
Eritrea,2009-11-01,9,0,0,12,2,23
Eritrea,2009-11-01,0,0,0,24,0,24
Eritrea,2009-11-01,12,0,0,6,0,18
Eritrea,2009-11-01,4,0,0,0,0,4
Eritrea,2009-11-01,0,0,0,0,0,0
Eritrea,2009-11-01,0,0,0,0,0,0
Eritrea,2009-11-01,4,0,0,0,0,4
Georgia,2009-11-01,7,0,0,3,0,10
Georgia,2009-11-01,12,0,-6,3,13,22
Georgia,2009-11-01,35,2,0,21,15,73
Georgia,2009-11-01,29,4,0,16,8,57
Georgia,2009-11-01,39,0,1,19,3,62
Georgia,2009-11-01,39,0,1,18,0,58
Georgia,2009-11-01,17,0,0,-3,2,16
Georgia,2009-11-01,19,0,0,-3,0,16
Georgia,2009-11-01,29,0,1,25,7,62
Georgia,2009-11-01,31,0,0,20,7,58
Georgia,2009-11-01,14,0,0,7,1,22
Georgia,2009-11-01,3,0,0,0,0,3
Georgia,2009-11-01,2,0,0,0,0,2
Georgia,2009-11-01,0,0,0,0,0,0
Georgia,2009-11-01,0,0,0,0,0,0
Georgia,2009-11-01,18,0,1,5,2,26
Georgia,2009-11-01,18,0,0,7,1,26
Georgia,2009-11-01,0,0,0,-2,0,-2
Georgia,2009-11-01,18,0,0,3,0,21
Georgia,2009-11-01,6,0,0,5,3,14
Georgia,2009-11-01,3,0,0,3,1,7
Georgia,2009-11-01,14,0,0,6,2,22
Georgia,2009-11-01,14,2,0,21,12,49
Georgia,2009-11-01,16,0,0,14,13,43
Georgia,2009-11-01,6,0,0,6,4,16
Georgia,2009-11-01,4,0,-2,3,1,6
Georgia,2009-11-01,8,0,0,3,0,11
Georgia,2009-11-01,6,2,0,0,2,10
Georgia,2009-11-01,17,0,0,4,1,22
India,2009-11-01,45,0,0,-8,4,41
India,2009-11-01,54,0,1,9,15,79
India,2009-11-01,96,2,1,4,9,112
India,2009-11-01,100,2,-5,8,9,114
India,2009-11-01,61,4,2,10,11,88
India,2009-11-01,71,2,-6,12,5,84
India,2009-11-01,25,2,0,22,3,52
India,2009-11-01,32,0,0,13,4,49
India,2009-11-01,72,0,1,18,7,98
India,2009-11-01,53,0,-4,6,5,60
India,2009-11-01,42,0,2,-6,6,44
India,2009-11-01,15,0,0,12,2,29
India,2009-11-01,18,0,1,21,3,43
India,2009-11-01,4,0,0,0,0,4
India,2009-11-01,1,0,0,0,0,1
India,2009-11-01,15,2,0,3,0,20
India,2009-11-01,50,4,0,11,9,74
India,2009-11-01,69,2,-1,42,4,116
India,2009-11-01,32,0,-4,12,0,40
India,2009-11-01,31,2,0,0,7,40
India,2009-11-01,43,0,0,2,5,50
India,2009-11-01,49,0,2,9,13,73
India,2009-11-01,104,0,-2,14,9,125
India,2009-11-01,43,0,0,0,13,56
India,2009-11-01,97,0,3,39,16,155
India,2009-11-01,67,4,2,18,6,97
India,2009-11-01,44,0,2,5,5,56
India,2009-11-01,28,2,-2,-9,4,23
India,2009-11-01,26,0,0,4,3,33
India,2009-11-01,31,0,-9,8,9,39
Iran,2009-11-01,46,0,0,4,2,52
Iran,2009-11-01,37,2,-1,35,7,80
Iran,2009-11-01,110,0,0,32,5,147
Iran,2009-11-01,83,0,0,142,9,234
Iran,2009-11-01,114,2,5,68,7,196
Iran,2009-11-01,71,0,2,42,3,118
Iran,2009-11-01,48,0,2,48,4,102
Iran,2009-11-01,53,2,0,14,8,77
Iran,2009-11-01,79,0,1,66,10,156
Iran,2009-11-01,84,0,1,23,6,114
Iran,2009-11-01,84,2,1,56,5,148
Iran,2009-11-01,55,0,0,11,0,66
Iran,2009-11-01,32,0,0,12,0,44
Iran,2009-11-01,11,0,0,3,1,15
Iran,2009-11-01,13,0,0,10,1,24
Iran,2009-11-01,8,0,0,0,5,13
Iran,2009-11-01,93,2,2,54,6,157
Iran,2009-11-01,52,0,0,39,10,101
Iran,2009-11-01,18,0,-1,3,0,20
Iran,2009-11-01,19,0,-2,4,4,25
Iran,2009-11-01,34,2,1,46,15,98
Iran,2009-11-01,70,0,1,51,17,139
Iran,2009-11-01,106,0,0,55,24,185
Iran,2009-11-01,84,0,0,7,14,105
Iran,2009-11-01,71,2,0,38,12,123
Iran,2009-11-01,83,0,1,61,18,163
Iran,2009-11-01,79,0,6,18,13,116
Iran,2009-11-01,61,0,1,4,7,73
Iran,2009-11-01,61,0,5,14,1,81
Iran,2009-11-01,52,0,2,96,1,151
Iraq,2009-11-01,71,0,0,10,9,90
Iraq,2009-11-01,87,0,0,28,12,127
Iraq,2009-11-01,72,0,0,22,13,107
Iraq,2009-11-01,119,0,2,26,6,153
Iraq,2009-11-01,327,0,3,24,17,371
Iraq,2009-11-01,476,0,3,48,8,535
Iraq,2009-11-01,170,10,-4,45,4,225
Iraq,2009-11-01,112,6,4,13,11,146
Iraq,2009-11-01,237,0,-1,122,5,363
Iraq,2009-11-01,241,0,1,98,4,344
Iraq,2009-11-01,262,4,1,22,25,314
Iraq,2009-11-01,111,0,0,9,3,123
Iraq,2009-11-01,23,0,1,0,2,26
Iraq,2009-11-01,15,0,-2,3,0,16
Iraq,2009-11-01,43,0,0,14,4,61
Iraq,2009-11-01,25,0,0,36,14,75
Iraq,2009-11-01,104,4,-3,53,28,186
Iraq,2009-11-01,137,0,7,41,18,203
Iraq,2009-11-01,31,0,1,-1,9,40
Iraq,2009-11-01,34,0,0,-1,1,34
Iraq,2009-11-01,74,0,-2,16,3,91
Iraq,2009-11-01,128,0,0,-5,8,131
Iraq,2009-11-01,198,0,3,20,17,238
Iraq,2009-11-01,178,0,1,42,35,256
Iraq,2009-11-01,214,0,0,48,28,290
Iraq,2009-11-01,153,0,3,20,12,188
Iraq,2009-11-01,103,4,-43,10,2,76
Iraq,2009-11-01,61,0,2,16,9,88
Iraq,2009-11-01,46,0,1,74,19,140
Iraq,2009-11-01,106,52,3,48,9,218
Morocco,2009-11-01,4,0,0,15,0,19
Morocco,2009-11-01,31,0,0,6,0,37
Morocco,2009-11-01,30,0,0,13,1,44
Morocco,2009-11-01,12,0,0,9,0,21
Morocco,2009-11-01,8,0,2,0,0,10
Morocco,2009-11-01,17,2,0,4,0,23
Morocco,2009-11-01,2,0,0,0,0,2
Morocco,2009-11-01,2,0,0,0,0,2
Morocco,2009-11-01,0,0,0,3,0,3
Morocco,2009-11-01,5,0,0,18,0,23
Morocco,2009-11-01,1,0,0,12,0,13
Morocco,2009-11-01,0,0,1,1,1,3
Morocco,2009-11-01,2,0,0,0,0,2
Morocco,2009-11-01,0,0,0,0,0,0
Morocco,2009-11-01,1,0,0,21,1,23
Morocco,2009-11-01,0,0,0,33,1,34
Morocco,2009-11-01,0,0,0,27,0,27
Morocco,2009-11-01,0,0,0,15,6,21
Morocco,2009-11-01,9,0,0,19,3,31
Morocco,2009-11-01,13,0,0,15,0,28
Morocco,2009-11-01,4,0,0,3,4,11
Morocco,2009-11-01,3,0,0,6,1,10
Morocco,2009-11-01,5,0,0,39,0,44
Morocco,2009-11-01,4,0,0,6,0,10
Morocco,2009-11-01,0,0,0,3,0,3
Morocco,2009-11-01,5,0,0,6,0,11
Morocco,2009-11-01,15,0,-2,6,0,19
Morocco,2009-11-01,3,0,0,9,2,14
Morocco,2009-11-01,8,0,0,6,0,14
Nigeria,2009-11-01,9,0,0,3,3,15
Nigeria,2009-11-01,15,0,3,0,4,22
Nigeria,2009-11-01,31,0,0,21,0,52
Nigeria,2009-11-01,48,0,0,6,6,60
Nigeria,2009-11-01,42,0,1,10,0,53
Nigeria,2009-11-01,1,0,1,-5,1,-2
Nigeria,2009-11-01,15,0,1,0,0,16
Nigeria,2009-11-01,36,0,1,-2,1,36
Nigeria,2009-11-01,51,0,0,7,10,68
Nigeria,2009-11-01,18,0,-4,19,4,37
Nigeria,2009-11-01,44,0,0,4,3,51
Nigeria,2009-11-01,4,0,0,1,0,5
Nigeria,2009-11-01,2,0,0,0,0,2
Nigeria,2009-11-01,0,0,0,6,0,6
Nigeria,2009-11-01,0,0,0,0,0,0
Nigeria,2009-11-01,0,0,0,3,0,3
Nigeria,2009-11-01,12,0,-3,4,1,14
Nigeria,2009-11-01,10,0,0,12,10,32
Nigeria,2009-11-01,10,0,0,6,3,19
Nigeria,2009-11-01,9,0,0,9,2,20
Nigeria,2009-11-01,10,14,0,7,0,31
Nigeria,2009-11-01,8,0,0,15,1,24
Nigeria,2009-11-01,10,0,0,17,1,28
Nigeria,2009-11-01,37,0,0,24,2,63
Nigeria,2009-11-01,42,0,1,21,6,70
Nigeria,2009-11-01,27,0,0,14,2,43
Nigeria,2009-11-01,17,0,0,18,0,35
Nigeria,2009-11-01,13,0,0,4,0,17
Nigeria,2009-11-01,17,0,0,12,2,31
Nigeria,2009-11-01,25,0,0,10,1,36
Pakistan,2009-11-01,62,0,-6,13,2,71
Pakistan,2009-11-01,100,4,-6,24,8,130
Pakistan,2009-11-01,68,6,0,30,9,113
Pakistan,2009-11-01,81,6,-1,31,14,131
Pakistan,2009-11-01,58,0,-3,1,3,59
Pakistan,2009-11-01,117,0,0,32,17,166
Pakistan,2009-11-01,41,0,0,17,5,63
Pakistan,2009-11-01,60,4,-4,43,16,119
Pakistan,2009-11-01,138,0,1,30,23,192
Pakistan,2009-11-01,163,0,3,12,16,194
Pakistan,2009-11-01,86,0,0,47,6,139
Pakistan,2009-11-01,65,0,0,23,3,91
Pakistan,2009-11-01,79,0,-3,25,2,103
Pakistan,2009-11-01,14,0,0,12,0,26
Pakistan,2009-11-01,20,0,0,33,4,57
Pakistan,2009-11-01,35,6,0,14,4,59
Pakistan,2009-11-01,139,2,1,19,26,187
Pakistan,2009-11-01,138,0,1,33,1,173
Pakistan,2009-11-01,59,0,0,36,1,96
Pakistan,2009-11-01,31,6,0,19,6,62
Pakistan,2009-11-01,62,0,0,49,8,119
Pakistan,2009-11-01,180,0,-4,56,9,241
Pakistan,2009-11-01,184,0,-6,45,8,231
Pakistan,2009-11-01,149,2,-5,153,11,310
Pakistan,2009-11-01,169,4,1,64,41,279
Pakistan,2009-11-01,117,0,0,25,11,153
Pakistan,2009-11-01,54,0,-2,50,12,114
Pakistan,2009-11-01,78,0,-6,18,4,94
Pakistan,2009-11-01,122,0,-5,25,9,151
Pakistan,2009-11-01,228,44,-1,35,8,314
Sierra Leone,2009-11-01,3,0,0,0,1,4
Sierra Leone,2009-11-01,17,0,2,0,2,21
Sierra Leone,2009-11-01,9,0,0,6,2,17
Sierra Leone,2009-11-01,5,0,0,10,0,15
Sierra Leone,2009-11-01,1,0,0,3,0,4
Sierra Leone,2009-11-01,6,0,0,0,0,6
Sierra Leone,2009-11-01,1,0,0,0,0,1
Sierra Leone,2009-11-01,0,0,0,0,0,0
Sierra Leone,2009-11-01,1,0,0,21,0,22
Sierra Leone,2009-11-01,22,0,0,23,3,48
Sierra Leone,2009-11-01,17,0,0,13,0,30
Sierra Leone,2009-11-01,0,0,0,0,1,1
Sierra Leone,2009-11-01,0,0,0,0,0,0
Sierra Leone,2009-11-01,8,0,0,6,2,16
Sierra Leone,2009-11-01,3,0,0,9,0,12
Sierra Leone,2009-11-01,0,0,0,3,0,3
Sierra Leone,2009-11-01,10,0,0,12,0,22
Sierra Leone,2009-11-01,0,0,0,0,2,2
Sierra Leone,2009-11-01,6,0,0,-2,1,5
Sierra Leone,2009-11-01,0,0,0,-2,1,-1
Sierra Leone,2009-11-01,2,0,0,0,0,2
Sierra Leone,2009-11-01,13,0,0,6,0,19
Sierra Leone,2009-11-01,6,0,0,3,1,10
Sierra Leone,2009-11-01,6,0,0,3,3,12
Sierra Leone,2009-11-01,1,0,0,3,2,6
Sierra Leone,2009-11-01,0,0,0,0,1,1
Sierra Leone,2009-11-01,0,0,0,0,0,0
Somalia,2009-11-01,55,0,0,1,22,78
Somalia,2009-11-01,79,0,0,17,2,98
Somalia,2009-11-01,14,0,0,1,2,17
Somalia,2009-11-01,74,0,0,11,1,86
Somalia,2009-11-01,79,0,0,76,2,157
Somalia,2009-11-01,58,4,2,80,4,148
Somalia,2009-11-01,17,2,0,43,2,64
Somalia,2009-11-01,8,0,0,22,0,30
Somalia,2009-11-01,66,0,0,7,6,79
Somalia,2009-11-01,76,0,0,66,4,146
Somalia,2009-11-01,65,2,0,111,8,186
Somalia,2009-11-01,12,0,0,36,0,48
Somalia,2009-11-01,0,0,0,15,1,16
Somalia,2009-11-01,9,0,1,10,0,20
Somalia,2009-11-01,3,0,0,-4,0,-1
Somalia,2009-11-01,6,0,0,13,1,20
Somalia,2009-11-01,72,0,0,39,5,116
Somalia,2009-11-01,229,2,0,84,22,337
Somalia,2009-11-01,50,0,0,17,11,78
Somalia,2009-11-01,51,0,0,10,3,64
Somalia,2009-11-01,62,0,0,7,2,71
Somalia,2009-11-01,39,0,2,13,1,55
Somalia,2009-11-01,62,0,2,20,1,85
Somalia,2009-11-01,92,0,0,49,7,148
Somalia,2009-11-01,58,0,0,46,1,105
Somalia,2009-11-01,46,0,0,-57,2,-9
Somalia,2009-11-01,29,0,0,-7,1,23
Somalia,2009-11-01,7,0,0,-1,0,6
Somalia,2009-11-01,17,0,0,-6,0,11
Somalia,2009-11-01,78,0,0,42,0,120
Syria,2009-11-01,5,0,0,3,0,8
Syria,2009-11-01,16,0,0,33,2,51
Syria,2009-11-01,13,0,3,60,1,77
Syria,2009-11-01,14,0,-3,12,2,25
Syria,2009-11-01,27,0,0,12,1,40
Syria,2009-11-01,18,0,0,7,0,25
Syria,2009-11-01,10,0,0,9,1,20
Syria,2009-11-01,11,0,0,3,0,14
Syria,2009-11-01,14,0,0,14,0,28
Syria,2009-11-01,12,0,2,27,0,41
Syria,2009-11-01,31,0,2,22,2,57
Syria,2009-11-01,10,0,0,3,3,16
Syria,2009-11-01,5,0,0,0,0,5
Syria,2009-11-01,8,0,0,-2,1,7
Syria,2009-11-01,6,0,0,12,1,19
Syria,2009-11-01,4,0,0,-2,3,5
Syria,2009-11-01,10,0,0,24,2,36
Syria,2009-11-01,10,0,0,18,0,28
Syria,2009-11-01,4,0,0,0,0,4
Syria,2009-11-01,1,0,0,0,0,1
Syria,2009-11-01,0,0,0,19,1,20
Syria,2009-11-01,4,0,0,15,0,19
Syria,2009-11-01,29,0,0,4,2,35
Syria,2009-11-01,26,0,0,13,6,45
Syria,2009-11-01,3,0,0,21,0,24
Syria,2009-11-01,55,0,0,40,3,98
Syria,2009-11-01,22,0,0,14,0,36
Syria,2009-11-01,7,0,0,3,0,10
Syria,2009-11-01,3,0,0,6,0,9
Syria,2009-11-01,-4,0,0,5,1,2
Yemen,2009-11-01,9,0,0,13,0,22
Yemen,2009-11-01,15,2,0,4,1,22
Yemen,2009-11-01,15,0,0,12,12,39
Yemen,2009-11-01,89,0,1,14,2,106
Yemen,2009-11-01,168,0,0,30,8,206
Yemen,2009-11-01,248,0,0,18,6,272
Yemen,2009-11-01,83,0,0,18,0,101
Yemen,2009-11-01,176,0,0,6,0,182
Yemen,2009-11-01,108,0,2,25,1,136
Yemen,2009-11-01,199,0,0,38,5,242
Yemen,2009-11-01,150,0,0,46,7,203
Yemen,2009-11-01,32,0,0,13,8,53
Yemen,2009-11-01,24,0,0,6,0,30
Yemen,2009-11-01,18,0,-2,18,0,34
Yemen,2009-11-01,13,0,0,0,2,15
Yemen,2009-11-01,10,0,0,-7,0,3
Yemen,2009-11-01,48,0,0,-9,2,41
Yemen,2009-11-01,100,0,-1,5,8,112
Yemen,2009-11-01,52,0,3,10,0,65
Yemen,2009-11-01,18,0,2,2,0,22
Yemen,2009-11-01,15,0,2,1,2,20
Yemen,2009-11-01,26,0,0,0,0,26
Yemen,2009-11-01,38,0,0,-4,1,35
Yemen,2009-11-01,30,2,0,6,10,48
Yemen,2009-11-01,50,2,0,22,6,80
Yemen,2009-11-01,42,0,2,0,1,45
Yemen,2009-11-01,16,0,0,6,0,22
Yemen,2009-11-01,0,0,0,-2,0,-2
Yemen,2009-11-01,36,0,0,3,0,39
Yemen,2009-11-01,26,4,0,4,2,36
Afghanistan,2012-12-01,60,4,2,52,9,127
Afghanistan,2012-12-01,161,0,-2,35,20,214
Afghanistan,2012-12-01,124,0,-1,26,9,158
Afghanistan,2012-12-01,113,0,9,61,11,194
Afghanistan,2012-12-01,136,0,1,55,18,210
Afghanistan,2012-12-01,210,0,1,-7,5,209
Afghanistan,2012-12-01,128,0,1,10,15,154
Afghanistan,2012-12-01,140,0,-2,11,8,157
Afghanistan,2012-12-01,96,0,-2,9,12,115
Afghanistan,2012-12-01,226,2,-1,52,24,303
Afghanistan,2012-12-01,171,0,-2,96,23,288
Afghanistan,2012-12-01,92,0,-4,30,24,142
Afghanistan,2012-12-01,209,2,2,32,81,326
Afghanistan,2012-12-01,122,0,-2,35,13,168
Afghanistan,2012-12-01,75,0,-2,18,14,105
Afghanistan,2012-12-01,47,0,0,10,4,61
Afghanistan,2012-12-01,119,0,0,14,11,144
Afghanistan,2012-12-01,150,2,0,39,3,194
Afghanistan,2012-12-01,169,0,0,40,22,231
Afghanistan,2012-12-01,137,0,2,57,18,214
Afghanistan,2012-12-01,96,2,-1,26,4,127
Afghanistan,2012-12-01,65,0,0,18,16,99
Afghanistan,2012-12-01,102,2,0,-2,8,110
Afghanistan,2012-12-01,139,0,0,7,7,153
Afghanistan,2012-12-01,109,0,0,-2,3,110
Afghanistan,2012-12-01,52,0,1,-2,6,57
Afghanistan,2012-12-01,56,0,0,9,2,67
Afghanistan,2012-12-01,77,2,-2,17,16,110
Afghanistan,2012-12-01,96,4,1,0,23,124
Afghanistan,2012-12-01,100,0,-1,38,19,156
Afghanistan,2012-12-01,216,0,0,-11,12,217
Albania,2012-12-01,2,0,0,0,0,2
Albania,2012-12-01,0,0,0,0,0,0
Albania,2012-12-01,2,0,0,0,0,2
Albania,2012-12-01,6,0,0,0,0,6
Albania,2012-12-01,0,0,0,6,0,6
Albania,2012-12-01,23,0,0,1,7,31
Albania,2012-12-01,8,0,0,0,0,8
Albania,2012-12-01,0,0,0,0,0,0
Albania,2012-12-01,0,0,0,6,2,8
Albania,2012-12-01,0,0,0,0,0,0
Albania,2012-12-01,2,0,0,9,0,11
Albania,2012-12-01,14,0,0,6,0,20
Albania,2012-12-01,1,0,1,3,0,5
Albania,2012-12-01,2,0,0,0,0,2
Albania,2012-12-01,0,0,0,9,1,10
Albania,2012-12-01,0,0,0,0,0,0
Albania,2012-12-01,0,0,0,3,0,3
Albania,2012-12-01,0,0,0,-4,0,-4
Albania,2012-12-01,2,0,0,0,0,2
Albania,2012-12-01,3,0,0,6,0,9
Albania,2012-12-01,2,0,0,0,0,2
Albania,2012-12-01,10,0,0,0,0,10
Albania,2012-12-01,2,0,0,0,0,2
Albania,2012-12-01,0,0,0,0,0,0
Albania,2012-12-01,1,0,0,0,0,1
Albania,2012-12-01,0,0,0,0,0,0
Albania,2012-12-01,1,0,1,0,1,3
Albania,2012-12-01,1,0,0,0,0,1
Albania,2012-12-01,11,0,0,1,0,12
Algeria,2012-12-01,0,0,0,0,0,0
Algeria,2012-12-01,0,0,0,3,0,3
Algeria,2012-12-01,19,0,0,3,0,22
Algeria,2012-12-01,6,0,0,12,0,18
Algeria,2012-12-01,21,0,0,9,0,30
Algeria,2012-12-01,-6,0,0,9,0,3
Algeria,2012-12-01,0,0,0,18,0,18
Algeria,2012-12-01,19,0,0,18,0,37
Algeria,2012-12-01,13,0,0,0,0,13
Algeria,2012-12-01,89,0,0,11,0,100
Algeria,2012-12-01,66,0,0,37,7,110
Algeria,2012-12-01,34,0,0,6,0,40
Algeria,2012-12-01,2,0,-2,9,0,9
Algeria,2012-12-01,0,0,0,0,0,0
Algeria,2012-12-01,4,0,-1,9,1,13
Algeria,2012-12-01,9,0,0,9,0,18
Algeria,2012-12-01,15,0,0,0,0,15
Algeria,2012-12-01,1,0,0,12,0,13
Algeria,2012-12-01,-4,0,0,-1,0,-5
Algeria,2012-12-01,9,4,0,-4,0,9
Algeria,2012-12-01,49,0,-1,11,4,63
Algeria,2012-12-01,7,0,0,6,2,15
Algeria,2012-12-01,6,0,0,18,0,24
Algeria,2012-12-01,108,0,-3,20,30,155
Algeria,2012-12-01,6,0,0,3,0,9
Algeria,2012-12-01,3,0,0,0,0,3
Algeria,2012-12-01,15,0,0,3,0,18
Algeria,2012-12-01,2,0,0,0,0,2
Algeria,2012-12-01,10,0,0,3,0,13
Algeria,2012-12-01,4,0,0,3,2,9
Algeria,2012-12-01,2,0,0,-2,10,10
Bangladesh,2012-12-01,24,0,-3,15,0,36
Bangladesh,2012-12-01,30,0,0,-9,4,25
Bangladesh,2012-12-01,23,0,0,7,6,36
Bangladesh,2012-12-01,31,0,0,48,1,80
Bangladesh,2012-12-01,15,0,0,8,4,27
Bangladesh,2012-12-01,31,0,0,19,3,53
Bangladesh,2012-12-01,26,0,-2,4,4,32
Bangladesh,2012-12-01,22,0,-1,0,2,23
Bangladesh,2012-12-01,16,0,0,4,5,25
Bangladesh,2012-12-01,37,0,0,7,4,48
Bangladesh,2012-12-01,22,0,-7,28,2,45
Bangladesh,2012-12-01,25,4,-4,7,8,40
Bangladesh,2012-12-01,18,0,-2,19,-4,31
Bangladesh,2012-12-01,28,0,-2,7,2,35
Bangladesh,2012-12-01,1,0,0,17,1,19
Bangladesh,2012-12-01,19,2,0,3,0,24
Bangladesh,2012-12-01,20,0,0,0,3,23
Bangladesh,2012-12-01,11,0,0,-4,10,17
Bangladesh,2012-12-01,4,0,1,7,2,14
Bangladesh,2012-12-01,49,0,0,23,0,72
Bangladesh,2012-12-01,15,0,0,0,1,16
Bangladesh,2012-12-01,12,0,-2,0,1,11
Bangladesh,2012-12-01,11,0,0,-5,1,7
Bangladesh,2012-12-01,55,0,0,-3,9,61
Bangladesh,2012-12-01,30,0,1,8,0,39
Bangladesh,2012-12-01,11,0,0,-3,0,8
Bangladesh,2012-12-01,17,0,0,4,1,22
Bangladesh,2012-12-01,18,0,0,6,0,24
Bangladesh,2012-12-01,32,0,0,23,4,59
Bangladesh,2012-12-01,16,0,-4,12,13,37
Bangladesh,2012-12-01,32,0,0,3,5,40
Cameroon,2012-12-01,0,0,0,0,0,0
Cameroon,2012-12-01,29,0,0,3,7,39
Cameroon,2012-12-01,22,0,0,-2,1,21
Cameroon,2012-12-01,35,0,0,0,1,36
Cameroon,2012-12-01,6,0,0,3,0,9
Cameroon,2012-12-01,1,0,0,6,0,7
Cameroon,2012-12-01,2,0,0,6,2,10
Cameroon,2012-12-01,0,0,0,0,0,0
Cameroon,2012-12-01,0,0,0,0,0,0
Cameroon,2012-12-01,0,0,0,0,2,2
Cameroon,2012-12-01,0,0,0,0,0,0
Cameroon,2012-12-01,15,0,0,12,0,27
Cameroon,2012-12-01,6,0,0,9,0,15
Cameroon,2012-12-01,0,0,0,0,0,0
Cameroon,2012-12-01,3,0,0,0,0,3
Cameroon,2012-12-01,3,0,0,0,0,3
Cameroon,2012-12-01,1,0,1,36,3,41
Cameroon,2012-12-01,0,0,1,6,0,7
Cameroon,2012-12-01,2,0,0,0,0,2
Cameroon,2012-12-01,0,0,0,0,0,0
Cameroon,2012-12-01,0,2,0,3,0,5
Cameroon,2012-12-01,0,0,0,3,0,3
Cameroon,2012-12-01,1,0,-2,0,0,-1
Cameroon,2012-12-01,5,0,0,3,0,8
Cameroon,2012-12-01,3,0,0,0,0,3
Cameroon,2012-12-01,6,0,0,0,0,6
Cameroon,2012-12-01,0,0,0,0,0,0
Cameroon,2012-12-01,10,0,0,0,0,10
China,2012-12-01,60,0,0,65,9,134
China,2012-12-01,99,4,-6,33,14,144
China,2012-12-01,194,2,-10,104,21,311
China,2012-12-01,164,12,-5,64,30,265
China,2012-12-01,173,0,4,20,12,209
China,2012-12-01,174,0,-12,31,12,205
China,2012-12-01,152,0,1,79,25,257
China,2012-12-01,74,0,0,57,14,145
China,2012-12-01,112,2,-1,46,16,175
China,2012-12-01,161,2,-6,74,21,252
China,2012-12-01,126,2,-20,128,22,258
China,2012-12-01,201,6,4,71,11,293
China,2012-12-01,120,0,5,29,11,165
China,2012-12-01,164,0,0,43,7,214
China,2012-12-01,148,8,-3,31,14,198
China,2012-12-01,173,0,-13,20,5,185
China,2012-12-01,134,0,-5,91,16,236
China,2012-12-01,180,0,0,81,9,270
China,2012-12-01,132,2,-6,60,29,217
China,2012-12-01,74,6,-6,45,31,150
China,2012-12-01,48,0,-2,76,25,147
China,2012-12-01,62,0,-2,99,16,175
China,2012-12-01,59,0,0,25,10,94
China,2012-12-01,94,0,0,31,7,132
China,2012-12-01,87,0,-1,78,14,178
China,2012-12-01,129,0,0,44,11,184
China,2012-12-01,150,2,-2,75,15,240
China,2012-12-01,107,0,-2,43,15,163
China,2012-12-01,76,2,-1,25,9,111
China,2012-12-01,62,0,-17,22,7,74
China,2012-12-01,86,0,1,36,10,133
Egypt,2012-12-01,61,0,0,15,15,91
Egypt,2012-12-01,65,0,7,24,32,128
Egypt,2012-12-01,96,0,0,4,34,134
Egypt,2012-12-01,101,0,2,19,32,154
Egypt,2012-12-01,165,0,-2,32,46,241
Egypt,2012-12-01,176,0,-1,63,35,273
Egypt,2012-12-01,130,2,0,45,33,210
Egypt,2012-12-01,620,0,-19,253,98,952
Egypt,2012-12-01,105,0,-2,12,24,139
Egypt,2012-12-01,64,4,-3,10,17,92
Egypt,2012-12-01,66,0,-5,68,35,164
Egypt,2012-12-01,67,0,0,56,39,162
Egypt,2012-12-01,107,0,0,55,19,181
Egypt,2012-12-01,60,0,1,0,16,77
Egypt,2012-12-01,51,0,3,26,13,93
Egypt,2012-12-01,73,0,-10,37,7,107
Egypt,2012-12-01,62,0,-7,22,22,99
Egypt,2012-12-01,54,0,-28,25,12,63
Egypt,2012-12-01,74,14,0,15,5,108
Egypt,2012-12-01,102,0,0,32,25,159
Egypt,2012-12-01,27,0,-8,38,4,61
Egypt,2012-12-01,35,0,-22,32,13,58
Egypt,2012-12-01,81,0,-3,18,23,119
Egypt,2012-12-01,83,0,2,10,12,107
Egypt,2012-12-01,78,0,-1,4,17,98
Egypt,2012-12-01,83,0,-14,36,18,123
Egypt,2012-12-01,37,0,-27,17,13,40
Egypt,2012-12-01,60,0,-19,22,4,67
Egypt,2012-12-01,42,0,-3,15,13,67
Egypt,2012-12-01,61,0,-10,46,6,103
Egypt,2012-12-01,70,0,0,108,22,200
Eritrea,2012-12-01,0,0,0,0,0,0
Eritrea,2012-12-01,0,0,0,0,0,0
Eritrea,2012-12-01,0,0,0,0,0,0
Eritrea,2012-12-01,17,0,3,6,0,26
Eritrea,2012-12-01,2,0,0,18,0,20
Eritrea,2012-12-01,0,0,0,4,0,4
Eritrea,2012-12-01,1,0,0,6,0,7
Eritrea,2012-12-01,-1,0,0,0,0,-1
Eritrea,2012-12-01,0,0,0,0,0,0
Eritrea,2012-12-01,0,0,0,0,0,0
Eritrea,2012-12-01,6,0,0,24,0,30
Eritrea,2012-12-01,3,0,0,0,0,3
Eritrea,2012-12-01,0,0,0,6,0,6
Eritrea,2012-12-01,1,0,0,6,0,7
Eritrea,2012-12-01,0,0,0,0,0,0
Eritrea,2012-12-01,2,0,0,3,0,5
Eritrea,2012-12-01,1,0,0,0,1,2
Eritrea,2012-12-01,0,0,0,0,0,0
Eritrea,2012-12-01,0,0,0,0,0,0
Eritrea,2012-12-01,0,0,0,3,0,3
Eritrea,2012-12-01,0,0,0,15,0,15
Eritrea,2012-12-01,0,0,0,3,0,3
Eritrea,2012-12-01,0,0,0,-4,0,-4
Eritrea,2012-12-01,1,0,0,24,0,25
Eritrea,2012-12-01,0,0,0,9,0,9
Eritrea,2012-12-01,3,0,0,0,0,3
Eritrea,2012-12-01,6,0,0,3,2,11
Georgia,2012-12-01,0,0,0,0,0,0
Georgia,2012-12-01,0,0,0,0,0,0
Georgia,2012-12-01,-1,0,-4,0,0,-5
Georgia,2012-12-01,1,0,0,-2,1,0
Georgia,2012-12-01,8,0,-2,0,0,6
Georgia,2012-12-01,0,0,0,0,0,0
Georgia,2012-12-01,3,0,0,0,0,3
Georgia,2012-12-01,7,0,1,-2,2,8
Georgia,2012-12-01,4,0,0,0,0,4
Georgia,2012-12-01,3,0,0,9,0,12
Georgia,2012-12-01,-2,0,0,0,0,-2
Georgia,2012-12-01,4,0,0,0,0,4
Georgia,2012-12-01,3,0,4,1,2,10
Georgia,2012-12-01,0,0,0,0,2,2
Georgia,2012-12-01,0,0,0,0,0,0
Georgia,2012-12-01,0,0,0,12,0,12
Georgia,2012-12-01,0,0,0,6,0,6
Georgia,2012-12-01,3,0,0,6,2,11
Georgia,2012-12-01,0,0,0,7,0,7
Georgia,2012-12-01,0,0,1,9,2,12
Georgia,2012-12-01,0,0,0,0,0,0
Georgia,2012-12-01,0,2,0,0,0,2
Georgia,2012-12-01,2,0,0,4,0,6
Georgia,2012-12-01,1,0,0,0,2,3
Georgia,2012-12-01,6,0,-2,0,0,4
Georgia,2012-12-01,-1,0,0,-5,0,-6
Georgia,2012-12-01,0,0,0,3,0,3
Georgia,2012-12-01,5,0,0,-2,0,3
Georgia,2012-12-01,4,0,0,-2,0,2
Georgia,2012-12-01,0,2,0,0,0,2
India,2012-12-01,52,0,-4,6,6,60
India,2012-12-01,33,0,-6,3,7,37
India,2012-12-01,57,0,-1,-2,17,71
India,2012-12-01,74,6,-3,15,13,105
India,2012-12-01,53,4,0,31,15,103
India,2012-12-01,97,0,-3,-1,10,103
India,2012-12-01,45,2,2,53,5,107
India,2012-12-01,59,0,0,32,11,102
India,2012-12-01,62,0,-3,10,7,76
India,2012-12-01,131,0,2,52,15,200
India,2012-12-01,60,0,-3,23,14,94
India,2012-12-01,80,0,0,3,10,93
India,2012-12-01,95,0,1,18,5,119
India,2012-12-01,35,0,1,11,3,50
India,2012-12-01,47,0,-2,14,9,68
India,2012-12-01,93,0,1,8,3,105
India,2012-12-01,39,0,-5,23,11,68
India,2012-12-01,62,0,-6,38,14,108
India,2012-12-01,71,0,-2,0,17,86
India,2012-12-01,35,2,-6,18,17,66
India,2012-12-01,45,0,2,19,17,83
India,2012-12-01,65,0,-1,28,34,126
India,2012-12-01,37,0,1,20,24,82
India,2012-12-01,50,0,1,18,19,88
India,2012-12-01,79,2,1,3,11,96
India,2012-12-01,20,4,0,4,6,34
India,2012-12-01,30,0,-5,15,16,56
India,2012-12-01,63,2,-5,-11,17,66
India,2012-12-01,85,0,-5,25,23,128
India,2012-12-01,46,0,-5,43,18,102
India,2012-12-01,87,0,-2,16,18,119
Iran,2012-12-01,43,0,-2,45,15,101
Iran,2012-12-01,63,0,0,38,3,104
Iran,2012-12-01,88,0,-2,60,19,165
Iran,2012-12-01,165,0,0,81,23,269
Iran,2012-12-01,71,0,0,90,11,172
Iran,2012-12-01,67,0,4,37,6,114
Iran,2012-12-01,38,0,-2,-8,6,34
Iran,2012-12-01,32,0,0,33,7,72
Iran,2012-12-01,89,0,0,27,13,129
Iran,2012-12-01,92,0,-4,55,5,148
Iran,2012-12-01,89,0,-2,102,5,194
Iran,2012-12-01,63,0,0,61,8,132
Iran,2012-12-01,507,0,-3,228,64,796
Iran,2012-12-01,77,2,-2,28,6,111
Iran,2012-12-01,78,4,1,16,8,107
Iran,2012-12-01,119,2,-4,27,8,152
Iran,2012-12-01,106,0,0,29,27,162
Iran,2012-12-01,97,0,0,-4,14,107
Iran,2012-12-01,70,0,-4,44,6,116
Iran,2012-12-01,69,0,0,27,8,104
Iran,2012-12-01,83,0,1,21,6,111
Iran,2012-12-01,77,0,-4,17,24,114
Iran,2012-12-01,69,0,1,38,11,119
Iran,2012-12-01,59,4,1,4,14,82
Iran,2012-12-01,76,0,2,42,5,125
Iran,2012-12-01,82,0,0,73,8,163
Iran,2012-12-01,94,0,2,36,7,139
Iran,2012-12-01,69,0,0,48,4,121
Iran,2012-12-01,33,0,0,36,5,74
Iran,2012-12-01,87,0,0,39,31,157
Iran,2012-12-01,62,0,0,36,7,105
Iraq,2012-12-01,81,0,0,36,2,119
Iraq,2012-12-01,79,0,0,8,2,89
Iraq,2012-12-01,90,6,0,51,2,149
Iraq,2012-12-01,95,0,0,-14,5,86
Iraq,2012-12-01,108,2,0,6,5,121
Iraq,2012-12-01,103,0,0,-5,5,103
Iraq,2012-12-01,35,2,0,37,22,96
Iraq,2012-12-01,39,0,0,35,6,80
Iraq,2012-12-01,37,2,0,22,0,61
Iraq,2012-12-01,84,0,-4,15,8,103
Iraq,2012-12-01,161,0,1,47,4,213
Iraq,2012-12-01,126,0,0,3,13,142
Iraq,2012-12-01,114,0,0,12,5,131
Iraq,2012-12-01,98,2,-2,11,2,111
Iraq,2012-12-01,56,0,-2,10,3,67
Iraq,2012-12-01,94,4,-2,87,5,188
Iraq,2012-12-01,113,0,0,21,2,136
Iraq,2012-12-01,91,0,0,15,2,108
Iraq,2012-12-01,77,4,-1,0,2,82
Iraq,2012-12-01,80,2,0,31,9,122
Iraq,2012-12-01,57,2,1,73,1,134
Iraq,2012-12-01,49,0,-4,20,4,69
Iraq,2012-12-01,21,0,-1,19,23,62
Iraq,2012-12-01,74,0,0,0,0,74
Iraq,2012-12-01,55,0,0,10,0,65
Iraq,2012-12-01,37,0,0,24,15,76
Iraq,2012-12-01,101,0,0,42,25,168
Iraq,2012-12-01,138,6,0,24,16,184
Iraq,2012-12-01,67,4,0,3,2,76
Iraq,2012-12-01,46,2,-26,25,11,58
Iraq,2012-12-01,38,0,0,-5,6,39
Morocco,2012-12-01,-1,0,0,-4,0,-5
Morocco,2012-12-01,1,0,0,3,0,4
Morocco,2012-12-01,8,0,0,5,0,13
Morocco,2012-12-01,11,0,1,27,0,39
Morocco,2012-12-01,6,0,0,7,0,13
Morocco,2012-12-01,27,0,0,-2,4,29
Morocco,2012-12-01,-2,0,0,12,0,10
Morocco,2012-12-01,2,0,0,3,0,5
Morocco,2012-12-01,39,0,0,33,0,72
Morocco,2012-12-01,15,0,-2,12,1,26
Morocco,2012-12-01,87,0,-2,33,7,125
Morocco,2012-12-01,35,0,0,5,0,40
Morocco,2012-12-01,10,0,0,21,2,33
Morocco,2012-12-01,19,0,0,7,0,26
Morocco,2012-12-01,1,0,0,0,1,2
Morocco,2012-12-01,14,0,0,6,0,20
Morocco,2012-12-01,6,2,0,9,0,17
Morocco,2012-12-01,8,0,0,-2,1,7
Morocco,2012-12-01,2,0,0,0,1,3
Morocco,2012-12-01,23,0,4,3,0,30
Morocco,2012-12-01,0,0,0,6,1,7
Morocco,2012-12-01,2,0,0,18,0,20
Morocco,2012-12-01,2,0,0,6,0,8
Morocco,2012-12-01,3,0,0,3,0,6
Morocco,2012-12-01,4,0,0,0,0,4
Morocco,2012-12-01,2,0,0,12,0,14
Morocco,2012-12-01,4,0,0,6,3,13
Morocco,2012-12-01,6,0,0,3,1,10
Morocco,2012-12-01,7,0,0,0,0,7
Morocco,2012-12-01,7,4,0,0,0,11
Morocco,2012-12-01,9,0,0,-6,0,3
Nigeria,2012-12-01,15,0,0,8,5,28
Nigeria,2012-12-01,15,0,0,3,3,21
Nigeria,2012-12-01,16,0,0,-2,1,15
Nigeria,2012-12-01,33,2,1,12,1,49
Nigeria,2012-12-01,32,4,-1,54,23,112
Nigeria,2012-12-01,10,4,0,21,6,41
Nigeria,2012-12-01,10,4,3,0,3,20
Nigeria,2012-12-01,18,0,2,3,2,25
Nigeria,2012-12-01,-2,4,1,24,5,32
Nigeria,2012-12-01,36,2,0,13,5,56
Nigeria,2012-12-01,30,0,-8,30,5,57
Nigeria,2012-12-01,24,0,-4,33,4,57
Nigeria,2012-12-01,36,0,2,30,7,75
Nigeria,2012-12-01,43,0,0,22,2,67
Nigeria,2012-12-01,11,0,0,14,1,26
Nigeria,2012-12-01,18,0,0,6,1,25
Nigeria,2012-12-01,48,0,1,1,5,55
Nigeria,2012-12-01,40,0,-4,76,0,112
Nigeria,2012-12-01,33,0,-3,40,7,77
Nigeria,2012-12-01,22,0,-6,17,6,39
Nigeria,2012-12-01,14,0,0,15,1,30
Nigeria,2012-12-01,14,0,0,12,0,26
Nigeria,2012-12-01,33,0,0,7,4,44
Nigeria,2012-12-01,27,0,-3,16,1,41
Nigeria,2012-12-01,17,0,0,7,1,25
Nigeria,2012-12-01,24,0,0,4,1,29
Nigeria,2012-12-01,12,0,0,25,3,40
Nigeria,2012-12-01,20,0,0,7,9,36
Nigeria,2012-12-01,10,0,0,20,9,39
Nigeria,2012-12-01,11,0,0,9,0,20
Nigeria,2012-12-01,25,0,-3,10,4,36
Pakistan,2012-12-01,34,0,3,51,2,90
Pakistan,2012-12-01,45,8,1,4,19,77
Pakistan,2012-12-01,44,0,-1,26,5,74
Pakistan,2012-12-01,75,2,-2,11,6,92
Pakistan,2012-12-01,35,0,0,38,7,80
Pakistan,2012-12-01,45,0,-6,1,5,45
Pakistan,2012-12-01,48,0,0,10,5,63
Pakistan,2012-12-01,105,0,0,13,22,140
Pakistan,2012-12-01,68,0,2,69,8,147
Pakistan,2012-12-01,90,0,-2,40,12,140
Pakistan,2012-12-01,107,0,3,74,13,197
Pakistan,2012-12-01,44,0,0,4,1,49
Pakistan,2012-12-01,101,2,0,73,8,184
Pakistan,2012-12-01,65,0,0,72,5,142
Pakistan,2012-12-01,63,0,0,55,16,134
Pakistan,2012-12-01,150,0,3,65,1,219
Pakistan,2012-12-01,75,0,4,43,10,132
Pakistan,2012-12-01,115,0,0,24,7,146
Pakistan,2012-12-01,98,0,0,49,5,152
Pakistan,2012-12-01,45,0,6,24,15,90
Pakistan,2012-12-01,46,2,0,10,5,63
Pakistan,2012-12-01,77,0,0,33,7,117
Pakistan,2012-12-01,61,0,2,15,2,80
Pakistan,2012-12-01,47,0,3,6,4,60
Pakistan,2012-12-01,47,0,1,30,8,86
Pakistan,2012-12-01,71,0,-2,2,21,92
Pakistan,2012-12-01,75,0,0,6,22,103
Pakistan,2012-12-01,72,2,-2,7,4,83
Pakistan,2012-12-01,29,0,0,56,12,97
Pakistan,2012-12-01,341,0,0,75,29,445
Pakistan,2012-12-01,42,0,0,-33,11,20
Sierra Leone,2012-12-01,-3,0,0,0,0,-3
Sierra Leone,2012-12-01,0,0,0,0,3,3
Sierra Leone,2012-12-01,1,2,0,6,0,9
Sierra Leone,2012-12-01,8,0,0,3,0,11
Sierra Leone,2012-12-01,7,2,0,0,0,9
Sierra Leone,2012-12-01,7,0,0,0,0,7
Sierra Leone,2012-12-01,2,0,0,7,0,9
Sierra Leone,2012-12-01,3,0,0,1,3,7
Sierra Leone,2012-12-01,0,0,0,0,0,0
Sierra Leone,2012-12-01,0,0,0,-2,0,-2
Sierra Leone,2012-12-01,1,0,0,0,0,1
Sierra Leone,2012-12-01,4,0,0,0,0,4
Sierra Leone,2012-12-01,15,2,0,3,0,20
Sierra Leone,2012-12-01,0,0,0,0,0,0
Sierra Leone,2012-12-01,0,0,0,0,0,0
Sierra Leone,2012-12-01,0,0,0,0,0,0
Sierra Leone,2012-12-01,5,0,0,0,0,5
Sierra Leone,2012-12-01,0,0,0,3,0,3
Sierra Leone,2012-12-01,0,0,0,0,0,0
Sierra Leone,2012-12-01,9,0,0,0,0,9
Sierra Leone,2012-12-01,15,0,0,0,0,15
Sierra Leone,2012-12-01,0,0,0,0,0,0
Sierra Leone,2012-12-01,2,0,0,0,0,2
Sierra Leone,2012-12-01,-1,0,0,0,0,-1
Sierra Leone,2012-12-01,0,0,0,0,0,0
Sierra Leone,2012-12-01,3,0,0,0,0,3
Somalia,2012-12-01,7,0,0,4,4,15
Somalia,2012-12-01,11,2,0,-9,0,4
Somalia,2012-12-01,41,0,0,6,0,47
Somalia,2012-12-01,20,0,0,0,0,20
Somalia,2012-12-01,25,0,0,6,3,34
Somalia,2012-12-01,21,0,0,0,0,21
Somalia,2012-12-01,28,0,0,13,6,47
Somalia,2012-12-01,6,0,0,-4,2,4
Somalia,2012-12-01,24,0,0,0,0,24
Somalia,2012-12-01,42,2,0,34,8,86
Somalia,2012-12-01,50,2,0,38,0,90
Somalia,2012-12-01,20,2,0,61,3,86
Somalia,2012-12-01,11,0,0,9,0,20
Somalia,2012-12-01,76,2,0,-1,12,89
Somalia,2012-12-01,5,0,0,4,3,12
Somalia,2012-12-01,17,0,0,8,0,25
Somalia,2012-12-01,26,0,2,-3,2,27
Somalia,2012-12-01,30,0,0,7,3,40
Somalia,2012-12-01,31,0,0,16,1,48
Somalia,2012-12-01,80,0,0,17,13,110
Somalia,2012-12-01,41,0,2,22,2,67
Somalia,2012-12-01,9,0,0,12,0,21
Somalia,2012-12-01,12,0,0,-4,0,8
Somalia,2012-12-01,11,2,0,6,0,19
Somalia,2012-12-01,13,0,0,-2,0,11
Somalia,2012-12-01,5,0,1,3,3,12
Somalia,2012-12-01,8,0,0,13,0,21
Somalia,2012-12-01,24,0,0,-5,6,25
Somalia,2012-12-01,15,0,0,8,0,23
Somalia,2012-12-01,17,0,0,-4,0,13
Somalia,2012-12-01,10,0,0,10,0,20
Syria,2012-12-01,87,0,0,17,1,105
Syria,2012-12-01,104,0,0,6,17,127
Syria,2012-12-01,292,0,3,26,29,350
Syria,2012-12-01,312,4,-3,56,26,395
Syria,2012-12-01,258,0,0,1,20,279
Syria,2012-12-01,311,0,0,19,13,343
Syria,2012-12-01,207,4,-4,-1,15,221
Syria,2012-12-01,263,0,-1,12,14,288
Syria,2012-12-01,237,0,-1,-11,9,234
Syria,2012-12-01,170,0,-1,48,30,247
Syria,2012-12-01,240,8,-2,41,21,308
Syria,2012-12-01,348,4,-14,39,20,397
Syria,2012-12-01,170,2,0,7,15,194
Syria,2012-12-01,272,20,-1,32,8,331
Syria,2012-12-01,122,0,0,15,9,146
Syria,2012-12-01,152,4,-2,23,24,201
Syria,2012-12-01,213,4,2,10,11,240
Syria,2012-12-01,293,0,-2,186,20,497
Syria,2012-12-01,387,24,-6,93,44,542
Syria,2012-12-01,284,8,2,68,11,373
Syria,2012-12-01,115,0,-3,23,14,149
Syria,2012-12-01,133,2,-14,31,17,169
Syria,2012-12-01,154,4,0,2,10,170
Syria,2012-12-01,185,4,-1,21,21,230
Syria,2012-12-01,195,0,-3,5,4,201
Syria,2012-12-01,346,4,1,38,20,409
Syria,2012-12-01,178,0,-10,24,14,206
Syria,2012-12-01,208,0,-5,33,37,273
Syria,2012-12-01,115,6,-19,2,14,118
Syria,2012-12-01,159,0,-13,51,7,204
Syria,2012-12-01,145,0,-8,16,6,159
Yemen,2012-12-01,62,0,0,1,3,66
Yemen,2012-12-01,9,0,0,3,0,12
Yemen,2012-12-01,17,0,0,3,0,20
Yemen,2012-12-01,19,0,0,3,1,23
Yemen,2012-12-01,0,0,0,0,2,2
Yemen,2012-12-01,13,0,0,6,5,24
Yemen,2012-12-01,5,0,0,3,1,9
Yemen,2012-12-01,18,0,0,3,9,30
Yemen,2012-12-01,35,2,1,0,4,42
Yemen,2012-12-01,11,2,0,6,0,19
Yemen,2012-12-01,20,0,0,-4,0,16
Yemen,2012-12-01,13,0,0,6,0,19
Yemen,2012-12-01,24,0,0,13,1,38
Yemen,2012-12-01,20,0,-10,5,7,22
Yemen,2012-12-01,14,0,0,6,6,26
Yemen,2012-12-01,1,0,0,6,0,7
Yemen,2012-12-01,25,0,0,0,1,26
Yemen,2012-12-01,27,0,0,12,1,40
Yemen,2012-12-01,24,0,0,-2,3,25
Yemen,2012-12-01,28,0,0,-10,0,18
Yemen,2012-12-01,21,0,0,-5,0,16
Yemen,2012-12-01,6,0,0,19,0,25
Yemen,2012-12-01,3,0,0,-3,0,0
Yemen,2012-12-01,10,0,0,-2,4,12
Yemen,2012-12-01,75,0,0,11,6,92
Yemen,2012-12-01,25,0,0,10,0,35
Yemen,2012-12-01,40,2,0,12,4,58
Yemen,2012-12-01,35,0,0,14,2,51
Yemen,2012-12-01,23,0,1,11,0,35
Yemen,2012-12-01,24,0,0,9,2,35
Yemen,2012-12-01,41,0,0,6,3,50
Afghanistan,2012-06-01,137,0,-1,13,15,164
Afghanistan,2012-06-01,213,0,-4,35,13,257
Afghanistan,2012-06-01,175,0,-5,29,5,204
Afghanistan,2012-06-01,194,2,-6,17,11,218
Afghanistan,2012-06-01,125,2,-5,17,7,146
Afghanistan,2012-06-01,320,6,0,36,73,435
Afghanistan,2012-06-01,86,0,0,15,6,107
Afghanistan,2012-06-01,220,4,0,49,13,286
Afghanistan,2012-06-01,239,0,-5,2,7,243
Afghanistan,2012-06-01,68,2,0,8,5,83
Afghanistan,2012-06-01,177,0,1,34,12,224
Afghanistan,2012-06-01,217,2,0,59,19,297
Afghanistan,2012-06-01,165,4,-4,85,12,262
Afghanistan,2012-06-01,167,0,6,27,17,217
Afghanistan,2012-06-01,156,0,1,25,8,190
Afghanistan,2012-06-01,222,0,0,7,35,264
Afghanistan,2012-06-01,144,0,0,-7,5,142
Afghanistan,2012-06-01,199,0,2,14,5,220
Afghanistan,2012-06-01,200,0,12,55,26,293
Afghanistan,2012-06-01,217,2,4,61,38,322
Afghanistan,2012-06-01,238,2,1,89,22,352
Afghanistan,2012-06-01,203,8,0,29,12,252
Afghanistan,2012-06-01,68,2,1,24,4,99
Afghanistan,2012-06-01,131,0,-2,18,6,153
Afghanistan,2012-06-01,138,0,-2,32,9,177
Afghanistan,2012-06-01,183,0,0,35,9,227
Afghanistan,2012-06-01,170,2,0,31,8,211
Afghanistan,2012-06-01,94,0,0,8,26,128
Afghanistan,2012-06-01,153,0,1,34,31,219
Afghanistan,2012-06-01,102,4,-4,20,11,133
Albania,2012-06-01,22,0,0,6,4,32
Albania,2012-06-01,6,0,0,3,0,9
Albania,2012-06-01,2,0,0,0,0,2
Albania,2012-06-01,18,0,2,6,0,26
Albania,2012-06-01,15,0,-7,11,2,21
Albania,2012-06-01,1,0,0,0,0,1
Albania,2012-06-01,0,0,0,0,0,0
Albania,2012-06-01,8,0,0,0,1,9
Albania,2012-06-01,3,0,0,0,0,3
Albania,2012-06-01,2,0,0,0,0,2
Albania,2012-06-01,5,0,-3,0,5,7
Albania,2012-06-01,2,0,0,21,1,24
Albania,2012-06-01,5,0,1,3,1,10
Albania,2012-06-01,2,0,0,3,0,5
Albania,2012-06-01,2,0,0,0,0,2
Albania,2012-06-01,2,0,0,0,0,2
Albania,2012-06-01,0,4,0,0,1,5
Albania,2012-06-01,2,0,-2,3,0,3
Albania,2012-06-01,25,0,0,3,0,28
Albania,2012-06-01,4,0,0,0,2,6
Albania,2012-06-01,7,0,0,0,0,7
Albania,2012-06-01,0,0,0,0,0,0
Albania,2012-06-01,0,0,-2,-2,0,-4
Albania,2012-06-01,2,0,0,4,1,7
Albania,2012-06-01,2,0,-3,0,0,-1
Albania,2012-06-01,0,0,0,0,0,0
Albania,2012-06-01,3,0,-1,3,2,7
Albania,2012-06-01,4,0,1,-4,0,1
Albania,2012-06-01,0,0,0,0,0,0
Algeria,2012-06-01,2,0,0,0,0,2
Algeria,2012-06-01,0,0,0,0,0,0
Algeria,2012-06-01,1,0,0,3,0,4
Algeria,2012-06-01,0,0,0,3,0,3
Algeria,2012-06-01,0,0,0,0,0,0
Algeria,2012-06-01,12,0,0,3,1,16
Algeria,2012-06-01,0,0,1,0,0,1
Algeria,2012-06-01,4,0,0,0,0,4
Algeria,2012-06-01,-3,0,0,6,4,7
Algeria,2012-06-01,11,0,0,6,1,18
Algeria,2012-06-01,58,0,-1,29,2,88
Algeria,2012-06-01,9,0,0,39,2,50
Algeria,2012-06-01,9,0,0,27,1,37
Algeria,2012-06-01,10,0,0,9,2,21
Algeria,2012-06-01,3,0,0,12,2,17
Algeria,2012-06-01,6,0,0,5,1,12
Algeria,2012-06-01,35,0,-8,0,0,27
Algeria,2012-06-01,46,0,-2,0,0,44
Algeria,2012-06-01,19,0,-2,0,3,20
Algeria,2012-06-01,55,0,0,21,4,80
Algeria,2012-06-01,19,0,0,-1,11,29
Algeria,2012-06-01,23,0,-2,3,0,24
Algeria,2012-06-01,23,0,-2,0,0,21
Algeria,2012-06-01,5,0,0,1,1,7
Algeria,2012-06-01,6,0,-6,17,0,17
Algeria,2012-06-01,6,0,-2,6,1,11
Algeria,2012-06-01,42,0,0,1,0,43
Algeria,2012-06-01,7,0,0,0,0,7
Algeria,2012-06-01,17,0,0,9,0,26
Algeria,2012-06-01,0,0,0,3,0,3
Bangladesh,2012-06-01,1,0,0,0,0,1
Bangladesh,2012-06-01,9,0,0,0,1,10
Bangladesh,2012-06-01,19,0,0,2,2,23
Bangladesh,2012-06-01,47,0,0,0,0,47
Bangladesh,2012-06-01,52,0,-2,15,9,74
Bangladesh,2012-06-01,27,0,-2,1,12,38
Bangladesh,2012-06-01,0,0,0,-2,0,-2
Bangladesh,2012-06-01,15,0,1,20,0,36
Bangladesh,2012-06-01,75,0,0,15,17,107
Bangladesh,2012-06-01,40,0,0,54,8,102
Bangladesh,2012-06-01,74,0,0,28,17,119
Bangladesh,2012-06-01,127,0,0,42,13,182
Bangladesh,2012-06-01,82,0,0,12,3,97
Bangladesh,2012-06-01,95,0,0,5,3,103
Bangladesh,2012-06-01,67,0,0,18,10,95
Bangladesh,2012-06-01,66,0,0,12,21,99
Bangladesh,2012-06-01,135,0,0,22,16,173
Bangladesh,2012-06-01,34,0,2,22,1,59
Bangladesh,2012-06-01,91,0,1,34,4,130
Bangladesh,2012-06-01,40,0,0,-1,4,43
Bangladesh,2012-06-01,79,0,0,40,8,127
Bangladesh,2012-06-01,-11,2,0,10,8,9
Bangladesh,2012-06-01,10,0,0,13,2,25
Bangladesh,2012-06-01,11,2,2,-4,4,15
Bangladesh,2012-06-01,1,0,0,9,2,12
Bangladesh,2012-06-01,25,0,0,34,5,64
Bangladesh,2012-06-01,19,0,0,6,1,26
Bangladesh,2012-06-01,29,0,0,4,1,34
Bangladesh,2012-06-01,29,2,0,10,2,43
Bangladesh,2012-06-01,8,0,0,4,2,14
Cameroon,2012-06-01,3,0,0,0,0,3
Cameroon,2012-06-01,0,0,0,0,0,0
Cameroon,2012-06-01,0,0,0,0,0,0
Cameroon,2012-06-01,0,0,0,0,0,0
Cameroon,2012-06-01,-1,0,0,0,0,-1
Cameroon,2012-06-01,0,0,0,0,0,0
Cameroon,2012-06-01,0,0,0,0,0,0
Cameroon,2012-06-01,6,2,0,3,0,11
Cameroon,2012-06-01,0,0,0,3,0,3
Cameroon,2012-06-01,0,0,0,0,0,0
Cameroon,2012-06-01,2,0,0,0,0,2
Cameroon,2012-06-01,6,0,0,-2,0,4
Cameroon,2012-06-01,0,0,0,0,0,0
Cameroon,2012-06-01,0,0,0,0,0,0
Cameroon,2012-06-01,0,0,0,0,0,0
Cameroon,2012-06-01,2,0,0,0,0,2
Cameroon,2012-06-01,6,2,0,0,0,8
Cameroon,2012-06-01,2,0,0,0,0,2
Cameroon,2012-06-01,5,0,-1,0,0,4
Cameroon,2012-06-01,0,0,0,3,0,3
Cameroon,2012-06-01,0,0,0,3,0,3
Cameroon,2012-06-01,6,2,0,0,2,10
Cameroon,2012-06-01,1,0,0,0,0,1
Cameroon,2012-06-01,0,0,0,0,0,0
Cameroon,2012-06-01,0,0,0,0,0,0
Cameroon,2012-06-01,0,0,0,0,0,0
China,2012-06-01,77,0,1,62,15,155
China,2012-06-01,150,2,0,75,10,237
China,2012-06-01,162,0,4,40,13,219
China,2012-06-01,164,4,-2,128,29,323
China,2012-06-01,220,6,1,121,31,379
China,2012-06-01,258,4,1,170,32,465
China,2012-06-01,73,0,0,50,3,126
China,2012-06-01,219,2,0,112,30,363
China,2012-06-01,93,2,0,10,8,113
China,2012-06-01,67,6,-3,27,13,110
China,2012-06-01,208,6,2,48,36,300
China,2012-06-01,143,0,-2,114,25,280
China,2012-06-01,166,0,-2,178,19,361
China,2012-06-01,178,2,3,68,19,270
China,2012-06-01,114,12,-6,84,14,218
China,2012-06-01,58,4,0,44,7,113
China,2012-06-01,55,2,-2,30,6,91
China,2012-06-01,152,4,0,97,15,268
China,2012-06-01,238,2,-3,77,14,328
China,2012-06-01,255,6,-1,150,15,425
China,2012-06-01,163,2,-11,72,18,244
China,2012-06-01,192,2,-4,42,21,253
China,2012-06-01,100,4,0,43,16,163
China,2012-06-01,74,0,0,49,24,147
China,2012-06-01,51,2,2,71,11,137
China,2012-06-01,122,6,-3,29,18,172
China,2012-06-01,149,6,-6,53,18,220
China,2012-06-01,102,2,-3,67,8,176
China,2012-06-01,171,2,12,57,24,266
China,2012-06-01,107,0,0,17,11,135
Egypt,2012-06-01,62,0,-4,29,4,91
Egypt,2012-06-01,91,0,-5,223,21,330
Egypt,2012-06-01,72,0,0,102,20,194
Egypt,2012-06-01,112,0,-5,105,15,227
Egypt,2012-06-01,69,0,-2,22,18,107
Egypt,2012-06-01,85,0,-3,80,37,199
Egypt,2012-06-01,12,0,0,0,3,15
Egypt,2012-06-01,59,0,0,41,34,134
Egypt,2012-06-01,73,0,0,22,5,100
Egypt,2012-06-01,85,0,-5,81,19,180
Egypt,2012-06-01,60,0,-3,38,21,116
Egypt,2012-06-01,31,0,-5,59,15,100
Egypt,2012-06-01,103,0,6,101,30,240
Egypt,2012-06-01,162,0,-6,99,32,287
Egypt,2012-06-01,128,4,-5,70,24,221
Egypt,2012-06-01,129,0,-10,57,32,208
Egypt,2012-06-01,123,0,-34,37,17,143
Egypt,2012-06-01,460,2,-27,58,35,528
Egypt,2012-06-01,318,2,-22,102,44,444
Egypt,2012-06-01,212,0,-9,66,31,300
Egypt,2012-06-01,164,2,-9,33,26,216
Egypt,2012-06-01,167,0,-2,37,25,227
Egypt,2012-06-01,119,0,-7,46,14,172
Egypt,2012-06-01,195,0,-8,32,52,271
Egypt,2012-06-01,120,2,-4,17,7,142
Egypt,2012-06-01,155,0,-8,97,31,275
Egypt,2012-06-01,68,2,-6,72,14,150
Egypt,2012-06-01,43,0,-3,47,17,104
Egypt,2012-06-01,75,2,-1,78,19,173
Egypt,2012-06-01,63,0,-3,-17,15,58
Eritrea,2012-06-01,0,0,0,5,4,9
Eritrea,2012-06-01,12,0,0,0,17,29
Eritrea,2012-06-01,1,0,0,9,3,13
Eritrea,2012-06-01,2,0,0,10,2,14
Eritrea,2012-06-01,0,0,0,0,0,0
Eritrea,2012-06-01,4,0,0,0,2,6
Eritrea,2012-06-01,3,0,-1,9,13,24
Eritrea,2012-06-01,8,0,-1,12,14,33
Eritrea,2012-06-01,1,0,0,3,0,4
Eritrea,2012-06-01,2,2,0,15,0,19
Eritrea,2012-06-01,3,0,0,0,2,5
Eritrea,2012-06-01,8,0,0,3,2,13
Eritrea,2012-06-01,16,0,0,6,0,22
Eritrea,2012-06-01,14,0,0,29,0,43
Eritrea,2012-06-01,4,0,0,0,0,4
Eritrea,2012-06-01,-1,0,0,4,0,3
Eritrea,2012-06-01,9,0,0,12,0,21
Eritrea,2012-06-01,3,0,0,-2,0,1
Eritrea,2012-06-01,0,0,0,3,0,3
Eritrea,2012-06-01,2,0,0,6,2,10
Eritrea,2012-06-01,2,0,0,6,2,10
Eritrea,2012-06-01,0,0,0,6,0,6
Eritrea,2012-06-01,0,0,0,12,0,12
Eritrea,2012-06-01,0,0,0,0,0,0
Eritrea,2012-06-01,4,4,0,-2,2,8
Eritrea,2012-06-01,0,0,0,3,0,3
Georgia,2012-06-01,10,0,0,0,1,11
Georgia,2012-06-01,15,0,0,9,3,27
Georgia,2012-06-01,14,0,0,-1,0,13
Georgia,2012-06-01,16,0,0,8,2,26
Georgia,2012-06-01,43,2,-4,16,3,60
Georgia,2012-06-01,50,2,-3,19,6,74
Georgia,2012-06-01,6,0,0,3,0,9
Georgia,2012-06-01,72,2,-2,28,3,103
Georgia,2012-06-01,28,0,1,6,2,37
Georgia,2012-06-01,22,0,0,-2,8,28
Georgia,2012-06-01,47,2,0,1,0,50
Georgia,2012-06-01,72,2,3,8,6,91
Georgia,2012-06-01,62,0,-2,19,6,85
Georgia,2012-06-01,24,2,0,7,0,33
Georgia,2012-06-01,46,2,0,34,4,86
Georgia,2012-06-01,23,0,0,8,1,32
Georgia,2012-06-01,20,2,-3,7,1,27
Georgia,2012-06-01,50,0,0,46,7,103
Georgia,2012-06-01,59,2,0,34,5,100
Georgia,2012-06-01,40,2,-2,26,6,72
Georgia,2012-06-01,14,0,-2,34,1,47
Georgia,2012-06-01,32,2,0,25,2,61
Georgia,2012-06-01,15,0,0,16,0,31
Georgia,2012-06-01,16,0,0,12,1,29
Georgia,2012-06-01,3,0,0,-2,0,1
Georgia,2012-06-01,92,0,0,25,7,124
Georgia,2012-06-01,54,2,-1,7,8,70
Georgia,2012-06-01,37,0,-2,15,2,52
Georgia,2012-06-01,59,0,1,15,10,85
Georgia,2012-06-01,15,0,-6,23,0,32
India,2012-06-01,45,0,-4,13,4,58
India,2012-06-01,41,0,2,11,16,70
India,2012-06-01,39,0,0,7,4,50
India,2012-06-01,55,0,-2,13,12,78
India,2012-06-01,84,2,0,19,5,110
India,2012-06-01,27,0,0,9,1,37
India,2012-06-01,10,0,1,3,2,16
India,2012-06-01,62,0,-4,35,10,103
India,2012-06-01,47,0,1,19,10,77
India,2012-06-01,109,2,0,31,8,150
India,2012-06-01,188,1,4,52,11,256
India,2012-06-01,110,4,-1,15,17,145
India,2012-06-01,62,4,-3,19,5,87
India,2012-06-01,32,0,0,9,5,46
India,2012-06-01,68,2,-2,82,10,160
India,2012-06-01,122,2,1,66,4,195
India,2012-06-01,43,0,1,23,5,72
India,2012-06-01,61,2,0,23,17,103
India,2012-06-01,46,2,-1,80,12,139
India,2012-06-01,83,4,2,27,14,130
India,2012-06-01,122,6,2,15,9,154
India,2012-06-01,63,0,0,17,11,91
India,2012-06-01,28,0,-2,2,1,29
India,2012-06-01,51,0,-1,17,7,74
India,2012-06-01,37,0,0,-1,7,43
India,2012-06-01,78,0,-10,13,17,98
India,2012-06-01,62,2,-5,14,7,80
India,2012-06-01,71,2,0,47,9,129
India,2012-06-01,71,2,-4,24,5,98
India,2012-06-01,60,2,-2,6,13,79
Iran,2012-06-01,42,0,0,21,9,72
Iran,2012-06-01,83,0,0,25,8,116
Iran,2012-06-01,71,0,0,4,7,82
Iran,2012-06-01,114,0,0,1,13,128
Iran,2012-06-01,115,0,-3,52,17,181
Iran,2012-06-01,131,0,0,15,42,188
Iran,2012-06-01,43,0,0,0,14,57
Iran,2012-06-01,120,4,-5,35,13,167
Iran,2012-06-01,60,0,2,32,11,105
Iran,2012-06-01,127,0,1,38,6,172
Iran,2012-06-01,178,0,-2,30,13,219
Iran,2012-06-01,144,2,2,91,10,249
Iran,2012-06-01,126,0,-8,63,6,187
Iran,2012-06-01,133,0,-2,52,16,199
Iran,2012-06-01,71,0,0,23,17,111
Iran,2012-06-01,56,0,0,44,13,113
Iran,2012-06-01,95,0,-1,25,8,127
Iran,2012-06-01,110,0,3,56,10,179
Iran,2012-06-01,139,0,-2,44,9,190
Iran,2012-06-01,177,0,0,155,13,345
Iran,2012-06-01,91,0,1,79,5,176
Iran,2012-06-01,194,0,3,83,4,284
Iran,2012-06-01,140,0,2,34,8,184
Iran,2012-06-01,145,0,-4,24,4,169
Iran,2012-06-01,75,0,-1,52,1,127
Iran,2012-06-01,152,0,4,51,14,221
Iran,2012-06-01,191,0,0,32,5,228
Iran,2012-06-01,135,0,2,30,18,185
Iran,2012-06-01,146,0,3,32,12,193
Iran,2012-06-01,76,0,1,41,9,127
Iraq,2012-06-01,97,4,2,-1,0,102
Iraq,2012-06-01,76,0,2,16,6,100
Iraq,2012-06-01,42,2,0,19,4,67
Iraq,2012-06-01,111,0,1,54,11,177
Iraq,2012-06-01,110,2,1,24,6,143
Iraq,2012-06-01,61,10,1,19,11,102
Iraq,2012-06-01,12,0,0,18,0,30
Iraq,2012-06-01,89,2,7,69,18,185
Iraq,2012-06-01,39,2,3,26,0,70
Iraq,2012-06-01,17,0,0,19,1,37
Iraq,2012-06-01,75,2,-3,75,9,158
Iraq,2012-06-01,125,4,-6,26,12,161
Iraq,2012-06-01,147,4,0,13,30,194
Iraq,2012-06-01,55,2,3,17,16,93
Iraq,2012-06-01,105,4,1,27,19,156
Iraq,2012-06-01,86,0,2,16,34,138
Iraq,2012-06-01,59,0,0,-2,2,59
Iraq,2012-06-01,106,12,0,7,7,132
Iraq,2012-06-01,213,0,0,22,25,260
Iraq,2012-06-01,161,0,0,28,3,192
Iraq,2012-06-01,89,0,2,57,2,150
Iraq,2012-06-01,78,0,0,36,10,124
Iraq,2012-06-01,78,0,0,9,4,91
Iraq,2012-06-01,137,2,-2,15,15,167
Iraq,2012-06-01,33,2,-4,22,5,58
Iraq,2012-06-01,109,2,-1,21,12,143
Iraq,2012-06-01,106,4,11,16,25,162
Iraq,2012-06-01,86,0,2,14,3,105
Iraq,2012-06-01,35,2,3,6,6,52
Iraq,2012-06-01,141,4,-12,13,11,157
Morocco,2012-06-01,1,0,0,0,0,1
Morocco,2012-06-01,0,0,0,20,0,20
Morocco,2012-06-01,6,0,2,-4,0,4
Morocco,2012-06-01,0,0,0,-2,0,-2
Morocco,2012-06-01,0,1,0,5,1,7
Morocco,2012-06-01,5,0,0,0,1,6
Morocco,2012-06-01,2,0,0,6,0,8
Morocco,2012-06-01,1,0,0,-2,1,0
Morocco,2012-06-01,0,0,0,0,5,5
Morocco,2012-06-01,1,0,0,-2,0,-1
Morocco,2012-06-01,0,0,0,3,0,3
Morocco,2012-06-01,5,0,0,-2,1,4
Morocco,2012-06-01,0,0,0,0,0,0
Morocco,2012-06-01,0,0,0,-2,1,-1
Morocco,2012-06-01,3,0,0,-1,2,4
Morocco,2012-06-01,4,0,0,5,0,9
Morocco,2012-06-01,2,0,0,0,0,2
Morocco,2012-06-01,2,4,1,-8,1,0
Morocco,2012-06-01,18,0,0,-2,1,17
Morocco,2012-06-01,6,0,0,0,0,6
Morocco,2012-06-01,5,0,0,-1,2,6
Morocco,2012-06-01,28,0,0,15,2,45
Morocco,2012-06-01,10,0,0,15,2,27
Morocco,2012-06-01,1,0,0,6,0,7
Morocco,2012-06-01,1,0,0,0,2,3
Morocco,2012-06-01,8,0,0,28,1,37
Morocco,2012-06-01,2,0,0,13,3,18
Morocco,2012-06-01,5,0,0,0,1,6
Morocco,2012-06-01,7,0,0,0,10,17
Morocco,2012-06-01,15,0,0,0,0,15
Nigeria,2012-06-01,24,0,-1,8,2,33
Nigeria,2012-06-01,10,0,0,9,0,19
Nigeria,2012-06-01,31,0,0,7,10,48
Nigeria,2012-06-01,34,0,1,22,0,57
Nigeria,2012-06-01,28,2,0,10,3,43
Nigeria,2012-06-01,32,2,1,12,2,49
Nigeria,2012-06-01,4,0,0,0,0,4
Nigeria,2012-06-01,16,0,0,18,1,35
Nigeria,2012-06-01,8,0,0,0,1,9
Nigeria,2012-06-01,72,0,0,12,18,102
Nigeria,2012-06-01,40,2,0,14,8,64
Nigeria,2012-06-01,25,2,0,8,7,42
Nigeria,2012-06-01,33,0,-1,24,5,61
Nigeria,2012-06-01,37,0,-4,39,9,81
Nigeria,2012-06-01,69,2,1,32,9,113
Nigeria,2012-06-01,18,0,0,19,1,38
Nigeria,2012-06-01,19,0,1,21,0,41
Nigeria,2012-06-01,31,0,3,29,7,70
Nigeria,2012-06-01,38,0,0,18,3,59
Nigeria,2012-06-01,50,0,0,21,8,79
Nigeria,2012-06-01,26,0,3,-4,5,30
Nigeria,2012-06-01,37,0,0,20,4,61
Nigeria,2012-06-01,10,0,0,-5,0,5
Nigeria,2012-06-01,25,0,0,3,1,29
Nigeria,2012-06-01,14,0,0,40,1,55
Nigeria,2012-06-01,36,0,1,31,4,72
Nigeria,2012-06-01,15,0,0,37,3,55
Nigeria,2012-06-01,38,6,0,37,0,81
Nigeria,2012-06-01,13,0,-2,6,1,18
Nigeria,2012-06-01,14,0,0,0,0,14
Pakistan,2012-06-01,96,0,0,5,2,103
Pakistan,2012-06-01,54,0,3,25,15,97
Pakistan,2012-06-01,101,0,-8,-2,5,96
Pakistan,2012-06-01,156,0,5,60,14,235
Pakistan,2012-06-01,312,0,-8,62,12,378
Pakistan,2012-06-01,227,0,7,43,6,283
Pakistan,2012-06-01,71,0,0,1,7,79
Pakistan,2012-06-01,153,0,-9,37,38,219
Pakistan,2012-06-01,164,4,2,43,6,219
Pakistan,2012-06-01,189,2,-4,74,14,275
Pakistan,2012-06-01,171,0,-1,47,18,235
Pakistan,2012-06-01,106,2,9,43,15,175
Pakistan,2012-06-01,137,2,3,43,9,194
Pakistan,2012-06-01,62,4,-5,36,2,99
Pakistan,2012-06-01,62,0,0,25,4,91
Pakistan,2012-06-01,47,0,3,18,12,80
Pakistan,2012-06-01,75,0,-1,29,6,109
Pakistan,2012-06-01,92,0,0,57,10,159
Pakistan,2012-06-01,157,0,-9,177,18,343
Pakistan,2012-06-01,128,8,3,110,9,258
Pakistan,2012-06-01,310,0,0,155,45,510
Pakistan,2012-06-01,170,0,-2,89,22,279
Pakistan,2012-06-01,86,0,0,45,10,141
Pakistan,2012-06-01,77,0,-2,35,6,116
Pakistan,2012-06-01,89,0,-3,63,0,149
Pakistan,2012-06-01,109,0,0,36,9,154
Pakistan,2012-06-01,105,0,7,43,13,168
Pakistan,2012-06-01,88,6,0,15,7,116
Pakistan,2012-06-01,116,0,3,30,11,160
Pakistan,2012-06-01,95,0,4,14,5,118
Sierra Leone,2012-06-01,0,0,0,3,0,3
Sierra Leone,2012-06-01,7,0,0,27,0,34
Sierra Leone,2012-06-01,7,0,0,9,0,16
Sierra Leone,2012-06-01,3,0,0,18,1,22
Sierra Leone,2012-06-01,3,0,0,6,0,9
Sierra Leone,2012-06-01,9,0,0,0,0,9
Sierra Leone,2012-06-01,7,0,0,0,0,7
Sierra Leone,2012-06-01,7,0,1,0,0,8
Sierra Leone,2012-06-01,1,0,0,-2,0,-1
Sierra Leone,2012-06-01,-2,0,0,0,0,-2
Sierra Leone,2012-06-01,0,0,0,3,0,3
Sierra Leone,2012-06-01,4,0,0,15,2,21
Sierra Leone,2012-06-01,1,0,0,9,0,10
Sierra Leone,2012-06-01,11,0,-1,10,0,20
Sierra Leone,2012-06-01,6,0,-2,0,0,4
Sierra Leone,2012-06-01,0,0,0,0,0,0
Sierra Leone,2012-06-01,-1,0,0,0,0,-1
Sierra Leone,2012-06-01,16,0,0,7,1,24
Sierra Leone,2012-06-01,4,0,0,3,0,7
Sierra Leone,2012-06-01,0,0,0,0,0,0
Sierra Leone,2012-06-01,1,0,0,15,0,16
Sierra Leone,2012-06-01,10,0,0,0,0,10
Sierra Leone,2012-06-01,1,0,0,0,0,1
Sierra Leone,2012-06-01,0,0,0,0,0,0
Sierra Leone,2012-06-01,-2,2,0,0,0,0
Sierra Leone,2012-06-01,6,0,0,1,0,7
Sierra Leone,2012-06-01,0,0,0,3,0,3
Sierra Leone,2012-06-01,5,0,0,0,0,5
Sierra Leone,2012-06-01,2,0,0,0,0,2
Somalia,2012-06-01,76,8,2,21,5,112
Somalia,2012-06-01,38,0,0,19,0,57
Somalia,2012-06-01,42,0,0,39,10,91
Somalia,2012-06-01,72,4,1,97,20,194
Somalia,2012-06-01,124,0,1,42,11,178
Somalia,2012-06-01,103,0,0,49,7,159
Somalia,2012-06-01,13,0,0,-4,10,19
Somalia,2012-06-01,50,2,-1,40,4,95
Somalia,2012-06-01,38,0,0,7,4,49
Somalia,2012-06-01,84,4,0,10,17,115
Somalia,2012-06-01,95,0,-2,50,12,155
Somalia,2012-06-01,59,2,-2,22,1,82
Somalia,2012-06-01,83,0,1,70,6,160
Somalia,2012-06-01,82,0,-2,30,2,112
Somalia,2012-06-01,45,0,0,13,1,59
Somalia,2012-06-01,90,0,-1,13,12,114
Somalia,2012-06-01,107,2,-1,9,12,129
Somalia,2012-06-01,85,2,-3,44,45,173
Somalia,2012-06-01,94,0,0,42,15,151
Somalia,2012-06-01,119,0,-2,43,9,169
Somalia,2012-06-01,84,0,-6,30,18,126
Somalia,2012-06-01,74,0,0,94,28,196
Somalia,2012-06-01,117,0,0,47,10,174
Somalia,2012-06-01,76,0,0,22,2,100
Somalia,2012-06-01,82,6,0,27,3,118
Somalia,2012-06-01,66,0,-2,71,18,153
Somalia,2012-06-01,71,8,2,100,17,198
Somalia,2012-06-01,102,0,-1,47,13,161
Somalia,2012-06-01,271,0,0,169,41,481
Somalia,2012-06-01,123,4,-2,43,11,179
Syria,2012-06-01,224,14,-9,33,20,282
Syria,2012-06-01,408,12,-7,102,55,570
Syria,2012-06-01,467,2,0,37,39,545
Syria,2012-06-01,272,0,-7,66,36,367
Syria,2012-06-01,239,0,-1,95,25,358
Syria,2012-06-01,496,0,-1,64,34,593
Syria,2012-06-01,126,0,-6,18,21,159
Syria,2012-06-01,540,4,0,51,62,657
Syria,2012-06-01,248,0,-12,42,24,302
Syria,2012-06-01,276,2,-4,75,17,366
Syria,2012-06-01,293,4,0,28,14,339
Syria,2012-06-01,270,16,-12,46,31,351
Syria,2012-06-01,535,0,7,34,33,609
Syria,2012-06-01,226,2,-1,25,36,288
Syria,2012-06-01,273,0,-9,84,61,409
Syria,2012-06-01,169,0,-5,36,17,217
Syria,2012-06-01,128,4,-4,27,29,184
Syria,2012-06-01,261,12,-8,-16,21,270
Syria,2012-06-01,300,4,0,27,33,364
Syria,2012-06-01,354,0,-12,35,10,387
Syria,2012-06-01,398,0,-16,-9,16,389
Syria,2012-06-01,500,0,-2,19,25,542
Syria,2012-06-01,354,0,-12,0,18,360
Syria,2012-06-01,528,0,-5,13,28,564
Syria,2012-06-01,381,0,2,14,9,406
Syria,2012-06-01,784,0,-12,214,36,1022
Syria,2012-06-01,449,6,-11,37,39,520
Syria,2012-06-01,399,6,-14,6,20,417
Syria,2012-06-01,327,4,-5,21,9,356
Syria,2012-06-01,214,6,-21,18,17,234
Yemen,2012-06-01,4,0,-6,3,4,5
Yemen,2012-06-01,25,0,-7,20,8,46
Yemen,2012-06-01,23,0,0,8,10,41
Yemen,2012-06-01,36,0,0,12,4,52
Yemen,2012-06-01,78,0,-6,3,0,75
Yemen,2012-06-01,70,0,-6,9,2,75
Yemen,2012-06-01,9,0,0,-4,0,5
Yemen,2012-06-01,22,0,-4,-1,0,17
Yemen,2012-06-01,27,0,3,7,2,39
Yemen,2012-06-01,38,0,1,3,1,43
Yemen,2012-06-01,88,0,3,-12,9,88
Yemen,2012-06-01,68,0,1,8,13,90
Yemen,2012-06-01,82,2,2,3,4,93
Yemen,2012-06-01,59,8,0,3,4,74
Yemen,2012-06-01,62,0,-2,7,3,70
Yemen,2012-06-01,56,0,0,13,39,108
Yemen,2012-06-01,47,0,0,4,31,82
Yemen,2012-06-01,116,0,1,11,50,178
Yemen,2012-06-01,58,0,-2,7,13,76
Yemen,2012-06-01,119,0,-3,0,2,118
Yemen,2012-06-01,48,0,-5,6,13,62
Yemen,2012-06-01,26,0,-6,33,9,62
Yemen,2012-06-01,19,2,0,3,4,28
Yemen,2012-06-01,17,0,-2,-1,0,14
Yemen,2012-06-01,11,0,0,9,2,22
Yemen,2012-06-01,45,0,0,5,1,51
Yemen,2012-06-01,7,0,1,9,2,19
Yemen,2012-06-01,28,0,-8,9,4,33
Yemen,2012-06-01,26,0,-1,8,0,33
Yemen,2012-06-01,25,0,-1,-1,0,23
Afghanistan,2010-10-01,355,4,1,31,47,438
Afghanistan,2010-10-01,449,6,0,5,29,489
Afghanistan,2010-10-01,276,2,0,99,49,426
Afghanistan,2010-10-01,416,12,-2,70,55,551
Afghanistan,2010-10-01,633,6,-6,164,59,856
Afghanistan,2010-10-01,575,2,5,96,45,723
Afghanistan,2010-10-01,341,2,4,75,19,441
Afghanistan,2010-10-01,434,0,-9,78,36,539
Afghanistan,2010-10-01,216,0,-2,72,25,311
Afghanistan,2010-10-01,161,2,-2,32,17,210
Afghanistan,2010-10-01,232,2,-6,75,30,333
Afghanistan,2010-10-01,236,0,1,63,22,322
Afghanistan,2010-10-01,161,0,1,21,15,198
Afghanistan,2010-10-01,442,2,-1,170,66,679
Afghanistan,2010-10-01,476,0,2,71,35,584
Afghanistan,2010-10-01,303,2,0,52,26,383
Afghanistan,2010-10-01,205,0,2,135,18,360
Afghanistan,2010-10-01,207,2,3,45,17,274
Afghanistan,2010-10-01,127,2,-2,3,5,135
Afghanistan,2010-10-01,66,0,0,-8,1,59
Afghanistan,2010-10-01,17,0,0,0,5,22
Afghanistan,2010-10-01,249,2,3,82,12,348
Afghanistan,2010-10-01,344,0,2,54,19,419
Afghanistan,2010-10-01,266,0,4,51,18,339
Afghanistan,2010-10-01,414,4,2,100,33,553
Afghanistan,2010-10-01,160,0,-1,102,40,301
Afghanistan,2010-10-01,254,12,-6,161,30,451
Afghanistan,2010-10-01,203,2,0,110,12,327
Afghanistan,2010-10-01,201,0,-3,84,20,302
Afghanistan,2010-10-01,87,0,-2,30,8,123
Afghanistan,2010-10-01,244,0,1,103,32,380
Albania,2010-10-01,1,0,-3,1,0,-1
Albania,2010-10-01,3,0,0,0,0,3
Albania,2010-10-01,28,0,0,12,0,40
Albania,2010-10-01,1,0,0,0,0,1
Albania,2010-10-01,13,0,0,0,1,14
Albania,2010-10-01,4,0,0,0,0,4
Albania,2010-10-01,-1,0,0,12,1,12
Albania,2010-10-01,3,0,0,0,2,5
Albania,2010-10-01,-1,0,0,0,0,-1
Albania,2010-10-01,0,0,0,6,0,6
Albania,2010-10-01,2,0,0,9,0,11
Albania,2010-10-01,7,0,0,1,0,8
Albania,2010-10-01,11,0,-1,3,0,13
Albania,2010-10-01,5,0,0,3,1,9
Albania,2010-10-01,0,0,-3,6,0,3
Albania,2010-10-01,3,0,0,6,0,9
Albania,2010-10-01,0,0,0,0,0,0
Albania,2010-10-01,0,0,0,5,0,5
Albania,2010-10-01,2,0,0,0,1,3
Albania,2010-10-01,0,0,0,0,0,0
Albania,2010-10-01,0,0,0,-2,0,-2
Albania,2010-10-01,4,0,0,-2,0,2
Albania,2010-10-01,16,0,0,6,0,22
Albania,2010-10-01,0,0,0,6,0,6
Albania,2010-10-01,3,0,0,6,0,9
Albania,2010-10-01,0,0,0,-2,0,-2
Albania,2010-10-01,2,0,0,-2,0,0
Albania,2010-10-01,0,0,0,0,0,0
Albania,2010-10-01,22,0,1,-1,0,22
Albania,2010-10-01,0,0,-1,0,0,-1
Albania,2010-10-01,0,0,0,-2,0,-2
Algeria,2010-10-01,10,0,0,18,6,34
Algeria,2010-10-01,0,0,0,6,0,6
Algeria,2010-10-01,2,0,0,12,2,16
Algeria,2010-10-01,17,0,0,1,0,18
Algeria,2010-10-01,17,0,0,22,1,40
Algeria,2010-10-01,21,0,0,43,1,65
Algeria,2010-10-01,1,0,0,9,1,11
Algeria,2010-10-01,10,0,0,-11,3,2
Algeria,2010-10-01,0,0,0,0,0,0
Algeria,2010-10-01,10,0,0,0,0,10
Algeria,2010-10-01,3,0,0,8,2,13
Algeria,2010-10-01,-2,0,0,-2,1,-3
Algeria,2010-10-01,2,0,-1,13,0,14
Algeria,2010-10-01,23,0,0,0,0,23
Algeria,2010-10-01,6,0,0,0,0,6
Algeria,2010-10-01,-1,0,0,3,0,2
Algeria,2010-10-01,13,0,0,27,0,40
Algeria,2010-10-01,11,0,0,30,0,41
Algeria,2010-10-01,9,0,0,6,0,15
Algeria,2010-10-01,2,0,0,0,0,2
Algeria,2010-10-01,0,0,0,-1,0,-1
Algeria,2010-10-01,3,0,0,0,0,3
Algeria,2010-10-01,0,0,0,6,0,6
Algeria,2010-10-01,0,0,0,6,0,6
Algeria,2010-10-01,0,0,0,0,0,0
Algeria,2010-10-01,20,0,-1,0,0,19
Algeria,2010-10-01,10,0,0,0,0,10
Algeria,2010-10-01,2,0,0,0,1,3
Algeria,2010-10-01,14,0,0,13,0,27
Algeria,2010-10-01,0,0,0,0,0,0
Algeria,2010-10-01,8,2,0,9,0,19
Bangladesh,2010-10-01,18,0,0,0,0,18
Bangladesh,2010-10-01,11,0,0,-2,1,10
Bangladesh,2010-10-01,27,0,0,0,0,27
Bangladesh,2010-10-01,9,0,-2,9,3,19
Bangladesh,2010-10-01,13,0,0,24,2,39
Bangladesh,2010-10-01,12,0,0,13,5,30
Bangladesh,2010-10-01,8,0,-2,2,2,10
Bangladesh,2010-10-01,16,0,0,2,1,19
Bangladesh,2010-10-01,17,0,1,2,3,23
Bangladesh,2010-10-01,19,0,1,15,5,40
Bangladesh,2010-10-01,13,0,2,1,0,16
Bangladesh,2010-10-01,15,0,0,1,9,25
Bangladesh,2010-10-01,13,0,0,12,2,27
Bangladesh,2010-10-01,21,0,1,6,8,36
Bangladesh,2010-10-01,-2,4,0,21,3,26
Bangladesh,2010-10-01,14,0,0,3,1,18
Bangladesh,2010-10-01,23,0,0,-6,4,21
Bangladesh,2010-10-01,11,0,0,12,0,23
Bangladesh,2010-10-01,14,2,-1,-8,5,12
Bangladesh,2010-10-01,0,0,0,9,0,9
Bangladesh,2010-10-01,24,2,0,-6,0,20
Bangladesh,2010-10-01,13,0,-1,8,0,20
Bangladesh,2010-10-01,6,0,0,3,0,9
Bangladesh,2010-10-01,44,0,0,51,2,97
Bangladesh,2010-10-01,8,0,0,3,0,11
Bangladesh,2010-10-01,12,0,-1,31,2,44
Bangladesh,2010-10-01,12,0,0,-2,2,12
Bangladesh,2010-10-01,4,0,0,3,1,8
Bangladesh,2010-10-01,1,0,1,1,1,4
Bangladesh,2010-10-01,22,0,-2,-4,5,21
Cameroon,2010-10-01,0,0,0,-3,0,-3
Cameroon,2010-10-01,5,0,0,2,0,7
Cameroon,2010-10-01,1,0,0,0,0,1
Cameroon,2010-10-01,0,0,0,1,0,1
Cameroon,2010-10-01,6,0,0,0,0,6
Cameroon,2010-10-01,3,0,0,0,1,4
Cameroon,2010-10-01,-1,0,0,9,3,11
Cameroon,2010-10-01,0,0,0,0,0,0
Cameroon,2010-10-01,0,0,0,0,0,0
Cameroon,2010-10-01,0,0,0,0,0,0
Cameroon,2010-10-01,1,0,0,0,0,1
Cameroon,2010-10-01,0,0,0,0,0,0
Cameroon,2010-10-01,-3,0,0,9,0,6
Cameroon,2010-10-01,11,0,0,3,0,14
Cameroon,2010-10-01,7,0,-2,0,0,5
Cameroon,2010-10-01,0,0,0,0,0,0
Cameroon,2010-10-01,1,0,0,0,0,1
Cameroon,2010-10-01,0,0,0,0,0,0
Cameroon,2010-10-01,1,0,0,6,0,7
Cameroon,2010-10-01,4,0,0,0,0,4
Cameroon,2010-10-01,2,0,0,0,0,2
Cameroon,2010-10-01,0,0,0,0,0,0
Cameroon,2010-10-01,0,0,0,0,0,0
Cameroon,2010-10-01,0,0,0,0,0,0
Cameroon,2010-10-01,3,0,0,0,0,3
China,2010-10-01,132,4,-3,5,26,164
China,2010-10-01,78,0,-1,29,6,112
China,2010-10-01,50,4,2,18,4,78
China,2010-10-01,155,12,1,10,12,190
China,2010-10-01,162,0,-3,30,12,201
China,2010-10-01,201,0,-1,68,27,295
China,2010-10-01,111,0,0,15,11,137
China,2010-10-01,131,20,-3,89,29,266
China,2010-10-01,83,0,-2,48,8,137
China,2010-10-01,76,0,-5,44,16,131
China,2010-10-01,129,4,1,14,21,169
China,2010-10-01,83,4,-1,22,20,128
China,2010-10-01,76,0,1,33,5,115
China,2010-10-01,165,10,1,34,16,226
China,2010-10-01,100,8,-2,54,18,178
China,2010-10-01,76,4,-3,27,15,119
China,2010-10-01,136,8,-1,22,28,193
China,2010-10-01,121,0,1,51,30,203
China,2010-10-01,57,2,0,43,13,115
China,2010-10-01,0,0,0,6,1,7
China,2010-10-01,22,0,0,5,1,28
China,2010-10-01,99,0,0,61,17,177
China,2010-10-01,88,0,-1,63,10,160
China,2010-10-01,70,0,1,27,16,114
China,2010-10-01,146,6,0,28,9,189
China,2010-10-01,97,4,-1,43,7,150
China,2010-10-01,60,6,-2,77,15,156
China,2010-10-01,124,2,-4,76,15,213
China,2010-10-01,169,4,2,56,16,247
China,2010-10-01,56,0,3,14,3,76
China,2010-10-01,119,0,-2,18,7,142
Egypt,2010-10-01,73,0,0,9,7,89
Egypt,2010-10-01,26,0,0,19,2,47
Egypt,2010-10-01,24,0,0,5,3,32
Egypt,2010-10-01,51,0,0,2,1,54
Egypt,2010-10-01,45,0,0,39,1,85
Egypt,2010-10-01,40,0,0,9,0,49
Egypt,2010-10-01,27,0,0,36,5,68
Egypt,2010-10-01,45,0,0,21,1,67
Egypt,2010-10-01,26,0,-4,37,0,59
Egypt,2010-10-01,23,0,-1,16,0,38
Egypt,2010-10-01,105,0,2,7,1,115
Egypt,2010-10-01,9,0,0,24,0,33
Egypt,2010-10-01,32,2,0,13,3,50
Egypt,2010-10-01,29,0,2,25,0,56
Egypt,2010-10-01,26,0,0,21,4,51
Egypt,2010-10-01,23,0,0,3,0,26
Egypt,2010-10-01,44,0,1,7,2,54
Egypt,2010-10-01,20,0,0,8,2,30
Egypt,2010-10-01,10,0,1,8,4,23
Egypt,2010-10-01,0,0,1,0,0,1
Egypt,2010-10-01,5,0,0,-2,1,4
Egypt,2010-10-01,43,4,4,4,1,56
Egypt,2010-10-01,12,0,2,21,5,40
Egypt,2010-10-01,28,0,0,38,1,67
Egypt,2010-10-01,17,0,0,22,0,39
Egypt,2010-10-01,38,0,-1,16,8,61
Egypt,2010-10-01,40,0,0,18,0,58
Egypt,2010-10-01,35,0,-1,12,6,52
Egypt,2010-10-01,27,0,0,28,6,61
Egypt,2010-10-01,87,0,0,-2,0,85
Egypt,2010-10-01,70,0,0,20,3,93
Eritrea,2010-10-01,7,0,0,0,0,7
Eritrea,2010-10-01,6,0,0,0,0,6
Eritrea,2010-10-01,0,0,0,0,0,0
Eritrea,2010-10-01,1,0,0,-2,0,-1
Eritrea,2010-10-01,0,0,0,1,1,2
Eritrea,2010-10-01,0,0,3,0,0,3
Eritrea,2010-10-01,5,0,1,0,0,6
Eritrea,2010-10-01,10,0,1,6,0,17
Eritrea,2010-10-01,0,0,0,0,0,0
Eritrea,2010-10-01,1,0,0,6,0,7
Eritrea,2010-10-01,2,0,0,0,0,2
Eritrea,2010-10-01,0,0,0,0,0,0
Eritrea,2010-10-01,1,0,0,0,0,1
Eritrea,2010-10-01,2,0,0,0,0,2
Eritrea,2010-10-01,1,0,0,0,0,1
Eritrea,2010-10-01,1,0,0,0,0,1
Eritrea,2010-10-01,0,0,0,0,0,0
Eritrea,2010-10-01,1,0,0,6,2,9
Eritrea,2010-10-01,1,0,0,1,0,2
Eritrea,2010-10-01,0,0,0,0,0,0
Eritrea,2010-10-01,0,0,0,0,0,0
Eritrea,2010-10-01,0,0,0,0,0,0
Eritrea,2010-10-01,0,0,0,0,0,0
Eritrea,2010-10-01,0,0,0,6,0,6
Eritrea,2010-10-01,2,0,0,3,0,5
Eritrea,2010-10-01,4,0,1,-2,0,3
Eritrea,2010-10-01,0,0,0,0,0,0
Georgia,2010-10-01,36,0,-4,14,3,49
Georgia,2010-10-01,17,0,0,6,0,23
Georgia,2010-10-01,45,0,0,2,3,50
Georgia,2010-10-01,99,0,0,44,10,153
Georgia,2010-10-01,59,0,1,31,4,95
Georgia,2010-10-01,30,0,0,4,1,35
Georgia,2010-10-01,19,2,0,3,5,29
Georgia,2010-10-01,34,4,0,0,4,42
Georgia,2010-10-01,10,0,0,-1,2,11
Georgia,2010-10-01,11,0,0,7,1,19
Georgia,2010-10-01,35,0,-1,11,2,47
Georgia,2010-10-01,25,0,1,19,4,49
Georgia,2010-10-01,9,0,0,13,1,23
Georgia,2010-10-01,14,0,-2,-8,2,6
Georgia,2010-10-01,30,0,0,25,7,62
Georgia,2010-10-01,31,2,-4,28,5,62
Georgia,2010-10-01,12,0,-2,-1,0,9
Georgia,2010-10-01,-2,0,0,10,3,11
Georgia,2010-10-01,4,0,-2,3,1,6
Georgia,2010-10-01,0,0,0,0,1,1
Georgia,2010-10-01,9,0,0,0,0,9
Georgia,2010-10-01,11,0,-2,4,0,13
Georgia,2010-10-01,34,0,-1,18,2,53
Georgia,2010-10-01,19,0,0,-2,0,17
Georgia,2010-10-01,31,2,0,13,2,48
Georgia,2010-10-01,30,2,0,8,4,44
Georgia,2010-10-01,34,0,0,-2,3,35
Georgia,2010-10-01,9,0,-2,9,2,18
Georgia,2010-10-01,44,0,0,31,4,79
Georgia,2010-10-01,0,0,0,3,0,3
Georgia,2010-10-01,33,0,1,3,2,39
India,2010-10-01,79,2,0,23,9,113
India,2010-10-01,11,0,0,19,5,35
India,2010-10-01,33,4,0,5,4,46
India,2010-10-01,16,2,0,11,7,36
India,2010-10-01,77,2,-1,20,11,109
India,2010-10-01,50,0,1,0,5,56
India,2010-10-01,52,0,2,16,5,75
India,2010-10-01,78,2,0,40,11,131
India,2010-10-01,90,0,0,12,16,118
India,2010-10-01,86,0,0,-4,-1,81
India,2010-10-01,48,2,-2,6,8,62
India,2010-10-01,10,2,0,4,0,16
India,2010-10-01,35,2,0,4,7,48
India,2010-10-01,35,2,-1,25,6,67
India,2010-10-01,49,4,0,18,5,76
India,2010-10-01,27,0,1,5,1,34
India,2010-10-01,45,0,-2,10,1,54
India,2010-10-01,41,0,0,16,4,61
India,2010-10-01,29,2,0,13,2,46
India,2010-10-01,1,0,0,0,0,1
India,2010-10-01,7,0,0,0,0,7
India,2010-10-01,49,0,0,3,11,63
India,2010-10-01,77,0,1,4,14,96
India,2010-10-01,45,0,0,-7,4,42
India,2010-10-01,66,4,-1,59,4,132
India,2010-10-01,23,0,0,6,4,33
India,2010-10-01,52,6,-2,10,3,69
India,2010-10-01,16,2,0,17,5,40
India,2010-10-01,57,0,1,11,3,72
India,2010-10-01,4,0,-2,15,3,20
India,2010-10-01,50,0,-4,23,3,72
Iran,2010-10-01,49,0,-10,-2,3,40
Iran,2010-10-01,63,0,3,46,7,119
Iran,2010-10-01,22,0,0,26,0,48
Iran,2010-10-01,65,0,-1,30,5,99
Iran,2010-10-01,49,0,0,25,6,80
Iran,2010-10-01,41,0,0,18,14,73
Iran,2010-10-01,62,0,1,18,8,89
Iran,2010-10-01,42,0,0,32,5,79
Iran,2010-10-01,54,0,0,19,7,80
Iran,2010-10-01,42,0,5,8,5,60
Iran,2010-10-01,171,0,-4,53,4,224
Iran,2010-10-01,82,0,0,29,10,121
Iran,2010-10-01,70,0,1,25,7,103
Iran,2010-10-01,251,0,0,103,16,370
Iran,2010-10-01,113,2,2,35,14,166
Iran,2010-10-01,25,0,0,9,5,39
Iran,2010-10-01,34,0,2,54,3,93
Iran,2010-10-01,66,0,0,34,14,114
Iran,2010-10-01,28,0,1,22,13,64
Iran,2010-10-01,6,0,0,18,7,31
Iran,2010-10-01,17,0,0,9,1,27
Iran,2010-10-01,79,0,0,25,12,116
Iran,2010-10-01,86,0,0,52,24,162
Iran,2010-10-01,79,0,0,33,11,123
Iran,2010-10-01,86,0,4,51,10,151
Iran,2010-10-01,67,0,-3,42,6,112
Iran,2010-10-01,106,10,2,66,7,191
Iran,2010-10-01,52,0,-5,14,8,69
Iran,2010-10-01,68,0,-1,18,4,89
Iran,2010-10-01,29,0,0,14,0,43
Iran,2010-10-01,59,0,0,26,9,94
Iraq,2010-10-01,100,2,-2,13,12,125
Iraq,2010-10-01,90,4,-8,16,11,113
Iraq,2010-10-01,111,2,0,40,12,165
Iraq,2010-10-01,174,2,3,49,8,236
Iraq,2010-10-01,156,2,0,17,26,201
Iraq,2010-10-01,175,4,-4,58,27,260
Iraq,2010-10-01,156,2,0,28,6,192
Iraq,2010-10-01,120,2,-2,9,19,148
Iraq,2010-10-01,30,6,1,14,3,54
Iraq,2010-10-01,120,2,0,17,9,148
Iraq,2010-10-01,186,2,0,0,6,194
Iraq,2010-10-01,90,0,2,14,15,121
Iraq,2010-10-01,56,0,0,9,11,76
Iraq,2010-10-01,119,0,-4,57,20,192
Iraq,2010-10-01,85,2,0,55,14,156
Iraq,2010-10-01,78,0,2,40,4,124
Iraq,2010-10-01,130,4,0,21,16,171
Iraq,2010-10-01,130,0,0,-6,6,130
Iraq,2010-10-01,34,0,4,-2,4,40
Iraq,2010-10-01,6,0,0,12,0,18
Iraq,2010-10-01,28,0,0,-4,3,27
Iraq,2010-10-01,197,0,3,44,25,269
Iraq,2010-10-01,171,2,0,142,37,352
Iraq,2010-10-01,144,0,-1,91,24,258
Iraq,2010-10-01,193,2,1,97,30,323
Iraq,2010-10-01,150,0,6,203,26,385
Iraq,2010-10-01,136,2,1,171,22,332
Iraq,2010-10-01,115,4,1,88,4,212
Iraq,2010-10-01,112,2,2,40,20,176
Iraq,2010-10-01,16,0,0,1,10,27
Iraq,2010-10-01,116,0,1,25,21,163
Morocco,2010-10-01,9,0,0,18,0,27
Morocco,2010-10-01,3,0,0,48,0,51
Morocco,2010-10-01,7,0,0,0,0,7
Morocco,2010-10-01,22,0,0,18,4,44
Morocco,2010-10-01,10,0,0,9,1,20
Morocco,2010-10-01,4,0,0,-2,4,6
Morocco,2010-10-01,3,0,0,18,0,21
Morocco,2010-10-01,3,0,0,24,0,27
Morocco,2010-10-01,-3,0,0,1,0,-2
Morocco,2010-10-01,2,0,0,0,0,2
Morocco,2010-10-01,9,0,0,-6,0,3
Morocco,2010-10-01,9,0,0,4,0,13
Morocco,2010-10-01,9,0,0,3,0,12
Morocco,2010-10-01,8,0,0,0,6,14
Morocco,2010-10-01,-5,0,0,13,0,8
Morocco,2010-10-01,11,0,0,6,0,17
Morocco,2010-10-01,33,0,0,0,0,33
Morocco,2010-10-01,5,0,0,40,0,45
Morocco,2010-10-01,2,0,0,9,0,11
Morocco,2010-10-01,1,0,0,-4,0,-3
Morocco,2010-10-01,12,0,0,3,3,18
Morocco,2010-10-01,2,0,0,0,0,2
Morocco,2010-10-01,0,0,0,12,0,12
Morocco,2010-10-01,13,0,0,3,0,16
Morocco,2010-10-01,11,0,0,0,1,12
Morocco,2010-10-01,3,0,0,0,0,3
Morocco,2010-10-01,5,0,0,12,0,17
Morocco,2010-10-01,4,0,0,7,13,24
Morocco,2010-10-01,2,0,-4,0,2,0
Morocco,2010-10-01,3,0,0,4,0,7
Nigeria,2010-10-01,33,0,0,-17,0,16
Nigeria,2010-10-01,10,0,-2,-2,2,8
Nigeria,2010-10-01,12,0,0,9,1,22
Nigeria,2010-10-01,14,0,0,10,2,26
Nigeria,2010-10-01,15,0,0,7,3,25
Nigeria,2010-10-01,7,0,1,3,1,12
Nigeria,2010-10-01,10,0,2,13,0,25
Nigeria,2010-10-01,31,0,0,27,4,62
Nigeria,2010-10-01,5,0,0,15,0,20
Nigeria,2010-10-01,10,4,0,0,1,15
Nigeria,2010-10-01,49,0,0,13,1,63
Nigeria,2010-10-01,21,0,1,21,14,57
Nigeria,2010-10-01,30,0,2,39,0,71
Nigeria,2010-10-01,22,2,3,54,10,91
Nigeria,2010-10-01,14,0,0,18,0,32
Nigeria,2010-10-01,3,0,0,21,2,26
Nigeria,2010-10-01,12,0,0,21,0,33
Nigeria,2010-10-01,14,0,2,6,1,23
Nigeria,2010-10-01,2,0,0,1,2,5
Nigeria,2010-10-01,3,0,0,0,0,3
Nigeria,2010-10-01,3,0,0,0,2,5
Nigeria,2010-10-01,19,0,0,4,5,28
Nigeria,2010-10-01,11,0,0,0,3,14
Nigeria,2010-10-01,-2,2,0,2,3,5
Nigeria,2010-10-01,23,0,-4,16,0,35
Nigeria,2010-10-01,17,0,0,15,3,35
Nigeria,2010-10-01,10,0,0,4,4,18
Nigeria,2010-10-01,27,0,-4,3,2,28
Nigeria,2010-10-01,15,0,0,14,4,33
Nigeria,2010-10-01,0,0,0,6,0,6
Nigeria,2010-10-01,31,2,0,10,2,45
Pakistan,2010-10-01,312,4,-4,23,31,366
Pakistan,2010-10-01,211,12,-2,22,5,248
Pakistan,2010-10-01,181,4,-1,26,11,221
Pakistan,2010-10-01,216,2,8,53,16,295
Pakistan,2010-10-01,245,6,1,209,65,526
Pakistan,2010-10-01,382,2,-2,158,58,598
Pakistan,2010-10-01,206,2,0,83,23,314
Pakistan,2010-10-01,239,0,-4,41,29,305
Pakistan,2010-10-01,118,0,-3,69,27,211
Pakistan,2010-10-01,138,0,0,32,17,187
Pakistan,2010-10-01,184,0,-2,40,11,233
Pakistan,2010-10-01,87,0,-3,99,5,188
Pakistan,2010-10-01,100,2,0,43,17,162
Pakistan,2010-10-01,129,6,0,53,25,213
Pakistan,2010-10-01,166,6,0,65,20,257
Pakistan,2010-10-01,120,0,1,34,6,161
Pakistan,2010-10-01,169,0,0,57,19,245
Pakistan,2010-10-01,81,0,0,28,7,116
Pakistan,2010-10-01,51,2,0,6,23,82
Pakistan,2010-10-01,41,0,0,3,14,58
Pakistan,2010-10-01,38,0,0,6,10,54
Pakistan,2010-10-01,134,0,0,47,25,206
Pakistan,2010-10-01,145,4,2,8,31,190
Pakistan,2010-10-01,97,0,0,15,11,123
Pakistan,2010-10-01,155,4,6,57,10,232
Pakistan,2010-10-01,42,2,-2,41,18,101
Pakistan,2010-10-01,97,4,-2,89,51,239
Pakistan,2010-10-01,80,2,0,77,33,192
Pakistan,2010-10-01,65,4,-3,25,9,100
Pakistan,2010-10-01,102,0,-2,19,3,122
Pakistan,2010-10-01,72,4,-6,23,1,94
Sierra Leone,2010-10-01,8,0,0,0,0,8
Sierra Leone,2010-10-01,11,0,0,12,0,23
Sierra Leone,2010-10-01,3,0,0,9,0,12
Sierra Leone,2010-10-01,2,0,0,0,0,2
Sierra Leone,2010-10-01,6,0,0,9,2,17
Sierra Leone,2010-10-01,1,0,0,3,2,6
Sierra Leone,2010-10-01,6,0,0,6,1,13
Sierra Leone,2010-10-01,2,0,0,12,0,14
Sierra Leone,2010-10-01,0,0,0,0,0,0
Sierra Leone,2010-10-01,0,0,0,-1,0,-1
Sierra Leone,2010-10-01,7,0,0,-2,2,7
Sierra Leone,2010-10-01,0,0,0,0,0,0
Sierra Leone,2010-10-01,0,0,0,0,0,0
Sierra Leone,2010-10-01,0,0,0,3,0,3
Sierra Leone,2010-10-01,0,0,0,0,2,2
Sierra Leone,2010-10-01,6,0,0,0,0,6
Sierra Leone,2010-10-01,0,0,0,0,0,0
Sierra Leone,2010-10-01,0,0,0,-2,0,-2
Sierra Leone,2010-10-01,3,0,0,3,1,7
Sierra Leone,2010-10-01,2,0,0,0,1,3
Sierra Leone,2010-10-01,6,0,0,0,0,6
Sierra Leone,2010-10-01,4,0,0,0,0,4
Sierra Leone,2010-10-01,0,0,0,0,0,0
Sierra Leone,2010-10-01,0,0,0,0,0,0
Sierra Leone,2010-10-01,3,0,0,3,0,6
Sierra Leone,2010-10-01,4,0,0,12,2,18
Sierra Leone,2010-10-01,2,0,0,1,0,3
Sierra Leone,2010-10-01,2,0,0,9,0,11
Sierra Leone,2010-10-01,0,0,0,-2,0,-2
Sierra Leone,2010-10-01,1,0,0,0,1,2
Somalia,2010-10-01,23,0,0,16,2,41
Somalia,2010-10-01,18,2,0,20,3,43
Somalia,2010-10-01,18,0,0,12,0,30
Somalia,2010-10-01,9,0,0,4,0,13
Somalia,2010-10-01,58,0,3,30,0,91
Somalia,2010-10-01,26,4,1,20,3,54
Somalia,2010-10-01,17,2,0,16,10,45
Somalia,2010-10-01,33,0,0,100,1,134
Somalia,2010-10-01,26,0,0,16,2,44
Somalia,2010-10-01,13,0,0,3,5,21
Somalia,2010-10-01,34,0,-3,3,7,41
Somalia,2010-10-01,49,0,0,35,0,84
Somalia,2010-10-01,33,0,-1,-3,1,30
Somalia,2010-10-01,18,0,0,10,0,28
Somalia,2010-10-01,32,0,-2,113,0,143
Somalia,2010-10-01,26,0,0,31,0,57
Somalia,2010-10-01,17,0,0,109,8,134
Somalia,2010-10-01,27,2,0,42,3,74
Somalia,2010-10-01,9,0,0,14,0,23
Somalia,2010-10-01,2,0,0,6,0,8
Somalia,2010-10-01,16,0,0,0,0,16
Somalia,2010-10-01,82,0,0,31,1,114
Somalia,2010-10-01,33,0,0,8,8,49
Somalia,2010-10-01,26,0,0,98,2,126
Somalia,2010-10-01,74,0,-6,19,0,87
Somalia,2010-10-01,83,2,-6,18,8,105
Somalia,2010-10-01,55,0,0,66,18,139
Somalia,2010-10-01,18,4,0,34,63,119
Somalia,2010-10-01,33,0,0,1,25,59
Somalia,2010-10-01,12,0,0,0,0,12
Somalia,2010-10-01,60,0,-16,57,3,104
Syria,2010-10-01,13,0,4,6,0,23
Syria,2010-10-01,12,0,0,0,2,14
Syria,2010-10-01,13,0,0,0,0,13
Syria,2010-10-01,20,0,0,27,0,47
Syria,2010-10-01,19,0,0,20,6,45
Syria,2010-10-01,25,0,0,21,2,48
Syria,2010-10-01,18,0,2,14,2,36
Syria,2010-10-01,38,0,0,6,1,45
Syria,2010-10-01,26,0,0,3,1,30
Syria,2010-10-01,8,0,0,0,1,9
Syria,2010-10-01,-3,0,0,-4,0,-7
Syria,2010-10-01,18,0,0,4,0,22
Syria,2010-10-01,-5,0,0,1,1,-3
Syria,2010-10-01,7,0,0,-6,0,1
Syria,2010-10-01,21,0,0,1,0,22
Syria,2010-10-01,11,0,0,9,3,23
Syria,2010-10-01,18,0,0,2,5,25
Syria,2010-10-01,11,4,0,9,0,24
Syria,2010-10-01,9,0,0,12,1,22
Syria,2010-10-01,-1,0,0,0,0,-1
Syria,2010-10-01,3,0,0,0,0,3
Syria,2010-10-01,14,0,0,6,0,20
Syria,2010-10-01,3,0,0,-1,1,3
Syria,2010-10-01,12,0,0,0,3,15
Syria,2010-10-01,13,0,0,23,4,40
Syria,2010-10-01,2,0,0,12,0,14
Syria,2010-10-01,10,0,0,3,0,13
Syria,2010-10-01,26,0,-4,4,10,36
Syria,2010-10-01,33,0,-2,6,2,39
Syria,2010-10-01,3,0,0,0,0,3
Syria,2010-10-01,10,0,0,4,0,14
Yemen,2010-10-01,19,0,0,9,0,28
Yemen,2010-10-01,3,0,0,0,0,3
Yemen,2010-10-01,5,0,0,0,0,5
Yemen,2010-10-01,47,0,0,-8,3,42
Yemen,2010-10-01,35,0,0,1,2,38
Yemen,2010-10-01,247,0,0,14,33,294
Yemen,2010-10-01,97,0,0,66,2,165
Yemen,2010-10-01,15,2,0,31,5,53
Yemen,2010-10-01,0,0,0,3,0,3
Yemen,2010-10-01,18,0,0,0,1,19
Yemen,2010-10-01,44,0,0,-6,10,48
Yemen,2010-10-01,43,0,0,24,1,68
Yemen,2010-10-01,25,0,0,0,0,25
Yemen,2010-10-01,7,0,0,3,0,10
Yemen,2010-10-01,33,0,0,7,5,45
Yemen,2010-10-01,34,0,0,14,8,56
Yemen,2010-10-01,77,0,0,0,7,84
Yemen,2010-10-01,27,0,0,10,0,37
Yemen,2010-10-01,14,0,0,0,2,16
Yemen,2010-10-01,2,0,0,0,0,2
Yemen,2010-10-01,4,0,0,0,1,5
Yemen,2010-10-01,24,0,0,12,0,36
Yemen,2010-10-01,31,0,0,4,0,35
Yemen,2010-10-01,5,0,0,-4,0,1
Yemen,2010-10-01,22,0,0,12,0,34
Yemen,2010-10-01,37,0,-2,34,0,69
Yemen,2010-10-01,14,0,0,22,4,40
Yemen,2010-10-01,6,0,0,22,0,28
Yemen,2010-10-01,273,0,2,62,15,352
Yemen,2010-10-01,192,0,1,98,9,300
Yemen,2010-10-01,260,0,1,149,21,431
Afghanistan,2010-04-01,121,0,0,25,9,155
Afghanistan,2010-04-01,78,0,-1,0,2,79
Afghanistan,2010-04-01,234,0,-1,1,2,236
Afghanistan,2010-04-01,47,0,0,0,9,56
Afghanistan,2010-04-01,107,0,-1,7,3,116
Afghanistan,2010-04-01,68,0,1,7,1,77
Afghanistan,2010-04-01,70,0,-6,19,4,87
Afghanistan,2010-04-01,89,0,0,49,10,148
Afghanistan,2010-04-01,74,0,0,6,17,97
Afghanistan,2010-04-01,81,0,-3,0,10,88
Afghanistan,2010-04-01,100,0,-4,-1,12,107
Afghanistan,2010-04-01,100,0,0,32,37,169
Afghanistan,2010-04-01,104,4,1,29,11,149
Afghanistan,2010-04-01,124,0,-4,28,8,156
Afghanistan,2010-04-01,126,0,-2,55,9,188
Afghanistan,2010-04-01,84,0,-2,1,24,107
Afghanistan,2010-04-01,96,0,0,13,3,112
Afghanistan,2010-04-01,44,0,0,12,6,62
Afghanistan,2010-04-01,54,0,-1,15,4,72
Afghanistan,2010-04-01,205,2,2,68,18,295
Afghanistan,2010-04-01,185,0,-2,61,20,264
Afghanistan,2010-04-01,140,0,0,29,25,194
Afghanistan,2010-04-01,197,0,-1,19,68,283
Afghanistan,2010-04-01,215,2,0,20,18,255
Afghanistan,2010-04-01,171,0,0,7,12,190
Afghanistan,2010-04-01,339,2,-4,-28,39,348
Afghanistan,2010-04-01,118,0,2,10,8,138
Afghanistan,2010-04-01,113,0,0,9,19,141
Afghanistan,2010-04-01,192,2,2,51,31,278
Afghanistan,2010-04-01,162,0,0,61,20,243
Albania,2010-04-01,4,0,0,3,0,7
Albania,2010-04-01,3,0,0,0,2,5
Albania,2010-04-01,6,0,0,0,0,6
Albania,2010-04-01,1,0,0,0,3,4
Albania,2010-04-01,11,0,0,-2,0,9
Albania,2010-04-01,4,0,0,3,0,7
Albania,2010-04-01,16,0,0,0,0,16
Albania,2010-04-01,2,0,0,0,0,2
Albania,2010-04-01,2,0,0,0,0,2
Albania,2010-04-01,2,0,0,0,0,2
Albania,2010-04-01,0,0,0,0,0,0
Albania,2010-04-01,0,0,0,0,0,0
Albania,2010-04-01,1,0,0,0,0,1
Albania,2010-04-01,0,0,0,9,0,9
Albania,2010-04-01,2,0,0,0,1,3
Albania,2010-04-01,0,0,0,0,0,0
Albania,2010-04-01,2,0,0,0,0,2
Albania,2010-04-01,2,0,0,0,1,3
Albania,2010-04-01,0,0,0,0,1,1
Albania,2010-04-01,10,0,-2,-2,0,6
Albania,2010-04-01,3,0,0,6,0,9
Albania,2010-04-01,7,0,0,6,8,21
Albania,2010-04-01,0,0,0,0,0,0
Albania,2010-04-01,0,0,0,0,0,0
Albania,2010-04-01,5,0,0,0,0,5
Albania,2010-04-01,-1,0,0,0,2,1
Albania,2010-04-01,3,0,0,0,0,3
Albania,2010-04-01,13,0,-2,24,0,35
Albania,2010-04-01,1,0,0,48,16,65
Algeria,2010-04-01,8,0,0,0,1,9
Algeria,2010-04-01,-2,0,0,0,1,-1
Algeria,2010-04-01,3,0,0,0,0,3
Algeria,2010-04-01,-1,0,0,0,0,-1
Algeria,2010-04-01,8,0,0,0,0,8
Algeria,2010-04-01,1,0,0,0,0,1
Algeria,2010-04-01,0,0,0,0,0,0
Algeria,2010-04-01,-1,0,0,0,0,-1
Algeria,2010-04-01,0,0,0,3,0,3
Algeria,2010-04-01,0,0,0,0,0,0
Algeria,2010-04-01,0,0,0,0,0,0
Algeria,2010-04-01,2,0,0,3,0,5
Algeria,2010-04-01,1,0,0,0,0,1
Algeria,2010-04-01,0,0,0,0,0,0
Algeria,2010-04-01,0,0,0,30,0,30
Algeria,2010-04-01,0,0,0,0,0,0
Algeria,2010-04-01,0,0,-1,0,0,-1
Algeria,2010-04-01,0,0,0,0,0,0
Algeria,2010-04-01,-1,0,0,3,0,2
Algeria,2010-04-01,5,0,0,3,1,9
Algeria,2010-04-01,3,0,0,0,1,4
Algeria,2010-04-01,15,0,0,27,3,45
Algeria,2010-04-01,16,0,0,22,0,38
Algeria,2010-04-01,1,0,0,3,0,4
Algeria,2010-04-01,0,0,0,0,0,0
Algeria,2010-04-01,2,0,0,10,2,14
Algeria,2010-04-01,2,0,0,9,4,15
Algeria,2010-04-01,-1,0,0,3,0,2
Algeria,2010-04-01,24,0,1,-4,0,21
Algeria,2010-04-01,0,0,0,9,0,9
Bangladesh,2010-04-01,7,0,0,3,0,10
Bangladesh,2010-04-01,2,0,3,9,0,14
Bangladesh,2010-04-01,8,0,0,4,2,14
Bangladesh,2010-04-01,0,0,1,0,2,3
Bangladesh,2010-04-01,0,0,0,0,0,0
Bangladesh,2010-04-01,0,0,0,0,0,0
Bangladesh,2010-04-01,7,0,0,0,0,7
Bangladesh,2010-04-01,3,0,0,8,0,11
Bangladesh,2010-04-01,-3,0,0,-2,0,-5
Bangladesh,2010-04-01,0,0,0,0,0,0
Bangladesh,2010-04-01,0,0,0,6,0,6
Bangladesh,2010-04-01,0,0,0,-1,1,0
Bangladesh,2010-04-01,4,0,0,-2,0,2
Bangladesh,2010-04-01,10,2,0,3,3,18
Bangladesh,2010-04-01,3,0,0,0,2,5
Bangladesh,2010-04-01,5,0,0,6,1,12
Bangladesh,2010-04-01,8,0,0,15,5,28
Bangladesh,2010-04-01,6,0,0,15,0,21
Bangladesh,2010-04-01,5,0,1,7,4,17
Bangladesh,2010-04-01,29,0,0,8,1,38
Bangladesh,2010-04-01,9,0,0,2,0,11
Bangladesh,2010-04-01,0,0,0,0,0,0
Bangladesh,2010-04-01,20,6,0,3,3,32
Bangladesh,2010-04-01,-1,0,0,-1,1,-1
Bangladesh,2010-04-01,2,0,0,3,0,5
Bangladesh,2010-04-01,14,0,1,13,7,35
Bangladesh,2010-04-01,22,0,-1,1,2,24
Cameroon,2010-04-01,0,0,0,0,0,0
Cameroon,2010-04-01,0,0,0,0,0,0
Cameroon,2010-04-01,5,0,0,0,0,5
Cameroon,2010-04-01,2,0,0,0,0,2
Cameroon,2010-04-01,0,0,0,0,0,0
Cameroon,2010-04-01,2,0,0,0,1,3
Cameroon,2010-04-01,0,0,0,0,0,0
Cameroon,2010-04-01,3,0,0,6,2,11
Cameroon,2010-04-01,1,0,0,3,0,4
Cameroon,2010-04-01,0,0,0,0,0,0
Cameroon,2010-04-01,0,0,0,0,1,1
Cameroon,2010-04-01,0,0,0,0,0,0
Cameroon,2010-04-01,11,0,0,0,0,11
Cameroon,2010-04-01,4,0,0,0,0,4
Cameroon,2010-04-01,0,0,0,3,0,3
China,2010-04-01,79,0,2,22,9,112
China,2010-04-01,30,0,-1,7,5,41
China,2010-04-01,73,0,-6,21,3,91
China,2010-04-01,25,0,0,-1,0,24
China,2010-04-01,33,0,1,19,4,57
China,2010-04-01,92,0,0,38,19,149
China,2010-04-01,55,0,0,40,11,106
China,2010-04-01,74,6,2,5,12,99
China,2010-04-01,41,0,-1,6,1,47
China,2010-04-01,15,6,0,-1,6,26
China,2010-04-01,1,0,0,6,1,8
China,2010-04-01,16,0,0,12,0,28
China,2010-04-01,48,0,1,22,1,72
China,2010-04-01,42,0,1,23,1,67
China,2010-04-01,77,0,-4,40,13,126
China,2010-04-01,25,0,-1,-1,2,25
China,2010-04-01,5,0,0,3,0,8
China,2010-04-01,10,0,-2,9,3,20
China,2010-04-01,32,0,-1,11,4,46
China,2010-04-01,128,4,4,51,17,204
China,2010-04-01,127,0,-1,56,8,190
China,2010-04-01,120,4,-3,17,11,149
China,2010-04-01,112,0,-3,30,17,156
China,2010-04-01,86,2,0,50,8,146
China,2010-04-01,34,0,1,20,6,61
China,2010-04-01,86,0,4,29,14,133
China,2010-04-01,18,2,0,21,6,47
China,2010-04-01,38,0,-2,39,8,83
China,2010-04-01,131,2,2,48,19,202
China,2010-04-01,44,2,0,13,30,89
Egypt,2010-04-01,36,0,1,21,4,62
Egypt,2010-04-01,9,0,0,12,1,22
Egypt,2010-04-01,70,0,0,45,2,117
Egypt,2010-04-01,39,0,0,10,1,50
Egypt,2010-04-01,23,0,0,0,0,23
Egypt,2010-04-01,8,0,0,12,9,29
Egypt,2010-04-01,2,0,1,3,0,6
Egypt,2010-04-01,25,0,0,15,0,40
Egypt,2010-04-01,11,0,0,6,0,17
Egypt,2010-04-01,-5,0,0,6,2,3
Egypt,2010-04-01,6,0,0,0,0,6
Egypt,2010-04-01,7,0,0,0,0,7
Egypt,2010-04-01,4,0,0,0,2,6
Egypt,2010-04-01,6,0,0,15,0,21
Egypt,2010-04-01,12,0,0,7,3,22
Egypt,2010-04-01,2,0,0,0,0,2
Egypt,2010-04-01,1,0,0,2,0,3
Egypt,2010-04-01,8,0,0,0,2,10
Egypt,2010-04-01,20,0,1,3,3,27
Egypt,2010-04-01,62,0,1,39,5,107
Egypt,2010-04-01,53,0,0,39,3,95
Egypt,2010-04-01,82,0,0,16,0,98
Egypt,2010-04-01,40,0,0,7,3,50
Egypt,2010-04-01,60,0,-2,32,0,90
Egypt,2010-04-01,17,0,0,2,4,23
Egypt,2010-04-01,23,0,1,14,6,44
Egypt,2010-04-01,26,0,0,1,2,29
Egypt,2010-04-01,57,0,1,10,0,68
Egypt,2010-04-01,140,0,3,24,9,176
Egypt,2010-04-01,82,0,4,27,0,113
Eritrea,2010-04-01,3,0,0,3,0,6
Eritrea,2010-04-01,0,0,1,6,4,11
Eritrea,2010-04-01,0,0,0,0,0,0
Eritrea,2010-04-01,2,0,0,0,0,2
Eritrea,2010-04-01,0,0,0,0,0,0
Eritrea,2010-04-01,7,0,0,3,0,10
Eritrea,2010-04-01,3,0,0,0,0,3
Eritrea,2010-04-01,0,0,0,0,0,0
Eritrea,2010-04-01,0,0,0,0,0,0
Eritrea,2010-04-01,6,0,0,-1,0,5
Eritrea,2010-04-01,0,0,0,0,0,0
Eritrea,2010-04-01,0,0,0,0,0,0
Eritrea,2010-04-01,0,0,0,0,0,0
Eritrea,2010-04-01,0,0,0,3,0,3
Eritrea,2010-04-01,3,0,0,0,0,3
Eritrea,2010-04-01,3,0,0,0,0,3
Eritrea,2010-04-01,3,0,0,0,5,8
Eritrea,2010-04-01,0,0,0,0,5,5
Eritrea,2010-04-01,8,0,0,3,4,15
Eritrea,2010-04-01,0,0,0,0,0,0
Eritrea,2010-04-01,3,0,0,0,0,3
Eritrea,2010-04-01,0,0,0,0,0,0
Eritrea,2010-04-01,0,0,0,3,0,3
Georgia,2010-04-01,7,0,1,1,1,10
Georgia,2010-04-01,13,0,0,0,1,14
Georgia,2010-04-01,7,0,0,2,0,9
Georgia,2010-04-01,5,0,0,-4,0,1
Georgia,2010-04-01,2,0,0,3,0,5
Georgia,2010-04-01,22,0,0,-1,2,23
Georgia,2010-04-01,-1,0,0,4,0,3
Georgia,2010-04-01,13,0,0,3,0,16
Georgia,2010-04-01,6,0,0,3,0,9
Georgia,2010-04-01,2,0,0,3,0,5
Georgia,2010-04-01,0,0,0,0,0,0
Georgia,2010-04-01,3,0,1,6,0,10
Georgia,2010-04-01,6,0,0,0,0,6
Georgia,2010-04-01,3,0,0,0,6,9
Georgia,2010-04-01,4,0,1,2,0,7
Georgia,2010-04-01,0,0,0,0,0,0
Georgia,2010-04-01,-1,0,0,0,0,-1
Georgia,2010-04-01,0,0,0,0,0,0
Georgia,2010-04-01,5,0,0,6,0,11
Georgia,2010-04-01,9,0,0,31,4,44
Georgia,2010-04-01,34,2,0,10,1,47
Georgia,2010-04-01,24,0,-12,30,4,46
Georgia,2010-04-01,25,0,0,16,1,42
Georgia,2010-04-01,2,0,0,0,2,4
Georgia,2010-04-01,4,0,0,0,0,4
Georgia,2010-04-01,4,0,0,30,4,38
Georgia,2010-04-01,0,0,0,0,0,0
Georgia,2010-04-01,0,0,0,4,0,4
Georgia,2010-04-01,4,0,0,0,0,4
Georgia,2010-04-01,16,2,-2,19,0,35
India,2010-04-01,29,0,0,3,1,33
India,2010-04-01,9,0,0,4,0,13
India,2010-04-01,25,0,-1,11,1,36
India,2010-04-01,0,0,0,0,0,0
India,2010-04-01,4,0,-2,-6,7,3
India,2010-04-01,58,0,0,6,9,73
India,2010-04-01,30,0,1,-4,0,27
India,2010-04-01,32,0,0,12,1,45
India,2010-04-01,11,0,0,2,4,17
India,2010-04-01,14,0,-2,3,0,15
India,2010-04-01,4,0,0,0,0,4
India,2010-04-01,32,0,0,3,0,35
India,2010-04-01,16,0,0,12,2,30
India,2010-04-01,22,0,0,9,4,35
India,2010-04-01,29,0,0,-3,5,31
India,2010-04-01,3,0,0,-1,0,2
India,2010-04-01,8,0,0,0,9,17
India,2010-04-01,3,0,0,0,3,6
India,2010-04-01,22,0,0,13,1,36
India,2010-04-01,44,0,-8,6,3,45
India,2010-04-01,20,0,-1,22,4,45
India,2010-04-01,30,2,1,0,4,37
India,2010-04-01,51,0,-6,11,7,63
India,2010-04-01,64,0,-2,5,0,67
India,2010-04-01,20,0,0,7,0,27
India,2010-04-01,11,0,-2,3,5,17
India,2010-04-01,22,0,0,0,1,23
India,2010-04-01,7,0,0,0,0,7
India,2010-04-01,72,2,1,3,10,88
India,2010-04-01,82,0,-2,10,6,96
Iran,2010-04-01,41,2,0,10,2,55
Iran,2010-04-01,44,0,1,36,1,82
Iran,2010-04-01,33,0,-2,5,9,45
Iran,2010-04-01,52,0,0,18,10,80
Iran,2010-04-01,51,0,-1,26,16,92
Iran,2010-04-01,50,4,0,29,5,88
Iran,2010-04-01,15,0,0,11,6,32
Iran,2010-04-01,30,0,-4,2,5,33
Iran,2010-04-01,25,0,-4,3,4,28
Iran,2010-04-01,15,0,-1,12,0,26
Iran,2010-04-01,11,0,2,2,0,15
Iran,2010-04-01,40,0,-3,15,4,56
Iran,2010-04-01,46,0,0,1,4,51
Iran,2010-04-01,34,0,0,16,-3,47
Iran,2010-04-01,65,0,1,53,4,123
Iran,2010-04-01,19,0,0,29,7,55
Iran,2010-04-01,28,0,0,8,0,36
Iran,2010-04-01,34,2,0,42,1,79
Iran,2010-04-01,46,0,3,74,2,125
Iran,2010-04-01,46,0,0,65,10,121
Iran,2010-04-01,93,4,-2,10,8,113
Iran,2010-04-01,73,0,1,50,15,139
Iran,2010-04-01,123,0,2,13,14,152
Iran,2010-04-01,57,0,-4,33,6,92
Iran,2010-04-01,60,0,0,7,5,72
Iran,2010-04-01,57,0,1,5,4,67
Iran,2010-04-01,26,0,-1,11,3,39
Iran,2010-04-01,8,0,0,3,1,12
Iran,2010-04-01,75,0,0,34,2,111
Iran,2010-04-01,37,0,2,0,10,49
Iraq,2010-04-01,51,0,-3,6,6,60
Iraq,2010-04-01,49,0,0,0,0,49
Iraq,2010-04-01,52,0,0,28,2,82
Iraq,2010-04-01,40,0,0,3,8,51
Iraq,2010-04-01,19,0,0,21,0,40
Iraq,2010-04-01,33,0,0,20,1,54
Iraq,2010-04-01,17,0,1,9,6,33
Iraq,2010-04-01,31,0,0,6,3,40
Iraq,2010-04-01,14,0,0,-2,0,12
Iraq,2010-04-01,26,0,3,0,4,33
Iraq,2010-04-01,38,0,-1,-1,0,36
Iraq,2010-04-01,5,0,-1,0,0,4
Iraq,2010-04-01,50,0,2,17,5,74
Iraq,2010-04-01,26,0,0,4,0,30
Iraq,2010-04-01,19,0,0,26,1,46
Iraq,2010-04-01,1,0,0,2,1,4
Iraq,2010-04-01,3,0,1,6,0,10
Iraq,2010-04-01,5,0,0,0,2,7
Iraq,2010-04-01,6,0,0,4,1,11
Iraq,2010-04-01,234,2,0,42,12,290
Iraq,2010-04-01,127,0,-2,46,6,177
Iraq,2010-04-01,47,0,-1,24,17,87
Iraq,2010-04-01,117,0,0,88,15,220
Iraq,2010-04-01,42,0,1,26,13,82
Iraq,2010-04-01,40,0,-1,10,5,54
Iraq,2010-04-01,114,0,-1,8,11,132
Iraq,2010-04-01,19,0,0,6,1,26
Iraq,2010-04-01,17,0,0,0,0,17
Iraq,2010-04-01,76,0,0,10,6,92
Iraq,2010-04-01,59,0,3,14,2,78
Morocco,2010-04-01,1,0,0,0,0,1
Morocco,2010-04-01,4,0,0,0,0,4
Morocco,2010-04-01,7,0,0,0,0,7
Morocco,2010-04-01,0,0,0,0,0,0
Morocco,2010-04-01,0,0,0,0,0,0
Morocco,2010-04-01,0,0,0,3,0,3
Morocco,2010-04-01,3,0,0,0,0,3
Morocco,2010-04-01,0,0,0,0,0,0
Morocco,2010-04-01,0,0,0,0,0,0
Morocco,2010-04-01,3,0,0,0,0,3
Morocco,2010-04-01,1,0,0,-3,0,-2
Morocco,2010-04-01,0,0,0,0,0,0
Morocco,2010-04-01,0,0,0,0,0,0
Morocco,2010-04-01,3,0,0,9,0,12
Morocco,2010-04-01,0,0,0,0,0,0
Morocco,2010-04-01,0,0,0,0,0,0
Morocco,2010-04-01,0,0,0,0,0,0
Morocco,2010-04-01,5,0,0,6,2,13
Morocco,2010-04-01,7,0,0,6,0,13
Morocco,2010-04-01,6,0,0,9,1,16
Morocco,2010-04-01,19,0,0,6,0,25
Morocco,2010-04-01,11,0,0,3,0,14
Morocco,2010-04-01,6,0,0,6,0,12
Morocco,2010-04-01,7,0,0,3,1,11
Morocco,2010-04-01,0,0,0,0,0,0
Morocco,2010-04-01,4,0,0,-5,0,-1
Morocco,2010-04-01,0,0,0,-2,0,-2
Nigeria,2010-04-01,4,0,0,0,0,4
Nigeria,2010-04-01,19,0,0,6,0,25
Nigeria,2010-04-01,18,0,0,15,0,33
Nigeria,2010-04-01,0,4,0,0,0,4
Nigeria,2010-04-01,13,0,0,-4,0,9
Nigeria,2010-04-01,6,0,2,-4,1,5
Nigeria,2010-04-01,11,0,0,-2,0,9
Nigeria,2010-04-01,18,0,0,27,3,48
Nigeria,2010-04-01,8,0,0,-12,0,-4
Nigeria,2010-04-01,7,0,0,0,4,11
Nigeria,2010-04-01,0,0,0,0,0,0
Nigeria,2010-04-01,5,0,0,0,0,5
Nigeria,2010-04-01,5,0,0,18,0,23
Nigeria,2010-04-01,5,0,0,5,1,11
Nigeria,2010-04-01,11,0,1,8,1,21
Nigeria,2010-04-01,20,0,0,0,0,20
Nigeria,2010-04-01,-3,0,0,0,0,-3
Nigeria,2010-04-01,4,0,0,0,0,4
Nigeria,2010-04-01,0,0,0,8,0,8
Nigeria,2010-04-01,18,0,1,10,2,31
Nigeria,2010-04-01,11,0,0,21,0,32
Nigeria,2010-04-01,12,0,0,0,3,15
Nigeria,2010-04-01,9,0,0,-6,1,4
Nigeria,2010-04-01,29,0,0,-1,2,30
Nigeria,2010-04-01,9,0,0,15,4,28
Nigeria,2010-04-01,54,2,-4,1,2,55
Nigeria,2010-04-01,2,0,-2,0,0,0
Nigeria,2010-04-01,13,0,-6,0,0,7
Nigeria,2010-04-01,36,0,-5,24,1,56
Nigeria,2010-04-01,22,0,-2,24,1,45
Pakistan,2010-04-01,45,0,0,30,6,81
Pakistan,2010-04-01,41,2,0,30,7,80
Pakistan,2010-04-01,11,0,0,5,2,18
Pakistan,2010-04-01,11,0,0,9,0,20
Pakistan,2010-04-01,32,0,0,0,0,32
Pakistan,2010-04-01,66,0,0,21,2,89
Pakistan,2010-04-01,6,0,0,3,0,9
Pakistan,2010-04-01,14,0,0,8,1,23
Pakistan,2010-04-01,2,0,-2,12,0,12
Pakistan,2010-04-01,12,0,0,11,1,24
Pakistan,2010-04-01,2,0,0,9,0,11
Pakistan,2010-04-01,48,0,0,6,3,57
Pakistan,2010-04-01,35,0,-2,24,4,61
Pakistan,2010-04-01,32,0,2,2,0,36
Pakistan,2010-04-01,13,0,0,5,4,22
Pakistan,2010-04-01,35,0,0,13,12,60
Pakistan,2010-04-01,28,0,0,0,4,32
Pakistan,2010-04-01,17,0,0,11,2,30
Pakistan,2010-04-01,21,0,-2,22,4,45
Pakistan,2010-04-01,73,0,-6,29,3,99
Pakistan,2010-04-01,41,0,-2,5,12,56
Pakistan,2010-04-01,42,0,2,22,13,79
Pakistan,2010-04-01,93,0,1,28,10,132
Pakistan,2010-04-01,105,0,0,15,14,134
Pakistan,2010-04-01,99,0,-1,9,5,112
Pakistan,2010-04-01,97,0,0,31,16,144
Pakistan,2010-04-01,7,0,0,16,2,25
Pakistan,2010-04-01,-1,0,0,0,4,3
Pakistan,2010-04-01,154,0,0,19,12,185
Pakistan,2010-04-01,93,0,1,30,17,141
Sierra Leone,2010-04-01,0,0,0,3,0,3
Sierra Leone,2010-04-01,-1,0,0,0,0,-1
Sierra Leone,2010-04-01,0,0,0,0,0,0
Sierra Leone,2010-04-01,1,0,0,0,0,1
Sierra Leone,2010-04-01,1,0,0,0,0,1
Sierra Leone,2010-04-01,0,0,0,0,0,0
Sierra Leone,2010-04-01,0,0,0,0,0,0
Sierra Leone,2010-04-01,0,0,0,0,0,0
Sierra Leone,2010-04-01,0,0,0,-2,0,-2
Sierra Leone,2010-04-01,1,0,0,0,0,1
Sierra Leone,2010-04-01,-2,0,0,0,0,-2
Sierra Leone,2010-04-01,0,0,0,0,0,0
Sierra Leone,2010-04-01,1,0,0,0,0,1
Sierra Leone,2010-04-01,0,0,0,0,0,0
Sierra Leone,2010-04-01,4,0,0,15,0,19
Sierra Leone,2010-04-01,1,0,0,0,0,1
Sierra Leone,2010-04-01,1,0,0,-4,1,-2
Sierra Leone,2010-04-01,8,0,0,3,1,12
Sierra Leone,2010-04-01,4,0,0,-2,0,2
Sierra Leone,2010-04-01,16,0,0,0,0,16
Sierra Leone,2010-04-01,2,0,0,6,2,10
Sierra Leone,2010-04-01,4,0,0,0,0,4
Sierra Leone,2010-04-01,0,0,0,0,0,0
Sierra Leone,2010-04-01,0,0,0,3,0,3
Sierra Leone,2010-04-01,8,0,0,0,1,9
Somalia,2010-04-01,53,0,0,27,2,82
Somalia,2010-04-01,26,0,0,3,9,38
Somalia,2010-04-01,51,0,-1,20,4,74
Somalia,2010-04-01,12,0,0,17,2,31
Somalia,2010-04-01,15,0,0,2,2,19
Somalia,2010-04-01,45,2,0,8,0,55
Somalia,2010-04-01,38,0,0,14,0,52
Somalia,2010-04-01,9,0,0,9,3,21
Somalia,2010-04-01,2,0,0,-1,0,1
Somalia,2010-04-01,21,0,0,10,1,32
Somalia,2010-04-01,11,0,0,-1,0,10
Somalia,2010-04-01,0,0,0,-4,0,-4
Somalia,2010-04-01,0,0,0,-4,0,-4
Somalia,2010-04-01,4,0,0,10,1,15
Somalia,2010-04-01,7,2,0,9,6,24
Somalia,2010-04-01,5,0,0,-5,0,0
Somalia,2010-04-01,12,0,0,0,0,12
Somalia,2010-04-01,0,0,0,3,0,3
Somalia,2010-04-01,1,0,0,12,1,14
Somalia,2010-04-01,58,0,-1,16,2,75
Somalia,2010-04-01,62,0,0,72,6,140
Somalia,2010-04-01,36,2,0,27,6,71
Somalia,2010-04-01,93,2,0,125,12,232
Somalia,2010-04-01,75,0,-1,63,7,144
Somalia,2010-04-01,22,0,0,3,0,25
Somalia,2010-04-01,28,0,0,25,0,53
Somalia,2010-04-01,22,0,0,25,0,47
Somalia,2010-04-01,41,0,0,7,0,48
Somalia,2010-04-01,29,0,-1,26,0,54
Somalia,2010-04-01,28,0,0,14,0,42
Syria,2010-04-01,11,0,0,-7,2,6
Syria,2010-04-01,0,0,0,-1,0,-1
Syria,2010-04-01,0,0,0,0,0,0
Syria,2010-04-01,6,0,0,3,0,9
Syria,2010-04-01,1,0,0,3,0,4
Syria,2010-04-01,3,0,0,0,4,7
Syria,2010-04-01,7,0,0,0,0,7
Syria,2010-04-01,12,0,0,-6,0,6
Syria,2010-04-01,11,0,0,9,0,20
Syria,2010-04-01,5,0,0,12,0,17
Syria,2010-04-01,0,0,0,0,0,0
Syria,2010-04-01,10,0,0,3,0,13
Syria,2010-04-01,12,0,0,1,0,13
Syria,2010-04-01,17,0,0,6,0,23
Syria,2010-04-01,12,0,2,0,0,14
Syria,2010-04-01,4,0,3,6,0,13
Syria,2010-04-01,6,0,0,0,0,6
Syria,2010-04-01,6,0,0,0,0,6
Syria,2010-04-01,9,0,0,0,2,11
Syria,2010-04-01,12,0,0,6,3,21
Syria,2010-04-01,58,0,0,16,4,78
Syria,2010-04-01,15,0,0,18,1,34
Syria,2010-04-01,33,0,0,9,0,42
Syria,2010-04-01,34,0,0,3,0,37
Syria,2010-04-01,13,0,0,0,0,13
Syria,2010-04-01,33,0,0,-3,0,30
Syria,2010-04-01,6,0,0,0,0,6
Syria,2010-04-01,4,0,0,11,0,15
Syria,2010-04-01,11,0,0,16,1,28
Syria,2010-04-01,23,0,-7,13,4,33
Yemen,2010-04-01,25,0,0,17,17,59
Yemen,2010-04-01,7,0,0,3,1,11
Yemen,2010-04-01,2,0,0,12,0,14
Yemen,2010-04-01,0,0,0,0,0,0
Yemen,2010-04-01,0,0,0,-4,0,-4
Yemen,2010-04-01,2,0,0,-2,4,4
Yemen,2010-04-01,30,0,0,7,0,37
Yemen,2010-04-01,22,0,0,0,0,22
Yemen,2010-04-01,13,0,0,0,0,13
Yemen,2010-04-01,2,0,0,0,4,6
Yemen,2010-04-01,-7,0,0,0,0,-7
Yemen,2010-04-01,3,0,0,9,0,12
Yemen,2010-04-01,0,0,0,0,0,0
Yemen,2010-04-01,3,0,0,5,0,8
Yemen,2010-04-01,10,0,-6,6,3,13
Yemen,2010-04-01,13,0,0,9,0,22
Yemen,2010-04-01,24,0,0,17,0,41
Yemen,2010-04-01,0,0,0,6,0,6
Yemen,2010-04-01,4,0,0,5,0,9
Yemen,2010-04-01,6,0,0,-4,2,4
Yemen,2010-04-01,20,0,0,-2,0,18
Yemen,2010-04-01,18,0,0,6,0,24
Yemen,2010-04-01,2,0,0,-1,0,1
Yemen,2010-04-01,9,0,0,19,2,30
Yemen,2010-04-01,13,0,0,3,2,18
Yemen,2010-04-01,69,0,0,6,4,79
Yemen,2010-04-01,-1,0,0,0,0,-1
Yemen,2010-04-01,15,0,0,0,3,18
Yemen,2010-04-01,20,2,0,19,0,41
Yemen,2010-04-01,0,0,0,6,6,12
Afghanistan,2010-12-01,255,10,3,55,8,331
Afghanistan,2010-12-01,362,0,2,103,23,490
Afghanistan,2010-12-01,326,0,-1,54,25,404
Afghanistan,2010-12-01,241,8,1,56,17,323
Afghanistan,2010-12-01,195,10,0,4,59,268
Afghanistan,2010-12-01,287,6,1,50,74,418
Afghanistan,2010-12-01,213,4,3,43,30,293
Afghanistan,2010-12-01,204,6,0,68,54,332
Afghanistan,2010-12-01,253,2,0,93,17,365
Afghanistan,2010-12-01,295,0,-1,66,37,397
Afghanistan,2010-12-01,240,0,0,83,32,355
Afghanistan,2010-12-01,225,2,-2,26,30,281
Afghanistan,2010-12-01,296,2,-5,16,69,378
Afghanistan,2010-12-01,354,0,1,62,37,454
Afghanistan,2010-12-01,405,0,1,93,71,570
Afghanistan,2010-12-01,390,0,1,65,40,496
Afghanistan,2010-12-01,390,0,0,56,43,489
Afghanistan,2010-12-01,315,0,-1,24,28,366
Afghanistan,2010-12-01,231,0,6,8,27,272
Afghanistan,2010-12-01,354,0,0,52,16,422
Afghanistan,2010-12-01,331,0,6,31,18,386
Afghanistan,2010-12-01,219,0,0,58,15,292
Afghanistan,2010-12-01,205,4,0,36,26,271
Afghanistan,2010-12-01,351,8,-1,48,24,430
Afghanistan,2010-12-01,261,0,2,31,88,382
Afghanistan,2010-12-01,162,8,1,27,34,232
Afghanistan,2010-12-01,302,0,3,113,44,462
Afghanistan,2010-12-01,515,4,-11,187,68,763
Afghanistan,2010-12-01,256,4,0,99,37,396
Afghanistan,2010-12-01,205,0,3,48,16,272
Afghanistan,2010-12-01,180,0,0,34,4,218
Albania,2010-12-01,5,0,0,0,0,5
Albania,2010-12-01,8,2,0,8,1,19
Albania,2010-12-01,22,0,0,9,0,31
Albania,2010-12-01,4,0,0,0,0,4
Albania,2010-12-01,9,0,0,-2,0,7
Albania,2010-12-01,3,0,0,-2,0,1
Albania,2010-12-01,10,0,0,0,0,10
Albania,2010-12-01,10,0,1,-8,7,10
Albania,2010-12-01,2,0,0,-2,1,1
Albania,2010-12-01,7,0,0,4,3,14
Albania,2010-12-01,2,0,-4,0,5,3
Albania,2010-12-01,30,0,-11,6,17,42
Albania,2010-12-01,24,0,-5,-6,5,18
Albania,2010-12-01,12,0,-1,-1,2,12
Albania,2010-12-01,36,0,-2,10,5,49
Albania,2010-12-01,22,0,-1,18,5,44
Albania,2010-12-01,21,0,-2,18,4,41
Albania,2010-12-01,78,0,0,12,0,90
Albania,2010-12-01,11,0,0,5,0,16
Albania,2010-12-01,16,0,0,12,-2,26
Albania,2010-12-01,16,0,3,12,0,31
Albania,2010-12-01,10,0,1,6,0,17
Albania,2010-12-01,3,0,0,-4,2,1
Albania,2010-12-01,0,0,0,3,0,3
Albania,2010-12-01,1,0,0,3,0,4
Albania,2010-12-01,1,0,0,3,4,8
Albania,2010-12-01,3,0,0,0,0,3
Albania,2010-12-01,-3,0,0,0,0,-3
Albania,2010-12-01,9,0,0,6,1,16
Albania,2010-12-01,2,0,0,-4,0,-2
Albania,2010-12-01,2,0,0,6,0,8
Algeria,2010-12-01,1,0,0,3,0,4
Algeria,2010-12-01,-5,0,0,2,0,-3
Algeria,2010-12-01,1,0,0,9,0,10
Algeria,2010-12-01,2,0,0,0,0,2
Algeria,2010-12-01,16,0,0,0,0,16
Algeria,2010-12-01,13,0,0,3,2,18
Algeria,2010-12-01,28,8,2,3,0,41
Algeria,2010-12-01,11,4,1,0,0,16
Algeria,2010-12-01,6,0,0,6,0,12
Algeria,2010-12-01,9,0,0,2,0,11
Algeria,2010-12-01,3,0,0,0,0,3
Algeria,2010-12-01,0,0,-4,0,0,-4
Algeria,2010-12-01,0,0,0,0,0,0
Algeria,2010-12-01,0,0,0,3,0,3
Algeria,2010-12-01,12,0,-1,8,7,26
Algeria,2010-12-01,2,0,0,0,2,4
Algeria,2010-12-01,1,0,-1,3,0,3
Algeria,2010-12-01,0,0,0,0,3,3
Algeria,2010-12-01,-9,0,0,-4,1,-12
Algeria,2010-12-01,3,0,-2,0,0,1
Algeria,2010-12-01,7,0,0,0,9,16
Algeria,2010-12-01,0,0,0,0,0,0
Algeria,2010-12-01,0,0,0,-4,0,-4
Algeria,2010-12-01,3,0,0,-2,0,1
Algeria,2010-12-01,-3,0,0,0,0,-3
Algeria,2010-12-01,-3,0,0,0,0,-3
Algeria,2010-12-01,15,0,0,3,5,23
Algeria,2010-12-01,11,0,0,0,0,11
Algeria,2010-12-01,43,0,0,6,0,49
Algeria,2010-12-01,2,0,0,6,0,8
Algeria,2010-12-01,2,0,0,3,4,9
Bangladesh,2010-12-01,14,0,0,12,0,26
Bangladesh,2010-12-01,29,0,1,11,0,41
Bangladesh,2010-12-01,9,2,0,0,2,13
Bangladesh,2010-12-01,13,0,0,-3,1,11
Bangladesh,2010-12-01,23,0,0,30,1,54
Bangladesh,2010-12-01,22,0,-4,8,0,26
Bangladesh,2010-12-01,38,6,1,13,3,61
Bangladesh,2010-12-01,2,0,-2,4,3,7
Bangladesh,2010-12-01,50,0,0,12,2,64
Bangladesh,2010-12-01,25,0,0,19,2,46
Bangladesh,2010-12-01,9,2,0,13,0,24
Bangladesh,2010-12-01,39,0,0,21,5,65
Bangladesh,2010-12-01,65,0,0,34,25,124
Bangladesh,2010-12-01,55,0,0,19,4,78
Bangladesh,2010-12-01,3,0,0,13,1,17
Bangladesh,2010-12-01,19,2,1,-4,1,19
Bangladesh,2010-12-01,21,0,0,-6,0,15
Bangladesh,2010-12-01,49,4,0,29,2,84
Bangladesh,2010-12-01,29,2,-2,44,2,75
Bangladesh,2010-12-01,33,2,0,42,4,81
Bangladesh,2010-12-01,60,0,0,36,3,99
Bangladesh,2010-12-01,8,0,0,9,5,22
Bangladesh,2010-12-01,11,0,0,48,3,62
Bangladesh,2010-12-01,6,0,0,6,2,14
Bangladesh,2010-12-01,8,0,0,7,2,17
Bangladesh,2010-12-01,27,0,0,7,2,36
Bangladesh,2010-12-01,53,0,1,1,4,59
Bangladesh,2010-12-01,6,0,0,8,0,14
Bangladesh,2010-12-01,28,0,0,2,9,39
Bangladesh,2010-12-01,33,0,0,28,3,64
Bangladesh,2010-12-01,20,0,0,9,2,31
Cameroon,2010-12-01,6,0,0,0,0,6
Cameroon,2010-12-01,0,0,0,0,0,0
Cameroon,2010-12-01,4,0,0,0,1,5
Cameroon,2010-12-01,0,0,0,0,0,0
Cameroon,2010-12-01,9,0,0,0,0,9
Cameroon,2010-12-01,0,0,0,0,0,0
Cameroon,2010-12-01,0,0,0,0,0,0
Cameroon,2010-12-01,0,0,0,12,0,12
Cameroon,2010-12-01,0,0,0,0,1,1
Cameroon,2010-12-01,3,0,0,0,1,4
Cameroon,2010-12-01,9,0,0,0,0,9
Cameroon,2010-12-01,1,0,0,0,0,1
Cameroon,2010-12-01,2,0,0,0,0,2
Cameroon,2010-12-01,0,0,0,9,0,9
Cameroon,2010-12-01,-4,0,0,0,0,-4
Cameroon,2010-12-01,0,0,0,0,0,0
Cameroon,2010-12-01,3,0,0,3,0,6
Cameroon,2010-12-01,1,0,0,0,0,1
Cameroon,2010-12-01,0,0,0,0,0,0
Cameroon,2010-12-01,2,0,0,0,0,2
Cameroon,2010-12-01,2,0,0,0,0,2
Cameroon,2010-12-01,0,0,0,0,0,0
Cameroon,2010-12-01,2,0,0,0,0,2
Cameroon,2010-12-01,1,0,0,0,0,1
Cameroon,2010-12-01,0,0,0,0,0,0
Cameroon,2010-12-01,0,0,0,0,0,0
Cameroon,2010-12-01,6,0,0,-2,0,4
Cameroon,2010-12-01,0,0,0,3,0,3
Cameroon,2010-12-01,21,0,0,0,0,21
Cameroon,2010-12-01,0,0,0,0,0,0
China,2010-12-01,147,8,-4,43,18,212
China,2010-12-01,113,2,2,40,28,185
China,2010-12-01,179,2,3,14,21,219
China,2010-12-01,108,0,0,31,15,154
China,2010-12-01,150,8,-2,33,12,201
China,2010-12-01,153,2,-9,54,17,217
China,2010-12-01,279,8,0,39,31,357
China,2010-12-01,243,4,-7,40,37,317
China,2010-12-01,211,6,0,98,11,326
China,2010-12-01,177,8,4,135,22,346
China,2010-12-01,99,4,3,-3,6,109
China,2010-12-01,123,4,3,45,14,189
China,2010-12-01,172,0,-6,28,24,218
China,2010-12-01,178,0,-6,40,7,219
China,2010-12-01,205,4,-1,78,44,330
China,2010-12-01,95,8,-2,36,26,163
China,2010-12-01,141,8,0,55,10,214
China,2010-12-01,235,0,5,54,22,316
China,2010-12-01,232,0,-6,33,24,283
China,2010-12-01,232,2,-12,134,13,369
China,2010-12-01,144,4,-2,45,9,200
China,2010-12-01,470,8,-5,375,62,910
China,2010-12-01,176,2,-2,68,16,260
China,2010-12-01,105,0,-16,54,11,154
China,2010-12-01,56,6,-2,31,10,101
China,2010-12-01,51,0,2,31,16,100
China,2010-12-01,87,4,-7,34,6,124
China,2010-12-01,137,0,-6,60,9,200
China,2010-12-01,142,0,-5,30,15,182
China,2010-12-01,119,2,1,132,16,270
China,2010-12-01,62,2,-1,37,6,106
Egypt,2010-12-01,39,0,3,31,10,83
Egypt,2010-12-01,53,0,0,27,9,89
Egypt,2010-12-01,81,0,-2,24,4,107
Egypt,2010-12-01,51,0,-1,13,8,71
Egypt,2010-12-01,50,0,2,36,7,95
Egypt,2010-12-01,52,4,0,18,5,79
Egypt,2010-12-01,80,2,0,-2,0,80
Egypt,2010-12-01,94,0,2,39,20,155
Egypt,2010-12-01,34,0,0,21,0,55
Egypt,2010-12-01,28,0,1,7,5,41
Egypt,2010-12-01,23,0,2,26,4,55
Egypt,2010-12-01,29,0,1,3,2,35
Egypt,2010-12-01,16,0,0,7,4,27
Egypt,2010-12-01,49,0,1,9,2,61
Egypt,2010-12-01,54,0,1,15,4,74
Egypt,2010-12-01,18,2,0,6,2,28
Egypt,2010-12-01,19,0,0,22,2,43
Egypt,2010-12-01,22,0,0,12,0,34
Egypt,2010-12-01,20,0,0,0,0,20
Egypt,2010-12-01,54,0,3,54,0,111
Egypt,2010-12-01,17,0,0,18,0,35
Egypt,2010-12-01,84,0,0,6,4,94
Egypt,2010-12-01,30,0,-2,21,9,58
Egypt,2010-12-01,40,0,0,24,5,69
Egypt,2010-12-01,34,0,-5,40,0,69
Egypt,2010-12-01,21,0,-1,18,6,44
Egypt,2010-12-01,44,0,0,6,6,56
Egypt,2010-12-01,54,0,0,15,2,71
Egypt,2010-12-01,23,0,-3,16,0,36
Egypt,2010-12-01,18,0,0,4,5,27
Egypt,2010-12-01,37,0,1,2,2,42
Eritrea,2010-12-01,15,0,0,1,0,16
Eritrea,2010-12-01,1,0,0,0,0,1
Eritrea,2010-12-01,1,0,0,0,0,1
Eritrea,2010-12-01,7,0,0,0,0,7
Eritrea,2010-12-01,1,0,0,9,0,10
Eritrea,2010-12-01,11,0,0,5,0,16
Eritrea,2010-12-01,25,0,0,46,3,74
Eritrea,2010-12-01,5,0,0,30,0,35
Eritrea,2010-12-01,11,0,0,25,1,37
Eritrea,2010-12-01,5,0,0,22,0,27
Eritrea,2010-12-01,11,0,0,3,0,14
Eritrea,2010-12-01,3,0,0,13,0,16
Eritrea,2010-12-01,6,0,0,3,1,10
Eritrea,2010-12-01,9,0,0,3,4,16
Eritrea,2010-12-01,2,0,0,1,4,7
Eritrea,2010-12-01,0,0,0,-2,0,-2
Eritrea,2010-12-01,0,0,0,9,0,9
Eritrea,2010-12-01,0,0,0,0,0,0
Eritrea,2010-12-01,1,0,0,0,0,1
Eritrea,2010-12-01,1,0,0,0,0,1
Eritrea,2010-12-01,0,0,0,0,3,3
Eritrea,2010-12-01,0,0,0,0,1,1
Eritrea,2010-12-01,2,0,0,0,0,2
Eritrea,2010-12-01,0,0,0,0,0,0
Eritrea,2010-12-01,2,0,0,6,0,8
Eritrea,2010-12-01,1,0,0,6,0,7
Eritrea,2010-12-01,11,0,0,9,0,20
Eritrea,2010-12-01,3,0,0,0,0,3
Eritrea,2010-12-01,2,0,0,0,0,2
Georgia,2010-12-01,28,0,0,37,6,71
Georgia,2010-12-01,45,0,-3,21,2,65
Georgia,2010-12-01,-3,0,0,0,0,-3
Georgia,2010-12-01,2,0,0,21,6,29
Georgia,2010-12-01,16,0,0,7,1,24
Georgia,2010-12-01,52,0,0,7,11,70
Georgia,2010-12-01,62,0,-2,25,7,92
Georgia,2010-12-01,52,4,0,30,5,91
Georgia,2010-12-01,36,4,0,26,9,75
Georgia,2010-12-01,34,0,0,35,3,72
Georgia,2010-12-01,27,0,0,13,4,44
Georgia,2010-12-01,21,2,0,-4,3,22
Georgia,2010-12-01,87,0,0,19,6,112
Georgia,2010-12-01,28,0,0,25,10,63
Georgia,2010-12-01,22,2,0,21,8,53
Georgia,2010-12-01,28,0,0,3,3,34
Georgia,2010-12-01,28,0,0,7,0,35
Georgia,2010-12-01,11,0,0,12,0,23
Georgia,2010-12-01,15,0,0,7,0,22
Georgia,2010-12-01,54,0,0,8,1,63
Georgia,2010-12-01,29,2,0,0,4,35
Georgia,2010-12-01,22,2,1,2,0,27
Georgia,2010-12-01,33,0,-4,13,1,43
Georgia,2010-12-01,11,0,0,-2,3,12
Georgia,2010-12-01,8,0,0,3,1,12
Georgia,2010-12-01,4,0,0,10,2,16
Georgia,2010-12-01,24,0,0,21,5,50
Georgia,2010-12-01,59,0,0,25,0,84
Georgia,2010-12-01,56,2,0,28,1,87
Georgia,2010-12-01,29,0,0,7,1,37
Georgia,2010-12-01,36,0,-2,28,15,77
India,2010-12-01,71,6,-5,23,10,105
India,2010-12-01,75,2,3,1,5,86
India,2010-12-01,84,2,2,-3,3,88
India,2010-12-01,48,0,0,-2,9,55
India,2010-12-01,58,2,-2,13,9,80
India,2010-12-01,90,4,-8,12,11,109
India,2010-12-01,59,4,1,6,21,91
India,2010-12-01,23,2,0,-4,4,25
India,2010-12-01,56,4,1,33,18,112
India,2010-12-01,73,4,-4,16,21,110
India,2010-12-01,72,2,1,16,2,93
India,2010-12-01,51,2,-1,20,8,80
India,2010-12-01,92,0,2,-3,10,101
India,2010-12-01,82,0,-7,1,7,83
India,2010-12-01,62,0,0,8,24,94
India,2010-12-01,60,2,-3,12,8,79
India,2010-12-01,57,4,1,57,2,121
India,2010-12-01,22,0,0,0,2,24
India,2010-12-01,42,0,-3,-3,5,41
India,2010-12-01,46,2,-3,22,14,81
India,2010-12-01,40,2,0,16,5,63
India,2010-12-01,76,2,-2,3,6,85
India,2010-12-01,65,0,-2,34,10,107
India,2010-12-01,67,2,0,40,5,114
India,2010-12-01,23,0,0,41,6,70
India,2010-12-01,46,0,-2,0,9,53
India,2010-12-01,71,4,-1,48,7,129
India,2010-12-01,42,0,-1,32,2,75
India,2010-12-01,57,0,-1,-8,5,53
India,2010-12-01,216,2,-5,214,33,460
India,2010-12-01,151,8,-6,127,21,301
Iran,2010-12-01,96,0,3,63,10,172
Iran,2010-12-01,65,2,-1,15,14,95
Iran,2010-12-01,137,2,2,6,15,162
Iran,2010-12-01,179,0,2,12,75,268
Iran,2010-12-01,75,0,0,10,34,119
Iran,2010-12-01,65,2,0,26,10,103
Iran,2010-12-01,118,0,2,49,20,189
Iran,2010-12-01,126,0,1,18,25,170
Iran,2010-12-01,105,0,1,40,5,151
Iran,2010-12-01,105,0,1,79,2,187
Iran,2010-12-01,58,0,11,53,7,129
Iran,2010-12-01,42,0,3,28,3,76
Iran,2010-12-01,77,0,-5,73,16,161
Iran,2010-12-01,76,0,1,30,14,121
Iran,2010-12-01,180,0,-2,76,32,286
Iran,2010-12-01,107,0,-1,53,20,179
Iran,2010-12-01,80,0,0,58,7,145
Iran,2010-12-01,45,0,0,27,12,84
Iran,2010-12-01,31,0,0,9,5,45
Iran,2010-12-01,114,0,-1,147,14,274
Iran,2010-12-01,74,0,0,113,10,197
Iran,2010-12-01,54,0,0,84,4,142
Iran,2010-12-01,72,0,0,45,3,120
Iran,2010-12-01,55,0,0,20,6,81
Iran,2010-12-01,34,0,-2,80,13,125
Iran,2010-12-01,49,0,0,55,8,112
Iran,2010-12-01,21,4,2,47,4,78
Iran,2010-12-01,48,0,2,69,4,123
Iran,2010-12-01,71,0,3,66,8,148
Iran,2010-12-01,112,0,3,71,6,192
Iran,2010-12-01,15,0,2,64,5,86
Iraq,2010-12-01,149,2,2,93,11,257
Iraq,2010-12-01,90,0,1,68,10,169
Iraq,2010-12-01,120,2,0,28,14,164
Iraq,2010-12-01,80,0,0,22,14,116
Iraq,2010-12-01,98,4,0,36,12,150
Iraq,2010-12-01,115,0,1,40,61,217
Iraq,2010-12-01,127,2,1,45,9,184
Iraq,2010-12-01,125,0,1,78,21,225
Iraq,2010-12-01,170,2,2,104,30,308
Iraq,2010-12-01,154,0,-2,86,31,269
Iraq,2010-12-01,67,0,3,39,5,114
Iraq,2010-12-01,48,0,-2,6,26,78
Iraq,2010-12-01,139,0,2,66,32,239
Iraq,2010-12-01,154,2,3,59,18,236
Iraq,2010-12-01,191,0,7,57,38,293
Iraq,2010-12-01,148,0,3,100,26,277
Iraq,2010-12-01,126,6,1,65,31,229
Iraq,2010-12-01,97,0,1,31,9,138
Iraq,2010-12-01,52,0,0,22,3,77
Iraq,2010-12-01,115,0,0,29,12,156
Iraq,2010-12-01,145,0,0,65,15,225
Iraq,2010-12-01,116,0,0,42,2,160
Iraq,2010-12-01,132,4,2,61,12,211
Iraq,2010-12-01,72,0,0,30,7,109
Iraq,2010-12-01,56,0,0,4,3,63
Iraq,2010-12-01,57,0,0,15,2,74
Iraq,2010-12-01,92,0,0,13,8,113
Iraq,2010-12-01,75,0,0,16,7,98
Iraq,2010-12-01,118,0,1,78,53,250
Iraq,2010-12-01,107,0,7,46,14,174
Iraq,2010-12-01,86,0,0,39,7,132
Morocco,2010-12-01,11,0,0,12,2,25
Morocco,2010-12-01,45,0,0,10,2,57
Morocco,2010-12-01,26,0,0,4,0,30
Morocco,2010-12-01,19,0,0,0,2,21
Morocco,2010-12-01,15,0,0,27,8,50
Morocco,2010-12-01,41,0,0,13,6,60
Morocco,2010-12-01,18,0,0,6,0,24
Morocco,2010-12-01,10,0,0,3,0,13
Morocco,2010-12-01,6,0,0,3,4,13
Morocco,2010-12-01,24,0,0,4,0,28
Morocco,2010-12-01,32,0,1,3,1,37
Morocco,2010-12-01,9,0,0,3,0,12
Morocco,2010-12-01,8,0,0,3,1,12
Morocco,2010-12-01,12,0,0,4,0,16
Morocco,2010-12-01,6,0,0,3,0,9
Morocco,2010-12-01,0,0,0,1,2,3
Morocco,2010-12-01,10,0,0,6,1,17
Morocco,2010-12-01,-5,0,0,0,0,-5
Morocco,2010-12-01,28,0,-2,-2,0,24
Morocco,2010-12-01,13,0,0,-2,0,11
Morocco,2010-12-01,1,0,-1,3,0,3
Morocco,2010-12-01,0,0,0,0,0,0
Morocco,2010-12-01,8,0,0,3,0,11
Morocco,2010-12-01,0,0,0,0,0,0
Morocco,2010-12-01,0,0,-2,0,0,-2
Morocco,2010-12-01,0,0,0,6,0,6
Morocco,2010-12-01,2,0,0,12,4,18
Morocco,2010-12-01,-1,0,0,0,0,-1
Morocco,2010-12-01,-1,0,0,0,0,-1
Morocco,2010-12-01,3,0,0,0,2,5
Morocco,2010-12-01,1,0,0,0,0,1
Nigeria,2010-12-01,56,0,0,36,2,94
Nigeria,2010-12-01,42,0,0,36,1,79
Nigeria,2010-12-01,61,0,0,22,1,84
Nigeria,2010-12-01,40,0,0,3,2,45
Nigeria,2010-12-01,26,0,0,8,6,40
Nigeria,2010-12-01,39,0,-3,74,1,111
Nigeria,2010-12-01,48,0,-1,40,15,102
Nigeria,2010-12-01,87,0,0,28,4,119
Nigeria,2010-12-01,44,0,5,37,2,88
Nigeria,2010-12-01,48,2,2,26,4,82
Nigeria,2010-12-01,31,0,0,10,0,41
Nigeria,2010-12-01,11,0,0,3,4,18
Nigeria,2010-12-01,24,0,2,32,0,58
Nigeria,2010-12-01,10,0,-4,7,4,17
Nigeria,2010-12-01,44,0,-8,42,2,80
Nigeria,2010-12-01,42,0,-4,46,9,93
Nigeria,2010-12-01,19,0,-4,30,7,52
Nigeria,2010-12-01,-3,0,0,2,0,-1
Nigeria,2010-12-01,6,0,0,14,0,20
Nigeria,2010-12-01,6,0,-8,18,5,21
Nigeria,2010-12-01,37,0,0,5,-2,40
Nigeria,2010-12-01,23,0,0,10,3,36
Nigeria,2010-12-01,46,0,0,22,3,71
Nigeria,2010-12-01,29,0,-2,-3,8,32
Nigeria,2010-12-01,113,0,-2,23,34,168
Nigeria,2010-12-01,120,2,-1,13,29,163
Nigeria,2010-12-01,111,0,-1,36,38,184
Nigeria,2010-12-01,40,0,-3,28,4,69
Nigeria,2010-12-01,30,0,-2,31,8,67
Nigeria,2010-12-01,25,0,-10,0,2,17
Nigeria,2010-12-01,28,0,-6,6,4,32
Pakistan,2010-12-01,185,2,5,85,18,295
Pakistan,2010-12-01,172,4,2,74,10,262
Pakistan,2010-12-01,203,2,-1,-8,10,206
Pakistan,2010-12-01,189,2,0,7,13,211
Pakistan,2010-12-01,117,2,0,6,9,134
Pakistan,2010-12-01,138,0,4,-7,57,192
Pakistan,2010-12-01,171,8,-1,96,36,310
Pakistan,2010-12-01,164,4,-6,36,43,241
Pakistan,2010-12-01,86,4,0,15,6,111
Pakistan,2010-12-01,140,0,0,43,11,194
Pakistan,2010-12-01,79,0,0,8,4,91
Pakistan,2010-12-01,85,0,0,19,4,108
Pakistan,2010-12-01,91,0,-7,22,7,113
Pakistan,2010-12-01,123,0,-12,24,16,151
Pakistan,2010-12-01,233,0,-1,40,40,312
Pakistan,2010-12-01,320,2,0,113,40,475
Pakistan,2010-12-01,155,2,-1,72,8,236
Pakistan,2010-12-01,176,4,0,24,11,215
Pakistan,2010-12-01,72,4,0,30,4,110
Pakistan,2010-12-01,131,4,0,63,19,217
Pakistan,2010-12-01,300,2,-3,11,6,316
Pakistan,2010-12-01,133,4,-8,23,9,161
Pakistan,2010-12-01,108,6,-4,68,30,208
Pakistan,2010-12-01,162,4,-10,109,25,290
Pakistan,2010-12-01,335,0,0,95,131,561
Pakistan,2010-12-01,96,0,1,58,17,172
Pakistan,2010-12-01,169,4,-3,55,12,237
Pakistan,2010-12-01,125,0,-13,35,23,170
Pakistan,2010-12-01,128,2,-1,34,6,169
Pakistan,2010-12-01,157,0,-3,113,32,299
Pakistan,2010-12-01,124,0,-4,59,12,191
Sierra Leone,2010-12-01,5,2,0,3,0,10
Sierra Leone,2010-12-01,6,0,0,0,0,6
Sierra Leone,2010-12-01,2,2,0,0,2,6
Sierra Leone,2010-12-01,4,0,0,0,0,4
Sierra Leone,2010-12-01,0,0,0,0,0,0
Sierra Leone,2010-12-01,10,0,0,-2,1,9
Sierra Leone,2010-12-01,2,0,0,-4,0,-2
Sierra Leone,2010-12-01,5,6,0,6,1,18
Sierra Leone,2010-12-01,11,0,0,0,0,11
Sierra Leone,2010-12-01,13,0,0,2,0,15
Sierra Leone,2010-12-01,0,0,0,0,0,0
Sierra Leone,2010-12-01,0,0,0,0,0,0
Sierra Leone,2010-12-01,4,0,0,-6,0,-2
Sierra Leone,2010-12-01,7,0,0,-8,0,-1
Sierra Leone,2010-12-01,2,0,0,13,2,17
Sierra Leone,2010-12-01,5,0,0,0,1,6
Sierra Leone,2010-12-01,4,0,0,8,0,12
Sierra Leone,2010-12-01,2,0,1,10,0,13
Sierra Leone,2010-12-01,0,0,0,4,0,4
Sierra Leone,2010-12-01,0,0,0,0,2,2
Sierra Leone,2010-12-01,6,2,0,3,0,11
Sierra Leone,2010-12-01,5,0,0,11,0,16
Sierra Leone,2010-12-01,2,0,0,-4,0,-2
Sierra Leone,2010-12-01,0,0,-6,0,0,-6
Sierra Leone,2010-12-01,10,0,-4,0,0,6
Sierra Leone,2010-12-01,6,0,-8,12,0,10
Sierra Leone,2010-12-01,10,0,-14,6,0,2
Sierra Leone,2010-12-01,25,0,-22,0,1,4
Sierra Leone,2010-12-01,1,0,-34,-2,3,-32
Sierra Leone,2010-12-01,-2,0,-4,0,0,-6
Sierra Leone,2010-12-01,8,0,0,0,0,8
Somalia,2010-12-01,53,0,0,-5,2,50
Somalia,2010-12-01,43,0,1,-3,5,46
Somalia,2010-12-01,53,0,0,37,2,92
Somalia,2010-12-01,18,0,0,33,0,51
Somalia,2010-12-01,19,0,0,81,2,102
Somalia,2010-12-01,39,2,3,108,2,154
Somalia,2010-12-01,29,4,1,49,2,85
Somalia,2010-12-01,59,0,1,64,2,126
Somalia,2010-12-01,48,0,0,75,5,128
Somalia,2010-12-01,69,0,0,51,4,124
Somalia,2010-12-01,25,0,0,33,4,62
Somalia,2010-12-01,82,0,0,47,10,139
Somalia,2010-12-01,28,2,0,39,2,71
Somalia,2010-12-01,74,0,0,42,8,124
Somalia,2010-12-01,55,2,0,17,7,81
Somalia,2010-12-01,35,2,0,7,3,47
Somalia,2010-12-01,30,6,-2,87,0,121
Somalia,2010-12-01,17,4,0,4,0,25
Somalia,2010-12-01,2,2,-2,0,0,2
Somalia,2010-12-01,21,0,0,15,4,40
Somalia,2010-12-01,34,4,0,19,14,71
Somalia,2010-12-01,36,4,0,18,1,59
Somalia,2010-12-01,30,0,0,47,4,81
Somalia,2010-12-01,22,0,0,20,1,43
Somalia,2010-12-01,71,0,-12,75,0,134
Somalia,2010-12-01,59,0,-11,71,15,134
Somalia,2010-12-01,112,0,0,39,6,157
Somalia,2010-12-01,117,0,-1,83,4,203
Somalia,2010-12-01,39,0,0,48,10,97
Somalia,2010-12-01,16,0,0,2,8,26
Somalia,2010-12-01,67,2,1,67,3,140
Syria,2010-12-01,36,0,0,3,0,39
Syria,2010-12-01,35,0,1,-10,3,29
Syria,2010-12-01,23,0,1,-3,0,21
Syria,2010-12-01,16,0,1,0,0,17
Syria,2010-12-01,7,0,0,12,0,19
Syria,2010-12-01,11,0,-3,8,0,16
Syria,2010-12-01,1,4,0,11,5,21
Syria,2010-12-01,5,0,0,12,0,17
Syria,2010-12-01,19,0,0,4,1,24
Syria,2010-12-01,16,4,-1,15,0,34
Syria,2010-12-01,4,0,2,-2,1,5
Syria,2010-12-01,-1,0,3,0,0,2
Syria,2010-12-01,16,0,0,9,0,25
Syria,2010-12-01,16,0,0,3,2,21
Syria,2010-12-01,5,0,0,9,1,15
Syria,2010-12-01,9,0,1,0,0,10
Syria,2010-12-01,23,0,0,4,3,30
Syria,2010-12-01,36,0,-1,3,2,40
Syria,2010-12-01,-14,0,-2,-10,0,-26
Syria,2010-12-01,27,0,0,10,2,39
Syria,2010-12-01,-5,0,-2,7,4,4
Syria,2010-12-01,19,0,0,15,8,42
Syria,2010-12-01,13,0,0,0,1,14
Syria,2010-12-01,13,0,0,1,1,15
Syria,2010-12-01,8,0,1,12,0,21
Syria,2010-12-01,-3,0,0,2,0,-1
Syria,2010-12-01,15,0,0,-3,3,15
Syria,2010-12-01,6,0,-3,13,0,16
Syria,2010-12-01,41,0,-2,24,0,63
Syria,2010-12-01,25,0,0,9,0,34
Syria,2010-12-01,-1,0,0,9,0,8
Yemen,2010-12-01,54,0,0,1,12,67
Yemen,2010-12-01,83,2,1,5,3,94
Yemen,2010-12-01,39,0,0,17,1,57
Yemen,2010-12-01,51,0,0,3,6,60
Yemen,2010-12-01,12,0,0,9,0,21
Yemen,2010-12-01,16,0,0,15,0,31
Yemen,2010-12-01,37,0,0,-8,4,33
Yemen,2010-12-01,62,0,0,7,1,70
Yemen,2010-12-01,39,0,0,0,0,39
Yemen,2010-12-01,19,0,0,-8,0,11
Yemen,2010-12-01,-1,0,0,7,0,6
Yemen,2010-12-01,17,0,-4,0,2,15
Yemen,2010-12-01,10,0,0,-4,15,21
Yemen,2010-12-01,17,0,0,0,0,17
Yemen,2010-12-01,16,0,1,11,3,31
Yemen,2010-12-01,10,0,0,13,0,23
Yemen,2010-12-01,15,0,0,9,8,32
Yemen,2010-12-01,4,0,0,-2,0,2
Yemen,2010-12-01,11,2,0,4,0,17
Yemen,2010-12-01,9,0,1,15,5,30
Yemen,2010-12-01,4,0,0,7,3,14
Yemen,2010-12-01,29,0,-2,59,1,87
Yemen,2010-12-01,15,0,0,19,4,38
Yemen,2010-12-01,13,0,0,9,0,22
Yemen,2010-12-01,8,0,0,0,0,8
Yemen,2010-12-01,14,0,-4,0,12,22
Yemen,2010-12-01,14,0,-3,-2,8,17
Yemen,2010-12-01,8,0,1,15,0,24
Yemen,2010-12-01,10,0,-2,5,0,13
Yemen,2010-12-01,9,0,0,-5,2,6
Yemen,2010-12-01,8,0,-6,-6,0,-4
Afghanistan,2010-06-01,221,2,-4,15,4,238
Afghanistan,2010-06-01,24,0,0,6,5,35
Afghanistan,2010-06-01,36,0,0,-1,6,41
Afghanistan,2010-06-01,66,0,0,7,11,84
Afghanistan,2010-06-01,54,0,0,23,8,85
Afghanistan,2010-06-01,184,0,1,32,14,231
Afghanistan,2010-06-01,121,0,0,7,20,148
Afghanistan,2010-06-01,306,0,-6,12,37,349
Afghanistan,2010-06-01,96,0,-2,3,6,103
Afghanistan,2010-06-01,200,2,-8,20,25,239
Afghanistan,2010-06-01,134,0,0,24,13,171
Afghanistan,2010-06-01,101,0,0,10,15,126
Afghanistan,2010-06-01,32,4,-1,0,1,36
Afghanistan,2010-06-01,78,2,0,2,4,86
Afghanistan,2010-06-01,143,2,0,37,13,195
Afghanistan,2010-06-01,106,0,0,23,3,132
Afghanistan,2010-06-01,114,6,2,-6,4,120
Afghanistan,2010-06-01,34,0,0,-5,1,30
Afghanistan,2010-06-01,186,2,-2,11,10,207
Afghanistan,2010-06-01,86,4,0,19,4,113
Afghanistan,2010-06-01,82,0,-4,8,5,91
Afghanistan,2010-06-01,165,0,3,62,11,241
Afghanistan,2010-06-01,244,0,0,12,11,267
Afghanistan,2010-06-01,110,0,-3,16,0,123
Afghanistan,2010-06-01,62,2,3,48,4,119
Afghanistan,2010-06-01,51,0,0,0,6,57
Afghanistan,2010-06-01,61,0,0,1,0,62
Afghanistan,2010-06-01,46,0,0,3,7,56
Afghanistan,2010-06-01,388,2,-11,31,26,436
Afghanistan,2010-06-01,152,0,-4,11,9,168
Albania,2010-06-01,5,0,0,0,0,5
Albania,2010-06-01,9,0,0,6,0,15
Albania,2010-06-01,2,0,0,10,0,12
Albania,2010-06-01,0,0,0,0,2,2
Albania,2010-06-01,2,0,0,0,0,2
Albania,2010-06-01,4,0,0,0,0,4
Albania,2010-06-01,0,0,0,0,0,0
Albania,2010-06-01,4,0,-1,0,0,3
Albania,2010-06-01,4,0,0,0,0,4
Albania,2010-06-01,8,0,0,0,0,8
Albania,2010-06-01,0,0,0,3,0,3
Albania,2010-06-01,0,0,0,0,1,1
Albania,2010-06-01,1,0,0,0,0,1
Albania,2010-06-01,6,0,2,3,0,11
Albania,2010-06-01,-1,0,0,0,0,-1
Albania,2010-06-01,3,0,0,0,0,3
Albania,2010-06-01,0,0,0,0,0,0
Albania,2010-06-01,2,0,0,0,0,2
Albania,2010-06-01,2,0,0,0,0,2
Albania,2010-06-01,0,0,0,0,4,4
Albania,2010-06-01,3,0,0,3,0,6
Albania,2010-06-01,-3,0,0,15,0,12
Albania,2010-06-01,0,0,0,9,0,9
Albania,2010-06-01,0,0,0,0,0,0
Albania,2010-06-01,0,0,0,0,0,0
Albania,2010-06-01,0,0,0,0,0,0
Albania,2010-06-01,0,0,0,0,0,0
Albania,2010-06-01,0,0,0,0,1,1
Albania,2010-06-01,0,0,0,0,0,0
Algeria,2010-06-01,8,0,0,3,0,11
Algeria,2010-06-01,6,0,0,30,2,38
Algeria,2010-06-01,0,0,0,6,0,6
Algeria,2010-06-01,0,0,0,3,0,3
Algeria,2010-06-01,15,0,0,3,1,19
Algeria,2010-06-01,0,0,0,0,1,1
Algeria,2010-06-01,0,0,0,0,0,0
Algeria,2010-06-01,0,0,0,6,0,6
Algeria,2010-06-01,18,0,0,0,0,18
Algeria,2010-06-01,2,0,0,0,0,2
Algeria,2010-06-01,0,0,0,0,0,0
Algeria,2010-06-01,6,0,0,0,0,6
Algeria,2010-06-01,0,0,0,0,0,0
Algeria,2010-06-01,10,0,0,3,0,13
Algeria,2010-06-01,31,0,0,0,0,31
Algeria,2010-06-01,0,0,0,15,0,15
Algeria,2010-06-01,0,0,0,3,0,3
Algeria,2010-06-01,4,0,0,0,0,4
Algeria,2010-06-01,2,0,0,3,0,5
Algeria,2010-06-01,0,0,0,0,0,0
Algeria,2010-06-01,6,0,0,0,0,6
Algeria,2010-06-01,0,0,0,0,0,0
Algeria,2010-06-01,0,0,0,1,0,1
Algeria,2010-06-01,9,0,1,0,0,10
Bangladesh,2010-06-01,1,0,0,21,0,22
Bangladesh,2010-06-01,0,0,0,4,0,4
Bangladesh,2010-06-01,2,0,0,15,0,17
Bangladesh,2010-06-01,21,0,0,9,0,30
Bangladesh,2010-06-01,0,0,0,0,0,0
Bangladesh,2010-06-01,-4,0,0,58,2,56
Bangladesh,2010-06-01,8,0,0,9,1,18
Bangladesh,2010-06-01,3,0,0,12,1,16
Bangladesh,2010-06-01,6,0,0,-3,0,3
Bangladesh,2010-06-01,5,0,-2,0,1,4
Bangladesh,2010-06-01,6,0,0,0,0,6
Bangladesh,2010-06-01,4,0,0,3,0,7
Bangladesh,2010-06-01,0,0,0,0,0,0
Bangladesh,2010-06-01,0,0,0,3,2,5
Bangladesh,2010-06-01,4,0,0,-8,0,-4
Bangladesh,2010-06-01,4,0,0,3,1,8
Bangladesh,2010-06-01,4,0,0,6,0,10
Bangladesh,2010-06-01,4,0,0,6,0,10
Bangladesh,2010-06-01,32,0,0,6,2,40
Bangladesh,2010-06-01,7,0,0,-1,0,6
Bangladesh,2010-06-01,-1,0,0,0,0,-1
Bangladesh,2010-06-01,14,0,0,15,9,38
Bangladesh,2010-06-01,2,0,0,6,0,8
Bangladesh,2010-06-01,0,0,0,0,0,0
Bangladesh,2010-06-01,4,0,0,7,2,13
Bangladesh,2010-06-01,0,0,0,3,0,3
Bangladesh,2010-06-01,0,0,0,0,0,0
Bangladesh,2010-06-01,0,0,0,0,0,0
Bangladesh,2010-06-01,11,0,0,9,1,21
Bangladesh,2010-06-01,3,0,-1,0,4,6
Cameroon,2010-06-01,0,0,0,0,0,0
Cameroon,2010-06-01,0,0,0,0,0,0
Cameroon,2010-06-01,0,0,0,0,0,0
Cameroon,2010-06-01,0,0,0,3,0,3
Cameroon,2010-06-01,8,0,0,0,0,8
Cameroon,2010-06-01,9,0,0,0,0,9
Cameroon,2010-06-01,7,0,0,3,0,10
Cameroon,2010-06-01,3,0,1,-18,0,-14
Cameroon,2010-06-01,0,0,0,0,0,0
Cameroon,2010-06-01,0,0,0,0,0,0
Cameroon,2010-06-01,0,0,0,0,0,0
Cameroon,2010-06-01,8,0,0,0,1,9
Cameroon,2010-06-01,0,0,0,0,0,0
China,2010-06-01,62,0,-6,52,4,112
China,2010-06-01,18,0,0,3,2,23
China,2010-06-01,13,0,-2,9,2,22
China,2010-06-01,73,8,-4,9,14,100
China,2010-06-01,40,0,0,-12,2,30
China,2010-06-01,55,0,0,3,5,63
China,2010-06-01,17,0,0,9,1,27
China,2010-06-01,86,6,-5,16,16,119
China,2010-06-01,34,0,0,13,4,51
China,2010-06-01,60,0,0,4,11,75
China,2010-06-01,42,0,-2,9,14,63
China,2010-06-01,24,0,0,4,0,28
China,2010-06-01,21,0,0,10,0,31
China,2010-06-01,22,0,1,8,10,41
China,2010-06-01,61,0,0,3,5,69
China,2010-06-01,36,0,0,3,2,41
China,2010-06-01,42,0,-4,32,12,82
China,2010-06-01,28,0,-6,12,1,35
China,2010-06-01,51,0,-2,19,7,75
China,2010-06-01,32,0,-7,-3,15,37
China,2010-06-01,49,0,-1,-3,6,51
China,2010-06-01,68,0,-3,20,2,87
China,2010-06-01,62,0,-7,28,8,91
China,2010-06-01,23,0,1,6,6,36
China,2010-06-01,57,2,-2,8,2,67
China,2010-06-01,14,0,0,3,2,19
China,2010-06-01,5,0,-2,1,3,7
China,2010-06-01,18,0,-2,3,2,21
China,2010-06-01,163,0,-3,137,42,339
China,2010-06-01,48,0,1,-7,3,45
Egypt,2010-06-01,97,0,-2,9,0,104
Egypt,2010-06-01,57,0,0,3,1,61
Egypt,2010-06-01,15,0,0,6,0,21
Egypt,2010-06-01,41,0,0,4,1,46
Egypt,2010-06-01,7,0,0,0,0,7
Egypt,2010-06-01,32,0,3,-1,2,36
Egypt,2010-06-01,23,0,0,18,2,43
Egypt,2010-06-01,16,0,0,17,3,36
Egypt,2010-06-01,24,0,0,10,1,35
Egypt,2010-06-01,29,0,0,0,0,29
Egypt,2010-06-01,25,0,0,3,4,32
Egypt,2010-06-01,11,0,0,3,1,15
Egypt,2010-06-01,2,0,0,3,0,5
Egypt,2010-06-01,15,0,0,4,0,19
Egypt,2010-06-01,6,0,-1,10,6,21
Egypt,2010-06-01,86,0,0,8,1,95
Egypt,2010-06-01,37,0,0,3,0,40
Egypt,2010-06-01,0,0,0,0,2,2
Egypt,2010-06-01,20,0,0,8,4,32
Egypt,2010-06-01,22,0,0,6,0,28
Egypt,2010-06-01,24,0,0,-5,4,23
Egypt,2010-06-01,6,0,0,6,4,16
Egypt,2010-06-01,17,0,0,9,4,30
Egypt,2010-06-01,11,0,0,0,1,12
Egypt,2010-06-01,14,0,0,7,0,21
Egypt,2010-06-01,6,0,0,0,2,8
Egypt,2010-06-01,4,0,0,-4,1,1
Egypt,2010-06-01,0,0,1,-4,0,-3
Egypt,2010-06-01,97,0,0,45,0,142
Egypt,2010-06-01,-3,0,0,4,0,1
Eritrea,2010-06-01,2,0,0,0,0,2
Eritrea,2010-06-01,-6,0,0,0,0,-6
Eritrea,2010-06-01,-6,0,0,0,0,-6
Eritrea,2010-06-01,2,0,0,0,0,2
Eritrea,2010-06-01,0,0,0,0,0,0
Eritrea,2010-06-01,1,0,0,0,0,1
Eritrea,2010-06-01,3,0,0,0,0,3
Eritrea,2010-06-01,0,2,0,6,0,8
Eritrea,2010-06-01,0,0,0,3,0,3
Eritrea,2010-06-01,0,0,0,0,0,0
Eritrea,2010-06-01,2,0,0,0,0,2
Eritrea,2010-06-01,4,0,0,0,0,4
Eritrea,2010-06-01,0,0,0,0,0,0
Eritrea,2010-06-01,0,0,0,0,0,0
Eritrea,2010-06-01,0,0,0,12,0,12
Eritrea,2010-06-01,0,0,0,0,0,0
Eritrea,2010-06-01,0,0,0,0,0,0
Eritrea,2010-06-01,0,0,0,5,0,5
Eritrea,2010-06-01,9,0,0,0,0,9
Eritrea,2010-06-01,0,0,0,0,0,0
Eritrea,2010-06-01,-1,0,0,12,0,11
Eritrea,2010-06-01,0,0,0,6,0,6
Eritrea,2010-06-01,-3,0,0,0,0,-3
Eritrea,2010-06-01,0,0,0,0,0,0
Eritrea,2010-06-01,44,0,0,3,0,47
Eritrea,2010-06-01,0,0,0,0,2,2
Georgia,2010-06-01,1,0,0,9,0,10
Georgia,2010-06-01,6,0,0,0,1,7
Georgia,2010-06-01,0,0,0,0,0,0
Georgia,2010-06-01,0,0,0,-2,0,-2
Georgia,2010-06-01,4,0,0,0,1,5
Georgia,2010-06-01,3,0,0,1,0,4
Georgia,2010-06-01,0,0,0,3,0,3
Georgia,2010-06-01,37,0,-2,0,3,38
Georgia,2010-06-01,8,0,0,3,0,11
Georgia,2010-06-01,9,0,0,6,0,15
Georgia,2010-06-01,2,2,0,7,3,14
Georgia,2010-06-01,3,0,0,0,0,3
Georgia,2010-06-01,0,0,0,0,1,1
Georgia,2010-06-01,2,0,0,3,0,5
Georgia,2010-06-01,0,0,0,3,0,3
Georgia,2010-06-01,0,0,0,0,0,0
Georgia,2010-06-01,17,0,0,18,0,35
Georgia,2010-06-01,3,2,0,0,1,6
Georgia,2010-06-01,12,0,0,1,1,14
Georgia,2010-06-01,17,0,0,1,1,19
Georgia,2010-06-01,3,0,0,-2,1,2
Georgia,2010-06-01,8,0,3,4,1,16
Georgia,2010-06-01,19,0,0,0,0,19
Georgia,2010-06-01,0,0,0,0,0,0
Georgia,2010-06-01,9,0,0,3,0,12
Georgia,2010-06-01,5,0,0,-1,0,4
Georgia,2010-06-01,0,0,0,0,0,0
Georgia,2010-06-01,1,0,0,3,0,4
Georgia,2010-06-01,54,0,0,-2,3,55
Georgia,2010-06-01,10,0,0,2,2,14
India,2010-06-01,18,0,-2,17,2,35
India,2010-06-01,10,0,0,1,1,12
India,2010-06-01,1,0,0,0,1,2
India,2010-06-01,49,0,1,9,4,63
India,2010-06-01,7,0,0,3,0,10
India,2010-06-01,20,0,0,3,2,25
India,2010-06-01,23,0,0,-6,0,17
India,2010-06-01,72,2,-2,12,14,98
India,2010-06-01,14,2,-1,12,0,27
India,2010-06-01,12,0,0,20,2,34
India,2010-06-01,13,2,0,15,1,31
India,2010-06-01,13,0,0,4,3,20
India,2010-06-01,14,0,0,9,0,23
India,2010-06-01,32,0,0,1,0,33
India,2010-06-01,12,0,0,8,0,20
India,2010-06-01,19,0,0,9,0,28
India,2010-06-01,46,0,0,24,0,70
India,2010-06-01,50,0,-4,29,3,78
India,2010-06-01,65,0,0,22,5,92
India,2010-06-01,53,0,0,6,3,62
India,2010-06-01,17,0,-2,8,4,27
India,2010-06-01,20,0,-2,10,2,30
India,2010-06-01,6,0,-3,1,1,5
India,2010-06-01,21,0,0,4,4,29
India,2010-06-01,29,4,0,-4,2,31
India,2010-06-01,8,0,0,0,0,8
India,2010-06-01,6,0,0,0,0,6
India,2010-06-01,0,0,0,-2,0,-2
India,2010-06-01,102,6,-1,54,31,192
India,2010-06-01,33,0,-2,4,3,38
Iran,2010-06-01,43,2,0,12,6,63
Iran,2010-06-01,34,0,0,12,0,46
Iran,2010-06-01,10,0,0,4,0,14
Iran,2010-06-01,25,0,-2,2,0,25
Iran,2010-06-01,33,0,0,0,0,33
Iran,2010-06-01,104,0,2,13,5,124
Iran,2010-06-01,88,0,-2,25,3,114
Iran,2010-06-01,75,0,5,38,24,142
Iran,2010-06-01,28,0,0,67,7,102
Iran,2010-06-01,54,0,4,25,22,105
Iran,2010-06-01,30,0,0,4,4,38
Iran,2010-06-01,23,0,1,2,2,28
Iran,2010-06-01,12,0,-4,-4,0,4
Iran,2010-06-01,33,0,4,11,8,56
Iran,2010-06-01,38,2,-4,-3,0,33
Iran,2010-06-01,10,0,1,9,2,22
Iran,2010-06-01,23,0,0,3,0,26
Iran,2010-06-01,27,2,2,5,0,36
Iran,2010-06-01,77,0,2,19,7,105
Iran,2010-06-01,51,0,-4,46,2,95
Iran,2010-06-01,18,0,-2,31,0,47
Iran,2010-06-01,41,0,-1,36,5,81
Iran,2010-06-01,18,0,-4,10,4,28
Iran,2010-06-01,32,0,0,5,5,42
Iran,2010-06-01,24,0,0,1,3,28
Iran,2010-06-01,7,0,0,0,2,9
Iran,2010-06-01,25,0,0,-1,0,24
Iran,2010-06-01,16,0,0,0,2,18
Iran,2010-06-01,68,0,-1,105,5,177
Iran,2010-06-01,59,0,0,4,1,64
Iraq,2010-06-01,89,2,0,2,9,102
Iraq,2010-06-01,17,0,0,0,1,18
Iraq,2010-06-01,36,0,0,3,0,39
Iraq,2010-06-01,62,0,-1,7,10,78
Iraq,2010-06-01,40,0,0,0,2,42
Iraq,2010-06-01,92,0,-2,15,2,107
Iraq,2010-06-01,49,0,0,4,4,57
Iraq,2010-06-01,94,0,8,35,2,139
Iraq,2010-06-01,7,0,0,0,4,11
Iraq,2010-06-01,56,0,1,9,1,67
Iraq,2010-06-01,43,0,0,16,4,63
Iraq,2010-06-01,8,0,0,12,1,21
Iraq,2010-06-01,11,0,-1,9,0,19
Iraq,2010-06-01,26,0,-1,-6,7,26
Iraq,2010-06-01,51,0,0,6,0,57
Iraq,2010-06-01,50,0,0,37,8,95
Iraq,2010-06-01,42,2,0,22,7,73
Iraq,2010-06-01,20,0,0,-1,0,19
Iraq,2010-06-01,245,0,0,17,13,275
Iraq,2010-06-01,120,0,0,19,1,140
Iraq,2010-06-01,111,0,-4,16,20,143
Iraq,2010-06-01,68,0,2,31,5,106
Iraq,2010-06-01,63,0,-4,16,13,88
Iraq,2010-06-01,58,0,-5,-2,3,54
Iraq,2010-06-01,66,0,0,12,9,87
Iraq,2010-06-01,2,0,0,6,11,19
Iraq,2010-06-01,26,0,0,3,0,29
Iraq,2010-06-01,17,0,0,7,3,27
Iraq,2010-06-01,106,0,0,86,20,212
Iraq,2010-06-01,65,0,0,14,0,79
Morocco,2010-06-01,0,0,0,3,0,3
Morocco,2010-06-01,0,0,0,9,0,9
Morocco,2010-06-01,14,0,0,18,0,32
Morocco,2010-06-01,0,0,0,0,0,0
Morocco,2010-06-01,3,0,0,0,0,3
Morocco,2010-06-01,2,0,0,0,0,2
Morocco,2010-06-01,7,0,0,9,0,16
Morocco,2010-06-01,5,0,0,6,1,12
Morocco,2010-06-01,0,0,0,3,0,3
Morocco,2010-06-01,2,0,0,3,0,5
Morocco,2010-06-01,0,0,0,0,0,0
Morocco,2010-06-01,6,0,0,3,0,9
Morocco,2010-06-01,5,0,0,0,0,5
Morocco,2010-06-01,21,0,0,2,6,29
Morocco,2010-06-01,0,0,0,0,0,0
Morocco,2010-06-01,0,0,0,0,1,1
Morocco,2010-06-01,-2,0,0,0,1,-1
Morocco,2010-06-01,3,0,0,0,0,3
Morocco,2010-06-01,6,0,0,1,0,7
Morocco,2010-06-01,0,0,0,0,0,0
Morocco,2010-06-01,0,0,0,0,0,0
Morocco,2010-06-01,0,0,0,6,0,6
Morocco,2010-06-01,1,0,-3,0,2,0
Morocco,2010-06-01,1,0,0,0,0,1
Morocco,2010-06-01,0,0,0,0,0,0
Morocco,2010-06-01,0,0,0,0,0,0
Morocco,2010-06-01,0,0,-1,0,0,-1
Morocco,2010-06-01,3,0,0,15,0,18
Morocco,2010-06-01,2,0,0,9,0,11
Nigeria,2010-06-01,2,2,0,6,5,15
Nigeria,2010-06-01,1,0,0,0,0,1
Nigeria,2010-06-01,0,0,0,0,0,0
Nigeria,2010-06-01,10,0,-2,25,0,33
Nigeria,2010-06-01,3,0,0,0,0,3
Nigeria,2010-06-01,15,0,0,9,1,25
Nigeria,2010-06-01,13,0,1,9,1,24
Nigeria,2010-06-01,17,0,1,6,8,32
Nigeria,2010-06-01,11,0,1,9,0,21
Nigeria,2010-06-01,10,0,1,9,1,21
Nigeria,2010-06-01,1,0,0,1,0,2
Nigeria,2010-06-01,-1,0,0,3,0,2
Nigeria,2010-06-01,0,0,0,0,0,0
Nigeria,2010-06-01,3,0,0,10,0,13
Nigeria,2010-06-01,6,0,0,12,0,18
Nigeria,2010-06-01,2,0,0,6,0,8
Nigeria,2010-06-01,8,0,0,16,1,25
Nigeria,2010-06-01,0,0,0,6,0,6
Nigeria,2010-06-01,11,0,0,2,1,14
Nigeria,2010-06-01,-2,0,0,0,0,-2
Nigeria,2010-06-01,8,0,0,3,1,12
Nigeria,2010-06-01,6,0,1,15,1,23
Nigeria,2010-06-01,14,0,0,12,0,26
Nigeria,2010-06-01,0,0,0,7,0,7
Nigeria,2010-06-01,3,0,0,7,3,13
Nigeria,2010-06-01,0,0,0,0,0,0
Nigeria,2010-06-01,10,0,0,3,0,13
Nigeria,2010-06-01,8,0,0,0,0,8
Nigeria,2010-06-01,29,0,1,13,4,47
Nigeria,2010-06-01,3,0,1,3,0,7
Pakistan,2010-06-01,231,0,1,22,27,281
Pakistan,2010-06-01,12,0,0,9,0,21
Pakistan,2010-06-01,40,0,0,15,0,55
Pakistan,2010-06-01,72,0,0,38,4,114
Pakistan,2010-06-01,24,0,0,1,0,25
Pakistan,2010-06-01,17,0,0,33,2,52
Pakistan,2010-06-01,40,0,-6,12,20,66
Pakistan,2010-06-01,106,0,-6,37,21,158
Pakistan,2010-06-01,39,0,0,1,0,40
Pakistan,2010-06-01,24,2,-2,17,8,49
Pakistan,2010-06-01,20,0,0,21,4,45
Pakistan,2010-06-01,38,0,0,0,0,38
Pakistan,2010-06-01,-2,0,0,0,0,-2
Pakistan,2010-06-01,54,0,0,28,0,82
Pakistan,2010-06-01,30,0,0,23,10,63
Pakistan,2010-06-01,45,0,0,26,6,77
Pakistan,2010-06-01,36,2,0,12,4,54
Pakistan,2010-06-01,6,0,0,15,0,21
Pakistan,2010-06-01,78,0,-3,32,2,109
Pakistan,2010-06-01,144,0,-2,47,45,234
Pakistan,2010-06-01,43,0,0,16,22,81
Pakistan,2010-06-01,70,0,0,14,6,90
Pakistan,2010-06-01,35,2,0,18,8,63
Pakistan,2010-06-01,23,0,0,22,0,45
Pakistan,2010-06-01,52,0,0,22,4,78
Pakistan,2010-06-01,4,0,2,37,2,45
Pakistan,2010-06-01,8,0,1,0,4,13
Pakistan,2010-06-01,22,0,0,1,3,26
Pakistan,2010-06-01,85,0,-2,91,5,179
Pakistan,2010-06-01,55,0,0,38,0,93
Sierra Leone,2010-06-01,4,0,0,0,2,6
Sierra Leone,2010-06-01,0,0,0,0,0,0
Sierra Leone,2010-06-01,0,0,0,0,0,0
Sierra Leone,2010-06-01,9,0,0,0,0,9
Sierra Leone,2010-06-01,0,0,0,0,0,0
Sierra Leone,2010-06-01,0,0,0,0,0,0
Sierra Leone,2010-06-01,0,0,0,0,0,0
Sierra Leone,2010-06-01,0,0,0,0,0,0
Sierra Leone,2010-06-01,0,0,0,0,0,0
Sierra Leone,2010-06-01,0,0,0,0,0,0
Sierra Leone,2010-06-01,0,0,0,0,0,0
Sierra Leone,2010-06-01,6,0,0,6,0,12
Sierra Leone,2010-06-01,0,0,0,0,0,0
Sierra Leone,2010-06-01,0,0,0,0,0,0
Sierra Leone,2010-06-01,0,0,0,0,0,0
Sierra Leone,2010-06-01,0,0,0,10,0,10
Sierra Leone,2010-06-01,2,0,0,0,0,2
Sierra Leone,2010-06-01,1,0,0,0,0,1
Sierra Leone,2010-06-01,0,0,0,0,0,0
Sierra Leone,2010-06-01,0,0,0,0,0,0
Sierra Leone,2010-06-01,3,0,0,0,0,3
Sierra Leone,2010-06-01,0,0,0,0,2,2
Somalia,2010-06-01,13,0,0,30,1,44
Somalia,2010-06-01,50,0,0,21,0,71
Somalia,2010-06-01,24,0,0,3,6,33
Somalia,2010-06-01,19,0,0,2,0,21
Somalia,2010-06-01,1,0,0,0,0,1
Somalia,2010-06-01,39,0,0,102,2,143
Somalia,2010-06-01,17,0,0,46,9,72
Somalia,2010-06-01,23,0,-6,18,7,42
Somalia,2010-06-01,9,0,0,6,0,15
Somalia,2010-06-01,-1,0,0,19,0,18
Somalia,2010-06-01,11,0,0,-5,2,8
Somalia,2010-06-01,9,0,0,-6,0,3
Somalia,2010-06-01,3,0,0,3,1,7
Somalia,2010-06-01,2,0,0,0,0,2
Somalia,2010-06-01,20,0,0,9,2,31
Somalia,2010-06-01,10,0,0,1,0,11
Somalia,2010-06-01,27,0,0,51,0,78
Somalia,2010-06-01,11,0,0,4,0,15
Somalia,2010-06-01,9,0,0,10,0,19
Somalia,2010-06-01,3,0,0,0,0,3
Somalia,2010-06-01,13,0,0,9,2,24
Somalia,2010-06-01,-1,0,0,6,0,5
Somalia,2010-06-01,15,0,0,3,0,18
Somalia,2010-06-01,8,0,0,12,2,22
Somalia,2010-06-01,15,0,0,28,0,43
Somalia,2010-06-01,0,0,0,-1,0,-1
Somalia,2010-06-01,0,0,0,3,0,3
Somalia,2010-06-01,0,0,0,6,0,6
Somalia,2010-06-01,18,0,0,34,3,55
Somalia,2010-06-01,3,0,0,8,0,11
Syria,2010-06-01,6,0,0,-4,0,2
Syria,2010-06-01,17,0,0,7,0,24
Syria,2010-06-01,14,0,1,10,0,25
Syria,2010-06-01,6,0,0,0,0,6
Syria,2010-06-01,2,0,0,0,4,6
Syria,2010-06-01,12,0,0,24,6,42
Syria,2010-06-01,20,0,0,0,0,20
Syria,2010-06-01,20,0,0,5,4,29
Syria,2010-06-01,9,0,0,4,0,13
Syria,2010-06-01,-2,0,0,0,0,-2
Syria,2010-06-01,-4,0,0,3,0,-1
Syria,2010-06-01,-5,0,0,0,0,-5
Syria,2010-06-01,-2,0,0,0,0,-2
Syria,2010-06-01,10,0,0,9,0,19
Syria,2010-06-01,0,0,0,-4,0,-4
Syria,2010-06-01,6,0,0,3,0,9
Syria,2010-06-01,16,0,0,45,0,61
Syria,2010-06-01,6,0,0,0,2,8
Syria,2010-06-01,10,0,0,3,2,15
Syria,2010-06-01,8,0,0,3,0,11
Syria,2010-06-01,18,0,0,-1,0,17
Syria,2010-06-01,7,0,0,9,0,16
Syria,2010-06-01,13,0,0,3,0,16
Syria,2010-06-01,2,0,0,-2,0,0
Syria,2010-06-01,0,0,0,0,0,0
Syria,2010-06-01,0,0,0,0,0,0
Syria,2010-06-01,0,0,0,0,0,0
Syria,2010-06-01,9,0,0,-4,0,5
Syria,2010-06-01,15,0,0,0,1,16
Syria,2010-06-01,-2,2,0,0,0,0
Yemen,2010-06-01,8,0,0,22,0,30
Yemen,2010-06-01,17,0,0,26,0,43
Yemen,2010-06-01,29,0,0,16,4,49
Yemen,2010-06-01,0,0,0,9,0,9
Yemen,2010-06-01,2,0,0,3,0,5
Yemen,2010-06-01,8,0,0,0,0,8
Yemen,2010-06-01,33,0,0,55,5,93
Yemen,2010-06-01,38,0,0,55,5,98
Yemen,2010-06-01,12,0,1,3,0,16
Yemen,2010-06-01,0,0,0,0,0,0
Yemen,2010-06-01,0,0,0,27,0,27
Yemen,2010-06-01,0,0,0,0,0,0
Yemen,2010-06-01,13,0,0,-5,0,8
Yemen,2010-06-01,0,0,0,6,0,6
Yemen,2010-06-01,14,0,0,3,0,17
Yemen,2010-06-01,0,0,0,9,0,9
Yemen,2010-06-01,0,0,0,0,0,0
Yemen,2010-06-01,116,0,0,-1,14,129
Yemen,2010-06-01,58,0,0,12,12,82
Yemen,2010-06-01,18,0,0,6,6,30
Yemen,2010-06-01,-1,0,0,37,0,36
Yemen,2010-06-01,5,0,0,0,0,5
Yemen,2010-06-01,-2,0,0,3,0,1
Yemen,2010-06-01,33,0,0,12,0,45
Yemen,2010-06-01,25,0,0,2,1,28
Yemen,2010-06-01,5,0,0,1,0,6
Yemen,2010-06-01,4,0,0,0,0,4
Yemen,2010-06-01,3,0,0,5,4,12
Yemen,2010-06-01,0,0,0,-3,7,4
Afghanistan,2012-10-01,298,0,0,28,106,432
Afghanistan,2012-10-01,193,0,0,34,8,235
Afghanistan,2012-10-01,147,2,1,-14,3,139
Afghanistan,2012-10-01,141,0,0,26,8,175
Afghanistan,2012-10-01,108,4,-8,52,14,170
Afghanistan,2012-10-01,227,2,0,140,30,399
Afghanistan,2012-10-01,131,0,-3,31,12,171
Afghanistan,2012-10-01,151,0,2,-3,14,164
Afghanistan,2012-10-01,217,0,-3,46,19,279
Afghanistan,2012-10-01,222,2,0,53,15,292
Afghanistan,2012-10-01,341,2,-1,121,16,479
Afghanistan,2012-10-01,267,2,-4,60,20,345
Afghanistan,2012-10-01,158,0,0,41,44,243
Afghanistan,2012-10-01,146,0,3,75,3,227
Afghanistan,2012-10-01,232,0,3,59,15,309
Afghanistan,2012-10-01,152,0,1,104,19,276
Afghanistan,2012-10-01,279,2,0,45,23,349
Afghanistan,2012-10-01,130,4,0,24,31,189
Afghanistan,2012-10-01,134,0,0,6,22,162
Afghanistan,2012-10-01,205,6,0,20,2,233
Afghanistan,2012-10-01,115,0,0,31,5,151
Afghanistan,2012-10-01,118,2,0,43,7,170
Afghanistan,2012-10-01,183,6,1,16,11,217
Afghanistan,2012-10-01,128,2,1,43,5,179
Afghanistan,2012-10-01,129,4,-1,33,10,175
Afghanistan,2012-10-01,137,4,1,6,29,177
Afghanistan,2012-10-01,106,2,1,18,22,149
Afghanistan,2012-10-01,84,0,-2,21,11,114
Afghanistan,2012-10-01,82,2,0,0,9,93
Afghanistan,2012-10-01,143,2,0,41,1,187
Afghanistan,2012-10-01,107,0,-3,28,12,144
Albania,2012-10-01,-4,0,0,0,0,-4
Albania,2012-10-01,-2,0,0,0,0,-2
Albania,2012-10-01,9,0,0,0,0,9
Albania,2012-10-01,6,0,0,0,0,6
Albania,2012-10-01,7,0,1,3,1,12
Albania,2012-10-01,9,0,0,0,3,12
Albania,2012-10-01,-1,0,0,0,0,-1
Albania,2012-10-01,2,0,0,6,0,8
Albania,2012-10-01,-1,0,0,0,0,-1
Albania,2012-10-01,24,0,0,3,3,30
Albania,2012-10-01,3,0,-1,5,0,7
Albania,2012-10-01,5,0,0,0,0,5
Albania,2012-10-01,4,0,0,0,0,4
Albania,2012-10-01,3,0,0,0,0,3
Albania,2012-10-01,21,0,0,0,0,21
Albania,2012-10-01,22,0,0,6,0,28
Albania,2012-10-01,13,0,0,3,0,16
Albania,2012-10-01,6,0,0,6,0,12
Albania,2012-10-01,3,0,-1,0,1,3
Albania,2012-10-01,-2,0,0,0,0,-2
Albania,2012-10-01,0,0,0,0,0,0
Albania,2012-10-01,10,0,0,-2,5,13
Albania,2012-10-01,0,0,0,3,0,3
Albania,2012-10-01,2,0,-1,-2,0,-1
Albania,2012-10-01,8,0,0,3,1,12
Albania,2012-10-01,0,0,0,3,0,3
Albania,2012-10-01,0,0,0,0,0,0
Albania,2012-10-01,0,0,0,0,0,0
Albania,2012-10-01,3,0,0,0,0,3
Albania,2012-10-01,7,0,0,0,0,7
Albania,2012-10-01,13,0,-2,9,1,21
Algeria,2012-10-01,12,0,0,12,0,24
Algeria,2012-10-01,686,6,-17,204,100,979
Algeria,2012-10-01,3,0,0,0,2,5
Algeria,2012-10-01,4,0,0,0,0,4
Algeria,2012-10-01,11,0,0,0,0,11
Algeria,2012-10-01,10,0,0,0,0,10
Algeria,2012-10-01,1,0,0,21,0,22
Algeria,2012-10-01,8,0,0,6,0,14
Algeria,2012-10-01,3,0,-6,0,0,-3
Algeria,2012-10-01,-1,0,0,0,0,-1
Algeria,2012-10-01,3,2,0,3,2,10
Algeria,2012-10-01,0,0,0,0,0,0
Algeria,2012-10-01,9,0,0,0,0,9
Algeria,2012-10-01,42,0,0,4,0,46
Algeria,2012-10-01,13,0,0,9,0,22
Algeria,2012-10-01,6,0,0,9,0,15
Algeria,2012-10-01,34,0,0,3,1,38
Algeria,2012-10-01,0,0,0,3,0,3
Algeria,2012-10-01,20,0,0,-1,2,21
Algeria,2012-10-01,4,0,0,3,0,7
Algeria,2012-10-01,12,0,2,6,1,21
Algeria,2012-10-01,9,2,0,3,0,14
Algeria,2012-10-01,5,2,0,0,1,8
Algeria,2012-10-01,9,0,0,38,3,50
Algeria,2012-10-01,20,0,0,31,1,52
Algeria,2012-10-01,-1,0,0,0,0,-1
Algeria,2012-10-01,5,0,0,0,1,6
Algeria,2012-10-01,15,0,0,0,1,16
Algeria,2012-10-01,17,0,0,3,0,20
Algeria,2012-10-01,5,0,0,6,1,12
Algeria,2012-10-01,5,0,0,-2,0,3
Bangladesh,2012-10-01,65,0,-6,20,8,87
Bangladesh,2012-10-01,29,0,-2,4,2,33
Bangladesh,2012-10-01,59,0,0,13,14,86
Bangladesh,2012-10-01,31,0,0,28,10,69
Bangladesh,2012-10-01,32,0,0,9,23,64
Bangladesh,2012-10-01,30,0,0,7,7,44
Bangladesh,2012-10-01,19,0,4,8,0,31
Bangladesh,2012-10-01,14,0,0,29,9,52
Bangladesh,2012-10-01,11,0,0,28,16,55
Bangladesh,2012-10-01,20,0,0,12,12,44
Bangladesh,2012-10-01,4,0,0,10,7,21
Bangladesh,2012-10-01,46,0,1,7,5,59
Bangladesh,2012-10-01,17,0,-2,21,13,49
Bangladesh,2012-10-01,20,0,0,2,0,22
Bangladesh,2012-10-01,60,0,-1,22,13,94
Bangladesh,2012-10-01,29,0,0,21,1,51
Bangladesh,2012-10-01,63,0,1,24,4,92
Bangladesh,2012-10-01,24,0,0,57,7,88
Bangladesh,2012-10-01,30,0,0,57,17,104
Bangladesh,2012-10-01,20,2,0,46,9,77
Bangladesh,2012-10-01,9,0,-4,30,2,37
Bangladesh,2012-10-01,32,0,1,19,5,57
Bangladesh,2012-10-01,67,0,3,18,5,93
Bangladesh,2012-10-01,36,0,0,11,7,54
Bangladesh,2012-10-01,98,0,0,6,7,111
Bangladesh,2012-10-01,152,0,0,36,13,201
Bangladesh,2012-10-01,88,0,0,-1,16,103
Bangladesh,2012-10-01,87,0,0,3,5,95
Bangladesh,2012-10-01,83,0,-2,8,9,98
Bangladesh,2012-10-01,62,0,-1,31,6,98
Bangladesh,2012-10-01,83,0,0,11,3,97
Cameroon,2012-10-01,0,0,0,0,0,0
Cameroon,2012-10-01,0,0,0,0,0,0
Cameroon,2012-10-01,7,0,0,0,0,7
Cameroon,2012-10-01,0,0,0,0,0,0
Cameroon,2012-10-01,0,0,0,0,0,0
Cameroon,2012-10-01,0,0,0,0,0,0
Cameroon,2012-10-01,0,0,0,0,0,0
Cameroon,2012-10-01,3,0,0,0,0,3
Cameroon,2012-10-01,5,0,0,0,0,5
Cameroon,2012-10-01,1,0,0,0,0,1
Cameroon,2012-10-01,0,0,0,0,0,0
Cameroon,2012-10-01,0,0,0,0,0,0
Cameroon,2012-10-01,2,0,0,0,0,2
Cameroon,2012-10-01,0,0,0,0,0,0
Cameroon,2012-10-01,0,0,0,0,0,0
Cameroon,2012-10-01,5,0,0,0,0,5
Cameroon,2012-10-01,0,0,0,3,0,3
Cameroon,2012-10-01,0,0,0,0,0,0
Cameroon,2012-10-01,-1,0,0,3,0,2
Cameroon,2012-10-01,0,0,0,0,0,0
Cameroon,2012-10-01,23,0,0,15,0,38
Cameroon,2012-10-01,3,0,0,3,0,6
Cameroon,2012-10-01,0,0,0,6,0,6
Cameroon,2012-10-01,0,0,0,0,0,0
Cameroon,2012-10-01,0,0,0,0,0,0
Cameroon,2012-10-01,-6,0,0,0,0,-6
Cameroon,2012-10-01,2,0,0,-2,0,0
China,2012-10-01,161,0,-2,51,25,235
China,2012-10-01,179,0,-2,77,22,276
China,2012-10-01,159,0,-11,44,19,211
China,2012-10-01,174,0,1,79,27,281
China,2012-10-01,121,2,-5,68,12,198
China,2012-10-01,64,2,-3,9,18,90
China,2012-10-01,63,4,0,56,15,138
China,2012-10-01,992,4,-3,281,97,1371
China,2012-10-01,186,4,-2,81,29,298
China,2012-10-01,178,0,0,31,17,226
China,2012-10-01,185,0,-5,68,21,269
China,2012-10-01,141,0,5,62,11,219
China,2012-10-01,67,0,1,60,8,136
China,2012-10-01,65,0,-10,23,6,84
China,2012-10-01,128,10,1,91,15,245
China,2012-10-01,343,6,0,54,11,414
China,2012-10-01,259,2,-4,82,28,367
China,2012-10-01,165,6,-1,45,21,236
China,2012-10-01,158,2,-4,59,13,228
China,2012-10-01,122,4,3,30,8,167
China,2012-10-01,112,0,-6,27,16,149
China,2012-10-01,253,4,-8,24,13,286
China,2012-10-01,172,2,-6,44,16,228
China,2012-10-01,171,0,-7,132,23,319
China,2012-10-01,132,0,0,78,20,230
China,2012-10-01,149,2,-3,67,31,246
China,2012-10-01,78,0,-2,30,9,115
China,2012-10-01,116,4,-1,29,20,168
China,2012-10-01,192,2,-6,90,30,308
China,2012-10-01,171,0,1,78,24,274
China,2012-10-01,149,2,1,27,7,186
Egypt,2012-10-01,54,0,0,32,9,95
Egypt,2012-10-01,81,0,-5,20,11,107
Egypt,2012-10-01,70,0,1,24,8,103
Egypt,2012-10-01,99,0,3,119,14,235
Egypt,2012-10-01,163,0,4,60,24,251
Egypt,2012-10-01,39,0,-2,89,6,132
Egypt,2012-10-01,32,0,-2,48,10,88
Egypt,2012-10-01,111,2,1,40,25,179
Egypt,2012-10-01,58,2,1,86,17,164
Egypt,2012-10-01,70,0,3,40,24,137
Egypt,2012-10-01,63,4,-3,14,17,95
Egypt,2012-10-01,95,6,2,59,25,187
Egypt,2012-10-01,104,0,0,24,20,148
Egypt,2012-10-01,98,0,-2,20,14,130
Egypt,2012-10-01,124,0,-2,61,33,216
Egypt,2012-10-01,65,0,-2,31,18,112
Egypt,2012-10-01,47,0,-9,15,8,61
Egypt,2012-10-01,38,0,1,11,25,75
Egypt,2012-10-01,33,0,-6,8,16,51
Egypt,2012-10-01,42,0,0,23,14,79
Egypt,2012-10-01,43,0,1,8,12,64
Egypt,2012-10-01,140,0,-1,37,10,186
Egypt,2012-10-01,129,4,-5,9,10,147
Egypt,2012-10-01,162,0,0,20,18,200
Egypt,2012-10-01,201,0,2,8,25,236
Egypt,2012-10-01,40,0,0,16,9,65
Egypt,2012-10-01,57,0,-1,-1,12,67
Egypt,2012-10-01,90,0,0,-2,14,102
Egypt,2012-10-01,23,0,-1,5,8,35
Egypt,2012-10-01,31,8,0,0,8,47
Egypt,2012-10-01,22,0,0,15,6,43
Eritrea,2012-10-01,0,0,0,0,0,0
Eritrea,2012-10-01,3,0,0,0,0,3
Eritrea,2012-10-01,0,0,0,9,0,9
Eritrea,2012-10-01,0,0,0,9,0,9
Eritrea,2012-10-01,1,0,0,0,0,1
Eritrea,2012-10-01,1,0,0,-5,0,-4
Eritrea,2012-10-01,0,0,0,3,0,3
Eritrea,2012-10-01,0,0,0,6,0,6
Eritrea,2012-10-01,0,0,0,-1,0,-1
Eritrea,2012-10-01,0,0,0,0,7,7
Eritrea,2012-10-01,0,0,0,3,7,10
Eritrea,2012-10-01,0,0,0,0,0,0
Eritrea,2012-10-01,2,0,0,12,3,17
Eritrea,2012-10-01,0,0,0,6,0,6
Eritrea,2012-10-01,0,0,0,0,0,0
Eritrea,2012-10-01,0,0,0,0,0,0
Eritrea,2012-10-01,14,0,0,3,0,17
Eritrea,2012-10-01,3,2,0,0,0,5
Eritrea,2012-10-01,2,0,0,0,0,2
Eritrea,2012-10-01,0,0,0,0,0,0
Eritrea,2012-10-01,0,0,0,-2,0,-2
Eritrea,2012-10-01,0,0,0,-2,0,-2
Eritrea,2012-10-01,0,0,0,8,0,8
Georgia,2012-10-01,0,0,0,0,0,0
Georgia,2012-10-01,4,0,-2,0,0,2
Georgia,2012-10-01,0,0,0,0,0,0
Georgia,2012-10-01,1,0,0,0,0,1
Georgia,2012-10-01,0,0,0,0,0,0
Georgia,2012-10-01,1,0,0,0,0,1
Georgia,2012-10-01,6,0,0,0,0,6
Georgia,2012-10-01,2,0,0,0,1,3
Georgia,2012-10-01,0,2,0,0,0,2
Georgia,2012-10-01,3,0,0,0,0,3
Georgia,2012-10-01,-1,0,-4,-1,0,-6
Georgia,2012-10-01,2,0,0,0,0,2
Georgia,2012-10-01,0,0,0,0,0,0
Georgia,2012-10-01,0,2,0,0,1,3
Georgia,2012-10-01,0,0,0,0,1,1
Georgia,2012-10-01,2,0,0,0,1,3
Georgia,2012-10-01,0,0,0,0,0,0
Georgia,2012-10-01,1,0,0,0,0,1
Georgia,2012-10-01,0,0,0,3,0,3
Georgia,2012-10-01,0,0,0,0,0,0
Georgia,2012-10-01,0,0,0,0,0,0
Georgia,2012-10-01,0,0,0,0,0,0
Georgia,2012-10-01,0,2,0,3,0,5
Georgia,2012-10-01,-3,2,0,3,0,2
Georgia,2012-10-01,0,0,0,0,0,0
Georgia,2012-10-01,0,0,0,0,0,0
Georgia,2012-10-01,2,0,0,0,1,3
Georgia,2012-10-01,0,0,0,0,1,1
Georgia,2012-10-01,2,2,0,0,0,4
India,2012-10-01,79,2,1,13,7,102
India,2012-10-01,82,0,-1,9,15,105
India,2012-10-01,45,0,-5,10,7,57
India,2012-10-01,80,2,-2,16,10,106
India,2012-10-01,76,4,0,31,11,122
India,2012-10-01,45,0,0,22,11,78
India,2012-10-01,62,2,1,13,12,90
India,2012-10-01,56,4,-8,11,11,74
India,2012-10-01,65,2,-3,25,9,98
India,2012-10-01,23,0,2,-8,1,18
India,2012-10-01,22,0,1,9,1,33
India,2012-10-01,95,6,-8,23,17,133
India,2012-10-01,51,0,-4,3,6,56
India,2012-10-01,52,0,-5,20,15,82
India,2012-10-01,91,0,-1,9,19,118
India,2012-10-01,94,2,-24,4,6,82
India,2012-10-01,46,0,-10,24,8,68
India,2012-10-01,62,2,0,30,8,102
India,2012-10-01,117,0,0,8,15,140
India,2012-10-01,87,0,-2,11,22,118
India,2012-10-01,26,0,-1,1,12,38
India,2012-10-01,91,0,-7,44,24,152
India,2012-10-01,65,0,-7,23,8,89
India,2012-10-01,62,0,0,34,19,115
India,2012-10-01,43,0,0,40,11,94
India,2012-10-01,103,2,-16,51,19,159
India,2012-10-01,32,2,-14,2,4,26
India,2012-10-01,63,2,-1,7,12,83
India,2012-10-01,69,2,-1,27,18,115
India,2012-10-01,78,0,1,11,6,96
India,2012-10-01,63,0,-1,10,3,75
Iran,2012-10-01,209,0,-1,127,86,421
Iran,2012-10-01,301,2,4,160,31,498
Iran,2012-10-01,131,6,-3,41,36,211
Iran,2012-10-01,129,2,1,30,10,172
Iran,2012-10-01,103,0,-1,13,7,122
Iran,2012-10-01,74,2,1,29,3,109
Iran,2012-10-01,138,0,-2,46,4,186
Iran,2012-10-01,140,6,0,38,15,199
Iran,2012-10-01,142,4,10,30,18,204
Iran,2012-10-01,97,2,2,29,16,146
Iran,2012-10-01,245,4,2,9,22,282
Iran,2012-10-01,199,0,0,38,21,258
Iran,2012-10-01,57,0,3,26,5,91
Iran,2012-10-01,66,4,1,7,22,100
Iran,2012-10-01,114,0,4,46,10,174
Iran,2012-10-01,103,10,3,23,2,141
Iran,2012-10-01,174,4,2,57,4,241
Iran,2012-10-01,98,6,4,55,8,171
Iran,2012-10-01,84,0,3,38,18,143
Iran,2012-10-01,108,0,3,49,7,167
Iran,2012-10-01,178,0,5,18,9,210
Iran,2012-10-01,921,4,-10,403,84,1402
Iran,2012-10-01,162,6,-1,36,28,231
Iran,2012-10-01,138,2,1,9,7,157
Iran,2012-10-01,88,0,2,37,13,140
Iran,2012-10-01,69,0,-1,53,16,137
Iran,2012-10-01,142,0,0,30,15,187
Iran,2012-10-01,109,0,1,22,8,140
Iran,2012-10-01,126,2,1,4,17,150
Iran,2012-10-01,111,0,-5,25,24,155
Iran,2012-10-01,115,0,-5,46,27,183
Iraq,2012-10-01,145,0,0,21,27,193
Iraq,2012-10-01,110,0,-6,17,18,139
Iraq,2012-10-01,111,4,-1,33,9,156
Iraq,2012-10-01,195,4,0,32,11,242
Iraq,2012-10-01,92,2,0,3,9,106
Iraq,2012-10-01,44,0,0,0,6,50
Iraq,2012-10-01,32,0,-1,-2,4,33
Iraq,2012-10-01,64,2,0,16,3,85
Iraq,2012-10-01,66,2,0,28,8,104
Iraq,2012-10-01,57,2,-1,31,1,90
Iraq,2012-10-01,80,0,0,33,3,116
Iraq,2012-10-01,129,0,0,59,6,194
Iraq,2012-10-01,60,0,0,23,4,87
Iraq,2012-10-01,77,0,0,40,2,119
Iraq,2012-10-01,69,0,1,23,8,101
Iraq,2012-10-01,134,0,2,-1,10,145
Iraq,2012-10-01,89,2,-2,12,6,107
Iraq,2012-10-01,126,0,4,19,8,157
Iraq,2012-10-01,93,0,1,78,14,186
Iraq,2012-10-01,62,0,0,17,3,82
Iraq,2012-10-01,146,0,0,31,17,194
Iraq,2012-10-01,126,2,0,31,9,168
Iraq,2012-10-01,99,0,0,46,23,168
Iraq,2012-10-01,103,0,-1,40,2,144
Iraq,2012-10-01,96,0,0,31,5,132
Iraq,2012-10-01,48,0,0,10,20,78
Iraq,2012-10-01,70,0,0,-3,0,67
Iraq,2012-10-01,32,0,0,19,1,52
Iraq,2012-10-01,62,0,-1,7,6,74
Iraq,2012-10-01,108,0,-1,15,0,122
Iraq,2012-10-01,81,0,-2,46,3,128
Morocco,2012-10-01,11,0,0,-6,4,9
Morocco,2012-10-01,24,0,0,-2,4,26
Morocco,2012-10-01,0,0,1,15,4,20
Morocco,2012-10-01,42,0,1,19,9,71
Morocco,2012-10-01,479,2,-9,150,95,717
Morocco,2012-10-01,4,0,0,3,2,9
Morocco,2012-10-01,0,0,0,12,0,12
Morocco,2012-10-01,9,0,0,5,0,14
Morocco,2012-10-01,6,0,0,6,2,14
Morocco,2012-10-01,-1,0,0,9,2,10
Morocco,2012-10-01,-3,0,0,0,0,-3
Morocco,2012-10-01,1,0,0,0,0,1
Morocco,2012-10-01,1,0,0,7,0,8
Morocco,2012-10-01,2,0,0,-2,0,0
Morocco,2012-10-01,-1,0,0,4,2,5
Morocco,2012-10-01,2,0,0,3,0,5
Morocco,2012-10-01,4,0,0,12,1,17
Morocco,2012-10-01,8,0,0,4,4,16
Morocco,2012-10-01,11,2,0,-10,1,4
Morocco,2012-10-01,2,0,0,9,0,11
Morocco,2012-10-01,-1,0,0,0,0,-1
Morocco,2012-10-01,5,0,0,0,0,5
Morocco,2012-10-01,13,0,0,13,0,26
Morocco,2012-10-01,9,0,0,3,1,13
Morocco,2012-10-01,11,0,0,9,0,20
Morocco,2012-10-01,9,0,0,15,0,24
Morocco,2012-10-01,0,0,0,21,1,22
Morocco,2012-10-01,3,0,0,13,0,16
Morocco,2012-10-01,8,0,0,6,0,14
Morocco,2012-10-01,1,0,0,1,1,3
Morocco,2012-10-01,2,0,0,0,0,2
Nigeria,2012-10-01,54,0,1,23,9,87
Nigeria,2012-10-01,66,2,1,18,1,88
Nigeria,2012-10-01,80,0,2,14,11,107
Nigeria,2012-10-01,58,0,1,3,21,83
Nigeria,2012-10-01,40,0,1,22,6,69
Nigeria,2012-10-01,10,2,0,5,1,18
Nigeria,2012-10-01,18,0,0,14,3,35
Nigeria,2012-10-01,16,0,0,-1,2,17
Nigeria,2012-10-01,17,0,0,7,1,25
Nigeria,2012-10-01,31,0,0,21,3,55
Nigeria,2012-10-01,68,0,0,23,0,91
Nigeria,2012-10-01,22,2,1,4,0,29
Nigeria,2012-10-01,23,0,0,3,1,27
Nigeria,2012-10-01,37,0,2,6,0,45
Nigeria,2012-10-01,29,0,-4,40,10,75
Nigeria,2012-10-01,22,0,0,10,4,36
Nigeria,2012-10-01,39,0,1,13,7,60
Nigeria,2012-10-01,57,0,1,3,13,74
Nigeria,2012-10-01,16,0,0,3,1,20
Nigeria,2012-10-01,16,0,1,20,1,38
Nigeria,2012-10-01,16,0,0,11,3,30
Nigeria,2012-10-01,43,0,0,6,3,52
Nigeria,2012-10-01,14,0,-1,24,1,38
Nigeria,2012-10-01,37,0,0,22,-1,58
Nigeria,2012-10-01,29,0,0,12,2,43
Nigeria,2012-10-01,13,0,2,21,2,38
Nigeria,2012-10-01,0,0,0,15,5,20
Nigeria,2012-10-01,16,0,0,33,1,50
Nigeria,2012-10-01,21,0,0,14,8,43
Nigeria,2012-10-01,27,0,-1,15,0,41
Nigeria,2012-10-01,33,0,0,16,2,51
Pakistan,2012-10-01,130,0,0,36,21,187
Pakistan,2012-10-01,96,0,0,-1,4,99
Pakistan,2012-10-01,84,0,0,23,5,112
Pakistan,2012-10-01,101,0,0,23,15,139
Pakistan,2012-10-01,103,0,0,22,13,138
Pakistan,2012-10-01,82,0,-6,14,6,96
Pakistan,2012-10-01,38,0,0,6,6,50
Pakistan,2012-10-01,52,0,0,0,2,54
Pakistan,2012-10-01,119,0,2,20,17,158
Pakistan,2012-10-01,129,0,3,20,8,160
Pakistan,2012-10-01,179,0,3,28,22,232
Pakistan,2012-10-01,154,0,1,74,9,238
Pakistan,2012-10-01,153,2,0,15,27,197
Pakistan,2012-10-01,65,0,1,14,5,85
Pakistan,2012-10-01,173,8,-1,44,14,238
Pakistan,2012-10-01,293,0,0,25,12,330
Pakistan,2012-10-01,143,0,3,33,11,190
Pakistan,2012-10-01,98,0,1,58,3,160
Pakistan,2012-10-01,201,0,2,16,20,239
Pakistan,2012-10-01,153,0,0,21,19,193
Pakistan,2012-10-01,103,0,0,12,30,145
Pakistan,2012-10-01,212,2,0,52,7,273
Pakistan,2012-10-01,151,2,0,39,18,210
Pakistan,2012-10-01,138,0,-2,53,3,192
Pakistan,2012-10-01,84,0,0,17,5,106
Pakistan,2012-10-01,160,0,-8,7,5,164
Pakistan,2012-10-01,56,0,0,0,5,61
Pakistan,2012-10-01,93,0,-2,3,0,94
Pakistan,2012-10-01,97,0,0,7,9,113
Pakistan,2012-10-01,70,0,-4,19,6,91
Pakistan,2012-10-01,79,2,-1,25,9,114
Sierra Leone,2012-10-01,5,0,0,0,2,7
Sierra Leone,2012-10-01,1,0,0,0,0,1
Sierra Leone,2012-10-01,1,0,0,3,0,4
Sierra Leone,2012-10-01,2,0,0,0,0,2
Sierra Leone,2012-10-01,3,0,0,0,0,3
Sierra Leone,2012-10-01,3,0,0,0,0,3
Sierra Leone,2012-10-01,2,0,0,0,0,2
Sierra Leone,2012-10-01,-1,0,0,12,0,11
Sierra Leone,2012-10-01,4,0,0,1,0,5
Sierra Leone,2012-10-01,11,0,0,0,0,11
Sierra Leone,2012-10-01,4,0,0,0,0,4
Sierra Leone,2012-10-01,-2,0,0,9,0,7
Sierra Leone,2012-10-01,7,0,0,9,0,16
Sierra Leone,2012-10-01,1,0,0,0,1,2
Sierra Leone,2012-10-01,0,0,0,0,0,0
Sierra Leone,2012-10-01,3,0,0,0,0,3
Sierra Leone,2012-10-01,-1,0,0,3,0,2
Sierra Leone,2012-10-01,9,0,0,3,0,12
Sierra Leone,2012-10-01,1,0,0,0,0,1
Sierra Leone,2012-10-01,0,0,0,3,0,3
Sierra Leone,2012-10-01,0,0,0,0,0,0
Sierra Leone,2012-10-01,0,0,0,0,0,0
Sierra Leone,2012-10-01,11,0,0,6,0,17
Sierra Leone,2012-10-01,0,0,0,0,0,0
Sierra Leone,2012-10-01,0,0,0,0,0,0
Sierra Leone,2012-10-01,7,0,0,0,1,8
Sierra Leone,2012-10-01,2,0,0,0,1,3
Somalia,2012-10-01,150,0,0,32,27,209
Somalia,2012-10-01,116,0,3,18,4,141
Somalia,2012-10-01,38,2,0,25,15,80
Somalia,2012-10-01,44,0,2,43,3,92
Somalia,2012-10-01,45,0,0,62,2,109
Somalia,2012-10-01,36,0,0,22,1,59
Somalia,2012-10-01,62,0,0,7,1,70
Somalia,2012-10-01,49,0,0,51,4,104
Somalia,2012-10-01,64,0,-2,52,17,131
Somalia,2012-10-01,59,2,0,54,6,121
Somalia,2012-10-01,51,0,0,42,8,101
Somalia,2012-10-01,60,1,1,25,11,98
Somalia,2012-10-01,27,0,-2,18,7,50
Somalia,2012-10-01,41,0,0,16,1,58
Somalia,2012-10-01,83,0,0,31,5,119
Somalia,2012-10-01,76,0,0,33,8,117
Somalia,2012-10-01,117,0,0,50,13,180
Somalia,2012-10-01,71,0,1,76,8,156
Somalia,2012-10-01,74,4,-1,60,19,156
Somalia,2012-10-01,69,4,1,53,10,137
Somalia,2012-10-01,72,0,-6,7,7,80
Somalia,2012-10-01,115,0,-10,12,19,136
Somalia,2012-10-01,63,0,1,17,12,93
Somalia,2012-10-01,90,0,0,29,4,123
Somalia,2012-10-01,89,0,-4,36,6,127
Somalia,2012-10-01,78,4,0,7,10,99
Somalia,2012-10-01,52,0,0,21,7,80
Somalia,2012-10-01,60,0,0,18,13,91
Somalia,2012-10-01,85,0,1,15,5,106
Somalia,2012-10-01,66,0,1,25,3,95
Somalia,2012-10-01,83,0,4,36,12,135
Syria,2012-10-01,208,0,-33,18,32,225
Syria,2012-10-01,308,2,-4,96,24,426
Syria,2012-10-01,452,0,-3,55,20,524
Syria,2012-10-01,723,0,-2,41,34,796
Syria,2012-10-01,459,2,-3,6,35,499
Syria,2012-10-01,265,2,-6,31,16,308
Syria,2012-10-01,266,0,-8,39,13,310
Syria,2012-10-01,395,2,-5,65,21,478
Syria,2012-10-01,376,0,0,23,24,423
Syria,2012-10-01,762,10,-6,202,57,1025
Syria,2012-10-01,391,2,-6,64,12,463
Syria,2012-10-01,310,0,11,48,24,393
Syria,2012-10-01,110,4,-3,30,9,150
Syria,2012-10-01,405,1,4,100,43,553
Syria,2012-10-01,233,2,-4,58,22,311
Syria,2012-10-01,161,6,0,167,33,367
Syria,2012-10-01,265,10,3,94,20,392
Syria,2012-10-01,196,12,4,82,19,313
Syria,2012-10-01,351,2,0,53,97,503
Syria,2012-10-01,409,0,-13,121,36,553
Syria,2012-10-01,407,0,-12,89,56,540
Syria,2012-10-01,576,10,-13,55,65,693
Syria,2012-10-01,408,6,0,92,82,588
Syria,2012-10-01,292,4,-15,49,27,357
Syria,2012-10-01,267,0,-13,17,16,287
Syria,2012-10-01,250,0,1,27,6,284
Syria,2012-10-01,114,0,-7,17,14,138
Syria,2012-10-01,154,4,-2,33,16,205
Syria,2012-10-01,226,0,-3,1,11,235
Syria,2012-10-01,199,4,-6,55,17,269
Syria,2012-10-01,158,4,0,-5,7,164
Yemen,2012-10-01,41,0,0,2,3,46
Yemen,2012-10-01,71,0,0,25,4,100
Yemen,2012-10-01,37,0,1,12,0,50
Yemen,2012-10-01,13,0,0,12,0,25
Yemen,2012-10-01,23,0,0,70,4,97
Yemen,2012-10-01,41,0,0,117,2,160
Yemen,2012-10-01,16,0,-2,55,6,75
Yemen,2012-10-01,3,0,2,6,0,11
Yemen,2012-10-01,5,0,0,23,6,34
Yemen,2012-10-01,0,0,0,9,0,9
Yemen,2012-10-01,51,0,-3,1,18,67
Yemen,2012-10-01,11,0,0,-3,6,14
Yemen,2012-10-01,9,0,0,15,1,25
Yemen,2012-10-01,6,0,0,24,3,33
Yemen,2012-10-01,25,0,1,3,2,31
Yemen,2012-10-01,22,0,1,46,10,79
Yemen,2012-10-01,27,0,0,13,4,44
Yemen,2012-10-01,43,0,0,27,0,70
Yemen,2012-10-01,65,0,0,19,13,97
Yemen,2012-10-01,21,0,0,21,4,46
Yemen,2012-10-01,11,0,0,0,3,14
Yemen,2012-10-01,66,0,0,3,9,78
Yemen,2012-10-01,41,0,0,12,7,60
Yemen,2012-10-01,28,0,0,27,4,59
Yemen,2012-10-01,14,0,0,-6,2,10
Yemen,2012-10-01,32,0,0,0,1,33
Yemen,2012-10-01,23,0,0,2,0,25
Yemen,2012-10-01,30,0,0,6,0,36
Yemen,2012-10-01,21,0,0,0,0,21
Yemen,2012-10-01,2,0,0,0,0,2
Yemen,2012-10-01,3,0,0,9,0,12
Afghanistan,2012-04-01,70,0,-6,18,10,92
Afghanistan,2012-04-01,221,8,2,58,17,306
Afghanistan,2012-04-01,281,4,-2,83,17,383
Afghanistan,2012-04-01,206,2,-2,101,28,335
Afghanistan,2012-04-01,217,0,-7,72,25,307
Afghanistan,2012-04-01,129,0,-2,9,17,153
Afghanistan,2012-04-01,152,2,-3,11,14,176
Afghanistan,2012-04-01,210,0,1,18,11,240
Afghanistan,2012-04-01,141,0,0,35,11,187
Afghanistan,2012-04-01,195,6,1,71,28,301
Afghanistan,2012-04-01,81,0,3,23,14,121
Afghanistan,2012-04-01,112,0,4,64,9,189
Afghanistan,2012-04-01,162,2,0,48,28,240
Afghanistan,2012-04-01,141,2,0,23,3,169
Afghanistan,2012-04-01,414,0,-2,27,6,445
Afghanistan,2012-04-01,216,8,0,18,17,259
Afghanistan,2012-04-01,152,4,-4,87,24,263
Afghanistan,2012-04-01,408,10,1,111,29,559
Afghanistan,2012-04-01,222,2,0,111,21,356
Afghanistan,2012-04-01,58,4,0,33,3,98
Afghanistan,2012-04-01,81,0,0,20,17,118
Afghanistan,2012-04-01,54,0,0,13,12,79
Afghanistan,2012-04-01,160,0,-4,20,19,195
Afghanistan,2012-04-01,241,2,-2,56,2,299
Afghanistan,2012-04-01,135,0,3,33,24,195
Afghanistan,2012-04-01,347,0,-4,83,15,441
Afghanistan,2012-04-01,296,4,-10,87,33,410
Afghanistan,2012-04-01,436,0,0,12,20,468
Afghanistan,2012-04-01,297,2,0,66,5,370
Afghanistan,2012-04-01,319,2,0,21,27,369
Albania,2012-04-01,0,0,0,0,0,0
Albania,2012-04-01,5,0,0,-4,0,1
Albania,2012-04-01,3,0,0,6,0,9
Albania,2012-04-01,2,0,-3,3,6,8
Albania,2012-04-01,23,2,1,0,0,26
Albania,2012-04-01,2,0,-2,0,1,1
Albania,2012-04-01,2,0,0,0,0,2
Albania,2012-04-01,6,0,1,0,0,7
Albania,2012-04-01,1,0,0,6,2,9
Albania,2012-04-01,10,0,0,6,0,16
Albania,2012-04-01,13,0,0,9,3,25
Albania,2012-04-01,27,0,0,9,0,36
Albania,2012-04-01,33,0,0,7,4,44
Albania,2012-04-01,11,0,0,12,6,29
Albania,2012-04-01,0,0,0,0,0,0
Albania,2012-04-01,30,0,0,-2,4,32
Albania,2012-04-01,32,0,0,18,11,61
Albania,2012-04-01,38,0,0,12,14,64
Albania,2012-04-01,8,0,-2,-3,0,3
Albania,2012-04-01,10,0,0,0,0,10
Albania,2012-04-01,10,0,-2,0,0,8
Albania,2012-04-01,9,0,0,3,0,12
Albania,2012-04-01,6,0,0,0,6,12
Albania,2012-04-01,9,0,0,0,8,17
Albania,2012-04-01,12,0,-3,6,7,22
Albania,2012-04-01,3,0,0,0,0,3
Albania,2012-04-01,3,0,0,0,0,3
Albania,2012-04-01,0,0,0,3,0,3
Albania,2012-04-01,0,0,0,0,0,0
Albania,2012-04-01,4,0,0,0,0,4
Algeria,2012-04-01,-4,0,0,13,0,9
Algeria,2012-04-01,81,0,0,12,2,95
Algeria,2012-04-01,34,0,0,4,4,42
Algeria,2012-04-01,27,0,0,20,0,47
Algeria,2012-04-01,24,0,0,11,0,35
Algeria,2012-04-01,105,0,-5,28,2,130
Algeria,2012-04-01,56,0,-4,13,0,65
Algeria,2012-04-01,13,0,-2,-5,1,7
Algeria,2012-04-01,68,0,-2,9,6,81
Algeria,2012-04-01,15,0,0,9,1,25
Algeria,2012-04-01,13,0,1,21,0,35
Algeria,2012-04-01,19,0,0,18,2,39
Algeria,2012-04-01,7,0,1,0,1,9
Algeria,2012-04-01,1,0,0,0,0,1
Algeria,2012-04-01,10,0,0,9,0,19
Algeria,2012-04-01,9,0,-1,8,0,16
Algeria,2012-04-01,9,0,-1,-16,0,-8
Algeria,2012-04-01,3,0,3,-6,0,0
Algeria,2012-04-01,16,0,0,1,0,17
Algeria,2012-04-01,1,0,0,2,0,3
Algeria,2012-04-01,5,0,0,-4,2,3
Algeria,2012-04-01,4,0,0,-1,0,3
Algeria,2012-04-01,27,0,2,-16,4,17
Algeria,2012-04-01,6,0,0,25,0,31
Algeria,2012-04-01,6,0,0,15,1,22
Algeria,2012-04-01,8,0,0,-4,3,7
Algeria,2012-04-01,12,0,1,15,3,31
Algeria,2012-04-01,3,0,0,0,0,3
Algeria,2012-04-01,7,0,0,6,0,13
Algeria,2012-04-01,31,0,0,7,-1,37
Bangladesh,2012-04-01,12,0,0,15,0,27
Bangladesh,2012-04-01,17,0,0,3,1,21
Bangladesh,2012-04-01,19,0,0,3,2,24
Bangladesh,2012-04-01,9,0,0,3,4,16
Bangladesh,2012-04-01,5,0,0,0,4,9
Bangladesh,2012-04-01,6,0,0,-2,2,6
Bangladesh,2012-04-01,10,2,2,19,1,34
Bangladesh,2012-04-01,2,2,0,0,1,5
Bangladesh,2012-04-01,5,2,0,1,1,9
Bangladesh,2012-04-01,3,0,0,26,8,37
Bangladesh,2012-04-01,15,0,0,7,2,24
Bangladesh,2012-04-01,28,0,0,2,5,35
Bangladesh,2012-04-01,21,0,-4,24,2,43
Bangladesh,2012-04-01,20,0,-4,9,0,25
Bangladesh,2012-04-01,13,2,0,7,0,22
Bangladesh,2012-04-01,47,0,-2,24,5,74
Bangladesh,2012-04-01,32,0,-14,15,8,41
Bangladesh,2012-04-01,29,0,-6,13,2,38
Bangladesh,2012-04-01,29,0,0,4,9,42
Bangladesh,2012-04-01,7,0,0,7,2,16
Bangladesh,2012-04-01,33,0,-2,13,4,48
Bangladesh,2012-04-01,27,0,0,15,2,44
Bangladesh,2012-04-01,62,0,-2,4,2,66
Bangladesh,2012-04-01,34,0,0,6,0,40
Bangladesh,2012-04-01,16,0,0,-9,0,7
Bangladesh,2012-04-01,11,0,0,-3,0,8
Bangladesh,2012-04-01,9,0,0,8,0,17
Bangladesh,2012-04-01,9,0,0,8,5,22
Bangladesh,2012-04-01,22,0,-3,11,0,30
Bangladesh,2012-04-01,32,2,0,21,2,57
Cameroon,2012-04-01,0,0,0,0,0,0
Cameroon,2012-04-01,0,0,0,0,4,4
Cameroon,2012-04-01,5,0,0,1,3,9
Cameroon,2012-04-01,9,0,0,6,0,15
Cameroon,2012-04-01,6,0,0,0,0,6
Cameroon,2012-04-01,6,0,0,0,0,6
Cameroon,2012-04-01,3,0,0,0,0,3
Cameroon,2012-04-01,4,0,0,0,0,4
Cameroon,2012-04-01,0,0,0,0,0,0
Cameroon,2012-04-01,0,0,0,0,0,0
Cameroon,2012-04-01,9,0,0,0,0,9
Cameroon,2012-04-01,0,0,0,0,0,0
Cameroon,2012-04-01,0,0,0,0,0,0
Cameroon,2012-04-01,0,0,-2,0,0,-2
Cameroon,2012-04-01,0,0,0,0,0,0
Cameroon,2012-04-01,0,0,0,0,0,0
Cameroon,2012-04-01,0,0,0,0,0,0
Cameroon,2012-04-01,4,0,0,-4,0,0
Cameroon,2012-04-01,0,0,0,0,0,0
Cameroon,2012-04-01,3,0,0,0,0,3
Cameroon,2012-04-01,2,0,0,-4,0,-2
Cameroon,2012-04-01,0,0,0,0,0,0
Cameroon,2012-04-01,7,0,0,0,0,7
Cameroon,2012-04-01,2,0,0,0,0,2
Cameroon,2012-04-01,0,0,0,0,0,0
Cameroon,2012-04-01,2,0,0,0,0,2
Cameroon,2012-04-01,1,0,0,3,0,4
China,2012-04-01,76,4,0,38,9,127
China,2012-04-01,145,4,-2,40,25,212
China,2012-04-01,94,4,-14,83,21,188
China,2012-04-01,162,6,-1,65,9,241
China,2012-04-01,132,4,3,49,26,214
China,2012-04-01,121,2,-1,48,12,182
China,2012-04-01,133,2,1,27,6,169
China,2012-04-01,133,0,2,43,8,186
China,2012-04-01,187,0,-15,34,14,220
China,2012-04-01,136,6,-9,28,22,183
China,2012-04-01,165,2,5,59,14,245
China,2012-04-01,158,0,7,93,21,279
China,2012-04-01,168,2,2,51,19,242
China,2012-04-01,127,4,-3,37,25,190
China,2012-04-01,202,0,0,3,6,211
China,2012-04-01,87,4,3,31,29,154
China,2012-04-01,158,4,-13,65,26,240
China,2012-04-01,174,8,-10,43,8,223
China,2012-04-01,361,4,-16,146,35,530
China,2012-04-01,82,0,-4,38,8,124
China,2012-04-01,45,4,1,6,8,64
China,2012-04-01,141,0,-1,32,10,182
China,2012-04-01,208,6,-5,69,21,299
China,2012-04-01,98,2,-12,33,21,142
China,2012-04-01,182,2,2,64,21,271
China,2012-04-01,264,0,-3,101,32,394
China,2012-04-01,170,4,4,18,32,228
China,2012-04-01,88,0,1,22,18,129
China,2012-04-01,158,2,3,63,18,244
China,2012-04-01,176,4,3,78,34,295
Egypt,2012-04-01,25,0,-4,13,4,38
Egypt,2012-04-01,39,0,-1,33,20,91
Egypt,2012-04-01,61,2,0,13,6,82
Egypt,2012-04-01,30,0,0,36,15,81
Egypt,2012-04-01,131,0,0,43,22,196
Egypt,2012-04-01,39,2,-10,55,12,98
Egypt,2012-04-01,91,0,-6,64,10,159
Egypt,2012-04-01,108,0,-7,23,5,129
Egypt,2012-04-01,144,0,-19,46,23,194
Egypt,2012-04-01,80,0,-2,94,15,187
Egypt,2012-04-01,48,0,-10,44,11,93
Egypt,2012-04-01,54,0,-8,96,8,150
Egypt,2012-04-01,48,0,1,41,9,99
Egypt,2012-04-01,36,0,0,37,12,85
Egypt,2012-04-01,135,0,-12,90,16,229
Egypt,2012-04-01,42,0,-2,42,4,86
Egypt,2012-04-01,43,0,-7,73,11,120
Egypt,2012-04-01,67,4,-2,23,14,106
Egypt,2012-04-01,51,0,2,-8,11,56
Egypt,2012-04-01,30,0,-1,-3,1,27
Egypt,2012-04-01,65,0,-13,43,9,104
Egypt,2012-04-01,73,0,-8,22,15,102
Egypt,2012-04-01,130,0,-2,75,6,209
Egypt,2012-04-01,73,0,-3,142,8,220
Egypt,2012-04-01,62,0,1,93,6,162
Egypt,2012-04-01,51,0,0,37,13,101
Egypt,2012-04-01,49,0,0,50,21,120
Egypt,2012-04-01,64,0,-1,54,29,146
Egypt,2012-04-01,70,0,-9,68,25,154
Egypt,2012-04-01,86,0,-2,19,18,121
Eritrea,2012-04-01,3,0,0,3,4,10
Eritrea,2012-04-01,7,0,0,3,0,10
Eritrea,2012-04-01,2,0,0,0,0,2
Eritrea,2012-04-01,0,0,0,0,0,0
Eritrea,2012-04-01,0,0,-1,0,0,-1
Eritrea,2012-04-01,4,0,0,0,0,4
Eritrea,2012-04-01,0,0,0,0,0,0
Eritrea,2012-04-01,0,0,0,0,0,0
Eritrea,2012-04-01,0,0,-1,3,0,2
Eritrea,2012-04-01,0,0,0,0,0,0
Eritrea,2012-04-01,0,0,0,0,0,0
Eritrea,2012-04-01,0,0,0,0,0,0
Eritrea,2012-04-01,-5,0,0,0,0,-5
Eritrea,2012-04-01,-7,0,4,15,0,12
Eritrea,2012-04-01,0,0,3,3,0,6
Eritrea,2012-04-01,3,0,0,-2,0,1
Eritrea,2012-04-01,0,0,0,-2,0,-2
Eritrea,2012-04-01,4,0,0,0,2,6
Eritrea,2012-04-01,-1,0,0,0,0,-1
Eritrea,2012-04-01,0,0,0,0,0,0
Eritrea,2012-04-01,0,0,0,0,1,1
Eritrea,2012-04-01,11,0,0,-2,0,9
Eritrea,2012-04-01,2,0,0,12,0,14
Eritrea,2012-04-01,0,0,0,0,0,0
Eritrea,2012-04-01,0,0,0,0,0,0
Eritrea,2012-04-01,0,0,0,0,0,0
Georgia,2012-04-01,22,0,0,7,0,29
Georgia,2012-04-01,44,0,0,19,5,68
Georgia,2012-04-01,55,0,0,2,3,60
Georgia,2012-04-01,88,0,0,18,6,112
Georgia,2012-04-01,55,8,0,12,21,96
Georgia,2012-04-01,29,2,1,15,0,47
Georgia,2012-04-01,29,0,0,10,0,39
Georgia,2012-04-01,16,0,0,12,0,28
Georgia,2012-04-01,34,2,-1,22,7,64
Georgia,2012-04-01,67,0,0,32,4,103
Georgia,2012-04-01,24,0,0,28,2,54
Georgia,2012-04-01,16,0,0,15,2,33
Georgia,2012-04-01,33,0,0,20,11,64
Georgia,2012-04-01,-1,0,0,7,5,11
Georgia,2012-04-01,10,4,0,4,2,20
Georgia,2012-04-01,28,0,0,5,3,36
Georgia,2012-04-01,60,0,-1,34,15,108
Georgia,2012-04-01,42,2,-1,38,6,87
Georgia,2012-04-01,66,2,0,32,2,102
Georgia,2012-04-01,5,4,0,0,0,9
Georgia,2012-04-01,14,6,1,0,1,22
Georgia,2012-04-01,15,2,0,3,2,22
Georgia,2012-04-01,33,0,-1,21,1,54
Georgia,2012-04-01,70,0,0,33,1,104
Georgia,2012-04-01,50,6,0,29,3,88
Georgia,2012-04-01,73,0,0,36,5,114
Georgia,2012-04-01,40,0,-2,45,8,91
Georgia,2012-04-01,11,0,1,9,22,43
Georgia,2012-04-01,3,0,0,3,6,12
Georgia,2012-04-01,40,0,-4,53,10,99
India,2012-04-01,37,6,0,12,4,59
India,2012-04-01,96,2,-8,4,12,106
India,2012-04-01,70,6,-1,1,20,96
India,2012-04-01,86,0,3,33,10,132
India,2012-04-01,34,0,-4,26,18,74
India,2012-04-01,54,2,0,12,8,76
India,2012-04-01,93,2,1,26,11,133
India,2012-04-01,60,2,-2,14,2,76
India,2012-04-01,117,0,1,56,19,193
India,2012-04-01,57,2,-8,24,17,92
India,2012-04-01,69,0,0,26,5,100
India,2012-04-01,69,0,0,21,17,107
India,2012-04-01,44,2,0,16,17,79
India,2012-04-01,42,0,-1,9,7,57
India,2012-04-01,81,0,0,21,11,113
India,2012-04-01,100,0,-6,16,19,129
India,2012-04-01,72,2,3,9,6,92
India,2012-04-01,106,4,-5,4,28,137
India,2012-04-01,170,2,3,27,34,236
India,2012-04-01,67,0,1,49,10,127
India,2012-04-01,79,0,-4,29,17,121
India,2012-04-01,89,0,-3,47,12,145
India,2012-04-01,69,0,2,-2,11,80
India,2012-04-01,40,4,-5,14,9,62
India,2012-04-01,120,4,-4,46,13,179
India,2012-04-01,106,0,0,57,14,177
India,2012-04-01,69,2,0,40,15,126
India,2012-04-01,40,0,-1,22,7,68
India,2012-04-01,56,0,0,28,11,95
India,2012-04-01,73,4,-1,30,15,121
Iran,2012-04-01,65,0,-1,38,19,121
Iran,2012-04-01,107,0,2,69,14,192
Iran,2012-04-01,138,4,3,115,17,277
Iran,2012-04-01,133,0,7,90,15,245
Iran,2012-04-01,163,0,4,59,25,251
Iran,2012-04-01,74,0,0,45,15,134
Iran,2012-04-01,54,0,1,27,9,91
Iran,2012-04-01,153,0,-3,70,13,233
Iran,2012-04-01,153,0,-8,33,15,193
Iran,2012-04-01,71,0,-4,70,21,158
Iran,2012-04-01,122,2,4,33,14,175
Iran,2012-04-01,102,2,1,12,5,122
Iran,2012-04-01,73,2,6,35,14,130
Iran,2012-04-01,80,0,1,13,16,110
Iran,2012-04-01,119,0,-4,30,6,151
Iran,2012-04-01,104,1,3,36,7,151
Iran,2012-04-01,75,2,-3,21,8,103
Iran,2012-04-01,85,0,4,60,18,167
Iran,2012-04-01,117,2,6,31,15,171
Iran,2012-04-01,26,0,0,-13,6,19
Iran,2012-04-01,45,0,0,3,2,50
Iran,2012-04-01,93,0,1,65,5,164
Iran,2012-04-01,121,2,1,28,9,161
Iran,2012-04-01,117,0,-3,17,8,139
Iran,2012-04-01,119,2,0,42,12,175
Iran,2012-04-01,124,0,0,46,18,188
Iran,2012-04-01,184,1,-1,48,23,255
Iran,2012-04-01,97,0,-3,22,10,126
Iran,2012-04-01,93,0,1,57,12,163
Iran,2012-04-01,117,0,-10,48,9,164
Iraq,2012-04-01,31,4,0,16,3,54
Iraq,2012-04-01,85,0,2,28,10,125
Iraq,2012-04-01,77,0,1,6,5,89
Iraq,2012-04-01,82,0,-4,25,6,109
Iraq,2012-04-01,112,0,3,13,27,155
Iraq,2012-04-01,51,0,-2,9,36,94
Iraq,2012-04-01,77,0,0,44,37,158
Iraq,2012-04-01,48,2,0,8,11,69
Iraq,2012-04-01,48,6,0,33,10,97
Iraq,2012-04-01,91,0,0,42,7,140
Iraq,2012-04-01,65,4,0,12,4,85
Iraq,2012-04-01,60,0,0,16,6,82
Iraq,2012-04-01,58,0,0,24,19,101
Iraq,2012-04-01,42,2,0,8,10,62
Iraq,2012-04-01,62,4,-2,-1,4,67
Iraq,2012-04-01,71,0,0,11,3,85
Iraq,2012-04-01,91,0,-2,49,9,147
Iraq,2012-04-01,67,0,0,34,0,101
Iraq,2012-04-01,72,2,-1,54,6,133
Iraq,2012-04-01,97,0,0,23,10,130
Iraq,2012-04-01,53,0,0,5,12,70
Iraq,2012-04-01,45,2,2,33,6,88
Iraq,2012-04-01,69,0,1,11,2,83
Iraq,2012-04-01,99,0,-3,46,10,152
Iraq,2012-04-01,179,2,1,65,10,257
Iraq,2012-04-01,100,4,1,38,15,158
Iraq,2012-04-01,111,6,1,61,16,195
Iraq,2012-04-01,82,2,2,6,8,100
Iraq,2012-04-01,88,0,0,12,5,105
Iraq,2012-04-01,167,0,-1,33,17,216
Morocco,2012-04-01,2,0,0,0,2,4
Morocco,2012-04-01,4,2,0,3,4,13
Morocco,2012-04-01,12,0,0,12,1,25
Morocco,2012-04-01,12,0,0,3,4,19
Morocco,2012-04-01,2,0,-4,3,6,7
Morocco,2012-04-01,2,0,0,0,3,5
Morocco,2012-04-01,2,0,0,18,0,20
Morocco,2012-04-01,3,0,0,1,4,8
Morocco,2012-04-01,10,0,-2,8,0,16
Morocco,2012-04-01,1,0,0,6,1,8
Morocco,2012-04-01,20,0,-2,7,2,27
Morocco,2012-04-01,15,2,0,13,11,41
Morocco,2012-04-01,2,0,1,9,2,14
Morocco,2012-04-01,9,0,0,10,4,23
Morocco,2012-04-01,3,0,0,3,0,6
Morocco,2012-04-01,16,0,0,-3,5,18
Morocco,2012-04-01,19,0,0,6,1,26
Morocco,2012-04-01,27,0,0,9,17,53
Morocco,2012-04-01,7,0,0,6,4,17
Morocco,2012-04-01,5,4,0,0,0,9
Morocco,2012-04-01,6,2,0,0,2,10
Morocco,2012-04-01,4,0,0,-2,2,4
Morocco,2012-04-01,-5,0,0,6,0,1
Morocco,2012-04-01,8,0,0,12,2,22
Morocco,2012-04-01,2,0,0,0,2,4
Morocco,2012-04-01,10,0,0,6,5,21
Morocco,2012-04-01,20,0,0,15,2,37
Morocco,2012-04-01,11,0,1,19,0,31
Morocco,2012-04-01,9,0,0,-1,1,9
Morocco,2012-04-01,1,0,0,0,0,1
Nigeria,2012-04-01,11,0,0,5,6,22
Nigeria,2012-04-01,46,2,1,7,10,66
Nigeria,2012-04-01,71,0,0,32,0,103
Nigeria,2012-04-01,53,0,-6,9,6,62
Nigeria,2012-04-01,32,0,1,25,10,68
Nigeria,2012-04-01,2,0,-2,3,0,3
Nigeria,2012-04-01,12,0,-16,0,1,-3
Nigeria,2012-04-01,49,0,-6,9,4,56
Nigeria,2012-04-01,53,0,0,9,3,65
Nigeria,2012-04-01,15,0,0,11,3,29
Nigeria,2012-04-01,21,0,1,14,1,37
Nigeria,2012-04-01,19,0,2,42,4,67
Nigeria,2012-04-01,25,2,0,27,7,61
Nigeria,2012-04-01,21,0,0,9,0,30
Nigeria,2012-04-01,46,0,-2,0,4,48
Nigeria,2012-04-01,54,0,-5,20,2,71
Nigeria,2012-04-01,48,0,-6,34,3,79
Nigeria,2012-04-01,27,2,-1,-6,3,25
Nigeria,2012-04-01,25,0,0,47,3,75
Nigeria,2012-04-01,13,0,1,12,0,26
Nigeria,2012-04-01,11,0,0,3,1,15
Nigeria,2012-04-01,30,0,0,36,3,69
Nigeria,2012-04-01,31,2,3,49,0,85
Nigeria,2012-04-01,32,0,0,39,7,78
Nigeria,2012-04-01,48,4,-2,39,3,92
Nigeria,2012-04-01,72,0,-4,106,6,180
Nigeria,2012-04-01,41,0,2,40,7,90
Nigeria,2012-04-01,9,0,0,6,1,16
Nigeria,2012-04-01,-7,0,1,9,1,4
Nigeria,2012-04-01,58,0,0,15,15,88
Pakistan,2012-04-01,35,4,0,9,10,58
Pakistan,2012-04-01,70,6,0,15,4,95
Pakistan,2012-04-01,61,8,0,46,10,125
Pakistan,2012-04-01,83,0,0,127,30,240
Pakistan,2012-04-01,106,0,-2,86,11,201
Pakistan,2012-04-01,82,0,-6,58,15,149
Pakistan,2012-04-01,48,4,-1,19,10,80
Pakistan,2012-04-01,81,0,0,46,8,135
Pakistan,2012-04-01,61,2,-1,25,5,92
Pakistan,2012-04-01,49,2,2,15,19,87
Pakistan,2012-04-01,49,0,0,30,17,96
Pakistan,2012-04-01,83,0,-4,64,3,146
Pakistan,2012-04-01,73,0,0,41,1,115
Pakistan,2012-04-01,95,0,-2,23,12,128
Pakistan,2012-04-01,128,0,0,45,11,184
Pakistan,2012-04-01,122,2,0,25,20,169
Pakistan,2012-04-01,133,0,-4,44,12,185
Pakistan,2012-04-01,113,0,0,53,21,187
Pakistan,2012-04-01,98,2,3,25,1,129
Pakistan,2012-04-01,33,0,-1,28,3,63
Pakistan,2012-04-01,60,4,1,27,0,92
Pakistan,2012-04-01,53,0,0,25,11,89
Pakistan,2012-04-01,105,2,0,58,18,183
Pakistan,2012-04-01,44,0,1,24,15,84
Pakistan,2012-04-01,110,0,-7,64,5,172
Pakistan,2012-04-01,201,0,-29,280,19,471
Pakistan,2012-04-01,156,0,-24,113,15,260
Pakistan,2012-04-01,125,0,-19,49,13,168
Pakistan,2012-04-01,302,0,-3,245,31,575
Pakistan,2012-04-01,342,2,-7,150,31,518
Sierra Leone,2012-04-01,1,2,0,0,0,3
Sierra Leone,2012-04-01,0,0,0,3,0,3
Sierra Leone,2012-04-01,0,0,0,4,1,5
Sierra Leone,2012-04-01,18,0,0,0,0,18
Sierra Leone,2012-04-01,16,0,0,7,0,23
Sierra Leone,2012-04-01,8,0,0,0,0,8
Sierra Leone,2012-04-01,1,0,0,0,0,1
Sierra Leone,2012-04-01,0,0,0,0,0,0
Sierra Leone,2012-04-01,0,0,0,0,0,0
Sierra Leone,2012-04-01,0,0,0,0,0,0
Sierra Leone,2012-04-01,7,0,0,0,0,7
Sierra Leone,2012-04-01,8,0,0,0,2,10
Sierra Leone,2012-04-01,0,0,0,0,0,0
Sierra Leone,2012-04-01,0,0,0,-1,0,-1
Sierra Leone,2012-04-01,0,0,0,0,0,0
Sierra Leone,2012-04-01,6,0,1,0,0,7
Sierra Leone,2012-04-01,1,0,1,21,0,23
Sierra Leone,2012-04-01,8,0,0,24,2,34
Sierra Leone,2012-04-01,4,0,0,0,0,4
Sierra Leone,2012-04-01,0,0,0,-4,1,-3
Sierra Leone,2012-04-01,0,0,0,0,0,0
Sierra Leone,2012-04-01,1,0,-6,12,0,7
Sierra Leone,2012-04-01,3,0,0,3,0,6
Sierra Leone,2012-04-01,2,0,0,0,0,2
Sierra Leone,2012-04-01,27,0,0,21,7,55
Sierra Leone,2012-04-01,120,0,-3,370,33,520
Sierra Leone,2012-04-01,57,0,0,87,7,151
Sierra Leone,2012-04-01,7,0,0,45,4,56
Sierra Leone,2012-04-01,3,0,0,11,4,18
Sierra Leone,2012-04-01,3,0,0,21,2,26
Somalia,2012-04-01,75,2,-2,21,9,105
Somalia,2012-04-01,116,0,0,31,5,152
Somalia,2012-04-01,92,0,-4,26,16,130
Somalia,2012-04-01,54,0,-1,41,17,111
Somalia,2012-04-01,82,0,-2,37,5,122
Somalia,2012-04-01,84,0,-1,27,3,113
Somalia,2012-04-01,58,0,0,16,3,77
Somalia,2012-04-01,42,2,0,16,8,68
Somalia,2012-04-01,74,0,0,35,6,115
Somalia,2012-04-01,70,2,0,6,16,94
Somalia,2012-04-01,43,0,-1,39,6,87
Somalia,2012-04-01,82,0,-5,49,8,134
Somalia,2012-04-01,59,2,-2,39,7,105
Somalia,2012-04-01,41,0,-2,5,5,49
Somalia,2012-04-01,38,0,1,16,6,61
Somalia,2012-04-01,92,4,0,27,8,131
Somalia,2012-04-01,84,0,-3,-4,7,84
Somalia,2012-04-01,95,0,-4,-22,4,73
Somalia,2012-04-01,120,0,1,21,8,150
Somalia,2012-04-01,41,0,0,-4,1,38
Somalia,2012-04-01,77,2,-1,27,16,121
Somalia,2012-04-01,27,0,-1,17,4,47
Somalia,2012-04-01,131,0,3,2,14,150
Somalia,2012-04-01,54,0,-4,5,10,65
Somalia,2012-04-01,74,0,0,26,9,109
Somalia,2012-04-01,94,0,-5,68,7,164
Somalia,2012-04-01,152,10,-1,73,15,249
Somalia,2012-04-01,69,0,-2,70,1,138
Somalia,2012-04-01,181,0,-2,11,15,205
Somalia,2012-04-01,125,0,0,66,13,204
Syria,2012-04-01,245,2,-10,10,15,262
Syria,2012-04-01,241,0,-11,6,18,254
Syria,2012-04-01,125,0,-5,20,28,168
Syria,2012-04-01,134,2,-11,11,19,155
Syria,2012-04-01,171,2,-8,-11,37,191
Syria,2012-04-01,138,2,-5,6,21,162
Syria,2012-04-01,148,0,-7,8,13,162
Syria,2012-04-01,114,0,1,2,22,139
Syria,2012-04-01,640,20,-1,26,58,743
Syria,2012-04-01,329,22,2,12,30,395
Syria,2012-04-01,242,8,2,17,35,304
Syria,2012-04-01,248,2,1,22,32,305
Syria,2012-04-01,202,0,3,17,26,248
Syria,2012-04-01,205,2,5,28,25,265
Syria,2012-04-01,154,2,1,39,20,216
Syria,2012-04-01,278,0,4,23,21,326
Syria,2012-04-01,197,2,0,29,33,261
Syria,2012-04-01,200,0,-2,46,39,283
Syria,2012-04-01,169,4,-12,29,20,210
Syria,2012-04-01,130,2,-7,17,30,172
Syria,2012-04-01,193,0,1,-2,28,220
Syria,2012-04-01,161,6,-6,4,11,176
Syria,2012-04-01,167,4,0,102,55,328
Syria,2012-04-01,178,0,2,74,15,269
Syria,2012-04-01,148,2,-3,45,13,205
Syria,2012-04-01,218,2,5,52,16,293
Syria,2012-04-01,186,4,3,30,16,239
Syria,2012-04-01,80,0,-2,24,18,120
Syria,2012-04-01,114,0,-6,35,22,165
Syria,2012-04-01,127,1,-9,10,23,152
Yemen,2012-04-01,9,0,1,3,0,13
Yemen,2012-04-01,48,0,-2,46,0,92
Yemen,2012-04-01,30,0,-4,7,1,34
Yemen,2012-04-01,32,0,0,27,0,59
Yemen,2012-04-01,31,0,0,6,0,37
Yemen,2012-04-01,16,0,0,7,11,34
Yemen,2012-04-01,65,0,-4,33,6,100
Yemen,2012-04-01,5,0,-4,12,0,13
Yemen,2012-04-01,33,0,0,18,2,53
Yemen,2012-04-01,43,0,-2,92,12,145
Yemen,2012-04-01,27,0,4,21,0,52
Yemen,2012-04-01,41,0,-1,14,1,55
Yemen,2012-04-01,21,0,0,17,4,42
Yemen,2012-04-01,45,0,0,13,7,65
Yemen,2012-04-01,7,0,0,0,11,18
Yemen,2012-04-01,14,0,0,10,0,24
Yemen,2012-04-01,44,0,2,48,3,97
Yemen,2012-04-01,62,0,1,11,6,80
Yemen,2012-04-01,53,0,0,7,3,63
Yemen,2012-04-01,9,0,0,6,0,15
Yemen,2012-04-01,45,0,0,9,4,58
Yemen,2012-04-01,31,0,0,39,4,74
Yemen,2012-04-01,21,0,0,2,1,24
Yemen,2012-04-01,14,0,-4,9,4,23
Yemen,2012-04-01,10,0,0,3,24,37
Yemen,2012-04-01,105,0,-4,17,18,136
Yemen,2012-04-01,55,0,-1,45,10,109
Yemen,2012-04-01,42,0,-6,0,8,44
Yemen,2012-04-01,118,0,0,-5,4,117
Yemen,2012-04-01,107,0,-4,-2,10,111
Afghanistan,2009-07-01,94,6,0,22,6,128
Afghanistan,2009-07-01,207,0,0,20,16,243
Afghanistan,2009-07-01,261,4,-2,13,26,302
Afghanistan,2009-07-01,92,0,-5,39,13,139
Afghanistan,2009-07-01,139,0,1,39,7,186
Afghanistan,2009-07-01,160,2,-2,51,30,241
Afghanistan,2009-07-01,163,0,-4,18,18,195
Afghanistan,2009-07-01,152,0,0,22,7,181
Afghanistan,2009-07-01,114,4,0,17,30,165
Afghanistan,2009-07-01,275,0,0,26,25,326
Afghanistan,2009-07-01,201,2,-1,28,2,232
Afghanistan,2009-07-01,146,0,0,21,11,178
Afghanistan,2009-07-01,221,2,-5,26,8,252
Afghanistan,2009-07-01,331,0,0,26,16,373
Afghanistan,2009-07-01,286,0,-3,39,6,328
Afghanistan,2009-07-01,202,2,-1,28,8,239
Afghanistan,2009-07-01,212,0,0,28,23,263
Afghanistan,2009-07-01,111,0,0,35,20,166
Afghanistan,2009-07-01,180,0,-2,26,14,218
Afghanistan,2009-07-01,189,0,0,33,16,238
Afghanistan,2009-07-01,103,0,-4,19,10,128
Afghanistan,2009-07-01,229,0,-4,121,12,358
Afghanistan,2009-07-01,185,2,2,28,17,234
Afghanistan,2009-07-01,378,0,0,36,9,423
Afghanistan,2009-07-01,197,2,0,38,19,256
Afghanistan,2009-07-01,143,6,0,58,8,215
Afghanistan,2009-07-01,366,4,0,43,17,430
Afghanistan,2009-07-01,317,2,-2,86,27,430
Afghanistan,2009-07-01,256,0,1,47,22,326
Afghanistan,2009-07-01,355,0,0,123,21,499
Afghanistan,2009-07-01,493,6,2,119,39,659
Albania,2009-07-01,5,0,0,-2,0,3
Albania,2009-07-01,0,0,0,0,0,0
Albania,2009-07-01,0,0,0,0,0,0
Albania,2009-07-01,2,0,0,-2,0,0
Albania,2009-07-01,0,0,0,1,0,1
Albania,2009-07-01,5,0,0,0,1,6
Albania,2009-07-01,0,0,0,0,0,0
Albania,2009-07-01,-2,0,0,13,0,11
Albania,2009-07-01,9,0,0,15,0,24
Albania,2009-07-01,2,0,0,3,0,5
Albania,2009-07-01,0,0,0,0,0,0
Albania,2009-07-01,0,0,0,1,0,1
Albania,2009-07-01,19,0,0,1,0,20
Albania,2009-07-01,9,0,-2,3,2,12
Albania,2009-07-01,1,0,0,6,0,7
Albania,2009-07-01,14,0,0,-6,0,8
Albania,2009-07-01,-1,0,0,0,0,-1
Albania,2009-07-01,9,0,0,1,5,15
Albania,2009-07-01,-1,2,0,0,0,1
Albania,2009-07-01,-1,0,2,-4,0,-3
Albania,2009-07-01,6,0,0,-2,0,4
Albania,2009-07-01,10,0,0,0,0,10
Albania,2009-07-01,8,0,0,15,0,23
Albania,2009-07-01,-1,0,0,31,0,30
Albania,2009-07-01,4,0,-2,0,0,2
Albania,2009-07-01,2,0,0,0,0,2
Albania,2009-07-01,2,0,0,1,0,3
Albania,2009-07-01,6,0,0,3,1,10
Albania,2009-07-01,2,0,0,0,0,2
Albania,2009-07-01,-5,0,0,12,2,9
Albania,2009-07-01,6,0,0,-2,3,7
Algeria,2009-07-01,6,0,0,-2,2,6
Algeria,2009-07-01,10,0,0,0,0,10
Algeria,2009-07-01,-27,0,-1,3,3,-22
Algeria,2009-07-01,-16,0,0,0,1,-15
Algeria,2009-07-01,1,0,1,-2,0,0
Algeria,2009-07-01,1,0,0,3,0,4
Algeria,2009-07-01,15,0,0,3,0,18
Algeria,2009-07-01,7,0,0,0,0,7
Algeria,2009-07-01,0,0,0,0,0,0
Algeria,2009-07-01,2,0,0,12,0,14
Algeria,2009-07-01,0,0,0,3,0,3
Algeria,2009-07-01,7,0,0,3,0,10
Algeria,2009-07-01,23,0,0,3,0,26
Algeria,2009-07-01,50,0,0,-4,2,48
Algeria,2009-07-01,13,0,0,0,0,13
Algeria,2009-07-01,3,0,0,0,3,6
Algeria,2009-07-01,2,0,1,0,0,3
Algeria,2009-07-01,8,0,0,-6,0,2
Algeria,2009-07-01,5,0,0,-4,0,1
Algeria,2009-07-01,17,0,0,0,0,17
Algeria,2009-07-01,40,0,0,10,2,52
Algeria,2009-07-01,6,0,0,6,2,14
Algeria,2009-07-01,12,0,0,0,0,12
Algeria,2009-07-01,21,0,0,-4,0,17
Algeria,2009-07-01,4,0,0,0,0,4
Algeria,2009-07-01,0,0,0,3,0,3
Algeria,2009-07-01,7,0,0,-4,0,3
Algeria,2009-07-01,-3,0,0,10,0,7
Algeria,2009-07-01,3,0,0,-3,0,0
Algeria,2009-07-01,2,0,0,0,0,2
Algeria,2009-07-01,1,0,0,3,0,4
Bangladesh,2009-07-01,-5,0,0,15,0,10
Bangladesh,2009-07-01,9,0,0,0,0,9
Bangladesh,2009-07-01,6,0,0,6,0,12
Bangladesh,2009-07-01,-1,0,0,0,1,0
Bangladesh,2009-07-01,2,0,0,0,4,6
Bangladesh,2009-07-01,0,0,0,3,0,3
Bangladesh,2009-07-01,6,2,0,6,0,14
Bangladesh,2009-07-01,1,2,0,3,0,6
Bangladesh,2009-07-01,6,0,0,0,1,7
Bangladesh,2009-07-01,2,0,0,3,0,5
Bangladesh,2009-07-01,12,0,0,3,0,15
Bangladesh,2009-07-01,12,0,0,-2,0,10
Bangladesh,2009-07-01,11,2,0,3,2,18
Bangladesh,2009-07-01,3,0,0,3,0,6
Bangladesh,2009-07-01,2,0,0,0,5,7
Bangladesh,2009-07-01,7,0,0,0,0,7
Bangladesh,2009-07-01,7,0,1,0,1,9
Bangladesh,2009-07-01,-14,0,-1,15,0,0
Bangladesh,2009-07-01,2,0,0,6,2,10
Bangladesh,2009-07-01,2,0,0,0,2,4
Bangladesh,2009-07-01,4,0,0,-2,0,2
Bangladesh,2009-07-01,12,0,0,-2,5,15
Bangladesh,2009-07-01,-8,0,0,-26,0,-34
Bangladesh,2009-07-01,15,0,0,4,0,19
Bangladesh,2009-07-01,22,0,0,15,0,37
Bangladesh,2009-07-01,22,0,0,4,1,27
Bangladesh,2009-07-01,11,0,-2,-1,2,10
Bangladesh,2009-07-01,12,0,0,0,1,13
Bangladesh,2009-07-01,9,0,0,-12,1,-2
Bangladesh,2009-07-01,17,0,0,9,2,28
Bangladesh,2009-07-01,16,2,0,4,5,27
Cameroon,2009-07-01,-1,0,0,0,0,-1
Cameroon,2009-07-01,0,0,0,0,0,0
Cameroon,2009-07-01,3,0,0,0,0,3
Cameroon,2009-07-01,3,0,0,0,0,3
Cameroon,2009-07-01,0,0,0,-2,0,-2
Cameroon,2009-07-01,0,0,0,0,0,0
Cameroon,2009-07-01,0,0,0,0,0,0
Cameroon,2009-07-01,2,0,0,0,0,2
Cameroon,2009-07-01,0,0,0,0,0,0
Cameroon,2009-07-01,0,0,0,0,0,0
Cameroon,2009-07-01,0,0,0,0,0,0
Cameroon,2009-07-01,6,0,0,3,0,9
Cameroon,2009-07-01,7,0,0,0,0,7
Cameroon,2009-07-01,2,0,0,0,0,2
Cameroon,2009-07-01,0,0,0,0,0,0
Cameroon,2009-07-01,-1,0,0,0,0,-1
Cameroon,2009-07-01,2,0,0,0,0,2
Cameroon,2009-07-01,0,0,0,6,0,6
Cameroon,2009-07-01,0,0,0,0,0,0
Cameroon,2009-07-01,0,0,0,0,0,0
Cameroon,2009-07-01,-1,0,0,3,0,2
Cameroon,2009-07-01,0,0,0,0,0,0
Cameroon,2009-07-01,0,0,0,0,0,0
Cameroon,2009-07-01,15,0,0,0,4,19
Cameroon,2009-07-01,3,0,0,0,0,3
Cameroon,2009-07-01,0,0,0,0,0,0
Cameroon,2009-07-01,3,0,0,0,0,3
Cameroon,2009-07-01,6,0,0,6,0,12
China,2009-07-01,39,2,0,37,17,95
China,2009-07-01,69,0,-5,17,11,92
China,2009-07-01,68,0,0,39,2,109
China,2009-07-01,39,0,2,-2,4,43
China,2009-07-01,106,0,0,18,15,139
China,2009-07-01,201,0,1,102,68,372
China,2009-07-01,209,0,2,197,65,473
China,2009-07-01,184,0,-1,97,66,346
China,2009-07-01,97,4,-2,61,34,194
China,2009-07-01,124,2,7,78,50,261
China,2009-07-01,100,0,0,42,23,165
China,2009-07-01,68,2,0,22,23,115
China,2009-07-01,218,2,-2,15,84,317
China,2009-07-01,129,0,6,58,16,209
China,2009-07-01,52,0,-4,94,16,158
China,2009-07-01,94,4,-1,163,15,275
China,2009-07-01,107,2,1,90,17,217
China,2009-07-01,91,0,0,36,3,130
China,2009-07-01,105,0,3,42,21,171
China,2009-07-01,90,6,0,70,17,183
China,2009-07-01,42,2,3,17,8,72
China,2009-07-01,60,0,2,37,19,118
China,2009-07-01,68,0,2,40,9,119
China,2009-07-01,127,0,0,67,33,227
China,2009-07-01,89,0,-1,42,13,143
China,2009-07-01,70,0,-2,40,14,122
China,2009-07-01,168,0,-3,48,23,236
China,2009-07-01,173,2,-3,83,32,287
China,2009-07-01,158,8,-8,94,33,285
China,2009-07-01,159,2,-1,91,27,278
China,2009-07-01,107,6,0,83,23,219
Egypt,2009-07-01,14,0,0,25,3,42
Egypt,2009-07-01,23,4,0,14,1,42
Egypt,2009-07-01,11,0,0,3,0,14
Egypt,2009-07-01,6,0,0,-4,0,2
Egypt,2009-07-01,18,0,0,6,2,26
Egypt,2009-07-01,34,0,0,36,1,71
Egypt,2009-07-01,18,0,-6,5,0,17
Egypt,2009-07-01,18,0,0,6,0,24
Egypt,2009-07-01,28,0,0,21,4,53
Egypt,2009-07-01,21,0,0,-6,3,18
Egypt,2009-07-01,29,0,0,3,0,32
Egypt,2009-07-01,18,0,-4,19,0,33
Egypt,2009-07-01,59,0,0,14,0,73
Egypt,2009-07-01,26,0,0,26,7,59
Egypt,2009-07-01,4,0,0,11,3,18
Egypt,2009-07-01,16,0,0,18,0,34
Egypt,2009-07-01,28,0,-2,3,4,33
Egypt,2009-07-01,30,0,0,12,3,45
Egypt,2009-07-01,28,0,0,13,0,41
Egypt,2009-07-01,15,0,0,3,2,20
Egypt,2009-07-01,19,0,0,4,0,23
Egypt,2009-07-01,14,0,-2,6,1,19
Egypt,2009-07-01,32,0,-3,6,0,35
Egypt,2009-07-01,9,0,-4,8,3,16
Egypt,2009-07-01,11,0,1,15,1,28
Egypt,2009-07-01,23,0,0,12,3,38
Egypt,2009-07-01,25,0,0,12,2,39
Egypt,2009-07-01,41,0,0,29,3,73
Egypt,2009-07-01,11,0,0,3,2,16
Egypt,2009-07-01,30,0,0,27,7,64
Egypt,2009-07-01,48,0,0,25,0,73
Eritrea,2009-07-01,6,0,0,3,1,10
Eritrea,2009-07-01,0,0,0,0,0,0
Eritrea,2009-07-01,0,0,0,0,0,0
Eritrea,2009-07-01,1,0,0,0,0,1
Eritrea,2009-07-01,0,0,0,0,1,1
Eritrea,2009-07-01,13,0,0,0,0,13
Eritrea,2009-07-01,1,0,0,-6,0,-5
Eritrea,2009-07-01,3,0,0,0,2,5
Eritrea,2009-07-01,21,0,0,0,2,23
Eritrea,2009-07-01,39,0,0,0,0,39
Eritrea,2009-07-01,3,0,0,0,0,3
Eritrea,2009-07-01,24,0,0,0,0,24
Eritrea,2009-07-01,9,0,0,0,0,9
Eritrea,2009-07-01,6,0,0,0,0,6
Eritrea,2009-07-01,0,0,0,0,0,0
Eritrea,2009-07-01,6,0,0,9,0,15
Eritrea,2009-07-01,0,0,0,0,0,0
Eritrea,2009-07-01,0,0,0,0,0,0
Eritrea,2009-07-01,0,0,0,0,5,5
Eritrea,2009-07-01,4,0,0,0,2,6
Eritrea,2009-07-01,0,0,0,-2,0,-2
Eritrea,2009-07-01,0,0,0,-6,0,-6
Eritrea,2009-07-01,2,0,0,0,0,2
Eritrea,2009-07-01,0,0,0,0,0,0
Eritrea,2009-07-01,3,0,0,0,0,3
Eritrea,2009-07-01,5,0,0,0,0,5
Eritrea,2009-07-01,3,0,0,0,0,3
Eritrea,2009-07-01,16,0,1,0,0,17
Georgia,2009-07-01,7,0,0,-3,0,4
Georgia,2009-07-01,15,0,1,11,0,27
Georgia,2009-07-01,1,0,0,3,0,4
Georgia,2009-07-01,0,0,0,0,2,2
Georgia,2009-07-01,1,0,0,0,0,1
Georgia,2009-07-01,6,0,0,4,0,10
Georgia,2009-07-01,3,0,0,0,1,4
Georgia,2009-07-01,15,0,0,0,0,15
Georgia,2009-07-01,26,0,0,0,1,27
Georgia,2009-07-01,15,0,0,3,0,18
Georgia,2009-07-01,1,0,0,-4,0,-3
Georgia,2009-07-01,1,0,0,0,0,1
Georgia,2009-07-01,13,0,0,3,0,16
Georgia,2009-07-01,10,0,0,9,0,19
Georgia,2009-07-01,2,0,0,-2,0,0
Georgia,2009-07-01,8,0,0,-6,0,2
Georgia,2009-07-01,1,0,0,6,0,7
Georgia,2009-07-01,0,0,0,0,0,0
Georgia,2009-07-01,3,0,0,0,0,3
Georgia,2009-07-01,-3,0,0,0,2,-1
Georgia,2009-07-01,4,0,-2,0,0,2
Georgia,2009-07-01,1,0,0,0,4,5
Georgia,2009-07-01,12,0,0,4,2,18
Georgia,2009-07-01,2,0,1,3,5,11
Georgia,2009-07-01,10,0,0,0,2,12
Georgia,2009-07-01,6,0,0,0,3,9
Georgia,2009-07-01,11,0,0,9,6,26
Georgia,2009-07-01,16,0,-1,3,4,22
Georgia,2009-07-01,31,0,2,-3,1,31
Georgia,2009-07-01,28,0,0,5,1,34
Georgia,2009-07-01,10,0,-1,16,1,26
India,2009-07-01,25,0,0,4,2,31
India,2009-07-01,23,0,2,3,1,29
India,2009-07-01,21,0,0,3,2,26
India,2009-07-01,4,0,0,-3,2,3
India,2009-07-01,19,0,0,0,3,22
India,2009-07-01,31,0,-4,3,3,33
India,2009-07-01,20,0,0,16,5,41
India,2009-07-01,30,0,0,2,3,35
India,2009-07-01,18,0,-2,4,4,24
India,2009-07-01,5,0,0,7,3,15
India,2009-07-01,30,0,1,15,0,46
India,2009-07-01,20,0,0,2,11,33
India,2009-07-01,33,2,0,3,5,43
India,2009-07-01,36,0,0,8,5,49
India,2009-07-01,20,0,0,-2,3,21
India,2009-07-01,32,0,0,0,7,39
India,2009-07-01,13,0,0,5,1,19
India,2009-07-01,32,0,0,0,0,32
India,2009-07-01,32,0,0,-8,4,28
India,2009-07-01,6,0,0,1,2,9
India,2009-07-01,25,0,0,7,4,36
India,2009-07-01,36,0,0,-4,0,32
India,2009-07-01,32,0,0,1,2,35
India,2009-07-01,48,0,-1,8,2,57
India,2009-07-01,27,0,0,27,1,55
India,2009-07-01,45,2,3,13,7,70
India,2009-07-01,37,2,1,3,3,46
India,2009-07-01,52,2,-5,1,9,59
India,2009-07-01,5,0,0,5,2,12
India,2009-07-01,46,0,0,7,4,57
India,2009-07-01,48,0,-9,11,13,63
Iran,2009-07-01,72,0,8,35,7,122
Iran,2009-07-01,61,0,-1,23,4,87
Iran,2009-07-01,80,0,-1,33,4,116
Iran,2009-07-01,55,0,1,37,7,100
Iran,2009-07-01,46,0,2,25,11,84
Iran,2009-07-01,73,2,1,-4,9,81
Iran,2009-07-01,71,0,-1,3,7,80
Iran,2009-07-01,53,0,0,37,2,92
Iran,2009-07-01,69,0,-2,19,3,89
Iran,2009-07-01,45,0,0,54,2,101
Iran,2009-07-01,15,0,1,45,1,62
Iran,2009-07-01,32,2,1,23,3,61
Iran,2009-07-01,34,0,0,8,5,47
Iran,2009-07-01,65,0,0,8,5,78
Iran,2009-07-01,92,0,0,21,9,122
Iran,2009-07-01,60,0,-9,83,5,139
Iran,2009-07-01,80,0,0,19,17,116
Iran,2009-07-01,77,0,-1,16,12,104
Iran,2009-07-01,31,0,4,-10,4,29
Iran,2009-07-01,53,0,2,26,9,90
Iran,2009-07-01,15,0,4,6,5,30
Iran,2009-07-01,111,0,2,9,19,141
Iran,2009-07-01,83,0,1,14,18,116
Iran,2009-07-01,131,0,1,62,17,211
Iran,2009-07-01,132,0,-3,39,28,196
Iran,2009-07-01,54,0,-3,21,21,93
Iran,2009-07-01,107,2,-4,27,15,147
Iran,2009-07-01,180,0,1,60,14,255
Iran,2009-07-01,129,0,0,43,5,177
Iran,2009-07-01,180,0,-1,117,23,319
Iran,2009-07-01,116,0,1,81,31,229
Iraq,2009-07-01,54,0,0,27,1,82
Iraq,2009-07-01,118,0,-7,10,8,129
Iraq,2009-07-01,85,0,-2,6,4,93
Iraq,2009-07-01,63,6,-3,15,2,83
Iraq,2009-07-01,26,0,0,1,6,33
Iraq,2009-07-01,57,2,0,22,5,86
Iraq,2009-07-01,45,0,-6,6,2,47
Iraq,2009-07-01,52,0,0,-2,7,57
Iraq,2009-07-01,103,6,0,12,6,127
Iraq,2009-07-01,112,0,0,61,21,194
Iraq,2009-07-01,55,0,1,19,9,84
Iraq,2009-07-01,48,0,1,17,3,69
Iraq,2009-07-01,120,4,5,60,10,199
Iraq,2009-07-01,171,0,2,30,1,204
Iraq,2009-07-01,89,0,0,25,0,114
Iraq,2009-07-01,93,0,0,34,3,130
Iraq,2009-07-01,51,0,1,0,9,61
Iraq,2009-07-01,84,0,0,4,9,97
Iraq,2009-07-01,62,0,0,18,10,90
Iraq,2009-07-01,93,0,1,17,10,121
Iraq,2009-07-01,58,0,-2,16,3,75
Iraq,2009-07-01,119,0,-4,20,7,142
Iraq,2009-07-01,52,0,0,9,7,68
Iraq,2009-07-01,90,6,0,27,10,133
Iraq,2009-07-01,94,0,0,-5,0,89
Iraq,2009-07-01,123,0,-4,27,3,149
Iraq,2009-07-01,112,0,2,-20,10,104
Iraq,2009-07-01,144,0,7,13,9,173
Iraq,2009-07-01,104,0,-1,1,16,120
Iraq,2009-07-01,99,0,-2,33,15,145
Iraq,2009-07-01,59,0,-2,23,4,84
Morocco,2009-07-01,0,0,0,3,0,3
Morocco,2009-07-01,1,0,0,12,0,13
Morocco,2009-07-01,0,0,0,6,0,6
Morocco,2009-07-01,0,0,0,0,2,2
Morocco,2009-07-01,3,0,0,9,0,12
Morocco,2009-07-01,-1,0,0,-2,0,-3
Morocco,2009-07-01,8,0,0,3,6,17
Morocco,2009-07-01,2,0,0,0,0,2
Morocco,2009-07-01,0,0,0,0,0,0
Morocco,2009-07-01,3,0,0,30,0,33
Morocco,2009-07-01,3,0,0,9,0,12
Morocco,2009-07-01,0,0,0,6,0,6
Morocco,2009-07-01,0,0,0,-5,1,-4
Morocco,2009-07-01,4,0,0,1,0,5
Morocco,2009-07-01,1,0,0,3,0,4
Morocco,2009-07-01,0,0,0,0,0,0
Morocco,2009-07-01,2,0,0,7,0,9
Morocco,2009-07-01,2,0,0,0,0,2
Morocco,2009-07-01,8,0,0,0,5,13
Morocco,2009-07-01,2,0,0,0,0,2
Morocco,2009-07-01,-1,0,0,0,0,-1
Morocco,2009-07-01,0,0,0,0,0,0
Morocco,2009-07-01,1,0,0,3,0,4
Morocco,2009-07-01,3,0,0,6,0,9
Morocco,2009-07-01,2,0,0,9,0,11
Morocco,2009-07-01,0,0,0,3,0,3
Morocco,2009-07-01,-1,0,0,-2,0,-3
Morocco,2009-07-01,1,0,0,30,0,31
Morocco,2009-07-01,7,0,0,18,0,25
Morocco,2009-07-01,5,0,0,18,0,23
Morocco,2009-07-01,22,0,0,59,0,81
Nigeria,2009-07-01,19,0,0,7,1,27
Nigeria,2009-07-01,35,0,-2,6,0,39
Nigeria,2009-07-01,16,0,0,1,4,21
Nigeria,2009-07-01,1,0,0,0,0,1
Nigeria,2009-07-01,3,0,0,3,0,6
Nigeria,2009-07-01,12,0,0,6,2,20
Nigeria,2009-07-01,13,0,0,-2,0,11
Nigeria,2009-07-01,9,0,0,3,0,12
Nigeria,2009-07-01,8,0,-2,-2,0,4
Nigeria,2009-07-01,8,0,0,9,0,17
Nigeria,2009-07-01,4,0,0,3,0,7
Nigeria,2009-07-01,3,0,0,0,0,3
Nigeria,2009-07-01,1,0,2,35,0,38
Nigeria,2009-07-01,10,0,0,36,1,47
Nigeria,2009-07-01,13,0,0,4,5,22
Nigeria,2009-07-01,25,0,0,4,1,30
Nigeria,2009-07-01,4,0,0,3,4,11
Nigeria,2009-07-01,6,0,0,6,0,12
Nigeria,2009-07-01,0,0,0,0,4,4
Nigeria,2009-07-01,21,4,0,9,4,38
Nigeria,2009-07-01,1,0,0,10,0,11
Nigeria,2009-07-01,11,0,0,3,0,14
Nigeria,2009-07-01,0,0,0,3,0,3
Nigeria,2009-07-01,5,0,2,17,1,25
Nigeria,2009-07-01,5,0,0,2,2,9
Nigeria,2009-07-01,195,0,0,12,0,207
Nigeria,2009-07-01,69,2,0,12,6,89
Nigeria,2009-07-01,93,0,3,22,2,120
Nigeria,2009-07-01,65,0,2,37,2,106
Nigeria,2009-07-01,42,0,4,13,6,65
Nigeria,2009-07-01,38,0,2,15,2,57
Pakistan,2009-07-01,44,0,0,0,0,44
Pakistan,2009-07-01,60,0,0,20,8,88
Pakistan,2009-07-01,68,4,1,14,8,95
Pakistan,2009-07-01,60,0,0,3,24,87
Pakistan,2009-07-01,119,0,-2,15,9,141
Pakistan,2009-07-01,74,0,-2,25,3,100
Pakistan,2009-07-01,105,0,0,15,8,128
Pakistan,2009-07-01,39,0,0,54,10,103
Pakistan,2009-07-01,40,0,0,29,6,75
Pakistan,2009-07-01,100,0,0,57,5,162
Pakistan,2009-07-01,97,0,0,35,0,132
Pakistan,2009-07-01,68,0,0,16,3,87
Pakistan,2009-07-01,56,0,0,54,2,112
Pakistan,2009-07-01,108,2,0,14,1,125
Pakistan,2009-07-01,109,0,0,1,4,114
Pakistan,2009-07-01,72,2,-5,15,2,86
Pakistan,2009-07-01,75,0,1,30,10,116
Pakistan,2009-07-01,51,0,1,27,9,88
Pakistan,2009-07-01,54,0,0,9,21,84
Pakistan,2009-07-01,89,0,0,31,15,135
Pakistan,2009-07-01,39,2,-2,18,4,61
Pakistan,2009-07-01,130,0,0,72,17,219
Pakistan,2009-07-01,154,2,0,65,8,229
Pakistan,2009-07-01,99,0,0,34,13,146
Pakistan,2009-07-01,107,0,0,13,31,151
Pakistan,2009-07-01,86,0,-2,44,10,138
Pakistan,2009-07-01,94,0,0,56,0,150
Pakistan,2009-07-01,155,0,-7,75,11,234
Pakistan,2009-07-01,196,0,-1,135,8,338
Pakistan,2009-07-01,156,0,2,-14,9,153
Pakistan,2009-07-01,131,2,2,59,9,203
Sierra Leone,2009-07-01,6,0,0,0,0,6
Sierra Leone,2009-07-01,3,0,0,9,0,12
Sierra Leone,2009-07-01,2,0,0,12,0,14
Sierra Leone,2009-07-01,0,0,0,0,0,0
Sierra Leone,2009-07-01,2,0,0,0,0,2
Sierra Leone,2009-07-01,5,0,0,0,1,6
Sierra Leone,2009-07-01,0,0,0,6,0,6
Sierra Leone,2009-07-01,3,0,-2,3,0,4
Sierra Leone,2009-07-01,4,0,0,0,0,4
Sierra Leone,2009-07-01,1,0,0,0,0,1
Sierra Leone,2009-07-01,2,0,0,0,0,2
Sierra Leone,2009-07-01,25,0,0,7,1,33
Sierra Leone,2009-07-01,40,0,0,31,4,75
Sierra Leone,2009-07-01,7,0,0,-2,4,9
Sierra Leone,2009-07-01,3,6,0,6,2,17
Sierra Leone,2009-07-01,16,0,0,9,2,27
Sierra Leone,2009-07-01,15,0,0,3,0,18
Sierra Leone,2009-07-01,10,0,0,0,0,10
Sierra Leone,2009-07-01,8,0,0,0,0,8
Sierra Leone,2009-07-01,5,0,0,6,0,11
Sierra Leone,2009-07-01,9,0,0,0,0,9
Sierra Leone,2009-07-01,0,0,0,0,1,1
Sierra Leone,2009-07-01,13,0,0,3,3,19
Sierra Leone,2009-07-01,0,0,0,9,0,9
Sierra Leone,2009-07-01,1,0,0,-2,0,-1
Sierra Leone,2009-07-01,5,0,0,12,0,17
Sierra Leone,2009-07-01,5,0,0,0,0,5
Somalia,2009-07-01,17,0,2,4,1,24
Somalia,2009-07-01,24,0,0,0,0,24
Somalia,2009-07-01,13,0,0,12,2,27
Somalia,2009-07-01,5,0,0,3,0,8
Somalia,2009-07-01,9,0,0,0,0,9
Somalia,2009-07-01,19,0,0,-8,0,11
Somalia,2009-07-01,22,0,0,2,1,25
Somalia,2009-07-01,12,0,-2,0,0,10
Somalia,2009-07-01,8,0,0,9,4,21
Somalia,2009-07-01,32,0,0,3,1,36
Somalia,2009-07-01,15,2,0,-4,0,13
Somalia,2009-07-01,35,0,0,9,0,44
Somalia,2009-07-01,30,2,0,40,3,75
Somalia,2009-07-01,29,0,0,30,6,65
Somalia,2009-07-01,36,0,0,12,0,48
Somalia,2009-07-01,11,0,0,-5,4,10
Somalia,2009-07-01,10,2,0,33,0,45
Somalia,2009-07-01,16,0,0,-12,0,4
Somalia,2009-07-01,0,0,0,2,0,2
Somalia,2009-07-01,16,0,0,9,2,27
Somalia,2009-07-01,29,2,0,7,0,38
Somalia,2009-07-01,79,0,0,9,13,101
Somalia,2009-07-01,52,0,0,24,0,76
Somalia,2009-07-01,105,0,0,40,3,148
Somalia,2009-07-01,63,0,0,38,3,104
Somalia,2009-07-01,40,0,0,7,0,47
Somalia,2009-07-01,77,0,0,31,2,110
Somalia,2009-07-01,77,0,0,-3,15,89
Somalia,2009-07-01,72,0,0,10,0,82
Somalia,2009-07-01,9,0,0,37,4,50
Somalia,2009-07-01,38,0,-1,29,3,69
Syria,2009-07-01,1,0,0,16,0,17
Syria,2009-07-01,6,0,2,12,0,20
Syria,2009-07-01,6,0,1,0,1,8
Syria,2009-07-01,0,0,0,9,0,9
Syria,2009-07-01,8,0,0,0,0,8
Syria,2009-07-01,19,0,0,-2,0,17
Syria,2009-07-01,7,0,0,3,0,10
Syria,2009-07-01,-2,0,0,0,0,-2
Syria,2009-07-01,12,0,0,3,6,21
Syria,2009-07-01,15,0,0,-6,2,11
Syria,2009-07-01,-6,0,0,0,0,-6
Syria,2009-07-01,1,0,0,0,0,1
Syria,2009-07-01,35,0,0,36,0,71
Syria,2009-07-01,15,0,0,24,0,39
Syria,2009-07-01,19,0,0,18,0,37
Syria,2009-07-01,18,0,0,0,0,18
Syria,2009-07-01,7,0,0,0,2,9
Syria,2009-07-01,0,0,0,0,0,0
Syria,2009-07-01,3,0,0,3,0,6
Syria,2009-07-01,6,0,0,0,0,6
Syria,2009-07-01,7,0,0,15,0,22
Syria,2009-07-01,4,0,0,3,1,8
Syria,2009-07-01,12,0,0,6,0,18
Syria,2009-07-01,34,0,0,34,0,68
Syria,2009-07-01,19,0,3,3,0,25
Syria,2009-07-01,9,0,1,7,0,17
Syria,2009-07-01,18,0,0,6,0,24
Syria,2009-07-01,8,0,0,3,1,12
Syria,2009-07-01,22,0,0,-2,7,27
Syria,2009-07-01,26,0,0,19,9,54
Syria,2009-07-01,1,2,0,15,1,19
Yemen,2009-07-01,20,0,0,17,0,37
Yemen,2009-07-01,4,0,0,12,0,16
Yemen,2009-07-01,11,0,2,0,0,13
Yemen,2009-07-01,3,0,0,6,2,11
Yemen,2009-07-01,4,0,0,0,2,6
Yemen,2009-07-01,7,0,2,3,2,14
Yemen,2009-07-01,5,0,1,15,6,27
Yemen,2009-07-01,-1,0,0,0,0,-1
Yemen,2009-07-01,1,0,0,1,0,2
Yemen,2009-07-01,0,0,0,0,0,0
Yemen,2009-07-01,0,0,0,0,0,0
Yemen,2009-07-01,0,0,0,0,0,0
Yemen,2009-07-01,17,0,0,28,4,49
Yemen,2009-07-01,21,0,0,7,1,29
Yemen,2009-07-01,24,0,0,-1,3,26
Yemen,2009-07-01,0,0,0,-2,5,3
Yemen,2009-07-01,2,0,0,0,4,6
Yemen,2009-07-01,2,0,0,0,0,2
Yemen,2009-07-01,0,0,0,0,0,0
Yemen,2009-07-01,-2,0,0,0,0,-2
Yemen,2009-07-01,12,0,0,0,0,12
Yemen,2009-07-01,6,0,0,-5,0,1
Yemen,2009-07-01,5,0,0,1,0,6
Yemen,2009-07-01,27,0,0,1,6,34
Yemen,2009-07-01,1,0,0,0,0,1
Yemen,2009-07-01,10,0,0,0,0,10
Yemen,2009-07-01,6,0,0,21,1,28
Yemen,2009-07-01,27,4,0,-1,6,36
Yemen,2009-07-01,5,2,0,-4,0,3
Yemen,2009-07-01,3,0,0,3,1,7
Yemen,2009-07-01,2,0,0,6,0,8
Afghanistan,2007-08-01,233,0,0,78,17,328
Afghanistan,2007-08-01,70,0,0,20,3,93
Afghanistan,2007-08-01,53,0,0,42,2,97
Afghanistan,2007-08-01,123,6,0,9,34,172
Afghanistan,2007-08-01,93,0,0,54,6,153
Afghanistan,2007-08-01,125,0,-3,21,18,161
Afghanistan,2007-08-01,171,0,-2,14,12,195
Afghanistan,2007-08-01,131,0,-4,12,5,144
Afghanistan,2007-08-01,49,0,0,18,4,71
Afghanistan,2007-08-01,78,0,0,-2,9,85
Afghanistan,2007-08-01,66,0,-1,-25,4,44
Afghanistan,2007-08-01,97,2,0,-2,3,100
Afghanistan,2007-08-01,96,0,0,33,16,145
Afghanistan,2007-08-01,65,0,0,-5,7,67
Afghanistan,2007-08-01,105,0,0,7,9,121
Afghanistan,2007-08-01,117,0,0,55,12,184
Afghanistan,2007-08-01,171,0,0,33,67,271
Afghanistan,2007-08-01,135,0,0,54,25,214
Afghanistan,2007-08-01,88,0,0,6,3,97
Afghanistan,2007-08-01,73,0,0,-19,7,61
Afghanistan,2007-08-01,68,0,0,-5,10,73
Afghanistan,2007-08-01,111,0,1,28,11,151
Afghanistan,2007-08-01,143,8,0,14,6,171
Afghanistan,2007-08-01,128,0,2,9,22,161
Afghanistan,2007-08-01,96,0,0,33,5,134
Afghanistan,2007-08-01,122,0,7,10,10,149
Afghanistan,2007-08-01,71,0,0,-2,4,73
Afghanistan,2007-08-01,63,0,-4,-5,5,59
Afghanistan,2007-08-01,38,0,0,-1,0,37
Afghanistan,2007-08-01,25,0,0,-6,9,28
Afghanistan,2007-08-01,57,0,0,-13,2,46
Albania,2007-08-01,10,0,0,0,1,11
Albania,2007-08-01,-1,0,0,0,0,-1
Albania,2007-08-01,1,0,0,0,0,1
Albania,2007-08-01,2,0,0,0,0,2
Albania,2007-08-01,50,0,0,0,0,50
Albania,2007-08-01,40,0,-3,0,0,37
Albania,2007-08-01,17,0,0,0,2,19
Albania,2007-08-01,5,0,-2,7,2,12
Albania,2007-08-01,6,0,-1,0,0,5
Albania,2007-08-01,5,0,-1,3,2,9
Albania,2007-08-01,8,0,-2,3,1,10
Albania,2007-08-01,10,0,-6,6,1,11
Albania,2007-08-01,18,0,-3,0,0,15
Albania,2007-08-01,8,0,-1,-2,2,7
Albania,2007-08-01,13,0,0,-2,0,11
Albania,2007-08-01,17,0,0,3,1,21
Albania,2007-08-01,2,0,0,0,0,2
Albania,2007-08-01,4,4,0,-4,0,4
Albania,2007-08-01,6,0,0,0,0,6
Albania,2007-08-01,4,0,0,0,0,4
Albania,2007-08-01,22,0,-3,0,2,21
Albania,2007-08-01,0,0,-1,0,0,-1
Albania,2007-08-01,6,0,0,0,4,10
Albania,2007-08-01,40,0,0,6,1,47
Albania,2007-08-01,8,0,0,0,0,8
Albania,2007-08-01,2,0,-1,3,0,4
Albania,2007-08-01,11,0,0,0,0,11
Albania,2007-08-01,19,0,-4,0,0,15
Albania,2007-08-01,4,0,3,2,0,9
Albania,2007-08-01,11,0,-3,6,0,14
Albania,2007-08-01,8,0,0,0,0,8
Algeria,2007-08-01,0,0,0,3,0,3
Algeria,2007-08-01,0,0,0,45,0,45
Algeria,2007-08-01,2,0,0,0,0,2
Algeria,2007-08-01,0,0,0,3,0,3
Algeria,2007-08-01,0,0,0,0,0,0
Algeria,2007-08-01,-2,0,0,0,0,-2
Algeria,2007-08-01,4,4,0,6,0,14
Algeria,2007-08-01,8,0,0,10,0,18
Algeria,2007-08-01,0,0,0,0,2,2
Algeria,2007-08-01,4,0,0,3,2,9
Algeria,2007-08-01,0,0,0,0,0,0
Algeria,2007-08-01,8,0,0,9,0,17
Algeria,2007-08-01,4,0,0,3,0,7
Algeria,2007-08-01,0,0,0,0,0,0
Algeria,2007-08-01,0,0,0,12,0,12
Algeria,2007-08-01,0,0,0,0,0,0
Algeria,2007-08-01,0,0,0,0,0,0
Algeria,2007-08-01,0,0,0,9,0,9
Algeria,2007-08-01,0,0,0,0,0,0
Algeria,2007-08-01,6,0,0,0,0,6
Algeria,2007-08-01,16,0,0,3,0,19
Algeria,2007-08-01,3,0,0,0,0,3
Algeria,2007-08-01,14,0,0,6,4,24
Algeria,2007-08-01,0,0,0,0,0,0
Algeria,2007-08-01,6,0,0,-4,0,2
Algeria,2007-08-01,3,0,0,0,0,3
Algeria,2007-08-01,-1,0,0,0,0,-1
Algeria,2007-08-01,0,0,0,0,0,0
Algeria,2007-08-01,-8,0,0,18,0,10
Algeria,2007-08-01,2,0,0,0,6,8
Bangladesh,2007-08-01,0,0,0,3,0,3
Bangladesh,2007-08-01,19,0,0,12,0,31
Bangladesh,2007-08-01,19,0,0,0,0,19
Bangladesh,2007-08-01,17,0,0,3,0,20
Bangladesh,2007-08-01,9,0,0,1,1,11
Bangladesh,2007-08-01,20,4,0,4,6,34
Bangladesh,2007-08-01,-1,0,0,0,2,1
Bangladesh,2007-08-01,9,8,0,0,0,17
Bangladesh,2007-08-01,-1,0,0,-10,12,1
Bangladesh,2007-08-01,30,2,0,5,4,41
Bangladesh,2007-08-01,29,0,0,-4,6,31
Bangladesh,2007-08-01,43,0,0,6,5,54
Bangladesh,2007-08-01,7,0,1,11,6,25
Bangladesh,2007-08-01,8,0,0,6,0,14
Bangladesh,2007-08-01,7,0,0,0,0,7
Bangladesh,2007-08-01,3,0,0,0,0,3
Bangladesh,2007-08-01,11,0,0,3,6,20
Bangladesh,2007-08-01,4,0,1,0,0,5
Bangladesh,2007-08-01,0,0,0,6,0,6
Bangladesh,2007-08-01,6,0,0,12,1,19
Bangladesh,2007-08-01,7,0,-6,15,0,16
Bangladesh,2007-08-01,21,0,0,0,1,22
Bangladesh,2007-08-01,9,0,0,10,6,25
Bangladesh,2007-08-01,6,0,0,3,1,10
Bangladesh,2007-08-01,1,0,0,12,0,13
Bangladesh,2007-08-01,35,0,0,3,2,40
Bangladesh,2007-08-01,12,0,0,42,0,54
Bangladesh,2007-08-01,11,0,0,21,9,41
Bangladesh,2007-08-01,8,0,-4,3,0,7
Bangladesh,2007-08-01,9,0,0,-5,1,5
Bangladesh,2007-08-01,0,0,0,3,0,3
Cameroon,2007-08-01,0,0,0,0,0,0
Cameroon,2007-08-01,0,0,0,0,0,0
Cameroon,2007-08-01,8,0,0,0,0,8
Cameroon,2007-08-01,0,0,0,0,0,0
Cameroon,2007-08-01,0,0,0,0,0,0
Cameroon,2007-08-01,0,0,0,0,0,0
Cameroon,2007-08-01,3,0,0,3,0,6
Cameroon,2007-08-01,2,0,0,0,0,2
Cameroon,2007-08-01,1,0,0,-4,0,-3
Cameroon,2007-08-01,1,0,0,0,0,1
Cameroon,2007-08-01,0,0,0,0,0,0
Cameroon,2007-08-01,0,0,0,0,0,0
Cameroon,2007-08-01,0,0,0,0,0,0
Cameroon,2007-08-01,0,0,0,0,0,0
Cameroon,2007-08-01,0,0,0,0,0,0
China,2007-08-01,42,0,2,16,20,80
China,2007-08-01,23,0,0,24,4,51
China,2007-08-01,35,0,-4,3,1,35
China,2007-08-01,11,0,2,4,1,18
China,2007-08-01,18,0,-2,19,0,35
China,2007-08-01,65,2,-1,32,9,107
China,2007-08-01,36,0,0,22,2,60
China,2007-08-01,85,0,0,21,3,109
China,2007-08-01,9,0,0,6,12,27
China,2007-08-01,57,2,1,-1,5,64
China,2007-08-01,42,0,-2,-1,3,42
China,2007-08-01,31,0,0,4,6,41
China,2007-08-01,8,0,0,18,7,33
China,2007-08-01,28,0,1,30,8,67
China,2007-08-01,40,0,0,17,9,66
China,2007-08-01,75,2,0,23,9,109
China,2007-08-01,58,0,-2,1,5,62
China,2007-08-01,26,0,0,7,2,35
China,2007-08-01,18,0,0,8,4,30
China,2007-08-01,90,0,0,-4,2,88
China,2007-08-01,58,4,0,61,12,135
China,2007-08-01,187,0,0,9,11,207
China,2007-08-01,87,0,0,26,4,117
China,2007-08-01,25,0,1,14,0,40
China,2007-08-01,2,0,0,-16,0,-14
China,2007-08-01,8,0,0,-1,1,8
China,2007-08-01,18,0,0,0,0,18
China,2007-08-01,12,0,0,3,0,15
China,2007-08-01,23,0,0,0,4,27
China,2007-08-01,6,0,0,8,0,14
China,2007-08-01,4,0,-2,25,10,37
Egypt,2007-08-01,33,0,0,-24,8,17
Egypt,2007-08-01,42,0,0,10,18,70
Egypt,2007-08-01,20,0,0,4,0,24
Egypt,2007-08-01,12,0,0,2,0,14
Egypt,2007-08-01,32,0,0,-4,1,29
Egypt,2007-08-01,5,0,0,7,0,12
Egypt,2007-08-01,13,0,0,5,0,18
Egypt,2007-08-01,50,0,4,36,4,94
Egypt,2007-08-01,-6,0,0,-2,0,-8
Egypt,2007-08-01,37,0,0,15,0,52
Egypt,2007-08-01,33,0,0,1,0,34
Egypt,2007-08-01,7,0,0,-2,0,5
Egypt,2007-08-01,3,0,0,-1,0,2
Egypt,2007-08-01,9,0,0,6,0,15
Egypt,2007-08-01,10,0,0,-3,4,11
Egypt,2007-08-01,8,0,0,12,0,20
Egypt,2007-08-01,11,0,0,15,2,28
Egypt,2007-08-01,0,0,0,0,0,0
Egypt,2007-08-01,13,0,0,1,0,14
Egypt,2007-08-01,13,0,0,5,0,18
Egypt,2007-08-01,13,0,0,9,0,22
Egypt,2007-08-01,13,0,0,4,1,18
Egypt,2007-08-01,43,0,0,44,2,89
Egypt,2007-08-01,36,0,0,3,6,45
Egypt,2007-08-01,20,2,0,-3,0,19
Egypt,2007-08-01,21,0,0,-2,0,19
Egypt,2007-08-01,7,0,-8,3,0,2
Egypt,2007-08-01,12,0,0,16,0,28
Egypt,2007-08-01,1,0,0,6,1,8
Egypt,2007-08-01,-1,0,0,22,0,21
Egypt,2007-08-01,4,0,0,7,0,11
Eritrea,2007-08-01,0,0,0,0,0,0
Eritrea,2007-08-01,6,0,2,0,0,8
Eritrea,2007-08-01,0,0,0,0,0,0
Eritrea,2007-08-01,2,0,0,0,0,2
Eritrea,2007-08-01,0,0,0,6,0,6
Eritrea,2007-08-01,0,0,0,0,0,0
Eritrea,2007-08-01,0,0,0,0,0,0
Eritrea,2007-08-01,0,0,0,0,0,0
Eritrea,2007-08-01,0,0,0,0,0,0
Eritrea,2007-08-01,0,0,0,6,0,6
Eritrea,2007-08-01,0,0,0,0,0,0
Eritrea,2007-08-01,5,0,0,0,0,5
Eritrea,2007-08-01,1,0,0,3,0,4
Eritrea,2007-08-01,25,0,0,0,0,25
Eritrea,2007-08-01,0,0,0,0,0,0
Eritrea,2007-08-01,6,0,0,0,0,6
Eritrea,2007-08-01,1,0,0,0,0,1
Eritrea,2007-08-01,1,0,0,0,0,1
Eritrea,2007-08-01,1,0,0,0,0,1
Eritrea,2007-08-01,0,0,0,0,0,0
Eritrea,2007-08-01,21,0,0,-12,0,9
Eritrea,2007-08-01,0,0,0,0,0,0
Georgia,2007-08-01,9,0,0,-2,1,8
Georgia,2007-08-01,1,0,0,0,0,1
Georgia,2007-08-01,4,0,0,0,0,4
Georgia,2007-08-01,0,4,0,6,0,10
Georgia,2007-08-01,0,0,0,0,0,0
Georgia,2007-08-01,5,0,0,6,0,11
Georgia,2007-08-01,0,0,0,0,0,0
Georgia,2007-08-01,6,0,0,12,0,18
Georgia,2007-08-01,1,0,0,0,0,1
Georgia,2007-08-01,10,0,-2,19,1,28
Georgia,2007-08-01,0,0,0,0,0,0
Georgia,2007-08-01,3,0,0,0,0,3
Georgia,2007-08-01,21,0,0,0,0,21
Georgia,2007-08-01,0,0,0,3,0,3
Georgia,2007-08-01,4,0,0,0,0,4
Georgia,2007-08-01,2,0,0,6,0,8
Georgia,2007-08-01,1,0,0,0,3,4
Georgia,2007-08-01,6,0,0,0,2,8
Georgia,2007-08-01,4,0,0,0,0,4
Georgia,2007-08-01,5,0,0,9,0,14
Georgia,2007-08-01,5,0,-4,3,4,8
Georgia,2007-08-01,23,0,0,5,4,32
Georgia,2007-08-01,3,0,0,0,1,4
Georgia,2007-08-01,28,0,1,21,2,52
Georgia,2007-08-01,1,0,0,12,2,15
Georgia,2007-08-01,0,0,0,3,0,3
Georgia,2007-08-01,0,0,0,0,0,0
Georgia,2007-08-01,0,0,0,0,0,0
Georgia,2007-08-01,0,0,0,3,0,3
Georgia,2007-08-01,0,0,0,0,0,0
Georgia,2007-08-01,3,0,0,0,0,3
India,2007-08-01,20,0,8,0,1,29
India,2007-08-01,16,0,1,5,0,22
India,2007-08-01,44,2,0,31,12,89
India,2007-08-01,13,0,0,-4,0,9
India,2007-08-01,26,0,0,7,0,33
India,2007-08-01,24,0,0,10,0,34
India,2007-08-01,4,0,0,0,0,4
India,2007-08-01,13,4,0,24,6,47
India,2007-08-01,12,0,0,0,0,12
India,2007-08-01,20,0,0,22,1,43
India,2007-08-01,27,0,0,7,0,34
India,2007-08-01,16,0,0,-2,0,14
India,2007-08-01,24,0,-2,-8,3,17
India,2007-08-01,22,0,0,2,0,24
India,2007-08-01,20,0,0,18,0,38
India,2007-08-01,3,0,-2,1,3,5
India,2007-08-01,28,0,0,7,0,35
India,2007-08-01,6,0,1,9,0,16
India,2007-08-01,0,0,0,6,0,6
India,2007-08-01,25,0,0,3,0,28
India,2007-08-01,33,2,-4,-2,5,34
India,2007-08-01,49,0,0,6,6,61
India,2007-08-01,9,0,0,-2,3,10
India,2007-08-01,12,4,0,4,3,23
India,2007-08-01,27,0,-2,12,1,38
India,2007-08-01,21,0,0,-2,1,20
India,2007-08-01,-4,0,0,3,0,-1
India,2007-08-01,10,0,0,1,0,11
India,2007-08-01,0,0,0,0,0,0
India,2007-08-01,3,0,0,0,0,3
India,2007-08-01,6,0,0,4,1,11
Iran,2007-08-01,31,0,0,6,3,40
Iran,2007-08-01,30,0,0,4,2,36
Iran,2007-08-01,8,0,0,12,5,25
Iran,2007-08-01,8,0,0,36,9,53
Iran,2007-08-01,16,0,0,-5,2,13
Iran,2007-08-01,64,0,2,28,4,98
Iran,2007-08-01,13,0,-2,5,2,18
Iran,2007-08-01,15,0,1,0,2,18
Iran,2007-08-01,-13,0,0,12,0,-1
Iran,2007-08-01,11,0,0,9,1,21
Iran,2007-08-01,0,0,0,-4,7,3
Iran,2007-08-01,48,2,-2,3,0,51
Iran,2007-08-01,50,4,0,27,4,85
Iran,2007-08-01,62,0,2,18,0,82
Iran,2007-08-01,45,0,0,24,6,75
Iran,2007-08-01,40,0,0,15,6,61
Iran,2007-08-01,10,0,0,0,3,13
Iran,2007-08-01,25,0,0,1,0,26
Iran,2007-08-01,30,0,-2,3,2,33
Iran,2007-08-01,22,0,0,7,1,30
Iran,2007-08-01,58,0,1,-3,9,65
Iran,2007-08-01,46,0,3,17,19,85
Iran,2007-08-01,43,0,-2,28,4,73
Iran,2007-08-01,32,0,0,0,0,32
Iran,2007-08-01,15,0,1,1,8,25
Iran,2007-08-01,39,0,0,7,0,46
Iran,2007-08-01,13,0,0,3,2,18
Iran,2007-08-01,10,0,0,9,1,20
Iran,2007-08-01,24,0,0,4,5,33
Iran,2007-08-01,17,0,-1,-2,0,14
Iran,2007-08-01,7,0,0,9,4,20
Iraq,2007-08-01,288,0,-2,43,19,348
Iraq,2007-08-01,97,0,-8,50,26,165
Iraq,2007-08-01,290,2,-6,192,57,535
Iraq,2007-08-01,96,0,0,34,14,144
Iraq,2007-08-01,192,2,-6,18,23,229
Iraq,2007-08-01,150,0,-15,23,19,177
Iraq,2007-08-01,100,0,1,-7,6,100
Iraq,2007-08-01,142,2,1,11,15,171
Iraq,2007-08-01,14,0,0,5,0,19
Iraq,2007-08-01,160,2,-4,18,5,181
Iraq,2007-08-01,65,0,-2,7,13,83
Iraq,2007-08-01,75,0,0,10,15,100
Iraq,2007-08-01,129,0,-4,55,6,186
Iraq,2007-08-01,113,0,-6,11,2,120
Iraq,2007-08-01,113,6,2,27,16,164
Iraq,2007-08-01,128,0,0,15,22,165
Iraq,2007-08-01,106,2,0,36,6,150
Iraq,2007-08-01,117,0,-1,50,9,175
Iraq,2007-08-01,52,0,0,64,6,122
Iraq,2007-08-01,162,0,3,59,16,240
Iraq,2007-08-01,110,12,0,114,32,268
Iraq,2007-08-01,76,14,4,74,38,206
Iraq,2007-08-01,118,2,-2,31,14,163
Iraq,2007-08-01,148,0,-2,72,13,231
Iraq,2007-08-01,86,0,0,26,10,122
Iraq,2007-08-01,66,4,-8,7,39,108
Iraq,2007-08-01,47,0,-12,24,11,70
Iraq,2007-08-01,34,0,1,-2,5,38
Iraq,2007-08-01,41,0,1,7,2,51
Iraq,2007-08-01,24,14,0,6,0,44
Iraq,2007-08-01,58,0,0,-2,4,60
Morocco,2007-08-01,0,0,0,9,0,9
Morocco,2007-08-01,2,0,0,0,0,2
Morocco,2007-08-01,0,0,0,1,0,1
Morocco,2007-08-01,0,0,0,1,0,1
Morocco,2007-08-01,0,0,0,0,0,0
Morocco,2007-08-01,1,0,0,29,0,30
Morocco,2007-08-01,-6,0,0,9,0,3
Morocco,2007-08-01,13,0,0,7,0,20
Morocco,2007-08-01,12,0,0,12,0,24
Morocco,2007-08-01,-10,0,0,15,0,5
Morocco,2007-08-01,0,0,0,15,0,15
Morocco,2007-08-01,2,0,0,12,0,14
Morocco,2007-08-01,0,0,0,0,0,0
Morocco,2007-08-01,5,0,0,0,0,5
Morocco,2007-08-01,11,0,0,42,0,53
Morocco,2007-08-01,5,0,0,0,0,5
Morocco,2007-08-01,0,0,0,0,0,0
Morocco,2007-08-01,3,0,0,0,0,3
Morocco,2007-08-01,0,0,0,0,0,0
Morocco,2007-08-01,2,0,0,0,0,2
Morocco,2007-08-01,-1,0,0,6,0,5
Morocco,2007-08-01,15,0,0,22,1,38
Morocco,2007-08-01,9,0,0,3,0,12
Morocco,2007-08-01,37,0,-2,0,0,35
Morocco,2007-08-01,0,0,0,0,0,0
Morocco,2007-08-01,0,0,0,0,0,0
Morocco,2007-08-01,6,0,0,0,0,6
Morocco,2007-08-01,0,0,2,0,0,2
Morocco,2007-08-01,0,0,0,0,0,0
Nigeria,2007-08-01,-9,0,0,0,0,-9
Nigeria,2007-08-01,-3,0,0,0,0,-3
Nigeria,2007-08-01,31,0,0,15,0,46
Nigeria,2007-08-01,0,0,0,0,0,0
Nigeria,2007-08-01,0,0,0,3,0,3
Nigeria,2007-08-01,3,0,0,6,0,9
Nigeria,2007-08-01,0,0,0,0,0,0
Nigeria,2007-08-01,8,0,0,9,0,17
Nigeria,2007-08-01,0,0,0,30,5,35
Nigeria,2007-08-01,7,4,0,6,1,18
Nigeria,2007-08-01,0,0,0,3,1,4
Nigeria,2007-08-01,4,0,0,0,0,4
Nigeria,2007-08-01,8,0,0,6,0,14
Nigeria,2007-08-01,1,0,0,0,0,1
Nigeria,2007-08-01,7,0,0,0,1,8
Nigeria,2007-08-01,22,0,0,3,1,26
Nigeria,2007-08-01,7,0,0,9,0,16
Nigeria,2007-08-01,0,0,0,6,0,6
Nigeria,2007-08-01,12,0,0,0,2,14
Nigeria,2007-08-01,9,0,0,12,0,21
Nigeria,2007-08-01,24,0,0,3,4,31
Nigeria,2007-08-01,18,0,0,6,3,27
Nigeria,2007-08-01,19,0,0,-2,1,18
Nigeria,2007-08-01,4,0,0,3,1,8
Nigeria,2007-08-01,0,0,0,0,0,0
Nigeria,2007-08-01,0,0,0,0,0,0
Nigeria,2007-08-01,-2,0,0,0,0,-2
Nigeria,2007-08-01,4,0,0,0,0,4
Nigeria,2007-08-01,0,0,0,0,0,0
Nigeria,2007-08-01,4,0,0,0,0,4
Nigeria,2007-08-01,2,0,0,0,0,2
Pakistan,2007-08-01,38,0,0,12,4,54
Pakistan,2007-08-01,30,0,1,19,6,56
Pakistan,2007-08-01,59,0,2,65,4,130
Pakistan,2007-08-01,28,0,-1,25,3,55
Pakistan,2007-08-01,77,4,0,17,2,100
Pakistan,2007-08-01,80,0,1,14,6,101
Pakistan,2007-08-01,27,0,0,27,4,58
Pakistan,2007-08-01,42,0,0,19,0,61
Pakistan,2007-08-01,27,0,-4,19,4,46
Pakistan,2007-08-01,64,8,-2,3,3,76
Pakistan,2007-08-01,30,0,0,13,6,49
Pakistan,2007-08-01,67,2,0,-4,2,67
Pakistan,2007-08-01,54,0,0,-4,8,58
Pakistan,2007-08-01,23,0,-4,0,0,19
Pakistan,2007-08-01,50,0,0,31,5,86
Pakistan,2007-08-01,68,0,-2,64,3,133
Pakistan,2007-08-01,28,0,-2,3,2,31
Pakistan,2007-08-01,23,0,0,32,4,59
Pakistan,2007-08-01,34,0,0,-5,8,37
Pakistan,2007-08-01,36,0,0,-16,7,27
Pakistan,2007-08-01,20,0,0,15,1,36
Pakistan,2007-08-01,47,0,1,28,2,78
Pakistan,2007-08-01,26,2,-2,-2,1,25
Pakistan,2007-08-01,34,0,-1,32,1,66
Pakistan,2007-08-01,22,0,-4,8,1,27
Pakistan,2007-08-01,79,0,-3,47,8,131
Pakistan,2007-08-01,62,0,-2,4,0,64
Pakistan,2007-08-01,29,0,0,8,0,37
Pakistan,2007-08-01,14,0,-2,-6,0,6
Pakistan,2007-08-01,34,0,-12,6,0,28
Pakistan,2007-08-01,4,0,0,6,2,12
Sierra Leone,2007-08-01,0,0,0,0,0,0
Sierra Leone,2007-08-01,6,0,0,18,5,29
Sierra Leone,2007-08-01,2,0,0,6,0,8
Sierra Leone,2007-08-01,0,0,0,0,0,0
Sierra Leone,2007-08-01,0,0,0,9,0,9
Sierra Leone,2007-08-01,2,0,0,0,6,8
Sierra Leone,2007-08-01,-1,0,0,0,0,-1
Sierra Leone,2007-08-01,0,0,0,0,0,0
Sierra Leone,2007-08-01,2,0,0,-4,0,-2
Sierra Leone,2007-08-01,0,0,1,0,0,1
Sierra Leone,2007-08-01,6,0,0,4,2,12
Sierra Leone,2007-08-01,7,0,-6,0,1,2
Sierra Leone,2007-08-01,4,0,-6,0,4,2
Sierra Leone,2007-08-01,2,0,0,0,0,2
Sierra Leone,2007-08-01,3,0,0,0,0,3
Sierra Leone,2007-08-01,5,0,0,15,0,20
Sierra Leone,2007-08-01,0,0,0,6,1,7
Sierra Leone,2007-08-01,0,0,0,6,0,6
Sierra Leone,2007-08-01,2,0,-4,17,0,15
Sierra Leone,2007-08-01,0,0,0,6,0,6
Sierra Leone,2007-08-01,4,0,-4,0,0,0
Sierra Leone,2007-08-01,0,0,0,0,0,0
Sierra Leone,2007-08-01,0,0,0,-2,0,-2
Sierra Leone,2007-08-01,3,0,0,6,0,9
Sierra Leone,2007-08-01,0,0,0,0,0,0
Sierra Leone,2007-08-01,0,0,0,0,0,0
Somalia,2007-08-01,17,0,0,18,3,38
Somalia,2007-08-01,12,0,0,6,0,18
Somalia,2007-08-01,8,0,0,3,8,19
Somalia,2007-08-01,5,0,0,0,0,5
Somalia,2007-08-01,1,0,0,-6,0,-5
Somalia,2007-08-01,5,0,0,0,2,7
Somalia,2007-08-01,0,0,0,0,0,0
Somalia,2007-08-01,0,0,0,0,0,0
Somalia,2007-08-01,2,0,0,0,0,2
Somalia,2007-08-01,5,0,0,3,0,8
Somalia,2007-08-01,7,0,0,6,0,13
Somalia,2007-08-01,2,0,0,0,0,2
Somalia,2007-08-01,10,0,0,11,0,21
Somalia,2007-08-01,37,0,0,-4,0,33
Somalia,2007-08-01,13,0,0,6,0,19
Somalia,2007-08-01,6,0,0,0,3,9
Somalia,2007-08-01,-2,0,0,6,0,4
Somalia,2007-08-01,4,0,0,0,2,6
Somalia,2007-08-01,-1,0,0,0,2,1
Somalia,2007-08-01,6,0,0,-6,0,0
Somalia,2007-08-01,5,0,0,0,0,5
Somalia,2007-08-01,-3,0,0,-19,6,-16
Somalia,2007-08-01,3,0,0,-13,4,-6
Somalia,2007-08-01,22,0,0,0,0,22
Somalia,2007-08-01,-1,0,0,0,0,-1
Somalia,2007-08-01,0,0,0,0,2,2
Somalia,2007-08-01,8,0,0,0,0,8
Somalia,2007-08-01,3,0,0,12,2,17
Somalia,2007-08-01,0,4,0,6,2,12
Somalia,2007-08-01,8,0,0,0,0,8
Somalia,2007-08-01,0,0,0,0,0,0
Syria,2007-08-01,9,0,0,0,0,9
Syria,2007-08-01,3,0,0,0,0,3
Syria,2007-08-01,23,0,1,2,0,26
Syria,2007-08-01,26,0,1,15,2,44
Syria,2007-08-01,13,0,0,0,5,18
Syria,2007-08-01,52,0,0,12,1,65
Syria,2007-08-01,15,0,0,-6,0,9
Syria,2007-08-01,12,0,0,1,0,13
Syria,2007-08-01,-1,0,0,16,0,15
Syria,2007-08-01,13,0,0,23,0,36
Syria,2007-08-01,-3,0,0,-2,0,-5
Syria,2007-08-01,1,0,0,0,0,1
Syria,2007-08-01,5,0,0,18,0,23
Syria,2007-08-01,14,0,0,11,0,25
Syria,2007-08-01,24,0,2,16,0,42
Syria,2007-08-01,30,0,0,5,2,37
Syria,2007-08-01,24,0,0,0,1,25
Syria,2007-08-01,26,2,0,6,0,34
Syria,2007-08-01,17,4,0,0,0,21
Syria,2007-08-01,47,0,0,0,0,47
Syria,2007-08-01,61,4,2,1,2,70
Syria,2007-08-01,8,0,1,0,2,11
Syria,2007-08-01,13,0,2,0,0,15
Syria,2007-08-01,0,0,0,0,0,0
Syria,2007-08-01,17,0,0,-1,6,22
Syria,2007-08-01,12,0,0,6,4,22
Syria,2007-08-01,14,0,0,-6,3,11
Syria,2007-08-01,6,0,0,21,0,27
Syria,2007-08-01,3,0,0,0,0,3
Syria,2007-08-01,1,0,0,0,0,1
Syria,2007-08-01,4,0,0,0,0,4
Yemen,2007-08-01,1,0,0,0,0,1
Yemen,2007-08-01,8,0,0,30,0,38
Yemen,2007-08-01,9,0,0,9,0,18
Yemen,2007-08-01,0,0,0,0,0,0
Yemen,2007-08-01,9,0,0,7,2,18
Yemen,2007-08-01,0,0,0,0,0,0
Yemen,2007-08-01,8,0,0,0,0,8
Yemen,2007-08-01,0,0,0,0,0,0
Yemen,2007-08-01,11,0,0,3,0,14
Yemen,2007-08-01,-10,0,0,-2,1,-11
Yemen,2007-08-01,14,0,0,0,0,14
Yemen,2007-08-01,2,0,0,0,0,2
Yemen,2007-08-01,0,0,0,3,0,3
Yemen,2007-08-01,1,0,0,0,0,1
Yemen,2007-08-01,0,0,0,0,2,2
Yemen,2007-08-01,8,0,0,0,0,8
Yemen,2007-08-01,0,0,0,0,0,0
Yemen,2007-08-01,0,0,0,3,0,3
Yemen,2007-08-01,4,0,0,0,0,4
Yemen,2007-08-01,-4,0,0,36,0,32
Yemen,2007-08-01,0,0,0,0,0,0
Yemen,2007-08-01,0,0,0,0,0,0
Yemen,2007-08-01,0,0,0,0,2,2
Yemen,2007-08-01,2,0,0,6,2,10
Yemen,2007-08-01,0,0,0,0,0,0
Yemen,2007-08-01,3,0,0,0,0,3
Yemen,2007-08-01,0,0,0,0,0,0
Afghanistan,2007-09-01,32,0,0,-13,7,26
Afghanistan,2007-09-01,13,0,0,10,3,26
Afghanistan,2007-09-01,32,0,0,9,2,43
Afghanistan,2007-09-01,203,2,-1,69,30,303
Afghanistan,2007-09-01,118,0,0,36,32,186
Afghanistan,2007-09-01,116,2,0,24,7,149
Afghanistan,2007-09-01,55,0,1,35,2,93
Afghanistan,2007-09-01,133,2,0,-1,9,143
Afghanistan,2007-09-01,87,4,0,8,4,103
Afghanistan,2007-09-01,157,0,-4,14,24,191
Afghanistan,2007-09-01,171,0,-1,13,23,206
Afghanistan,2007-09-01,216,2,-28,64,10,264
Afghanistan,2007-09-01,79,0,-12,8,0,75
Afghanistan,2007-09-01,86,0,-16,29,13,112
Afghanistan,2007-09-01,46,0,-4,6,3,51
Afghanistan,2007-09-01,63,0,0,6,5,74
Afghanistan,2007-09-01,174,0,-2,0,26,198
Afghanistan,2007-09-01,106,2,0,10,3,121
Afghanistan,2007-09-01,119,4,2,13,26,164
Afghanistan,2007-09-01,198,0,0,27,11,236
Afghanistan,2007-09-01,187,0,0,14,9,210
Afghanistan,2007-09-01,78,0,2,4,8,92
Afghanistan,2007-09-01,50,0,-12,44,19,101
Afghanistan,2007-09-01,31,0,-10,16,8,45
Afghanistan,2007-09-01,123,0,-5,15,3,136
Afghanistan,2007-09-01,188,4,3,21,6,222
Afghanistan,2007-09-01,139,0,-4,72,5,212
Afghanistan,2007-09-01,15,0,0,25,4,44
Afghanistan,2007-09-01,39,0,0,-9,3,33
Afghanistan,2007-09-01,37,0,0,0,1,38
Albania,2007-09-01,0,0,0,0,0,0
Albania,2007-09-01,0,0,-1,0,0,-1
Albania,2007-09-01,0,0,0,0,0,0
Albania,2007-09-01,18,0,-2,3,2,21
Albania,2007-09-01,27,0,-1,0,2,28
Albania,2007-09-01,34,0,0,9,0,43
Albania,2007-09-01,0,0,0,6,2,8
Albania,2007-09-01,8,0,0,0,0,8
Albania,2007-09-01,36,0,0,0,0,36
Albania,2007-09-01,38,0,-1,4,3,44
Albania,2007-09-01,46,0,-3,0,1,44
Albania,2007-09-01,-2,0,0,0,0,-2
Albania,2007-09-01,8,0,0,6,0,14
Albania,2007-09-01,15,0,-1,0,0,14
Albania,2007-09-01,7,0,0,0,0,7
Albania,2007-09-01,0,0,-1,0,0,-1
Albania,2007-09-01,9,0,0,0,0,9
Albania,2007-09-01,15,0,-3,3,2,17
Albania,2007-09-01,14,0,0,24,0,38
Albania,2007-09-01,4,0,-1,0,0,3
Albania,2007-09-01,2,0,3,0,0,5
Albania,2007-09-01,8,0,0,0,4,12
Albania,2007-09-01,12,0,0,0,3,15
Albania,2007-09-01,30,0,-1,0,1,30
Albania,2007-09-01,5,0,0,6,2,13
Albania,2007-09-01,31,0,0,28,2,61
Albania,2007-09-01,39,0,-1,12,1,51
Albania,2007-09-01,4,0,0,0,3,7
Albania,2007-09-01,6,0,0,3,2,11
Albania,2007-09-01,1,0,0,0,0,1
Algeria,2007-09-01,0,0,0,0,2,2
Algeria,2007-09-01,2,0,0,0,0,2
Algeria,2007-09-01,0,0,0,0,0,0
Algeria,2007-09-01,12,0,0,3,6,21
Algeria,2007-09-01,2,0,0,6,4,12
Algeria,2007-09-01,17,0,0,6,1,24
Algeria,2007-09-01,3,0,0,0,2,5
Algeria,2007-09-01,43,0,0,0,8,51
Algeria,2007-09-01,16,0,0,13,0,29
Algeria,2007-09-01,25,2,0,0,1,28
Algeria,2007-09-01,25,0,0,9,0,34
Algeria,2007-09-01,4,0,1,-2,12,15
Algeria,2007-09-01,19,4,0,6,0,29
Algeria,2007-09-01,7,2,0,3,3,15
Algeria,2007-09-01,0,0,0,3,0,3
Algeria,2007-09-01,2,0,0,0,0,2
Algeria,2007-09-01,32,0,0,6,0,38
Algeria,2007-09-01,0,0,0,0,0,0
Algeria,2007-09-01,3,0,0,6,0,9
Algeria,2007-09-01,10,0,0,0,0,10
Algeria,2007-09-01,2,0,0,7,12,21
Algeria,2007-09-01,10,0,0,0,0,10
Algeria,2007-09-01,5,0,0,0,0,5
Algeria,2007-09-01,4,0,0,0,0,4
Algeria,2007-09-01,3,0,0,6,0,9
Algeria,2007-09-01,0,0,0,0,3,3
Algeria,2007-09-01,9,0,0,0,0,9
Algeria,2007-09-01,-2,0,0,12,0,10
Algeria,2007-09-01,0,0,0,0,1,1
Algeria,2007-09-01,4,0,0,0,1,5
Bangladesh,2007-09-01,6,0,0,-1,0,5
Bangladesh,2007-09-01,1,0,0,0,0,1
Bangladesh,2007-09-01,7,0,0,0,0,7
Bangladesh,2007-09-01,29,0,0,45,0,74
Bangladesh,2007-09-01,4,4,0,6,2,16
Bangladesh,2007-09-01,36,0,0,30,1,67
Bangladesh,2007-09-01,0,0,0,0,0,0
Bangladesh,2007-09-01,3,2,0,18,0,23
Bangladesh,2007-09-01,23,0,0,30,2,55
Bangladesh,2007-09-01,13,4,0,12,0,29
Bangladesh,2007-09-01,10,0,0,3,2,15
Bangladesh,2007-09-01,0,0,-4,7,0,3
Bangladesh,2007-09-01,42,0,0,12,0,54
Bangladesh,2007-09-01,4,2,0,0,0,6
Bangladesh,2007-09-01,2,0,0,0,0,2
Bangladesh,2007-09-01,5,0,0,3,0,8
Bangladesh,2007-09-01,24,2,2,31,11,70
Bangladesh,2007-09-01,14,0,0,24,3,41
Bangladesh,2007-09-01,7,0,-4,6,2,11
Bangladesh,2007-09-01,11,0,0,16,0,27
Bangladesh,2007-09-01,3,0,1,9,0,13
Bangladesh,2007-09-01,0,0,0,0,1,1
Bangladesh,2007-09-01,2,0,1,-1,1,3
Bangladesh,2007-09-01,8,0,0,12,0,20
Bangladesh,2007-09-01,2,0,-2,-1,3,2
Bangladesh,2007-09-01,9,0,0,35,0,44
Bangladesh,2007-09-01,7,0,0,27,3,37
Bangladesh,2007-09-01,0,0,0,0,0,0
Bangladesh,2007-09-01,0,0,0,14,0,14
Bangladesh,2007-09-01,-2,12,-1,4,0,13
Cameroon,2007-09-01,2,0,0,6,2,10
Cameroon,2007-09-01,0,0,0,0,0,0
Cameroon,2007-09-01,0,0,0,0,0,0
Cameroon,2007-09-01,4,0,0,0,0,4
Cameroon,2007-09-01,2,0,0,0,0,2
Cameroon,2007-09-01,0,0,0,0,0,0
Cameroon,2007-09-01,0,0,0,0,0,0
Cameroon,2007-09-01,0,0,0,0,0,0
Cameroon,2007-09-01,9,0,0,0,0,9
Cameroon,2007-09-01,1,0,0,6,0,7
Cameroon,2007-09-01,0,0,0,0,0,0
Cameroon,2007-09-01,0,0,0,0,0,0
Cameroon,2007-09-01,0,0,0,3,0,3
Cameroon,2007-09-01,0,0,0,0,0,0
China,2007-09-01,11,0,0,6,0,17
China,2007-09-01,0,0,0,3,0,3
China,2007-09-01,10,0,0,-2,3,11
China,2007-09-01,161,0,-4,60,14,231
China,2007-09-01,69,8,2,39,5,123
China,2007-09-01,38,0,0,12,4,54
China,2007-09-01,19,0,0,-4,2,17
China,2007-09-01,154,0,-2,12,11,175
China,2007-09-01,169,0,2,22,16,209
China,2007-09-01,50,0,4,15,7,76
China,2007-09-01,73,0,0,24,7,104
China,2007-09-01,88,2,-4,32,6,124
China,2007-09-01,31,0,-2,15,3,47
China,2007-09-01,50,0,-1,27,4,80
China,2007-09-01,16,0,0,6,6,28
China,2007-09-01,4,0,0,0,0,4
China,2007-09-01,73,2,1,18,10,104
China,2007-09-01,48,0,0,42,7,97
China,2007-09-01,64,4,0,33,9,110
China,2007-09-01,69,0,0,28,17,114
China,2007-09-01,60,4,1,40,5,110
China,2007-09-01,73,0,-2,13,7,91
China,2007-09-01,32,0,-2,12,8,50
China,2007-09-01,20,0,0,0,5,25
China,2007-09-01,132,0,1,88,40,261
China,2007-09-01,117,2,-2,56,18,191
China,2007-09-01,90,4,-4,43,7,140
China,2007-09-01,37,0,1,15,2,55
China,2007-09-01,35,0,0,3,3,41
China,2007-09-01,32,0,3,0,0,35
Egypt,2007-09-01,14,0,0,0,0,14
Egypt,2007-09-01,19,0,0,48,0,67
Egypt,2007-09-01,2,0,0,3,0,5
Egypt,2007-09-01,8,0,0,6,0,14
Egypt,2007-09-01,25,0,0,-4,0,21
Egypt,2007-09-01,66,0,0,3,0,69
Egypt,2007-09-01,12,0,0,6,2,20
Egypt,2007-09-01,3,0,0,9,3,15
Egypt,2007-09-01,25,0,-2,6,0,29
Egypt,2007-09-01,5,0,0,30,0,35
Egypt,2007-09-01,7,0,0,13,0,20
Egypt,2007-09-01,12,0,0,18,2,32
Egypt,2007-09-01,11,2,0,0,0,13
Egypt,2007-09-01,4,0,-1,11,2,16
Egypt,2007-09-01,6,0,0,-1,2,7
Egypt,2007-09-01,0,0,0,0,0,0
Egypt,2007-09-01,48,0,0,15,3,66
Egypt,2007-09-01,7,0,0,11,1,19
Egypt,2007-09-01,31,0,0,3,3,37
Egypt,2007-09-01,27,0,-1,3,9,38
Egypt,2007-09-01,26,0,0,-2,0,24
Egypt,2007-09-01,11,0,0,-2,0,9
Egypt,2007-09-01,16,0,0,12,3,31
Egypt,2007-09-01,2,0,0,9,2,13
Egypt,2007-09-01,28,0,0,19,1,48
Egypt,2007-09-01,8,0,0,13,0,21
Egypt,2007-09-01,23,0,0,10,1,34
Egypt,2007-09-01,19,0,0,0,5,24
Egypt,2007-09-01,8,0,0,9,0,17
Egypt,2007-09-01,13,0,0,23,0,36
Eritrea,2007-09-01,8,0,0,0,0,8
Eritrea,2007-09-01,7,0,0,3,0,10
Eritrea,2007-09-01,0,0,0,0,0,0
Eritrea,2007-09-01,0,0,0,0,0,0
Eritrea,2007-09-01,3,0,0,0,0,3
Eritrea,2007-09-01,0,0,0,0,0,0
Eritrea,2007-09-01,2,0,0,0,0,2
Eritrea,2007-09-01,23,0,0,1,0,24
Eritrea,2007-09-01,6,0,0,9,0,15
Eritrea,2007-09-01,6,0,0,0,0,6
Eritrea,2007-09-01,0,0,0,-1,0,-1
Eritrea,2007-09-01,0,0,0,0,0,0
Eritrea,2007-09-01,4,0,0,0,0,4
Eritrea,2007-09-01,14,0,0,0,0,14
Eritrea,2007-09-01,30,0,0,9,0,39
Eritrea,2007-09-01,3,0,0,3,0,6
Eritrea,2007-09-01,5,0,0,0,0,5
Eritrea,2007-09-01,1,0,0,0,0,1
Eritrea,2007-09-01,0,0,0,0,0,0
Eritrea,2007-09-01,2,0,0,0,0,2
Eritrea,2007-09-01,0,0,0,0,0,0
Eritrea,2007-09-01,0,0,0,0,0,0
Eritrea,2007-09-01,11,0,1,0,0,12
Eritrea,2007-09-01,3,0,0,0,0,3
Eritrea,2007-09-01,2,0,0,0,0,2
Georgia,2007-09-01,-1,0,0,0,0,-1
Georgia,2007-09-01,0,0,0,0,0,0
Georgia,2007-09-01,7,0,0,9,1,17
Georgia,2007-09-01,0,0,0,9,0,9
Georgia,2007-09-01,15,0,0,-2,0,13
Georgia,2007-09-01,6,0,0,0,0,6
Georgia,2007-09-01,3,2,0,6,0,11
Georgia,2007-09-01,0,0,0,0,0,0
Georgia,2007-09-01,3,0,0,3,0,6
Georgia,2007-09-01,10,0,0,3,0,13
Georgia,2007-09-01,6,0,0,9,0,15
Georgia,2007-09-01,2,0,0,0,0,2
Georgia,2007-09-01,9,0,0,6,2,17
Georgia,2007-09-01,2,0,0,0,0,2
Georgia,2007-09-01,8,0,0,6,0,14
Georgia,2007-09-01,10,0,0,9,0,19
Georgia,2007-09-01,4,0,0,3,1,8
Georgia,2007-09-01,2,0,0,3,1,6
Georgia,2007-09-01,3,0,0,2,2,7
Georgia,2007-09-01,2,0,0,6,0,8
Georgia,2007-09-01,6,0,0,0,0,6
Georgia,2007-09-01,3,0,0,0,0,3
Georgia,2007-09-01,14,0,0,-2,0,12
Georgia,2007-09-01,13,0,0,3,1,17
Georgia,2007-09-01,50,0,0,9,0,59
Georgia,2007-09-01,8,0,0,4,4,16
Georgia,2007-09-01,2,0,0,-2,0,0
Georgia,2007-09-01,0,0,0,0,1,1
India,2007-09-01,13,0,0,0,0,13
India,2007-09-01,0,0,0,0,0,0
India,2007-09-01,0,0,0,0,0,0
India,2007-09-01,42,4,-3,4,4,51
India,2007-09-01,28,2,-1,20,0,49
India,2007-09-01,17,0,-2,9,3,27
India,2007-09-01,19,0,0,18,4,41
India,2007-09-01,25,0,1,13,4,43
India,2007-09-01,14,0,0,2,0,16
India,2007-09-01,14,0,2,3,1,20
India,2007-09-01,16,0,0,0,1,17
India,2007-09-01,23,0,-1,15,3,40
India,2007-09-01,40,0,0,0,0,40
India,2007-09-01,22,0,0,8,1,31
India,2007-09-01,6,0,0,-1,1,6
India,2007-09-01,9,0,0,0,0,9
India,2007-09-01,19,2,-4,21,9,47
India,2007-09-01,32,0,-2,-4,5,31
India,2007-09-01,50,0,-2,37,5,90
India,2007-09-01,39,0,-5,22,6,62
India,2007-09-01,31,2,0,-1,3,35
India,2007-09-01,12,0,0,5,0,17
India,2007-09-01,16,0,-1,5,1,21
India,2007-09-01,6,0,0,-2,4,8
India,2007-09-01,39,0,-2,0,3,40
India,2007-09-01,35,0,-5,9,3,42
India,2007-09-01,16,0,-2,0,2,16
India,2007-09-01,14,0,0,0,0,14
India,2007-09-01,3,0,0,3,0,6
India,2007-09-01,16,0,0,0,0,16
Iran,2007-09-01,25,0,0,24,1,50
Iran,2007-09-01,14,0,0,0,0,14
Iran,2007-09-01,8,0,0,-6,2,4
Iran,2007-09-01,122,2,0,26,5,155
Iran,2007-09-01,44,0,0,21,10,75
Iran,2007-09-01,61,0,0,13,3,77
Iran,2007-09-01,27,0,0,3,0,30
Iran,2007-09-01,65,0,0,6,3,74
Iran,2007-09-01,60,0,1,4,2,67
Iran,2007-09-01,79,0,0,16,9,104
Iran,2007-09-01,69,0,0,-20,5,54
Iran,2007-09-01,39,0,-3,24,7,67
Iran,2007-09-01,34,0,1,12,3,50
Iran,2007-09-01,26,0,0,31,0,57
Iran,2007-09-01,14,2,0,4,2,22
Iran,2007-09-01,22,0,0,-8,0,14
Iran,2007-09-01,139,2,1,0,16,158
Iran,2007-09-01,117,0,3,47,11,178
Iran,2007-09-01,105,0,-1,21,31,156
Iran,2007-09-01,103,0,2,49,19,173
Iran,2007-09-01,101,0,-3,44,23,165
Iran,2007-09-01,50,0,0,25,18,93
Iran,2007-09-01,92,0,4,9,10,115
Iran,2007-09-01,87,0,0,14,11,112
Iran,2007-09-01,176,0,0,51,32,259
Iran,2007-09-01,107,8,1,-3,11,124
Iran,2007-09-01,60,0,1,5,3,69
Iran,2007-09-01,12,0,0,3,0,15
Iran,2007-09-01,2,0,-2,0,4,4
Iran,2007-09-01,14,0,1,2,0,17
Iraq,2007-09-01,65,0,-2,-2,1,62
Iraq,2007-09-01,37,0,-2,10,0,45
Iraq,2007-09-01,5,2,0,8,0,15
Iraq,2007-09-01,488,0,-15,157,44,674
Iraq,2007-09-01,218,0,-13,36,20,261
Iraq,2007-09-01,110,0,2,70,12,194
Iraq,2007-09-01,68,0,0,12,3,83
Iraq,2007-09-01,108,0,0,38,50,196
Iraq,2007-09-01,134,0,1,22,15,172
Iraq,2007-09-01,346,2,-3,21,12,378
Iraq,2007-09-01,326,0,5,15,16,362
Iraq,2007-09-01,121,0,-6,29,16,160
Iraq,2007-09-01,49,0,-4,-2,2,45
Iraq,2007-09-01,160,0,-8,79,27,258
Iraq,2007-09-01,54,0,0,5,7,66
Iraq,2007-09-01,51,0,0,6,9,66
Iraq,2007-09-01,176,2,0,52,31,261
Iraq,2007-09-01,131,0,0,32,27,190
Iraq,2007-09-01,158,0,0,39,27,224
Iraq,2007-09-01,201,0,-3,73,22,293
Iraq,2007-09-01,224,4,2,6,20,256
Iraq,2007-09-01,112,0,1,2,10,125
Iraq,2007-09-01,91,2,5,15,4,117
Iraq,2007-09-01,49,4,1,11,10,75
Iraq,2007-09-01,137,0,-4,21,17,171
Iraq,2007-09-01,232,4,0,59,9,304
Iraq,2007-09-01,149,0,1,21,10,181
Iraq,2007-09-01,139,4,0,15,3,161
Iraq,2007-09-01,85,0,0,9,6,100
Iraq,2007-09-01,86,0,0,9,2,97
Morocco,2007-09-01,0,0,0,6,0,6
Morocco,2007-09-01,2,0,0,0,0,2
Morocco,2007-09-01,13,0,0,0,3,16
Morocco,2007-09-01,1,0,-2,0,1,0
Morocco,2007-09-01,0,0,0,0,0,0
Morocco,2007-09-01,3,0,0,0,0,3
Morocco,2007-09-01,3,0,0,0,0,3
Morocco,2007-09-01,18,0,0,16,2,36
Morocco,2007-09-01,3,0,0,-4,1,0
Morocco,2007-09-01,4,0,0,0,0,4
Morocco,2007-09-01,7,0,0,9,2,18
Morocco,2007-09-01,-1,0,0,0,0,-1
Morocco,2007-09-01,8,0,2,3,0,13
Morocco,2007-09-01,2,0,0,0,0,2
Morocco,2007-09-01,0,0,0,0,0,0
Morocco,2007-09-01,8,0,0,3,0,11
Morocco,2007-09-01,-2,0,0,18,0,16
Morocco,2007-09-01,2,0,0,0,0,2
Morocco,2007-09-01,2,0,0,3,0,5
Morocco,2007-09-01,0,0,0,3,0,3
Morocco,2007-09-01,4,0,0,0,0,4
Morocco,2007-09-01,0,0,0,3,0,3
Morocco,2007-09-01,3,0,0,0,0,3
Morocco,2007-09-01,0,0,0,0,0,0
Morocco,2007-09-01,8,0,0,0,0,8
Morocco,2007-09-01,0,0,0,0,0,0
Morocco,2007-09-01,2,0,2,0,0,4
Morocco,2007-09-01,0,0,0,0,0,0
Nigeria,2007-09-01,0,0,1,1,0,2
Nigeria,2007-09-01,4,0,0,2,3,9
Nigeria,2007-09-01,8,0,0,3,0,11
Nigeria,2007-09-01,4,0,0,-3,0,1
Nigeria,2007-09-01,0,0,0,0,0,0
Nigeria,2007-09-01,0,0,0,0,1,1
Nigeria,2007-09-01,7,0,-2,9,4,18
Nigeria,2007-09-01,3,0,0,0,1,4
Nigeria,2007-09-01,2,0,0,0,0,2
Nigeria,2007-09-01,0,0,0,0,0,0
Nigeria,2007-09-01,3,0,0,3,0,6
Nigeria,2007-09-01,0,0,0,0,0,0
Nigeria,2007-09-01,25,0,0,-4,0,21
Nigeria,2007-09-01,18,0,-4,0,1,15
Nigeria,2007-09-01,41,0,-4,6,1,44
Nigeria,2007-09-01,7,0,-2,0,0,5
Nigeria,2007-09-01,2,0,0,15,4,21
Nigeria,2007-09-01,7,8,0,-6,0,9
Nigeria,2007-09-01,1,0,0,12,1,14
Nigeria,2007-09-01,9,0,0,3,4,16
Nigeria,2007-09-01,22,0,0,9,0,31
Nigeria,2007-09-01,42,0,0,9,4,55
Nigeria,2007-09-01,23,0,2,33,0,58
Nigeria,2007-09-01,7,0,0,3,1,11
Nigeria,2007-09-01,-1,0,2,12,0,13
Nigeria,2007-09-01,3,0,0,0,0,3
Pakistan,2007-09-01,28,0,-2,-3,11,34
Pakistan,2007-09-01,12,0,0,6,4,22
Pakistan,2007-09-01,4,0,0,4,4,12
Pakistan,2007-09-01,63,2,-5,44,12,116
Pakistan,2007-09-01,73,0,0,48,12,133
Pakistan,2007-09-01,47,0,0,46,0,93
Pakistan,2007-09-01,2,0,2,44,5,53
Pakistan,2007-09-01,22,0,0,52,0,74
Pakistan,2007-09-01,55,0,-1,25,8,87
Pakistan,2007-09-01,119,0,-4,149,15,279
Pakistan,2007-09-01,61,0,0,126,20,207
Pakistan,2007-09-01,42,0,-4,39,13,90
Pakistan,2007-09-01,8,0,0,6,0,14
Pakistan,2007-09-01,34,0,-5,47,3,79
Pakistan,2007-09-01,9,0,-2,21,0,28
Pakistan,2007-09-01,1,0,1,9,3,14
Pakistan,2007-09-01,50,0,-14,50,17,103
Pakistan,2007-09-01,53,2,-7,6,4,58
Pakistan,2007-09-01,40,0,-2,53,4,95
Pakistan,2007-09-01,40,0,-12,40,4,72
Pakistan,2007-09-01,29,0,0,28,1,58
Pakistan,2007-09-01,38,0,0,0,1,39
Pakistan,2007-09-01,14,0,0,2,7,23
Pakistan,2007-09-01,14,0,-6,3,4,15
Pakistan,2007-09-01,36,0,-2,9,5,48
Pakistan,2007-09-01,74,0,-6,14,1,83
Pakistan,2007-09-01,24,4,-2,82,9,117
Pakistan,2007-09-01,5,0,0,-5,4,4
Pakistan,2007-09-01,24,12,0,1,0,37
Pakistan,2007-09-01,3,0,0,0,0,3
Sierra Leone,2007-09-01,0,0,0,0,0,0
Sierra Leone,2007-09-01,2,0,-4,6,0,4
Sierra Leone,2007-09-01,0,0,0,0,2,2
Sierra Leone,2007-09-01,2,0,0,3,0,5
Sierra Leone,2007-09-01,2,0,0,6,0,8
Sierra Leone,2007-09-01,0,0,1,0,0,1
Sierra Leone,2007-09-01,-2,0,0,3,0,1
Sierra Leone,2007-09-01,0,0,-2,0,1,-1
Sierra Leone,2007-09-01,1,0,0,0,1,2
Sierra Leone,2007-09-01,0,0,0,0,0,0
Sierra Leone,2007-09-01,0,0,-4,0,0,-4
Sierra Leone,2007-09-01,0,0,-2,0,0,-2
Sierra Leone,2007-09-01,0,0,0,-4,0,-4
Sierra Leone,2007-09-01,10,0,3,6,2,21
Sierra Leone,2007-09-01,6,0,0,6,0,12
Sierra Leone,2007-09-01,7,0,0,9,2,18
Sierra Leone,2007-09-01,3,0,0,-1,0,2
Sierra Leone,2007-09-01,2,0,0,-4,0,-2
Sierra Leone,2007-09-01,0,0,0,3,0,3
Sierra Leone,2007-09-01,8,0,0,0,0,8
Sierra Leone,2007-09-01,2,0,0,6,0,8
Sierra Leone,2007-09-01,-5,0,0,6,4,5
Sierra Leone,2007-09-01,2,0,0,0,0,2
Sierra Leone,2007-09-01,0,0,0,3,0,3
Somalia,2007-09-01,1,0,0,0,0,1
Somalia,2007-09-01,-2,0,0,0,0,-2
Somalia,2007-09-01,0,0,0,6,0,6
Somalia,2007-09-01,8,0,2,7,0,17
Somalia,2007-09-01,24,0,0,16,0,40
Somalia,2007-09-01,7,0,0,-2,0,5
Somalia,2007-09-01,6,0,0,0,0,6
Somalia,2007-09-01,16,0,0,0,1,17
Somalia,2007-09-01,5,0,0,3,5,13
Somalia,2007-09-01,0,0,0,18,0,18
Somalia,2007-09-01,17,0,0,-6,2,13
Somalia,2007-09-01,17,0,0,0,0,17
Somalia,2007-09-01,2,0,0,0,0,2
Somalia,2007-09-01,1,0,0,0,2,3
Somalia,2007-09-01,4,0,0,6,0,10
Somalia,2007-09-01,0,0,0,0,0,0
Somalia,2007-09-01,3,0,0,0,0,3
Somalia,2007-09-01,-4,0,0,-1,2,-3
Somalia,2007-09-01,20,4,0,9,0,33
Somalia,2007-09-01,21,0,0,-2,0,19
Somalia,2007-09-01,7,0,0,0,0,7
Somalia,2007-09-01,12,0,0,0,0,12
Somalia,2007-09-01,0,0,0,0,0,0
Somalia,2007-09-01,4,0,0,0,0,4
Somalia,2007-09-01,1,2,0,0,0,3
Somalia,2007-09-01,23,0,0,0,1,24
Somalia,2007-09-01,3,2,0,0,2,7
Somalia,2007-09-01,0,0,0,0,0,0
Somalia,2007-09-01,0,0,0,0,0,0
Somalia,2007-09-01,6,0,0,0,0,6
Syria,2007-09-01,2,0,0,0,0,2
Syria,2007-09-01,-6,0,0,0,0,-6
Syria,2007-09-01,-5,0,0,-4,2,-7
Syria,2007-09-01,72,0,2,-2,5,77
Syria,2007-09-01,38,0,-3,0,1,36
Syria,2007-09-01,106,0,-1,12,2,119
Syria,2007-09-01,7,0,0,0,0,7
Syria,2007-09-01,17,0,0,6,0,23
Syria,2007-09-01,22,0,-4,8,1,27
Syria,2007-09-01,46,0,-4,4,2,48
Syria,2007-09-01,70,0,0,-5,3,68
Syria,2007-09-01,48,0,0,0,7,55
Syria,2007-09-01,23,0,0,0,0,23
Syria,2007-09-01,13,0,-6,0,0,7
Syria,2007-09-01,11,0,-4,0,0,7
Syria,2007-09-01,15,0,0,24,0,39
Syria,2007-09-01,47,0,0,36,1,84
Syria,2007-09-01,89,0,-5,0,0,84
Syria,2007-09-01,179,0,2,15,36,232
Syria,2007-09-01,142,0,-5,10,24,171
Syria,2007-09-01,152,0,0,9,0,161
Syria,2007-09-01,11,0,0,30,2,43
Syria,2007-09-01,57,0,0,21,3,81
Syria,2007-09-01,52,0,-6,0,3,49
Syria,2007-09-01,70,0,-6,23,3,90
Syria,2007-09-01,39,0,0,18,3,60
Syria,2007-09-01,35,0,-5,-10,2,22
Syria,2007-09-01,20,0,-2,0,0,18
Syria,2007-09-01,4,0,0,0,0,4
Syria,2007-09-01,0,0,0,36,0,36
Yemen,2007-09-01,4,4,0,18,5,31
Yemen,2007-09-01,11,0,0,0,1,12
Yemen,2007-09-01,8,0,0,9,0,17
Yemen,2007-09-01,0,0,0,0,0,0
Yemen,2007-09-01,-1,0,0,3,0,2
Yemen,2007-09-01,14,0,0,11,0,25
Yemen,2007-09-01,3,0,0,7,0,10
Yemen,2007-09-01,4,0,-4,6,0,6
Yemen,2007-09-01,15,0,0,15,0,30
Yemen,2007-09-01,3,0,0,0,0,3
Yemen,2007-09-01,-1,0,0,0,0,-1
Yemen,2007-09-01,6,0,0,12,0,18
Yemen,2007-09-01,46,0,-4,-2,2,42
Yemen,2007-09-01,6,2,0,6,4,18
Yemen,2007-09-01,5,0,0,3,0,8
Yemen,2007-09-01,-1,0,0,0,0,-1
Yemen,2007-09-01,0,0,0,-2,0,-2
Yemen,2007-09-01,4,0,0,0,0,4
Yemen,2007-09-01,0,0,0,0,0,0
Yemen,2007-09-01,0,0,0,0,0,0
Yemen,2007-09-01,7,0,0,6,3,16
Yemen,2007-09-01,9,0,0,0,0,9
Yemen,2007-09-01,0,0,0,0,0,0
Yemen,2007-09-01,0,0,0,0,0,0
Yemen,2007-09-01,15,0,0,18,0,33
Afghanistan,2009-12-01,666,2,1,130,87,886
Afghanistan,2009-12-01,898,6,-12,49,83,1024
Afghanistan,2009-12-01,762,16,-6,65,54,891
Afghanistan,2009-12-01,599,10,-3,41,49,696
Afghanistan,2009-12-01,279,0,1,12,26,318
Afghanistan,2009-12-01,237,2,-4,49,16,300
Afghanistan,2009-12-01,402,4,0,48,110,564
Afghanistan,2009-12-01,418,12,-13,123,64,604
Afghanistan,2009-12-01,334,2,-14,168,21,511
Afghanistan,2009-12-01,433,2,-6,198,76,703
Afghanistan,2009-12-01,332,10,-14,70,41,439
Afghanistan,2009-12-01,236,6,-6,63,26,325
Afghanistan,2009-12-01,267,2,-8,31,9,301
Afghanistan,2009-12-01,264,0,-8,89,15,360
Afghanistan,2009-12-01,441,0,1,30,73,545
Afghanistan,2009-12-01,315,6,-13,95,43,446
Afghanistan,2009-12-01,325,2,-8,67,47,433
Afghanistan,2009-12-01,280,0,-3,59,28,364
Afghanistan,2009-12-01,233,0,-2,81,16,328
Afghanistan,2009-12-01,121,0,0,25,3,149
Afghanistan,2009-12-01,133,0,-5,60,19,207
Afghanistan,2009-12-01,230,0,-1,30,33,292
Afghanistan,2009-12-01,236,2,0,28,15,281
Afghanistan,2009-12-01,301,0,1,53,153,508
Afghanistan,2009-12-01,231,0,0,98,11,340
Afghanistan,2009-12-01,214,0,-2,38,5,255
Afghanistan,2009-12-01,200,0,-11,37,6,232
Afghanistan,2009-12-01,276,2,-2,36,34,346
Afghanistan,2009-12-01,215,0,0,6,23,244
Afghanistan,2009-12-01,245,0,-2,9,21,273
Afghanistan,2009-12-01,374,4,4,8,43,433
Albania,2009-12-01,21,0,2,12,1,36
Albania,2009-12-01,17,0,0,1,1,19
Albania,2009-12-01,-13,0,0,0,2,-11
Albania,2009-12-01,-5,0,0,0,0,-5
Albania,2009-12-01,15,0,0,3,0,18
Albania,2009-12-01,22,0,0,10,0,32
Albania,2009-12-01,14,0,0,6,0,20
Albania,2009-12-01,7,0,-2,3,2,10
Albania,2009-12-01,4,0,0,3,0,7
Albania,2009-12-01,11,0,-4,15,0,22
Albania,2009-12-01,35,0,0,9,0,44
Albania,2009-12-01,4,0,0,0,0,4
Albania,2009-12-01,5,0,0,0,0,5
Albania,2009-12-01,6,0,0,-2,3,7
Albania,2009-12-01,14,0,0,2,1,17
Albania,2009-12-01,21,0,0,3,0,24
Albania,2009-12-01,6,0,0,0,0,6
Albania,2009-12-01,9,0,0,3,0,12
Albania,2009-12-01,3,0,-1,3,0,5
Albania,2009-12-01,0,0,0,0,0,0
Albania,2009-12-01,0,0,0,4,7,11
Albania,2009-12-01,2,0,0,18,0,20
Albania,2009-12-01,0,0,0,0,0,0
Albania,2009-12-01,1,0,0,12,0,13
Albania,2009-12-01,0,0,0,6,0,6
Albania,2009-12-01,6,0,0,0,0,6
Albania,2009-12-01,0,0,0,0,0,0
Albania,2009-12-01,9,0,1,3,0,13
Albania,2009-12-01,6,0,0,3,0,9
Albania,2009-12-01,3,0,0,3,0,6
Albania,2009-12-01,23,0,0,0,0,23
Algeria,2009-12-01,12,0,-2,22,0,32
Algeria,2009-12-01,10,0,0,9,0,19
Algeria,2009-12-01,8,0,0,11,0,19
Algeria,2009-12-01,17,0,0,5,0,22
Algeria,2009-12-01,3,0,0,-4,0,-1
Algeria,2009-12-01,1,0,0,-1,0,0
Algeria,2009-12-01,4,0,0,21,3,28
Algeria,2009-12-01,3,0,0,3,0,6
Algeria,2009-12-01,-1,0,0,30,4,33
Algeria,2009-12-01,-7,0,0,6,3,2
Algeria,2009-12-01,12,0,0,0,1,13
Algeria,2009-12-01,4,2,0,0,3,9
Algeria,2009-12-01,1,2,0,6,0,9
Algeria,2009-12-01,4,0,0,6,2,12
Algeria,2009-12-01,11,0,0,4,4,19
Algeria,2009-12-01,9,0,0,6,0,15
Algeria,2009-12-01,7,0,0,0,0,7
Algeria,2009-12-01,8,0,0,31,0,39
Algeria,2009-12-01,1,0,0,18,0,19
Algeria,2009-12-01,3,0,0,0,2,5
Algeria,2009-12-01,2,0,0,10,4,16
Algeria,2009-12-01,2,0,0,4,3,9
Algeria,2009-12-01,5,0,0,18,0,23
Algeria,2009-12-01,16,0,0,3,4,23
Algeria,2009-12-01,0,0,0,1,0,1
Algeria,2009-12-01,0,0,0,0,0,0
Algeria,2009-12-01,11,0,0,6,0,17
Algeria,2009-12-01,5,0,0,15,0,20
Algeria,2009-12-01,12,0,0,13,0,25
Algeria,2009-12-01,0,0,0,9,1,10
Algeria,2009-12-01,7,0,0,-4,0,3
Bangladesh,2009-12-01,9,0,0,10,0,19
Bangladesh,2009-12-01,25,4,0,25,0,54
Bangladesh,2009-12-01,61,0,0,5,4,70
Bangladesh,2009-12-01,87,0,1,55,5,148
Bangladesh,2009-12-01,56,0,0,58,1,115
Bangladesh,2009-12-01,46,2,-2,-5,0,41
Bangladesh,2009-12-01,26,0,0,6,2,34
Bangladesh,2009-12-01,15,0,-2,40,0,53
Bangladesh,2009-12-01,31,0,-2,26,7,62
Bangladesh,2009-12-01,12,0,0,3,4,19
Bangladesh,2009-12-01,12,0,0,0,0,12
Bangladesh,2009-12-01,2,0,0,0,3,5
Bangladesh,2009-12-01,7,0,-2,15,4,24
Bangladesh,2009-12-01,15,0,-3,30,5,47
Bangladesh,2009-12-01,12,0,0,17,4,33
Bangladesh,2009-12-01,19,0,-3,0,2,18
Bangladesh,2009-12-01,10,0,-1,11,5,25
Bangladesh,2009-12-01,35,0,-1,10,5,49
Bangladesh,2009-12-01,13,0,0,9,0,22
Bangladesh,2009-12-01,10,0,0,16,0,26
Bangladesh,2009-12-01,7,0,0,7,0,14
Bangladesh,2009-12-01,12,0,0,19,2,33
Bangladesh,2009-12-01,12,2,0,6,2,22
Bangladesh,2009-12-01,3,0,0,9,0,12
Bangladesh,2009-12-01,4,0,0,15,5,24
Bangladesh,2009-12-01,6,0,0,21,2,29
Bangladesh,2009-12-01,13,0,0,11,1,25
Bangladesh,2009-12-01,2,0,0,0,0,2
Bangladesh,2009-12-01,15,0,-2,14,3,30
Bangladesh,2009-12-01,1,0,-1,5,0,5
Bangladesh,2009-12-01,5,0,0,4,0,9
Cameroon,2009-12-01,31,0,0,0,0,31
Cameroon,2009-12-01,22,0,0,0,0,22
Cameroon,2009-12-01,7,0,0,3,0,10
Cameroon,2009-12-01,-2,0,0,0,0,-2
Cameroon,2009-12-01,0,0,0,0,0,0
Cameroon,2009-12-01,0,0,0,0,0,0
Cameroon,2009-12-01,6,0,0,6,0,12
Cameroon,2009-12-01,0,0,0,3,0,3
Cameroon,2009-12-01,0,0,0,3,0,3
Cameroon,2009-12-01,4,0,0,0,0,4
Cameroon,2009-12-01,0,0,0,0,0,0
Cameroon,2009-12-01,3,0,0,0,2,5
Cameroon,2009-12-01,0,0,0,0,0,0
Cameroon,2009-12-01,2,0,0,6,0,8
Cameroon,2009-12-01,3,0,0,0,0,3
Cameroon,2009-12-01,2,0,0,0,0,2
Cameroon,2009-12-01,2,0,0,3,0,5
Cameroon,2009-12-01,0,0,0,0,4,4
Cameroon,2009-12-01,-1,0,2,6,0,7
Cameroon,2009-12-01,2,0,0,1,0,3
Cameroon,2009-12-01,0,0,0,0,0,0
Cameroon,2009-12-01,0,0,0,0,0,0
Cameroon,2009-12-01,-1,0,0,0,0,-1
Cameroon,2009-12-01,0,0,0,0,0,0
Cameroon,2009-12-01,0,0,0,0,0,0
Cameroon,2009-12-01,1,0,0,0,0,1
Cameroon,2009-12-01,0,0,0,0,2,2
Cameroon,2009-12-01,2,0,0,0,0,2
Cameroon,2009-12-01,1,0,0,0,0,1
China,2009-12-01,202,4,-7,67,11,277
China,2009-12-01,163,0,3,62,19,247
China,2009-12-01,146,2,-6,92,13,247
China,2009-12-01,104,0,0,89,28,221
China,2009-12-01,92,4,2,30,13,141
China,2009-12-01,114,0,0,21,7,142
China,2009-12-01,146,4,-16,54,17,205
China,2009-12-01,89,0,-3,9,16,111
China,2009-12-01,186,0,2,26,18,232
China,2009-12-01,115,0,-13,25,17,144
China,2009-12-01,100,4,-2,77,5,184
China,2009-12-01,65,6,3,27,16,117
China,2009-12-01,92,4,3,86,15,200
China,2009-12-01,123,2,1,173,17,316
China,2009-12-01,90,4,-2,128,14,234
China,2009-12-01,124,0,-14,115,24,249
China,2009-12-01,203,0,-4,111,31,341
China,2009-12-01,188,0,-3,141,28,354
China,2009-12-01,100,0,-7,110,16,219
China,2009-12-01,115,2,2,28,23,170
China,2009-12-01,124,4,3,88,15,234
China,2009-12-01,218,0,1,78,19,316
China,2009-12-01,234,8,3,85,16,346
China,2009-12-01,136,8,-3,76,27,244
China,2009-12-01,39,2,-3,29,5,72
China,2009-12-01,53,0,5,-1,11,68
China,2009-12-01,52,8,5,20,9,94
China,2009-12-01,106,6,-7,66,15,186
China,2009-12-01,172,2,-2,173,25,370
China,2009-12-01,149,0,-1,33,21,202
China,2009-12-01,83,0,-8,40,9,124
Egypt,2009-12-01,30,0,-1,10,3,42
Egypt,2009-12-01,10,0,0,12,5,27
Egypt,2009-12-01,14,0,0,38,8,60
Egypt,2009-12-01,26,0,0,29,1,56
Egypt,2009-12-01,12,0,0,5,1,18
Egypt,2009-12-01,15,0,-2,23,2,38
Egypt,2009-12-01,34,0,0,50,3,87
Egypt,2009-12-01,25,0,0,27,4,56
Egypt,2009-12-01,27,2,0,-4,3,28
Egypt,2009-12-01,52,2,2,-4,8,60
Egypt,2009-12-01,71,0,0,7,0,78
Egypt,2009-12-01,16,0,-1,30,0,45
Egypt,2009-12-01,38,0,0,1,3,42
Egypt,2009-12-01,52,0,0,15,0,67
Egypt,2009-12-01,24,0,0,19,2,45
Egypt,2009-12-01,40,0,0,26,2,68
Egypt,2009-12-01,55,0,0,39,5,99
Egypt,2009-12-01,29,0,0,13,1,43
Egypt,2009-12-01,36,0,0,17,10,63
Egypt,2009-12-01,32,0,0,3,2,37
Egypt,2009-12-01,82,0,-5,23,1,101
Egypt,2009-12-01,39,0,2,15,5,61
Egypt,2009-12-01,34,0,2,47,2,85
Egypt,2009-12-01,54,0,0,7,7,68
Egypt,2009-12-01,27,4,0,-9,2,24
Egypt,2009-12-01,17,0,0,21,0,38
Egypt,2009-12-01,56,2,0,-2,8,64
Egypt,2009-12-01,57,0,-1,-5,9,60
Egypt,2009-12-01,28,0,0,9,8,45
Egypt,2009-12-01,52,0,0,8,0,60
Egypt,2009-12-01,14,0,-2,32,5,49
Eritrea,2009-12-01,19,0,1,0,0,20
Eritrea,2009-12-01,0,0,0,3,0,3
Eritrea,2009-12-01,18,0,0,1,3,22
Eritrea,2009-12-01,9,0,0,2,0,11
Eritrea,2009-12-01,0,0,0,0,0,0
Eritrea,2009-12-01,15,0,0,0,0,15
Eritrea,2009-12-01,6,0,0,0,0,6
Eritrea,2009-12-01,2,0,0,48,0,50
Eritrea,2009-12-01,0,0,0,30,0,30
Eritrea,2009-12-01,2,0,0,43,0,45
Eritrea,2009-12-01,0,0,0,36,0,36
Eritrea,2009-12-01,3,0,0,6,0,9
Eritrea,2009-12-01,0,0,0,0,0,0
Eritrea,2009-12-01,0,0,0,17,0,17
Eritrea,2009-12-01,0,0,0,0,0,0
Eritrea,2009-12-01,5,0,0,0,2,7
Eritrea,2009-12-01,6,0,0,4,1,11
Eritrea,2009-12-01,1,0,0,6,0,7
Eritrea,2009-12-01,9,0,0,0,0,9
Eritrea,2009-12-01,1,0,0,0,0,1
Eritrea,2009-12-01,3,0,0,0,0,3
Eritrea,2009-12-01,6,0,0,9,0,15
Eritrea,2009-12-01,0,0,0,8,0,8
Eritrea,2009-12-01,7,0,0,4,2,13
Eritrea,2009-12-01,0,0,0,0,0,0
Eritrea,2009-12-01,4,0,2,0,0,6
Eritrea,2009-12-01,2,0,0,0,0,2
Eritrea,2009-12-01,8,0,0,0,0,8
Eritrea,2009-12-01,9,0,-1,3,0,11
Eritrea,2009-12-01,11,0,0,21,3,35
Eritrea,2009-12-01,3,0,0,0,0,3
Georgia,2009-12-01,42,0,-5,7,7,51
Georgia,2009-12-01,41,2,0,19,3,65
Georgia,2009-12-01,34,0,-5,6,5,40
Georgia,2009-12-01,24,0,2,26,6,58
Georgia,2009-12-01,9,0,2,0,1,12
Georgia,2009-12-01,4,0,0,0,0,4
Georgia,2009-12-01,24,0,2,15,0,41
Georgia,2009-12-01,21,0,1,24,2,48
Georgia,2009-12-01,22,0,-4,31,6,55
Georgia,2009-12-01,19,2,-1,8,6,34
Georgia,2009-12-01,5,2,0,20,4,31
Georgia,2009-12-01,17,0,0,9,0,26
Georgia,2009-12-01,-1,0,0,9,0,8
Georgia,2009-12-01,27,0,-4,43,8,74
Georgia,2009-12-01,18,4,-2,54,6,80
Georgia,2009-12-01,30,2,-2,36,2,68
Georgia,2009-12-01,14,0,-2,-5,3,10
Georgia,2009-12-01,24,0,0,-8,3,19
Georgia,2009-12-01,-1,0,-1,-11,0,-13
Georgia,2009-12-01,6,0,0,3,0,9
Georgia,2009-12-01,19,0,0,10,2,31
Georgia,2009-12-01,5,4,-6,11,4,18
Georgia,2009-12-01,27,2,-2,19,6,52
Georgia,2009-12-01,12,0,0,9,3,24
Georgia,2009-12-01,1,0,0,0,0,1
Georgia,2009-12-01,13,0,0,9,0,22
Georgia,2009-12-01,5,0,0,3,0,8
Georgia,2009-12-01,21,0,0,4,1,26
Georgia,2009-12-01,16,0,0,1,3,20
Georgia,2009-12-01,14,0,1,3,4,22
Georgia,2009-12-01,11,0,0,7,3,21
India,2009-12-01,60,0,-4,-2,14,68
India,2009-12-01,10,0,-2,6,0,14
India,2009-12-01,84,10,0,-9,3,88
India,2009-12-01,96,4,-1,12,21,132
India,2009-12-01,84,0,1,36,5,126
India,2009-12-01,85,0,1,-1,6,91
India,2009-12-01,90,0,1,26,21,138
India,2009-12-01,71,0,-10,14,7,82
India,2009-12-01,75,0,3,12,10,100
India,2009-12-01,47,0,0,25,10,82
India,2009-12-01,98,2,1,9,16,126
India,2009-12-01,44,0,-3,16,11,68
India,2009-12-01,55,0,-2,5,11,69
India,2009-12-01,81,0,-4,8,9,94
India,2009-12-01,79,0,-5,20,13,107
India,2009-12-01,81,12,2,42,15,152
India,2009-12-01,32,2,-2,19,9,60
India,2009-12-01,86,0,0,23,4,113
India,2009-12-01,47,2,-5,13,8,65
India,2009-12-01,29,2,1,3,6,41
India,2009-12-01,54,0,0,28,2,84
India,2009-12-01,37,0,-1,17,4,57
India,2009-12-01,62,2,1,4,9,78
India,2009-12-01,36,2,1,14,9,62
India,2009-12-01,43,2,1,2,5,53
India,2009-12-01,62,2,1,4,17,86
India,2009-12-01,63,0,-4,19,13,91
India,2009-12-01,48,2,-8,-6,4,40
India,2009-12-01,48,2,1,3,3,57
India,2009-12-01,31,4,0,17,9,61
India,2009-12-01,22,0,-2,13,25,58
Iran,2009-12-01,192,0,0,114,3,309
Iran,2009-12-01,65,0,0,49,9,123
Iran,2009-12-01,90,0,0,37,11,138
Iran,2009-12-01,53,0,-8,13,0,58
Iran,2009-12-01,25,0,0,18,2,45
Iran,2009-12-01,36,0,0,12,2,50
Iran,2009-12-01,41,2,0,23,13,79
Iran,2009-12-01,73,4,0,77,6,160
Iran,2009-12-01,71,0,-1,75,8,153
Iran,2009-12-01,93,0,2,46,11,152
Iran,2009-12-01,71,0,5,32,13,121
Iran,2009-12-01,36,0,0,32,0,68
Iran,2009-12-01,44,0,0,82,11,137
Iran,2009-12-01,65,0,1,131,18,215
Iran,2009-12-01,110,0,0,42,45,197
Iran,2009-12-01,138,0,1,45,7,191
Iran,2009-12-01,100,0,2,49,7,158
Iran,2009-12-01,236,2,1,98,14,351
Iran,2009-12-01,102,2,0,62,8,174
Iran,2009-12-01,71,0,1,24,8,104
Iran,2009-12-01,173,0,1,66,31,271
Iran,2009-12-01,95,0,0,34,14,143
Iran,2009-12-01,66,0,3,47,19,135
Iran,2009-12-01,92,0,2,38,8,140
Iran,2009-12-01,29,0,2,22,1,54
Iran,2009-12-01,52,0,0,30,-1,81
Iran,2009-12-01,101,0,-1,32,18,150
Iran,2009-12-01,147,0,1,109,26,283
Iran,2009-12-01,174,0,0,140,38,352
Iran,2009-12-01,146,0,2,97,20,265
Iran,2009-12-01,148,0,0,90,12,250
Iraq,2009-12-01,155,64,1,103,23,346
Iraq,2009-12-01,162,0,-4,72,24,254
Iraq,2009-12-01,146,2,0,44,25,217
Iraq,2009-12-01,144,2,0,13,4,163
Iraq,2009-12-01,118,0,-1,37,6,160
Iraq,2009-12-01,35,0,-1,4,4,42
Iraq,2009-12-01,142,12,2,20,12,188
Iraq,2009-12-01,101,0,0,41,25,167
Iraq,2009-12-01,99,0,5,32,12,148
Iraq,2009-12-01,183,2,1,43,13,242
Iraq,2009-12-01,163,2,0,17,10,192
Iraq,2009-12-01,86,0,1,-8,9,88
Iraq,2009-12-01,41,0,1,22,20,84
Iraq,2009-12-01,134,0,-1,126,17,276
Iraq,2009-12-01,149,4,1,32,12,198
Iraq,2009-12-01,86,0,0,8,9,103
Iraq,2009-12-01,182,2,5,65,9,263
Iraq,2009-12-01,200,2,0,49,7,258
Iraq,2009-12-01,73,2,-1,61,6,141
Iraq,2009-12-01,17,0,0,39,1,57
Iraq,2009-12-01,63,2,1,36,6,108
Iraq,2009-12-01,63,2,-2,61,20,144
Iraq,2009-12-01,74,0,-2,15,18,105
Iraq,2009-12-01,96,2,-2,26,15,137
Iraq,2009-12-01,72,0,0,5,11,88
Iraq,2009-12-01,39,0,-2,5,10,52
Iraq,2009-12-01,73,0,0,24,8,105
Iraq,2009-12-01,95,2,1,28,31,157
Iraq,2009-12-01,76,0,-4,37,4,113
Iraq,2009-12-01,96,10,2,29,24,161
Iraq,2009-12-01,78,2,1,3,6,90
Morocco,2009-12-01,13,0,0,-4,0,9
Morocco,2009-12-01,2,0,-1,25,1,27
Morocco,2009-12-01,0,0,0,13,0,13
Morocco,2009-12-01,46,0,2,0,2,50
Morocco,2009-12-01,77,0,0,0,3,80
Morocco,2009-12-01,60,0,0,0,1,61
Morocco,2009-12-01,69,0,0,9,13,91
Morocco,2009-12-01,20,0,0,7,2,29
Morocco,2009-12-01,35,0,0,15,2,52
Morocco,2009-12-01,40,0,0,9,7,56
Morocco,2009-12-01,49,0,0,0,12,61
Morocco,2009-12-01,17,0,0,0,6,23
Morocco,2009-12-01,13,0,0,-4,2,11
Morocco,2009-12-01,40,0,1,10,11,62
Morocco,2009-12-01,22,0,0,6,5,33
Morocco,2009-12-01,11,2,1,19,0,33
Morocco,2009-12-01,27,2,0,15,6,50
Morocco,2009-12-01,84,0,0,22,9,115
Morocco,2009-12-01,21,0,0,20,4,45
Morocco,2009-12-01,12,0,0,9,0,21
Morocco,2009-12-01,7,0,0,3,2,12
Morocco,2009-12-01,-3,0,0,3,0,0
Morocco,2009-12-01,29,0,-1,4,0,32
Morocco,2009-12-01,5,0,0,0,0,5
Morocco,2009-12-01,8,0,0,0,0,8
Morocco,2009-12-01,4,0,0,0,0,4
Morocco,2009-12-01,3,0,0,0,0,3
Morocco,2009-12-01,6,0,0,9,0,15
Morocco,2009-12-01,33,0,0,10,2,45
Morocco,2009-12-01,6,0,0,2,0,8
Morocco,2009-12-01,2,0,0,3,0,5
Nigeria,2009-12-01,25,0,0,-2,0,23
Nigeria,2009-12-01,17,0,2,22,3,44
Nigeria,2009-12-01,36,0,-2,3,3,40
Nigeria,2009-12-01,24,0,-1,6,0,29
Nigeria,2009-12-01,11,0,1,16,3,31
Nigeria,2009-12-01,16,0,0,14,1,31
Nigeria,2009-12-01,26,0,0,1,7,34
Nigeria,2009-12-01,22,0,0,19,6,47
Nigeria,2009-12-01,33,0,0,10,2,45
Nigeria,2009-12-01,8,0,1,11,2,22
Nigeria,2009-12-01,34,0,-1,15,2,50
Nigeria,2009-12-01,16,0,0,-2,0,14
Nigeria,2009-12-01,18,0,3,21,0,42
Nigeria,2009-12-01,19,0,0,12,1,32
Nigeria,2009-12-01,13,0,0,-4,0,9
Nigeria,2009-12-01,4,0,0,1,1,6
Nigeria,2009-12-01,37,0,0,7,0,44
Nigeria,2009-12-01,44,0,0,18,0,62
Nigeria,2009-12-01,7,0,0,0,0,7
Nigeria,2009-12-01,28,0,-4,6,0,30
Nigeria,2009-12-01,40,0,-3,17,4,58
Nigeria,2009-12-01,34,0,2,9,0,45
Nigeria,2009-12-01,13,0,0,22,1,36
Nigeria,2009-12-01,27,0,0,-2,3,28
Nigeria,2009-12-01,45,0,1,9,8,63
Nigeria,2009-12-01,227,0,-1,98,88,412
Nigeria,2009-12-01,245,0,-2,157,107,507
Nigeria,2009-12-01,270,0,3,146,43,462
Nigeria,2009-12-01,289,0,6,108,24,427
Nigeria,2009-12-01,281,4,5,131,44,465
Nigeria,2009-12-01,163,0,3,87,10,263
Pakistan,2009-12-01,267,64,0,46,12,389
Pakistan,2009-12-01,182,4,0,18,24,228
Pakistan,2009-12-01,270,0,-2,20,12,300
Pakistan,2009-12-01,192,2,1,40,16,251
Pakistan,2009-12-01,79,2,1,32,14,128
Pakistan,2009-12-01,139,2,-2,22,22,183
Pakistan,2009-12-01,181,0,0,106,23,310
Pakistan,2009-12-01,90,0,0,74,19,183
Pakistan,2009-12-01,134,6,0,156,7,303
Pakistan,2009-12-01,98,2,0,116,6,222
Pakistan,2009-12-01,207,0,-4,219,5,427
Pakistan,2009-12-01,117,0,0,49,3,169
Pakistan,2009-12-01,72,6,-1,37,6,120
Pakistan,2009-12-01,108,2,-6,132,19,255
Pakistan,2009-12-01,111,0,-1,71,24,205
Pakistan,2009-12-01,161,0,-3,74,16,248
Pakistan,2009-12-01,215,0,-3,110,9,331
Pakistan,2009-12-01,114,0,2,125,2,243
Pakistan,2009-12-01,20,0,-3,52,8,77
Pakistan,2009-12-01,101,0,-4,20,5,122
Pakistan,2009-12-01,85,0,-10,27,4,106
Pakistan,2009-12-01,98,2,-1,19,10,128
Pakistan,2009-12-01,123,0,-2,42,7,170
Pakistan,2009-12-01,91,0,0,15,23,129
Pakistan,2009-12-01,81,0,0,32,3,116
Pakistan,2009-12-01,56,0,-7,5,13,67
Pakistan,2009-12-01,92,0,-3,14,13,116
Pakistan,2009-12-01,72,0,1,32,19,124
Pakistan,2009-12-01,66,0,-2,34,4,102
Pakistan,2009-12-01,166,0,0,37,38,241
Pakistan,2009-12-01,195,0,0,6,31,232
Sierra Leone,2009-12-01,1,0,0,0,0,1
Sierra Leone,2009-12-01,30,0,0,6,1,37
Sierra Leone,2009-12-01,5,0,0,0,0,5
Sierra Leone,2009-12-01,5,0,0,6,1,12
Sierra Leone,2009-12-01,1,0,0,6,0,7
Sierra Leone,2009-12-01,0,0,0,9,0,9
Sierra Leone,2009-12-01,0,0,0,6,0,6
Sierra Leone,2009-12-01,2,0,1,0,0,3
Sierra Leone,2009-12-01,2,0,0,1,0,3
Sierra Leone,2009-12-01,0,0,0,0,0,0
Sierra Leone,2009-12-01,1,0,0,0,0,1
Sierra Leone,2009-12-01,0,2,-2,-2,0,-2
Sierra Leone,2009-12-01,6,0,-2,0,0,4
Sierra Leone,2009-12-01,0,0,0,9,0,9
Sierra Leone,2009-12-01,0,2,0,0,0,2
Sierra Leone,2009-12-01,-2,2,0,6,0,6
Sierra Leone,2009-12-01,3,0,0,9,0,12
Sierra Leone,2009-12-01,1,0,0,4,0,5
Sierra Leone,2009-12-01,0,0,0,0,0,0
Sierra Leone,2009-12-01,0,0,0,0,0,0
Sierra Leone,2009-12-01,2,0,0,0,0,2
Sierra Leone,2009-12-01,0,0,0,0,0,0
Sierra Leone,2009-12-01,1,0,0,0,0,1
Sierra Leone,2009-12-01,0,0,0,0,0,0
Sierra Leone,2009-12-01,0,0,0,0,0,0
Sierra Leone,2009-12-01,-1,0,0,0,0,-1
Sierra Leone,2009-12-01,0,0,0,0,0,0
Sierra Leone,2009-12-01,0,0,0,-4,0,-4
Sierra Leone,2009-12-01,0,0,0,-4,0,-4
Somalia,2009-12-01,57,0,0,75,10,142
Somalia,2009-12-01,49,4,0,19,0,72
Somalia,2009-12-01,61,2,0,31,14,108
Somalia,2009-12-01,15,0,0,19,7,41
Somalia,2009-12-01,26,0,0,6,0,32
Somalia,2009-12-01,12,0,0,-2,3,13
Somalia,2009-12-01,92,0,0,21,2,115
Somalia,2009-12-01,20,0,1,28,0,49
Somalia,2009-12-01,12,0,0,12,5,29
Somalia,2009-12-01,10,0,0,5,39,54
Somalia,2009-12-01,34,0,0,14,11,59
Somalia,2009-12-01,52,0,0,6,0,58
Somalia,2009-12-01,56,0,0,4,4,64
Somalia,2009-12-01,40,0,0,-2,5,43
Somalia,2009-12-01,19,0,2,30,0,51
Somalia,2009-12-01,55,0,0,-3,4,56
Somalia,2009-12-01,65,0,0,52,3,120
Somalia,2009-12-01,65,0,0,-31,6,40
Somalia,2009-12-01,20,0,0,-7,3,16
Somalia,2009-12-01,9,0,0,-1,0,8
Somalia,2009-12-01,22,0,0,4,1,27
Somalia,2009-12-01,27,0,0,-1,0,26
Somalia,2009-12-01,17,0,0,4,9,30
Somalia,2009-12-01,31,0,0,-1,1,31
Somalia,2009-12-01,55,0,0,-11,0,44
Somalia,2009-12-01,8,0,0,-2,4,10
Somalia,2009-12-01,18,0,0,2,0,20
Somalia,2009-12-01,36,0,0,-1,4,39
Somalia,2009-12-01,144,0,3,52,1,200
Somalia,2009-12-01,160,0,2,3,9,174
Somalia,2009-12-01,53,0,0,18,8,79
Syria,2009-12-01,6,0,0,-2,0,4
Syria,2009-12-01,8,2,0,10,2,22
Syria,2009-12-01,25,2,0,7,3,37
Syria,2009-12-01,8,0,0,0,0,8
Syria,2009-12-01,4,0,0,0,0,4
Syria,2009-12-01,2,0,0,0,0,2
Syria,2009-12-01,9,0,0,0,1,10
Syria,2009-12-01,5,0,0,15,0,20
Syria,2009-12-01,22,0,0,-2,1,21
Syria,2009-12-01,14,0,1,6,0,21
Syria,2009-12-01,18,0,0,1,3,22
Syria,2009-12-01,17,0,0,-3,3,17
Syria,2009-12-01,9,0,0,6,0,15
Syria,2009-12-01,19,0,0,51,2,72
Syria,2009-12-01,25,0,0,15,0,40
Syria,2009-12-01,20,0,0,3,0,23
Syria,2009-12-01,41,0,0,1,0,42
Syria,2009-12-01,40,0,0,6,0,46
Syria,2009-12-01,12,0,0,4,0,16
Syria,2009-12-01,4,0,0,3,3,10
Syria,2009-12-01,7,0,0,-1,27,33
Syria,2009-12-01,6,0,0,12,2,20
Syria,2009-12-01,43,0,0,20,6,69
Syria,2009-12-01,32,0,0,0,0,32
Syria,2009-12-01,4,0,0,7,0,11
Syria,2009-12-01,-3,0,0,0,0,-3
Syria,2009-12-01,12,0,0,21,0,33
Syria,2009-12-01,5,0,0,29,0,34
Syria,2009-12-01,25,0,0,7,5,37
Syria,2009-12-01,5,0,0,6,4,15
Syria,2009-12-01,3,0,0,-2,1,2
Yemen,2009-12-01,64,2,0,5,0,71
Yemen,2009-12-01,86,4,0,9,2,101
Yemen,2009-12-01,37,0,0,7,0,44
Yemen,2009-12-01,48,0,0,9,2,59
Yemen,2009-12-01,29,0,0,3,2,34
Yemen,2009-12-01,33,0,0,-2,0,31
Yemen,2009-12-01,86,0,0,0,0,86
Yemen,2009-12-01,36,0,1,18,1,56
Yemen,2009-12-01,6,0,0,24,0,30
Yemen,2009-12-01,18,0,1,42,0,61
Yemen,2009-12-01,36,0,0,12,1,49
Yemen,2009-12-01,25,0,-2,6,0,29
Yemen,2009-12-01,20,0,0,4,4,28
Yemen,2009-12-01,32,0,0,6,1,39
Yemen,2009-12-01,70,4,0,27,1,102
Yemen,2009-12-01,32,0,0,5,0,37
Yemen,2009-12-01,14,0,0,-8,6,12
Yemen,2009-12-01,58,0,0,-2,4,60
Yemen,2009-12-01,61,2,0,4,14,81
Yemen,2009-12-01,117,0,0,-29,9,97
Yemen,2009-12-01,44,0,0,-14,0,30
Yemen,2009-12-01,104,0,0,21,11,136
Yemen,2009-12-01,56,0,0,10,4,70
Yemen,2009-12-01,217,0,0,35,32,284
Yemen,2009-12-01,37,0,0,15,6,58
Yemen,2009-12-01,103,0,0,30,32,165
Yemen,2009-12-01,237,0,0,58,66,361
Yemen,2009-12-01,323,0,0,88,58,469
Yemen,2009-12-01,478,16,3,64,19,580
Yemen,2009-12-01,300,4,0,25,38,367
Yemen,2009-12-01,211,0,1,-18,17,211
Afghanistan,2009-06-01,163,4,0,43,12,222
Afghanistan,2009-06-01,288,0,1,48,34,371
Afghanistan,2009-06-01,247,0,-3,34,19,297
Afghanistan,2009-06-01,180,4,2,-9,14,191
Afghanistan,2009-06-01,269,4,-2,57,19,347
Afghanistan,2009-06-01,196,0,0,74,48,318
Afghanistan,2009-06-01,157,2,2,28,7,196
Afghanistan,2009-06-01,190,4,-4,47,26,263
Afghanistan,2009-06-01,164,0,1,80,6,251
Afghanistan,2009-06-01,155,6,0,37,7,205
Afghanistan,2009-06-01,282,6,0,29,13,330
Afghanistan,2009-06-01,269,0,0,53,23,345
Afghanistan,2009-06-01,186,0,0,20,20,226
Afghanistan,2009-06-01,413,0,0,26,20,459
Afghanistan,2009-06-01,241,0,0,16,20,277
Afghanistan,2009-06-01,226,0,-1,38,13,276
Afghanistan,2009-06-01,237,2,0,22,13,274
Afghanistan,2009-06-01,174,0,2,9,30,215
Afghanistan,2009-06-01,210,4,1,22,23,260
Afghanistan,2009-06-01,185,0,0,12,7,204
Afghanistan,2009-06-01,174,0,-2,1,11,184
Afghanistan,2009-06-01,308,6,0,27,12,353
Afghanistan,2009-06-01,384,12,0,27,15,438
Afghanistan,2009-06-01,319,0,-3,29,11,356
Afghanistan,2009-06-01,154,2,-4,36,11,199
Afghanistan,2009-06-01,130,14,-2,22,11,175
Afghanistan,2009-06-01,162,4,1,16,16,199
Afghanistan,2009-06-01,144,8,1,24,15,192
Afghanistan,2009-06-01,273,0,-1,73,14,359
Afghanistan,2009-06-01,47,0,1,7,20,75
Albania,2009-06-01,5,0,0,4,0,9
Albania,2009-06-01,2,0,0,1,1,4
Albania,2009-06-01,4,0,0,0,0,4
Albania,2009-06-01,4,0,0,-4,2,2
Albania,2009-06-01,3,0,0,0,0,3
Albania,2009-06-01,4,0,0,0,0,4
Albania,2009-06-01,10,0,0,0,0,10
Albania,2009-06-01,6,0,0,0,3,9
Albania,2009-06-01,10,0,0,0,0,10
Albania,2009-06-01,13,0,0,4,0,17
Albania,2009-06-01,12,0,0,18,0,30
Albania,2009-06-01,26,0,0,23,1,50
Albania,2009-06-01,6,0,0,-4,0,2
Albania,2009-06-01,4,0,0,9,0,13
Albania,2009-06-01,8,0,-1,0,0,7
Albania,2009-06-01,3,0,0,6,5,14
Albania,2009-06-01,4,0,0,0,0,4
Albania,2009-06-01,27,0,0,9,0,36
Albania,2009-06-01,15,0,0,0,1,16
Albania,2009-06-01,1,0,0,0,0,1
Albania,2009-06-01,0,0,0,0,0,0
Albania,2009-06-01,6,0,0,0,0,6
Albania,2009-06-01,4,0,0,0,3,7
Albania,2009-06-01,13,0,0,10,6,29
Albania,2009-06-01,0,0,-2,12,6,16
Albania,2009-06-01,4,0,0,8,4,16
Albania,2009-06-01,3,0,0,0,4,7
Albania,2009-06-01,0,0,0,0,1,1
Albania,2009-06-01,-1,0,-1,0,0,-2
Albania,2009-06-01,0,0,0,0,0,0
Algeria,2009-06-01,0,0,0,0,0,0
Algeria,2009-06-01,1,0,0,0,0,1
Algeria,2009-06-01,33,0,-2,29,0,60
Algeria,2009-06-01,47,0,-2,6,0,51
Algeria,2009-06-01,27,0,0,-2,1,26
Algeria,2009-06-01,16,0,0,9,0,25
Algeria,2009-06-01,0,0,0,0,5,5
Algeria,2009-06-01,6,0,0,9,3,18
Algeria,2009-06-01,8,0,0,6,2,16
Algeria,2009-06-01,2,0,0,13,0,15
Algeria,2009-06-01,0,0,0,14,1,15
Algeria,2009-06-01,-4,0,0,0,0,-4
Algeria,2009-06-01,0,0,-1,-2,0,-3
Algeria,2009-06-01,5,0,0,-3,0,2
Algeria,2009-06-01,1,0,0,0,0,1
Algeria,2009-06-01,3,0,0,0,0,3
Algeria,2009-06-01,27,0,0,13,4,44
Algeria,2009-06-01,40,0,0,9,12,61
Algeria,2009-06-01,20,0,0,3,2,25
Algeria,2009-06-01,4,0,0,0,0,4
Algeria,2009-06-01,0,0,0,0,2,2
Algeria,2009-06-01,5,0,0,0,0,5
Algeria,2009-06-01,6,0,0,4,0,10
Algeria,2009-06-01,2,0,0,1,0,3
Algeria,2009-06-01,5,0,0,36,3,44
Algeria,2009-06-01,4,0,0,0,0,4
Algeria,2009-06-01,0,0,0,0,0,0
Algeria,2009-06-01,0,0,0,0,0,0
Algeria,2009-06-01,0,0,0,3,0,3
Algeria,2009-06-01,3,0,0,15,0,18
Bangladesh,2009-06-01,4,0,0,6,0,10
Bangladesh,2009-06-01,0,0,-10,6,0,-4
Bangladesh,2009-06-01,12,0,-2,12,0,22
Bangladesh,2009-06-01,12,0,-2,-1,0,9
Bangladesh,2009-06-01,20,0,0,10,1,31
Bangladesh,2009-06-01,2,0,0,5,0,7
Bangladesh,2009-06-01,10,0,0,0,1,11
Bangladesh,2009-06-01,21,0,0,1,4,26
Bangladesh,2009-06-01,6,0,0,-1,1,6
Bangladesh,2009-06-01,20,0,0,6,1,27
Bangladesh,2009-06-01,7,0,0,15,7,29
Bangladesh,2009-06-01,13,0,1,-1,0,13
Bangladesh,2009-06-01,13,0,0,3,0,16
Bangladesh,2009-06-01,15,2,3,9,1,30
Bangladesh,2009-06-01,13,0,0,-2,2,13
Bangladesh,2009-06-01,13,0,0,-2,2,13
Bangladesh,2009-06-01,3,0,0,3,0,6
Bangladesh,2009-06-01,6,0,0,3,6,15
Bangladesh,2009-06-01,7,0,0,0,0,7
Bangladesh,2009-06-01,18,0,0,-4,4,18
Bangladesh,2009-06-01,3,0,0,0,4,7
Bangladesh,2009-06-01,14,0,0,3,2,19
Bangladesh,2009-06-01,16,0,-2,9,0,23
Bangladesh,2009-06-01,8,0,0,0,0,8
Bangladesh,2009-06-01,21,0,0,12,2,35
Bangladesh,2009-06-01,5,0,0,3,0,8
Bangladesh,2009-06-01,2,0,0,0,0,2
Bangladesh,2009-06-01,23,0,0,3,0,26
Bangladesh,2009-06-01,8,0,0,3,2,13
Bangladesh,2009-06-01,6,0,0,-2,1,5
Cameroon,2009-06-01,0,0,0,0,0,0
Cameroon,2009-06-01,-1,0,0,9,0,8
Cameroon,2009-06-01,0,0,0,0,0,0
Cameroon,2009-06-01,9,0,0,0,0,9
Cameroon,2009-06-01,0,0,0,0,0,0
Cameroon,2009-06-01,0,0,-2,0,0,-2
Cameroon,2009-06-01,0,0,0,3,0,3
Cameroon,2009-06-01,0,0,0,3,0,3
Cameroon,2009-06-01,0,0,0,0,0,0
Cameroon,2009-06-01,0,0,0,0,2,2
Cameroon,2009-06-01,0,0,0,0,0,0
Cameroon,2009-06-01,0,0,0,0,0,0
Cameroon,2009-06-01,0,0,1,0,0,1
Cameroon,2009-06-01,0,0,0,0,0,0
Cameroon,2009-06-01,4,0,0,0,0,4
Cameroon,2009-06-01,0,0,0,3,0,3
Cameroon,2009-06-01,0,0,0,3,0,3
Cameroon,2009-06-01,0,0,0,0,0,0
Cameroon,2009-06-01,0,0,0,0,0,0
Cameroon,2009-06-01,4,0,0,0,0,4
Cameroon,2009-06-01,0,0,0,0,0,0
Cameroon,2009-06-01,2,0,0,0,0,2
Cameroon,2009-06-01,0,0,0,0,0,0
Cameroon,2009-06-01,0,0,0,0,0,0
Cameroon,2009-06-01,3,0,0,9,0,12
Cameroon,2009-06-01,0,0,0,0,0,0
Cameroon,2009-06-01,3,0,0,3,0,6
Cameroon,2009-06-01,0,0,0,0,0,0
China,2009-06-01,69,0,-1,78,19,165
China,2009-06-01,125,6,-2,75,35,239
China,2009-06-01,105,2,0,73,8,188
China,2009-06-01,99,0,-14,57,6,148
China,2009-06-01,121,2,-4,41,11,171
China,2009-06-01,43,0,-10,18,9,60
China,2009-06-01,61,0,-5,21,5,82
China,2009-06-01,136,0,-4,149,22,303
China,2009-06-01,93,6,2,100,8,209
China,2009-06-01,76,2,0,88,19,185
China,2009-06-01,96,0,1,49,15,161
China,2009-06-01,116,8,1,40,2,167
China,2009-06-01,65,8,0,-3,8,78
China,2009-06-01,42,0,0,7,12,61
China,2009-06-01,91,0,0,20,16,127
China,2009-06-01,139,0,-8,97,11,239
China,2009-06-01,63,6,2,19,6,96
China,2009-06-01,88,0,-1,76,30,193
China,2009-06-01,98,0,-5,142,15,250
China,2009-06-01,65,0,-3,86,7,155
China,2009-06-01,43,0,0,50,9,102
China,2009-06-01,60,0,0,29,4,93
China,2009-06-01,107,4,2,80,14,207
China,2009-06-01,103,4,2,50,7,166
China,2009-06-01,93,8,-3,54,18,170
China,2009-06-01,50,4,3,38,8,103
China,2009-06-01,42,4,1,19,9,75
China,2009-06-01,32,0,0,25,3,60
China,2009-06-01,50,0,0,20,10,80
China,2009-06-01,85,0,0,-5,3,83
Egypt,2009-06-01,39,0,0,30,5,74
Egypt,2009-06-01,68,0,0,7,7,82
Egypt,2009-06-01,46,0,2,13,8,69
Egypt,2009-06-01,31,0,2,1,10,44
Egypt,2009-06-01,20,0,-3,9,2,28
Egypt,2009-06-01,6,0,0,12,3,21
Egypt,2009-06-01,5,0,0,6,5,16
Egypt,2009-06-01,46,4,-1,25,6,80
Egypt,2009-06-01,7,0,1,9,6,23
Egypt,2009-06-01,10,0,0,1,0,11
Egypt,2009-06-01,19,0,0,15,5,39
Egypt,2009-06-01,19,0,0,6,0,25
Egypt,2009-06-01,2,0,0,15,0,17
Egypt,2009-06-01,8,0,-4,14,5,23
Egypt,2009-06-01,46,0,-1,1,0,46
Egypt,2009-06-01,42,0,-2,19,7,66
Egypt,2009-06-01,21,0,-4,-5,3,15
Egypt,2009-06-01,11,0,-4,19,1,27
Egypt,2009-06-01,10,0,1,-10,0,1
Egypt,2009-06-01,17,0,0,0,1,18
Egypt,2009-06-01,19,0,0,9,0,28
Egypt,2009-06-01,27,0,0,22,0,49
Egypt,2009-06-01,24,0,0,-5,1,20
Egypt,2009-06-01,86,0,0,15,2,103
Egypt,2009-06-01,62,0,0,11,5,78
Egypt,2009-06-01,22,0,0,6,1,29
Egypt,2009-06-01,14,0,0,2,0,16
Egypt,2009-06-01,14,0,0,19,0,33
Egypt,2009-06-01,14,0,-4,6,0,16
Egypt,2009-06-01,20,0,0,9,0,29
Eritrea,2009-06-01,4,0,0,0,0,4
Eritrea,2009-06-01,0,0,0,7,0,7
Eritrea,2009-06-01,0,0,0,0,0,0
Eritrea,2009-06-01,2,0,1,3,0,6
Eritrea,2009-06-01,2,0,1,0,0,3
Eritrea,2009-06-01,0,0,0,-3,0,-3
Eritrea,2009-06-01,0,0,0,0,0,0
Eritrea,2009-06-01,6,0,0,0,0,6
Eritrea,2009-06-01,17,0,0,3,4,24
Eritrea,2009-06-01,23,0,3,0,2,28
Eritrea,2009-06-01,0,0,0,0,0,0
Eritrea,2009-06-01,6,0,3,0,0,9
Eritrea,2009-06-01,6,0,0,0,0,6
Eritrea,2009-06-01,2,0,0,0,0,2
Eritrea,2009-06-01,9,0,0,0,0,9
Eritrea,2009-06-01,4,0,0,0,0,4
Eritrea,2009-06-01,7,0,0,0,0,7
Eritrea,2009-06-01,6,0,0,0,0,6
Eritrea,2009-06-01,0,0,0,0,0,0
Eritrea,2009-06-01,0,0,0,0,0,0
Eritrea,2009-06-01,5,0,0,3,0,8
Eritrea,2009-06-01,14,0,0,0,0,14
Eritrea,2009-06-01,3,0,0,0,0,3
Eritrea,2009-06-01,0,0,0,0,0,0
Eritrea,2009-06-01,21,0,0,0,0,21
Eritrea,2009-06-01,15,0,0,0,0,15
Eritrea,2009-06-01,33,0,0,0,0,33
Eritrea,2009-06-01,12,0,0,6,2,20
Eritrea,2009-06-01,4,0,0,0,4,8
Georgia,2009-06-01,15,0,0,12,5,32
Georgia,2009-06-01,22,0,-2,15,5,40
Georgia,2009-06-01,11,2,0,-2,0,11
Georgia,2009-06-01,16,0,0,3,1,20
Georgia,2009-06-01,27,0,0,-4,6,29
Georgia,2009-06-01,9,0,0,0,0,9
Georgia,2009-06-01,16,0,0,1,0,17
Georgia,2009-06-01,4,0,1,6,2,13
Georgia,2009-06-01,11,2,0,3,1,17
Georgia,2009-06-01,8,0,0,15,0,23
Georgia,2009-06-01,6,0,0,9,2,17
Georgia,2009-06-01,9,2,0,-2,2,11
Georgia,2009-06-01,8,0,0,0,0,8
Georgia,2009-06-01,8,0,0,10,0,18
Georgia,2009-06-01,13,0,0,6,2,21
Georgia,2009-06-01,18,0,0,19,12,49
Georgia,2009-06-01,6,0,1,-1,1,7
Georgia,2009-06-01,5,0,0,6,7,18
Georgia,2009-06-01,10,0,0,6,2,18
Georgia,2009-06-01,13,0,-4,13,6,28
Georgia,2009-06-01,7,0,0,12,0,19
Georgia,2009-06-01,7,0,0,0,2,9
Georgia,2009-06-01,25,0,0,12,0,37
Georgia,2009-06-01,5,0,0,6,1,12
Georgia,2009-06-01,2,0,0,9,3,14
Georgia,2009-06-01,2,0,-2,0,1,1
Georgia,2009-06-01,1,0,2,0,0,3
Georgia,2009-06-01,6,0,0,0,0,6
Georgia,2009-06-01,3,0,0,0,0,3
Georgia,2009-06-01,5,0,0,18,0,23
India,2009-06-01,36,0,-7,31,17,77
India,2009-06-01,45,2,-18,24,8,61
India,2009-06-01,40,0,-13,7,8,42
India,2009-06-01,39,2,0,21,10,72
India,2009-06-01,56,0,-1,16,6,77
India,2009-06-01,23,0,-1,9,0,31
India,2009-06-01,35,0,0,16,8,59
India,2009-06-01,58,0,-1,19,5,81
India,2009-06-01,52,0,0,13,12,77
India,2009-06-01,35,2,1,3,14,55
India,2009-06-01,54,0,0,10,6,70
India,2009-06-01,58,0,0,6,2,66
India,2009-06-01,48,0,0,0,9,57
India,2009-06-01,33,0,-1,16,1,49
India,2009-06-01,36,0,-1,25,4,64
India,2009-06-01,36,0,-1,21,9,65
India,2009-06-01,47,2,-4,28,7,80
India,2009-06-01,27,2,0,4,11,44
India,2009-06-01,22,0,0,1,3,26
India,2009-06-01,30,0,-1,14,0,43
India,2009-06-01,17,0,0,-1,2,18
India,2009-06-01,67,4,1,4,6,82
India,2009-06-01,72,0,-1,33,11,115
India,2009-06-01,49,2,-3,14,0,62
India,2009-06-01,50,0,-3,30,5,82
India,2009-06-01,14,0,0,4,15,33
India,2009-06-01,24,2,-1,10,2,37
India,2009-06-01,17,0,2,0,0,19
India,2009-06-01,49,0,0,6,1,56
India,2009-06-01,15,0,0,16,0,31
Iran,2009-06-01,47,0,0,26,22,95
Iran,2009-06-01,96,0,1,10,3,110
Iran,2009-06-01,56,0,5,44,0,105
Iran,2009-06-01,138,0,1,34,24,197
Iran,2009-06-01,75,0,2,-5,5,77
Iran,2009-06-01,64,0,3,20,3,90
Iran,2009-06-01,38,0,2,14,2,56
Iran,2009-06-01,34,0,-3,12,10,53
Iran,2009-06-01,59,0,3,3,7,72
Iran,2009-06-01,66,2,-1,24,12,103
Iran,2009-06-01,51,0,1,68,5,125
Iran,2009-06-01,68,0,1,53,25,147
Iran,2009-06-01,86,2,0,16,18,122
Iran,2009-06-01,121,0,-5,34,25,175
Iran,2009-06-01,117,0,-2,72,35,222
Iran,2009-06-01,138,6,4,113,34,295
Iran,2009-06-01,126,2,8,159,39,334
Iran,2009-06-01,134,0,3,73,29,239
Iran,2009-06-01,122,0,3,48,36,209
Iran,2009-06-01,167,4,14,10,46,241
Iran,2009-06-01,212,0,0,44,38,294
Iran,2009-06-01,165,4,8,89,44,310
Iran,2009-06-01,195,2,8,93,41,339
Iran,2009-06-01,166,0,7,114,35,322
Iran,2009-06-01,163,0,6,104,48,321
Iran,2009-06-01,124,4,-2,68,28,222
Iran,2009-06-01,64,0,2,51,23,140
Iran,2009-06-01,63,0,1,55,14,133
Iran,2009-06-01,33,0,-1,13,11,56
Iran,2009-06-01,56,2,4,24,3,89
Iraq,2009-06-01,79,0,-4,24,15,114
Iraq,2009-06-01,90,0,0,19,27,136
Iraq,2009-06-01,110,4,0,49,16,179
Iraq,2009-06-01,126,4,-1,21,6,156
Iraq,2009-06-01,103,2,0,29,8,142
Iraq,2009-06-01,18,0,-6,9,9,30
Iraq,2009-06-01,20,0,-4,12,2,30
Iraq,2009-06-01,55,0,-2,-8,5,50
Iraq,2009-06-01,58,6,-2,-64,6,4
Iraq,2009-06-01,105,6,-4,41,13,161
Iraq,2009-06-01,82,0,-2,37,3,120
Iraq,2009-06-01,102,0,0,48,1,151
Iraq,2009-06-01,51,0,-6,40,3,88
Iraq,2009-06-01,75,0,0,33,4,112
Iraq,2009-06-01,6,0,-1,43,13,61
Iraq,2009-06-01,166,0,0,40,26,232
Iraq,2009-06-01,124,2,0,-11,12,127
Iraq,2009-06-01,118,0,-7,35,23,169
Iraq,2009-06-01,66,0,-10,21,14,91
Iraq,2009-06-01,77,0,-3,43,36,153
Iraq,2009-06-01,84,0,0,50,6,140
Iraq,2009-06-01,81,0,0,42,11,134
Iraq,2009-06-01,119,2,2,33,7,163
Iraq,2009-06-01,48,8,-1,6,0,61
Iraq,2009-06-01,57,8,1,5,10,81
Iraq,2009-06-01,31,0,1,2,7,41
Iraq,2009-06-01,41,0,0,0,2,43
Iraq,2009-06-01,14,0,1,6,8,29
Iraq,2009-06-01,58,0,0,6,0,64
Iraq,2009-06-01,42,2,4,26,8,82
Morocco,2009-06-01,3,0,0,0,0,3
Morocco,2009-06-01,-2,0,0,0,0,-2
Morocco,2009-06-01,5,0,0,1,2,8
Morocco,2009-06-01,2,0,0,0,3,5
Morocco,2009-06-01,3,0,0,6,0,9
Morocco,2009-06-01,23,0,0,0,0,23
Morocco,2009-06-01,17,0,0,0,0,17
Morocco,2009-06-01,8,0,0,0,0,8
Morocco,2009-06-01,0,0,0,12,0,12
Morocco,2009-06-01,16,0,0,3,1,20
Morocco,2009-06-01,0,0,0,0,0,0
Morocco,2009-06-01,4,0,0,0,1,5
Morocco,2009-06-01,1,0,0,0,0,1
Morocco,2009-06-01,-6,0,0,0,0,-6
Morocco,2009-06-01,0,0,0,3,0,3
Morocco,2009-06-01,-2,0,0,11,4,13
Morocco,2009-06-01,10,0,0,6,1,17
Morocco,2009-06-01,3,0,0,0,1,4
Morocco,2009-06-01,0,0,0,3,1,4
Morocco,2009-06-01,3,0,0,3,1,7
Morocco,2009-06-01,6,0,0,0,0,6
Morocco,2009-06-01,6,0,0,0,0,6
Morocco,2009-06-01,5,0,0,9,0,14
Morocco,2009-06-01,6,0,0,4,0,10
Morocco,2009-06-01,12,0,-2,22,6,38
Morocco,2009-06-01,0,0,0,6,0,6
Morocco,2009-06-01,0,0,0,-2,0,-2
Morocco,2009-06-01,0,0,0,6,0,6
Morocco,2009-06-01,7,0,0,0,0,7
Morocco,2009-06-01,0,0,0,0,1,1
Nigeria,2009-06-01,18,0,1,10,1,30
Nigeria,2009-06-01,13,0,0,-4,4,13
Nigeria,2009-06-01,36,0,0,15,3,54
Nigeria,2009-06-01,15,0,4,9,6,34
Nigeria,2009-06-01,5,0,0,7,0,12
Nigeria,2009-06-01,4,0,0,2,0,6
Nigeria,2009-06-01,24,0,0,0,0,24
Nigeria,2009-06-01,27,0,0,5,2,34
Nigeria,2009-06-01,23,0,0,30,3,56
Nigeria,2009-06-01,71,0,0,11,6,88
Nigeria,2009-06-01,-4,0,1,15,1,13
Nigeria,2009-06-01,19,0,0,10,10,39
Nigeria,2009-06-01,9,0,0,15,1,25
Nigeria,2009-06-01,4,0,0,9,0,13
Nigeria,2009-06-01,18,0,0,9,2,29
Nigeria,2009-06-01,25,0,0,-9,0,16
Nigeria,2009-06-01,9,0,2,0,1,12
Nigeria,2009-06-01,54,0,2,31,3,90
Nigeria,2009-06-01,48,0,0,5,3,56
Nigeria,2009-06-01,30,4,0,0,4,38
Nigeria,2009-06-01,12,4,0,1,0,17
Nigeria,2009-06-01,24,0,0,19,6,49
Nigeria,2009-06-01,17,0,-1,1,3,20
Nigeria,2009-06-01,22,0,0,30,-1,51
Nigeria,2009-06-01,37,0,0,13,3,53
Nigeria,2009-06-01,2,0,0,9,2,13
Nigeria,2009-06-01,6,0,0,6,0,12
Nigeria,2009-06-01,4,0,0,-7,0,-3
Nigeria,2009-06-01,2,0,2,10,3,17
Nigeria,2009-06-01,23,0,0,9,0,32
Pakistan,2009-06-01,127,0,0,58,16,201
Pakistan,2009-06-01,107,0,-6,28,10,139
Pakistan,2009-06-01,132,0,-5,31,33,191
Pakistan,2009-06-01,101,2,3,15,4,125
Pakistan,2009-06-01,56,2,0,38,7,103
Pakistan,2009-06-01,82,0,0,37,46,165
Pakistan,2009-06-01,52,2,0,17,7,78
Pakistan,2009-06-01,70,0,0,25,5,100
Pakistan,2009-06-01,92,2,0,50,14,158
Pakistan,2009-06-01,54,0,0,33,0,87
Pakistan,2009-06-01,46,0,-4,30,8,80
Pakistan,2009-06-01,66,0,1,67,16,150
Pakistan,2009-06-01,32,0,0,27,6,65
Pakistan,2009-06-01,44,0,0,39,21,104
Pakistan,2009-06-01,56,2,0,9,4,71
Pakistan,2009-06-01,141,4,0,109,4,258
Pakistan,2009-06-01,69,0,0,7,4,80
Pakistan,2009-06-01,69,0,0,24,2,95
Pakistan,2009-06-01,44,0,0,31,6,81
Pakistan,2009-06-01,49,0,0,21,8,78
Pakistan,2009-06-01,42,0,0,24,13,79
Pakistan,2009-06-01,68,2,0,25,8,103
Pakistan,2009-06-01,112,4,-1,57,12,184
Pakistan,2009-06-01,71,0,1,7,14,93
Pakistan,2009-06-01,59,0,0,26,7,92
Pakistan,2009-06-01,61,0,1,2,8,72
Pakistan,2009-06-01,77,0,0,9,2,88
Pakistan,2009-06-01,41,0,0,6,6,53
Pakistan,2009-06-01,87,0,0,33,1,121
Pakistan,2009-06-01,52,0,1,25,9,87
Sierra Leone,2009-06-01,0,0,0,3,0,3
Sierra Leone,2009-06-01,0,0,0,0,0,0
Sierra Leone,2009-06-01,3,0,0,9,1,13
Sierra Leone,2009-06-01,0,0,0,3,0,3
Sierra Leone,2009-06-01,0,0,0,0,0,0
Sierra Leone,2009-06-01,0,0,0,3,0,3
Sierra Leone,2009-06-01,0,0,0,0,0,0
Sierra Leone,2009-06-01,7,0,0,6,1,14
Sierra Leone,2009-06-01,1,0,0,0,3,4
Sierra Leone,2009-06-01,-1,0,0,9,0,8
Sierra Leone,2009-06-01,-9,0,0,0,2,-7
Sierra Leone,2009-06-01,0,0,0,0,0,0
Sierra Leone,2009-06-01,1,0,0,0,0,1
Sierra Leone,2009-06-01,0,0,0,0,0,0
Sierra Leone,2009-06-01,0,0,0,0,0,0
Sierra Leone,2009-06-01,6,0,-1,0,0,5
Sierra Leone,2009-06-01,3,0,0,0,0,3
Sierra Leone,2009-06-01,9,0,0,1,0,10
Sierra Leone,2009-06-01,0,0,0,0,0,0
Sierra Leone,2009-06-01,0,0,0,0,0,0
Sierra Leone,2009-06-01,2,0,0,0,0,2
Sierra Leone,2009-06-01,10,0,0,-4,0,6
Sierra Leone,2009-06-01,2,0,0,0,0,2
Sierra Leone,2009-06-01,2,0,0,0,0,2
Sierra Leone,2009-06-01,6,0,0,0,0,6
Sierra Leone,2009-06-01,0,0,0,0,0,0
Sierra Leone,2009-06-01,0,0,0,0,0,0
Somalia,2009-06-01,44,0,0,33,5,82
Somalia,2009-06-01,21,0,0,15,11,47
Somalia,2009-06-01,26,0,0,10,12,48
Somalia,2009-06-01,7,0,0,9,2,18
Somalia,2009-06-01,21,0,0,7,1,29
Somalia,2009-06-01,18,0,0,24,0,42
Somalia,2009-06-01,2,0,0,-8,0,-6
Somalia,2009-06-01,23,0,0,13,1,37
Somalia,2009-06-01,64,0,0,0,11,75
Somalia,2009-06-01,43,4,0,31,2,80
Somalia,2009-06-01,8,2,0,20,1,31
Somalia,2009-06-01,32,2,0,48,6,88
Somalia,2009-06-01,14,0,0,7,8,29
Somalia,2009-06-01,17,0,0,0,4,21
Somalia,2009-06-01,18,0,0,14,8,40
Somalia,2009-06-01,35,0,0,4,10,49
Somalia,2009-06-01,29,4,1,-2,1,33
Somalia,2009-06-01,105,10,0,23,18,156
Somalia,2009-06-01,95,0,0,15,2,112
Somalia,2009-06-01,25,0,0,10,4,39
Somalia,2009-06-01,24,0,0,43,5,72
Somalia,2009-06-01,73,0,0,51,8,132
Somalia,2009-06-01,31,0,-1,27,0,57
Somalia,2009-06-01,25,0,0,8,1,34
Somalia,2009-06-01,27,0,0,4,2,33
Somalia,2009-06-01,41,0,0,9,8,58
Somalia,2009-06-01,19,0,0,0,1,20
Somalia,2009-06-01,4,0,0,-1,1,4
Somalia,2009-06-01,48,0,1,-5,2,46
Somalia,2009-06-01,31,0,0,18,0,49
Syria,2009-06-01,1,0,0,0,0,1
Syria,2009-06-01,29,0,0,3,6,38
Syria,2009-06-01,5,0,0,0,3,8
Syria,2009-06-01,11,0,1,3,6,21
Syria,2009-06-01,31,0,1,6,2,40
Syria,2009-06-01,-2,0,0,0,2,0
Syria,2009-06-01,7,0,2,5,5,19
Syria,2009-06-01,17,0,-8,20,9,38
Syria,2009-06-01,25,0,-2,13,5,41
Syria,2009-06-01,26,0,1,9,2,38
Syria,2009-06-01,19,0,0,12,2,33
Syria,2009-06-01,-4,0,0,-1,0,-5
Syria,2009-06-01,6,0,0,-2,1,5
Syria,2009-06-01,-1,0,0,3,-1,1
Syria,2009-06-01,14,0,0,0,4,18
Syria,2009-06-01,4,0,0,9,3,16
Syria,2009-06-01,23,0,0,0,0,23
Syria,2009-06-01,42,0,-2,3,0,43
Syria,2009-06-01,4,0,0,3,1,8
Syria,2009-06-01,8,0,0,3,0,11
Syria,2009-06-01,19,0,0,6,0,25
Syria,2009-06-01,3,0,0,12,2,17
Syria,2009-06-01,1,0,0,44,0,45
Syria,2009-06-01,1,0,0,3,0,4
Syria,2009-06-01,11,0,-2,24,0,33
Syria,2009-06-01,7,0,1,0,0,8
Syria,2009-06-01,7,0,0,0,3,10
Syria,2009-06-01,13,0,1,0,0,14
Syria,2009-06-01,23,0,-4,0,3,22
Syria,2009-06-01,9,0,0,0,0,9
Yemen,2009-06-01,35,0,-1,2,1,37
Yemen,2009-06-01,15,0,0,39,7,61
Yemen,2009-06-01,50,0,0,27,6,83
Yemen,2009-06-01,4,0,0,19,2,25
Yemen,2009-06-01,19,0,0,11,0,30
Yemen,2009-06-01,3,0,0,-8,1,-4
Yemen,2009-06-01,13,2,1,-8,3,11
Yemen,2009-06-01,10,0,0,33,4,47
Yemen,2009-06-01,9,0,0,18,4,31
Yemen,2009-06-01,10,0,0,9,4,23
Yemen,2009-06-01,13,0,-1,45,0,57
Yemen,2009-06-01,29,0,0,7,1,37
Yemen,2009-06-01,18,0,0,5,2,25
Yemen,2009-06-01,24,0,0,84,0,108
Yemen,2009-06-01,93,0,0,88,17,198
Yemen,2009-06-01,137,0,0,80,20,237
Yemen,2009-06-01,13,0,0,17,9,39
Yemen,2009-06-01,13,0,0,30,7,50
Yemen,2009-06-01,41,0,0,0,0,41
Yemen,2009-06-01,35,0,0,4,0,39
Yemen,2009-06-01,60,0,0,13,8,81
Yemen,2009-06-01,22,0,0,15,3,40
Yemen,2009-06-01,26,0,0,15,1,42
Yemen,2009-06-01,8,0,0,1,4,13
Yemen,2009-06-01,17,0,0,3,0,20
Yemen,2009-06-01,6,0,0,12,0,18
Yemen,2009-06-01,8,0,0,-4,0,4
Yemen,2009-06-01,3,0,3,6,0,12
Yemen,2009-06-01,2,0,0,9,0,11
Yemen,2009-06-01,18,0,0,3,0,21
Afghanistan,2012-05-01,295,3,2,54,16,370
Afghanistan,2012-05-01,180,4,0,60,26,270
Afghanistan,2012-05-01,176,2,1,35,24,238
Afghanistan,2012-05-01,345,0,0,13,45,403
Afghanistan,2012-05-01,165,0,0,24,16,205
Afghanistan,2012-05-01,234,2,0,22,26,284
Afghanistan,2012-05-01,365,2,-1,98,28,492
Afghanistan,2012-05-01,346,2,-4,63,21,428
Afghanistan,2012-05-01,191,0,1,60,21,273
Afghanistan,2012-05-01,39,0,-5,12,6,52
Afghanistan,2012-05-01,174,2,0,46,0,222
Afghanistan,2012-05-01,200,0,-6,-7,13,200
Afghanistan,2012-05-01,203,0,0,-4,13,212
Afghanistan,2012-05-01,173,4,-2,39,14,228
Afghanistan,2012-05-01,205,4,0,60,35,304
Afghanistan,2012-05-01,178,0,0,73,9,260
Afghanistan,2012-05-01,274,2,0,68,40,384
Afghanistan,2012-05-01,130,4,3,31,40,208
Afghanistan,2012-05-01,174,8,-1,55,54,290
Afghanistan,2012-05-01,257,4,-1,79,30,369
Afghanistan,2012-05-01,375,32,-4,103,50,556
Afghanistan,2012-05-01,291,4,-20,46,35,356
Afghanistan,2012-05-01,305,4,-6,111,19,433
Afghanistan,2012-05-01,231,6,3,114,17,371
Afghanistan,2012-05-01,223,2,0,72,17,314
Afghanistan,2012-05-01,175,0,-4,42,4,217
Afghanistan,2012-05-01,294,2,-4,22,13,327
Afghanistan,2012-05-01,408,0,-5,37,25,465
Afghanistan,2012-05-01,372,0,0,21,3,396
Afghanistan,2012-05-01,226,4,3,34,14,281
Afghanistan,2012-05-01,121,0,0,18,23,162
Albania,2012-05-01,31,0,0,33,0,64
Albania,2012-05-01,7,0,-5,42,0,44
Albania,2012-05-01,8,0,-2,17,0,23
Albania,2012-05-01,45,0,-2,38,10,91
Albania,2012-05-01,4,0,1,9,4,18
Albania,2012-05-01,19,0,0,12,2,33
Albania,2012-05-01,28,0,-2,3,3,32
Albania,2012-05-01,16,0,0,10,0,26
Albania,2012-05-01,0,0,0,1,2,3
Albania,2012-05-01,2,0,0,6,0,8
Albania,2012-05-01,34,0,0,12,14,60
Albania,2012-05-01,8,0,0,-2,0,6
Albania,2012-05-01,0,0,0,3,0,3
Albania,2012-05-01,5,0,0,0,0,5
Albania,2012-05-01,16,0,1,-2,2,17
Albania,2012-05-01,5,0,0,6,0,11
Albania,2012-05-01,26,0,-2,12,0,36
Albania,2012-05-01,9,0,0,0,1,10
Albania,2012-05-01,0,0,0,3,0,3
Albania,2012-05-01,14,0,0,0,0,14
Albania,2012-05-01,7,0,0,0,2,9
Albania,2012-05-01,6,0,-2,6,0,10
Albania,2012-05-01,9,0,0,1,1,11
Albania,2012-05-01,8,0,0,6,0,14
Albania,2012-05-01,9,0,0,-4,0,5
Albania,2012-05-01,0,0,0,6,0,6
Albania,2012-05-01,1,0,0,0,0,1
Albania,2012-05-01,5,0,0,9,0,14
Albania,2012-05-01,2,0,-1,0,1,2
Albania,2012-05-01,2,0,0,3,1,6
Albania,2012-05-01,11,0,0,6,0,17
Algeria,2012-05-01,5,0,0,6,2,13
Algeria,2012-05-01,6,0,0,16,0,22
Algeria,2012-05-01,11,0,-4,22,0,29
Algeria,2012-05-01,24,0,2,86,6,118
Algeria,2012-05-01,55,0,0,61,5,121
Algeria,2012-05-01,4,0,0,5,3,12
Algeria,2012-05-01,39,0,1,6,8,54
Algeria,2012-05-01,17,0,0,2,0,19
Algeria,2012-05-01,3,0,-2,15,3,19
Algeria,2012-05-01,15,0,4,3,10,32
Algeria,2012-05-01,18,0,-2,14,2,32
Algeria,2012-05-01,12,0,2,3,5,22
Algeria,2012-05-01,-2,0,0,9,3,10
Algeria,2012-05-01,5,0,0,3,1,9
Algeria,2012-05-01,0,0,0,0,0,0
Algeria,2012-05-01,9,0,0,6,0,15
Algeria,2012-05-01,11,0,0,13,4,28
Algeria,2012-05-01,8,0,0,0,-4,4
Algeria,2012-05-01,4,0,0,0,0,4
Algeria,2012-05-01,2,0,0,12,8,22
Algeria,2012-05-01,-2,0,0,15,4,17
Algeria,2012-05-01,23,0,0,15,0,38
Algeria,2012-05-01,13,0,0,3,0,16
Algeria,2012-05-01,4,0,0,6,0,10
Algeria,2012-05-01,18,0,0,6,9,33
Algeria,2012-05-01,4,0,0,9,2,15
Algeria,2012-05-01,4,0,0,3,0,7
Algeria,2012-05-01,8,0,0,7,0,15
Algeria,2012-05-01,12,0,1,0,3,16
Algeria,2012-05-01,19,0,-2,-2,3,18
Algeria,2012-05-01,9,0,0,-3,0,6
Bangladesh,2012-05-01,21,0,2,13,2,38
Bangladesh,2012-05-01,29,0,-4,12,6,43
Bangladesh,2012-05-01,38,0,0,7,1,46
Bangladesh,2012-05-01,10,0,0,15,2,27
Bangladesh,2012-05-01,6,0,0,9,-4,11
Bangladesh,2012-05-01,20,0,0,6,0,26
Bangladesh,2012-05-01,24,0,0,19,0,43
Bangladesh,2012-05-01,18,0,0,17,0,35
Bangladesh,2012-05-01,15,0,-4,3,0,14
Bangladesh,2012-05-01,3,0,-4,0,0,-1
Bangladesh,2012-05-01,10,0,0,27,0,37
Bangladesh,2012-05-01,1,0,0,25,1,27
Bangladesh,2012-05-01,26,0,0,61,11,98
Bangladesh,2012-05-01,38,0,0,21,9,68
Bangladesh,2012-05-01,23,0,0,49,1,73
Bangladesh,2012-05-01,25,0,0,19,2,46
Bangladesh,2012-05-01,20,2,0,9,1,32
Bangladesh,2012-05-01,10,0,0,13,8,31
Bangladesh,2012-05-01,7,0,0,0,1,8
Bangladesh,2012-05-01,7,0,0,9,1,17
Bangladesh,2012-05-01,4,0,0,3,0,7
Bangladesh,2012-05-01,9,0,0,4,1,14
Bangladesh,2012-05-01,18,0,0,7,0,25
Bangladesh,2012-05-01,-4,0,0,3,0,-1
Bangladesh,2012-05-01,7,0,0,1,0,8
Bangladesh,2012-05-01,1,0,0,-4,1,-2
Bangladesh,2012-05-01,19,0,2,5,9,35
Bangladesh,2012-05-01,17,0,1,26,1,45
Bangladesh,2012-05-01,20,0,1,3,0,24
Bangladesh,2012-05-01,13,0,0,1,1,15
Bangladesh,2012-05-01,9,0,0,16,2,27
Cameroon,2012-05-01,24,0,0,0,0,24
Cameroon,2012-05-01,1,0,0,-4,0,-3
Cameroon,2012-05-01,0,0,0,0,0,0
Cameroon,2012-05-01,4,0,0,18,0,22
Cameroon,2012-05-01,2,0,0,0,0,2
Cameroon,2012-05-01,5,0,0,0,0,5
Cameroon,2012-05-01,2,0,0,-2,0,0
Cameroon,2012-05-01,4,0,0,0,0,4
Cameroon,2012-05-01,10,2,2,13,0,27
Cameroon,2012-05-01,0,0,0,6,0,6
Cameroon,2012-05-01,0,0,0,0,0,0
Cameroon,2012-05-01,0,0,0,0,0,0
Cameroon,2012-05-01,6,0,0,0,0,6
Cameroon,2012-05-01,3,0,0,-2,0,1
Cameroon,2012-05-01,9,0,0,0,0,9
Cameroon,2012-05-01,0,0,0,0,0,0
Cameroon,2012-05-01,0,0,0,0,0,0
Cameroon,2012-05-01,3,0,0,0,2,5
Cameroon,2012-05-01,0,0,0,0,1,1
Cameroon,2012-05-01,1,0,0,0,0,1
Cameroon,2012-05-01,0,0,0,0,0,0
Cameroon,2012-05-01,6,0,-1,0,1,6
Cameroon,2012-05-01,13,0,-1,-2,1,11
Cameroon,2012-05-01,6,0,0,6,0,12
Cameroon,2012-05-01,0,0,0,3,0,3
Cameroon,2012-05-01,2,0,0,3,0,5
Cameroon,2012-05-01,0,0,0,0,0,0
Cameroon,2012-05-01,2,0,0,0,0,2
Cameroon,2012-05-01,0,0,0,0,1,1
Cameroon,2012-05-01,6,0,0,0,0,6
Cameroon,2012-05-01,0,0,0,0,0,0
China,2012-05-01,133,4,-3,59,21,214
China,2012-05-01,177,4,2,72,13,268
China,2012-05-01,154,8,1,21,16,200
China,2012-05-01,173,6,5,71,24,279
China,2012-05-01,59,4,1,12,16,92
China,2012-05-01,101,2,-4,18,43,160
China,2012-05-01,146,2,6,119,13,286
China,2012-05-01,124,4,-4,33,13,170
China,2012-05-01,167,0,-1,85,18,269
China,2012-05-01,89,0,1,28,20,138
China,2012-05-01,157,2,4,102,41,306
China,2012-05-01,104,14,0,28,27,173
China,2012-05-01,123,4,-6,58,18,197
China,2012-05-01,176,10,-13,74,19,266
China,2012-05-01,157,2,-6,155,27,335
China,2012-05-01,187,8,5,89,11,300
China,2012-05-01,134,10,-1,68,9,220
China,2012-05-01,150,2,1,171,12,336
China,2012-05-01,52,0,1,32,13,98
China,2012-05-01,101,8,-1,-19,6,95
China,2012-05-01,139,12,-1,61,25,236
China,2012-05-01,146,0,-5,85,39,265
China,2012-05-01,156,2,-7,161,15,327
China,2012-05-01,150,10,2,88,16,266
China,2012-05-01,131,4,3,57,12,207
China,2012-05-01,80,0,-2,25,11,114
China,2012-05-01,105,2,-1,0,21,127
China,2012-05-01,173,2,-8,63,37,267
China,2012-05-01,263,0,-8,76,33,364
China,2012-05-01,212,4,-3,98,43,354
China,2012-05-01,105,4,-5,82,16,202
Egypt,2012-05-01,59,2,-2,39,13,111
Egypt,2012-05-01,64,0,5,13,23,105
Egypt,2012-05-01,37,2,-13,32,7,65
Egypt,2012-05-01,79,2,-2,51,22,152
Egypt,2012-05-01,96,0,-4,67,17,176
Egypt,2012-05-01,41,0,-10,40,26,97
Egypt,2012-05-01,85,0,-10,31,8,114
Egypt,2012-05-01,56,0,5,59,17,137
Egypt,2012-05-01,60,0,-8,16,9,77
Egypt,2012-05-01,8,0,0,0,4,12
Egypt,2012-05-01,56,0,-3,25,11,89
Egypt,2012-05-01,55,2,-4,30,36,119
Egypt,2012-05-01,106,2,-6,23,14,139
Egypt,2012-05-01,55,2,-2,25,32,112
Egypt,2012-05-01,41,2,-11,22,7,61
Egypt,2012-05-01,55,0,-2,52,8,113
Egypt,2012-05-01,53,6,-7,55,12,119
Egypt,2012-05-01,31,2,-4,19,9,57
Egypt,2012-05-01,30,0,-2,36,11,75
Egypt,2012-05-01,10,0,1,24,22,57
Egypt,2012-05-01,61,0,0,47,26,134
Egypt,2012-05-01,72,0,-5,41,21,129
Egypt,2012-05-01,85,0,1,52,34,172
Egypt,2012-05-01,37,0,-9,64,32,124
Egypt,2012-05-01,74,0,-1,51,27,151
Egypt,2012-05-01,72,2,-1,10,13,96
Egypt,2012-05-01,73,0,0,46,11,130
Egypt,2012-05-01,101,0,-2,2,35,136
Egypt,2012-05-01,69,0,-2,26,28,121
Egypt,2012-05-01,41,0,1,46,15,103
Egypt,2012-05-01,24,0,1,11,24,60
Eritrea,2012-05-01,5,0,0,0,0,5
Eritrea,2012-05-01,3,0,0,43,2,48
Eritrea,2012-05-01,9,0,0,11,0,20
Eritrea,2012-05-01,9,0,0,8,0,17
Eritrea,2012-05-01,13,0,0,0,0,13
Eritrea,2012-05-01,3,0,0,7,0,10
Eritrea,2012-05-01,0,0,0,0,0,0
Eritrea,2012-05-01,4,0,0,3,2,9
Eritrea,2012-05-01,6,0,0,0,0,6
Eritrea,2012-05-01,1,0,0,0,2,3
Eritrea,2012-05-01,9,0,0,0,2,11
Eritrea,2012-05-01,0,0,1,0,0,1
Eritrea,2012-05-01,0,0,0,0,0,0
Eritrea,2012-05-01,6,0,0,9,4,19
Eritrea,2012-05-01,6,0,0,15,4,25
Eritrea,2012-05-01,1,0,0,21,15,37
Eritrea,2012-05-01,1,0,0,1,3,5
Eritrea,2012-05-01,0,0,0,3,0,3
Eritrea,2012-05-01,1,0,0,12,0,13
Eritrea,2012-05-01,20,0,0,6,4,30
Eritrea,2012-05-01,26,0,0,0,0,26
Eritrea,2012-05-01,0,0,0,-2,0,-2
Eritrea,2012-05-01,3,0,0,12,16,31
Eritrea,2012-05-01,0,0,0,4,3,7
Eritrea,2012-05-01,0,0,0,3,0,3
Eritrea,2012-05-01,0,0,0,3,0,3
Eritrea,2012-05-01,0,0,0,3,4,7
Eritrea,2012-05-01,0,0,0,0,6,6
Eritrea,2012-05-01,-2,0,0,7,0,5
Eritrea,2012-05-01,1,0,0,0,0,1
Georgia,2012-05-01,46,6,4,49,9,114
Georgia,2012-05-01,37,2,-5,26,4,64
Georgia,2012-05-01,20,2,-9,29,12,54
Georgia,2012-05-01,27,4,-1,32,6,68
Georgia,2012-05-01,19,4,0,10,1,34
Georgia,2012-05-01,11,0,0,16,1,28
Georgia,2012-05-01,35,4,-12,13,8,48
Georgia,2012-05-01,43,0,-4,18,9,66
Georgia,2012-05-01,55,2,0,13,11,81
Georgia,2012-05-01,7,0,0,0,0,7
Georgia,2012-05-01,30,2,0,18,1,51
Georgia,2012-05-01,14,0,0,15,1,30
Georgia,2012-05-01,5,2,-2,9,1,15
Georgia,2012-05-01,62,2,-4,37,1,98
Georgia,2012-05-01,74,0,0,63,3,140
Georgia,2012-05-01,36,2,-2,13,5,54
Georgia,2012-05-01,57,0,0,23,4,84
Georgia,2012-05-01,38,0,-4,27,5,66
Georgia,2012-05-01,22,0,-4,-2,4,20
Georgia,2012-05-01,-1,2,0,0,1,2
Georgia,2012-05-01,65,0,-3,22,5,89
Georgia,2012-05-01,66,2,0,11,3,82
Georgia,2012-05-01,16,2,-5,2,6,21
Georgia,2012-05-01,39,4,0,-2,5,46
Georgia,2012-05-01,27,0,0,2,1,30
Georgia,2012-05-01,10,0,-2,3,1,12
Georgia,2012-05-01,10,2,1,1,4,18
Georgia,2012-05-01,57,0,1,14,6,78
Georgia,2012-05-01,32,0,0,28,5,65
Georgia,2012-05-01,52,2,1,21,8,84
Georgia,2012-05-01,15,0,0,-5,1,11
India,2012-05-01,64,2,1,28,5,100
India,2012-05-01,89,4,-3,5,9,104
India,2012-05-01,84,4,-4,17,12,113
India,2012-05-01,59,2,-3,41,15,114
India,2012-05-01,66,8,3,31,7,115
India,2012-05-01,50,2,2,20,6,80
India,2012-05-01,60,0,1,29,18,108
India,2012-05-01,78,0,-3,22,10,107
India,2012-05-01,88,2,-7,27,11,121
India,2012-05-01,32,0,0,10,5,47
India,2012-05-01,71,0,-6,21,7,93
India,2012-05-01,30,0,-2,14,14,56
India,2012-05-01,65,0,-7,38,8,104
India,2012-05-01,74,0,5,33,3,115
India,2012-05-01,86,2,2,67,7,164
India,2012-05-01,39,2,0,10,11,62
India,2012-05-01,50,0,-3,42,6,95
India,2012-05-01,43,0,1,39,5,88
India,2012-05-01,68,0,-1,10,4,81
India,2012-05-01,36,2,-2,9,5,50
India,2012-05-01,64,4,-1,31,9,107
India,2012-05-01,64,4,-3,28,6,99
India,2012-05-01,93,2,-4,21,14,126
India,2012-05-01,65,0,-3,20,7,89
India,2012-05-01,45,0,-3,31,8,81
India,2012-05-01,56,0,3,39,10,108
India,2012-05-01,98,2,-1,15,12,126
India,2012-05-01,62,2,-1,25,11,99
India,2012-05-01,94,0,-4,46,13,149
India,2012-05-01,88,2,-1,41,12,142
India,2012-05-01,65,0,-1,11,9,84
Iran,2012-05-01,65,0,-12,71,8,132
Iran,2012-05-01,95,0,0,47,11,153
Iran,2012-05-01,178,0,3,118,12,311
Iran,2012-05-01,128,0,-2,69,10,205
Iran,2012-05-01,88,0,7,50,8,153
Iran,2012-05-01,116,0,3,64,11,194
Iran,2012-05-01,107,0,1,76,12,196
Iran,2012-05-01,138,0,2,61,12,213
Iran,2012-05-01,105,0,-1,32,15,151
Iran,2012-05-01,44,0,0,0,6,50
Iran,2012-05-01,117,2,0,55,14,188
Iran,2012-05-01,69,0,2,-11,20,80
Iran,2012-05-01,81,0,0,18,9,108
Iran,2012-05-01,120,0,0,43,4,167
Iran,2012-05-01,104,0,0,51,13,168
Iran,2012-05-01,74,2,-4,60,16,148
Iran,2012-05-01,139,2,-2,30,16,185
Iran,2012-05-01,131,0,3,25,9,168
Iran,2012-05-01,68,0,1,33,14,116
Iran,2012-05-01,71,0,0,16,14,101
Iran,2012-05-01,142,2,0,86,5,235
Iran,2012-05-01,39,0,0,92,24,155
Iran,2012-05-01,137,0,1,131,2,271
Iran,2012-05-01,130,0,-3,74,14,215
Iran,2012-05-01,105,6,0,74,35,220
Iran,2012-05-01,49,0,2,51,3,105
Iran,2012-05-01,47,2,0,129,5,183
Iran,2012-05-01,103,2,0,76,9,190
Iran,2012-05-01,124,0,0,85,16,225
Iran,2012-05-01,114,0,1,98,9,222
Iran,2012-05-01,87,0,0,44,6,137
Iraq,2012-05-01,118,0,-2,21,10,147
Iraq,2012-05-01,118,0,-5,25,5,143
Iraq,2012-05-01,150,2,0,22,10,184
Iraq,2012-05-01,100,0,1,19,11,131
Iraq,2012-05-01,60,2,0,54,2,118
Iraq,2012-05-01,111,0,0,15,0,126
Iraq,2012-05-01,55,0,1,19,5,80
Iraq,2012-05-01,138,4,-2,62,4,206
Iraq,2012-05-01,74,0,3,60,4,141
Iraq,2012-05-01,15,0,0,3,3,21
Iraq,2012-05-01,89,0,-4,36,25,146
Iraq,2012-05-01,91,0,1,14,3,109
Iraq,2012-05-01,65,0,0,8,1,74
Iraq,2012-05-01,139,0,2,22,7,170
Iraq,2012-05-01,174,0,3,45,25,247
Iraq,2012-05-01,113,0,3,53,10,179
Iraq,2012-05-01,166,0,-1,79,14,258
Iraq,2012-05-01,103,0,0,39,10,152
Iraq,2012-05-01,91,2,0,37,5,135
Iraq,2012-05-01,24,0,0,12,9,45
Iraq,2012-05-01,112,0,0,28,17,157
Iraq,2012-05-01,64,0,-17,43,2,92
Iraq,2012-05-01,84,0,-6,48,9,135
Iraq,2012-05-01,119,0,-7,28,13,153
Iraq,2012-05-01,142,2,3,19,4,170
Iraq,2012-05-01,137,0,-2,6,11,152
Iraq,2012-05-01,123,2,0,1,23,149
Iraq,2012-05-01,219,12,7,28,17,283
Iraq,2012-05-01,151,0,1,26,15,193
Iraq,2012-05-01,71,2,-10,27,4,94
Iraq,2012-05-01,43,0,0,17,4,64
Morocco,2012-05-01,10,0,0,9,0,19
Morocco,2012-05-01,0,2,0,12,3,17
Morocco,2012-05-01,0,0,-1,24,3,26
Morocco,2012-05-01,28,0,0,8,0,36
Morocco,2012-05-01,-2,0,0,0,1,-1
Morocco,2012-05-01,6,0,0,0,3,9
Morocco,2012-05-01,4,0,0,0,0,4
Morocco,2012-05-01,23,0,0,12,0,35
Morocco,2012-05-01,10,0,0,9,8,27
Morocco,2012-05-01,2,0,0,0,0,2
Morocco,2012-05-01,2,0,0,6,1,9
Morocco,2012-05-01,8,2,0,9,0,19
Morocco,2012-05-01,2,0,0,0,0,2
Morocco,2012-05-01,2,0,0,-4,0,-2
Morocco,2012-05-01,-3,0,0,6,2,5
Morocco,2012-05-01,9,0,0,7,2,18
Morocco,2012-05-01,1,0,0,12,0,13
Morocco,2012-05-01,-8,0,0,3,1,-4
Morocco,2012-05-01,-1,0,0,0,0,-1
Morocco,2012-05-01,10,0,0,0,1,11
Morocco,2012-05-01,10,0,0,9,1,20
Morocco,2012-05-01,2,0,0,0,2,4
Morocco,2012-05-01,12,0,0,3,3,18
Morocco,2012-05-01,11,0,0,1,1,13
Morocco,2012-05-01,22,0,-2,12,2,34
Morocco,2012-05-01,6,0,0,6,0,12
Morocco,2012-05-01,26,0,0,0,2,28
Morocco,2012-05-01,6,0,0,-1,2,7
Morocco,2012-05-01,22,0,0,0,0,22
Morocco,2012-05-01,10,0,0,-3,2,9
Morocco,2012-05-01,11,0,0,-3,0,8
Nigeria,2012-05-01,20,0,0,22,5,47
Nigeria,2012-05-01,34,0,-9,15,9,49
Nigeria,2012-05-01,42,0,-4,30,2,70
Nigeria,2012-05-01,21,0,-1,11,9,40
Nigeria,2012-05-01,34,0,-1,26,5,64
Nigeria,2012-05-01,22,0,0,11,5,38
Nigeria,2012-05-01,31,0,2,11,2,46
Nigeria,2012-05-01,67,2,-1,30,4,102
Nigeria,2012-05-01,44,2,0,16,9,71
Nigeria,2012-05-01,28,0,2,5,0,35
Nigeria,2012-05-01,22,0,0,6,7,35
Nigeria,2012-05-01,30,0,1,6,5,42
Nigeria,2012-05-01,5,0,0,19,8,32
Nigeria,2012-05-01,58,2,0,37,10,107
Nigeria,2012-05-01,74,2,4,44,0,124
Nigeria,2012-05-01,41,0,1,50,7,99
Nigeria,2012-05-01,38,0,0,21,1,60
Nigeria,2012-05-01,12,0,0,11,2,25
Nigeria,2012-05-01,13,0,0,1,2,16
Nigeria,2012-05-01,22,0,0,3,6,31
Nigeria,2012-05-01,15,2,0,-2,8,23
Nigeria,2012-05-01,45,0,0,12,2,59
Nigeria,2012-05-01,39,2,2,30,6,79
Nigeria,2012-05-01,27,0,1,47,5,80
Nigeria,2012-05-01,19,6,0,4,2,31
Nigeria,2012-05-01,23,0,1,8,0,32
Nigeria,2012-05-01,14,0,0,3,4,21
Nigeria,2012-05-01,35,2,0,21,10,68
Nigeria,2012-05-01,30,0,0,14,4,48
Nigeria,2012-05-01,33,0,-3,156,4,190
Nigeria,2012-05-01,10,0,1,44,1,56
Pakistan,2012-05-01,351,4,1,114,24,494
Pakistan,2012-05-01,176,0,1,15,42,234
Pakistan,2012-05-01,192,0,0,70,19,281
Pakistan,2012-05-01,287,0,1,53,49,390
Pakistan,2012-05-01,170,6,-6,70,14,254
Pakistan,2012-05-01,73,4,-4,22,4,99
Pakistan,2012-05-01,109,0,-8,90,13,204
Pakistan,2012-05-01,152,4,-7,40,7,196
Pakistan,2012-05-01,107,0,-2,132,20,257
Pakistan,2012-05-01,72,0,0,46,9,127
Pakistan,2012-05-01,63,4,0,51,8,126
Pakistan,2012-05-01,68,2,0,28,4,102
Pakistan,2012-05-01,114,0,2,40,9,165
Pakistan,2012-05-01,110,0,0,28,18,156
Pakistan,2012-05-01,128,0,0,52,32,212
Pakistan,2012-05-01,114,0,-2,44,16,172
Pakistan,2012-05-01,90,2,1,48,12,153
Pakistan,2012-05-01,90,0,-3,24,6,117
Pakistan,2012-05-01,90,0,-1,43,11,143
Pakistan,2012-05-01,85,2,1,117,10,215
Pakistan,2012-05-01,186,0,-10,123,22,321
Pakistan,2012-05-01,125,2,-18,64,12,185
Pakistan,2012-05-01,78,2,1,90,6,177
Pakistan,2012-05-01,97,0,-8,103,27,219
Pakistan,2012-05-01,142,2,-9,107,15,257
Pakistan,2012-05-01,29,0,0,73,5,107
Pakistan,2012-05-01,36,0,0,39,2,77
Pakistan,2012-05-01,122,4,1,167,7,301
Pakistan,2012-05-01,220,0,-4,69,3,288
Pakistan,2012-05-01,95,0,-1,73,7,174
Pakistan,2012-05-01,17,0,0,15,5,37
Sierra Leone,2012-05-01,3,0,0,42,2,47
Sierra Leone,2012-05-01,15,2,0,9,0,26
Sierra Leone,2012-05-01,8,0,-4,23,4,31
Sierra Leone,2012-05-01,11,0,0,9,5,25
Sierra Leone,2012-05-01,0,0,0,0,0,0
Sierra Leone,2012-05-01,3,0,0,10,0,13
Sierra Leone,2012-05-01,1,0,0,25,1,27
Sierra Leone,2012-05-01,8,0,0,9,0,17
Sierra Leone,2012-05-01,0,0,0,9,1,10
Sierra Leone,2012-05-01,0,0,0,1,2,3
Sierra Leone,2012-05-01,7,0,0,21,2,30
Sierra Leone,2012-05-01,1,0,0,6,0,7
Sierra Leone,2012-05-01,0,0,0,3,0,3
Sierra Leone,2012-05-01,12,0,0,6,0,18
Sierra Leone,2012-05-01,12,0,0,9,1,22
Sierra Leone,2012-05-01,25,0,0,43,5,73
Sierra Leone,2012-05-01,15,0,0,37,4,56
Sierra Leone,2012-05-01,4,0,0,15,0,19
Sierra Leone,2012-05-01,2,0,0,0,0,2
Sierra Leone,2012-05-01,0,0,0,0,0,0
Sierra Leone,2012-05-01,8,0,0,12,2,22
Sierra Leone,2012-05-01,21,0,0,6,2,29
Sierra Leone,2012-05-01,2,0,0,3,0,5
Sierra Leone,2012-05-01,4,0,0,0,0,4
Sierra Leone,2012-05-01,0,0,0,0,0,0
Sierra Leone,2012-05-01,3,0,0,8,1,12
Sierra Leone,2012-05-01,1,0,0,39,0,40
Sierra Leone,2012-05-01,5,0,0,39,2,46
Sierra Leone,2012-05-01,21,0,-3,372,7,397
Sierra Leone,2012-05-01,14,0,0,66,4,84
Somalia,2012-05-01,145,0,0,33,19,197
Somalia,2012-05-01,51,6,4,54,18,133
Somalia,2012-05-01,190,10,-7,53,18,264
Somalia,2012-05-01,126,2,0,78,32,238
Somalia,2012-05-01,45,0,0,22,15,82
Somalia,2012-05-01,50,0,0,46,3,99
Somalia,2012-05-01,62,0,-2,9,6,75
Somalia,2012-05-01,61,0,1,18,5,85
Somalia,2012-05-01,64,0,0,14,7,85
Somalia,2012-05-01,35,0,0,7,1,43
Somalia,2012-05-01,67,2,-3,4,16,86
Somalia,2012-05-01,19,0,0,34,9,62
Somalia,2012-05-01,60,2,0,4,18,84
Somalia,2012-05-01,70,2,-3,27,19,115
Somalia,2012-05-01,175,4,-4,43,41,259
Somalia,2012-05-01,165,4,-7,68,23,253
Somalia,2012-05-01,67,0,-1,43,5,114
Somalia,2012-05-01,58,2,0,44,7,111
Somalia,2012-05-01,49,0,1,33,10,93
Somalia,2012-05-01,37,0,0,27,3,67
Somalia,2012-05-01,69,0,-3,32,10,108
Somalia,2012-05-01,88,0,-9,82,11,172
Somalia,2012-05-01,118,0,-8,49,4,163
Somalia,2012-05-01,96,2,-1,43,13,153
Somalia,2012-05-01,91,2,-2,31,18,140
Somalia,2012-05-01,63,0,0,12,12,87
Somalia,2012-05-01,30,0,-1,45,11,85
Somalia,2012-05-01,99,0,0,2,18,119
Somalia,2012-05-01,109,0,0,80,13,202
Somalia,2012-05-01,119,0,0,58,14,191
Somalia,2012-05-01,88,0,0,63,9,160
Syria,2012-05-01,163,0,1,49,11,224
Syria,2012-05-01,193,0,0,36,24,253
Syria,2012-05-01,102,0,3,39,12,156
Syria,2012-05-01,145,0,-5,33,19,192
Syria,2012-05-01,28,0,-2,-6,8,28
Syria,2012-05-01,192,2,1,31,37,263
Syria,2012-05-01,162,2,-14,35,41,226
Syria,2012-05-01,132,6,0,97,19,254
Syria,2012-05-01,218,2,-5,32,27,274
Syria,2012-05-01,47,0,0,-3,22,66
Syria,2012-05-01,95,0,0,59,21,175
Syria,2012-05-01,66,0,4,-9,11,72
Syria,2012-05-01,201,0,0,16,5,222
Syria,2012-05-01,349,0,1,84,35,469
Syria,2012-05-01,346,0,-4,87,31,460
Syria,2012-05-01,277,4,-2,88,8,375
Syria,2012-05-01,234,0,-24,188,16,414
Syria,2012-05-01,112,0,-6,10,2,118
Syria,2012-05-01,121,0,0,36,52,209
Syria,2012-05-01,138,0,-1,30,42,209
Syria,2012-05-01,434,4,1,29,43,511
Syria,2012-05-01,248,0,-8,89,15,344
Syria,2012-05-01,196,2,-7,82,47,320
Syria,2012-05-01,334,4,-7,61,34,426
Syria,2012-05-01,274,2,-6,30,31,331
Syria,2012-05-01,393,4,-2,49,18,462
Syria,2012-05-01,416,2,-3,47,18,480
Syria,2012-05-01,360,2,0,38,17,417
Syria,2012-05-01,759,4,-5,213,71,1042
Syria,2012-05-01,579,4,-10,185,63,821
Syria,2012-05-01,387,0,-8,53,32,464
Yemen,2012-05-01,81,0,0,33,8,122
Yemen,2012-05-01,66,2,0,-4,7,71
Yemen,2012-05-01,66,0,-6,10,2,72
Yemen,2012-05-01,45,0,-4,-15,10,36
Yemen,2012-05-01,89,0,-1,37,0,125
Yemen,2012-05-01,83,0,1,5,0,89
Yemen,2012-05-01,90,0,0,14,7,111
Yemen,2012-05-01,168,0,-4,35,23,222
Yemen,2012-05-01,145,0,-1,24,14,182
Yemen,2012-05-01,52,0,0,-1,2,53
Yemen,2012-05-01,48,0,0,9,3,60
Yemen,2012-05-01,30,0,-2,14,0,42
Yemen,2012-05-01,106,0,0,11,7,124
Yemen,2012-05-01,88,0,0,3,10,101
Yemen,2012-05-01,33,0,0,15,22,70
Yemen,2012-05-01,45,2,2,-4,5,50
Yemen,2012-05-01,77,0,0,10,4,91
Yemen,2012-05-01,53,2,0,-10,14,59
Yemen,2012-05-01,21,4,0,-6,7,26
Yemen,2012-05-01,36,0,0,0,1,37
Yemen,2012-05-01,67,0,-1,1,18,85
Yemen,2012-05-01,73,0,0,3,13,89
Yemen,2012-05-01,63,0,-2,0,1,62
Yemen,2012-05-01,92,2,-6,14,12,114
Yemen,2012-05-01,57,0,0,11,42,110
Yemen,2012-05-01,37,0,0,65,8,110
Yemen,2012-05-01,72,2,-8,-4,8,70
Yemen,2012-05-01,57,0,-4,3,7,63
Yemen,2012-05-01,44,0,0,-3,10,51
Yemen,2012-05-01,46,0,-6,6,1,47
Yemen,2012-05-01,35,0,-4,14,4,49
Afghanistan,2012-11-01,96,0,0,37,26,159
Afghanistan,2012-11-01,96,0,-1,31,8,134
Afghanistan,2012-11-01,86,6,0,9,12,113
Afghanistan,2012-11-01,46,0,0,4,5,55
Afghanistan,2012-11-01,205,0,0,56,26,287
Afghanistan,2012-11-01,143,0,0,21,31,195
Afghanistan,2012-11-01,128,0,-3,28,30,183
Afghanistan,2012-11-01,78,0,1,18,19,116
Afghanistan,2012-11-01,199,4,-13,20,12,222
Afghanistan,2012-11-01,211,0,-6,53,5,263
Afghanistan,2012-11-01,362,0,-11,40,7,398
Afghanistan,2012-11-01,447,6,7,44,19,523
Afghanistan,2012-11-01,348,0,-34,60,35,409
Afghanistan,2012-11-01,297,2,-25,-4,37,307
Afghanistan,2012-11-01,247,0,-13,23,14,271
Afghanistan,2012-11-01,232,2,2,1,31,268
Afghanistan,2012-11-01,127,2,-2,43,3,173
Afghanistan,2012-11-01,116,0,1,4,6,127
Afghanistan,2012-11-01,182,6,-7,3,10,194
Afghanistan,2012-11-01,147,0,-1,156,16,318
Afghanistan,2012-11-01,131,0,0,59,21,211
Afghanistan,2012-11-01,96,0,5,22,5,128
Afghanistan,2012-11-01,62,0,2,3,13,80
Afghanistan,2012-11-01,100,0,-2,9,0,107
Afghanistan,2012-11-01,53,0,0,12,2,67
Afghanistan,2012-11-01,98,2,-5,17,11,123
Afghanistan,2012-11-01,102,2,-20,26,10,120
Afghanistan,2012-11-01,106,0,-13,25,12,130
Afghanistan,2012-11-01,152,10,1,63,21,247
Afghanistan,2012-11-01,124,2,0,25,6,157
Albania,2012-11-01,7,0,0,3,0,10
Albania,2012-11-01,0,0,0,0,5,5
Albania,2012-11-01,2,0,0,3,1,6
Albania,2012-11-01,-1,0,0,0,0,-1
Albania,2012-11-01,0,0,0,3,0,3
Albania,2012-11-01,7,0,-1,3,0,9
Albania,2012-11-01,2,0,0,0,2,4
Albania,2012-11-01,2,0,-1,3,0,4
Albania,2012-11-01,11,0,-2,-2,1,8
Albania,2012-11-01,0,0,0,0,0,0
Albania,2012-11-01,4,0,0,2,0,6
Albania,2012-11-01,-10,0,0,3,2,-5
Albania,2012-11-01,-1,0,0,0,0,-1
Albania,2012-11-01,6,0,0,0,0,6
Albania,2012-11-01,3,0,0,0,0,3
Albania,2012-11-01,5,0,0,12,0,17
Albania,2012-11-01,3,0,0,0,0,3
Albania,2012-11-01,0,0,0,-2,0,-2
Albania,2012-11-01,0,0,0,9,0,9
Albania,2012-11-01,11,0,0,12,2,25
Albania,2012-11-01,2,0,0,3,2,7
Albania,2012-11-01,16,0,0,18,4,38
Albania,2012-11-01,3,0,0,0,0,3
Albania,2012-11-01,0,0,-1,3,4,6
Albania,2012-11-01,6,0,-2,0,2,6
Albania,2012-11-01,11,0,-1,3,3,16
Albania,2012-11-01,10,0,0,33,0,43
Albania,2012-11-01,2,0,0,12,2,16
Albania,2012-11-01,19,0,-2,22,2,41
Albania,2012-11-01,0,0,0,1,0,1
Algeria,2012-11-01,6,0,0,0,0,6
Algeria,2012-11-01,66,0,0,23,10,99
Algeria,2012-11-01,4,0,0,0,3,7
Algeria,2012-11-01,7,0,0,0,0,7
Algeria,2012-11-01,33,0,-6,37,10,74
Algeria,2012-11-01,7,2,-1,0,0,8
Algeria,2012-11-01,0,0,0,0,0,0
Algeria,2012-11-01,4,0,0,6,2,12
Algeria,2012-11-01,6,0,0,0,0,6
Algeria,2012-11-01,5,0,0,0,0,5
Algeria,2012-11-01,29,0,0,0,0,29
Algeria,2012-11-01,551,2,-8,109,50,704
Algeria,2012-11-01,18,0,0,3,0,21
Algeria,2012-11-01,10,0,-2,15,0,23
Algeria,2012-11-01,0,0,0,3,0,3
Algeria,2012-11-01,4,0,0,6,0,10
Algeria,2012-11-01,9,0,1,3,2,15
Algeria,2012-11-01,0,0,0,6,0,6
Algeria,2012-11-01,7,0,1,2,0,10
Algeria,2012-11-01,1046,8,0,221,126,1401
Algeria,2012-11-01,0,0,0,15,0,15
Algeria,2012-11-01,4,0,1,15,0,20
Algeria,2012-11-01,7,0,0,-8,0,-1
Algeria,2012-11-01,7,0,0,-1,0,6
Algeria,2012-11-01,4,0,0,0,1,5
Algeria,2012-11-01,0,0,0,0,0,0
Algeria,2012-11-01,6,0,-4,-1,0,1
Algeria,2012-11-01,3,0,0,3,0,6
Algeria,2012-11-01,0,0,0,3,1,4
Algeria,2012-11-01,14,0,1,9,2,26
Bangladesh,2012-11-01,65,0,-4,16,6,83
Bangladesh,2012-11-01,51,0,0,11,2,64
Bangladesh,2012-11-01,16,0,1,-1,3,19
Bangladesh,2012-11-01,11,0,0,6,1,18
Bangladesh,2012-11-01,59,0,-2,20,1,78
Bangladesh,2012-11-01,40,0,0,5,1,46
Bangladesh,2012-11-01,35,0,0,14,5,54
Bangladesh,2012-11-01,36,0,1,12,2,51
Bangladesh,2012-11-01,57,0,-2,12,-1,66
Bangladesh,2012-11-01,26,0,2,0,1,29
Bangladesh,2012-11-01,24,0,0,-1,6,29
Bangladesh,2012-11-01,26,2,0,21,3,52
Bangladesh,2012-11-01,56,0,0,21,4,81
Bangladesh,2012-11-01,39,0,0,11,3,53
Bangladesh,2012-11-01,14,0,0,3,4,21
Bangladesh,2012-11-01,19,0,0,17,1,37
Bangladesh,2012-11-01,14,0,0,20,1,35
Bangladesh,2012-11-01,74,0,0,8,18,100
Bangladesh,2012-11-01,20,0,2,9,16,47
Bangladesh,2012-11-01,6,0,0,3,0,9
Bangladesh,2012-11-01,30,0,1,15,0,46
Bangladesh,2012-11-01,34,0,0,4,4,42
Bangladesh,2012-11-01,22,0,-2,3,1,24
Bangladesh,2012-11-01,34,0,1,8,8,51
Bangladesh,2012-11-01,97,0,0,18,6,121
Bangladesh,2012-11-01,68,0,0,-10,15,73
Bangladesh,2012-11-01,24,0,2,21,3,50
Bangladesh,2012-11-01,21,0,0,23,4,48
Bangladesh,2012-11-01,50,0,0,24,2,76
Bangladesh,2012-11-01,24,0,2,24,3,53
Cameroon,2012-11-01,0,0,0,0,0,0
Cameroon,2012-11-01,2,0,0,0,0,2
Cameroon,2012-11-01,0,0,0,0,0,0
Cameroon,2012-11-01,0,0,0,-4,0,-4
Cameroon,2012-11-01,0,0,0,-2,0,-2
Cameroon,2012-11-01,2,0,0,6,1,9
Cameroon,2012-11-01,18,0,0,0,0,18
Cameroon,2012-11-01,5,0,-4,0,0,1
Cameroon,2012-11-01,3,0,0,0,0,3
Cameroon,2012-11-01,2,0,0,-2,0,0
Cameroon,2012-11-01,0,0,0,-2,0,-2
Cameroon,2012-11-01,8,0,0,0,0,8
Cameroon,2012-11-01,0,0,0,4,0,4
Cameroon,2012-11-01,3,2,0,0,0,5
Cameroon,2012-11-01,3,0,0,3,0,6
Cameroon,2012-11-01,10,0,1,9,0,20
Cameroon,2012-11-01,0,0,0,0,2,2
Cameroon,2012-11-01,5,0,0,6,0,11
Cameroon,2012-11-01,0,0,0,0,0,0
Cameroon,2012-11-01,3,0,0,-2,0,1
Cameroon,2012-11-01,0,0,0,3,0,3
Cameroon,2012-11-01,0,0,0,3,1,4
Cameroon,2012-11-01,0,0,0,0,0,0
Cameroon,2012-11-01,0,0,0,-2,0,-2
Cameroon,2012-11-01,0,0,0,3,0,3
Cameroon,2012-11-01,4,0,0,0,0,4
Cameroon,2012-11-01,-2,0,0,3,0,1
Cameroon,2012-11-01,0,0,0,0,0,0
Cameroon,2012-11-01,0,0,0,6,0,6
Cameroon,2012-11-01,0,0,0,15,0,15
China,2012-11-01,195,8,-2,73,32,306
China,2012-11-01,83,2,0,55,19,159
China,2012-11-01,77,0,-1,14,10,100
China,2012-11-01,342,0,6,139,70,557
China,2012-11-01,138,0,-2,74,29,239
China,2012-11-01,134,6,2,39,33,214
China,2012-11-01,123,2,-6,36,7,162
China,2012-11-01,165,2,1,36,30,234
China,2012-11-01,147,4,-4,90,18,255
China,2012-11-01,112,0,-4,34,12,154
China,2012-11-01,76,4,1,17,16,114
China,2012-11-01,73,2,2,23,29,129
China,2012-11-01,91,10,-3,62,16,176
China,2012-11-01,146,14,-3,81,23,261
China,2012-11-01,79,0,5,19,15,118
China,2012-11-01,136,4,3,36,20,199
China,2012-11-01,84,2,1,26,6,119
China,2012-11-01,93,8,-6,25,12,132
China,2012-11-01,175,2,-1,36,9,221
China,2012-11-01,133,2,-4,25,15,171
China,2012-11-01,133,4,-3,100,14,248
China,2012-11-01,88,2,-1,38,6,133
China,2012-11-01,122,2,0,8,12,144
China,2012-11-01,47,4,2,19,6,78
China,2012-11-01,58,6,1,-3,6,68
China,2012-11-01,97,0,-2,34,26,155
China,2012-11-01,176,2,7,76,18,279
China,2012-11-01,194,6,-4,73,11,280
China,2012-11-01,171,4,1,70,41,287
China,2012-11-01,130,0,8,31,26,195
Egypt,2012-11-01,50,0,0,19,6,75
Egypt,2012-11-01,49,0,0,9,7,65
Egypt,2012-11-01,183,0,0,33,10,226
Egypt,2012-11-01,75,0,0,27,2,104
Egypt,2012-11-01,68,0,-4,16,11,91
Egypt,2012-11-01,95,2,-1,27,13,136
Egypt,2012-11-01,57,0,1,38,10,106
Egypt,2012-11-01,58,0,0,54,18,130
Egypt,2012-11-01,50,0,0,26,4,80
Egypt,2012-11-01,63,2,0,-9,7,63
Egypt,2012-11-01,79,2,0,28,7,116
Egypt,2012-11-01,177,0,-2,23,4,202
Egypt,2012-11-01,109,0,0,12,9,130
Egypt,2012-11-01,220,0,0,33,38,291
Egypt,2012-11-01,376,4,1,15,45,441
Egypt,2012-11-01,471,0,0,16,50,537
Egypt,2012-11-01,250,2,-6,38,19,303
Egypt,2012-11-01,185,0,1,35,19,240
Egypt,2012-11-01,220,6,-1,26,41,292
Egypt,2012-11-01,126,0,2,25,34,187
Egypt,2012-11-01,215,8,1,23,16,263
Egypt,2012-11-01,150,2,-2,41,11,202
Egypt,2012-11-01,274,0,0,31,33,338
Egypt,2012-11-01,177,0,4,33,18,232
Egypt,2012-11-01,198,0,-2,30,30,256
Egypt,2012-11-01,171,0,-3,45,26,239
Egypt,2012-11-01,94,4,-6,37,41,170
Egypt,2012-11-01,165,0,0,70,43,278
Egypt,2012-11-01,103,0,-4,43,44,186
Egypt,2012-11-01,81,0,1,23,28,133
Eritrea,2012-11-01,0,0,0,0,3,3
Eritrea,2012-11-01,2,0,0,0,0,2
Eritrea,2012-11-01,0,0,0,7,0,7
Eritrea,2012-11-01,0,0,0,0,0,0
Eritrea,2012-11-01,0,0,0,0,0,0
Eritrea,2012-11-01,6,0,0,0,0,6
Eritrea,2012-11-01,2,0,-1,0,0,1
Eritrea,2012-11-01,0,0,0,15,0,15
Eritrea,2012-11-01,0,0,0,0,0,0
Eritrea,2012-11-01,0,0,0,6,0,6
Eritrea,2012-11-01,3,0,0,0,0,3
Eritrea,2012-11-01,13,0,0,0,0,13
Eritrea,2012-11-01,11,0,0,0,0,11
Eritrea,2012-11-01,0,0,0,15,0,15
Eritrea,2012-11-01,0,0,0,0,0,0
Eritrea,2012-11-01,1,0,0,0,0,1
Eritrea,2012-11-01,7,0,0,0,0,7
Eritrea,2012-11-01,0,0,0,0,0,0
Eritrea,2012-11-01,0,0,0,0,0,0
Eritrea,2012-11-01,8,0,0,0,0,8
Eritrea,2012-11-01,0,0,0,6,0,6
Eritrea,2012-11-01,3,0,0,0,0,3
Eritrea,2012-11-01,2,0,0,12,0,14
Eritrea,2012-11-01,1,0,0,0,0,1
Eritrea,2012-11-01,3,0,0,3,0,6
Eritrea,2012-11-01,0,0,0,0,0,0
Georgia,2012-11-01,2,0,0,0,0,2
Georgia,2012-11-01,0,0,0,0,1,1
Georgia,2012-11-01,-1,0,0,0,1,0
Georgia,2012-11-01,13,0,0,0,2,15
Georgia,2012-11-01,2,0,-2,3,1,4
Georgia,2012-11-01,0,0,-2,-2,1,-3
Georgia,2012-11-01,14,0,-2,15,0,27
Georgia,2012-11-01,4,0,0,12,1,17
Georgia,2012-11-01,0,0,0,6,0,6
Georgia,2012-11-01,-1,0,0,0,0,-1
Georgia,2012-11-01,2,0,0,0,0,2
Georgia,2012-11-01,7,0,0,0,1,8
Georgia,2012-11-01,1,0,0,0,0,1
Georgia,2012-11-01,9,0,0,0,0,9
Georgia,2012-11-01,11,0,0,15,0,26
Georgia,2012-11-01,0,0,-2,0,0,-2
Georgia,2012-11-01,0,0,0,0,0,0
Georgia,2012-11-01,0,0,0,0,0,0
Georgia,2012-11-01,1,0,0,0,0,1
Georgia,2012-11-01,2,0,0,12,0,14
Georgia,2012-11-01,8,0,0,0,0,8
Georgia,2012-11-01,2,0,0,1,0,3
Georgia,2012-11-01,-3,0,0,0,0,-3
Georgia,2012-11-01,1,0,0,0,0,1
Georgia,2012-11-01,0,0,0,0,0,0
Georgia,2012-11-01,0,0,0,0,0,0
Georgia,2012-11-01,0,0,0,0,0,0
Georgia,2012-11-01,-1,0,0,1,0,0
Georgia,2012-11-01,0,0,0,0,3,3
Georgia,2012-11-01,-1,0,0,3,0,2
India,2012-11-01,68,4,2,31,2,107
India,2012-11-01,62,0,-4,22,6,86
India,2012-11-01,74,2,0,42,11,129
India,2012-11-01,44,4,0,2,11,61
India,2012-11-01,27,0,-2,-1,5,29
India,2012-11-01,58,4,-4,25,11,94
India,2012-11-01,64,4,0,19,12,99
India,2012-11-01,57,2,-2,1,19,77
India,2012-11-01,36,2,-4,15,13,62
India,2012-11-01,15,0,-5,17,8,35
India,2012-11-01,56,2,3,-4,18,75
India,2012-11-01,34,4,1,11,12,62
India,2012-11-01,37,2,0,4,5,48
India,2012-11-01,69,0,1,16,7,93
India,2012-11-01,42,2,-1,-1,14,56
India,2012-11-01,47,4,3,33,5,92
India,2012-11-01,41,0,-9,34,4,70
India,2012-11-01,59,2,0,3,4,68
India,2012-11-01,58,2,-1,0,9,68
India,2012-11-01,44,4,-2,28,13,87
India,2012-11-01,53,0,-2,6,5,62
India,2012-11-01,63,4,0,7,11,85
India,2012-11-01,40,0,0,14,11,65
India,2012-11-01,52,6,0,0,16,74
India,2012-11-01,65,0,0,13,10,88
India,2012-11-01,64,0,-4,9,12,81
India,2012-11-01,37,6,0,16,3,62
India,2012-11-01,103,0,2,15,14,134
India,2012-11-01,53,2,0,-6,22,71
India,2012-11-01,49,4,0,17,17,87
Iran,2012-11-01,108,0,-1,29,8,144
Iran,2012-11-01,83,0,-4,29,13,121
Iran,2012-11-01,64,0,0,21,6,91
Iran,2012-11-01,59,0,2,7,3,71
Iran,2012-11-01,113,0,1,14,26,154
Iran,2012-11-01,105,0,0,4,13,122
Iran,2012-11-01,136,0,-3,44,16,193
Iran,2012-11-01,199,0,3,27,22,251
Iran,2012-11-01,166,0,4,69,15,254
Iran,2012-11-01,63,0,-2,59,4,124
Iran,2012-11-01,84,0,1,37,7,129
Iran,2012-11-01,135,2,4,48,14,203
Iran,2012-11-01,57,0,1,32,18,108
Iran,2012-11-01,137,0,16,12,9,174
Iran,2012-11-01,137,0,1,54,19,211
Iran,2012-11-01,100,0,1,58,7,166
Iran,2012-11-01,106,0,0,25,13,144
Iran,2012-11-01,106,0,0,5,10,121
Iran,2012-11-01,138,0,1,29,21,189
Iran,2012-11-01,225,0,1,41,10,277
Iran,2012-11-01,173,0,-4,37,21,227
Iran,2012-11-01,132,2,-1,30,16,179
Iran,2012-11-01,86,0,3,26,-3,112
Iran,2012-11-01,99,0,8,20,2,129
Iran,2012-11-01,106,0,0,12,4,122
Iran,2012-11-01,86,0,0,18,11,115
Iran,2012-11-01,88,0,1,4,4,97
Iran,2012-11-01,64,2,2,8,12,88
Iran,2012-11-01,89,8,1,18,23,139
Iran,2012-11-01,57,2,-1,36,10,104
Iraq,2012-11-01,59,0,2,54,14,129
Iraq,2012-11-01,112,2,0,31,11,156
Iraq,2012-11-01,56,6,0,13,7,82
Iraq,2012-11-01,24,6,0,20,10,60
Iraq,2012-11-01,83,0,0,43,11,137
Iraq,2012-11-01,91,0,0,19,25,135
Iraq,2012-11-01,109,0,0,31,9,149
Iraq,2012-11-01,80,0,2,68,11,161
Iraq,2012-11-01,175,0,-5,76,7,253
Iraq,2012-11-01,260,6,-6,44,17,321
Iraq,2012-11-01,224,4,-8,30,9,259
Iraq,2012-11-01,206,2,0,35,14,257
Iraq,2012-11-01,186,10,-8,62,19,269
Iraq,2012-11-01,111,2,1,15,6,135
Iraq,2012-11-01,148,0,-2,11,4,161
Iraq,2012-11-01,250,0,-2,41,13,302
Iraq,2012-11-01,136,2,-2,8,6,150
Iraq,2012-11-01,155,0,3,-7,3,154
Iraq,2012-11-01,92,0,0,11,2,105
Iraq,2012-11-01,153,6,2,59,4,224
Iraq,2012-11-01,45,0,2,36,2,85
Iraq,2012-11-01,103,6,7,7,7,130
Iraq,2012-11-01,68,0,0,21,2,91
Iraq,2012-11-01,26,0,0,6,7,39
Iraq,2012-11-01,51,0,0,-10,1,42
Iraq,2012-11-01,63,0,1,27,13,104
Iraq,2012-11-01,108,0,0,42,5,155
Iraq,2012-11-01,109,0,3,46,17,175
Iraq,2012-11-01,117,0,0,51,16,184
Iraq,2012-11-01,64,2,2,73,2,143
Morocco,2012-11-01,5,0,0,0,0,5
Morocco,2012-11-01,41,0,0,16,5,62
Morocco,2012-11-01,2,0,0,0,0,2
Morocco,2012-11-01,3,0,0,0,0,3
Morocco,2012-11-01,435,26,-6,198,92,745
Morocco,2012-11-01,701,0,5,323,114,1143
Morocco,2012-11-01,3,0,0,9,0,12
Morocco,2012-11-01,25,0,0,6,2,33
Morocco,2012-11-01,8,0,-1,3,3,13
Morocco,2012-11-01,0,0,0,0,0,0
Morocco,2012-11-01,3,0,0,3,2,8
Morocco,2012-11-01,14,0,0,6,0,20
Morocco,2012-11-01,0,0,0,0,0,0
Morocco,2012-11-01,-1,0,0,3,1,3
Morocco,2012-11-01,5,0,0,0,0,5
Morocco,2012-11-01,6,0,0,-2,0,4
Morocco,2012-11-01,0,0,0,0,0,0
Morocco,2012-11-01,10,0,0,3,4,17
Morocco,2012-11-01,32,0,0,12,2,46
Morocco,2012-11-01,46,0,0,3,0,49
Morocco,2012-11-01,116,0,-3,21,18,152
Morocco,2012-11-01,5,0,0,-2,0,3
Morocco,2012-11-01,6,0,0,9,0,15
Morocco,2012-11-01,4,0,0,0,1,5
Morocco,2012-11-01,6,0,0,0,0,6
Morocco,2012-11-01,8,0,0,-4,0,4
Morocco,2012-11-01,10,0,0,15,0,25
Morocco,2012-11-01,6,0,-1,11,6,22
Morocco,2012-11-01,17,0,0,8,2,27
Morocco,2012-11-01,7,0,0,6,0,13
Nigeria,2012-11-01,27,0,0,-7,10,30
Nigeria,2012-11-01,18,0,0,26,2,46
Nigeria,2012-11-01,29,0,-2,-4,0,23
Nigeria,2012-11-01,21,0,0,12,1,34
Nigeria,2012-11-01,51,0,-7,13,12,69
Nigeria,2012-11-01,22,0,0,15,1,38
Nigeria,2012-11-01,15,0,0,27,1,43
Nigeria,2012-11-01,43,0,-2,40,3,84
Nigeria,2012-11-01,53,0,-1,24,9,85
Nigeria,2012-11-01,19,0,-3,6,1,23
Nigeria,2012-11-01,47,0,0,16,1,64
Nigeria,2012-11-01,80,0,0,17,12,109
Nigeria,2012-11-01,59,2,1,31,6,99
Nigeria,2012-11-01,49,0,1,8,2,60
Nigeria,2012-11-01,20,0,0,2,5,27
Nigeria,2012-11-01,31,8,-1,9,5,52
Nigeria,2012-11-01,18,0,0,57,1,76
Nigeria,2012-11-01,6,0,1,4,5,16
Nigeria,2012-11-01,25,2,-1,31,3,60
Nigeria,2012-11-01,23,0,-2,32,2,55
Nigeria,2012-11-01,42,0,0,34,8,84
Nigeria,2012-11-01,11,0,0,-1,4,14
Nigeria,2012-11-01,13,0,0,7,3,23
Nigeria,2012-11-01,11,0,0,12,1,24
Nigeria,2012-11-01,14,2,0,9,7,32
Nigeria,2012-11-01,23,0,0,17,0,40
Nigeria,2012-11-01,43,0,0,13,5,61
Nigeria,2012-11-01,52,0,-2,9,3,62
Nigeria,2012-11-01,20,0,0,-2,1,19
Nigeria,2012-11-01,6,0,1,3,2,12
Pakistan,2012-11-01,52,0,-1,15,2,68
Pakistan,2012-11-01,67,0,4,36,15,122
Pakistan,2012-11-01,70,0,2,11,7,90
Pakistan,2012-11-01,75,0,2,16,1,94
Pakistan,2012-11-01,108,0,0,78,12,198
Pakistan,2012-11-01,154,0,0,60,8,222
Pakistan,2012-11-01,64,0,-7,30,9,96
Pakistan,2012-11-01,81,0,-5,40,5,121
Pakistan,2012-11-01,131,2,-3,22,8,160
Pakistan,2012-11-01,95,0,1,8,5,109
Pakistan,2012-11-01,66,0,0,9,3,78
Pakistan,2012-11-01,103,4,3,18,17,145
Pakistan,2012-11-01,132,3,3,23,23,184
Pakistan,2012-11-01,172,6,-1,63,23,263
Pakistan,2012-11-01,211,0,-4,72,18,297
Pakistan,2012-11-01,152,4,2,49,20,227
Pakistan,2012-11-01,51,0,1,17,4,73
Pakistan,2012-11-01,59,0,0,-3,4,60
Pakistan,2012-11-01,52,0,0,36,2,90
Pakistan,2012-11-01,172,4,1,36,6,219
Pakistan,2012-11-01,363,0,5,115,18,501
Pakistan,2012-11-01,144,6,1,16,5,172
Pakistan,2012-11-01,48,0,4,25,3,80
Pakistan,2012-11-01,49,0,0,23,10,82
Pakistan,2012-11-01,107,0,0,19,7,133
Pakistan,2012-11-01,109,4,3,36,15,167
Pakistan,2012-11-01,106,0,-5,39,28,168
Pakistan,2012-11-01,61,2,-12,31,27,109
Pakistan,2012-11-01,19,0,-4,27,22,64
Pakistan,2012-11-01,69,8,-4,63,10,146
Sierra Leone,2012-11-01,0,0,0,0,3,3
Sierra Leone,2012-11-01,3,0,0,1,1,5
Sierra Leone,2012-11-01,0,0,0,0,0,0
Sierra Leone,2012-11-01,7,0,0,0,0,7
Sierra Leone,2012-11-01,25,0,0,0,0,25
Sierra Leone,2012-11-01,2,0,0,0,0,2
Sierra Leone,2012-11-01,2,0,0,0,0,2
Sierra Leone,2012-11-01,7,0,0,10,0,17
Sierra Leone,2012-11-01,7,0,0,0,2,9
Sierra Leone,2012-11-01,0,0,0,0,0,0
Sierra Leone,2012-11-01,0,0,0,0,0,0
Sierra Leone,2012-11-01,3,0,0,3,0,6
Sierra Leone,2012-11-01,4,0,1,1,1,7
Sierra Leone,2012-11-01,17,0,-6,3,1,15
Sierra Leone,2012-11-01,5,0,3,0,0,8
Sierra Leone,2012-11-01,1,0,0,4,2,7
Sierra Leone,2012-11-01,0,0,0,2,5,7
Sierra Leone,2012-11-01,0,0,0,0,2,2
Sierra Leone,2012-11-01,23,0,0,0,3,26
Sierra Leone,2012-11-01,4,0,0,6,1,11
Sierra Leone,2012-11-01,3,0,0,-4,0,-1
Sierra Leone,2012-11-01,1,0,0,0,1,2
Sierra Leone,2012-11-01,12,0,-2,3,0,13
Sierra Leone,2012-11-01,3,0,-2,0,1,2
Sierra Leone,2012-11-01,4,0,0,3,1,8
Sierra Leone,2012-11-01,15,0,-1,-6,2,10
Sierra Leone,2012-11-01,4,0,1,6,2,13
Sierra Leone,2012-11-01,2,0,0,1,3,6
Sierra Leone,2012-11-01,8,0,0,0,7,15
Sierra Leone,2012-11-01,0,0,0,0,0,0
Somalia,2012-11-01,20,0,0,12,8,40
Somalia,2012-11-01,74,0,0,39,11,124
Somalia,2012-11-01,42,2,0,7,6,57
Somalia,2012-11-01,167,0,0,10,7,184
Somalia,2012-11-01,46,0,0,34,15,95
Somalia,2012-11-01,129,0,1,27,12,169
Somalia,2012-11-01,102,2,-2,31,9,142
Somalia,2012-11-01,76,4,0,9,0,89
Somalia,2012-11-01,37,0,0,3,0,40
Somalia,2012-11-01,3,0,0,3,1,7
Somalia,2012-11-01,36,4,0,3,2,45
Somalia,2012-11-01,-5,0,0,3,2,0
Somalia,2012-11-01,13,0,0,15,2,30
Somalia,2012-11-01,49,0,0,39,0,88
Somalia,2012-11-01,17,0,0,13,4,34
Somalia,2012-11-01,25,0,0,12,0,37
Somalia,2012-11-01,10,0,0,9,0,19
Somalia,2012-11-01,41,0,0,7,8,56
Somalia,2012-11-01,151,0,0,35,3,189
Somalia,2012-11-01,141,0,0,67,10,218
Somalia,2012-11-01,43,0,0,0,11,54
Somalia,2012-11-01,15,0,0,4,0,19
Somalia,2012-11-01,884,2,-4,274,139,1295
Somalia,2012-11-01,23,0,0,7,0,30
Somalia,2012-11-01,60,0,0,-2,0,58
Somalia,2012-11-01,67,0,0,12,0,79
Somalia,2012-11-01,17,0,0,27,5,49
Somalia,2012-11-01,22,0,0,-1,2,23
Somalia,2012-11-01,60,0,0,3,2,65
Somalia,2012-11-01,15,0,0,0,2,17
Syria,2012-11-01,244,0,-7,9,15,261
Syria,2012-11-01,216,0,-2,26,44,284
Syria,2012-11-01,62,0,0,16,14,92
Syria,2012-11-01,255,0,8,56,41,360
Syria,2012-11-01,251,2,-2,85,88,424
Syria,2012-11-01,305,0,4,-9,55,355
Syria,2012-11-01,201,4,-2,7,12,222
Syria,2012-11-01,405,0,-20,8,12,405
Syria,2012-11-01,320,14,-6,24,10,362
Syria,2012-11-01,572,10,0,140,31,753
Syria,2012-11-01,355,6,-2,37,6,402
Syria,2012-11-01,378,14,2,76,12,482
Syria,2012-11-01,253,16,-1,45,21,334
Syria,2012-11-01,270,2,5,38,35,350
Syria,2012-11-01,171,0,7,80,21,279
Syria,2012-11-01,173,2,-4,43,12,226
Syria,2012-11-01,225,0,0,24,24,273
Syria,2012-11-01,130,0,0,8,12,150
Syria,2012-11-01,206,6,1,6,24,243
Syria,2012-11-01,221,8,1,24,11,265
Syria,2012-11-01,190,0,1,10,21,222
Syria,2012-11-01,137,0,3,-1,9,148
Syria,2012-11-01,212,0,3,23,13,251
Syria,2012-11-01,143,0,1,24,3,171
Syria,2012-11-01,121,0,0,22,4,147
Syria,2012-11-01,166,0,0,10,6,182
Syria,2012-11-01,174,6,0,19,12,211
Syria,2012-11-01,204,4,-2,44,25,275
Syria,2012-11-01,197,1,-2,7,19,222
Syria,2012-11-01,224,6,-5,51,9,285
Yemen,2012-11-01,5,0,0,0,4,9
Yemen,2012-11-01,6,0,2,0,1,9
Yemen,2012-11-01,18,0,0,6,0,24
Yemen,2012-11-01,24,0,0,-1,1,24
Yemen,2012-11-01,68,0,0,9,10,87
Yemen,2012-11-01,8,0,0,6,5,19
Yemen,2012-11-01,22,0,0,30,3,55
Yemen,2012-11-01,11,0,0,3,2,16
Yemen,2012-11-01,0,0,0,3,1,4
Yemen,2012-11-01,-1,0,0,0,0,-1
Yemen,2012-11-01,8,0,0,0,0,8
Yemen,2012-11-01,3,0,0,0,1,4
Yemen,2012-11-01,4,0,0,3,0,7
Yemen,2012-11-01,0,0,0,6,0,6
Yemen,2012-11-01,1,0,0,0,0,1
Yemen,2012-11-01,17,0,0,-2,2,17
Yemen,2012-11-01,-2,0,-2,0,0,-4
Yemen,2012-11-01,4,0,0,0,0,4
Yemen,2012-11-01,10,0,0,0,2,12
Yemen,2012-11-01,16,0,0,6,3,25
Yemen,2012-11-01,15,0,0,0,0,15
Yemen,2012-11-01,10,0,0,4,2,16
Yemen,2012-11-01,12,0,-2,0,3,13
Yemen,2012-11-01,6,0,0,6,0,12
Yemen,2012-11-01,29,0,0,3,0,32
Yemen,2012-11-01,4,0,0,4,0,8
Yemen,2012-11-01,2,0,0,3,5,10
Yemen,2012-11-01,81,0,-2,1,2,82
Yemen,2012-11-01,24,0,0,1,6,31
Yemen,2012-11-01,14,0,0,0,1,15
Afghanistan,2010-07-01,191,0,-2,46,18,253
Afghanistan,2010-07-01,142,2,-1,0,12,155
Afghanistan,2010-07-01,72,0,-2,17,2,89
Afghanistan,2010-07-01,216,0,3,24,14,257
Afghanistan,2010-07-01,245,4,-4,39,55,339
Afghanistan,2010-07-01,103,6,0,79,7,195
Afghanistan,2010-07-01,281,2,-9,67,28,369
Afghanistan,2010-07-01,101,6,3,27,56,193
Afghanistan,2010-07-01,243,2,-6,43,31,313
Afghanistan,2010-07-01,279,4,0,31,33,347
Afghanistan,2010-07-01,59,0,0,6,3,68
Afghanistan,2010-07-01,113,4,0,20,9,146
Afghanistan,2010-07-01,77,0,0,17,5,99
Afghanistan,2010-07-01,162,0,0,0,22,184
Afghanistan,2010-07-01,73,0,0,13,6,92
Afghanistan,2010-07-01,75,0,0,0,9,84
Afghanistan,2010-07-01,85,0,0,6,18,109
Afghanistan,2010-07-01,101,0,2,2,18,123
Afghanistan,2010-07-01,126,0,-4,6,12,140
Afghanistan,2010-07-01,83,2,4,11,6,106
Afghanistan,2010-07-01,103,0,0,14,4,121
Afghanistan,2010-07-01,89,0,-4,-1,0,84
Afghanistan,2010-07-01,35,4,0,5,8,52
Afghanistan,2010-07-01,80,0,1,18,1,100
Afghanistan,2010-07-01,115,0,1,10,15,141
Afghanistan,2010-07-01,139,2,0,9,12,162
Afghanistan,2010-07-01,91,0,1,-3,15,104
Afghanistan,2010-07-01,152,0,4,23,10,189
Afghanistan,2010-07-01,338,0,0,77,39,454
Afghanistan,2010-07-01,314,0,6,86,17,423
Afghanistan,2010-07-01,242,4,-4,48,20,310
Albania,2010-07-01,2,0,0,0,0,2
Albania,2010-07-01,47,0,0,6,3,56
Albania,2010-07-01,16,0,0,0,0,16
Albania,2010-07-01,8,0,0,0,0,8
Albania,2010-07-01,96,0,3,3,18,120
Albania,2010-07-01,2,0,1,0,0,3
Albania,2010-07-01,4,0,0,0,0,4
Albania,2010-07-01,4,0,0,0,0,4
Albania,2010-07-01,5,0,0,0,0,5
Albania,2010-07-01,1,0,0,0,0,1
Albania,2010-07-01,0,0,0,0,1,1
Albania,2010-07-01,10,0,0,6,0,16
Albania,2010-07-01,0,0,0,9,0,9
Albania,2010-07-01,5,0,0,0,0,5
Albania,2010-07-01,4,0,-1,0,0,3
Albania,2010-07-01,1,0,0,15,0,16
Albania,2010-07-01,0,0,1,0,0,1
Albania,2010-07-01,0,0,0,3,0,3
Albania,2010-07-01,9,0,0,0,6,15
Albania,2010-07-01,3,0,0,0,0,3
Albania,2010-07-01,13,0,0,18,0,31
Albania,2010-07-01,41,0,-4,3,2,42
Albania,2010-07-01,19,0,0,0,0,19
Albania,2010-07-01,0,0,0,0,0,0
Albania,2010-07-01,2,0,0,3,0,5
Albania,2010-07-01,5,0,0,0,0,5
Albania,2010-07-01,2,0,0,0,0,2
Albania,2010-07-01,3,0,0,0,0,3
Albania,2010-07-01,32,0,0,0,1,33
Albania,2010-07-01,12,0,0,9,0,21
Albania,2010-07-01,9,0,0,0,0,9
Algeria,2010-07-01,15,0,0,6,0,21
Algeria,2010-07-01,9,0,0,0,0,9
Algeria,2010-07-01,4,0,0,8,0,12
Algeria,2010-07-01,0,0,0,0,0,0
Algeria,2010-07-01,6,0,0,0,0,6
Algeria,2010-07-01,0,0,0,0,0,0
Algeria,2010-07-01,2,0,0,2,0,4
Algeria,2010-07-01,5,0,0,3,2,10
Algeria,2010-07-01,0,0,0,0,0,0
Algeria,2010-07-01,0,0,0,3,0,3
Algeria,2010-07-01,0,0,0,-1,0,-1
Algeria,2010-07-01,6,0,0,0,3,9
Algeria,2010-07-01,2,0,0,3,0,5
Algeria,2010-07-01,1,0,0,9,0,10
Algeria,2010-07-01,0,0,0,0,0,0
Algeria,2010-07-01,0,0,0,3,0,3
Algeria,2010-07-01,0,0,0,3,0,3
Algeria,2010-07-01,13,0,0,0,0,13
Algeria,2010-07-01,15,0,0,4,2,21
Algeria,2010-07-01,6,0,0,6,0,12
Algeria,2010-07-01,-2,0,0,0,0,-2
Algeria,2010-07-01,0,0,0,0,0,0
Algeria,2010-07-01,0,0,0,0,0,0
Algeria,2010-07-01,10,0,0,12,0,22
Algeria,2010-07-01,12,0,0,22,1,35
Algeria,2010-07-01,8,0,0,-2,0,6
Algeria,2010-07-01,9,0,0,11,0,20
Algeria,2010-07-01,7,0,0,3,0,10
Algeria,2010-07-01,1,0,0,3,0,4
Algeria,2010-07-01,0,0,0,6,0,6
Bangladesh,2010-07-01,6,0,0,9,0,15
Bangladesh,2010-07-01,0,0,0,1,0,1
Bangladesh,2010-07-01,3,0,0,2,0,5
Bangladesh,2010-07-01,17,0,0,9,0,26
Bangladesh,2010-07-01,30,0,1,10,7,48
Bangladesh,2010-07-01,13,0,0,13,0,26
Bangladesh,2010-07-01,6,0,3,9,4,22
Bangladesh,2010-07-01,0,0,0,3,0,3
Bangladesh,2010-07-01,2,0,0,15,1,18
Bangladesh,2010-07-01,31,0,0,16,2,49
Bangladesh,2010-07-01,1,0,0,12,0,13
Bangladesh,2010-07-01,2,0,0,0,0,2
Bangladesh,2010-07-01,0,0,0,0,3,3
Bangladesh,2010-07-01,7,0,-4,28,0,31
Bangladesh,2010-07-01,1,0,0,-2,0,-1
Bangladesh,2010-07-01,0,0,0,-2,0,-2
Bangladesh,2010-07-01,0,0,0,0,0,0
Bangladesh,2010-07-01,0,0,0,3,0,3
Bangladesh,2010-07-01,-1,0,0,15,0,14
Bangladesh,2010-07-01,3,0,0,3,0,6
Bangladesh,2010-07-01,14,0,0,3,2,19
Bangladesh,2010-07-01,15,0,0,-5,0,10
Bangladesh,2010-07-01,3,0,0,15,0,18
Bangladesh,2010-07-01,1,0,0,-5,0,-4
Bangladesh,2010-07-01,8,0,0,-14,6,0
Bangladesh,2010-07-01,0,0,0,6,1,7
Bangladesh,2010-07-01,-2,0,0,0,0,-2
Bangladesh,2010-07-01,11,0,0,0,6,17
Bangladesh,2010-07-01,34,0,-2,37,8,77
Bangladesh,2010-07-01,17,0,1,6,1,25
Bangladesh,2010-07-01,11,0,-2,10,4,23
Cameroon,2010-07-01,0,0,0,0,0,0
Cameroon,2010-07-01,0,0,0,0,0,0
Cameroon,2010-07-01,9,0,0,-2,0,7
Cameroon,2010-07-01,10,0,0,-6,0,4
Cameroon,2010-07-01,9,0,0,0,0,9
Cameroon,2010-07-01,13,0,-2,7,0,18
Cameroon,2010-07-01,0,0,0,0,0,0
Cameroon,2010-07-01,0,0,0,0,0,0
Cameroon,2010-07-01,5,0,0,0,0,5
Cameroon,2010-07-01,3,0,0,0,0,3
Cameroon,2010-07-01,0,0,0,0,0,0
Cameroon,2010-07-01,6,0,0,3,0,9
Cameroon,2010-07-01,0,0,0,0,0,0
Cameroon,2010-07-01,0,0,0,0,0,0
Cameroon,2010-07-01,1,0,0,0,0,1
Cameroon,2010-07-01,0,0,0,0,0,0
Cameroon,2010-07-01,0,0,0,0,0,0
Cameroon,2010-07-01,0,0,0,0,0,0
Cameroon,2010-07-01,0,0,0,0,0,0
Cameroon,2010-07-01,1,0,0,9,0,10
Cameroon,2010-07-01,9,0,0,0,0,9
China,2010-07-01,100,0,-3,56,5,158
China,2010-07-01,47,0,-2,5,6,56
China,2010-07-01,36,0,0,0,0,36
China,2010-07-01,58,0,-1,10,12,79
China,2010-07-01,118,2,-7,61,13,187
China,2010-07-01,91,2,-2,33,10,134
China,2010-07-01,101,0,-5,68,21,185
China,2010-07-01,71,4,-4,69,15,155
China,2010-07-01,127,6,-10,106,17,246
China,2010-07-01,58,0,-6,37,12,101
China,2010-07-01,10,0,0,2,0,12
China,2010-07-01,15,0,-2,10,6,29
China,2010-07-01,27,0,1,-5,2,25
China,2010-07-01,44,0,-2,34,10,86
China,2010-07-01,41,0,0,7,3,51
China,2010-07-01,44,0,0,22,1,67
China,2010-07-01,20,0,0,8,0,28
China,2010-07-01,20,0,0,6,0,26
China,2010-07-01,71,0,0,0,11,82
China,2010-07-01,31,0,-1,16,5,51
China,2010-07-01,103,2,-1,53,7,164
China,2010-07-01,43,2,-1,-3,6,47
China,2010-07-01,35,4,-2,12,3,52
China,2010-07-01,32,0,0,20,4,56
China,2010-07-01,76,0,2,27,0,105
China,2010-07-01,32,0,-1,9,4,44
China,2010-07-01,23,0,-2,36,2,59
China,2010-07-01,66,0,-2,25,3,92
China,2010-07-01,119,0,-2,76,20,213
China,2010-07-01,150,4,-2,98,31,281
China,2010-07-01,111,2,2,13,9,137
Egypt,2010-07-01,32,0,0,13,0,45
Egypt,2010-07-01,11,0,0,0,2,13
Egypt,2010-07-01,0,0,0,7,0,7
Egypt,2010-07-01,45,0,0,12,0,57
Egypt,2010-07-01,26,0,0,-8,3,21
Egypt,2010-07-01,10,0,0,5,0,15
Egypt,2010-07-01,46,0,0,4,0,50
Egypt,2010-07-01,10,0,2,9,6,27
Egypt,2010-07-01,9,2,3,3,3,20
Egypt,2010-07-01,4,0,0,-1,0,3
Egypt,2010-07-01,11,0,1,-4,5,13
Egypt,2010-07-01,15,0,0,1,0,16
Egypt,2010-07-01,13,0,0,-5,2,10
Egypt,2010-07-01,18,0,6,7,1,32
Egypt,2010-07-01,1,0,0,19,1,21
Egypt,2010-07-01,1,0,0,9,0,10
Egypt,2010-07-01,4,0,0,-2,0,2
Egypt,2010-07-01,12,0,1,0,3,16
Egypt,2010-07-01,45,0,5,14,2,66
Egypt,2010-07-01,12,0,0,0,0,12
Egypt,2010-07-01,0,0,-10,22,11,23
Egypt,2010-07-01,7,0,1,-9,0,-1
Egypt,2010-07-01,14,0,-1,-4,0,9
Egypt,2010-07-01,0,0,0,1,0,1
Egypt,2010-07-01,6,0,0,1,0,7
Egypt,2010-07-01,13,0,0,3,2,18
Egypt,2010-07-01,-2,0,0,0,0,-2
Egypt,2010-07-01,-1,0,0,-2,0,-3
Egypt,2010-07-01,40,2,-5,10,3,50
Egypt,2010-07-01,34,2,-2,6,0,40
Egypt,2010-07-01,130,0,0,12,0,142
Eritrea,2010-07-01,0,0,0,0,0,0
Eritrea,2010-07-01,0,0,0,0,0,0
Eritrea,2010-07-01,0,0,0,3,0,3
Eritrea,2010-07-01,0,0,0,6,0,6
Eritrea,2010-07-01,3,0,0,0,0,3
Eritrea,2010-07-01,0,0,0,0,0,0
Eritrea,2010-07-01,8,0,0,3,0,11
Eritrea,2010-07-01,0,0,0,0,0,0
Eritrea,2010-07-01,4,0,0,-2,0,2
Eritrea,2010-07-01,-3,0,0,0,0,-3
Eritrea,2010-07-01,0,0,0,0,0,0
Eritrea,2010-07-01,5,0,0,6,1,12
Eritrea,2010-07-01,2,0,0,0,0,2
Eritrea,2010-07-01,0,0,0,0,0,0
Eritrea,2010-07-01,2,2,0,9,0,13
Eritrea,2010-07-01,5,0,0,0,0,5
Eritrea,2010-07-01,4,0,0,0,0,4
Eritrea,2010-07-01,0,0,0,-6,0,-6
Eritrea,2010-07-01,0,0,0,0,0,0
Eritrea,2010-07-01,-8,0,0,0,0,-8
Eritrea,2010-07-01,0,0,0,0,1,1
Eritrea,2010-07-01,0,0,0,0,0,0
Eritrea,2010-07-01,0,0,0,3,0,3
Eritrea,2010-07-01,14,0,0,0,2,16
Eritrea,2010-07-01,1,0,0,0,0,1
Eritrea,2010-07-01,0,0,0,0,0,0
Georgia,2010-07-01,0,0,0,0,0,0
Georgia,2010-07-01,0,0,0,0,0,0
Georgia,2010-07-01,1,0,0,3,0,4
Georgia,2010-07-01,4,0,0,1,3,8
Georgia,2010-07-01,12,0,-2,22,0,32
Georgia,2010-07-01,13,0,0,-1,0,12
Georgia,2010-07-01,25,2,0,24,11,62
Georgia,2010-07-01,9,4,0,7,7,27
Georgia,2010-07-01,2,0,1,24,3,30
Georgia,2010-07-01,7,2,0,0,0,9
Georgia,2010-07-01,2,0,0,0,2,4
Georgia,2010-07-01,6,0,0,3,4,13
Georgia,2010-07-01,0,0,0,0,0,0
Georgia,2010-07-01,11,0,0,9,0,20
Georgia,2010-07-01,5,0,-4,2,1,4
Georgia,2010-07-01,7,0,0,0,0,7
Georgia,2010-07-01,6,0,0,-2,2,6
Georgia,2010-07-01,12,0,0,6,0,18
Georgia,2010-07-01,24,6,0,2,9,41
Georgia,2010-07-01,2,0,0,0,0,2
Georgia,2010-07-01,34,2,-1,6,9,50
Georgia,2010-07-01,8,0,0,-3,2,7
Georgia,2010-07-01,11,2,4,0,1,18
Georgia,2010-07-01,3,0,0,0,0,3
Georgia,2010-07-01,8,0,0,9,4,21
Georgia,2010-07-01,3,0,0,0,0,3
Georgia,2010-07-01,4,0,0,0,0,4
Georgia,2010-07-01,3,0,0,7,1,11
Georgia,2010-07-01,10,0,-1,25,5,39
Georgia,2010-07-01,27,2,0,33,3,65
Georgia,2010-07-01,30,2,0,2,7,41
India,2010-07-01,34,4,-3,9,21,65
India,2010-07-01,9,2,0,6,7,24
India,2010-07-01,26,0,0,3,0,29
India,2010-07-01,15,0,0,8,15,38
India,2010-07-01,41,2,-4,26,4,69
India,2010-07-01,45,2,0,24,3,74
India,2010-07-01,74,0,2,2,7,85
India,2010-07-01,29,0,0,5,5,39
India,2010-07-01,41,0,-2,11,4,54
India,2010-07-01,52,0,-1,35,4,90
India,2010-07-01,7,0,0,0,2,9
India,2010-07-01,47,0,0,17,3,67
India,2010-07-01,8,0,0,1,2,11
India,2010-07-01,13,0,0,17,2,32
India,2010-07-01,7,0,0,-1,5,11
India,2010-07-01,14,2,0,3,5,24
India,2010-07-01,6,0,0,0,0,6
India,2010-07-01,12,0,0,4,3,19
India,2010-07-01,38,0,-3,1,7,43
India,2010-07-01,28,0,-1,10,6,43
India,2010-07-01,18,0,1,7,5,31
India,2010-07-01,12,0,0,3,0,15
India,2010-07-01,32,0,0,7,6,45
India,2010-07-01,16,0,0,2,0,18
India,2010-07-01,26,0,-2,22,5,51
India,2010-07-01,4,0,0,0,0,4
India,2010-07-01,6,0,0,12,0,18
India,2010-07-01,44,0,0,21,1,66
India,2010-07-01,102,0,1,21,5,129
India,2010-07-01,56,0,0,62,13,131
India,2010-07-01,91,4,2,17,15,129
Iran,2010-07-01,49,0,1,31,16,97
Iran,2010-07-01,12,0,0,8,4,24
Iran,2010-07-01,35,0,0,3,0,38
Iran,2010-07-01,41,0,0,26,5,72
Iran,2010-07-01,57,0,1,24,13,95
Iran,2010-07-01,10,0,1,28,0,39
Iran,2010-07-01,58,0,-1,37,24,118
Iran,2010-07-01,37,0,-2,3,29,67
Iran,2010-07-01,59,0,1,72,33,165
Iran,2010-07-01,29,0,1,67,38,135
Iran,2010-07-01,8,0,0,16,12,36
Iran,2010-07-01,34,0,1,36,8,79
Iran,2010-07-01,17,0,2,39,0,58
Iran,2010-07-01,34,0,-3,53,8,92
Iran,2010-07-01,10,0,0,31,2,43
Iran,2010-07-01,33,0,0,-1,10,42
Iran,2010-07-01,20,0,0,13,4,37
Iran,2010-07-01,38,0,0,19,5,62
Iran,2010-07-01,48,0,0,29,25,102
Iran,2010-07-01,41,0,0,23,2,66
Iran,2010-07-01,45,0,0,18,0,63
Iran,2010-07-01,41,0,-2,8,8,55
Iran,2010-07-01,9,0,0,6,0,15
Iran,2010-07-01,5,0,0,0,0,5
Iran,2010-07-01,25,0,0,5,0,30
Iran,2010-07-01,16,0,0,30,9,55
Iran,2010-07-01,26,0,0,18,1,45
Iran,2010-07-01,13,0,0,7,0,20
Iran,2010-07-01,71,2,8,30,8,119
Iran,2010-07-01,107,4,-2,87,15,211
Iran,2010-07-01,63,0,0,11,4,78
Iraq,2010-07-01,66,0,1,6,10,83
Iraq,2010-07-01,60,0,1,13,7,81
Iraq,2010-07-01,50,0,2,5,2,59
Iraq,2010-07-01,41,0,0,3,3,47
Iraq,2010-07-01,104,2,0,11,9,126
Iraq,2010-07-01,92,0,0,2,4,98
Iraq,2010-07-01,119,2,1,4,17,143
Iraq,2010-07-01,54,0,4,6,4,68
Iraq,2010-07-01,145,0,-1,22,0,166
Iraq,2010-07-01,95,0,1,18,6,120
Iraq,2010-07-01,15,0,0,0,0,15
Iraq,2010-07-01,20,0,-1,28,4,51
Iraq,2010-07-01,14,0,0,14,2,30
Iraq,2010-07-01,60,0,0,1,4,65
Iraq,2010-07-01,33,4,0,0,0,37
Iraq,2010-07-01,41,0,0,7,6,54
Iraq,2010-07-01,18,0,0,-2,0,16
Iraq,2010-07-01,23,0,0,0,6,29
Iraq,2010-07-01,53,2,1,18,49,123
Iraq,2010-07-01,85,2,-4,3,32,118
Iraq,2010-07-01,76,0,0,19,7,102
Iraq,2010-07-01,62,0,0,-1,9,70
Iraq,2010-07-01,18,0,0,3,0,21
Iraq,2010-07-01,22,0,0,9,7,38
Iraq,2010-07-01,25,0,0,9,2,36
Iraq,2010-07-01,47,2,0,24,0,73
Iraq,2010-07-01,21,0,0,7,5,33
Iraq,2010-07-01,29,0,-2,21,10,58
Iraq,2010-07-01,101,2,1,63,15,182
Iraq,2010-07-01,188,2,2,89,26,307
Iraq,2010-07-01,91,2,1,62,4,160
Morocco,2010-07-01,0,0,0,0,0,0
Morocco,2010-07-01,2,0,0,0,0,2
Morocco,2010-07-01,15,0,0,0,0,15
Morocco,2010-07-01,0,0,0,0,0,0
Morocco,2010-07-01,7,0,0,0,0,7
Morocco,2010-07-01,8,0,0,0,0,8
Morocco,2010-07-01,0,0,0,0,0,0
Morocco,2010-07-01,9,0,0,3,0,12
Morocco,2010-07-01,0,0,0,3,0,3
Morocco,2010-07-01,3,0,0,0,0,3
Morocco,2010-07-01,3,0,0,1,0,4
Morocco,2010-07-01,3,0,0,6,0,9
Morocco,2010-07-01,4,0,0,3,0,7
Morocco,2010-07-01,2,0,0,0,0,2
Morocco,2010-07-01,0,0,0,0,0,0
Morocco,2010-07-01,3,0,0,3,6,12
Morocco,2010-07-01,0,0,0,0,0,0
Morocco,2010-07-01,0,0,0,6,0,6
Morocco,2010-07-01,0,0,0,0,0,0
Morocco,2010-07-01,7,0,0,2,0,9
Morocco,2010-07-01,0,0,0,0,0,0
Morocco,2010-07-01,8,0,0,6,0,14
Morocco,2010-07-01,8,0,0,6,0,14
Morocco,2010-07-01,0,0,0,6,0,6
Morocco,2010-07-01,0,0,0,0,0,0
Morocco,2010-07-01,6,0,0,0,0,6
Morocco,2010-07-01,8,0,0,5,0,13
Morocco,2010-07-01,10,0,0,-2,0,8
Morocco,2010-07-01,0,0,0,-8,0,-8
Nigeria,2010-07-01,8,0,0,0,0,8
Nigeria,2010-07-01,-3,0,-1,0,0,-4
Nigeria,2010-07-01,8,0,0,9,0,17
Nigeria,2010-07-01,4,0,0,14,2,20
Nigeria,2010-07-01,7,0,0,6,2,15
Nigeria,2010-07-01,1,0,0,3,0,4
Nigeria,2010-07-01,8,0,0,14,0,22
Nigeria,2010-07-01,-3,0,0,7,1,5
Nigeria,2010-07-01,35,0,0,-9,0,26
Nigeria,2010-07-01,7,0,0,1,0,8
Nigeria,2010-07-01,0,0,0,0,0,0
Nigeria,2010-07-01,0,0,0,18,2,20
Nigeria,2010-07-01,0,0,0,0,0,0
Nigeria,2010-07-01,14,0,0,-4,0,10
Nigeria,2010-07-01,0,0,0,0,0,0
Nigeria,2010-07-01,0,0,0,0,3,3
Nigeria,2010-07-01,2,0,0,6,0,8
Nigeria,2010-07-01,13,0,0,8,0,21
Nigeria,2010-07-01,-3,0,0,-2,2,-3
Nigeria,2010-07-01,8,0,-1,6,1,14
Nigeria,2010-07-01,23,0,-1,8,0,30
Nigeria,2010-07-01,4,0,0,6,0,10
Nigeria,2010-07-01,0,0,0,-1,0,-1
Nigeria,2010-07-01,8,0,0,0,0,8
Nigeria,2010-07-01,3,0,0,0,0,3
Nigeria,2010-07-01,0,0,0,12,0,12
Nigeria,2010-07-01,0,0,0,0,0,0
Nigeria,2010-07-01,12,0,0,12,0,24
Nigeria,2010-07-01,24,2,-2,43,6,73
Nigeria,2010-07-01,20,2,1,16,2,41
Nigeria,2010-07-01,10,0,2,12,7,31
Pakistan,2010-07-01,34,0,0,10,1,45
Pakistan,2010-07-01,32,0,0,32,6,70
Pakistan,2010-07-01,22,0,0,0,1,23
Pakistan,2010-07-01,21,0,0,29,4,54
Pakistan,2010-07-01,80,0,0,27,4,111
Pakistan,2010-07-01,26,0,0,31,5,62
Pakistan,2010-07-01,125,2,-5,125,28,275
Pakistan,2010-07-01,56,0,1,51,13,121
Pakistan,2010-07-01,60,4,-5,11,38,108
Pakistan,2010-07-01,184,0,0,-1,21,204
Pakistan,2010-07-01,40,0,0,1,1,42
Pakistan,2010-07-01,20,0,0,21,2,43
Pakistan,2010-07-01,31,0,0,10,0,41
Pakistan,2010-07-01,50,0,1,24,1,76
Pakistan,2010-07-01,19,0,0,7,0,26
Pakistan,2010-07-01,35,0,0,12,3,50
Pakistan,2010-07-01,20,0,0,6,0,26
Pakistan,2010-07-01,33,0,0,24,3,60
Pakistan,2010-07-01,111,0,0,41,14,166
Pakistan,2010-07-01,3,0,0,9,0,12
Pakistan,2010-07-01,66,0,0,10,1,77
Pakistan,2010-07-01,35,0,0,1,0,36
Pakistan,2010-07-01,22,0,0,9,2,33
Pakistan,2010-07-01,16,0,1,0,0,17
Pakistan,2010-07-01,57,0,0,16,2,75
Pakistan,2010-07-01,57,4,-2,23,4,86
Pakistan,2010-07-01,40,0,1,-4,0,37
Pakistan,2010-07-01,102,0,0,6,10,118
Pakistan,2010-07-01,207,0,1,15,22,245
Pakistan,2010-07-01,75,2,-1,58,11,145
Pakistan,2010-07-01,166,0,3,68,24,261
Sierra Leone,2010-07-01,27,0,0,36,1,64
Sierra Leone,2010-07-01,11,0,0,0,1,12
Sierra Leone,2010-07-01,0,0,0,0,1,1
Sierra Leone,2010-07-01,0,0,0,0,0,0
Sierra Leone,2010-07-01,8,0,0,0,0,8
Sierra Leone,2010-07-01,0,0,0,-2,2,0
Sierra Leone,2010-07-01,3,0,0,1,0,4
Sierra Leone,2010-07-01,0,0,0,0,0,0
Sierra Leone,2010-07-01,0,0,2,0,0,2
Sierra Leone,2010-07-01,0,0,0,0,0,0
Sierra Leone,2010-07-01,0,0,0,3,0,3
Sierra Leone,2010-07-01,0,0,0,-2,0,-2
Sierra Leone,2010-07-01,1,0,2,0,0,3
Sierra Leone,2010-07-01,0,0,0,0,1,1
Sierra Leone,2010-07-01,0,0,0,3,0,3
Sierra Leone,2010-07-01,0,0,0,0,0,0
Sierra Leone,2010-07-01,4,0,0,6,0,10
Sierra Leone,2010-07-01,7,0,0,3,0,10
Sierra Leone,2010-07-01,6,0,0,-2,0,4
Sierra Leone,2010-07-01,2,0,0,-2,0,0
Sierra Leone,2010-07-01,1,0,0,0,0,1
Sierra Leone,2010-07-01,0,0,0,0,0,0
Sierra Leone,2010-07-01,0,0,0,0,0,0
Sierra Leone,2010-07-01,0,0,0,0,0,0
Sierra Leone,2010-07-01,0,0,0,-2,0,-2
Sierra Leone,2010-07-01,11,0,-2,-4,0,5
Sierra Leone,2010-07-01,2,0,0,0,0,2
Somalia,2010-07-01,8,0,0,0,6,14
Somalia,2010-07-01,17,0,-3,12,1,27
Somalia,2010-07-01,0,0,0,0,1,1
Somalia,2010-07-01,9,0,0,15,0,24
Somalia,2010-07-01,44,0,0,12,7,63
Somalia,2010-07-01,15,0,0,25,0,40
Somalia,2010-07-01,7,0,0,18,2,27
Somalia,2010-07-01,10,0,0,1,0,11
Somalia,2010-07-01,9,0,0,-2,0,7
Somalia,2010-07-01,11,0,0,3,3,17
Somalia,2010-07-01,1,0,0,0,3,4
Somalia,2010-07-01,13,2,0,7,6,28
Somalia,2010-07-01,18,0,0,6,5,29
Somalia,2010-07-01,-2,0,0,0,0,-2
Somalia,2010-07-01,7,0,0,9,3,19
Somalia,2010-07-01,5,0,0,0,0,5
Somalia,2010-07-01,17,0,0,6,1,24
Somalia,2010-07-01,3,0,0,3,0,6
Somalia,2010-07-01,18,0,0,-2,0,16
Somalia,2010-07-01,33,0,0,-2,2,33
Somalia,2010-07-01,52,0,0,-2,15,65
Somalia,2010-07-01,8,0,0,7,0,15
Somalia,2010-07-01,0,0,0,0,1,1
Somalia,2010-07-01,1,0,0,0,0,1
Somalia,2010-07-01,34,6,-2,6,2,46
Somalia,2010-07-01,34,0,0,21,2,57
Somalia,2010-07-01,11,0,0,15,1,27
Somalia,2010-07-01,17,0,0,23,1,41
Somalia,2010-07-01,43,0,0,-30,11,24
Somalia,2010-07-01,21,0,0,-9,0,12
Somalia,2010-07-01,7,0,0,-5,0,2
Syria,2010-07-01,17,0,0,10,0,27
Syria,2010-07-01,0,0,0,0,2,2
Syria,2010-07-01,-2,0,0,3,0,1
Syria,2010-07-01,5,0,0,31,0,36
Syria,2010-07-01,2,0,3,19,0,24
Syria,2010-07-01,20,0,0,13,0,33
Syria,2010-07-01,27,4,0,33,5,69
Syria,2010-07-01,6,0,0,0,0,6
Syria,2010-07-01,18,0,0,-4,0,14
Syria,2010-07-01,5,0,0,0,0,5
Syria,2010-07-01,3,0,1,3,0,7
Syria,2010-07-01,0,0,0,0,0,0
Syria,2010-07-01,9,0,0,15,0,24
Syria,2010-07-01,0,0,0,9,0,9
Syria,2010-07-01,0,0,0,0,0,0
Syria,2010-07-01,0,0,0,0,0,0
Syria,2010-07-01,0,0,0,0,0,0
Syria,2010-07-01,3,0,0,9,0,12
Syria,2010-07-01,13,0,0,46,3,62
Syria,2010-07-01,0,0,0,18,0,18
Syria,2010-07-01,14,0,1,12,3,30
Syria,2010-07-01,22,0,0,39,0,61
Syria,2010-07-01,-3,0,0,3,0,0
Syria,2010-07-01,0,0,0,0,0,0
Syria,2010-07-01,4,0,0,3,0,7
Syria,2010-07-01,0,2,-1,0,0,1
Syria,2010-07-01,0,0,0,0,0,0
Syria,2010-07-01,0,0,0,0,0,0
Syria,2010-07-01,-7,2,0,-4,4,-5
Syria,2010-07-01,12,2,0,30,0,44
Syria,2010-07-01,19,0,3,68,2,92
Yemen,2010-07-01,3,0,0,0,0,3
Yemen,2010-07-01,5,0,0,3,0,8
Yemen,2010-07-01,0,0,0,0,0,0
Yemen,2010-07-01,19,0,0,-2,0,17
Yemen,2010-07-01,26,0,0,-4,0,22
Yemen,2010-07-01,11,0,0,3,1,15
Yemen,2010-07-01,63,0,0,48,4,115
Yemen,2010-07-01,6,0,0,18,0,24
Yemen,2010-07-01,25,0,0,-10,1,16
Yemen,2010-07-01,3,0,0,0,0,3
Yemen,2010-07-01,1,0,2,21,0,24
Yemen,2010-07-01,8,0,0,16,0,24
Yemen,2010-07-01,2,0,0,-2,0,0
Yemen,2010-07-01,7,0,0,12,0,19
Yemen,2010-07-01,0,0,0,0,0,0
Yemen,2010-07-01,3,0,0,3,2,8
Yemen,2010-07-01,3,0,0,0,0,3
Yemen,2010-07-01,0,0,0,-2,0,-2
Yemen,2010-07-01,2,0,0,0,0,2
Yemen,2010-07-01,9,0,0,3,1,13
Yemen,2010-07-01,11,0,0,3,2,16
Yemen,2010-07-01,20,0,0,-7,2,15
Yemen,2010-07-01,-2,0,0,3,0,1
Yemen,2010-07-01,-2,0,0,0,0,-2
Yemen,2010-07-01,5,0,0,3,0,8
Yemen,2010-07-01,30,0,0,0,0,30
Yemen,2010-07-01,3,0,0,0,2,5
Yemen,2010-07-01,2,0,0,12,0,14
Yemen,2010-07-01,11,0,0,-1,2,12
Yemen,2010-07-01,16,0,0,-1,0,15
Yemen,2010-07-01,14,0,0,7,0,21
Afghanistan,2010-03-01,72,0,0,15,30,117
Afghanistan,2010-03-01,117,0,0,54,3,174
Afghanistan,2010-03-01,51,0,0,35,0,86
Afghanistan,2010-03-01,105,2,0,19,3,129
Afghanistan,2010-03-01,77,4,2,49,14,146
Afghanistan,2010-03-01,51,2,0,23,12,88
Afghanistan,2010-03-01,112,6,2,19,14,153
Afghanistan,2010-03-01,80,0,0,48,16,144
Afghanistan,2010-03-01,52,2,0,30,2,86
Afghanistan,2010-03-01,87,0,-1,23,6,115
Afghanistan,2010-03-01,92,0,0,12,7,111
Afghanistan,2010-03-01,55,0,0,18,11,84
Afghanistan,2010-03-01,29,0,-4,3,28,56
Afghanistan,2010-03-01,37,0,0,24,5,66
Afghanistan,2010-03-01,76,0,-2,9,2,85
Afghanistan,2010-03-01,83,0,-3,14,13,107
Afghanistan,2010-03-01,144,0,-1,20,18,181
Afghanistan,2010-03-01,94,0,0,43,13,150
Afghanistan,2010-03-01,40,0,0,4,4,48
Afghanistan,2010-03-01,35,0,0,12,2,49
Afghanistan,2010-03-01,118,0,1,59,35,213
Afghanistan,2010-03-01,28,0,0,2,8,38
Afghanistan,2010-03-01,98,0,0,27,14,139
Afghanistan,2010-03-01,110,0,-1,23,7,139
Afghanistan,2010-03-01,53,4,0,16,3,76
Afghanistan,2010-03-01,167,0,1,0,19,187
Afghanistan,2010-03-01,60,0,-1,2,1,62
Afghanistan,2010-03-01,50,0,0,23,4,77
Afghanistan,2010-03-01,78,0,0,4,6,88
Afghanistan,2010-03-01,103,2,0,43,15,163
Afghanistan,2010-03-01,193,0,0,48,5,246
Albania,2010-03-01,4,0,0,3,0,7
Albania,2010-03-01,4,0,4,0,1,9
Albania,2010-03-01,0,0,0,0,1,1
Albania,2010-03-01,0,0,0,0,0,0
Albania,2010-03-01,2,0,0,9,0,11
Albania,2010-03-01,9,0,0,0,0,9
Albania,2010-03-01,-1,0,0,0,0,-1
Albania,2010-03-01,-1,0,0,0,0,-1
Albania,2010-03-01,2,0,0,0,0,2
Albania,2010-03-01,2,0,0,0,0,2
Albania,2010-03-01,0,0,0,0,0,0
Albania,2010-03-01,3,0,0,0,0,3
Albania,2010-03-01,3,0,0,0,0,3
Albania,2010-03-01,5,0,0,9,0,14
Albania,2010-03-01,0,0,0,3,1,4
Albania,2010-03-01,0,0,0,19,0,19
Albania,2010-03-01,1,0,0,0,0,1
Albania,2010-03-01,0,0,0,0,0,0
Albania,2010-03-01,2,0,0,0,0,2
Albania,2010-03-01,0,0,0,0,0,0
Albania,2010-03-01,1,0,0,6,0,7
Albania,2010-03-01,0,0,0,0,0,0
Albania,2010-03-01,8,0,0,0,0,8
Albania,2010-03-01,15,0,0,0,1,16
Albania,2010-03-01,2,0,0,0,0,2
Albania,2010-03-01,0,0,0,0,0,0
Albania,2010-03-01,4,0,1,0,3,8
Albania,2010-03-01,0,0,0,-2,0,-2
Albania,2010-03-01,6,0,0,-2,2,6
Albania,2010-03-01,2,0,0,0,0,2
Algeria,2010-03-01,9,0,0,0,0,9
Algeria,2010-03-01,0,0,0,2,0,2
Algeria,2010-03-01,1,0,0,0,0,1
Algeria,2010-03-01,2,0,0,0,0,2
Algeria,2010-03-01,2,0,0,3,0,5
Algeria,2010-03-01,0,0,0,1,0,1
Algeria,2010-03-01,8,0,0,9,0,17
Algeria,2010-03-01,0,0,0,0,0,0
Algeria,2010-03-01,19,0,0,24,0,43
Algeria,2010-03-01,0,0,0,6,0,6
Algeria,2010-03-01,5,0,0,28,4,37
Algeria,2010-03-01,0,0,0,3,0,3
Algeria,2010-03-01,0,0,0,17,0,17
Algeria,2010-03-01,18,0,-2,24,1,41
Algeria,2010-03-01,0,0,0,0,0,0
Algeria,2010-03-01,0,0,0,0,0,0
Algeria,2010-03-01,2,0,0,0,0,2
Algeria,2010-03-01,4,0,0,6,0,10
Algeria,2010-03-01,0,0,0,3,0,3
Algeria,2010-03-01,1,0,0,0,0,1
Algeria,2010-03-01,0,0,0,0,0,0
Algeria,2010-03-01,0,0,0,0,0,0
Algeria,2010-03-01,0,0,0,12,1,13
Algeria,2010-03-01,0,0,0,0,0,0
Algeria,2010-03-01,-1,0,0,0,0,-1
Algeria,2010-03-01,0,0,0,15,0,15
Algeria,2010-03-01,2,0,0,-6,0,-4
Algeria,2010-03-01,5,0,0,0,0,5
Bangladesh,2010-03-01,4,0,0,3,0,7
Bangladesh,2010-03-01,52,0,-1,22,21,94
Bangladesh,2010-03-01,12,0,0,9,7,28
Bangladesh,2010-03-01,6,0,0,6,2,14
Bangladesh,2010-03-01,16,0,0,1,8,25
Bangladesh,2010-03-01,0,0,0,0,0,0
Bangladesh,2010-03-01,0,0,0,0,3,3
Bangladesh,2010-03-01,1,0,0,3,1,5
Bangladesh,2010-03-01,4,0,0,12,2,18
Bangladesh,2010-03-01,12,0,0,0,0,12
Bangladesh,2010-03-01,5,0,0,9,0,14
Bangladesh,2010-03-01,2,0,0,0,1,3
Bangladesh,2010-03-01,-2,0,0,-6,0,-8
Bangladesh,2010-03-01,6,0,0,6,1,13
Bangladesh,2010-03-01,2,0,0,9,7,18
Bangladesh,2010-03-01,-4,0,0,0,0,-4
Bangladesh,2010-03-01,1,0,0,4,1,6
Bangladesh,2010-03-01,8,0,0,0,9,17
Bangladesh,2010-03-01,22,0,1,0,0,23
Bangladesh,2010-03-01,2,0,0,3,0,5
Bangladesh,2010-03-01,1,0,0,0,1,2
Bangladesh,2010-03-01,6,0,0,4,0,10
Bangladesh,2010-03-01,0,0,0,0,2,2
Bangladesh,2010-03-01,7,0,0,0,0,7
Bangladesh,2010-03-01,3,0,0,0,0,3
Bangladesh,2010-03-01,2,0,1,3,0,6
Bangladesh,2010-03-01,2,0,0,0,0,2
Bangladesh,2010-03-01,0,0,0,-1,0,-1
Cameroon,2010-03-01,0,0,0,9,0,9
Cameroon,2010-03-01,0,0,0,9,0,9
Cameroon,2010-03-01,2,0,0,0,0,2
Cameroon,2010-03-01,0,0,0,3,0,3
Cameroon,2010-03-01,0,0,0,0,0,0
Cameroon,2010-03-01,-2,0,0,0,0,-2
Cameroon,2010-03-01,-1,0,0,0,0,-1
Cameroon,2010-03-01,0,0,0,0,0,0
Cameroon,2010-03-01,0,0,0,0,0,0
Cameroon,2010-03-01,0,0,0,0,0,0
Cameroon,2010-03-01,12,0,0,0,0,12
Cameroon,2010-03-01,0,0,0,0,0,0
Cameroon,2010-03-01,0,0,0,0,0,0
Cameroon,2010-03-01,0,0,0,0,0,0
Cameroon,2010-03-01,0,0,0,0,0,0
Cameroon,2010-03-01,0,0,0,-2,0,-2
Cameroon,2010-03-01,1,0,0,0,0,1
Cameroon,2010-03-01,0,0,0,3,0,3
Cameroon,2010-03-01,-5,0,0,0,0,-5
Cameroon,2010-03-01,0,0,0,0,0,0
Cameroon,2010-03-01,0,0,0,0,0,0
Cameroon,2010-03-01,6,0,0,3,0,9
Cameroon,2010-03-01,3,0,0,0,0,3
Cameroon,2010-03-01,0,0,0,-2,0,-2
China,2010-03-01,8,0,-4,13,0,17
China,2010-03-01,33,0,0,13,3,49
China,2010-03-01,18,0,0,2,6,26
China,2010-03-01,64,0,-4,27,0,87
China,2010-03-01,58,0,-6,26,2,80
China,2010-03-01,9,0,0,0,1,10
China,2010-03-01,40,0,0,11,7,58
China,2010-03-01,14,0,1,13,6,34
China,2010-03-01,56,0,1,25,6,88
China,2010-03-01,75,12,-8,25,6,110
China,2010-03-01,61,0,-1,36,1,97
China,2010-03-01,13,0,0,-10,3,6
China,2010-03-01,23,0,-2,13,4,38
China,2010-03-01,6,0,1,9,0,16
China,2010-03-01,38,0,-3,26,5,66
China,2010-03-01,32,0,2,69,3,106
China,2010-03-01,22,0,1,2,1,26
China,2010-03-01,21,4,-4,3,2,26
China,2010-03-01,20,0,-2,9,6,33
China,2010-03-01,-8,2,0,6,0,0
China,2010-03-01,32,0,1,24,2,59
China,2010-03-01,28,0,1,34,7,70
China,2010-03-01,86,4,-1,89,16,194
China,2010-03-01,52,2,-1,32,3,88
China,2010-03-01,37,0,3,26,2,68
China,2010-03-01,88,0,1,62,5,156
China,2010-03-01,25,0,1,-3,3,26
China,2010-03-01,17,0,0,6,4,27
China,2010-03-01,53,0,-1,39,2,93
China,2010-03-01,35,4,0,5,9,53
China,2010-03-01,49,2,-1,2,1,53
Egypt,2010-03-01,7,0,0,3,0,10
Egypt,2010-03-01,27,0,0,11,0,38
Egypt,2010-03-01,11,0,0,3,0,14
Egypt,2010-03-01,8,0,0,0,0,8
Egypt,2010-03-01,4,0,0,0,0,4
Egypt,2010-03-01,0,0,-4,6,0,2
Egypt,2010-03-01,19,0,-3,9,0,25
Egypt,2010-03-01,3,0,0,4,0,7
Egypt,2010-03-01,2,0,0,3,0,5
Egypt,2010-03-01,4,0,0,-4,0,0
Egypt,2010-03-01,11,0,0,9,2,22
Egypt,2010-03-01,1,0,0,15,0,16
Egypt,2010-03-01,5,0,0,24,0,29
Egypt,2010-03-01,2,0,0,9,0,11
Egypt,2010-03-01,8,0,0,12,0,20
Egypt,2010-03-01,14,0,-8,9,2,17
Egypt,2010-03-01,19,0,1,6,7,33
Egypt,2010-03-01,3,0,0,6,2,11
Egypt,2010-03-01,13,0,0,0,0,13
Egypt,2010-03-01,0,0,0,0,0,0
Egypt,2010-03-01,19,0,0,5,2,26
Egypt,2010-03-01,9,0,0,12,0,21
Egypt,2010-03-01,44,0,0,40,2,86
Egypt,2010-03-01,10,0,-6,9,2,15
Egypt,2010-03-01,4,0,-7,3,1,1
Egypt,2010-03-01,14,0,0,12,0,26
Egypt,2010-03-01,-1,0,0,2,0,1
Egypt,2010-03-01,9,0,0,0,0,9
Egypt,2010-03-01,9,0,0,3,0,12
Egypt,2010-03-01,5,0,-2,0,0,3
Egypt,2010-03-01,4,0,0,16,0,20
Eritrea,2010-03-01,0,0,0,6,0,6
Eritrea,2010-03-01,1,0,0,0,3,4
Eritrea,2010-03-01,3,0,0,0,0,3
Eritrea,2010-03-01,0,4,0,0,0,4
Eritrea,2010-03-01,0,0,0,0,0,0
Eritrea,2010-03-01,2,0,0,0,0,2
Eritrea,2010-03-01,1,0,0,6,0,7
Eritrea,2010-03-01,0,0,0,9,0,9
Eritrea,2010-03-01,6,0,0,0,0,6
Eritrea,2010-03-01,0,0,0,0,0,0
Eritrea,2010-03-01,0,0,0,0,0,0
Eritrea,2010-03-01,4,0,0,0,0,4
Eritrea,2010-03-01,10,0,0,0,0,10
Eritrea,2010-03-01,0,0,0,0,0,0
Eritrea,2010-03-01,0,0,0,0,0,0
Eritrea,2010-03-01,3,0,0,0,0,3
Eritrea,2010-03-01,0,0,0,0,0,0
Eritrea,2010-03-01,-1,0,0,0,3,2
Eritrea,2010-03-01,0,0,0,0,0,0
Eritrea,2010-03-01,0,0,0,9,5,14
Eritrea,2010-03-01,2,0,0,0,0,2
Eritrea,2010-03-01,0,0,0,0,0,0
Eritrea,2010-03-01,0,0,0,0,0,0
Eritrea,2010-03-01,0,0,0,0,0,0
Eritrea,2010-03-01,3,0,0,0,0,3
Georgia,2010-03-01,0,0,0,0,0,0
Georgia,2010-03-01,3,0,0,0,1,4
Georgia,2010-03-01,3,0,0,0,0,3
Georgia,2010-03-01,-1,0,0,6,0,5
Georgia,2010-03-01,0,0,0,-2,2,0
Georgia,2010-03-01,1,0,0,-2,1,0
Georgia,2010-03-01,0,0,0,12,0,12
Georgia,2010-03-01,0,0,0,0,0,0
Georgia,2010-03-01,12,0,0,3,0,15
Georgia,2010-03-01,4,0,0,6,0,10
Georgia,2010-03-01,3,2,0,0,1,6
Georgia,2010-03-01,0,0,0,0,0,0
Georgia,2010-03-01,0,0,0,0,0,0
Georgia,2010-03-01,2,0,0,0,1,3
Georgia,2010-03-01,13,0,0,2,3,18
Georgia,2010-03-01,3,0,0,15,2,20
Georgia,2010-03-01,5,0,-2,0,0,3
Georgia,2010-03-01,2,0,0,0,3,5
Georgia,2010-03-01,-1,0,0,0,0,-1
Georgia,2010-03-01,2,0,0,-2,0,0
Georgia,2010-03-01,1,0,0,0,0,1
Georgia,2010-03-01,4,0,1,9,0,14
Georgia,2010-03-01,-2,0,0,0,0,-2
Georgia,2010-03-01,-1,0,0,0,0,-1
Georgia,2010-03-01,14,0,1,15,4,34
Georgia,2010-03-01,3,0,0,0,0,3
Georgia,2010-03-01,0,0,0,3,0,3
Georgia,2010-03-01,0,0,0,0,0,0
Georgia,2010-03-01,7,0,1,6,1,15
Georgia,2010-03-01,0,0,0,0,0,0
India,2010-03-01,-2,0,0,0,0,-2
India,2010-03-01,8,0,0,-2,0,6
India,2010-03-01,9,0,0,0,0,9
India,2010-03-01,24,0,-1,12,0,35
India,2010-03-01,25,0,0,4,0,29
India,2010-03-01,8,0,0,0,0,8
India,2010-03-01,27,0,0,43,3,73
India,2010-03-01,11,0,-2,3,0,12
India,2010-03-01,28,2,0,16,11,57
India,2010-03-01,26,0,-1,10,2,37
India,2010-03-01,11,0,-5,12,7,25
India,2010-03-01,12,0,0,3,0,15
India,2010-03-01,14,0,0,9,5,28
India,2010-03-01,0,0,0,6,0,6
India,2010-03-01,20,0,0,0,1,21
India,2010-03-01,43,2,-3,12,0,54
India,2010-03-01,16,0,0,-2,1,15
India,2010-03-01,9,0,0,0,0,9
India,2010-03-01,7,0,-1,-2,0,4
India,2010-03-01,6,0,0,5,0,11
India,2010-03-01,25,0,0,31,0,56
India,2010-03-01,5,4,1,0,0,10
India,2010-03-01,17,0,1,18,2,38
India,2010-03-01,19,2,0,15,2,38
India,2010-03-01,22,2,0,12,0,36
India,2010-03-01,23,0,0,2,3,28
India,2010-03-01,11,0,0,-4,1,8
India,2010-03-01,1,0,0,3,0,4
India,2010-03-01,22,0,0,5,3,30
India,2010-03-01,18,0,-1,21,2,40
India,2010-03-01,13,0,0,6,0,19
Iran,2010-03-01,31,0,1,27,3,62
Iran,2010-03-01,18,0,0,12,3,33
Iran,2010-03-01,38,0,0,16,4,58
Iran,2010-03-01,17,0,5,10,0,32
Iran,2010-03-01,23,0,0,19,0,42
Iran,2010-03-01,19,0,-7,13,18,43
Iran,2010-03-01,37,0,0,27,14,78
Iran,2010-03-01,15,0,1,27,1,44
Iran,2010-03-01,45,0,0,44,6,95
Iran,2010-03-01,81,0,1,36,8,126
Iran,2010-03-01,34,0,0,10,2,46
Iran,2010-03-01,38,0,0,2,0,40
Iran,2010-03-01,33,0,0,14,5,52
Iran,2010-03-01,6,0,0,0,4,10
Iran,2010-03-01,26,0,0,24,0,50
Iran,2010-03-01,50,14,0,23,0,87
Iran,2010-03-01,21,2,0,6,-1,28
Iran,2010-03-01,7,0,0,-2,1,6
Iran,2010-03-01,27,6,0,7,0,40
Iran,2010-03-01,8,0,0,5,0,13
Iran,2010-03-01,38,0,0,18,7,63
Iran,2010-03-01,17,0,2,19,1,39
Iran,2010-03-01,54,4,2,-4,1,57
Iran,2010-03-01,21,0,1,15,0,37
Iran,2010-03-01,24,0,0,-2,0,22
Iran,2010-03-01,9,0,1,4,0,14
Iran,2010-03-01,14,0,0,3,0,17
Iran,2010-03-01,15,0,0,0,3,18
Iran,2010-03-01,24,0,-1,7,1,31
Iran,2010-03-01,39,0,1,-9,3,34
Iran,2010-03-01,28,0,1,12,1,42
Iraq,2010-03-01,18,0,0,0,13,31
Iraq,2010-03-01,23,0,2,12,5,42
Iraq,2010-03-01,3,0,0,15,1,19
Iraq,2010-03-01,49,0,0,10,10,69
Iraq,2010-03-01,20,0,3,16,18,57
Iraq,2010-03-01,61,0,2,1,8,72
Iraq,2010-03-01,60,0,1,15,30,106
Iraq,2010-03-01,1,0,0,12,7,20
Iraq,2010-03-01,57,0,0,2,2,61
Iraq,2010-03-01,20,0,0,5,2,27
Iraq,2010-03-01,76,2,0,5,1,84
Iraq,2010-03-01,10,2,2,3,4,21
Iraq,2010-03-01,14,0,0,17,4,35
Iraq,2010-03-01,1,0,0,0,5,6
Iraq,2010-03-01,58,0,0,12,1,71
Iraq,2010-03-01,38,0,0,14,4,56
Iraq,2010-03-01,30,0,0,4,0,34
Iraq,2010-03-01,17,0,-1,0,2,18
Iraq,2010-03-01,31,0,0,0,4,35
Iraq,2010-03-01,6,0,0,0,3,9
Iraq,2010-03-01,7,0,5,34,23,69
Iraq,2010-03-01,29,0,0,0,3,32
Iraq,2010-03-01,47,0,0,2,5,54
Iraq,2010-03-01,7,0,0,6,3,16
Iraq,2010-03-01,39,0,-1,-3,3,38
Iraq,2010-03-01,21,2,0,12,4,39
Iraq,2010-03-01,-5,0,-4,-2,0,-11
Iraq,2010-03-01,7,0,0,-7,0,0
Iraq,2010-03-01,6,0,0,3,-1,8
Iraq,2010-03-01,52,0,0,19,0,71
Iraq,2010-03-01,7,0,0,0,1,8
Morocco,2010-03-01,3,0,0,3,0,6
Morocco,2010-03-01,0,0,0,0,0,0
Morocco,2010-03-01,6,0,0,3,0,9
Morocco,2010-03-01,6,0,0,0,0,6
Morocco,2010-03-01,0,0,0,0,0,0
Morocco,2010-03-01,0,0,0,0,0,0
Morocco,2010-03-01,11,0,0,3,0,14
Morocco,2010-03-01,0,0,0,0,0,0
Morocco,2010-03-01,0,0,0,3,1,4
Morocco,2010-03-01,2,0,0,3,0,5
Morocco,2010-03-01,0,0,0,0,0,0
Morocco,2010-03-01,0,0,0,0,0,0
Morocco,2010-03-01,0,0,0,3,0,3
Morocco,2010-03-01,6,0,0,0,0,6
Morocco,2010-03-01,13,0,0,0,0,13
Morocco,2010-03-01,3,0,0,0,0,3
Morocco,2010-03-01,0,0,0,6,0,6
Morocco,2010-03-01,2,0,0,0,0,2
Morocco,2010-03-01,-3,0,0,6,0,3
Morocco,2010-03-01,0,0,0,0,0,0
Morocco,2010-03-01,0,0,0,3,0,3
Morocco,2010-03-01,0,0,0,3,0,3
Morocco,2010-03-01,6,0,0,0,2,8
Morocco,2010-03-01,0,0,0,0,0,0
Morocco,2010-03-01,0,0,0,0,0,0
Morocco,2010-03-01,0,0,0,3,0,3
Morocco,2010-03-01,6,0,0,0,0,6
Morocco,2010-03-01,10,0,0,0,1,11
Nigeria,2010-03-01,18,0,0,0,0,18
Nigeria,2010-03-01,8,0,0,0,0,8
Nigeria,2010-03-01,4,0,0,0,1,5
Nigeria,2010-03-01,3,0,-2,0,1,2
Nigeria,2010-03-01,5,0,0,15,0,20
Nigeria,2010-03-01,2,0,0,3,0,5
Nigeria,2010-03-01,-2,0,0,3,0,1
Nigeria,2010-03-01,36,0,0,12,0,48
Nigeria,2010-03-01,41,0,1,13,1,56
Nigeria,2010-03-01,25,0,0,13,0,38
Nigeria,2010-03-01,33,0,-6,6,1,34
Nigeria,2010-03-01,2,0,1,-2,1,2
Nigeria,2010-03-01,2,0,0,19,1,22
Nigeria,2010-03-01,3,0,0,6,0,9
Nigeria,2010-03-01,18,0,0,0,3,21
Nigeria,2010-03-01,7,0,1,1,0,9
Nigeria,2010-03-01,1,0,0,4,0,5
Nigeria,2010-03-01,2,0,0,-1,2,3
Nigeria,2010-03-01,4,0,0,0,0,4
Nigeria,2010-03-01,0,0,0,-4,1,-3
Nigeria,2010-03-01,18,0,0,7,0,25
Nigeria,2010-03-01,3,0,0,25,0,28
Nigeria,2010-03-01,0,0,0,6,0,6
Nigeria,2010-03-01,10,0,0,9,0,19
Nigeria,2010-03-01,6,0,0,12,0,18
Nigeria,2010-03-01,0,0,0,0,0,0
Nigeria,2010-03-01,1,0,0,0,0,1
Nigeria,2010-03-01,0,0,0,10,0,10
Nigeria,2010-03-01,4,0,0,12,0,16
Nigeria,2010-03-01,4,0,0,0,0,4
Pakistan,2010-03-01,10,0,1,15,6,32
Pakistan,2010-03-01,37,4,-4,30,3,70
Pakistan,2010-03-01,16,0,0,7,0,23
Pakistan,2010-03-01,48,0,0,16,13,77
Pakistan,2010-03-01,51,0,0,6,9,66
Pakistan,2010-03-01,3,0,0,15,1,19
Pakistan,2010-03-01,33,0,0,12,4,49
Pakistan,2010-03-01,14,0,-2,0,0,12
Pakistan,2010-03-01,25,0,0,-2,3,26
Pakistan,2010-03-01,59,0,-5,13,0,67
Pakistan,2010-03-01,15,0,0,27,4,46
Pakistan,2010-03-01,41,0,0,18,7,66
Pakistan,2010-03-01,33,0,0,8,19,60
Pakistan,2010-03-01,25,0,0,9,0,34
Pakistan,2010-03-01,32,0,0,18,3,53
Pakistan,2010-03-01,50,0,1,19,0,70
Pakistan,2010-03-01,24,0,0,37,2,63
Pakistan,2010-03-01,12,0,0,24,0,36
Pakistan,2010-03-01,53,0,0,35,4,92
Pakistan,2010-03-01,16,0,0,30,2,48
Pakistan,2010-03-01,50,8,0,14,7,79
Pakistan,2010-03-01,48,0,-3,35,7,87
Pakistan,2010-03-01,46,4,0,1,0,51
Pakistan,2010-03-01,34,2,0,15,1,52
Pakistan,2010-03-01,21,0,0,48,4,73
Pakistan,2010-03-01,80,0,0,18,17,115
Pakistan,2010-03-01,3,0,0,6,0,9
Pakistan,2010-03-01,12,0,0,9,1,22
Pakistan,2010-03-01,21,0,0,21,2,44
Pakistan,2010-03-01,45,0,1,32,13,91
Pakistan,2010-03-01,54,0,-1,14,2,69
Sierra Leone,2010-03-01,0,0,0,6,0,6
Sierra Leone,2010-03-01,0,0,0,0,0,0
Sierra Leone,2010-03-01,0,0,0,0,0,0
Sierra Leone,2010-03-01,2,0,0,0,0,2
Sierra Leone,2010-03-01,0,0,0,0,0,0
Sierra Leone,2010-03-01,0,0,1,0,0,1
Sierra Leone,2010-03-01,0,0,0,3,0,3
Sierra Leone,2010-03-01,0,0,0,9,0,9
Sierra Leone,2010-03-01,0,0,0,3,0,3
Sierra Leone,2010-03-01,0,0,0,6,0,6
Sierra Leone,2010-03-01,3,0,0,0,0,3
Sierra Leone,2010-03-01,0,0,0,0,0,0
Sierra Leone,2010-03-01,2,0,0,4,0,6
Sierra Leone,2010-03-01,0,0,0,0,0,0
Sierra Leone,2010-03-01,0,0,0,0,0,0
Sierra Leone,2010-03-01,2,0,0,0,1,3
Sierra Leone,2010-03-01,2,0,0,3,0,5
Sierra Leone,2010-03-01,3,0,0,0,0,3
Sierra Leone,2010-03-01,3,0,0,3,0,6
Sierra Leone,2010-03-01,0,0,0,0,0,0
Sierra Leone,2010-03-01,4,0,0,0,0,4
Sierra Leone,2010-03-01,7,0,0,3,0,10
Sierra Leone,2010-03-01,0,0,0,0,0,0
Sierra Leone,2010-03-01,9,0,0,0,0,9
Sierra Leone,2010-03-01,0,0,0,0,0,0
Sierra Leone,2010-03-01,0,0,0,0,1,1
Somalia,2010-03-01,0,0,0,-4,1,-3
Somalia,2010-03-01,7,0,0,15,0,22
Somalia,2010-03-01,0,0,0,20,0,20
Somalia,2010-03-01,20,0,0,10,0,30
Somalia,2010-03-01,19,0,0,-3,5,21
Somalia,2010-03-01,3,0,0,4,0,7
Somalia,2010-03-01,11,0,0,9,0,20
Somalia,2010-03-01,5,2,0,2,0,9
Somalia,2010-03-01,0,0,0,26,0,26
Somalia,2010-03-01,17,0,0,27,6,50
Somalia,2010-03-01,6,0,0,6,0,12
Somalia,2010-03-01,0,0,0,21,0,21
Somalia,2010-03-01,4,0,0,9,0,13
Somalia,2010-03-01,7,0,0,4,2,13
Somalia,2010-03-01,15,0,0,4,0,19
Somalia,2010-03-01,16,0,0,7,2,25
Somalia,2010-03-01,10,0,0,-4,0,6
Somalia,2010-03-01,13,0,0,18,0,31
Somalia,2010-03-01,17,0,0,4,0,21
Somalia,2010-03-01,21,0,0,-6,0,15
Somalia,2010-03-01,10,0,0,19,0,29
Somalia,2010-03-01,9,0,0,4,0,13
Somalia,2010-03-01,25,0,-2,37,1,61
Somalia,2010-03-01,40,0,0,20,2,62
Somalia,2010-03-01,37,0,0,12,0,49
Somalia,2010-03-01,9,0,0,3,0,12
Somalia,2010-03-01,9,0,0,3,0,12
Somalia,2010-03-01,22,0,0,6,0,28
Somalia,2010-03-01,101,0,0,32,0,133
Somalia,2010-03-01,16,0,0,12,0,28
Syria,2010-03-01,9,0,0,0,3,12
Syria,2010-03-01,6,0,-1,-4,3,4
Syria,2010-03-01,8,0,0,-4,0,4
Syria,2010-03-01,5,0,0,0,0,5
Syria,2010-03-01,11,0,0,0,3,14
Syria,2010-03-01,8,0,0,0,3,11
Syria,2010-03-01,7,0,0,9,3,19
Syria,2010-03-01,2,2,0,-1,2,5
Syria,2010-03-01,13,0,0,0,1,14
Syria,2010-03-01,14,0,0,0,2,16
Syria,2010-03-01,9,0,0,0,0,9
Syria,2010-03-01,0,0,0,0,0,0
Syria,2010-03-01,0,0,0,0,0,0
Syria,2010-03-01,2,0,0,0,0,2
Syria,2010-03-01,9,0,0,0,0,9
Syria,2010-03-01,0,0,0,0,0,0
Syria,2010-03-01,12,0,0,0,0,12
Syria,2010-03-01,1,0,0,0,0,1
Syria,2010-03-01,3,0,0,0,0,3
Syria,2010-03-01,0,0,0,0,0,0
Syria,2010-03-01,2,0,0,0,0,2
Syria,2010-03-01,20,0,0,6,0,26
Syria,2010-03-01,0,0,0,3,0,3
Syria,2010-03-01,4,0,0,5,0,9
Syria,2010-03-01,4,0,0,3,2,9
Syria,2010-03-01,14,0,-1,0,0,13
Syria,2010-03-01,12,0,-4,0,0,8
Syria,2010-03-01,-1,0,0,0,0,-1
Syria,2010-03-01,25,0,0,4,4,33
Syria,2010-03-01,6,0,0,0,3,9
Syria,2010-03-01,0,0,0,0,0,0
Yemen,2010-03-01,0,0,0,0,0,0
Yemen,2010-03-01,-3,0,1,0,0,-2
Yemen,2010-03-01,0,0,0,3,0,3
Yemen,2010-03-01,2,0,0,0,0,2
Yemen,2010-03-01,0,0,0,0,0,0
Yemen,2010-03-01,11,0,0,0,6,17
Yemen,2010-03-01,0,0,0,0,0,0
Yemen,2010-03-01,0,0,0,3,0,3
Yemen,2010-03-01,6,0,0,0,0,6
Yemen,2010-03-01,15,0,0,6,4,25
Yemen,2010-03-01,9,0,1,39,0,49
Yemen,2010-03-01,24,0,0,9,0,33
Yemen,2010-03-01,22,0,0,12,1,35
Yemen,2010-03-01,1,0,0,3,0,4
Yemen,2010-03-01,29,0,0,9,0,38
Yemen,2010-03-01,4,0,-1,0,2,5
Yemen,2010-03-01,61,0,0,-8,21,74
Yemen,2010-03-01,29,0,0,24,1,54
Yemen,2010-03-01,7,0,0,0,0,7
Yemen,2010-03-01,0,0,0,3,2,5
Yemen,2010-03-01,5,0,0,14,1,20
Yemen,2010-03-01,18,0,0,11,5,34
Yemen,2010-03-01,18,0,0,11,0,29
Yemen,2010-03-01,30,0,0,48,0,78
Yemen,2010-03-01,0,2,0,6,0,8
Yemen,2010-03-01,1,0,0,0,0,1
Yemen,2010-03-01,8,0,0,0,0,8
Yemen,2010-03-01,1,0,0,0,1,2
Yemen,2010-03-01,11,0,0,20,9,40
Yemen,2010-03-01,11,0,0,0,0,11
Afghanistan,2012-01-01,90,0,0,-9,12,93
Afghanistan,2012-01-01,141,4,-4,41,5,187
Afghanistan,2012-01-01,190,0,0,42,71,303
Afghanistan,2012-01-01,96,0,0,32,9,137
Afghanistan,2012-01-01,240,0,1,136,37,414
Afghanistan,2012-01-01,185,4,1,-3,17,204
Afghanistan,2012-01-01,150,0,0,3,11,164
Afghanistan,2012-01-01,109,4,0,3,7,123
Afghanistan,2012-01-01,226,12,-6,55,11,298
Afghanistan,2012-01-01,250,2,0,74,19,345
Afghanistan,2012-01-01,321,0,1,66,19,407
Afghanistan,2012-01-01,223,0,8,79,38,348
Afghanistan,2012-01-01,280,0,5,61,19,365
Afghanistan,2012-01-01,79,0,0,5,15,99
Afghanistan,2012-01-01,52,0,1,42,8,103
Afghanistan,2012-01-01,135,0,0,37,20,192
Afghanistan,2012-01-01,120,0,1,37,6,164
Afghanistan,2012-01-01,175,0,0,26,21,222
Afghanistan,2012-01-01,196,2,3,-4,38,235
Afghanistan,2012-01-01,265,0,0,74,23,362
Afghanistan,2012-01-01,175,0,0,24,7,206
Afghanistan,2012-01-01,37,0,1,15,2,55
Afghanistan,2012-01-01,82,0,1,9,0,92
Afghanistan,2012-01-01,162,0,-8,11,6,171
Afghanistan,2012-01-01,459,10,2,102,38,611
Afghanistan,2012-01-01,296,0,-2,47,41,382
Afghanistan,2012-01-01,284,0,-1,33,7,323
Afghanistan,2012-01-01,40,4,0,24,14,82
Afghanistan,2012-01-01,140,4,0,67,15,226
Afghanistan,2012-01-01,219,10,2,40,20,291
Afghanistan,2012-01-01,213,0,-1,68,28,308
Albania,2012-01-01,2,0,0,0,0,2
Albania,2012-01-01,25,0,-1,0,0,24
Albania,2012-01-01,13,0,0,0,0,13
Albania,2012-01-01,0,0,0,-2,0,-2
Albania,2012-01-01,5,0,-1,15,2,21
Albania,2012-01-01,15,0,-5,18,5,33
Albania,2012-01-01,2,0,0,0,10,12
Albania,2012-01-01,0,0,0,0,0,0
Albania,2012-01-01,25,0,0,0,2,27
Albania,2012-01-01,2,0,0,6,3,11
Albania,2012-01-01,9,0,0,30,14,53
Albania,2012-01-01,5,0,0,3,3,11
Albania,2012-01-01,6,0,0,0,2,8
Albania,2012-01-01,9,0,-2,0,7,14
Albania,2012-01-01,9,0,-2,0,0,7
Albania,2012-01-01,4,0,1,6,2,13
Albania,2012-01-01,10,0,0,35,3,48
Albania,2012-01-01,0,0,0,6,0,6
Albania,2012-01-01,2,0,0,0,0,2
Albania,2012-01-01,2,0,-2,-4,0,-4
Albania,2012-01-01,4,0,-2,-8,0,-6
Albania,2012-01-01,0,0,0,0,0,0
Albania,2012-01-01,6,0,0,0,0,6
Albania,2012-01-01,13,0,0,9,0,22
Albania,2012-01-01,53,0,0,19,4,76
Albania,2012-01-01,4,0,-1,0,0,3
Albania,2012-01-01,12,0,-2,3,0,13
Albania,2012-01-01,0,0,0,0,0,0
Albania,2012-01-01,0,0,0,3,0,3
Albania,2012-01-01,4,0,0,0,1,5
Albania,2012-01-01,5,0,0,-1,5,9
Algeria,2012-01-01,7,0,0,0,0,7
Algeria,2012-01-01,5,0,0,15,0,20
Algeria,2012-01-01,15,0,0,12,0,27
Algeria,2012-01-01,0,0,2,0,2,4
Algeria,2012-01-01,13,0,0,-2,1,12
Algeria,2012-01-01,7,0,0,18,2,27
Algeria,2012-01-01,21,0,0,4,0,25
Algeria,2012-01-01,15,0,-1,0,0,14
Algeria,2012-01-01,8,0,0,0,0,8
Algeria,2012-01-01,14,0,2,0,2,18
Algeria,2012-01-01,41,0,0,13,30,84
Algeria,2012-01-01,78,0,1,-16,20,83
Algeria,2012-01-01,24,0,0,-11,0,13
Algeria,2012-01-01,35,0,0,-3,0,32
Algeria,2012-01-01,2,0,0,0,0,2
Algeria,2012-01-01,0,0,0,0,0,0
Algeria,2012-01-01,34,0,0,33,0,67
Algeria,2012-01-01,29,0,0,6,0,35
Algeria,2012-01-01,66,0,0,9,2,77
Algeria,2012-01-01,56,0,0,5,3,64
Algeria,2012-01-01,0,0,0,7,1,8
Algeria,2012-01-01,4,0,0,3,0,7
Algeria,2012-01-01,12,0,0,0,0,12
Algeria,2012-01-01,14,0,-2,9,1,22
Algeria,2012-01-01,16,0,-2,6,3,23
Algeria,2012-01-01,4,0,0,-2,2,4
Algeria,2012-01-01,6,0,0,3,0,9
Algeria,2012-01-01,6,0,0,-2,1,5
Algeria,2012-01-01,4,0,0,3,0,7
Algeria,2012-01-01,5,0,0,0,1,6
Algeria,2012-01-01,22,0,0,0,2,24
Bangladesh,2012-01-01,6,0,2,-2,4,10
Bangladesh,2012-01-01,26,2,0,18,5,51
Bangladesh,2012-01-01,29,0,-1,19,3,50
Bangladesh,2012-01-01,19,0,0,15,2,36
Bangladesh,2012-01-01,7,0,0,17,2,26
Bangladesh,2012-01-01,29,0,0,23,0,52
Bangladesh,2012-01-01,20,0,0,9,0,29
Bangladesh,2012-01-01,20,0,0,4,0,24
Bangladesh,2012-01-01,13,0,0,8,4,25
Bangladesh,2012-01-01,15,0,-1,-2,1,13
Bangladesh,2012-01-01,14,0,3,4,3,24
Bangladesh,2012-01-01,6,0,1,4,9,20
Bangladesh,2012-01-01,15,0,0,-2,2,15
Bangladesh,2012-01-01,15,0,0,3,12,30
Bangladesh,2012-01-01,13,0,0,4,0,17
Bangladesh,2012-01-01,11,2,-1,0,7,19
Bangladesh,2012-01-01,22,0,0,5,0,27
Bangladesh,2012-01-01,15,0,-1,27,2,43
Bangladesh,2012-01-01,24,0,0,47,2,73
Bangladesh,2012-01-01,11,0,1,18,0,30
Bangladesh,2012-01-01,16,0,0,0,0,16
Bangladesh,2012-01-01,2,0,0,3,1,6
Bangladesh,2012-01-01,0,0,0,12,0,12
Bangladesh,2012-01-01,20,0,2,9,2,33
Bangladesh,2012-01-01,39,0,2,30,1,72
Bangladesh,2012-01-01,20,0,1,6,0,27
Bangladesh,2012-01-01,12,0,0,0,2,14
Bangladesh,2012-01-01,11,0,0,21,0,32
Bangladesh,2012-01-01,12,0,0,6,0,18
Bangladesh,2012-01-01,9,0,0,21,0,30
Bangladesh,2012-01-01,12,0,0,21,1,34
Cameroon,2012-01-01,7,0,0,0,0,7
Cameroon,2012-01-01,2,0,0,0,0,2
Cameroon,2012-01-01,12,0,0,0,0,12
Cameroon,2012-01-01,0,0,0,0,0,0
Cameroon,2012-01-01,3,0,0,6,1,10
Cameroon,2012-01-01,24,0,0,3,3,30
Cameroon,2012-01-01,2,0,0,3,0,5
Cameroon,2012-01-01,5,0,0,0,0,5
Cameroon,2012-01-01,5,0,0,6,1,12
Cameroon,2012-01-01,3,0,0,0,0,3
Cameroon,2012-01-01,4,0,0,0,0,4
Cameroon,2012-01-01,1,0,0,0,0,1
Cameroon,2012-01-01,0,0,0,0,1,1
Cameroon,2012-01-01,0,0,0,0,0,0
Cameroon,2012-01-01,0,0,0,0,0,0
Cameroon,2012-01-01,0,0,0,-4,0,-4
Cameroon,2012-01-01,1,0,0,3,0,4
Cameroon,2012-01-01,6,0,0,9,0,15
Cameroon,2012-01-01,3,0,0,-2,0,1
Cameroon,2012-01-01,0,0,0,0,0,0
Cameroon,2012-01-01,0,0,0,0,0,0
Cameroon,2012-01-01,-2,0,0,0,0,-2
Cameroon,2012-01-01,0,0,0,4,0,4
Cameroon,2012-01-01,-1,0,0,0,1,0
Cameroon,2012-01-01,3,0,0,2,0,5
Cameroon,2012-01-01,2,0,0,0,0,2
Cameroon,2012-01-01,5,0,0,0,0,5
Cameroon,2012-01-01,18,0,0,0,0,18
Cameroon,2012-01-01,4,0,0,0,0,4
China,2012-01-01,64,0,0,8,6,78
China,2012-01-01,84,0,-4,49,4,133
China,2012-01-01,113,0,1,69,14,197
China,2012-01-01,159,0,-2,51,25,233
China,2012-01-01,149,2,-1,40,24,214
China,2012-01-01,202,4,-2,61,30,295
China,2012-01-01,76,0,2,61,9,148
China,2012-01-01,149,0,-7,42,9,193
China,2012-01-01,115,2,-6,69,17,197
China,2012-01-01,109,2,7,44,15,177
China,2012-01-01,192,0,3,-22,23,196
China,2012-01-01,164,0,6,60,19,249
China,2012-01-01,153,0,-1,99,18,269
China,2012-01-01,63,2,0,30,9,104
China,2012-01-01,99,6,9,42,12,168
China,2012-01-01,86,2,-1,60,17,164
China,2012-01-01,170,0,-8,110,39,311
China,2012-01-01,246,0,-7,57,25,321
China,2012-01-01,131,0,0,76,25,232
China,2012-01-01,139,0,-2,74,12,223
China,2012-01-01,70,0,3,30,10,113
China,2012-01-01,21,0,0,6,1,28
China,2012-01-01,39,0,1,19,1,60
China,2012-01-01,161,0,-12,30,10,189
China,2012-01-01,489,4,-9,135,59,678
China,2012-01-01,162,6,-4,75,17,256
China,2012-01-01,228,2,-1,50,31,310
China,2012-01-01,97,2,1,39,12,151
China,2012-01-01,158,0,0,88,8,254
China,2012-01-01,261,0,4,165,20,450
China,2012-01-01,160,2,-5,111,37,305
Egypt,2012-01-01,98,0,-6,20,27,139
Egypt,2012-01-01,41,0,0,40,28,109
Egypt,2012-01-01,92,0,-1,52,32,175
Egypt,2012-01-01,51,0,1,8,14,74
Egypt,2012-01-01,106,0,-5,80,31,212
Egypt,2012-01-01,55,0,-2,67,16,136
Egypt,2012-01-01,49,0,0,34,5,88
Egypt,2012-01-01,101,0,1,22,8,132
Egypt,2012-01-01,449,10,4,274,64,801
Egypt,2012-01-01,405,4,-4,196,91,692
Egypt,2012-01-01,159,4,-24,87,44,270
Egypt,2012-01-01,69,0,-2,20,18,105
Egypt,2012-01-01,37,0,-5,4,15,51
Egypt,2012-01-01,39,0,-5,10,12,56
Egypt,2012-01-01,50,0,-4,-9,11,48
Egypt,2012-01-01,87,0,-4,11,15,109
Egypt,2012-01-01,94,0,0,17,19,130
Egypt,2012-01-01,46,2,1,53,11,113
Egypt,2012-01-01,57,2,0,17,11,87
Egypt,2012-01-01,21,0,-4,-7,11,21
Egypt,2012-01-01,36,0,-10,16,15,57
Egypt,2012-01-01,4,0,-4,2,1,3
Egypt,2012-01-01,16,0,-8,13,17,38
Egypt,2012-01-01,46,0,-18,16,23,67
Egypt,2012-01-01,163,8,-42,62,76,267
Egypt,2012-01-01,69,0,-2,93,10,170
Egypt,2012-01-01,51,0,2,49,13,115
Egypt,2012-01-01,37,0,-17,28,18,66
Egypt,2012-01-01,51,0,-4,25,14,86
Egypt,2012-01-01,67,0,-7,51,17,128
Egypt,2012-01-01,64,0,-3,60,16,137
Eritrea,2012-01-01,0,0,0,0,0,0
Eritrea,2012-01-01,0,0,0,0,0,0
Eritrea,2012-01-01,3,0,0,6,0,9
Eritrea,2012-01-01,4,0,0,0,0,4
Eritrea,2012-01-01,0,0,0,-2,0,-2
Eritrea,2012-01-01,0,0,0,0,0,0
Eritrea,2012-01-01,0,0,0,0,0,0
Eritrea,2012-01-01,0,0,0,0,0,0
Eritrea,2012-01-01,4,6,0,10,0,20
Eritrea,2012-01-01,0,0,0,-7,1,-6
Eritrea,2012-01-01,9,0,0,0,0,9
Eritrea,2012-01-01,12,0,0,0,0,12
Eritrea,2012-01-01,0,0,0,0,0,0
Eritrea,2012-01-01,12,0,0,30,0,42
Eritrea,2012-01-01,82,0,0,21,0,103
Eritrea,2012-01-01,137,0,0,9,0,146
Eritrea,2012-01-01,45,0,0,4,0,49
Eritrea,2012-01-01,9,0,0,6,5,20
Eritrea,2012-01-01,3,0,0,0,0,3
Eritrea,2012-01-01,3,0,0,0,0,3
Eritrea,2012-01-01,11,0,0,0,0,11
Eritrea,2012-01-01,42,0,0,-3,0,39
Eritrea,2012-01-01,0,0,0,15,0,15
Eritrea,2012-01-01,8,0,0,0,2,10
Eritrea,2012-01-01,11,0,0,-2,0,9
Eritrea,2012-01-01,0,0,0,0,0,0
Eritrea,2012-01-01,0,2,0,3,0,5
Eritrea,2012-01-01,0,0,0,8,1,9
Georgia,2012-01-01,7,0,0,0,1,8
Georgia,2012-01-01,17,2,0,-2,2,19
Georgia,2012-01-01,22,0,0,6,1,29
Georgia,2012-01-01,23,0,0,5,1,29
Georgia,2012-01-01,28,0,0,21,2,51
Georgia,2012-01-01,44,2,0,8,9,63
Georgia,2012-01-01,71,0,0,12,10,93
Georgia,2012-01-01,13,0,-1,-2,4,14
Georgia,2012-01-01,19,4,0,-13,0,10
Georgia,2012-01-01,18,0,3,12,3,36
Georgia,2012-01-01,15,0,0,18,4,37
Georgia,2012-01-01,16,0,0,4,1,21
Georgia,2012-01-01,19,0,0,13,2,34
Georgia,2012-01-01,2,0,0,3,0,5
Georgia,2012-01-01,28,0,0,-2,2,28
Georgia,2012-01-01,25,0,2,-4,1,24
Georgia,2012-01-01,62,4,0,27,12,105
Georgia,2012-01-01,31,0,0,21,0,52
Georgia,2012-01-01,27,6,0,6,1,40
Georgia,2012-01-01,44,4,-2,44,6,96
Georgia,2012-01-01,6,0,0,9,0,15
Georgia,2012-01-01,0,0,0,3,0,3
Georgia,2012-01-01,4,0,0,6,2,12
Georgia,2012-01-01,6,0,0,12,4,22
Georgia,2012-01-01,104,4,-2,46,9,161
Georgia,2012-01-01,52,0,-5,44,3,94
Georgia,2012-01-01,22,0,-1,12,4,37
Georgia,2012-01-01,9,2,0,3,1,15
Georgia,2012-01-01,25,0,0,16,3,44
Georgia,2012-01-01,52,0,0,19,13,84
Georgia,2012-01-01,52,2,1,15,6,76
India,2012-01-01,30,2,-1,26,6,63
India,2012-01-01,46,0,0,18,5,69
India,2012-01-01,37,4,-1,-2,7,45
India,2012-01-01,47,2,1,42,10,102
India,2012-01-01,57,0,1,17,4,79
India,2012-01-01,38,0,2,8,11,59
India,2012-01-01,57,2,0,25,1,85
India,2012-01-01,36,0,0,20,13,69
India,2012-01-01,60,0,-4,0,13,69
India,2012-01-01,65,0,-3,13,11,86
India,2012-01-01,33,0,-2,15,12,58
India,2012-01-01,28,2,7,1,10,48
India,2012-01-01,44,0,3,25,5,77
India,2012-01-01,20,2,0,24,13,59
India,2012-01-01,54,0,1,11,4,70
India,2012-01-01,13,0,0,-3,1,11
India,2012-01-01,71,0,-6,12,10,87
India,2012-01-01,95,0,-6,4,5,98
India,2012-01-01,47,2,1,15,6,71
India,2012-01-01,44,2,1,21,3,71
India,2012-01-01,34,0,-3,12,4,47
India,2012-01-01,25,0,0,6,1,32
India,2012-01-01,5,0,-1,4,1,9
India,2012-01-01,78,4,0,30,18,130
India,2012-01-01,242,10,3,122,35,412
India,2012-01-01,108,0,-1,53,10,170
India,2012-01-01,68,4,0,7,7,86
India,2012-01-01,40,0,0,26,2,68
India,2012-01-01,99,2,0,50,1,152
India,2012-01-01,109,0,1,24,7,141
India,2012-01-01,95,0,-1,35,18,147
Iran,2012-01-01,128,0,0,18,2,148
Iran,2012-01-01,164,4,5,65,18,256
Iran,2012-01-01,164,4,-1,86,5,258
Iran,2012-01-01,120,0,1,110,10,241
Iran,2012-01-01,189,0,0,46,14,249
Iran,2012-01-01,290,0,7,161,74,532
Iran,2012-01-01,156,4,0,87,19,266
Iran,2012-01-01,57,0,0,33,14,104
Iran,2012-01-01,209,0,2,161,15,387
Iran,2012-01-01,242,8,-1,161,12,422
Iran,2012-01-01,177,0,8,35,14,234
Iran,2012-01-01,228,0,-1,70,12,309
Iran,2012-01-01,182,0,-2,105,28,313
Iran,2012-01-01,111,0,1,3,19,134
Iran,2012-01-01,97,6,-15,11,25,124
Iran,2012-01-01,727,22,1,247,118,1115
Iran,2012-01-01,447,4,-6,160,91,696
Iran,2012-01-01,397,2,-1,129,49,576
Iran,2012-01-01,342,12,0,208,42,604
Iran,2012-01-01,120,0,-1,89,21,229
Iran,2012-01-01,52,0,-2,10,14,74
Iran,2012-01-01,22,0,0,-2,2,22
Iran,2012-01-01,54,0,0,16,2,72
Iran,2012-01-01,100,0,1,37,18,156
Iran,2012-01-01,434,8,7,263,37,749
Iran,2012-01-01,194,0,5,60,16,275
Iran,2012-01-01,187,0,3,34,23,247
Iran,2012-01-01,114,0,2,67,15,198
Iran,2012-01-01,124,2,-3,89,9,221
Iran,2012-01-01,174,0,2,59,36,271
Iran,2012-01-01,176,0,-8,39,17,224
Iraq,2012-01-01,66,0,0,11,19,96
Iraq,2012-01-01,182,0,-4,50,17,245
Iraq,2012-01-01,160,0,2,5,7,174
Iraq,2012-01-01,151,0,9,18,7,185
Iraq,2012-01-01,223,0,1,45,16,285
Iraq,2012-01-01,146,0,1,14,15,176
Iraq,2012-01-01,105,0,0,12,13,130
Iraq,2012-01-01,78,4,0,-4,11,89
Iraq,2012-01-01,86,0,-10,46,9,131
Iraq,2012-01-01,79,0,0,38,9,126
Iraq,2012-01-01,132,2,0,5,9,148
Iraq,2012-01-01,110,0,-1,35,11,155
Iraq,2012-01-01,134,0,1,76,19,230
Iraq,2012-01-01,82,2,0,11,39,134
Iraq,2012-01-01,131,0,-2,68,19,216
Iraq,2012-01-01,117,0,2,30,56,205
Iraq,2012-01-01,172,2,-1,100,7,280
Iraq,2012-01-01,115,2,-2,40,14,169
Iraq,2012-01-01,72,0,1,3,12,88
Iraq,2012-01-01,49,0,2,18,12,81
Iraq,2012-01-01,85,0,2,38,5,130
Iraq,2012-01-01,4,0,0,3,0,7
Iraq,2012-01-01,10,0,0,0,1,11
Iraq,2012-01-01,72,0,0,31,9,112
Iraq,2012-01-01,290,2,1,191,44,528
Iraq,2012-01-01,100,0,-1,59,28,186
Iraq,2012-01-01,110,0,1,26,9,146
Iraq,2012-01-01,99,2,0,39,17,157
Iraq,2012-01-01,133,0,0,41,16,190
Iraq,2012-01-01,90,2,1,95,28,216
Iraq,2012-01-01,106,0,-1,49,12,166
Morocco,2012-01-01,9,0,0,0,0,9
Morocco,2012-01-01,11,0,0,0,0,11
Morocco,2012-01-01,10,0,0,1,0,11
Morocco,2012-01-01,7,0,0,3,0,10
Morocco,2012-01-01,4,0,0,1,2,7
Morocco,2012-01-01,5,0,0,-3,2,4
Morocco,2012-01-01,4,0,0,-5,0,-1
Morocco,2012-01-01,0,0,0,1,0,1
Morocco,2012-01-01,2,0,0,0,0,2
Morocco,2012-01-01,-1,0,0,0,0,-1
Morocco,2012-01-01,4,0,0,3,0,7
Morocco,2012-01-01,14,0,0,8,1,23
Morocco,2012-01-01,0,0,0,18,2,20
Morocco,2012-01-01,0,0,0,-2,1,-1
Morocco,2012-01-01,3,0,0,0,1,4
Morocco,2012-01-01,1,0,0,9,0,10
Morocco,2012-01-01,6,0,0,24,0,30
Morocco,2012-01-01,21,0,0,6,2,29
Morocco,2012-01-01,1,0,0,0,7,8
Morocco,2012-01-01,0,0,0,3,0,3
Morocco,2012-01-01,0,0,0,3,12,15
Morocco,2012-01-01,0,2,0,0,0,2
Morocco,2012-01-01,0,0,0,0,0,0
Morocco,2012-01-01,2,0,0,0,0,2
Morocco,2012-01-01,2,0,-2,-1,0,-1
Morocco,2012-01-01,2,0,0,-2,1,1
Morocco,2012-01-01,10,0,-2,4,3,15
Morocco,2012-01-01,9,0,-2,3,0,10
Morocco,2012-01-01,0,0,0,0,0,0
Morocco,2012-01-01,16,0,0,3,4,23
Morocco,2012-01-01,10,0,-4,9,4,19
Nigeria,2012-01-01,24,0,0,25,1,50
Nigeria,2012-01-01,21,0,0,15,6,42
Nigeria,2012-01-01,32,0,0,12,2,46
Nigeria,2012-01-01,21,0,0,12,3,36
Nigeria,2012-01-01,52,0,0,13,8,73
Nigeria,2012-01-01,51,0,0,0,9,60
Nigeria,2012-01-01,44,0,0,9,6,59
Nigeria,2012-01-01,18,0,0,13,5,36
Nigeria,2012-01-01,36,0,0,22,16,74
Nigeria,2012-01-01,56,0,1,16,5,78
Nigeria,2012-01-01,57,0,1,13,11,82
Nigeria,2012-01-01,45,0,1,6,14,66
Nigeria,2012-01-01,32,2,4,6,6,50
Nigeria,2012-01-01,29,0,-9,3,0,23
Nigeria,2012-01-01,44,0,-2,7,13,62
Nigeria,2012-01-01,50,2,-2,11,5,66
Nigeria,2012-01-01,55,0,-2,23,12,88
Nigeria,2012-01-01,33,0,3,12,2,50
Nigeria,2012-01-01,24,0,3,5,9,41
Nigeria,2012-01-01,23,0,-1,27,3,52
Nigeria,2012-01-01,12,0,0,0,7,19
Nigeria,2012-01-01,3,0,0,0,0,3
Nigeria,2012-01-01,7,0,0,0,0,7
Nigeria,2012-01-01,21,0,-2,5,5,29
Nigeria,2012-01-01,76,0,0,42,9,127
Nigeria,2012-01-01,54,2,3,24,6,89
Nigeria,2012-01-01,66,0,-1,6,3,74
Nigeria,2012-01-01,-4,0,0,4,0,0
Nigeria,2012-01-01,14,0,0,6,0,20
Nigeria,2012-01-01,36,0,0,32,7,75
Nigeria,2012-01-01,38,2,0,28,3,71
Pakistan,2012-01-01,71,0,0,19,19,109
Pakistan,2012-01-01,60,2,-2,27,19,106
Pakistan,2012-01-01,170,0,0,20,7,197
Pakistan,2012-01-01,93,0,1,65,4,163
Pakistan,2012-01-01,105,4,-2,106,14,227
Pakistan,2012-01-01,60,0,2,68,6,136
Pakistan,2012-01-01,81,8,-1,25,12,125
Pakistan,2012-01-01,39,0,-12,1,-2,26
Pakistan,2012-01-01,131,4,-6,31,16,176
Pakistan,2012-01-01,140,0,-4,47,15,198
Pakistan,2012-01-01,129,2,4,47,21,203
Pakistan,2012-01-01,153,6,-7,26,6,184
Pakistan,2012-01-01,60,14,3,53,5,135
Pakistan,2012-01-01,49,0,0,3,6,58
Pakistan,2012-01-01,74,0,0,31,8,113
Pakistan,2012-01-01,162,2,-23,38,18,197
Pakistan,2012-01-01,126,0,-17,63,6,178
Pakistan,2012-01-01,100,0,1,78,2,181
Pakistan,2012-01-01,84,2,-8,79,9,166
Pakistan,2012-01-01,63,2,0,41,2,108
Pakistan,2012-01-01,55,0,0,18,2,75
Pakistan,2012-01-01,27,0,0,19,3,49
Pakistan,2012-01-01,54,2,-8,57,2,107
Pakistan,2012-01-01,312,4,-10,168,25,499
Pakistan,2012-01-01,558,6,-18,178,42,766
Pakistan,2012-01-01,107,0,-5,8,21,131
Pakistan,2012-01-01,164,4,-2,60,16,242
Pakistan,2012-01-01,90,0,1,74,11,176
Pakistan,2012-01-01,84,0,2,30,21,137
Pakistan,2012-01-01,74,0,-3,206,5,282
Pakistan,2012-01-01,120,0,-1,27,7,153
Sierra Leone,2012-01-01,3,0,2,-4,0,1
Sierra Leone,2012-01-01,1,0,-2,-4,0,-5
Sierra Leone,2012-01-01,9,0,0,15,6,30
Sierra Leone,2012-01-01,0,0,0,0,0,0
Sierra Leone,2012-01-01,0,0,0,0,0,0
Sierra Leone,2012-01-01,-1,0,0,0,2,1
Sierra Leone,2012-01-01,2,0,-2,9,0,9
Sierra Leone,2012-01-01,0,0,0,0,0,0
Sierra Leone,2012-01-01,0,0,0,0,0,0
Sierra Leone,2012-01-01,1,0,0,1,0,2
Sierra Leone,2012-01-01,2,0,0,3,0,5
Sierra Leone,2012-01-01,2,0,0,0,0,2
Sierra Leone,2012-01-01,-1,0,0,0,0,-1
Sierra Leone,2012-01-01,0,0,0,3,3,6
Sierra Leone,2012-01-01,2,0,0,-2,9,9
Sierra Leone,2012-01-01,0,0,0,6,1,7
Sierra Leone,2012-01-01,12,0,0,3,1,16
Sierra Leone,2012-01-01,0,0,0,0,0,0
Sierra Leone,2012-01-01,0,0,0,0,0,0
Sierra Leone,2012-01-01,3,0,0,-2,0,1
Sierra Leone,2012-01-01,1,0,0,3,1,5
Sierra Leone,2012-01-01,4,0,0,0,1,5
Sierra Leone,2012-01-01,0,0,0,6,0,6
Sierra Leone,2012-01-01,4,0,0,-2,0,2
Sierra Leone,2012-01-01,0,0,0,0,4,4
Sierra Leone,2012-01-01,0,0,0,3,0,3
Sierra Leone,2012-01-01,3,0,0,0,0,3
Somalia,2012-01-01,94,0,0,20,4,118
Somalia,2012-01-01,25,0,0,9,0,34
Somalia,2012-01-01,49,0,-2,8,3,58
Somalia,2012-01-01,66,0,0,13,4,83
Somalia,2012-01-01,66,0,-4,18,13,93
Somalia,2012-01-01,32,0,0,33,3,68
Somalia,2012-01-01,124,0,0,15,2,141
Somalia,2012-01-01,35,0,0,22,4,61
Somalia,2012-01-01,71,0,0,30,2,103
Somalia,2012-01-01,77,0,0,75,21,173
Somalia,2012-01-01,43,0,0,28,12,83
Somalia,2012-01-01,185,0,1,53,33,272
Somalia,2012-01-01,119,0,1,30,13,163
Somalia,2012-01-01,35,0,0,6,1,42
Somalia,2012-01-01,64,0,0,12,2,78
Somalia,2012-01-01,42,0,0,28,0,70
Somalia,2012-01-01,43,0,3,23,7,76
Somalia,2012-01-01,55,0,0,30,0,85
Somalia,2012-01-01,56,0,0,29,7,92
Somalia,2012-01-01,9,0,0,3,3,15
Somalia,2012-01-01,11,0,0,6,0,17
Somalia,2012-01-01,2,6,0,-2,1,7
Somalia,2012-01-01,14,0,0,1,4,19
Somalia,2012-01-01,51,0,0,6,0,57
Somalia,2012-01-01,294,0,-2,164,21,477
Somalia,2012-01-01,154,2,2,86,8,252
Somalia,2012-01-01,80,4,0,23,8,115
Somalia,2012-01-01,80,2,0,5,0,87
Somalia,2012-01-01,70,0,0,35,3,108
Somalia,2012-01-01,112,8,0,88,2,210
Somalia,2012-01-01,81,4,-1,65,4,153
Syria,2012-01-01,42,0,0,-10,14,46
Syria,2012-01-01,141,0,1,26,15,183
Syria,2012-01-01,126,2,-10,6,18,142
Syria,2012-01-01,86,4,-1,20,16,125
Syria,2012-01-01,87,12,-9,-5,11,96
Syria,2012-01-01,91,8,-4,7,31,133
Syria,2012-01-01,22,2,-2,4,7,33
Syria,2012-01-01,101,0,0,4,33,138
Syria,2012-01-01,105,0,-2,-8,24,119
Syria,2012-01-01,118,4,-6,27,16,159
Syria,2012-01-01,263,0,-4,-3,44,300
Syria,2012-01-01,276,4,0,17,17,314
Syria,2012-01-01,237,0,1,15,14,267
Syria,2012-01-01,133,0,-9,25,10,159
Syria,2012-01-01,107,0,-8,4,15,118
Syria,2012-01-01,120,0,-2,16,7,141
Syria,2012-01-01,117,2,-20,3,10,112
Syria,2012-01-01,112,0,-9,61,13,177
Syria,2012-01-01,94,4,-3,51,7,153
Syria,2012-01-01,68,2,0,-9,2,63
Syria,2012-01-01,104,0,-2,27,15,144
Syria,2012-01-01,17,0,-4,9,0,22
Syria,2012-01-01,100,0,-2,-6,2,94
Syria,2012-01-01,147,0,-20,-18,15,124
Syria,2012-01-01,348,0,-44,35,48,387
Syria,2012-01-01,69,0,-32,0,18,55
Syria,2012-01-01,188,0,-23,24,34,223
Syria,2012-01-01,162,0,-21,46,34,221
Syria,2012-01-01,111,0,-5,11,15,132
Syria,2012-01-01,243,0,-13,54,19,303
Syria,2012-01-01,301,4,-24,19,39,339
Yemen,2012-01-01,15,0,0,4,1,20
Yemen,2012-01-01,19,0,0,6,15,40
Yemen,2012-01-01,6,0,0,3,8,17
Yemen,2012-01-01,39,0,-2,-2,8,43
Yemen,2012-01-01,21,0,-8,-3,1,11
Yemen,2012-01-01,14,0,0,12,8,34
Yemen,2012-01-01,8,0,-1,4,0,11
Yemen,2012-01-01,6,0,-4,8,7,17
Yemen,2012-01-01,44,4,-4,20,4,68
Yemen,2012-01-01,51,0,-6,8,6,59
Yemen,2012-01-01,34,0,-4,4,5,39
Yemen,2012-01-01,31,0,-2,18,2,49
Yemen,2012-01-01,57,0,0,9,10,76
Yemen,2012-01-01,27,0,-4,0,5,28
Yemen,2012-01-01,3,0,0,-4,1,0
Yemen,2012-01-01,15,0,0,10,4,29
Yemen,2012-01-01,26,0,-6,7,2,29
Yemen,2012-01-01,15,0,-8,12,7,26
Yemen,2012-01-01,27,0,-2,7,1,33
Yemen,2012-01-01,37,0,-2,1,4,40
Yemen,2012-01-01,23,0,-4,-2,4,21
Yemen,2012-01-01,1,0,-14,-4,2,-15
Yemen,2012-01-01,8,0,-2,6,2,14
Yemen,2012-01-01,12,0,-5,14,8,29
Yemen,2012-01-01,91,0,-20,31,14,116
Yemen,2012-01-01,33,4,-6,0,3,34
Yemen,2012-01-01,25,0,0,-12,2,15
Yemen,2012-01-01,17,2,0,0,2,21
Yemen,2012-01-01,22,0,0,-1,0,21
Yemen,2012-01-01,28,0,-2,7,1,34
Yemen,2012-01-01,53,0,0,-3,2,52
Afghanistan,2009-02-01,150,4,-6,51,5,204
Afghanistan,2009-02-01,150,0,-8,126,34,302
Afghanistan,2009-02-01,218,12,-3,145,14,386
Afghanistan,2009-02-01,282,22,6,99,17,426
Afghanistan,2009-02-01,123,6,-16,34,15,162
Afghanistan,2009-02-01,283,0,-1,38,44,364
Afghanistan,2009-02-01,217,0,1,54,17,289
Afghanistan,2009-02-01,307,2,3,38,17,367
Afghanistan,2009-02-01,381,0,0,55,26,462
Afghanistan,2009-02-01,505,6,0,18,14,543
Afghanistan,2009-02-01,434,0,-4,26,33,489
Afghanistan,2009-02-01,168,4,2,30,17,221
Afghanistan,2009-02-01,170,0,0,34,22,226
Afghanistan,2009-02-01,245,0,0,20,31,296
Afghanistan,2009-02-01,197,0,0,0,9,206
Afghanistan,2009-02-01,291,0,0,32,31,354
Afghanistan,2009-02-01,389,0,-5,28,26,438
Afghanistan,2009-02-01,351,2,0,37,21,411
Afghanistan,2009-02-01,267,0,-6,64,35,360
Afghanistan,2009-02-01,159,6,-3,14,21,197
Afghanistan,2009-02-01,144,0,0,59,29,232
Afghanistan,2009-02-01,53,4,0,6,4,67
Afghanistan,2009-02-01,211,8,0,59,11,289
Afghanistan,2009-02-01,86,0,1,47,6,140
Afghanistan,2009-02-01,190,4,-10,41,11,236
Afghanistan,2009-02-01,158,24,-6,69,20,265
Afghanistan,2009-02-01,198,16,0,76,7,297
Afghanistan,2009-02-01,201,0,3,31,23,258
Albania,2009-02-01,-1,0,0,3,0,2
Albania,2009-02-01,0,0,0,6,0,6
Albania,2009-02-01,11,0,1,3,4,19
Albania,2009-02-01,6,0,0,0,0,6
Albania,2009-02-01,6,0,0,3,1,10
Albania,2009-02-01,3,0,1,-2,0,2
Albania,2009-02-01,4,0,-1,-2,0,1
Albania,2009-02-01,20,0,0,1,0,21
Albania,2009-02-01,30,0,0,-2,0,28
Albania,2009-02-01,33,0,0,0,6,39
Albania,2009-02-01,-2,0,0,-2,4,0
Albania,2009-02-01,9,0,0,3,0,12
Albania,2009-02-01,6,2,0,8,1,17
Albania,2009-02-01,11,0,0,0,0,11
Albania,2009-02-01,-12,0,0,0,0,-12
Albania,2009-02-01,21,0,-6,3,4,22
Albania,2009-02-01,47,0,-1,15,5,66
Albania,2009-02-01,11,0,0,-20,1,-8
Albania,2009-02-01,20,2,0,-9,2,15
Albania,2009-02-01,6,0,-2,0,0,4
Albania,2009-02-01,13,0,0,-1,1,13
Albania,2009-02-01,3,0,0,12,0,15
Albania,2009-02-01,37,0,-10,25,0,52
Albania,2009-02-01,14,0,-8,21,0,27
Albania,2009-02-01,24,0,0,21,2,47
Albania,2009-02-01,48,2,-1,108,13,170
Albania,2009-02-01,11,0,-1,29,0,39
Albania,2009-02-01,0,0,0,0,0,0
Algeria,2009-02-01,0,0,0,0,0,0
Algeria,2009-02-01,1,0,0,0,2,3
Algeria,2009-02-01,-2,0,0,11,2,11
Algeria,2009-02-01,3,0,0,0,5,8
Algeria,2009-02-01,1,0,0,10,4,15
Algeria,2009-02-01,13,0,0,0,1,14
Algeria,2009-02-01,7,0,-2,0,0,5
Algeria,2009-02-01,3,0,0,0,0,3
Algeria,2009-02-01,15,0,0,0,0,15
Algeria,2009-02-01,3,0,0,0,0,3
Algeria,2009-02-01,0,0,0,-2,2,0
Algeria,2009-02-01,13,0,0,6,2,21
Algeria,2009-02-01,4,0,0,3,1,8
Algeria,2009-02-01,14,0,0,3,4,21
Algeria,2009-02-01,2,0,0,0,0,2
Algeria,2009-02-01,1,0,0,9,2,12
Algeria,2009-02-01,5,0,0,6,0,11
Algeria,2009-02-01,3,0,2,28,1,34
Algeria,2009-02-01,11,0,0,10,0,21
Algeria,2009-02-01,-2,0,0,10,0,8
Algeria,2009-02-01,6,0,0,9,0,15
Algeria,2009-02-01,5,0,0,0,0,5
Algeria,2009-02-01,3,0,0,-7,0,-4
Algeria,2009-02-01,4,0,0,6,0,10
Algeria,2009-02-01,9,0,0,0,0,9
Algeria,2009-02-01,0,0,0,9,0,9
Algeria,2009-02-01,20,0,0,22,1,43
Algeria,2009-02-01,22,0,0,-4,0,18
Bangladesh,2009-02-01,7,0,0,6,1,14
Bangladesh,2009-02-01,8,0,0,36,0,44
Bangladesh,2009-02-01,19,0,2,12,3,36
Bangladesh,2009-02-01,44,2,0,26,2,74
Bangladesh,2009-02-01,13,0,0,0,0,13
Bangladesh,2009-02-01,16,0,-1,9,13,37
Bangladesh,2009-02-01,13,0,0,3,4,20
Bangladesh,2009-02-01,10,0,-1,21,3,33
Bangladesh,2009-02-01,36,0,0,21,0,57
Bangladesh,2009-02-01,16,0,-1,-2,0,13
Bangladesh,2009-02-01,21,0,0,10,1,32
Bangladesh,2009-02-01,18,0,0,9,1,28
Bangladesh,2009-02-01,1,0,0,0,0,1
Bangladesh,2009-02-01,12,0,1,14,2,29
Bangladesh,2009-02-01,16,0,1,-3,2,16
Bangladesh,2009-02-01,12,0,0,6,4,22
Bangladesh,2009-02-01,10,2,-2,1,0,11
Bangladesh,2009-02-01,17,4,0,13,0,34
Bangladesh,2009-02-01,13,0,0,-2,4,15
Bangladesh,2009-02-01,7,0,-2,-1,0,4
Bangladesh,2009-02-01,5,0,2,3,2,12
Bangladesh,2009-02-01,-3,0,0,0,0,-3
Bangladesh,2009-02-01,24,2,0,4,7,37
Bangladesh,2009-02-01,14,0,0,6,3,23
Bangladesh,2009-02-01,19,0,-4,6,4,25
Bangladesh,2009-02-01,45,0,0,10,8,63
Bangladesh,2009-02-01,19,0,0,9,1,29
Bangladesh,2009-02-01,8,0,0,12,0,20
Cameroon,2009-02-01,4,0,0,3,-2,5
Cameroon,2009-02-01,0,0,0,3,0,3
Cameroon,2009-02-01,5,0,0,3,4,12
Cameroon,2009-02-01,3,0,-1,3,3,8
Cameroon,2009-02-01,3,0,0,3,3,9
Cameroon,2009-02-01,3,0,0,6,0,9
Cameroon,2009-02-01,4,0,0,0,0,4
Cameroon,2009-02-01,5,2,0,0,0,7
Cameroon,2009-02-01,0,0,0,0,0,0
Cameroon,2009-02-01,0,0,0,0,0,0
Cameroon,2009-02-01,0,0,0,0,0,0
Cameroon,2009-02-01,1,0,0,0,0,1
Cameroon,2009-02-01,0,0,0,0,0,0
Cameroon,2009-02-01,-1,0,0,-2,0,-3
Cameroon,2009-02-01,3,0,1,6,0,10
Cameroon,2009-02-01,0,0,0,0,0,0
Cameroon,2009-02-01,12,0,0,6,0,18
Cameroon,2009-02-01,0,0,0,3,0,3
Cameroon,2009-02-01,2,0,0,3,0,5
Cameroon,2009-02-01,0,0,0,0,0,0
Cameroon,2009-02-01,9,0,0,6,0,15
Cameroon,2009-02-01,-3,0,0,0,0,-3
Cameroon,2009-02-01,3,0,0,3,0,6
Cameroon,2009-02-01,-1,0,0,0,0,-1
Cameroon,2009-02-01,2,0,0,-2,0,0
Cameroon,2009-02-01,2,0,0,3,0,5
China,2009-02-01,60,2,1,5,9,77
China,2009-02-01,102,0,-1,73,24,198
China,2009-02-01,73,2,0,46,16,137
China,2009-02-01,124,2,3,46,7,182
China,2009-02-01,28,0,0,19,4,51
China,2009-02-01,41,2,-2,11,3,55
China,2009-02-01,59,0,1,41,7,108
China,2009-02-01,84,0,0,7,7,98
China,2009-02-01,111,4,0,36,32,183
China,2009-02-01,108,8,4,61,17,198
China,2009-02-01,112,2,6,38,8,166
China,2009-02-01,128,2,6,37,20,193
China,2009-02-01,64,0,-4,9,6,75
China,2009-02-01,61,0,-4,-20,1,38
China,2009-02-01,45,0,0,4,8,57
China,2009-02-01,89,0,0,9,9,107
China,2009-02-01,64,0,-1,32,12,107
China,2009-02-01,135,6,0,20,10,171
China,2009-02-01,47,2,-4,39,12,96
China,2009-02-01,83,0,-1,26,28,136
China,2009-02-01,16,0,0,11,19,46
China,2009-02-01,20,0,0,7,6,33
China,2009-02-01,32,0,1,-2,26,57
China,2009-02-01,42,0,0,-4,5,43
China,2009-02-01,82,0,0,41,15,138
China,2009-02-01,147,4,-3,53,28,229
China,2009-02-01,80,0,0,8,13,101
China,2009-02-01,25,0,0,18,18,61
Egypt,2009-02-01,127,0,2,20,1,150
Egypt,2009-02-01,92,0,3,-5,18,108
Egypt,2009-02-01,87,0,0,6,10,103
Egypt,2009-02-01,15,0,0,10,4,29
Egypt,2009-02-01,51,0,-2,1,22,72
Egypt,2009-02-01,40,0,0,4,1,45
Egypt,2009-02-01,52,0,0,-10,0,42
Egypt,2009-02-01,55,0,0,1,3,59
Egypt,2009-02-01,89,2,1,-1,2,93
Egypt,2009-02-01,31,0,0,7,0,38
Egypt,2009-02-01,4,0,-2,50,2,54
Egypt,2009-02-01,9,0,0,48,4,61
Egypt,2009-02-01,25,0,-4,21,5,47
Egypt,2009-02-01,53,0,1,10,2,66
Egypt,2009-02-01,48,0,0,7,1,56
Egypt,2009-02-01,94,0,-4,9,3,102
Egypt,2009-02-01,31,0,1,13,2,47
Egypt,2009-02-01,85,0,0,16,9,110
Egypt,2009-02-01,88,0,1,-13,0,76
Egypt,2009-02-01,55,2,1,6,3,67
Egypt,2009-02-01,8,0,0,18,10,36
Egypt,2009-02-01,39,0,0,-2,5,42
Egypt,2009-02-01,32,0,0,-2,6,36
Egypt,2009-02-01,18,0,0,-1,0,17
Egypt,2009-02-01,40,0,0,7,2,49
Egypt,2009-02-01,28,4,0,8,2,42
Egypt,2009-02-01,65,4,-2,12,0,79
Egypt,2009-02-01,54,2,3,12,8,79
Eritrea,2009-02-01,-2,0,0,3,0,1
Eritrea,2009-02-01,13,0,0,6,0,19
Eritrea,2009-02-01,2,0,0,0,0,2
Eritrea,2009-02-01,0,0,0,13,0,13
Eritrea,2009-02-01,0,0,0,1,0,1
Eritrea,2009-02-01,0,0,0,0,0,0
Eritrea,2009-02-01,16,0,0,0,1,17
Eritrea,2009-02-01,15,0,0,0,0,15
Eritrea,2009-02-01,0,0,0,1,0,1
Eritrea,2009-02-01,-4,0,0,9,0,5
Eritrea,2009-02-01,5,0,0,0,0,5
Eritrea,2009-02-01,0,0,0,9,0,9
Eritrea,2009-02-01,2,0,0,3,0,5
Eritrea,2009-02-01,0,0,0,0,0,0
Eritrea,2009-02-01,0,0,0,0,0,0
Eritrea,2009-02-01,0,0,0,0,0,0
Eritrea,2009-02-01,6,0,0,0,0,6
Eritrea,2009-02-01,0,0,0,0,0,0
Eritrea,2009-02-01,0,0,0,0,0,0
Eritrea,2009-02-01,21,0,0,0,0,21
Eritrea,2009-02-01,0,0,0,-2,0,-2
Eritrea,2009-02-01,6,0,0,0,0,6
Eritrea,2009-02-01,-2,0,0,0,0,-2
Eritrea,2009-02-01,-5,0,0,33,0,28
Eritrea,2009-02-01,2,0,0,6,0,8
Eritrea,2009-02-01,-2,0,0,6,1,5
Georgia,2009-02-01,7,0,0,-2,0,5
Georgia,2009-02-01,7,0,-1,10,0,16
Georgia,2009-02-01,12,0,0,0,0,12
Georgia,2009-02-01,9,0,0,-2,1,8
Georgia,2009-02-01,11,0,0,16,6,33
Georgia,2009-02-01,1,0,-2,13,1,13
Georgia,2009-02-01,3,0,0,5,3,11
Georgia,2009-02-01,6,0,0,0,0,6
Georgia,2009-02-01,6,0,0,6,0,12
Georgia,2009-02-01,14,2,0,21,0,37
Georgia,2009-02-01,9,0,0,1,2,12
Georgia,2009-02-01,13,0,0,3,1,17
Georgia,2009-02-01,11,0,1,6,1,19
Georgia,2009-02-01,1,2,0,-2,2,3
Georgia,2009-02-01,0,0,0,0,0,0
Georgia,2009-02-01,13,0,0,-2,2,13
Georgia,2009-02-01,11,0,1,9,2,23
Georgia,2009-02-01,2,0,1,1,1,5
Georgia,2009-02-01,9,0,0,12,2,23
Georgia,2009-02-01,9,0,0,1,0,10
Georgia,2009-02-01,5,0,0,-8,0,-3
Georgia,2009-02-01,7,0,0,0,0,7
Georgia,2009-02-01,10,0,0,6,0,16
Georgia,2009-02-01,9,0,0,0,4,13
Georgia,2009-02-01,9,0,0,1,2,12
Georgia,2009-02-01,5,0,0,12,2,19
Georgia,2009-02-01,4,0,0,6,2,12
India,2009-02-01,34,0,-1,13,0,46
India,2009-02-01,54,0,0,26,16,96
India,2009-02-01,49,2,0,26,12,89
India,2009-02-01,46,0,0,23,9,78
India,2009-02-01,33,0,0,13,1,47
India,2009-02-01,39,0,-1,9,2,49
India,2009-02-01,49,10,0,6,12,77
India,2009-02-01,29,6,-1,13,3,50
India,2009-02-01,53,0,1,21,6,81
India,2009-02-01,33,2,-1,7,4,45
India,2009-02-01,42,0,0,20,14,76
India,2009-02-01,32,0,0,4,9,45
India,2009-02-01,10,0,-1,3,3,15
India,2009-02-01,10,0,-2,12,4,24
India,2009-02-01,25,0,-2,15,1,39
India,2009-02-01,18,0,0,12,6,36
India,2009-02-01,48,2,3,15,3,71
India,2009-02-01,70,0,-2,19,3,90
India,2009-02-01,45,0,-3,7,3,52
India,2009-02-01,92,0,-1,7,11,109
India,2009-02-01,22,0,0,19,1,42
India,2009-02-01,20,0,0,1,0,21
India,2009-02-01,35,0,-2,8,2,43
India,2009-02-01,18,0,0,3,4,25
India,2009-02-01,54,2,-2,11,6,71
India,2009-02-01,22,0,-1,19,6,46
India,2009-02-01,43,0,-2,9,8,58
India,2009-02-01,54,0,0,32,20,106
Iran,2009-02-01,45,0,0,14,4,63
Iran,2009-02-01,138,0,0,111,15,264
Iran,2009-02-01,113,0,0,44,28,185
Iran,2009-02-01,90,2,2,12,4,110
Iran,2009-02-01,101,0,0,25,19,145
Iran,2009-02-01,144,2,0,35,1,182
Iran,2009-02-01,108,2,3,48,3,164
Iran,2009-02-01,95,0,-2,80,4,177
Iran,2009-02-01,75,0,1,40,7,123
Iran,2009-02-01,72,0,4,37,10,123
Iran,2009-02-01,59,4,-2,15,9,85
Iran,2009-02-01,44,0,-1,12,5,60
Iran,2009-02-01,73,0,2,8,37,120
Iran,2009-02-01,50,2,2,11,1,66
Iran,2009-02-01,64,0,0,1,6,71
Iran,2009-02-01,45,6,0,3,10,64
Iran,2009-02-01,25,0,0,2,3,30
Iran,2009-02-01,20,0,3,23,20,66
Iran,2009-02-01,156,0,2,35,18,211
Iran,2009-02-01,21,0,0,-6,16,31
Iran,2009-02-01,36,0,0,25,2,63
Iran,2009-02-01,34,0,0,27,3,64
Iran,2009-02-01,18,0,1,4,1,24
Iran,2009-02-01,58,0,-1,25,2,84
Iran,2009-02-01,17,0,0,54,3,74
Iran,2009-02-01,57,0,0,24,5,86
Iran,2009-02-01,44,0,0,28,1,73
Iran,2009-02-01,3,0,0,18,1,22
Iraq,2009-02-01,40,0,-5,26,14,75
Iraq,2009-02-01,78,0,0,11,25,114
Iraq,2009-02-01,118,0,-2,43,25,184
Iraq,2009-02-01,103,0,2,14,21,140
Iraq,2009-02-01,40,0,-10,31,4,65
Iraq,2009-02-01,102,2,-2,26,15,143
Iraq,2009-02-01,169,0,0,30,11,210
Iraq,2009-02-01,76,2,-2,25,19,120
Iraq,2009-02-01,67,0,1,16,24,108
Iraq,2009-02-01,92,0,-1,18,14,123
Iraq,2009-02-01,73,0,0,22,4,99
Iraq,2009-02-01,135,0,0,39,33,207
Iraq,2009-02-01,59,0,-2,-4,18,71
Iraq,2009-02-01,60,0,0,3,1,64
Iraq,2009-02-01,126,0,0,10,5,141
Iraq,2009-02-01,119,0,0,-4,29,144
Iraq,2009-02-01,76,0,-1,1,26,102
Iraq,2009-02-01,169,2,1,43,33,248
Iraq,2009-02-01,52,0,1,40,6,99
Iraq,2009-02-01,121,0,0,36,7,164
Iraq,2009-02-01,104,0,0,23,6,133
Iraq,2009-02-01,13,0,0,-1,1,13
Iraq,2009-02-01,73,0,0,27,5,105
Iraq,2009-02-01,21,0,0,-2,0,19
Iraq,2009-02-01,79,4,-6,28,16,121
Iraq,2009-02-01,123,6,-10,99,12,230
Iraq,2009-02-01,101,6,-1,43,24,173
Iraq,2009-02-01,60,0,-1,47,18,124
Morocco,2009-02-01,2,0,0,-4,0,-2
Morocco,2009-02-01,14,0,0,5,0,19
Morocco,2009-02-01,13,0,-1,0,3,15
Morocco,2009-02-01,6,0,0,15,1,22
Morocco,2009-02-01,5,0,0,6,1,12
Morocco,2009-02-01,4,0,0,29,0,33
Morocco,2009-02-01,2,0,0,4,0,6
Morocco,2009-02-01,3,0,0,0,0,3
Morocco,2009-02-01,2,0,0,0,0,2
Morocco,2009-02-01,5,0,0,3,0,8
Morocco,2009-02-01,2,0,0,2,0,4
Morocco,2009-02-01,17,0,0,18,2,37
Morocco,2009-02-01,6,0,0,6,4,16
Morocco,2009-02-01,6,0,0,-4,7,9
Morocco,2009-02-01,2,0,0,0,1,3
Morocco,2009-02-01,1,0,0,12,0,13
Morocco,2009-02-01,9,0,0,30,0,39
Morocco,2009-02-01,5,0,0,16,0,21
Morocco,2009-02-01,6,0,0,6,0,12
Morocco,2009-02-01,3,0,0,0,0,3
Morocco,2009-02-01,-2,0,0,21,1,20
Morocco,2009-02-01,5,0,0,4,2,11
Morocco,2009-02-01,10,0,-5,40,3,48
Morocco,2009-02-01,7,0,0,27,4,38
Morocco,2009-02-01,5,0,0,18,0,23
Morocco,2009-02-01,0,0,0,25,0,25
Morocco,2009-02-01,15,0,0,24,1,40
Morocco,2009-02-01,0,0,0,0,2,2
Nigeria,2009-02-01,17,0,1,10,1,29
Nigeria,2009-02-01,39,0,1,2,0,42
Nigeria,2009-02-01,44,0,0,3,3,50
Nigeria,2009-02-01,44,0,0,15,4,63
Nigeria,2009-02-01,0,0,-2,12,2,12
Nigeria,2009-02-01,17,0,0,18,1,36
Nigeria,2009-02-01,39,0,-2,30,1,68
Nigeria,2009-02-01,14,0,-1,7,8,28
Nigeria,2009-02-01,19,0,1,12,8,40
Nigeria,2009-02-01,15,0,2,18,6,41
Nigeria,2009-02-01,33,2,-2,15,3,51
Nigeria,2009-02-01,23,0,0,30,3,56
Nigeria,2009-02-01,15,2,1,21,5,44
Nigeria,2009-02-01,18,0,1,4,5,28
Nigeria,2009-02-01,19,0,0,0,3,22
Nigeria,2009-02-01,26,0,0,9,0,35
Nigeria,2009-02-01,27,0,0,1,6,34
Nigeria,2009-02-01,8,0,0,15,2,25
Nigeria,2009-02-01,32,0,-1,6,2,39
Nigeria,2009-02-01,26,0,0,-4,4,26
Nigeria,2009-02-01,36,0,0,15,1,52
Nigeria,2009-02-01,24,0,0,12,0,36
Nigeria,2009-02-01,12,0,0,0,4,16
Nigeria,2009-02-01,7,0,0,9,0,16
Nigeria,2009-02-01,25,0,0,12,1,38
Nigeria,2009-02-01,7,0,0,10,0,17
Nigeria,2009-02-01,20,0,0,3,2,25
Nigeria,2009-02-01,7,0,1,-2,0,6
Pakistan,2009-02-01,107,0,0,24,18,149
Pakistan,2009-02-01,152,0,0,117,45,314
Pakistan,2009-02-01,146,2,1,75,11,235
Pakistan,2009-02-01,156,0,0,82,9,247
Pakistan,2009-02-01,84,0,0,47,13,144
Pakistan,2009-02-01,113,0,-5,43,15,166
Pakistan,2009-02-01,132,0,1,38,9,180
Pakistan,2009-02-01,160,6,0,28,18,212
Pakistan,2009-02-01,252,0,0,104,16,372
Pakistan,2009-02-01,163,2,0,70,6,241
Pakistan,2009-02-01,196,4,-2,84,17,299
Pakistan,2009-02-01,190,0,-3,62,30,279
Pakistan,2009-02-01,95,0,0,39,8,142
Pakistan,2009-02-01,119,0,-2,117,20,254
Pakistan,2009-02-01,102,0,0,43,21,166
Pakistan,2009-02-01,128,0,0,37,3,168
Pakistan,2009-02-01,123,0,1,32,1,157
Pakistan,2009-02-01,144,0,1,40,12,197
Pakistan,2009-02-01,77,6,0,23,6,112
Pakistan,2009-02-01,77,0,0,61,17,155
Pakistan,2009-02-01,95,0,1,22,16,134
Pakistan,2009-02-01,34,0,0,46,11,91
Pakistan,2009-02-01,163,0,0,156,9,328
Pakistan,2009-02-01,64,0,0,59,8,131
Pakistan,2009-02-01,180,2,1,116,7,306
Pakistan,2009-02-01,142,0,-1,67,2,210
Pakistan,2009-02-01,68,2,1,41,13,125
Pakistan,2009-02-01,52,0,0,19,8,79
Sierra Leone,2009-02-01,2,0,0,3,0,5
Sierra Leone,2009-02-01,3,0,0,3,0,6
Sierra Leone,2009-02-01,1,0,0,3,3,7
Sierra Leone,2009-02-01,1,0,0,0,3,4
Sierra Leone,2009-02-01,1,0,0,0,0,1
Sierra Leone,2009-02-01,0,0,0,0,0,0
Sierra Leone,2009-02-01,0,0,0,-2,0,-2
Sierra Leone,2009-02-01,0,0,0,0,0,0
Sierra Leone,2009-02-01,7,0,0,0,0,7
Sierra Leone,2009-02-01,8,0,0,0,0,8
Sierra Leone,2009-02-01,2,0,0,0,0,2
Sierra Leone,2009-02-01,13,0,0,0,0,13
Sierra Leone,2009-02-01,1,0,0,0,0,1
Sierra Leone,2009-02-01,2,0,0,3,0,5
Sierra Leone,2009-02-01,0,0,0,0,0,0
Sierra Leone,2009-02-01,0,0,0,0,0,0
Sierra Leone,2009-02-01,5,0,0,-5,0,0
Sierra Leone,2009-02-01,0,0,0,0,0,0
Sierra Leone,2009-02-01,0,0,0,0,0,0
Sierra Leone,2009-02-01,0,0,0,0,0,0
Sierra Leone,2009-02-01,0,0,0,0,0,0
Sierra Leone,2009-02-01,0,0,0,-1,0,-1
Sierra Leone,2009-02-01,0,0,0,0,0,0
Sierra Leone,2009-02-01,3,0,0,228,3,234
Sierra Leone,2009-02-01,7,0,0,30,0,37
Sierra Leone,2009-02-01,-1,0,0,10,0,9
Sierra Leone,2009-02-01,12,0,0,0,0,12
Somalia,2009-02-01,21,0,0,5,1,27
Somalia,2009-02-01,26,2,0,-18,0,10
Somalia,2009-02-01,50,4,3,-20,0,37
Somalia,2009-02-01,51,2,-1,9,0,61
Somalia,2009-02-01,87,2,0,-27,6,68
Somalia,2009-02-01,47,2,1,-29,0,21
Somalia,2009-02-01,34,2,0,29,0,65
Somalia,2009-02-01,9,0,0,-18,1,-8
Somalia,2009-02-01,46,0,0,33,2,81
Somalia,2009-02-01,22,0,0,3,0,25
Somalia,2009-02-01,25,0,0,-11,0,14
Somalia,2009-02-01,65,0,0,64,0,129
Somalia,2009-02-01,69,0,0,78,3,150
Somalia,2009-02-01,20,0,0,32,0,52
Somalia,2009-02-01,1,0,0,-4,1,-2
Somalia,2009-02-01,24,0,0,7,0,31
Somalia,2009-02-01,3,0,2,-2,0,3
Somalia,2009-02-01,23,0,2,-1,9,33
Somalia,2009-02-01,51,0,0,-30,6,27
Somalia,2009-02-01,31,0,0,22,4,57
Somalia,2009-02-01,4,2,0,-2,4,8
Somalia,2009-02-01,11,0,0,14,0,25
Somalia,2009-02-01,18,0,0,1,5,24
Somalia,2009-02-01,26,0,0,0,0,26
Somalia,2009-02-01,26,0,0,2,0,28
Somalia,2009-02-01,40,0,0,21,2,63
Somalia,2009-02-01,10,0,0,6,2,18
Somalia,2009-02-01,2,0,0,0,0,2
Syria,2009-02-01,8,4,0,0,0,12
Syria,2009-02-01,15,0,0,0,4,19
Syria,2009-02-01,13,0,0,5,2,20
Syria,2009-02-01,6,0,0,0,0,6
Syria,2009-02-01,6,0,0,2,0,8
Syria,2009-02-01,5,0,0,3,3,11
Syria,2009-02-01,6,0,0,9,0,15
Syria,2009-02-01,5,0,0,0,0,5
Syria,2009-02-01,23,0,-4,9,8,36
Syria,2009-02-01,136,0,2,12,1,151
Syria,2009-02-01,16,0,0,15,2,33
Syria,2009-02-01,20,0,0,7,0,27
Syria,2009-02-01,5,0,0,-2,5,8
Syria,2009-02-01,-1,0,0,9,1,9
Syria,2009-02-01,9,0,0,16,0,25
Syria,2009-02-01,14,0,0,-2,3,15
Syria,2009-02-01,24,0,0,3,3,30
Syria,2009-02-01,18,0,0,6,7,31
Syria,2009-02-01,12,0,0,-4,6,14
Syria,2009-02-01,3,0,0,9,0,12
Syria,2009-02-01,20,0,0,0,0,20
Syria,2009-02-01,6,0,0,0,2,8
Syria,2009-02-01,21,0,0,6,3,30
Syria,2009-02-01,5,0,0,3,3,11
Syria,2009-02-01,-1,0,0,18,1,18
Syria,2009-02-01,19,0,0,9,0,28
Syria,2009-02-01,-4,0,0,8,2,6
Syria,2009-02-01,10,0,0,5,1,16
Yemen,2009-02-01,7,0,0,-1,2,8
Yemen,2009-02-01,5,0,0,2,8,15
Yemen,2009-02-01,8,0,0,4,0,12
Yemen,2009-02-01,4,0,0,19,1,24
Yemen,2009-02-01,10,0,0,10,4,24
Yemen,2009-02-01,4,0,0,46,10,60
Yemen,2009-02-01,11,0,0,16,2,29
Yemen,2009-02-01,6,0,0,-3,0,3
Yemen,2009-02-01,0,0,0,3,2,5
Yemen,2009-02-01,4,0,3,0,0,7
Yemen,2009-02-01,4,0,1,3,3,11
Yemen,2009-02-01,29,0,-3,10,7,43
Yemen,2009-02-01,9,0,0,0,0,9
Yemen,2009-02-01,3,0,0,0,1,4
Yemen,2009-02-01,0,0,0,0,1,1
Yemen,2009-02-01,3,0,0,0,10,13
Yemen,2009-02-01,-1,0,0,-2,4,1
Yemen,2009-02-01,0,0,0,16,4,20
Yemen,2009-02-01,26,0,1,-6,5,26
Yemen,2009-02-01,4,0,0,-1,4,7
Yemen,2009-02-01,7,2,2,15,0,26
Yemen,2009-02-01,-3,0,0,9,0,6
Yemen,2009-02-01,13,0,0,1,5,19
Yemen,2009-02-01,11,0,0,7,2,20
Yemen,2009-02-01,23,0,-2,6,1,28
Yemen,2009-02-01,8,0,0,0,1,9
Yemen,2009-02-01,10,0,0,0,0,10
Yemen,2009-02-01,0,4,0,0,1,5
Afghanistan,2009-03-01,193,0,7,51,21,272
Afghanistan,2009-03-01,151,4,-9,34,13,193
Afghanistan,2009-03-01,81,2,3,8,5,99
Afghanistan,2009-03-01,99,4,-1,11,5,118
Afghanistan,2009-03-01,145,0,-3,8,22,172
Afghanistan,2009-03-01,71,4,1,13,13,102
Afghanistan,2009-03-01,36,0,-1,7,7,49
Afghanistan,2009-03-01,169,0,1,35,10,215
Afghanistan,2009-03-01,305,8,2,48,33,396
Afghanistan,2009-03-01,286,10,1,108,26,431
Afghanistan,2009-03-01,150,0,0,36,15,201
Afghanistan,2009-03-01,205,0,0,59,6,270
Afghanistan,2009-03-01,183,0,-4,35,14,228
Afghanistan,2009-03-01,184,0,1,27,14,226
Afghanistan,2009-03-01,193,10,2,26,33,264
Afghanistan,2009-03-01,186,8,0,32,44,270
Afghanistan,2009-03-01,146,2,-1,53,54,254
Afghanistan,2009-03-01,255,4,-1,69,30,357
Afghanistan,2009-03-01,154,4,0,45,30,233
Afghanistan,2009-03-01,303,0,-2,68,36,405
Afghanistan,2009-03-01,194,14,2,33,25,268
Afghanistan,2009-03-01,125,10,1,34,6,176
Afghanistan,2009-03-01,210,8,-1,53,31,301
Afghanistan,2009-03-01,197,2,1,-1,25,224
Afghanistan,2009-03-01,246,0,0,5,15,266
Afghanistan,2009-03-01,313,0,1,15,65,394
Afghanistan,2009-03-01,466,6,-1,6,72,549
Afghanistan,2009-03-01,361,2,0,24,41,428
Afghanistan,2009-03-01,154,2,-2,36,21,211
Afghanistan,2009-03-01,229,4,-1,44,52,328
Afghanistan,2009-03-01,498,10,1,77,31,617
Albania,2009-03-01,6,0,0,0,0,6
Albania,2009-03-01,13,0,0,19,0,32
Albania,2009-03-01,10,0,0,3,10,23
Albania,2009-03-01,35,0,0,60,0,95
Albania,2009-03-01,25,4,0,4,8,41
Albania,2009-03-01,-2,0,0,-2,0,-4
Albania,2009-03-01,2,0,0,0,0,2
Albania,2009-03-01,-1,0,0,0,0,-1
Albania,2009-03-01,1,0,3,3,4,11
Albania,2009-03-01,7,0,0,6,1,14
Albania,2009-03-01,6,0,0,9,0,15
Albania,2009-03-01,2,0,0,6,5,13
Albania,2009-03-01,30,0,0,8,2,40
Albania,2009-03-01,24,0,0,-4,7,27
Albania,2009-03-01,0,0,0,-2,1,-1
Albania,2009-03-01,3,0,0,9,2,14
Albania,2009-03-01,34,0,-4,24,9,63
Albania,2009-03-01,38,0,0,4,5,47
Albania,2009-03-01,36,0,-4,11,1,44
Albania,2009-03-01,23,2,-2,6,1,30
Albania,2009-03-01,11,0,0,11,2,24
Albania,2009-03-01,4,0,-4,-5,10,5
Albania,2009-03-01,10,0,0,3,5,18
Albania,2009-03-01,36,0,-3,15,2,50
Albania,2009-03-01,0,0,0,6,8,14
Albania,2009-03-01,0,0,0,1,1,2
Albania,2009-03-01,23,0,0,4,5,32
Albania,2009-03-01,0,0,0,6,0,6
Albania,2009-03-01,0,0,0,0,0,0
Albania,2009-03-01,2,0,0,0,1,3
Albania,2009-03-01,0,0,0,0,0,0
Algeria,2009-03-01,10,0,0,3,0,13
Algeria,2009-03-01,14,0,0,4,0,18
Algeria,2009-03-01,0,0,0,4,0,4
Algeria,2009-03-01,2,0,0,0,0,2
Algeria,2009-03-01,1,0,0,0,0,1
Algeria,2009-03-01,0,0,0,0,0,0
Algeria,2009-03-01,0,0,0,0,3,3
Algeria,2009-03-01,1,0,-1,3,0,3
Algeria,2009-03-01,11,0,0,3,0,14
Algeria,2009-03-01,5,0,0,3,0,8
Algeria,2009-03-01,2,0,0,0,1,3
Algeria,2009-03-01,-1,0,0,6,1,6
Algeria,2009-03-01,8,0,0,0,0,8
Algeria,2009-03-01,1,0,0,1,0,2
Algeria,2009-03-01,7,0,0,0,0,7
Algeria,2009-03-01,7,0,0,6,0,13
Algeria,2009-03-01,9,0,0,0,0,9
Algeria,2009-03-01,22,0,0,3,2,27
Algeria,2009-03-01,3,0,0,0,0,3
Algeria,2009-03-01,5,0,0,0,2,7
Algeria,2009-03-01,0,0,0,6,5,11
Algeria,2009-03-01,6,0,0,3,0,9
Algeria,2009-03-01,3,0,-2,26,0,27
Algeria,2009-03-01,0,0,-1,15,0,14
Algeria,2009-03-01,2,0,1,0,0,3
Algeria,2009-03-01,4,0,0,0,0,4
Algeria,2009-03-01,2,0,0,0,0,2
Algeria,2009-03-01,0,0,0,-2,0,-2
Algeria,2009-03-01,1,0,0,0,0,1
Algeria,2009-03-01,13,0,0,9,0,22
Algeria,2009-03-01,5,0,0,-1,0,4
Bangladesh,2009-03-01,9,0,-2,15,0,22
Bangladesh,2009-03-01,13,6,0,13,2,34
Bangladesh,2009-03-01,8,0,0,6,0,14
Bangladesh,2009-03-01,9,0,0,3,1,13
Bangladesh,2009-03-01,31,0,0,1,10,42
Bangladesh,2009-03-01,2,0,0,3,2,7
Bangladesh,2009-03-01,2,0,0,3,2,7
Bangladesh,2009-03-01,8,0,0,0,2,10
Bangladesh,2009-03-01,41,0,0,6,7,54
Bangladesh,2009-03-01,8,0,0,28,3,39
Bangladesh,2009-03-01,6,0,0,0,0,6
Bangladesh,2009-03-01,4,0,0,1,8,13
Bangladesh,2009-03-01,25,0,0,7,8,40
Bangladesh,2009-03-01,25,0,0,0,10,35
Bangladesh,2009-03-01,15,0,-2,6,8,27
Bangladesh,2009-03-01,30,0,0,5,0,35
Bangladesh,2009-03-01,12,2,0,24,0,38
Bangladesh,2009-03-01,7,2,0,12,0,21
Bangladesh,2009-03-01,4,0,0,12,1,17
Bangladesh,2009-03-01,10,0,0,7,0,17
Bangladesh,2009-03-01,0,0,-2,0,0,-2
Bangladesh,2009-03-01,10,0,0,3,6,19
Bangladesh,2009-03-01,16,0,0,9,3,28
Bangladesh,2009-03-01,10,0,0,0,0,10
Bangladesh,2009-03-01,23,0,0,-2,1,22
Bangladesh,2009-03-01,35,0,0,19,1,55
Bangladesh,2009-03-01,1,0,-3,7,1,6
Bangladesh,2009-03-01,10,0,0,5,6,21
Bangladesh,2009-03-01,30,0,0,21,6,57
Bangladesh,2009-03-01,14,0,0,2,4,20
Bangladesh,2009-03-01,11,0,0,0,0,11
Cameroon,2009-03-01,6,0,0,0,5,11
Cameroon,2009-03-01,1,0,0,0,0,1
Cameroon,2009-03-01,2,0,0,0,0,2
Cameroon,2009-03-01,0,0,0,0,0,0
Cameroon,2009-03-01,2,0,0,3,0,5
Cameroon,2009-03-01,0,0,0,3,0,3
Cameroon,2009-03-01,0,0,0,0,0,0
Cameroon,2009-03-01,3,0,0,3,0,6
Cameroon,2009-03-01,1,0,0,0,0,1
Cameroon,2009-03-01,0,0,0,3,0,3
Cameroon,2009-03-01,1,0,0,-2,1,0
Cameroon,2009-03-01,0,0,0,0,0,0
Cameroon,2009-03-01,0,0,0,3,2,5
Cameroon,2009-03-01,2,0,0,12,2,16
Cameroon,2009-03-01,5,0,0,0,0,5
Cameroon,2009-03-01,18,0,0,1,1,20
Cameroon,2009-03-01,34,0,0,9,3,46
Cameroon,2009-03-01,12,0,0,3,0,15
Cameroon,2009-03-01,18,0,0,1,2,21
Cameroon,2009-03-01,0,0,0,0,0,0
Cameroon,2009-03-01,9,0,0,0,0,9
Cameroon,2009-03-01,5,0,0,3,0,8
Cameroon,2009-03-01,2,0,0,0,0,2
Cameroon,2009-03-01,2,0,0,0,0,2
Cameroon,2009-03-01,0,0,0,0,0,0
Cameroon,2009-03-01,0,0,0,0,0,0
Cameroon,2009-03-01,0,0,0,0,0,0
Cameroon,2009-03-01,2,0,0,0,0,2
Cameroon,2009-03-01,0,0,0,0,0,0
Cameroon,2009-03-01,2,0,0,0,0,2
China,2009-03-01,109,0,0,59,8,176
China,2009-03-01,34,2,0,40,16,92
China,2009-03-01,12,0,0,19,1,32
China,2009-03-01,160,10,-2,136,15,319
China,2009-03-01,124,4,1,53,19,201
China,2009-03-01,46,0,0,27,14,87
China,2009-03-01,24,2,-2,14,19,57
China,2009-03-01,31,0,-1,20,5,55
China,2009-03-01,158,0,-3,53,20,228
China,2009-03-01,166,0,-7,44,15,218
China,2009-03-01,71,0,-3,17,8,93
China,2009-03-01,100,0,-7,87,19,199
China,2009-03-01,226,2,-6,50,21,293
China,2009-03-01,125,8,-2,4,19,154
China,2009-03-01,130,6,0,42,11,189
China,2009-03-01,108,4,-1,-1,10,120
China,2009-03-01,109,4,-1,29,3,144
China,2009-03-01,128,4,-7,32,12,169
China,2009-03-01,115,0,-3,67,8,187
China,2009-03-01,79,2,-8,42,10,125
China,2009-03-01,56,0,0,84,3,143
China,2009-03-01,44,0,-3,100,12,153
China,2009-03-01,94,0,-1,75,15,183
China,2009-03-01,77,12,3,101,15,208
China,2009-03-01,116,2,-14,48,27,179
China,2009-03-01,92,4,-8,44,7,139
China,2009-03-01,93,2,2,46,12,155
China,2009-03-01,110,0,-5,7,3,115
China,2009-03-01,38,4,-2,17,6,63
China,2009-03-01,99,0,2,66,15,182
China,2009-03-01,88,0,-15,31,18,122
Egypt,2009-03-01,77,0,1,16,1,95
Egypt,2009-03-01,65,6,0,13,3,87
Egypt,2009-03-01,13,0,0,0,0,13
Egypt,2009-03-01,104,2,0,18,5,129
Egypt,2009-03-01,57,0,0,3,7,67
Egypt,2009-03-01,-1,0,0,12,0,11
Egypt,2009-03-01,21,0,-1,4,0,24
Egypt,2009-03-01,27,4,0,3,4,38
Egypt,2009-03-01,59,0,0,25,3,87
Egypt,2009-03-01,34,2,-4,31,11,74
Egypt,2009-03-01,24,0,0,28,4,56
Egypt,2009-03-01,32,0,-8,0,0,24
Egypt,2009-03-01,12,0,0,-6,0,6
Egypt,2009-03-01,27,0,1,13,6,47
Egypt,2009-03-01,36,0,0,12,3,51
Egypt,2009-03-01,32,0,0,37,3,72
Egypt,2009-03-01,31,0,0,12,3,46
Egypt,2009-03-01,54,0,-3,7,0,58
Egypt,2009-03-01,22,0,0,9,6,37
Egypt,2009-03-01,6,0,0,21,7,34
Egypt,2009-03-01,15,0,0,5,1,21
Egypt,2009-03-01,15,0,1,1,1,18
Egypt,2009-03-01,25,0,2,23,6,56
Egypt,2009-03-01,19,0,0,13,0,32
Egypt,2009-03-01,28,0,-2,31,2,59
Egypt,2009-03-01,55,2,-5,15,4,71
Egypt,2009-03-01,62,2,0,9,1,74
Egypt,2009-03-01,42,0,0,10,2,54
Egypt,2009-03-01,25,0,-2,3,2,28
Egypt,2009-03-01,29,0,0,-10,0,19
Egypt,2009-03-01,80,0,0,7,3,90
Eritrea,2009-03-01,1,0,0,-4,0,-3
Eritrea,2009-03-01,27,0,0,0,0,27
Eritrea,2009-03-01,1,0,2,3,0,6
Eritrea,2009-03-01,0,0,0,13,0,13
Eritrea,2009-03-01,0,0,0,0,0,0
Eritrea,2009-03-01,4,0,0,5,0,9
Eritrea,2009-03-01,0,0,0,0,0,0
Eritrea,2009-03-01,8,0,0,6,0,14
Eritrea,2009-03-01,-1,0,0,0,0,-1
Eritrea,2009-03-01,2,0,0,0,0,2
Eritrea,2009-03-01,5,0,0,0,0,5
Eritrea,2009-03-01,-1,0,0,0,0,-1
Eritrea,2009-03-01,6,0,0,12,1,19
Eritrea,2009-03-01,0,0,1,3,0,4
Eritrea,2009-03-01,0,0,0,0,0,0
Eritrea,2009-03-01,0,0,0,0,0,0
Eritrea,2009-03-01,22,0,0,24,1,47
Eritrea,2009-03-01,4,0,0,18,0,22
Eritrea,2009-03-01,8,0,2,78,0,88
Eritrea,2009-03-01,14,0,0,7,2,23
Eritrea,2009-03-01,6,0,0,6,0,12
Eritrea,2009-03-01,3,0,0,0,0,3
Eritrea,2009-03-01,11,0,0,6,0,17
Eritrea,2009-03-01,1,0,0,3,0,4
Eritrea,2009-03-01,0,0,0,0,0,0
Georgia,2009-03-01,2,0,0,1,0,3
Georgia,2009-03-01,4,0,0,-3,0,1
Georgia,2009-03-01,2,0,0,1,0,3
Georgia,2009-03-01,22,0,1,10,1,34
Georgia,2009-03-01,-2,0,-2,15,7,18
Georgia,2009-03-01,27,0,-2,0,0,25
Georgia,2009-03-01,15,0,0,-2,0,13
Georgia,2009-03-01,14,4,0,6,1,25
Georgia,2009-03-01,19,0,0,5,2,26
Georgia,2009-03-01,35,0,-2,13,4,50
Georgia,2009-03-01,13,0,0,0,4,17
Georgia,2009-03-01,23,2,0,-1,2,26
Georgia,2009-03-01,3,0,-2,10,2,13
Georgia,2009-03-01,4,0,0,18,1,23
Georgia,2009-03-01,5,0,0,6,0,11
Georgia,2009-03-01,6,2,0,4,3,15
Georgia,2009-03-01,13,0,2,10,0,25
Georgia,2009-03-01,24,6,3,4,1,38
Georgia,2009-03-01,7,0,0,8,4,19
Georgia,2009-03-01,17,0,0,2,5,24
Georgia,2009-03-01,20,0,0,-2,3,21
Georgia,2009-03-01,16,0,0,4,2,22
Georgia,2009-03-01,18,0,0,16,4,38
Georgia,2009-03-01,18,2,0,4,6,30
Georgia,2009-03-01,4,6,0,6,1,17
Georgia,2009-03-01,8,0,-6,12,1,15
Georgia,2009-03-01,30,0,0,9,2,41
Georgia,2009-03-01,1,0,0,0,0,1
Georgia,2009-03-01,1,0,-2,0,2,1
Georgia,2009-03-01,14,0,0,4,1,19
Georgia,2009-03-01,5,0,0,5,2,12
India,2009-03-01,33,0,-2,21,2,54
India,2009-03-01,36,0,-3,35,8,76
India,2009-03-01,5,0,0,-1,0,4
India,2009-03-01,43,0,0,13,3,59
India,2009-03-01,51,0,0,19,0,70
India,2009-03-01,37,2,0,15,5,59
India,2009-03-01,21,0,0,5,3,29
India,2009-03-01,3,0,0,12,1,16
India,2009-03-01,55,0,0,32,10,97
India,2009-03-01,62,0,-2,-4,42,98
India,2009-03-01,15,2,0,4,7,28
India,2009-03-01,34,0,-2,21,9,62
India,2009-03-01,20,0,-2,5,1,24
India,2009-03-01,65,0,0,20,0,85
India,2009-03-01,38,0,0,20,6,64
India,2009-03-01,38,4,-2,12,1,53
India,2009-03-01,34,0,0,6,17,57
India,2009-03-01,55,0,0,18,2,75
India,2009-03-01,41,0,0,6,7,54
India,2009-03-01,19,0,1,14,3,37
India,2009-03-01,42,0,-2,20,6,66
India,2009-03-01,56,0,0,25,3,84
India,2009-03-01,56,4,0,14,5,79
India,2009-03-01,31,6,0,21,0,58
India,2009-03-01,36,4,-1,24,7,70
India,2009-03-01,77,0,2,1,2,82
India,2009-03-01,40,0,-1,6,6,51
India,2009-03-01,14,0,0,-4,2,12
India,2009-03-01,33,0,-2,1,2,34
India,2009-03-01,61,2,0,-1,4,66
India,2009-03-01,97,2,-1,40,17,155
Iran,2009-03-01,50,0,0,36,7,93
Iran,2009-03-01,87,0,8,57,5,157
Iran,2009-03-01,32,0,1,13,3,49
Iran,2009-03-01,58,0,-4,14,26,94
Iran,2009-03-01,60,6,0,21,5,92
Iran,2009-03-01,54,2,0,17,12,85
Iran,2009-03-01,23,2,0,14,3,42
Iran,2009-03-01,76,0,0,33,8,117
Iran,2009-03-01,100,2,2,70,13,187
Iran,2009-03-01,62,0,2,20,15,99
Iran,2009-03-01,35,0,-4,30,1,62
Iran,2009-03-01,48,4,1,35,9,97
Iran,2009-03-01,26,0,1,36,7,70
Iran,2009-03-01,27,0,0,-5,7,29
Iran,2009-03-01,29,0,2,7,2,40
Iran,2009-03-01,96,0,0,5,7,108
Iran,2009-03-01,72,0,2,18,16,108
Iran,2009-03-01,51,0,-3,46,8,102
Iran,2009-03-01,51,0,-3,16,4,68
Iran,2009-03-01,42,2,1,11,4,60
Iran,2009-03-01,9,2,1,21,5,38
Iran,2009-03-01,31,0,0,18,1,50
Iran,2009-03-01,48,0,0,15,2,65
Iran,2009-03-01,14,0,-2,18,0,30
Iran,2009-03-01,0,0,-2,36,1,35
Iran,2009-03-01,60,0,-4,27,9,92
Iran,2009-03-01,111,0,0,-6,4,109
Iran,2009-03-01,93,0,0,7,0,100
Iran,2009-03-01,46,0,-4,-5,1,38
Iran,2009-03-01,115,4,0,11,6,136
Iran,2009-03-01,50,0,0,100,3,153
Iraq,2009-03-01,108,0,2,31,22,163
Iraq,2009-03-01,44,0,-7,29,6,72
Iraq,2009-03-01,2,0,0,9,0,11
Iraq,2009-03-01,60,0,3,39,9,111
Iraq,2009-03-01,79,0,-4,16,6,97
Iraq,2009-03-01,38,0,0,12,7,57
Iraq,2009-03-01,24,2,0,12,4,42
Iraq,2009-03-01,54,0,-2,18,16,86
Iraq,2009-03-01,162,2,1,13,9,187
Iraq,2009-03-01,76,2,0,25,26,129
Iraq,2009-03-01,45,0,1,36,5,87
Iraq,2009-03-01,98,0,-3,77,42,214
Iraq,2009-03-01,104,0,0,31,11,146
Iraq,2009-03-01,68,0,0,21,2,91
Iraq,2009-03-01,125,0,-2,69,26,218
Iraq,2009-03-01,128,0,-2,80,13,219
Iraq,2009-03-01,150,0,-4,86,18,250
Iraq,2009-03-01,194,0,1,86,29,310
Iraq,2009-03-01,64,4,0,15,10,93
Iraq,2009-03-01,80,0,0,42,19,141
Iraq,2009-03-01,36,0,1,12,24,73
Iraq,2009-03-01,104,4,0,6,21,135
Iraq,2009-03-01,117,2,0,42,5,166
Iraq,2009-03-01,125,0,0,33,13,171
Iraq,2009-03-01,113,6,0,5,16,140
Iraq,2009-03-01,122,4,1,20,10,157
Iraq,2009-03-01,59,0,0,9,18,86
Iraq,2009-03-01,56,0,4,10,1,71
Iraq,2009-03-01,26,0,-2,9,5,38
Iraq,2009-03-01,93,0,2,40,8,143
Iraq,2009-03-01,84,0,2,15,39,140
Morocco,2009-03-01,0,0,0,6,1,7
Morocco,2009-03-01,3,0,0,0,1,4
Morocco,2009-03-01,0,0,0,6,0,6
Morocco,2009-03-01,1,0,1,12,0,14
Morocco,2009-03-01,11,0,0,6,0,17
Morocco,2009-03-01,6,0,0,0,0,6
Morocco,2009-03-01,1,0,0,0,0,1
Morocco,2009-03-01,-1,0,0,20,0,19
Morocco,2009-03-01,7,0,0,46,4,57
Morocco,2009-03-01,4,0,0,10,0,14
Morocco,2009-03-01,0,0,0,4,1,5
Morocco,2009-03-01,4,0,0,9,0,13
Morocco,2009-03-01,2,0,0,34,4,40
Morocco,2009-03-01,4,0,0,11,0,15
Morocco,2009-03-01,0,0,0,12,2,14
Morocco,2009-03-01,11,0,2,24,0,37
Morocco,2009-03-01,17,0,0,24,1,42
Morocco,2009-03-01,17,0,0,30,4,51
Morocco,2009-03-01,2,0,1,3,1,7
Morocco,2009-03-01,4,0,0,0,0,4
Morocco,2009-03-01,0,0,0,21,0,21
Morocco,2009-03-01,1,0,0,12,7,20
Morocco,2009-03-01,3,0,0,24,0,27
Morocco,2009-03-01,0,0,0,9,0,9
Morocco,2009-03-01,1,0,0,0,0,1
Morocco,2009-03-01,13,0,0,66,4,83
Morocco,2009-03-01,0,0,0,15,3,18
Morocco,2009-03-01,0,0,0,3,0,3
Morocco,2009-03-01,0,0,0,0,0,0
Morocco,2009-03-01,5,0,0,12,0,17
Morocco,2009-03-01,0,0,0,0,0,0
Nigeria,2009-03-01,14,0,0,1,1,16
Nigeria,2009-03-01,14,0,-2,12,0,24
Nigeria,2009-03-01,9,0,0,4,0,13
Nigeria,2009-03-01,19,2,-2,33,9,61
Nigeria,2009-03-01,23,0,1,26,1,51
Nigeria,2009-03-01,1,0,0,0,0,1
Nigeria,2009-03-01,4,0,0,2,0,6
Nigeria,2009-03-01,5,0,0,3,0,8
Nigeria,2009-03-01,12,0,-2,7,5,22
Nigeria,2009-03-01,26,0,0,19,6,51
Nigeria,2009-03-01,8,0,1,-2,0,7
Nigeria,2009-03-01,29,0,2,27,7,65
Nigeria,2009-03-01,16,0,3,24,0,43
Nigeria,2009-03-01,13,0,0,3,1,17
Nigeria,2009-03-01,47,0,1,12,3,63
Nigeria,2009-03-01,7,0,-2,5,0,10
Nigeria,2009-03-01,33,8,1,6,8,56
Nigeria,2009-03-01,7,0,0,21,2,30
Nigeria,2009-03-01,34,0,2,3,1,40
Nigeria,2009-03-01,12,0,0,3,0,15
Nigeria,2009-03-01,8,0,0,-2,0,6
Nigeria,2009-03-01,8,0,0,3,0,11
Nigeria,2009-03-01,13,0,-2,40,1,52
Nigeria,2009-03-01,36,0,-5,63,4,98
Nigeria,2009-03-01,55,0,0,27,3,85
Nigeria,2009-03-01,18,0,0,2,2,22
Nigeria,2009-03-01,14,0,-1,8,0,21
Nigeria,2009-03-01,10,0,0,10,1,21
Nigeria,2009-03-01,24,0,0,12,3,39
Nigeria,2009-03-01,27,0,0,23,-1,49
Nigeria,2009-03-01,12,0,0,7,0,19
Pakistan,2009-03-01,60,0,3,69,11,143
Pakistan,2009-03-01,71,2,-1,48,19,139
Pakistan,2009-03-01,8,0,-2,15,0,21
Pakistan,2009-03-01,37,0,0,13,5,55
Pakistan,2009-03-01,21,0,0,14,1,36
Pakistan,2009-03-01,21,0,0,0,0,21
Pakistan,2009-03-01,23,0,0,12,2,37
Pakistan,2009-03-01,40,0,1,50,2,93
Pakistan,2009-03-01,109,0,0,48,3,160
Pakistan,2009-03-01,72,2,2,30,7,113
Pakistan,2009-03-01,31,0,0,40,5,76
Pakistan,2009-03-01,92,4,-1,83,10,188
Pakistan,2009-03-01,103,0,-7,66,9,171
Pakistan,2009-03-01,83,0,-10,39,9,121
Pakistan,2009-03-01,66,0,-4,26,13,101
Pakistan,2009-03-01,97,0,-5,4,32,128
Pakistan,2009-03-01,81,0,-5,25,11,112
Pakistan,2009-03-01,81,8,2,165,10,266
Pakistan,2009-03-01,90,0,-3,22,1,110
Pakistan,2009-03-01,84,6,0,12,4,106
Pakistan,2009-03-01,84,2,-6,49,39,168
Pakistan,2009-03-01,106,0,1,17,3,127
Pakistan,2009-03-01,128,8,-2,61,14,209
Pakistan,2009-03-01,134,0,-1,64,4,201
Pakistan,2009-03-01,98,2,1,73,7,181
Pakistan,2009-03-01,156,0,3,27,6,192
Pakistan,2009-03-01,282,2,1,39,45,369
Pakistan,2009-03-01,225,2,-13,27,31,272
Pakistan,2009-03-01,79,2,-1,38,3,121
Pakistan,2009-03-01,160,0,-1,11,22,192
Pakistan,2009-03-01,145,4,-5,26,6,176
Sierra Leone,2009-03-01,0,0,0,0,0,0
Sierra Leone,2009-03-01,3,0,0,0,0,3
Sierra Leone,2009-03-01,4,0,0,9,0,13
Sierra Leone,2009-03-01,6,0,0,18,0,24
Sierra Leone,2009-03-01,3,0,-1,12,1,15
Sierra Leone,2009-03-01,0,0,0,0,0,0
Sierra Leone,2009-03-01,0,0,0,12,0,12
Sierra Leone,2009-03-01,1,0,0,12,0,13
Sierra Leone,2009-03-01,0,0,0,-6,0,-6
Sierra Leone,2009-03-01,0,0,0,0,4,4
Sierra Leone,2009-03-01,0,0,0,0,0,0
Sierra Leone,2009-03-01,0,0,0,6,0,6
Sierra Leone,2009-03-01,0,0,0,0,0,0
Sierra Leone,2009-03-01,0,0,0,-10,0,-10
Sierra Leone,2009-03-01,5,0,0,-5,2,2
Sierra Leone,2009-03-01,0,0,0,3,0,3
Sierra Leone,2009-03-01,0,0,0,-2,0,-2
Sierra Leone,2009-03-01,2,0,0,18,0,20
Sierra Leone,2009-03-01,5,0,0,0,1,6
Sierra Leone,2009-03-01,7,0,0,0,3,10
Sierra Leone,2009-03-01,3,0,0,0,0,3
Sierra Leone,2009-03-01,-2,0,0,0,0,-2
Sierra Leone,2009-03-01,-5,0,0,2,0,-3
Sierra Leone,2009-03-01,3,0,0,0,1,4
Sierra Leone,2009-03-01,0,0,0,0,0,0
Sierra Leone,2009-03-01,4,0,0,-2,1,3
Sierra Leone,2009-03-01,0,0,0,0,0,0
Sierra Leone,2009-03-01,0,0,0,0,0,0
Sierra Leone,2009-03-01,0,0,0,0,0,0
Sierra Leone,2009-03-01,0,0,0,0,1,1
Somalia,2009-03-01,6,0,0,3,1,10
Somalia,2009-03-01,9,0,0,2,0,11
Somalia,2009-03-01,17,0,0,6,0,23
Somalia,2009-03-01,38,0,0,-10,0,28
Somalia,2009-03-01,25,0,0,-45,0,-20
Somalia,2009-03-01,7,0,0,-6,6,7
Somalia,2009-03-01,2,0,0,18,0,20
Somalia,2009-03-01,12,0,0,0,3,15
Somalia,2009-03-01,36,0,1,9,0,46
Somalia,2009-03-01,59,0,2,40,4,105
Somalia,2009-03-01,16,0,0,7,3,26
Somalia,2009-03-01,100,0,0,30,17,147
Somalia,2009-03-01,68,0,0,25,12,105
Somalia,2009-03-01,14,0,0,12,8,34
Somalia,2009-03-01,51,0,-2,14,3,66
Somalia,2009-03-01,47,0,0,73,8,128
Somalia,2009-03-01,43,0,0,6,6,55
Somalia,2009-03-01,14,0,0,6,6,26
Somalia,2009-03-01,27,2,8,4,0,41
Somalia,2009-03-01,75,0,6,19,0,100
Somalia,2009-03-01,15,2,0,0,0,17
Somalia,2009-03-01,49,0,0,-30,2,21
Somalia,2009-03-01,109,0,0,21,0,130
Somalia,2009-03-01,44,0,0,11,5,60
Somalia,2009-03-01,19,0,0,27,2,48
Somalia,2009-03-01,73,0,0,40,8,121
Somalia,2009-03-01,28,0,0,28,1,57
Somalia,2009-03-01,54,0,0,13,3,70
Somalia,2009-03-01,38,0,0,10,0,48
Somalia,2009-03-01,58,0,0,56,2,116
Somalia,2009-03-01,31,0,0,18,0,49
Syria,2009-03-01,50,0,0,52,5,107
Syria,2009-03-01,4,0,0,31,2,37
Syria,2009-03-01,6,0,0,5,0,11
Syria,2009-03-01,21,0,2,5,0,28
Syria,2009-03-01,51,0,0,6,0,57
Syria,2009-03-01,23,2,0,7,7,39
Syria,2009-03-01,0,0,0,-2,0,-2
Syria,2009-03-01,9,0,0,0,0,9
Syria,2009-03-01,28,0,1,46,5,80
Syria,2009-03-01,41,0,0,30,1,72
Syria,2009-03-01,11,0,0,3,1,15
Syria,2009-03-01,7,4,0,30,1,42
Syria,2009-03-01,23,0,0,0,0,23
Syria,2009-03-01,6,0,0,3,0,9
Syria,2009-03-01,7,0,0,21,0,28
Syria,2009-03-01,32,0,0,20,1,53
Syria,2009-03-01,17,0,0,9,0,26
Syria,2009-03-01,17,0,0,33,2,52
Syria,2009-03-01,20,0,0,6,1,27
Syria,2009-03-01,8,0,0,0,0,8
Syria,2009-03-01,-2,0,0,9,0,7
Syria,2009-03-01,9,0,0,3,0,12
Syria,2009-03-01,9,0,0,4,13,26
Syria,2009-03-01,-3,0,0,6,18,21
Syria,2009-03-01,3,0,-2,22,1,24
Syria,2009-03-01,41,0,0,23,1,65
Syria,2009-03-01,17,0,0,-8,2,11
Syria,2009-03-01,40,0,0,3,0,43
Syria,2009-03-01,3,0,0,6,0,9
Syria,2009-03-01,67,0,0,-2,10,75
Syria,2009-03-01,11,0,0,13,0,24
Yemen,2009-03-01,1,0,-2,18,2,19
Yemen,2009-03-01,8,0,0,20,1,29
Yemen,2009-03-01,0,0,-8,1,6,-1
Yemen,2009-03-01,-12,0,0,6,1,-5
Yemen,2009-03-01,2,0,0,-2,2,2
Yemen,2009-03-01,3,0,0,-1,0,2
Yemen,2009-03-01,6,0,0,6,0,12
Yemen,2009-03-01,-1,0,0,9,0,8
Yemen,2009-03-01,27,0,1,0,5,33
Yemen,2009-03-01,2,0,0,0,0,2
Yemen,2009-03-01,9,0,0,0,0,9
Yemen,2009-03-01,15,0,0,5,1,21
Yemen,2009-03-01,11,0,0,3,0,14
Yemen,2009-03-01,17,0,0,-10,0,7
Yemen,2009-03-01,57,0,0,3,27,87
Yemen,2009-03-01,64,4,-2,15,40,121
Yemen,2009-03-01,15,0,0,4,1,20
Yemen,2009-03-01,18,0,0,3,5,26
Yemen,2009-03-01,36,0,1,-1,1,37
Yemen,2009-03-01,3,0,0,0,6,9
Yemen,2009-03-01,7,0,0,6,0,13
Yemen,2009-03-01,24,0,0,6,0,30
Yemen,2009-03-01,24,0,0,27,0,51
Yemen,2009-03-01,5,0,0,0,0,5
Yemen,2009-03-01,15,0,0,27,1,43
Yemen,2009-03-01,8,0,0,3,0,11
Yemen,2009-03-01,27,0,0,4,3,34
Yemen,2009-03-01,36,0,0,6,0,42
Yemen,2009-03-01,2,0,0,40,0,42
Yemen,2009-03-01,6,0,0,48,0,54
Yemen,2009-03-01,19,0,0,45,0,64
Afghanistan,2010-02-01,318,22,-4,70,44,450
Afghanistan,2010-02-01,415,12,0,79,39,545
Afghanistan,2010-02-01,487,6,-5,153,39,680
Afghanistan,2010-02-01,393,8,2,199,46,648
Afghanistan,2010-02-01,255,12,2,73,33,375
Afghanistan,2010-02-01,228,6,0,18,31,283
Afghanistan,2010-02-01,147,2,-1,33,22,203
Afghanistan,2010-02-01,192,0,0,42,11,245
Afghanistan,2010-02-01,198,10,0,61,51,320
Afghanistan,2010-02-01,395,0,5,49,67,516
Afghanistan,2010-02-01,262,0,0,72,45,379
Afghanistan,2010-02-01,243,0,-2,25,29,295
Afghanistan,2010-02-01,271,2,-1,23,50,345
Afghanistan,2010-02-01,417,2,2,68,22,511
Afghanistan,2010-02-01,475,4,-8,59,44,574
Afghanistan,2010-02-01,600,2,0,251,61,914
Afghanistan,2010-02-01,454,0,0,197,22,673
Afghanistan,2010-02-01,291,2,0,63,68,424
Afghanistan,2010-02-01,341,0,2,108,24,475
Afghanistan,2010-02-01,350,0,-3,54,32,433
Afghanistan,2010-02-01,259,8,-13,44,32,330
Afghanistan,2010-02-01,341,2,-12,96,51,478
Afghanistan,2010-02-01,457,2,-7,211,66,729
Afghanistan,2010-02-01,304,0,-2,120,13,435
Afghanistan,2010-02-01,144,0,5,24,29,202
Afghanistan,2010-02-01,68,0,0,6,8,82
Afghanistan,2010-02-01,159,0,1,35,29,224
Afghanistan,2010-02-01,56,0,0,17,2,75
Albania,2010-02-01,2,0,0,0,3,5
Albania,2010-02-01,-6,0,0,12,0,6
Albania,2010-02-01,12,0,-1,4,0,15
Albania,2010-02-01,7,0,-1,0,0,6
Albania,2010-02-01,16,0,0,0,0,16
Albania,2010-02-01,-5,0,0,0,0,-5
Albania,2010-02-01,3,0,0,0,0,3
Albania,2010-02-01,1,6,2,0,0,9
Albania,2010-02-01,0,6,0,0,0,6
Albania,2010-02-01,6,0,0,0,0,6
Albania,2010-02-01,18,0,0,12,1,31
Albania,2010-02-01,8,0,-2,4,0,10
Albania,2010-02-01,3,0,0,3,0,6
Albania,2010-02-01,12,0,0,9,0,21
Albania,2010-02-01,29,0,-5,13,6,43
Albania,2010-02-01,0,0,-1,3,0,2
Albania,2010-02-01,10,0,0,3,2,15
Albania,2010-02-01,0,0,0,6,0,6
Albania,2010-02-01,4,0,0,12,0,16
Albania,2010-02-01,3,0,0,9,0,12
Albania,2010-02-01,0,0,0,0,0,0
Albania,2010-02-01,4,0,0,-2,1,3
Albania,2010-02-01,5,0,0,-2,0,3
Albania,2010-02-01,5,0,-1,1,2,7
Albania,2010-02-01,2,0,0,0,0,2
Albania,2010-02-01,0,0,0,3,0,3
Albania,2010-02-01,0,0,0,0,0,0
Albania,2010-02-01,0,0,0,0,0,0
Algeria,2010-02-01,18,0,0,9,0,27
Algeria,2010-02-01,14,0,0,3,7,24
Algeria,2010-02-01,20,0,0,14,2,36
Algeria,2010-02-01,11,0,0,3,0,14
Algeria,2010-02-01,1,0,0,0,0,1
Algeria,2010-02-01,3,0,0,0,0,3
Algeria,2010-02-01,12,0,0,-2,0,10
Algeria,2010-02-01,5,0,0,4,0,9
Algeria,2010-02-01,10,0,0,6,0,16
Algeria,2010-02-01,3,0,0,0,0,3
Algeria,2010-02-01,2,0,0,3,0,5
Algeria,2010-02-01,1,0,0,6,0,7
Algeria,2010-02-01,4,0,0,0,1,5
Algeria,2010-02-01,5,0,0,6,2,13
Algeria,2010-02-01,3,0,0,0,2,5
Algeria,2010-02-01,6,0,0,5,3,14
Algeria,2010-02-01,8,0,0,0,1,9
Algeria,2010-02-01,9,0,0,0,2,11
Algeria,2010-02-01,13,0,0,9,0,22
Algeria,2010-02-01,23,0,0,0,1,24
Algeria,2010-02-01,3,0,0,-8,0,-5
Algeria,2010-02-01,-2,0,0,2,0,0
Algeria,2010-02-01,9,0,0,-44,2,-33
Algeria,2010-02-01,-7,0,0,-14,4,-17
Algeria,2010-02-01,23,0,0,-2,1,22
Algeria,2010-02-01,7,0,0,-2,0,5
Algeria,2010-02-01,14,0,0,0,0,14
Algeria,2010-02-01,7,0,0,0,0,7
Bangladesh,2010-02-01,3,0,0,-2,0,1
Bangladesh,2010-02-01,27,2,0,15,3,47
Bangladesh,2010-02-01,20,0,0,10,3,33
Bangladesh,2010-02-01,9,0,-4,-2,4,7
Bangladesh,2010-02-01,16,0,1,6,0,23
Bangladesh,2010-02-01,15,0,0,12,10,37
Bangladesh,2010-02-01,20,0,0,9,4,33
Bangladesh,2010-02-01,9,0,0,22,6,37
Bangladesh,2010-02-01,24,0,0,3,0,27
Bangladesh,2010-02-01,17,0,0,5,1,23
Bangladesh,2010-02-01,26,0,0,21,-2,45
Bangladesh,2010-02-01,3,0,0,-2,0,1
Bangladesh,2010-02-01,5,0,0,0,1,6
Bangladesh,2010-02-01,4,0,0,6,2,12
Bangladesh,2010-02-01,16,0,0,7,2,25
Bangladesh,2010-02-01,10,0,-2,8,2,18
Bangladesh,2010-02-01,27,0,0,6,1,34
Bangladesh,2010-02-01,50,0,0,24,4,78
Bangladesh,2010-02-01,7,0,0,10,2,19
Bangladesh,2010-02-01,2,0,0,12,3,17
Bangladesh,2010-02-01,30,0,0,7,1,38
Bangladesh,2010-02-01,18,0,1,12,2,33
Bangladesh,2010-02-01,12,0,0,13,14,39
Bangladesh,2010-02-01,3,0,1,4,1,9
Bangladesh,2010-02-01,0,0,1,11,0,12
Bangladesh,2010-02-01,1,0,0,0,0,1
Bangladesh,2010-02-01,5,0,0,3,1,9
Bangladesh,2010-02-01,8,0,-2,-2,2,6
Cameroon,2010-02-01,4,0,0,0,0,4
Cameroon,2010-02-01,3,0,0,21,0,24
Cameroon,2010-02-01,2,0,1,0,0,3
Cameroon,2010-02-01,2,0,0,0,0,2
Cameroon,2010-02-01,0,0,0,0,0,0
Cameroon,2010-02-01,0,0,0,0,0,0
Cameroon,2010-02-01,0,0,0,0,0,0
Cameroon,2010-02-01,-1,0,0,1,0,0
Cameroon,2010-02-01,1,0,0,0,0,1
Cameroon,2010-02-01,0,0,0,-2,0,-2
Cameroon,2010-02-01,7,0,0,-2,1,6
Cameroon,2010-02-01,-1,0,0,0,0,-1
Cameroon,2010-02-01,-1,0,0,3,0,2
Cameroon,2010-02-01,4,0,0,6,0,10
Cameroon,2010-02-01,0,0,0,-2,0,-2
Cameroon,2010-02-01,14,0,0,0,0,14
Cameroon,2010-02-01,1,0,0,0,0,1
Cameroon,2010-02-01,1,0,-2,0,0,-1
Cameroon,2010-02-01,0,0,0,0,0,0
Cameroon,2010-02-01,0,0,0,0,0,0
Cameroon,2010-02-01,1,0,0,0,0,1
Cameroon,2010-02-01,0,0,0,0,0,0
Cameroon,2010-02-01,1,0,0,0,0,1
Cameroon,2010-02-01,0,0,0,0,0,0
China,2010-02-01,238,0,-2,59,21,316
China,2010-02-01,190,4,-7,53,13,253
China,2010-02-01,239,0,-1,98,24,360
China,2010-02-01,250,4,-3,68,20,339
China,2010-02-01,132,0,-2,82,19,231
China,2010-02-01,131,0,-11,6,18,144
China,2010-02-01,88,0,0,25,9,122
China,2010-02-01,115,2,-1,131,3,250
China,2010-02-01,126,8,-3,120,10,261
China,2010-02-01,143,12,0,93,6,254
China,2010-02-01,130,6,3,135,22,296
China,2010-02-01,120,8,-1,71,14,212
China,2010-02-01,36,6,0,27,4,73
China,2010-02-01,43,0,1,27,9,80
China,2010-02-01,98,4,-6,45,11,152
China,2010-02-01,114,0,0,42,9,165
China,2010-02-01,212,2,1,62,8,285
China,2010-02-01,117,4,6,39,21,187
China,2010-02-01,114,4,-2,2,18,136
China,2010-02-01,71,0,-3,19,9,96
China,2010-02-01,81,0,3,5,6,95
China,2010-02-01,166,0,-3,49,11,223
China,2010-02-01,131,4,-1,19,19,172
China,2010-02-01,126,0,1,59,13,199
China,2010-02-01,53,2,0,52,4,111
China,2010-02-01,47,0,-4,-5,4,42
China,2010-02-01,189,2,0,35,9,235
China,2010-02-01,43,2,0,6,1,52
Egypt,2010-02-01,29,0,-10,3,2,24
Egypt,2010-02-01,33,0,-2,22,3,56
Egypt,2010-02-01,88,0,0,9,3,100
Egypt,2010-02-01,66,0,0,72,6,144
Egypt,2010-02-01,23,0,0,13,0,36
Egypt,2010-02-01,27,0,0,0,3,30
Egypt,2010-02-01,0,0,0,3,4,7
Egypt,2010-02-01,81,0,0,54,5,140
Egypt,2010-02-01,21,0,0,22,0,43
Egypt,2010-02-01,36,0,0,6,0,42
Egypt,2010-02-01,33,0,0,43,1,77
Egypt,2010-02-01,11,0,0,12,3,26
Egypt,2010-02-01,20,0,0,5,2,27
Egypt,2010-02-01,71,0,0,33,6,110
Egypt,2010-02-01,63,0,-3,18,5,83
Egypt,2010-02-01,44,0,0,8,2,54
Egypt,2010-02-01,26,0,0,1,3,30
Egypt,2010-02-01,65,0,0,29,7,101
Egypt,2010-02-01,28,0,-4,1,3,28
Egypt,2010-02-01,12,0,-2,10,0,20
Egypt,2010-02-01,35,0,0,3,4,42
Egypt,2010-02-01,33,0,0,11,0,44
Egypt,2010-02-01,35,0,0,15,16,66
Egypt,2010-02-01,11,0,-2,24,7,40
Egypt,2010-02-01,10,0,0,13,4,27
Egypt,2010-02-01,1,0,0,0,0,1
Egypt,2010-02-01,7,0,-2,9,1,15
Egypt,2010-02-01,5,0,0,12,0,17
Eritrea,2010-02-01,11,0,0,17,0,28
Eritrea,2010-02-01,-3,0,0,6,2,5
Eritrea,2010-02-01,4,0,0,0,4,8
Eritrea,2010-02-01,23,0,1,18,4,46
Eritrea,2010-02-01,6,0,0,0,4,10
Eritrea,2010-02-01,0,0,0,6,0,6
Eritrea,2010-02-01,0,0,0,0,0,0
Eritrea,2010-02-01,6,0,0,3,2,11
Eritrea,2010-02-01,7,0,0,0,0,7
Eritrea,2010-02-01,2,0,0,-4,0,-2
Eritrea,2010-02-01,1,0,0,0,1,2
Eritrea,2010-02-01,1,0,0,0,0,1
Eritrea,2010-02-01,0,0,0,15,7,22
Eritrea,2010-02-01,0,0,0,28,0,28
Eritrea,2010-02-01,13,0,0,11,0,24
Eritrea,2010-02-01,11,0,0,4,0,15
Eritrea,2010-02-01,17,0,0,15,1,33
Eritrea,2010-02-01,0,0,0,0,0,0
Eritrea,2010-02-01,12,0,0,3,9,24
Eritrea,2010-02-01,25,0,0,3,0,28
Eritrea,2010-02-01,26,0,0,3,0,29
Eritrea,2010-02-01,33,0,0,6,0,39
Eritrea,2010-02-01,4,0,0,3,2,9
Eritrea,2010-02-01,6,0,0,0,2,8
Eritrea,2010-02-01,1,0,0,0,0,1
Georgia,2010-02-01,33,0,2,27,18,80
Georgia,2010-02-01,31,0,-2,29,5,63
Georgia,2010-02-01,25,0,0,19,0,44
Georgia,2010-02-01,28,0,0,4,4,36
Georgia,2010-02-01,17,0,-2,18,7,40
Georgia,2010-02-01,2,0,0,3,1,6
Georgia,2010-02-01,15,0,-2,9,0,22
Georgia,2010-02-01,26,0,-1,23,6,54
Georgia,2010-02-01,19,2,0,15,2,38
Georgia,2010-02-01,28,0,0,10,6,44
Georgia,2010-02-01,37,0,0,2,0,39
Georgia,2010-02-01,64,2,0,26,9,101
Georgia,2010-02-01,47,0,0,27,15,89
Georgia,2010-02-01,17,0,0,-1,2,18
Georgia,2010-02-01,13,0,0,-6,1,8
Georgia,2010-02-01,50,2,1,14,3,70
Georgia,2010-02-01,12,0,0,6,0,18
Georgia,2010-02-01,28,0,0,50,0,78
Georgia,2010-02-01,28,2,0,15,4,49
Georgia,2010-02-01,19,0,0,15,0,34
Georgia,2010-02-01,20,0,0,4,2,26
Georgia,2010-02-01,31,0,-1,21,4,55
Georgia,2010-02-01,23,0,1,28,4,56
Georgia,2010-02-01,6,0,1,12,2,21
Georgia,2010-02-01,7,0,0,-3,1,5
Georgia,2010-02-01,-1,0,0,0,0,-1
Georgia,2010-02-01,-3,0,0,3,6,6
Georgia,2010-02-01,2,0,0,-2,8,8
India,2010-02-01,60,0,-1,8,4,71
India,2010-02-01,69,0,-1,21,12,101
India,2010-02-01,49,0,-4,30,14,89
India,2010-02-01,53,2,-2,-3,5,55
India,2010-02-01,48,4,-9,28,4,75
India,2010-02-01,66,2,-2,21,5,92
India,2010-02-01,43,2,1,20,10,76
India,2010-02-01,143,2,0,22,4,171
India,2010-02-01,87,2,0,12,4,105
India,2010-02-01,77,0,-1,26,2,104
India,2010-02-01,74,0,-8,16,10,92
India,2010-02-01,56,0,1,29,5,91
India,2010-02-01,80,0,2,23,4,109
India,2010-02-01,56,0,1,3,8,68
India,2010-02-01,151,0,-3,21,7,176
India,2010-02-01,61,4,4,17,8,94
India,2010-02-01,75,6,1,25,9,116
India,2010-02-01,61,0,-2,47,6,112
India,2010-02-01,79,0,0,8,16,103
India,2010-02-01,63,2,-2,12,1,76
India,2010-02-01,45,0,0,4,-2,47
India,2010-02-01,55,0,3,45,6,109
India,2010-02-01,42,2,-5,11,12,62
India,2010-02-01,35,4,-4,29,9,73
India,2010-02-01,13,0,0,0,1,14
India,2010-02-01,57,0,0,6,10,73
India,2010-02-01,36,0,1,4,10,51
India,2010-02-01,17,0,0,3,0,20
Iran,2010-02-01,175,6,1,18,18,218
Iran,2010-02-01,256,0,-6,31,20,301
Iran,2010-02-01,190,2,1,82,33,308
Iran,2010-02-01,108,2,1,55,31,197
Iran,2010-02-01,59,2,-2,25,21,105
Iran,2010-02-01,57,0,-2,15,10,80
Iran,2010-02-01,70,0,-1,19,14,102
Iran,2010-02-01,119,0,-1,71,7,196
Iran,2010-02-01,120,0,1,31,7,159
Iran,2010-02-01,85,0,-2,64,15,162
Iran,2010-02-01,178,0,1,119,48,346
Iran,2010-02-01,175,0,-4,100,17,288
Iran,2010-02-01,64,0,1,42,21,128
Iran,2010-02-01,122,2,1,13,15,153
Iran,2010-02-01,189,0,4,18,14,225
Iran,2010-02-01,156,2,2,41,11,212
Iran,2010-02-01,142,2,2,63,19,228
Iran,2010-02-01,110,2,0,43,16,171
Iran,2010-02-01,61,0,-10,42,15,108
Iran,2010-02-01,44,4,1,22,5,76
Iran,2010-02-01,64,2,1,27,19,113
Iran,2010-02-01,126,0,1,34,13,174
Iran,2010-02-01,139,0,3,101,26,269
Iran,2010-02-01,64,0,0,29,4,97
Iran,2010-02-01,13,0,0,22,1,36
Iran,2010-02-01,11,0,0,3,-1,13
Iran,2010-02-01,61,0,0,22,3,86
Iran,2010-02-01,25,0,-1,30,39,93
Iraq,2010-02-01,86,4,6,7,12,115
Iraq,2010-02-01,149,0,-11,113,26,277
Iraq,2010-02-01,112,2,0,67,-3,178
Iraq,2010-02-01,85,0,3,47,6,141
Iraq,2010-02-01,81,0,-4,24,10,111
Iraq,2010-02-01,50,0,0,22,5,77
Iraq,2010-02-01,49,0,1,25,7,82
Iraq,2010-02-01,118,0,-2,67,9,192
Iraq,2010-02-01,104,0,-1,27,18,148
Iraq,2010-02-01,127,0,3,44,15,189
Iraq,2010-02-01,98,0,2,42,6,148
Iraq,2010-02-01,48,0,3,39,21,111
Iraq,2010-02-01,85,2,0,47,10,144
Iraq,2010-02-01,115,0,0,31,11,157
Iraq,2010-02-01,120,0,2,59,17,198
Iraq,2010-02-01,206,0,1,90,38,335
Iraq,2010-02-01,96,0,0,14,12,122
Iraq,2010-02-01,124,0,1,32,56,213
Iraq,2010-02-01,85,4,0,16,32,137
Iraq,2010-02-01,65,2,0,10,16,93
Iraq,2010-02-01,69,6,-1,26,20,120
Iraq,2010-02-01,70,0,1,11,11,93
Iraq,2010-02-01,177,0,-3,13,15,202
Iraq,2010-02-01,104,2,0,15,6,127
Iraq,2010-02-01,21,0,0,7,0,28
Iraq,2010-02-01,15,0,0,9,4,28
Iraq,2010-02-01,43,0,1,0,10,54
Iraq,2010-02-01,39,0,-1,18,2,58
Morocco,2010-02-01,18,0,0,15,0,33
Morocco,2010-02-01,24,0,0,18,0,42
Morocco,2010-02-01,16,0,0,28,3,47
Morocco,2010-02-01,7,0,0,3,0,10
Morocco,2010-02-01,2,0,0,0,2,4
Morocco,2010-02-01,7,0,0,6,0,13
Morocco,2010-02-01,0,0,0,0,0,0
Morocco,2010-02-01,0,0,0,6,0,6
Morocco,2010-02-01,-1,0,0,7,0,6
Morocco,2010-02-01,-1,0,3,38,0,40
Morocco,2010-02-01,5,0,0,15,0,20
Morocco,2010-02-01,16,0,0,10,0,26
Morocco,2010-02-01,8,0,0,0,0,8
Morocco,2010-02-01,-1,0,0,0,0,-1
Morocco,2010-02-01,70,0,0,12,5,87
Morocco,2010-02-01,3,2,0,0,0,5
Morocco,2010-02-01,8,0,0,12,0,20
Morocco,2010-02-01,6,0,0,9,1,16
Morocco,2010-02-01,18,0,0,16,0,34
Morocco,2010-02-01,0,0,0,27,2,29
Morocco,2010-02-01,0,0,0,0,0,0
Morocco,2010-02-01,5,0,0,5,0,10
Morocco,2010-02-01,3,0,0,9,0,12
Morocco,2010-02-01,0,0,0,9,0,9
Morocco,2010-02-01,2,0,0,0,0,2
Morocco,2010-02-01,0,0,0,0,0,0
Morocco,2010-02-01,10,0,0,4,0,14
Morocco,2010-02-01,2,0,0,0,0,2
Nigeria,2010-02-01,82,0,1,39,11,133
Nigeria,2010-02-01,62,2,-2,26,8,96
Nigeria,2010-02-01,79,0,-2,38,13,128
Nigeria,2010-02-01,63,0,-8,34,1,90
Nigeria,2010-02-01,26,6,1,30,1,64
Nigeria,2010-02-01,17,0,0,-4,2,15
Nigeria,2010-02-01,48,0,-2,8,4,58
Nigeria,2010-02-01,26,0,0,4,4,34
Nigeria,2010-02-01,43,0,-10,6,6,45
Nigeria,2010-02-01,77,0,0,11,4,92
Nigeria,2010-02-01,53,4,1,26,11,95
Nigeria,2010-02-01,28,0,-6,3,7,32
Nigeria,2010-02-01,23,0,-1,13,4,39
Nigeria,2010-02-01,35,0,1,4,4,44
Nigeria,2010-02-01,34,0,2,16,5,57
Nigeria,2010-02-01,15,0,0,-2,4,17
Nigeria,2010-02-01,16,0,-4,35,0,47
Nigeria,2010-02-01,50,0,0,4,4,58
Nigeria,2010-02-01,36,0,-1,20,4,59
Nigeria,2010-02-01,40,0,0,16,1,57
Nigeria,2010-02-01,19,0,0,1,1,21
Nigeria,2010-02-01,14,2,-7,25,8,42
Nigeria,2010-02-01,13,0,0,15,7,35
Nigeria,2010-02-01,13,0,0,12,10,35
Nigeria,2010-02-01,20,0,-1,0,0,19
Nigeria,2010-02-01,5,0,0,3,1,9
Nigeria,2010-02-01,14,0,0,1,5,20
Nigeria,2010-02-01,3,0,0,0,0,3
Pakistan,2010-02-01,59,12,1,20,4,96
Pakistan,2010-02-01,93,8,0,28,3,132
Pakistan,2010-02-01,161,0,0,48,17,226
Pakistan,2010-02-01,181,0,0,26,19,226
Pakistan,2010-02-01,77,2,-5,46,17,137
Pakistan,2010-02-01,84,2,0,-7,20,99
Pakistan,2010-02-01,54,0,0,54,12,120
Pakistan,2010-02-01,77,10,0,48,9,144
Pakistan,2010-02-01,51,0,0,36,22,109
Pakistan,2010-02-01,130,0,-1,154,35,318
Pakistan,2010-02-01,304,0,0,90,19,413
Pakistan,2010-02-01,154,0,-2,49,26,227
Pakistan,2010-02-01,137,0,2,39,14,192
Pakistan,2010-02-01,211,0,0,38,17,266
Pakistan,2010-02-01,122,0,-1,48,15,184
Pakistan,2010-02-01,155,2,-2,134,12,301
Pakistan,2010-02-01,170,2,0,155,9,336
Pakistan,2010-02-01,139,0,0,90,19,248
Pakistan,2010-02-01,99,0,-2,90,10,197
Pakistan,2010-02-01,41,0,-4,89,9,135
Pakistan,2010-02-01,122,0,4,47,14,187
Pakistan,2010-02-01,137,0,-4,71,38,242
Pakistan,2010-02-01,106,0,-20,156,21,263
Pakistan,2010-02-01,75,0,-1,77,7,158
Pakistan,2010-02-01,97,0,3,61,10,171
Pakistan,2010-02-01,93,0,3,74,12,182
Pakistan,2010-02-01,131,0,3,38,22,194
Pakistan,2010-02-01,65,0,2,24,0,91
Sierra Leone,2010-02-01,0,0,0,0,0,0
Sierra Leone,2010-02-01,0,0,0,0,0,0
Sierra Leone,2010-02-01,1,0,0,0,0,1
Sierra Leone,2010-02-01,2,0,0,6,0,8
Sierra Leone,2010-02-01,6,0,0,15,0,21
Sierra Leone,2010-02-01,-1,0,0,24,2,25
Sierra Leone,2010-02-01,0,0,0,-1,0,-1
Sierra Leone,2010-02-01,3,0,0,12,0,15
Sierra Leone,2010-02-01,4,0,-2,-4,0,-2
Sierra Leone,2010-02-01,0,0,0,-4,0,-4
Sierra Leone,2010-02-01,4,0,0,0,0,4
Sierra Leone,2010-02-01,3,0,0,3,0,6
Sierra Leone,2010-02-01,4,0,0,0,0,4
Sierra Leone,2010-02-01,0,0,0,0,0,0
Sierra Leone,2010-02-01,0,0,0,0,0,0
Sierra Leone,2010-02-01,3,0,0,0,0,3
Sierra Leone,2010-02-01,3,0,0,0,0,3
Sierra Leone,2010-02-01,0,0,0,6,0,6
Sierra Leone,2010-02-01,0,0,0,0,0,0
Sierra Leone,2010-02-01,2,0,0,12,0,14
Sierra Leone,2010-02-01,-1,0,0,12,0,11
Sierra Leone,2010-02-01,2,0,-1,4,4,9
Sierra Leone,2010-02-01,7,0,0,0,0,7
Sierra Leone,2010-02-01,3,0,0,15,0,18
Sierra Leone,2010-02-01,1,0,0,6,4,11
Sierra Leone,2010-02-01,0,0,0,3,0,3
Sierra Leone,2010-02-01,0,0,0,0,0,0
Somalia,2010-02-01,72,2,-2,-4,10,78
Somalia,2010-02-01,28,2,0,-39,3,-6
Somalia,2010-02-01,15,0,0,51,0,66
Somalia,2010-02-01,13,2,4,-2,7,24
Somalia,2010-02-01,29,0,0,28,1,58
Somalia,2010-02-01,25,0,0,-5,1,21
Somalia,2010-02-01,14,0,0,7,2,23
Somalia,2010-02-01,20,8,0,15,0,43
Somalia,2010-02-01,85,6,0,-30,3,64
Somalia,2010-02-01,54,0,0,42,4,100
Somalia,2010-02-01,42,8,0,-12,2,40
Somalia,2010-02-01,2,0,0,-1,2,3
Somalia,2010-02-01,6,0,0,-2,2,6
Somalia,2010-02-01,9,0,0,-3,0,6
Somalia,2010-02-01,38,0,-2,20,4,60
Somalia,2010-02-01,45,0,0,6,0,51
Somalia,2010-02-01,46,0,0,18,1,65
Somalia,2010-02-01,34,0,0,10,0,44
Somalia,2010-02-01,7,0,0,7,0,14
Somalia,2010-02-01,10,0,0,13,0,23
Somalia,2010-02-01,19,0,0,0,0,19
Somalia,2010-02-01,14,0,0,13,1,28
Somalia,2010-02-01,39,0,0,21,0,60
Somalia,2010-02-01,9,2,0,4,0,15
Somalia,2010-02-01,2,0,0,0,0,2
Somalia,2010-02-01,0,0,0,-4,1,-3
Somalia,2010-02-01,27,0,0,-23,0,4
Somalia,2010-02-01,13,0,0,-25,2,-10
Syria,2010-02-01,14,0,0,27,0,41
Syria,2010-02-01,14,0,0,39,0,53
Syria,2010-02-01,3,0,0,12,4,19
Syria,2010-02-01,62,0,0,1,2,65
Syria,2010-02-01,61,0,-2,5,1,65
Syria,2010-02-01,7,0,-4,0,2,5
Syria,2010-02-01,6,0,0,3,0,9
Syria,2010-02-01,25,0,0,0,0,25
Syria,2010-02-01,20,0,0,18,0,38
Syria,2010-02-01,18,2,0,12,3,35
Syria,2010-02-01,15,0,0,1,0,16
Syria,2010-02-01,3,0,0,3,4,10
Syria,2010-02-01,10,0,0,0,2,12
Syria,2010-02-01,51,0,1,6,0,58
Syria,2010-02-01,24,0,2,18,0,44
Syria,2010-02-01,2,0,0,12,2,16
Syria,2010-02-01,20,0,0,14,7,41
Syria,2010-02-01,11,0,0,39,1,51
Syria,2010-02-01,11,0,0,21,0,32
Syria,2010-02-01,5,0,0,6,5,16
Syria,2010-02-01,18,0,0,0,0,18
Syria,2010-02-01,20,0,0,12,2,34
Syria,2010-02-01,30,0,0,19,2,51
Syria,2010-02-01,20,0,0,9,2,31
Syria,2010-02-01,-5,0,0,9,0,4
Syria,2010-02-01,0,0,0,0,0,0
Syria,2010-02-01,9,0,0,3,3,15
Syria,2010-02-01,22,0,0,0,0,22
Yemen,2010-02-01,65,6,0,6,1,78
Yemen,2010-02-01,60,2,0,-5,6,63
Yemen,2010-02-01,80,0,0,14,6,100
Yemen,2010-02-01,41,0,0,10,7,58
Yemen,2010-02-01,21,2,0,22,1,46
Yemen,2010-02-01,36,0,0,37,6,79
Yemen,2010-02-01,28,0,0,14,3,45
Yemen,2010-02-01,127,4,0,10,18,159
Yemen,2010-02-01,48,0,0,15,0,63
Yemen,2010-02-01,24,0,0,4,3,31
Yemen,2010-02-01,-9,0,0,8,2,1
Yemen,2010-02-01,38,0,0,4,2,44
Yemen,2010-02-01,21,0,0,-2,0,19
Yemen,2010-02-01,15,0,2,0,1,18
Yemen,2010-02-01,57,2,0,-10,0,49
Yemen,2010-02-01,50,2,0,15,1,68
Yemen,2010-02-01,33,2,0,16,0,51
Yemen,2010-02-01,11,0,0,-16,2,-3
Yemen,2010-02-01,42,0,0,4,3,49
Yemen,2010-02-01,29,0,0,15,6,50
Yemen,2010-02-01,10,0,0,1,0,11
Yemen,2010-02-01,17,0,0,12,0,29
Yemen,2010-02-01,32,0,0,-8,0,24
Yemen,2010-02-01,5,0,0,8,0,13
Yemen,2010-02-01,3,0,0,0,0,3
Yemen,2010-02-01,6,0,0,0,0,6
Yemen,2010-02-01,6,0,0,3,1,10
Yemen,2010-02-01,3,0,0,15,2,20
Afghanistan,2012-02-01,414,2,-1,24,26,465
Afghanistan,2012-02-01,205,2,-1,8,27,241
Afghanistan,2012-02-01,71,0,0,25,5,101
Afghanistan,2012-02-01,246,0,4,55,33,338
Afghanistan,2012-02-01,207,2,0,42,60,311
Afghanistan,2012-02-01,190,0,5,25,13,233
Afghanistan,2012-02-01,181,2,-16,9,10,186
Afghanistan,2012-02-01,275,0,-8,28,11,306
Afghanistan,2012-02-01,430,0,0,50,9,489
Afghanistan,2012-02-01,335,0,-6,78,41,448
Afghanistan,2012-02-01,160,0,-1,18,7,184
Afghanistan,2012-02-01,240,2,-2,116,7,363
Afghanistan,2012-02-01,127,0,2,42,18,189
Afghanistan,2012-02-01,62,6,-2,50,10,126
Afghanistan,2012-02-01,134,6,1,37,20,198
Afghanistan,2012-02-01,179,2,3,17,7,208
Afghanistan,2012-02-01,256,2,-2,37,49,342
Afghanistan,2012-02-01,172,14,0,24,7,217
Afghanistan,2012-02-01,167,4,0,25,24,220
Afghanistan,2012-02-01,227,0,-6,42,59,322
Afghanistan,2012-02-01,99,4,0,16,40,159
Afghanistan,2012-02-01,104,0,0,28,13,145
Afghanistan,2012-02-01,277,4,-4,33,49,359
Afghanistan,2012-02-01,302,0,1,79,65,447
Afghanistan,2012-02-01,273,0,0,29,38,340
Afghanistan,2012-02-01,286,2,1,34,34,357
Afghanistan,2012-02-01,244,2,0,18,49,313
Afghanistan,2012-02-01,220,0,0,10,8,238
Afghanistan,2012-02-01,165,4,0,44,35,248
Albania,2012-02-01,4,0,-1,-2,5,6
Albania,2012-02-01,5,0,0,0,1,6
Albania,2012-02-01,-1,0,0,0,2,1
Albania,2012-02-01,24,0,0,3,4,31
Albania,2012-02-01,5,0,0,0,2,7
Albania,2012-02-01,13,0,-1,3,2,17
Albania,2012-02-01,0,0,0,6,0,6
Albania,2012-02-01,4,0,0,0,0,4
Albania,2012-02-01,5,0,0,1,3,9
Albania,2012-02-01,52,0,0,6,6,64
Albania,2012-02-01,0,0,0,3,0,3
Albania,2012-02-01,6,0,0,0,0,6
Albania,2012-02-01,2,2,-1,0,4,7
Albania,2012-02-01,30,0,2,6,5,43
Albania,2012-02-01,12,0,2,6,1,21
Albania,2012-02-01,21,0,0,0,4,25
Albania,2012-02-01,7,0,0,0,2,9
Albania,2012-02-01,6,0,0,-1,0,5
Albania,2012-02-01,10,0,0,12,0,22
Albania,2012-02-01,37,0,0,3,4,44
Albania,2012-02-01,26,0,0,3,2,31
Albania,2012-02-01,4,0,1,0,1,6
Albania,2012-02-01,13,0,0,-4,0,9
Albania,2012-02-01,2,0,0,0,0,2
Albania,2012-02-01,0,0,0,0,0,0
Albania,2012-02-01,3,0,0,0,0,3
Albania,2012-02-01,7,0,-4,0,0,3
Albania,2012-02-01,2,0,-1,7,5,13
Albania,2012-02-01,8,0,0,0,0,8
Algeria,2012-02-01,15,0,0,3,2,20
Algeria,2012-02-01,20,0,0,40,2,62
Algeria,2012-02-01,5,0,0,0,0,5
Algeria,2012-02-01,8,0,0,7,0,15
Algeria,2012-02-01,9,0,0,-2,0,7
Algeria,2012-02-01,30,0,0,0,2,32
Algeria,2012-02-01,4,0,2,-4,0,2
Algeria,2012-02-01,31,0,-2,0,0,29
Algeria,2012-02-01,14,0,0,4,0,18
Algeria,2012-02-01,2,0,0,7,1,10
Algeria,2012-02-01,0,0,-6,3,0,-3
Algeria,2012-02-01,8,0,0,0,0,8
Algeria,2012-02-01,46,0,0,48,0,94
Algeria,2012-02-01,13,0,0,27,0,40
Algeria,2012-02-01,10,0,0,9,3,22
Algeria,2012-02-01,4,0,0,6,0,10
Algeria,2012-02-01,-1,0,0,0,0,-1
Algeria,2012-02-01,20,0,0,9,1,30
Algeria,2012-02-01,19,0,0,0,0,19
Algeria,2012-02-01,4,0,0,9,2,15
Algeria,2012-02-01,24,0,0,6,1,31
Algeria,2012-02-01,27,0,0,15,0,42
Algeria,2012-02-01,3,0,1,6,0,10
Algeria,2012-02-01,9,0,1,-5,0,5
Algeria,2012-02-01,-16,0,-2,-4,0,-22
Algeria,2012-02-01,2,0,-3,0,0,-1
Algeria,2012-02-01,5,0,0,0,0,5
Algeria,2012-02-01,4,0,0,0,0,4
Algeria,2012-02-01,8,0,2,7,0,17
Bangladesh,2012-02-01,-1,6,0,9,3,17
Bangladesh,2012-02-01,4,0,0,22,2,28
Bangladesh,2012-02-01,6,0,0,-4,0,2
Bangladesh,2012-02-01,10,2,0,4,0,16
Bangladesh,2012-02-01,9,0,0,1,7,17
Bangladesh,2012-02-01,12,0,0,-3,10,19
Bangladesh,2012-02-01,22,0,0,15,12,49
Bangladesh,2012-02-01,10,0,-2,12,11,31
Bangladesh,2012-02-01,38,2,0,-5,8,43
Bangladesh,2012-02-01,8,0,0,4,1,13
Bangladesh,2012-02-01,14,0,0,1,0,15
Bangladesh,2012-02-01,0,0,-2,3,1,2
Bangladesh,2012-02-01,33,0,-1,0,4,36
Bangladesh,2012-02-01,14,0,1,0,1,16
Bangladesh,2012-02-01,14,2,0,3,0,19
Bangladesh,2012-02-01,26,2,0,15,2,45
Bangladesh,2012-02-01,11,0,0,15,4,30
Bangladesh,2012-02-01,12,0,0,7,3,22
Bangladesh,2012-02-01,14,0,0,0,2,16
Bangladesh,2012-02-01,10,0,4,0,1,15
Bangladesh,2012-02-01,13,0,0,13,3,29
Bangladesh,2012-02-01,10,0,0,3,3,16
Bangladesh,2012-02-01,27,0,-2,23,3,51
Bangladesh,2012-02-01,6,0,0,13,4,23
Bangladesh,2012-02-01,26,0,-2,0,11,35
Bangladesh,2012-02-01,8,0,0,0,7,15
Bangladesh,2012-02-01,1,0,2,6,1,10
Bangladesh,2012-02-01,8,0,0,20,2,30
Bangladesh,2012-02-01,5,0,0,6,0,11
Cameroon,2012-02-01,14,0,0,0,0,14
Cameroon,2012-02-01,0,0,0,0,0,0
Cameroon,2012-02-01,2,0,1,3,2,8
Cameroon,2012-02-01,0,0,0,0,0,0
Cameroon,2012-02-01,0,0,0,0,0,0
Cameroon,2012-02-01,8,0,0,0,0,8
Cameroon,2012-02-01,3,0,0,0,0,3
Cameroon,2012-02-01,11,0,0,6,0,17
Cameroon,2012-02-01,0,0,0,42,0,42
Cameroon,2012-02-01,0,0,0,0,1,1
Cameroon,2012-02-01,0,0,0,0,0,0
Cameroon,2012-02-01,0,0,0,0,0,0
Cameroon,2012-02-01,-1,0,0,0,0,-1
Cameroon,2012-02-01,0,0,0,0,0,0
Cameroon,2012-02-01,4,0,0,0,0,4
Cameroon,2012-02-01,3,0,0,3,1,7
Cameroon,2012-02-01,17,0,0,0,0,17
Cameroon,2012-02-01,-12,0,0,0,0,-12
Cameroon,2012-02-01,2,0,0,3,0,5
Cameroon,2012-02-01,23,0,0,0,0,23
Cameroon,2012-02-01,8,0,0,0,0,8
Cameroon,2012-02-01,3,0,0,0,0,3
Cameroon,2012-02-01,16,0,0,0,0,16
Cameroon,2012-02-01,0,0,0,0,0,0
Cameroon,2012-02-01,11,0,0,0,0,11
Cameroon,2012-02-01,0,0,0,0,0,0
Cameroon,2012-02-01,12,0,0,2,0,14
Cameroon,2012-02-01,6,0,0,3,0,9
China,2012-02-01,173,0,3,95,36,307
China,2012-02-01,197,6,-2,71,21,293
China,2012-02-01,27,0,1,5,10,43
China,2012-02-01,197,4,-17,36,22,242
China,2012-02-01,219,14,-27,27,49,282
China,2012-02-01,311,0,-17,90,35,419
China,2012-02-01,302,2,-47,23,41,321
China,2012-02-01,195,4,-16,157,36,376
China,2012-02-01,169,2,-8,62,20,245
China,2012-02-01,223,8,-2,81,37,347
China,2012-02-01,109,0,3,8,26,146
China,2012-02-01,137,2,-12,23,22,172
China,2012-02-01,301,2,-8,45,28,368
China,2012-02-01,135,6,0,128,27,296
China,2012-02-01,107,8,2,23,27,167
China,2012-02-01,210,4,-17,69,27,293
China,2012-02-01,206,2,-15,58,23,274
China,2012-02-01,152,0,0,9,15,176
China,2012-02-01,243,2,-3,38,11,291
China,2012-02-01,124,0,-4,61,20,201
China,2012-02-01,225,4,1,53,32,315
China,2012-02-01,194,2,-7,92,38,319
China,2012-02-01,214,0,-7,47,48,302
China,2012-02-01,275,10,-8,51,32,360
China,2012-02-01,122,8,-3,39,15,181
China,2012-02-01,100,0,-15,35,21,141
China,2012-02-01,170,12,-24,50,22,230
China,2012-02-01,240,6,-11,38,41,314
China,2012-02-01,255,6,1,68,54,384
Egypt,2012-02-01,47,0,0,37,13,97
Egypt,2012-02-01,88,12,-7,98,18,209
Egypt,2012-02-01,23,8,0,12,3,46
Egypt,2012-02-01,26,0,0,62,2,90
Egypt,2012-02-01,76,0,0,55,7,138
Egypt,2012-02-01,109,0,-3,72,14,192
Egypt,2012-02-01,84,0,-4,36,12,128
Egypt,2012-02-01,58,0,-1,56,22,135
Egypt,2012-02-01,83,0,-1,63,26,171
Egypt,2012-02-01,52,0,-11,61,12,114
Egypt,2012-02-01,84,0,-6,29,9,116
Egypt,2012-02-01,45,0,0,-5,4,44
Egypt,2012-02-01,50,0,-8,3,18,63
Egypt,2012-02-01,62,8,0,4,16,90
Egypt,2012-02-01,53,2,-3,-5,2,49
Egypt,2012-02-01,65,0,3,38,13,119
Egypt,2012-02-01,52,2,-5,11,10,70
Egypt,2012-02-01,35,0,-2,25,7,65
Egypt,2012-02-01,50,2,-8,-1,2,45
Egypt,2012-02-01,50,2,-9,20,3,66
Egypt,2012-02-01,47,2,-4,36,13,94
Egypt,2012-02-01,137,0,0,84,10,231
Egypt,2012-02-01,42,0,-11,44,6,81
Egypt,2012-02-01,48,0,0,24,6,78
Egypt,2012-02-01,62,0,0,10,7,79
Egypt,2012-02-01,35,2,0,30,13,80
Egypt,2012-02-01,60,0,0,18,7,85
Egypt,2012-02-01,80,2,4,81,10,177
Egypt,2012-02-01,74,0,-1,112,15,200
Eritrea,2012-02-01,1,0,0,2,4,7
Eritrea,2012-02-01,3,0,0,0,0,3
Eritrea,2012-02-01,6,0,0,6,0,12
Eritrea,2012-02-01,1,0,0,0,0,1
Eritrea,2012-02-01,0,0,0,0,0,0
Eritrea,2012-02-01,0,0,0,0,0,0
Eritrea,2012-02-01,0,0,0,0,0,0
Eritrea,2012-02-01,0,0,0,0,0,0
Eritrea,2012-02-01,0,0,0,0,0,0
Eritrea,2012-02-01,2,0,0,6,0,8
Eritrea,2012-02-01,0,0,0,0,0,0
Eritrea,2012-02-01,0,8,0,3,0,11
Eritrea,2012-02-01,0,4,0,-1,0,3
Eritrea,2012-02-01,0,0,0,0,0,0
Eritrea,2012-02-01,8,0,0,18,0,26
Eritrea,2012-02-01,4,0,0,15,0,19
Eritrea,2012-02-01,4,0,0,3,3,10
Eritrea,2012-02-01,-1,0,0,3,1,3
Eritrea,2012-02-01,4,0,0,3,0,7
Eritrea,2012-02-01,3,0,0,0,0,3
Eritrea,2012-02-01,2,0,0,0,0,2
Eritrea,2012-02-01,6,0,0,-2,0,4
Eritrea,2012-02-01,0,0,0,0,0,0
Georgia,2012-02-01,33,2,0,33,4,72
Georgia,2012-02-01,54,2,-6,20,8,78
Georgia,2012-02-01,2,2,0,-2,2,4
Georgia,2012-02-01,20,0,0,9,3,32
Georgia,2012-02-01,34,2,0,27,3,66
Georgia,2012-02-01,49,2,2,32,3,88
Georgia,2012-02-01,62,0,-41,54,10,85
Georgia,2012-02-01,87,0,-8,43,12,134
Georgia,2012-02-01,24,0,-4,36,15,71
Georgia,2012-02-01,58,0,1,40,5,104
Georgia,2012-02-01,20,0,0,41,0,61
Georgia,2012-02-01,22,2,-6,6,0,24
Georgia,2012-02-01,78,0,-1,35,9,121
Georgia,2012-02-01,52,2,2,61,19,136
Georgia,2012-02-01,76,0,0,53,12,141
Georgia,2012-02-01,73,0,0,34,7,114
Georgia,2012-02-01,41,0,-3,37,13,88
Georgia,2012-02-01,45,0,0,32,8,85
Georgia,2012-02-01,32,0,0,27,7,66
Georgia,2012-02-01,30,2,-1,45,10,86
Georgia,2012-02-01,126,0,-5,28,8,157
Georgia,2012-02-01,189,8,-8,38,16,243
Georgia,2012-02-01,91,0,-3,11,6,105
Georgia,2012-02-01,54,4,-2,15,5,76
Georgia,2012-02-01,32,0,0,10,4,46
Georgia,2012-02-01,14,0,0,9,0,23
Georgia,2012-02-01,50,4,1,45,12,112
Georgia,2012-02-01,60,0,-1,62,10,131
Georgia,2012-02-01,65,4,-4,56,10,131
India,2012-02-01,70,2,-6,30,8,104
India,2012-02-01,108,14,-9,8,12,133
India,2012-02-01,17,6,0,0,4,27
India,2012-02-01,15,0,-6,28,6,43
India,2012-02-01,70,6,-6,37,8,115
India,2012-02-01,64,2,1,61,14,142
India,2012-02-01,72,0,-6,32,9,107
India,2012-02-01,82,4,-28,30,15,103
India,2012-02-01,80,2,-25,13,34,104
India,2012-02-01,119,8,-20,7,18,132
India,2012-02-01,80,2,-14,21,14,103
India,2012-02-01,76,0,4,42,21,143
India,2012-02-01,107,0,2,49,14,172
India,2012-02-01,86,2,2,55,30,175
India,2012-02-01,70,0,0,63,12,145
India,2012-02-01,98,2,-6,48,19,161
India,2012-02-01,104,0,-9,49,12,156
India,2012-02-01,67,2,-2,6,13,86
India,2012-02-01,55,2,1,16,9,83
India,2012-02-01,105,0,1,44,36,186
India,2012-02-01,105,0,3,32,21,161
India,2012-02-01,92,2,-3,26,21,138
India,2012-02-01,49,2,5,12,7,75
India,2012-02-01,80,2,-7,3,10,88
India,2012-02-01,41,2,-1,7,11,60
India,2012-02-01,68,0,-2,-5,10,71
India,2012-02-01,58,2,-6,24,10,88
India,2012-02-01,88,0,0,13,13,114
India,2012-02-01,80,2,-1,33,22,136
Iran,2012-02-01,171,0,-10,112,21,294
Iran,2012-02-01,158,0,-2,35,36,227
Iran,2012-02-01,47,0,0,31,17,95
Iran,2012-02-01,153,0,1,38,19,211
Iran,2012-02-01,234,1,-1,46,40,320
Iran,2012-02-01,241,0,3,88,41,373
Iran,2012-02-01,188,0,2,125,11,326
Iran,2012-02-01,164,0,-9,85,18,258
Iran,2012-02-01,209,4,-2,132,30,373
Iran,2012-02-01,156,0,6,75,20,257
Iran,2012-02-01,74,0,1,54,7,136
Iran,2012-02-01,86,0,1,32,11,130
Iran,2012-02-01,310,6,3,178,60,557
Iran,2012-02-01,382,0,0,145,85,612
Iran,2012-02-01,338,4,1,158,67,568
Iran,2012-02-01,285,2,2,77,35,401
Iran,2012-02-01,183,2,-2,60,23,266
Iran,2012-02-01,154,0,-2,51,19,222
Iran,2012-02-01,194,0,-1,39,68,300
Iran,2012-02-01,172,0,3,104,64,343
Iran,2012-02-01,215,0,1,165,32,413
Iran,2012-02-01,207,4,-9,123,37,362
Iran,2012-02-01,268,0,-5,74,46,383
Iran,2012-02-01,158,2,1,60,22,243
Iran,2012-02-01,138,0,-2,54,14,204
Iran,2012-02-01,155,0,4,64,11,234
Iran,2012-02-01,176,4,-4,98,23,297
Iran,2012-02-01,230,2,-1,101,24,356
Iran,2012-02-01,216,0,3,222,23,464
Iraq,2012-02-01,109,0,0,60,14,183
Iraq,2012-02-01,170,6,-2,67,18,259
Iraq,2012-02-01,56,0,0,19,3,78
Iraq,2012-02-01,88,0,2,28,12,130
Iraq,2012-02-01,97,0,0,6,5,108
Iraq,2012-02-01,75,0,-3,37,8,117
Iraq,2012-02-01,86,0,1,43,9,139
Iraq,2012-02-01,134,0,0,22,12,168
Iraq,2012-02-01,159,0,0,59,14,232
Iraq,2012-02-01,117,2,2,41,9,171
Iraq,2012-02-01,107,2,0,25,7,141
Iraq,2012-02-01,150,2,3,43,22,220
Iraq,2012-02-01,149,2,5,54,10,220
Iraq,2012-02-01,80,4,-1,21,43,147
Iraq,2012-02-01,145,0,-1,40,19,203
Iraq,2012-02-01,113,4,1,20,19,157
Iraq,2012-02-01,125,0,0,37,13,175
Iraq,2012-02-01,88,0,-2,16,2,104
Iraq,2012-02-01,55,2,0,3,4,64
Iraq,2012-02-01,100,6,-1,46,27,178
Iraq,2012-02-01,114,0,0,23,15,152
Iraq,2012-02-01,123,0,-2,14,27,162
Iraq,2012-02-01,168,0,6,30,21,225
Iraq,2012-02-01,124,2,3,38,21,188
Iraq,2012-02-01,65,2,0,9,9,85
Iraq,2012-02-01,65,0,0,13,29,107
Iraq,2012-02-01,157,2,1,40,14,214
Iraq,2012-02-01,161,12,0,38,9,220
Iraq,2012-02-01,125,0,3,43,9,180
Morocco,2012-02-01,14,0,-9,0,1,6
Morocco,2012-02-01,9,0,0,-7,0,2
Morocco,2012-02-01,11,0,0,16,0,27
Morocco,2012-02-01,18,0,0,-1,2,19
Morocco,2012-02-01,12,0,0,2,2,16
Morocco,2012-02-01,13,0,0,-6,0,7
Morocco,2012-02-01,5,0,0,6,0,11
Morocco,2012-02-01,0,0,0,10,0,10
Morocco,2012-02-01,29,0,-12,30,3,50
Morocco,2012-02-01,7,0,-24,0,1,-16
Morocco,2012-02-01,5,0,-10,3,1,-1
Morocco,2012-02-01,15,0,1,-2,1,15
Morocco,2012-02-01,7,0,0,3,0,10
Morocco,2012-02-01,7,0,0,12,9,28
Morocco,2012-02-01,28,0,0,25,0,53
Morocco,2012-02-01,27,0,0,3,1,31
Morocco,2012-02-01,51,0,0,96,2,149
Morocco,2012-02-01,52,0,0,100,5,157
Morocco,2012-02-01,4,0,0,7,0,11
Morocco,2012-02-01,7,0,0,9,1,17
Morocco,2012-02-01,4,0,-2,14,0,16
Morocco,2012-02-01,22,0,0,41,0,63
Morocco,2012-02-01,17,0,0,9,0,26
Morocco,2012-02-01,23,2,0,2,0,27
Morocco,2012-02-01,26,0,0,6,0,32
Morocco,2012-02-01,25,6,-1,-4,0,26
Morocco,2012-02-01,3,0,0,2,4,9
Morocco,2012-02-01,1,0,0,1,0,2
Morocco,2012-02-01,15,4,-4,3,2,20
Nigeria,2012-02-01,29,0,-2,5,1,33
Nigeria,2012-02-01,1,0,1,11,5,18
Nigeria,2012-02-01,2,0,0,0,0,2
Nigeria,2012-02-01,49,0,0,1,1,51
Nigeria,2012-02-01,21,0,0,6,2,29
Nigeria,2012-02-01,16,0,-2,6,10,30
Nigeria,2012-02-01,14,0,3,22,3,42
Nigeria,2012-02-01,45,4,3,11,0,63
Nigeria,2012-02-01,41,0,4,7,5,57
Nigeria,2012-02-01,27,0,1,26,11,65
Nigeria,2012-02-01,9,4,-2,17,4,32
Nigeria,2012-02-01,11,2,0,10,0,23
Nigeria,2012-02-01,50,2,0,-2,1,51
Nigeria,2012-02-01,33,0,-2,4,3,38
Nigeria,2012-02-01,23,0,0,13,3,39
Nigeria,2012-02-01,165,0,0,147,19,331
Nigeria,2012-02-01,101,0,-3,83,22,203
Nigeria,2012-02-01,26,0,0,21,6,53
Nigeria,2012-02-01,11,0,0,6,1,18
Nigeria,2012-02-01,22,2,0,25,1,50
Nigeria,2012-02-01,38,4,-3,15,4,58
Nigeria,2012-02-01,31,0,0,30,4,65
Nigeria,2012-02-01,74,0,0,93,5,172
Nigeria,2012-02-01,35,0,-6,78,1,108
Nigeria,2012-02-01,42,0,0,10,3,55
Nigeria,2012-02-01,74,0,1,16,8,99
Nigeria,2012-02-01,65,2,-4,72,5,140
Nigeria,2012-02-01,41,2,-1,30,2,74
Nigeria,2012-02-01,75,0,0,38,11,124
Pakistan,2012-02-01,129,0,1,10,3,143
Pakistan,2012-02-01,94,0,-3,93,12,196
Pakistan,2012-02-01,3,14,0,36,0,53
Pakistan,2012-02-01,52,0,2,63,4,121
Pakistan,2012-02-01,40,2,0,42,7,91
Pakistan,2012-02-01,39,0,-10,2,7,38
Pakistan,2012-02-01,74,0,-3,7,5,83
Pakistan,2012-02-01,75,0,-7,54,5,127
Pakistan,2012-02-01,95,0,-2,75,4,172
Pakistan,2012-02-01,123,14,6,42,18,203
Pakistan,2012-02-01,45,0,3,13,9,70
Pakistan,2012-02-01,111,0,1,116,1,229
Pakistan,2012-02-01,128,2,5,170,28,333
Pakistan,2012-02-01,75,0,-1,84,13,171
Pakistan,2012-02-01,110,0,-12,80,17,195
Pakistan,2012-02-01,99,4,-6,79,16,192
Pakistan,2012-02-01,112,0,-2,50,22,182
Pakistan,2012-02-01,71,2,0,19,11,103
Pakistan,2012-02-01,25,2,0,15,5,47
Pakistan,2012-02-01,108,2,-1,-1,18,126
Pakistan,2012-02-01,113,2,-4,42,11,164
Pakistan,2012-02-01,139,2,1,30,20,192
Pakistan,2012-02-01,121,0,-1,27,8,155
Pakistan,2012-02-01,46,0,0,31,13,90
Pakistan,2012-02-01,89,2,-1,12,19,121
Pakistan,2012-02-01,79,0,0,20,34,133
Pakistan,2012-02-01,99,0,-2,31,23,151
Pakistan,2012-02-01,127,0,1,9,12,149
Pakistan,2012-02-01,188,0,0,209,30,427
Sierra Leone,2012-02-01,37,0,0,0,1,38
Sierra Leone,2012-02-01,7,0,0,9,0,16
Sierra Leone,2012-02-01,1,0,0,3,0,4
Sierra Leone,2012-02-01,2,0,0,0,0,2
Sierra Leone,2012-02-01,0,0,0,0,0,0
Sierra Leone,2012-02-01,6,0,0,0,0,6
Sierra Leone,2012-02-01,8,0,0,0,0,8
Sierra Leone,2012-02-01,12,0,0,3,0,15
Sierra Leone,2012-02-01,0,0,0,3,2,5
Sierra Leone,2012-02-01,0,0,0,-2,0,-2
Sierra Leone,2012-02-01,0,0,0,0,0,0
Sierra Leone,2012-02-01,2,0,0,0,0,2
Sierra Leone,2012-02-01,9,0,0,7,0,16
Sierra Leone,2012-02-01,3,0,0,0,0,3
Sierra Leone,2012-02-01,-2,0,0,0,0,-2
Sierra Leone,2012-02-01,5,0,1,3,0,9
Sierra Leone,2012-02-01,3,0,0,0,0,3
Sierra Leone,2012-02-01,0,0,0,3,0,3
Sierra Leone,2012-02-01,0,0,0,-2,0,-2
Sierra Leone,2012-02-01,3,0,0,0,0,3
Sierra Leone,2012-02-01,4,0,0,0,4,8
Sierra Leone,2012-02-01,1,0,0,3,0,4
Sierra Leone,2012-02-01,0,0,0,0,0,0
Sierra Leone,2012-02-01,0,0,0,0,0,0
Sierra Leone,2012-02-01,4,0,0,0,1,5
Sierra Leone,2012-02-01,1,0,0,0,0,1
Sierra Leone,2012-02-01,3,0,0,-2,0,1
Somalia,2012-02-01,89,0,-2,58,4,149
Somalia,2012-02-01,79,0,0,87,12,178
Somalia,2012-02-01,18,0,-2,18,3,37
Somalia,2012-02-01,59,2,0,4,13,78
Somalia,2012-02-01,31,0,0,3,11,45
Somalia,2012-02-01,103,6,0,67,8,184
Somalia,2012-02-01,76,2,0,33,8,119
Somalia,2012-02-01,139,8,-1,6,4,156
Somalia,2012-02-01,58,4,1,37,1,101
Somalia,2012-02-01,100,2,0,17,14,133
Somalia,2012-02-01,33,0,0,28,7,68
Somalia,2012-02-01,63,0,-1,27,16,105
Somalia,2012-02-01,76,0,0,40,10,126
Somalia,2012-02-01,84,4,-1,12,11,110
Somalia,2012-02-01,94,1,1,48,13,157
Somalia,2012-02-01,136,0,-5,37,11,179
Somalia,2012-02-01,100,0,1,22,14,137
Somalia,2012-02-01,41,0,-4,32,10,79
Somalia,2012-02-01,80,2,-1,13,17,111
Somalia,2012-02-01,74,2,0,55,9,140
Somalia,2012-02-01,68,0,-1,27,15,109
Somalia,2012-02-01,125,2,0,57,12,196
Somalia,2012-02-01,136,4,-4,28,16,180
Somalia,2012-02-01,77,2,-4,57,10,142
Somalia,2012-02-01,54,0,-2,42,2,96
Somalia,2012-02-01,54,0,1,22,13,90
Somalia,2012-02-01,76,0,0,12,16,104
Somalia,2012-02-01,173,0,-1,50,9,231
Somalia,2012-02-01,82,6,0,31,14,133
Syria,2012-02-01,289,0,-29,54,22,336
Syria,2012-02-01,245,0,-30,5,71,291
Syria,2012-02-01,87,0,-10,22,20,119
Syria,2012-02-01,607,0,-58,206,322,1077
Syria,2012-02-01,463,0,-23,83,140,663
Syria,2012-02-01,464,0,-31,34,84,551
Syria,2012-02-01,331,2,-4,173,43,545
Syria,2012-02-01,470,0,-15,63,76,594
Syria,2012-02-01,356,10,-11,141,89,585
Syria,2012-02-01,354,8,-4,71,79,508
Syria,2012-02-01,288,2,-10,26,36,342
Syria,2012-02-01,424,8,-9,19,74,516
Syria,2012-02-01,514,4,-11,50,40,597
Syria,2012-02-01,343,6,-1,82,49,479
Syria,2012-02-01,366,6,-36,105,73,514
Syria,2012-02-01,488,12,-46,75,54,583
Syria,2012-02-01,446,4,-8,80,53,575
Syria,2012-02-01,183,0,-4,41,15,235
Syria,2012-02-01,148,4,0,41,17,210
Syria,2012-02-01,229,2,-8,44,31,298
Syria,2012-02-01,380,0,-9,38,62,471
Syria,2012-02-01,785,4,-17,49,57,878
Syria,2012-02-01,511,8,-16,48,89,640
Syria,2012-02-01,574,8,-21,26,63,650
Syria,2012-02-01,380,8,-8,22,56,458
Syria,2012-02-01,352,2,-4,47,42,439
Syria,2012-02-01,331,2,-15,135,45,498
Syria,2012-02-01,538,10,-8,74,79,693
Syria,2012-02-01,303,0,0,45,41,389
Yemen,2012-02-01,71,0,-5,-9,10,67
Yemen,2012-02-01,27,0,0,34,6,67
Yemen,2012-02-01,1,0,0,9,0,10
Yemen,2012-02-01,8,0,-2,12,0,18
Yemen,2012-02-01,15,0,-2,14,4,31
Yemen,2012-02-01,45,0,0,18,3,66
Yemen,2012-02-01,41,0,0,12,6,59
Yemen,2012-02-01,54,0,0,3,8,65
Yemen,2012-02-01,42,0,0,11,12,65
Yemen,2012-02-01,24,0,0,-2,3,25
Yemen,2012-02-01,29,0,1,-4,3,29
Yemen,2012-02-01,40,0,0,0,14,54
Yemen,2012-02-01,37,0,0,-6,6,37
Yemen,2012-02-01,46,0,2,6,9,63
Yemen,2012-02-01,54,0,0,6,3,63
Yemen,2012-02-01,66,0,0,61,1,128
Yemen,2012-02-01,41,0,-1,27,1,68
Yemen,2012-02-01,15,0,0,19,0,34
Yemen,2012-02-01,37,0,-3,12,5,51
Yemen,2012-02-01,41,2,-3,7,15,62
Yemen,2012-02-01,30,0,-2,0,14,42
Yemen,2012-02-01,39,0,1,23,7,70
Yemen,2012-02-01,14,0,2,12,6,34
Yemen,2012-02-01,30,0,-18,9,7,28
Yemen,2012-02-01,97,0,-4,6,31,130
Yemen,2012-02-01,21,0,-2,-1,19,37
Yemen,2012-02-01,35,0,-8,13,5,45
Yemen,2012-02-01,16,2,0,28,3,49
Yemen,2012-02-01,28,0,-4,14,0,38
Afghanistan,2009-01-01,93,0,2,7,7,109
Afghanistan,2009-01-01,302,2,-1,68,44,415
Afghanistan,2009-01-01,114,0,0,110,9,233
Afghanistan,2009-01-01,145,0,0,17,27,189
Afghanistan,2009-01-01,288,0,0,68,32,388
Afghanistan,2009-01-01,263,2,1,34,20,320
Afghanistan,2009-01-01,140,0,0,14,10,164
Afghanistan,2009-01-01,94,0,0,-6,3,91
Afghanistan,2009-01-01,209,0,1,1,13,224
Afghanistan,2009-01-01,68,2,-7,22,2,87
Afghanistan,2009-01-01,235,0,-3,53,13,298
Afghanistan,2009-01-01,131,6,0,29,16,182
Afghanistan,2009-01-01,131,0,0,81,4,216
Afghanistan,2009-01-01,67,4,0,21,5,97
Afghanistan,2009-01-01,211,0,0,87,30,328
Afghanistan,2009-01-01,136,4,0,77,81,298
Afghanistan,2009-01-01,90,0,4,22,63,179
Afghanistan,2009-01-01,212,0,0,44,48,304
Afghanistan,2009-01-01,167,2,0,45,14,228
Afghanistan,2009-01-01,420,0,0,47,25,492
Afghanistan,2009-01-01,290,2,0,103,16,411
Afghanistan,2009-01-01,225,6,2,158,20,411
Afghanistan,2009-01-01,304,10,-1,51,26,390
Afghanistan,2009-01-01,242,2,1,37,23,305
Afghanistan,2009-01-01,166,0,1,41,28,236
Afghanistan,2009-01-01,82,0,-3,44,17,140
Afghanistan,2009-01-01,251,0,2,37,15,305
Afghanistan,2009-01-01,193,0,-6,-12,21,196
Afghanistan,2009-01-01,284,8,-2,29,30,349
Afghanistan,2009-01-01,146,2,0,18,5,171
Afghanistan,2009-01-01,125,2,-2,21,6,152
Albania,2009-01-01,0,0,0,0,0,0
Albania,2009-01-01,7,0,0,0,0,7
Albania,2009-01-01,23,0,-7,-2,18,32
Albania,2009-01-01,22,0,-2,-4,14,30
Albania,2009-01-01,37,0,-2,-4,17,48
Albania,2009-01-01,22,0,0,-12,1,11
Albania,2009-01-01,7,0,-2,-6,0,-1
Albania,2009-01-01,9,0,0,5,4,18
Albania,2009-01-01,19,0,0,9,2,30
Albania,2009-01-01,3,0,0,4,2,9
Albania,2009-01-01,5,0,0,0,0,5
Albania,2009-01-01,8,0,0,6,0,14
Albania,2009-01-01,2,0,0,1,4,7
Albania,2009-01-01,10,0,-2,0,1,9
Albania,2009-01-01,0,0,-4,15,5,16
Albania,2009-01-01,7,0,0,0,1,8
Albania,2009-01-01,0,0,0,0,0,0
Albania,2009-01-01,2,0,0,0,0,2
Albania,2009-01-01,3,0,2,0,0,5
Albania,2009-01-01,0,0,0,0,1,1
Albania,2009-01-01,18,0,-6,12,0,24
Albania,2009-01-01,14,0,0,-8,3,9
Albania,2009-01-01,2,0,0,10,9,21
Albania,2009-01-01,14,0,0,2,4,20
Albania,2009-01-01,0,0,0,3,6,9
Albania,2009-01-01,22,0,0,-3,3,22
Albania,2009-01-01,18,0,0,10,8,36
Albania,2009-01-01,25,0,0,3,3,31
Albania,2009-01-01,-2,0,-2,19,3,18
Albania,2009-01-01,4,0,0,21,0,25
Albania,2009-01-01,11,0,0,0,0,11
Algeria,2009-01-01,2,0,0,0,0,2
Algeria,2009-01-01,6,0,0,1,1,8
Algeria,2009-01-01,0,0,0,12,0,12
Algeria,2009-01-01,9,0,0,0,4,13
Algeria,2009-01-01,13,0,0,3,4,20
Algeria,2009-01-01,6,0,0,9,2,17
Algeria,2009-01-01,12,0,0,0,2,14
Algeria,2009-01-01,5,0,0,15,0,20
Algeria,2009-01-01,18,0,0,24,0,42
Algeria,2009-01-01,11,0,0,0,16,27
Algeria,2009-01-01,0,0,0,-4,6,2
Algeria,2009-01-01,16,0,0,9,0,25
Algeria,2009-01-01,11,0,0,12,0,23
Algeria,2009-01-01,18,0,0,9,0,27
Algeria,2009-01-01,13,0,0,-4,1,10
Algeria,2009-01-01,7,0,0,-2,1,6
Algeria,2009-01-01,13,0,0,0,0,13
Algeria,2009-01-01,13,0,0,-2,1,12
Algeria,2009-01-01,5,0,0,4,1,10
Algeria,2009-01-01,-1,0,0,4,2,5
Algeria,2009-01-01,4,0,0,-3,2,3
Algeria,2009-01-01,3,0,0,16,0,19
Algeria,2009-01-01,8,0,0,7,0,15
Algeria,2009-01-01,-2,0,0,-4,0,-6
Algeria,2009-01-01,2,0,0,0,0,2
Algeria,2009-01-01,10,0,0,9,0,19
Algeria,2009-01-01,-2,0,0,12,1,11
Algeria,2009-01-01,-3,0,0,0,3,0
Algeria,2009-01-01,13,0,0,13,0,26
Algeria,2009-01-01,1,0,0,0,0,1
Algeria,2009-01-01,6,0,0,0,0,6
Bangladesh,2009-01-01,21,0,-6,5,3,23
Bangladesh,2009-01-01,31,24,-1,3,4,61
Bangladesh,2009-01-01,24,0,0,1,3,28
Bangladesh,2009-01-01,22,0,0,3,2,27
Bangladesh,2009-01-01,37,2,0,24,3,66
Bangladesh,2009-01-01,22,0,1,18,5,46
Bangladesh,2009-01-01,13,0,-5,6,1,15
Bangladesh,2009-01-01,4,0,0,-3,1,2
Bangladesh,2009-01-01,21,0,0,-10,3,14
Bangladesh,2009-01-01,6,0,0,4,0,10
Bangladesh,2009-01-01,14,0,0,6,2,22
Bangladesh,2009-01-01,19,0,-4,14,0,29
Bangladesh,2009-01-01,17,0,0,4,2,23
Bangladesh,2009-01-01,8,0,0,3,0,11
Bangladesh,2009-01-01,20,0,0,13,2,35
Bangladesh,2009-01-01,9,0,0,12,2,23
Bangladesh,2009-01-01,18,0,0,24,5,47
Bangladesh,2009-01-01,16,0,1,43,0,60
Bangladesh,2009-01-01,31,0,0,18,6,55
Bangladesh,2009-01-01,14,0,0,10,1,25
Bangladesh,2009-01-01,14,2,0,-4,0,12
Bangladesh,2009-01-01,18,0,1,15,0,34
Bangladesh,2009-01-01,24,0,0,19,4,47
Bangladesh,2009-01-01,3,0,0,5,2,10
Bangladesh,2009-01-01,-4,0,0,11,0,7
Bangladesh,2009-01-01,32,0,1,9,2,44
Bangladesh,2009-01-01,34,2,1,18,2,57
Bangladesh,2009-01-01,11,0,-5,9,2,17
Bangladesh,2009-01-01,23,4,0,36,4,67
Bangladesh,2009-01-01,13,0,1,1,0,15
Bangladesh,2009-01-01,20,0,0,9,0,29
Cameroon,2009-01-01,0,0,0,3,0,3
Cameroon,2009-01-01,0,0,0,3,0,3
Cameroon,2009-01-01,2,0,0,0,0,2
Cameroon,2009-01-01,3,0,0,-4,0,-1
Cameroon,2009-01-01,0,0,0,0,0,0
Cameroon,2009-01-01,3,0,0,-2,0,1
Cameroon,2009-01-01,0,0,0,0,0,0
Cameroon,2009-01-01,-1,0,0,3,0,2
Cameroon,2009-01-01,5,0,0,0,0,5
Cameroon,2009-01-01,2,0,0,0,0,2
Cameroon,2009-01-01,4,0,-6,0,0,-2
Cameroon,2009-01-01,0,0,0,0,0,0
Cameroon,2009-01-01,-1,0,1,0,0,0
Cameroon,2009-01-01,7,0,0,0,0,7
Cameroon,2009-01-01,3,0,0,3,0,6
Cameroon,2009-01-01,5,0,0,0,0,5
Cameroon,2009-01-01,-1,0,0,0,0,-1
Cameroon,2009-01-01,0,0,0,0,0,0
Cameroon,2009-01-01,-1,0,0,3,0,2
Cameroon,2009-01-01,0,0,0,0,0,0
Cameroon,2009-01-01,2,0,0,0,0,2
Cameroon,2009-01-01,2,0,0,0,0,2
Cameroon,2009-01-01,0,0,0,0,0,0
Cameroon,2009-01-01,0,0,0,0,0,0
Cameroon,2009-01-01,3,0,1,12,1,17
Cameroon,2009-01-01,-2,0,0,0,0,-2
Cameroon,2009-01-01,6,0,0,6,4,16
Cameroon,2009-01-01,6,0,0,13,7,26
Cameroon,2009-01-01,7,0,0,11,3,21
Cameroon,2009-01-01,0,0,0,0,0,0
China,2009-01-01,85,0,0,25,4,114
China,2009-01-01,49,0,0,-5,1,45
China,2009-01-01,106,0,0,15,13,134
China,2009-01-01,39,0,0,0,13,52
China,2009-01-01,91,0,0,21,17,129
China,2009-01-01,57,2,-8,16,12,79
China,2009-01-01,39,0,-9,12,3,45
China,2009-01-01,50,0,-6,0,7,51
China,2009-01-01,59,0,7,19,8,93
China,2009-01-01,40,0,0,21,3,64
China,2009-01-01,87,2,0,26,15,130
China,2009-01-01,39,2,0,26,18,85
China,2009-01-01,78,0,0,49,7,134
China,2009-01-01,43,2,0,8,5,58
China,2009-01-01,42,0,2,46,6,96
China,2009-01-01,95,0,0,49,8,152
China,2009-01-01,64,0,-2,30,22,114
China,2009-01-01,91,2,-2,20,6,117
China,2009-01-01,77,0,-2,17,12,104
China,2009-01-01,72,4,9,47,6,138
China,2009-01-01,88,8,-2,65,11,170
China,2009-01-01,56,0,0,103,6,165
China,2009-01-01,98,0,-4,46,14,154
China,2009-01-01,56,0,-4,22,5,79
China,2009-01-01,18,0,1,23,3,45
China,2009-01-01,167,0,1,44,12,224
China,2009-01-01,59,2,3,35,11,110
China,2009-01-01,52,0,-2,47,4,101
China,2009-01-01,83,2,1,53,12,151
China,2009-01-01,115,0,1,17,14,147
China,2009-01-01,136,2,1,20,16,175
Egypt,2009-01-01,207,2,2,19,18,248
Egypt,2009-01-01,147,0,0,42,21,210
Egypt,2009-01-01,136,0,4,10,20,170
Egypt,2009-01-01,172,0,3,4,16,195
Egypt,2009-01-01,145,0,0,16,12,173
Egypt,2009-01-01,254,4,3,47,14,322
Egypt,2009-01-01,269,8,0,17,47,341
Egypt,2009-01-01,193,4,1,18,22,238
Egypt,2009-01-01,178,4,0,10,24,216
Egypt,2009-01-01,85,0,4,-1,21,109
Egypt,2009-01-01,148,0,0,10,19,177
Egypt,2009-01-01,229,0,-12,23,27,267
Egypt,2009-01-01,165,0,-1,18,10,192
Egypt,2009-01-01,42,0,-3,7,4,50
Egypt,2009-01-01,267,4,4,73,11,359
Egypt,2009-01-01,118,0,7,34,5,164
Egypt,2009-01-01,175,0,0,1,30,206
Egypt,2009-01-01,181,0,-2,-4,20,195
Egypt,2009-01-01,121,0,6,12,12,151
Egypt,2009-01-01,53,0,6,10,2,71
Egypt,2009-01-01,56,0,0,8,4,68
Egypt,2009-01-01,119,0,-1,11,4,133
Egypt,2009-01-01,47,0,0,13,4,64
Egypt,2009-01-01,30,0,-1,15,6,50
Egypt,2009-01-01,94,0,-4,46,3,139
Egypt,2009-01-01,31,2,-2,43,6,80
Egypt,2009-01-01,224,0,7,25,9,265
Egypt,2009-01-01,159,0,-2,-6,4,155
Egypt,2009-01-01,91,8,0,18,28,145
Egypt,2009-01-01,33,4,-2,10,8,53
Egypt,2009-01-01,28,0,0,42,4,74
Eritrea,2009-01-01,0,0,0,0,0,0
Eritrea,2009-01-01,0,0,0,0,0,0
Eritrea,2009-01-01,0,0,0,0,0,0
Eritrea,2009-01-01,-3,0,0,0,0,-3
Eritrea,2009-01-01,3,0,0,0,0,3
Eritrea,2009-01-01,0,0,0,0,0,0
Eritrea,2009-01-01,0,0,0,-8,0,-8
Eritrea,2009-01-01,11,0,0,13,0,24
Eritrea,2009-01-01,6,0,0,0,0,6
Eritrea,2009-01-01,0,0,0,0,0,0
Eritrea,2009-01-01,0,0,0,0,0,0
Eritrea,2009-01-01,23,0,0,0,0,23
Eritrea,2009-01-01,-10,0,0,0,0,-10
Eritrea,2009-01-01,6,0,0,0,0,6
Eritrea,2009-01-01,-3,0,0,0,0,-3
Eritrea,2009-01-01,5,0,0,6,0,11
Eritrea,2009-01-01,2,0,0,0,0,2
Eritrea,2009-01-01,0,0,0,-2,0,-2
Eritrea,2009-01-01,0,0,0,9,0,9
Eritrea,2009-01-01,7,0,0,0,0,7
Eritrea,2009-01-01,16,0,0,12,1,29
Eritrea,2009-01-01,0,0,0,0,0,0
Eritrea,2009-01-01,15,0,0,0,0,15
Eritrea,2009-01-01,-2,0,0,6,2,6
Eritrea,2009-01-01,10,0,0,3,1,14
Eritrea,2009-01-01,-4,0,0,3,0,-1
Eritrea,2009-01-01,10,0,0,0,0,10
Eritrea,2009-01-01,0,0,0,6,0,6
Eritrea,2009-01-01,0,0,0,0,0,0
Georgia,2009-01-01,1,0,0,0,0,1
Georgia,2009-01-01,0,0,0,0,2,2
Georgia,2009-01-01,4,0,0,0,0,4
Georgia,2009-01-01,10,0,0,16,0,26
Georgia,2009-01-01,12,0,0,13,0,25
Georgia,2009-01-01,4,0,0,6,0,10
Georgia,2009-01-01,0,0,0,12,0,12
Georgia,2009-01-01,-4,0,0,-1,3,-2
Georgia,2009-01-01,5,0,0,3,1,9
Georgia,2009-01-01,7,0,-4,15,0,18
Georgia,2009-01-01,0,0,0,6,0,6
Georgia,2009-01-01,7,0,-4,9,2,14
Georgia,2009-01-01,13,0,0,1,0,14
Georgia,2009-01-01,6,0,0,0,0,6
Georgia,2009-01-01,5,2,1,3,0,11
Georgia,2009-01-01,22,0,-1,21,0,42
Georgia,2009-01-01,5,0,0,4,3,12
Georgia,2009-01-01,4,0,0,3,1,8
Georgia,2009-01-01,5,0,0,9,0,14
Georgia,2009-01-01,-3,0,0,6,1,4
Georgia,2009-01-01,5,0,0,0,1,6
Georgia,2009-01-01,11,2,-1,0,0,12
Georgia,2009-01-01,4,0,0,4,1,9
Georgia,2009-01-01,8,0,0,0,0,8
Georgia,2009-01-01,9,0,0,0,0,9
Georgia,2009-01-01,16,0,-1,-2,0,13
Georgia,2009-01-01,10,0,0,-2,2,10
Georgia,2009-01-01,13,0,0,3,2,18
Georgia,2009-01-01,13,0,1,6,1,21
Georgia,2009-01-01,9,0,-9,0,2,2
Georgia,2009-01-01,7,0,-2,3,0,8
India,2009-01-01,32,0,0,9,0,41
India,2009-01-01,20,0,0,7,0,27
India,2009-01-01,41,2,0,9,11,63
India,2009-01-01,38,0,-1,4,7,48
India,2009-01-01,6,0,0,11,4,21
India,2009-01-01,22,0,-4,4,2,24
India,2009-01-01,60,0,-4,18,2,76
India,2009-01-01,95,0,-2,15,1,109
India,2009-01-01,117,4,0,-4,16,133
India,2009-01-01,43,0,0,15,9,67
India,2009-01-01,29,0,-5,7,7,38
India,2009-01-01,58,2,-2,17,12,87
India,2009-01-01,52,0,0,26,0,78
India,2009-01-01,2,0,0,18,2,22
India,2009-01-01,32,2,0,23,3,60
India,2009-01-01,95,0,2,32,2,131
India,2009-01-01,36,0,0,7,2,45
India,2009-01-01,77,0,2,8,3,90
India,2009-01-01,72,0,1,21,3,97
India,2009-01-01,77,5,0,20,15,117
India,2009-01-01,51,0,1,25,1,78
India,2009-01-01,56,0,0,22,11,89
India,2009-01-01,48,0,-7,6,6,53
India,2009-01-01,35,0,0,10,1,46
India,2009-01-01,58,0,0,24,8,90
India,2009-01-01,46,0,-4,16,11,69
India,2009-01-01,85,0,0,30,6,121
India,2009-01-01,87,0,2,67,17,173
India,2009-01-01,54,0,1,31,8,94
India,2009-01-01,46,0,0,16,0,62
India,2009-01-01,49,2,0,-2,2,51
Iran,2009-01-01,71,0,1,8,10,90
Iran,2009-01-01,97,0,1,36,9,143
Iran,2009-01-01,109,0,0,-2,21,128
Iran,2009-01-01,136,0,3,31,155,325
Iran,2009-01-01,164,2,2,23,31,222
Iran,2009-01-01,102,0,0,20,29,151
Iran,2009-01-01,43,0,0,6,7,56
Iran,2009-01-01,109,2,0,15,15,141
Iran,2009-01-01,79,0,2,13,7,101
Iran,2009-01-01,19,2,2,-12,7,18
Iran,2009-01-01,463,0,2,4,3,472
Iran,2009-01-01,61,0,2,10,15,88
Iran,2009-01-01,64,0,0,5,14,83
Iran,2009-01-01,81,0,0,19,1,101
Iran,2009-01-01,139,0,-1,63,4,205
Iran,2009-01-01,83,0,2,55,24,164
Iran,2009-01-01,88,4,1,31,6,130
Iran,2009-01-01,30,0,0,7,8,45
Iran,2009-01-01,55,0,0,14,24,93
Iran,2009-01-01,70,0,0,0,20,90
Iran,2009-01-01,108,0,1,20,7,136
Iran,2009-01-01,24,0,0,37,4,65
Iran,2009-01-01,49,0,0,4,6,59
Iran,2009-01-01,19,2,0,9,6,36
Iran,2009-01-01,52,4,0,15,10,81
Iran,2009-01-01,52,2,-2,31,8,91
Iran,2009-01-01,84,0,0,28,13,125
Iran,2009-01-01,46,0,1,27,3,77
Iran,2009-01-01,60,0,0,28,2,90
Iran,2009-01-01,64,0,0,37,3,104
Iran,2009-01-01,19,0,0,21,6,46
Iraq,2009-01-01,106,0,0,21,7,134
Iraq,2009-01-01,124,0,1,42,14,181
Iraq,2009-01-01,85,0,-2,9,25,117
Iraq,2009-01-01,93,0,1,-12,20,102
Iraq,2009-01-01,119,0,-8,14,11,136
Iraq,2009-01-01,107,0,-4,15,14,132
Iraq,2009-01-01,155,0,-1,36,7,197
Iraq,2009-01-01,83,0,0,19,8,110
Iraq,2009-01-01,-24,0,0,23,20,19
Iraq,2009-01-01,46,0,0,25,6,77
Iraq,2009-01-01,103,0,0,0,34,137
Iraq,2009-01-01,105,4,-1,22,8,138
Iraq,2009-01-01,72,0,0,33,6,111
Iraq,2009-01-01,44,0,-4,5,17,62
Iraq,2009-01-01,140,2,-2,50,24,214
Iraq,2009-01-01,181,0,-7,6,12,192
Iraq,2009-01-01,62,0,0,4,3,69
Iraq,2009-01-01,110,0,3,20,20,153
Iraq,2009-01-01,58,0,1,55,26,140
Iraq,2009-01-01,90,0,1,24,6,121
Iraq,2009-01-01,58,0,-1,70,17,144
Iraq,2009-01-01,42,2,-2,57,20,119
Iraq,2009-01-01,37,0,0,40,13,90
Iraq,2009-01-01,60,0,1,28,8,97
Iraq,2009-01-01,68,2,0,17,4,91
Iraq,2009-01-01,91,4,-1,41,18,153
Iraq,2009-01-01,95,0,0,63,35,193
Iraq,2009-01-01,120,4,-2,30,34,186
Iraq,2009-01-01,111,12,-5,16,10,144
Iraq,2009-01-01,119,0,5,50,23,197
Iraq,2009-01-01,171,0,2,35,25,233
Morocco,2009-01-01,8,0,0,6,3,17
Morocco,2009-01-01,8,0,0,3,0,11
Morocco,2009-01-01,0,0,0,3,2,5
Morocco,2009-01-01,45,0,0,0,0,45
Morocco,2009-01-01,7,0,0,0,0,7
Morocco,2009-01-01,5,0,0,0,0,5
Morocco,2009-01-01,2,0,0,0,0,2
Morocco,2009-01-01,3,0,0,6,0,9
Morocco,2009-01-01,15,0,0,0,0,15
Morocco,2009-01-01,24,0,0,-6,0,18
Morocco,2009-01-01,17,0,0,0,0,17
Morocco,2009-01-01,13,0,0,12,3,28
Morocco,2009-01-01,2,0,0,3,0,5
Morocco,2009-01-01,0,0,0,3,0,3
Morocco,2009-01-01,11,0,0,-2,0,9
Morocco,2009-01-01,5,0,0,0,2,7
Morocco,2009-01-01,8,0,0,0,0,8
Morocco,2009-01-01,4,0,0,0,0,4
Morocco,2009-01-01,0,0,0,0,2,2
Morocco,2009-01-01,1,0,0,9,3,13
Morocco,2009-01-01,-3,0,0,0,0,-3
Morocco,2009-01-01,5,0,0,2,0,7
Morocco,2009-01-01,-6,0,-6,0,0,-12
Morocco,2009-01-01,4,0,0,3,0,7
Morocco,2009-01-01,7,0,0,0,0,7
Morocco,2009-01-01,-1,0,0,3,0,2
Morocco,2009-01-01,3,0,0,-2,0,1
Morocco,2009-01-01,2,0,0,0,0,2
Morocco,2009-01-01,0,0,0,0,0,0
Morocco,2009-01-01,10,0,0,3,0,13
Morocco,2009-01-01,0,0,0,6,0,6
Nigeria,2009-01-01,1,0,0,1,2,4
Nigeria,2009-01-01,0,0,0,9,4,13
Nigeria,2009-01-01,1,0,0,3,1,5
Nigeria,2009-01-01,8,0,0,6,3,17
Nigeria,2009-01-01,19,0,0,19,1,39
Nigeria,2009-01-01,14,0,1,0,0,15
Nigeria,2009-01-01,22,0,0,-30,0,-8
Nigeria,2009-01-01,14,0,0,-10,2,6
Nigeria,2009-01-01,15,0,0,15,1,31
Nigeria,2009-01-01,0,0,0,0,-6,-6
Nigeria,2009-01-01,8,0,0,-3,1,6
Nigeria,2009-01-01,23,0,0,16,1,40
Nigeria,2009-01-01,28,0,2,16,1,47
Nigeria,2009-01-01,2,0,0,1,1,4
Nigeria,2009-01-01,13,0,0,1,2,16
Nigeria,2009-01-01,25,0,0,-1,1,25
Nigeria,2009-01-01,15,0,0,14,4,33
Nigeria,2009-01-01,34,0,0,30,0,64
Nigeria,2009-01-01,39,0,0,-3,0,36
Nigeria,2009-01-01,16,0,1,9,0,26
Nigeria,2009-01-01,21,0,0,15,4,40
Nigeria,2009-01-01,37,2,0,15,0,54
Nigeria,2009-01-01,39,2,-2,9,2,50
Nigeria,2009-01-01,24,0,0,19,2,45
Nigeria,2009-01-01,7,0,0,12,1,20
Nigeria,2009-01-01,55,0,-6,12,7,68
Nigeria,2009-01-01,13,0,0,13,1,27
Nigeria,2009-01-01,20,0,0,4,0,24
Nigeria,2009-01-01,17,0,0,6,4,27
Nigeria,2009-01-01,18,0,0,6,0,24
Nigeria,2009-01-01,27,0,0,3,2,32
Pakistan,2009-01-01,82,0,0,28,9,119
Pakistan,2009-01-01,112,0,0,23,5,140
Pakistan,2009-01-01,48,0,0,12,11,71
Pakistan,2009-01-01,67,0,0,3,9,79
Pakistan,2009-01-01,84,0,-1,-7,11,87
Pakistan,2009-01-01,128,0,0,36,12,176
Pakistan,2009-01-01,108,0,-1,39,22,168
Pakistan,2009-01-01,39,0,1,18,6,64
Pakistan,2009-01-01,88,0,1,19,6,114
Pakistan,2009-01-01,76,0,-5,0,6,77
Pakistan,2009-01-01,119,2,0,24,7,152
Pakistan,2009-01-01,110,0,0,52,8,170
Pakistan,2009-01-01,90,2,0,22,18,132
Pakistan,2009-01-01,58,0,0,15,2,75
Pakistan,2009-01-01,88,0,1,114,3,206
Pakistan,2009-01-01,129,2,0,133,3,267
Pakistan,2009-01-01,63,0,0,15,14,92
Pakistan,2009-01-01,35,0,0,22,10,67
Pakistan,2009-01-01,155,0,0,36,20,211
Pakistan,2009-01-01,204,0,0,76,12,292
Pakistan,2009-01-01,134,0,2,77,7,220
Pakistan,2009-01-01,131,2,0,58,11,202
Pakistan,2009-01-01,152,4,0,45,4,205
Pakistan,2009-01-01,137,2,0,42,8,189
Pakistan,2009-01-01,232,0,0,34,6,272
Pakistan,2009-01-01,218,4,1,81,8,312
Pakistan,2009-01-01,168,0,1,61,25,255
Pakistan,2009-01-01,171,4,0,2,19,196
Pakistan,2009-01-01,103,0,0,14,6,123
Pakistan,2009-01-01,171,0,0,66,4,241
Pakistan,2009-01-01,113,2,0,22,10,147
Sierra Leone,2009-01-01,4,0,0,0,0,4
Sierra Leone,2009-01-01,16,0,0,0,0,16
Sierra Leone,2009-01-01,0,0,0,0,1,1
Sierra Leone,2009-01-01,0,0,0,0,0,0
Sierra Leone,2009-01-01,1,0,0,0,1,2
Sierra Leone,2009-01-01,0,0,0,0,0,0
Sierra Leone,2009-01-01,2,0,3,0,0,5
Sierra Leone,2009-01-01,-2,2,0,8,0,8
Sierra Leone,2009-01-01,6,0,0,42,0,48
Sierra Leone,2009-01-01,0,0,0,42,2,44
Sierra Leone,2009-01-01,0,0,0,9,1,10
Sierra Leone,2009-01-01,3,0,0,0,0,3
Sierra Leone,2009-01-01,9,0,0,-2,0,7
Sierra Leone,2009-01-01,0,0,0,0,0,0
Sierra Leone,2009-01-01,2,0,0,-2,3,3
Sierra Leone,2009-01-01,4,4,0,3,0,11
Sierra Leone,2009-01-01,0,0,0,0,0,0
Sierra Leone,2009-01-01,0,0,0,-2,0,-2
Sierra Leone,2009-01-01,2,0,0,9,0,11
Sierra Leone,2009-01-01,0,0,0,0,0,0
Sierra Leone,2009-01-01,3,0,0,0,0,3
Sierra Leone,2009-01-01,4,0,0,0,0,4
Sierra Leone,2009-01-01,2,0,0,0,0,2
Sierra Leone,2009-01-01,0,0,0,6,0,6
Sierra Leone,2009-01-01,2,0,0,6,2,10
Sierra Leone,2009-01-01,13,0,0,3,0,16
Sierra Leone,2009-01-01,12,2,0,3,0,17
Sierra Leone,2009-01-01,-1,0,0,0,0,-1
Sierra Leone,2009-01-01,1,0,0,-1,0,0
Sierra Leone,2009-01-01,0,0,-1,-1,0,-2
Sierra Leone,2009-01-01,2,0,0,18,0,20
Somalia,2009-01-01,71,0,0,9,1,81
Somalia,2009-01-01,81,0,0,-2,25,104
Somalia,2009-01-01,19,0,0,0,20,39
Somalia,2009-01-01,49,0,-4,-6,13,52
Somalia,2009-01-01,29,0,0,38,21,88
Somalia,2009-01-01,71,0,0,9,22,102
Somalia,2009-01-01,43,0,0,-44,2,1
Somalia,2009-01-01,87,0,0,-18,2,71
Somalia,2009-01-01,95,0,-2,-38,9,64
Somalia,2009-01-01,37,2,-5,-55,4,-17
Somalia,2009-01-01,66,0,0,-22,4,48
Somalia,2009-01-01,35,6,-2,-5,7,41
Somalia,2009-01-01,37,0,0,-77,2,-38
Somalia,2009-01-01,53,0,0,5,0,58
Somalia,2009-01-01,47,2,0,29,7,85
Somalia,2009-01-01,49,0,0,1,6,56
Somalia,2009-01-01,6,0,0,8,2,16
Somalia,2009-01-01,3,0,0,5,0,8
Somalia,2009-01-01,17,0,0,7,6,30
Somalia,2009-01-01,31,0,0,15,1,47
Somalia,2009-01-01,9,0,0,-9,5,5
Somalia,2009-01-01,35,0,4,-4,0,35
Somalia,2009-01-01,41,2,0,11,7,61
Somalia,2009-01-01,7,0,2,-32,5,-18
Somalia,2009-01-01,-11,0,0,9,0,-2
Somalia,2009-01-01,7,0,-2,2,-2,5
Somalia,2009-01-01,46,0,0,21,3,70
Somalia,2009-01-01,49,0,0,3,3,55
Somalia,2009-01-01,44,0,3,60,3,110
Somalia,2009-01-01,40,0,0,38,2,80
Somalia,2009-01-01,-8,0,0,28,1,21
Syria,2009-01-01,31,0,0,0,5,36
Syria,2009-01-01,45,0,0,11,9,65
Syria,2009-01-01,42,0,0,11,3,56
Syria,2009-01-01,26,0,0,0,8,34
Syria,2009-01-01,28,0,0,0,1,29
Syria,2009-01-01,54,0,0,9,0,63
Syria,2009-01-01,32,0,0,9,1,42
Syria,2009-01-01,41,0,0,3,0,44
Syria,2009-01-01,9,0,0,3,4,16
Syria,2009-01-01,17,0,1,0,0,18
Syria,2009-01-01,43,0,0,0,13,56
Syria,2009-01-01,44,0,0,0,9,53
Syria,2009-01-01,30,0,0,6,15,51
Syria,2009-01-01,24,0,0,0,0,24
Syria,2009-01-01,28,0,0,-2,5,31
Syria,2009-01-01,32,0,0,-3,1,30
Syria,2009-01-01,47,0,0,24,0,71
Syria,2009-01-01,4,0,0,2,2,8
Syria,2009-01-01,55,0,0,3,8,66
Syria,2009-01-01,23,0,0,19,7,49
Syria,2009-01-01,16,0,0,13,4,33
Syria,2009-01-01,3,0,0,9,0,12
Syria,2009-01-01,7,0,0,4,2,13
Syria,2009-01-01,34,0,1,6,6,47
Syria,2009-01-01,3,0,0,0,4,7
Syria,2009-01-01,10,0,0,0,0,10
Syria,2009-01-01,40,0,0,16,4,60
Syria,2009-01-01,15,2,0,-2,2,17
Syria,2009-01-01,20,6,0,7,1,34
Syria,2009-01-01,25,0,0,8,11,44
Syria,2009-01-01,6,0,0,0,12,18
Yemen,2009-01-01,9,0,0,-3,5,11
Yemen,2009-01-01,16,0,0,18,6,40
Yemen,2009-01-01,22,0,0,4,2,28
Yemen,2009-01-01,-2,0,0,6,6,10
Yemen,2009-01-01,1,0,0,0,3,4
Yemen,2009-01-01,3,0,0,6,0,9
Yemen,2009-01-01,2,0,0,6,0,8
Yemen,2009-01-01,9,0,0,0,0,9
Yemen,2009-01-01,12,0,0,5,2,19
Yemen,2009-01-01,7,0,0,6,2,15
Yemen,2009-01-01,10,0,0,14,1,25
Yemen,2009-01-01,2,0,0,21,0,23
Yemen,2009-01-01,17,0,0,0,2,19
Yemen,2009-01-01,3,0,0,-4,0,-1
Yemen,2009-01-01,40,0,0,-2,3,41
Yemen,2009-01-01,22,0,0,0,5,27
Yemen,2009-01-01,17,0,0,0,0,17
Yemen,2009-01-01,8,0,0,20,2,30
Yemen,2009-01-01,14,0,0,30,0,44
Yemen,2009-01-01,6,0,0,2,4,12
Yemen,2009-01-01,18,0,0,1,3,22
Yemen,2009-01-01,16,0,0,23,0,39
Yemen,2009-01-01,66,0,0,-1,0,65
Yemen,2009-01-01,49,0,-1,54,1,103
Yemen,2009-01-01,21,0,0,9,0,30
Yemen,2009-01-01,110,4,2,62,0,178
Yemen,2009-01-01,65,0,2,0,0,67
Yemen,2009-01-01,0,0,0,-2,0,-2
Yemen,2009-01-01,29,0,4,25,5,63
Yemen,2009-01-01,9,0,1,0,5,15
Yemen,2009-01-01,0,0,1,12,0,13
Afghanistan,2012-03-01,264,0,3,52,17,336
Afghanistan,2012-03-01,323,0,2,52,36,413
Afghanistan,2012-03-01,161,0,-1,19,6,185
Afghanistan,2012-03-01,139,0,0,24,15,178
Afghanistan,2012-03-01,166,0,0,37,20,223
Afghanistan,2012-03-01,222,0,0,109,23,354
Afghanistan,2012-03-01,294,2,-7,26,21,336
Afghanistan,2012-03-01,311,0,-2,40,11,360
Afghanistan,2012-03-01,161,0,0,29,19,209
Afghanistan,2012-03-01,185,4,1,1,9,200
Afghanistan,2012-03-01,551,0,2,65,32,650
Afghanistan,2012-03-01,614,2,2,107,56,781
Afghanistan,2012-03-01,777,4,-1,87,64,931
Afghanistan,2012-03-01,475,2,-2,86,63,624
Afghanistan,2012-03-01,418,4,3,230,54,709
Afghanistan,2012-03-01,407,14,-4,122,50,589
Afghanistan,2012-03-01,349,0,0,125,31,505
Afghanistan,2012-03-01,323,4,0,101,13,441
Afghanistan,2012-03-01,381,0,-1,102,18,500
Afghanistan,2012-03-01,426,0,5,121,29,581
Afghanistan,2012-03-01,589,0,-6,311,65,959
Afghanistan,2012-03-01,660,2,1,290,64,1017
Afghanistan,2012-03-01,502,2,1,251,27,783
Afghanistan,2012-03-01,256,10,0,43,11,320
Afghanistan,2012-03-01,281,2,-3,84,27,391
Afghanistan,2012-03-01,422,8,0,90,31,551
Afghanistan,2012-03-01,395,0,-2,62,35,490
Afghanistan,2012-03-01,319,6,0,74,38,437
Afghanistan,2012-03-01,293,2,1,68,27,391
Afghanistan,2012-03-01,113,0,-2,18,7,136
Afghanistan,2012-03-01,133,2,0,22,7,164
Albania,2012-03-01,15,0,4,-2,4,21
Albania,2012-03-01,8,0,0,3,1,12
Albania,2012-03-01,2,0,0,0,1,3
Albania,2012-03-01,3,0,0,6,0,9
Albania,2012-03-01,0,0,0,0,2,2
Albania,2012-03-01,11,0,0,9,0,20
Albania,2012-03-01,2,0,1,0,2,5
Albania,2012-03-01,9,0,1,0,0,10
Albania,2012-03-01,3,0,0,-2,0,1
Albania,2012-03-01,27,0,0,-2,4,29
Albania,2012-03-01,-3,0,0,0,0,-3
Albania,2012-03-01,3,0,0,0,3,6
Albania,2012-03-01,5,0,0,-4,1,2
Albania,2012-03-01,11,0,0,-2,0,9
Albania,2012-03-01,2,0,0,5,0,7
Albania,2012-03-01,8,0,0,-5,2,5
Albania,2012-03-01,15,0,0,-7,5,13
Albania,2012-03-01,0,0,0,0,1,1
Albania,2012-03-01,7,0,0,2,3,12
Albania,2012-03-01,35,0,0,-2,11,44
Albania,2012-03-01,23,0,1,15,4,43
Albania,2012-03-01,5,0,0,-6,2,1
Albania,2012-03-01,15,0,1,6,0,22
Albania,2012-03-01,40,0,1,13,2,56
Albania,2012-03-01,3,0,0,3,0,6
Albania,2012-03-01,9,0,0,0,2,11
Albania,2012-03-01,12,0,0,1,2,15
Albania,2012-03-01,14,0,-5,4,0,13
Albania,2012-03-01,3,0,0,0,0,3
Albania,2012-03-01,10,0,0,0,3,13
Albania,2012-03-01,2,0,0,12,0,14
Algeria,2012-03-01,16,0,3,8,2,29
Algeria,2012-03-01,114,0,3,-8,2,111
Algeria,2012-03-01,19,0,0,11,3,33
Algeria,2012-03-01,9,0,0,-1,0,8
Algeria,2012-03-01,9,0,0,4,0,13
Algeria,2012-03-01,18,0,0,5,0,23
Algeria,2012-03-01,31,0,1,12,3,47
Algeria,2012-03-01,16,0,0,0,0,16
Algeria,2012-03-01,4,0,0,0,0,4
Algeria,2012-03-01,-1,0,0,7,0,6
Algeria,2012-03-01,21,0,0,0,0,21
Algeria,2012-03-01,42,0,1,22,0,65
Algeria,2012-03-01,18,2,1,10,4,35
Algeria,2012-03-01,31,0,1,3,4,39
Algeria,2012-03-01,23,0,1,1,1,26
Algeria,2012-03-01,27,0,-2,0,1,26
Algeria,2012-03-01,20,0,0,15,1,36
Algeria,2012-03-01,9,0,0,10,0,19
Algeria,2012-03-01,25,0,-2,0,0,23
Algeria,2012-03-01,18,0,0,3,2,23
Algeria,2012-03-01,316,0,0,49,3,368
Algeria,2012-03-01,333,0,-2,28,9,368
Algeria,2012-03-01,145,0,0,6,4,155
Algeria,2012-03-01,80,0,0,42,0,122
Algeria,2012-03-01,29,0,2,4,3,38
Algeria,2012-03-01,47,0,0,8,1,56
Algeria,2012-03-01,86,0,0,27,6,119
Algeria,2012-03-01,48,0,0,31,2,81
Algeria,2012-03-01,127,0,0,63,22,212
Algeria,2012-03-01,72,0,-4,33,4,105
Algeria,2012-03-01,27,0,0,24,0,51
Bangladesh,2012-03-01,20,0,0,9,1,30
Bangladesh,2012-03-01,10,0,-4,4,3,13
Bangladesh,2012-03-01,16,0,-2,4,5,23
Bangladesh,2012-03-01,19,0,-2,-1,1,17
Bangladesh,2012-03-01,30,0,-1,-4,1,26
Bangladesh,2012-03-01,21,0,0,7,1,29
Bangladesh,2012-03-01,8,0,0,9,0,17
Bangladesh,2012-03-01,17,0,0,5,0,22
Bangladesh,2012-03-01,3,0,0,0,2,5
Bangladesh,2012-03-01,5,0,0,0,3,8
Bangladesh,2012-03-01,17,0,0,9,0,26
Bangladesh,2012-03-01,13,0,-2,10,6,27
Bangladesh,2012-03-01,14,0,0,12,3,29
Bangladesh,2012-03-01,6,0,0,33,4,43
Bangladesh,2012-03-01,9,0,0,0,0,9
Bangladesh,2012-03-01,43,4,0,3,0,50
Bangladesh,2012-03-01,12,0,0,-2,4,14
Bangladesh,2012-03-01,9,0,0,4,1,14
Bangladesh,2012-03-01,4,0,0,-1,1,4
Bangladesh,2012-03-01,23,0,0,3,9,35
Bangladesh,2012-03-01,25,0,0,9,1,35
Bangladesh,2012-03-01,24,0,0,7,7,38
Bangladesh,2012-03-01,35,0,0,12,5,52
Bangladesh,2012-03-01,24,0,1,3,4,32
Bangladesh,2012-03-01,35,0,0,3,3,41
Bangladesh,2012-03-01,50,0,1,24,4,79
Bangladesh,2012-03-01,23,0,0,3,5,31
Bangladesh,2012-03-01,4,2,1,25,2,34
Bangladesh,2012-03-01,15,2,0,9,5,31
Bangladesh,2012-03-01,2,0,0,9,0,11
Bangladesh,2012-03-01,5,0,0,6,2,13
Cameroon,2012-03-01,10,0,0,0,0,10
Cameroon,2012-03-01,29,0,0,0,0,29
Cameroon,2012-03-01,3,0,0,0,0,3
Cameroon,2012-03-01,0,0,0,0,0,0
Cameroon,2012-03-01,3,0,0,1,0,4
Cameroon,2012-03-01,5,0,0,0,0,5
Cameroon,2012-03-01,4,2,0,0,0,6
Cameroon,2012-03-01,0,0,0,3,0,3
Cameroon,2012-03-01,2,0,0,0,0,2
Cameroon,2012-03-01,-4,0,0,3,0,-1
Cameroon,2012-03-01,-6,0,0,27,0,21
Cameroon,2012-03-01,8,0,0,3,0,11
Cameroon,2012-03-01,13,0,0,3,0,16
Cameroon,2012-03-01,2,0,0,0,0,2
Cameroon,2012-03-01,17,0,0,6,2,25
Cameroon,2012-03-01,25,0,0,3,0,28
Cameroon,2012-03-01,9,0,0,1,0,10
Cameroon,2012-03-01,0,0,0,-2,0,-2
Cameroon,2012-03-01,0,0,0,-2,0,-2
Cameroon,2012-03-01,2,0,0,3,0,5
Cameroon,2012-03-01,0,0,0,-3,0,-3
Cameroon,2012-03-01,1,0,0,-2,0,-1
Cameroon,2012-03-01,0,0,0,0,0,0
Cameroon,2012-03-01,0,0,0,0,0,0
Cameroon,2012-03-01,2,0,0,0,0,2
Cameroon,2012-03-01,3,0,0,3,0,6
Cameroon,2012-03-01,2,0,0,0,0,2
Cameroon,2012-03-01,0,0,0,0,0,0
Cameroon,2012-03-01,0,0,0,0,0,0
Cameroon,2012-03-01,3,0,0,3,0,6
China,2012-03-01,186,6,3,31,25,251
China,2012-03-01,168,2,-12,48,42,248
China,2012-03-01,43,0,-1,44,17,103
China,2012-03-01,156,4,-3,56,24,237
China,2012-03-01,202,4,1,31,24,262
China,2012-03-01,145,6,-5,42,31,219
China,2012-03-01,126,0,-15,54,42,207
China,2012-03-01,194,10,-14,81,28,299
China,2012-03-01,169,0,-4,67,15,247
China,2012-03-01,100,2,7,84,18,211
China,2012-03-01,69,0,-6,46,16,125
China,2012-03-01,205,0,-6,46,34,279
China,2012-03-01,162,2,1,142,23,330
China,2012-03-01,121,4,0,83,28,236
China,2012-03-01,118,2,-15,43,15,163
China,2012-03-01,170,10,1,80,25,286
China,2012-03-01,88,0,0,65,12,165
China,2012-03-01,113,6,0,109,6,234
China,2012-03-01,147,6,0,92,29,274
China,2012-03-01,156,4,-5,72,36,263
China,2012-03-01,211,8,-13,91,22,319
China,2012-03-01,190,2,-16,50,31,257
China,2012-03-01,188,2,-22,58,29,255
China,2012-03-01,102,6,-10,55,9,162
China,2012-03-01,147,6,-1,11,19,182
China,2012-03-01,233,4,-5,58,89,379
China,2012-03-01,188,0,-4,88,27,299
China,2012-03-01,238,2,-3,87,61,385
China,2012-03-01,81,4,-1,42,14,140
China,2012-03-01,97,2,0,39,2,140
China,2012-03-01,50,4,2,30,3,89
Egypt,2012-03-01,57,2,-4,73,11,139
Egypt,2012-03-01,50,0,-2,67,26,141
Egypt,2012-03-01,109,0,-2,64,19,190
Egypt,2012-03-01,107,0,-4,49,8,160
Egypt,2012-03-01,56,0,0,16,10,82
Egypt,2012-03-01,73,4,-2,12,4,91
Egypt,2012-03-01,38,2,-4,38,14,88
Egypt,2012-03-01,56,0,0,57,17,130
Egypt,2012-03-01,134,0,0,58,7,199
Egypt,2012-03-01,166,0,2,17,15,200
Egypt,2012-03-01,185,0,0,41,14,240
Egypt,2012-03-01,270,0,2,17,20,309
Egypt,2012-03-01,189,2,1,16,14,222
Egypt,2012-03-01,64,0,0,16,10,90
Egypt,2012-03-01,67,2,0,36,3,108
Egypt,2012-03-01,45,2,1,-3,3,48
Egypt,2012-03-01,46,4,2,11,7,70
Egypt,2012-03-01,93,0,0,117,13,223
Egypt,2012-03-01,69,2,-5,123,16,205
Egypt,2012-03-01,41,0,-6,61,6,102
Egypt,2012-03-01,60,2,1,36,9,108
Egypt,2012-03-01,53,0,0,31,10,94
Egypt,2012-03-01,71,0,0,37,11,119
Egypt,2012-03-01,31,6,0,1,20,58
Egypt,2012-03-01,25,0,0,17,16,58
Egypt,2012-03-01,21,0,-14,51,21,79
Egypt,2012-03-01,66,0,-8,40,12,110
Egypt,2012-03-01,68,0,0,44,16,128
Egypt,2012-03-01,44,0,-4,66,15,121
Egypt,2012-03-01,12,0,-4,24,3,35
Egypt,2012-03-01,10,0,0,10,5,25
Eritrea,2012-03-01,0,0,0,0,0,0
Eritrea,2012-03-01,3,0,0,6,0,9
Eritrea,2012-03-01,9,0,0,3,4,16
Eritrea,2012-03-01,6,0,0,6,0,12
Eritrea,2012-03-01,4,0,0,-6,0,-2
Eritrea,2012-03-01,0,0,0,-12,1,-11
Eritrea,2012-03-01,11,0,0,-1,2,12
Eritrea,2012-03-01,2,0,0,0,0,2
Eritrea,2012-03-01,0,0,0,3,0,3
Eritrea,2012-03-01,0,0,0,3,0,3
Eritrea,2012-03-01,8,0,0,0,0,8
Eritrea,2012-03-01,1,0,0,0,0,1
Eritrea,2012-03-01,1,0,0,-4,0,-3
Eritrea,2012-03-01,94,0,0,1,2,97
Eritrea,2012-03-01,57,0,0,0,6,63
Eritrea,2012-03-01,19,0,0,0,2,21
Eritrea,2012-03-01,0,0,0,0,0,0
Eritrea,2012-03-01,3,0,0,9,0,12
Eritrea,2012-03-01,9,0,0,0,0,9
Eritrea,2012-03-01,22,0,0,1,0,23
Eritrea,2012-03-01,4,0,0,0,0,4
Eritrea,2012-03-01,0,0,0,6,0,6
Eritrea,2012-03-01,5,0,0,0,0,5
Eritrea,2012-03-01,3,0,0,0,0,3
Eritrea,2012-03-01,77,0,0,0,0,77
Eritrea,2012-03-01,10,0,0,0,2,12
Eritrea,2012-03-01,0,0,0,1,0,1
Eritrea,2012-03-01,1,0,0,6,0,7
Eritrea,2012-03-01,0,0,0,0,0,0
Eritrea,2012-03-01,0,0,0,0,0,0
Georgia,2012-03-01,65,2,0,40,9,116
Georgia,2012-03-01,22,0,1,0,5,28
Georgia,2012-03-01,44,4,0,-3,2,47
Georgia,2012-03-01,25,0,0,0,2,27
Georgia,2012-03-01,59,2,0,33,12,106
Georgia,2012-03-01,82,8,1,50,29,170
Georgia,2012-03-01,97,0,-1,21,13,130
Georgia,2012-03-01,39,0,-2,17,5,59
Georgia,2012-03-01,55,0,0,18,5,78
Georgia,2012-03-01,19,0,0,18,7,44
Georgia,2012-03-01,5,2,0,25,1,33
Georgia,2012-03-01,27,2,-2,24,5,56
Georgia,2012-03-01,103,0,0,43,12,158
Georgia,2012-03-01,128,4,0,35,14,181
Georgia,2012-03-01,169,2,0,56,13,240
Georgia,2012-03-01,56,0,0,41,9,106
Georgia,2012-03-01,18,0,0,31,3,52
Georgia,2012-03-01,27,0,0,12,1,40
Georgia,2012-03-01,21,0,-1,51,10,81
Georgia,2012-03-01,53,2,-1,57,10,121
Georgia,2012-03-01,47,6,1,21,9,84
Georgia,2012-03-01,50,2,-1,39,10,100
Georgia,2012-03-01,12,0,0,5,2,19
Georgia,2012-03-01,20,2,-4,25,5,48
Georgia,2012-03-01,34,0,0,4,2,40
Georgia,2012-03-01,80,0,0,51,3,134
Georgia,2012-03-01,79,0,-2,46,2,125
Georgia,2012-03-01,133,0,0,60,14,207
Georgia,2012-03-01,76,8,-9,20,10,105
Georgia,2012-03-01,10,4,-1,1,1,15
Georgia,2012-03-01,5,2,-1,12,2,20
India,2012-03-01,124,8,2,82,13,229
India,2012-03-01,106,0,0,21,15,142
India,2012-03-01,69,2,-2,22,12,103
India,2012-03-01,44,2,2,10,13,71
India,2012-03-01,146,0,0,30,12,188
India,2012-03-01,57,0,1,66,16,140
India,2012-03-01,50,0,1,45,14,110
India,2012-03-01,42,0,-1,21,8,70
India,2012-03-01,55,0,-1,31,19,104
India,2012-03-01,41,2,-2,16,13,70
India,2012-03-01,34,0,-2,30,6,68
India,2012-03-01,89,0,-6,33,4,120
India,2012-03-01,83,0,-11,15,12,99
India,2012-03-01,132,0,1,44,7,184
India,2012-03-01,100,0,-13,48,15,150
India,2012-03-01,65,2,-5,54,12,128
India,2012-03-01,47,0,-8,43,10,92
India,2012-03-01,70,0,-8,34,11,107
India,2012-03-01,71,0,-3,37,22,127
India,2012-03-01,119,0,-3,48,8,172
India,2012-03-01,122,0,-3,21,25,165
India,2012-03-01,117,2,-6,41,9,163
India,2012-03-01,84,2,-1,41,14,140
India,2012-03-01,61,0,0,28,13,102
India,2012-03-01,69,2,-5,36,15,117
India,2012-03-01,94,0,0,48,28,170
India,2012-03-01,68,8,-1,20,33,128
India,2012-03-01,103,6,-2,27,21,155
India,2012-03-01,49,0,0,-2,8,55
India,2012-03-01,23,2,1,-2,0,24
India,2012-03-01,55,0,-2,32,6,91
Iran,2012-03-01,235,2,1,109,22,369
Iran,2012-03-01,169,0,6,24,35,234
Iran,2012-03-01,89,0,2,55,15,161
Iran,2012-03-01,162,4,0,11,24,201
Iran,2012-03-01,299,2,1,136,27,465
Iran,2012-03-01,389,2,4,103,25,523
Iran,2012-03-01,263,6,-4,124,36,425
Iran,2012-03-01,179,0,9,59,24,271
Iran,2012-03-01,178,0,0,70,29,277
Iran,2012-03-01,172,4,1,48,23,248
Iran,2012-03-01,227,0,2,69,15,313
Iran,2012-03-01,296,2,1,108,28,435
Iran,2012-03-01,241,10,0,49,13,313
Iran,2012-03-01,266,0,1,81,16,364
Iran,2012-03-01,266,0,8,102,39,415
Iran,2012-03-01,146,2,0,43,13,204
Iran,2012-03-01,105,2,0,36,17,160
Iran,2012-03-01,52,6,-2,20,6,82
Iran,2012-03-01,116,0,1,23,5,145
Iran,2012-03-01,183,0,1,58,21,263
Iran,2012-03-01,166,4,7,78,22,277
Iran,2012-03-01,157,0,6,41,14,218
Iran,2012-03-01,162,0,0,53,27,242
Iran,2012-03-01,98,2,-12,17,12,117
Iran,2012-03-01,79,0,0,40,9,128
Iran,2012-03-01,130,0,1,43,22,196
Iran,2012-03-01,100,0,0,15,13,128
Iran,2012-03-01,130,0,-4,27,30,183
Iran,2012-03-01,166,0,-3,10,26,199
Iran,2012-03-01,37,0,2,18,13,70
Iran,2012-03-01,87,0,-6,62,5,148
Iraq,2012-03-01,196,0,0,37,20,253
Iraq,2012-03-01,101,0,0,33,17,151
Iraq,2012-03-01,52,0,0,18,1,71
Iraq,2012-03-01,75,0,-4,7,5,83
Iraq,2012-03-01,103,0,3,51,9,166
Iraq,2012-03-01,93,6,2,40,12,153
Iraq,2012-03-01,108,0,0,38,21,167
Iraq,2012-03-01,121,2,0,32,20,175
Iraq,2012-03-01,99,0,-4,18,12,125
Iraq,2012-03-01,84,0,0,3,2,89
Iraq,2012-03-01,81,0,0,25,3,109
Iraq,2012-03-01,231,2,0,26,17,276
Iraq,2012-03-01,240,0,0,55,16,311
Iraq,2012-03-01,151,0,3,47,9,210
Iraq,2012-03-01,179,6,4,94,12,295
Iraq,2012-03-01,350,10,-4,32,38,426
Iraq,2012-03-01,295,0,-10,63,56,404
Iraq,2012-03-01,230,2,2,78,23,335
Iraq,2012-03-01,117,0,1,44,14,176
Iraq,2012-03-01,218,6,2,36,10,272
Iraq,2012-03-01,274,0,0,30,25,329
Iraq,2012-03-01,213,4,0,89,25,331
Iraq,2012-03-01,151,4,5,80,18,258
Iraq,2012-03-01,177,6,1,70,13,267
Iraq,2012-03-01,170,4,2,55,14,245
Iraq,2012-03-01,202,2,0,65,14,283
Iraq,2012-03-01,132,2,1,35,28,198
Iraq,2012-03-01,170,0,0,50,18,238
Iraq,2012-03-01,122,6,0,60,7,195
Iraq,2012-03-01,52,4,0,16,0,72
Iraq,2012-03-01,29,0,-7,15,5,42
Morocco,2012-03-01,17,0,0,18,0,35
Morocco,2012-03-01,16,0,0,18,1,35
Morocco,2012-03-01,6,0,0,12,1,19
Morocco,2012-03-01,19,0,0,3,0,22
Morocco,2012-03-01,13,0,0,0,2,15
Morocco,2012-03-01,7,0,0,9,2,18
Morocco,2012-03-01,23,0,0,7,6,36
Morocco,2012-03-01,14,0,0,12,0,26
Morocco,2012-03-01,31,2,0,-4,5,34
Morocco,2012-03-01,21,2,0,5,4,32
Morocco,2012-03-01,11,0,0,0,4,15
Morocco,2012-03-01,13,0,0,0,0,13
Morocco,2012-03-01,13,0,0,2,1,16
Morocco,2012-03-01,37,0,0,1,9,47
Morocco,2012-03-01,21,0,0,24,4,49
Morocco,2012-03-01,6,0,0,21,9,36
Morocco,2012-03-01,3,0,0,23,23,49
Morocco,2012-03-01,7,0,0,9,7,23
Morocco,2012-03-01,8,0,0,19,2,29
Morocco,2012-03-01,34,0,0,4,1,39
Morocco,2012-03-01,73,0,0,12,2,87
Morocco,2012-03-01,24,0,0,3,4,31
Morocco,2012-03-01,6,0,0,4,0,10
Morocco,2012-03-01,4,0,0,0,7,11
Morocco,2012-03-01,8,0,0,1,0,9
Morocco,2012-03-01,19,0,0,0,3,22
Morocco,2012-03-01,19,0,0,0,0,19
Morocco,2012-03-01,0,0,0,3,0,3
Morocco,2012-03-01,4,0,0,3,0,7
Morocco,2012-03-01,3,0,0,0,0,3
Morocco,2012-03-01,0,0,0,0,0,0
Nigeria,2012-03-01,39,0,-2,22,6,65
Nigeria,2012-03-01,55,0,-1,14,9,77
Nigeria,2012-03-01,10,0,0,12,3,25
Nigeria,2012-03-01,14,0,-1,16,13,42
Nigeria,2012-03-01,35,0,0,58,11,104
Nigeria,2012-03-01,40,0,0,21,7,68
Nigeria,2012-03-01,21,0,0,18,7,46
Nigeria,2012-03-01,59,0,2,54,7,122
Nigeria,2012-03-01,118,2,0,39,9,168
Nigeria,2012-03-01,53,4,1,35,2,95
Nigeria,2012-03-01,54,0,0,3,23,80
Nigeria,2012-03-01,78,0,0,16,12,106
Nigeria,2012-03-01,37,0,-2,26,1,62
Nigeria,2012-03-01,42,0,0,2,7,51
Nigeria,2012-03-01,42,0,1,34,9,86
Nigeria,2012-03-01,21,0,-2,14,3,36
Nigeria,2012-03-01,11,0,0,18,3,32
Nigeria,2012-03-01,20,0,0,6,3,29
Nigeria,2012-03-01,43,0,-1,10,2,54
Nigeria,2012-03-01,42,0,-5,13,5,55
Nigeria,2012-03-01,58,0,-4,15,4,73
Nigeria,2012-03-01,45,0,-3,22,4,68
Nigeria,2012-03-01,56,0,-11,35,7,87
Nigeria,2012-03-01,18,0,0,12,0,30
Nigeria,2012-03-01,15,0,1,-7,3,12
Nigeria,2012-03-01,46,0,-9,14,-2,49
Nigeria,2012-03-01,22,0,-8,57,6,77
Nigeria,2012-03-01,3,0,-2,40,0,41
Nigeria,2012-03-01,16,0,1,18,4,39
Nigeria,2012-03-01,0,0,0,3,1,4
Nigeria,2012-03-01,34,0,0,12,0,46
Pakistan,2012-03-01,143,0,-2,63,18,222
Pakistan,2012-03-01,141,0,1,81,21,244
Pakistan,2012-03-01,64,0,0,28,11,103
Pakistan,2012-03-01,32,0,0,4,5,41
Pakistan,2012-03-01,66,0,0,44,2,112
Pakistan,2012-03-01,49,0,2,60,6,117
Pakistan,2012-03-01,70,2,0,22,19,113
Pakistan,2012-03-01,69,2,0,44,1,116
Pakistan,2012-03-01,63,0,0,57,13,133
Pakistan,2012-03-01,61,0,0,14,10,85
Pakistan,2012-03-01,60,0,4,12,6,82
Pakistan,2012-03-01,86,0,2,59,13,160
Pakistan,2012-03-01,92,0,1,195,15,303
Pakistan,2012-03-01,60,0,0,91,29,180
Pakistan,2012-03-01,42,0,0,63,21,126
Pakistan,2012-03-01,182,2,0,77,5,266
Pakistan,2012-03-01,148,2,0,80,19,249
Pakistan,2012-03-01,110,0,-2,60,7,175
Pakistan,2012-03-01,91,0,-6,57,12,154
Pakistan,2012-03-01,123,0,2,53,4,182
Pakistan,2012-03-01,146,2,-5,75,28,246
Pakistan,2012-03-01,191,2,0,64,15,272
Pakistan,2012-03-01,141,0,-2,79,19,237
Pakistan,2012-03-01,64,0,0,24,6,94
Pakistan,2012-03-01,123,2,0,5,11,141
Pakistan,2012-03-01,99,4,0,45,17,165
Pakistan,2012-03-01,121,2,1,43,32,199
Pakistan,2012-03-01,110,0,0,24,12,146
Pakistan,2012-03-01,112,0,1,28,10,151
Pakistan,2012-03-01,10,0,0,12,0,22
Pakistan,2012-03-01,65,0,-2,45,3,111
Sierra Leone,2012-03-01,4,0,0,15,1,20
Sierra Leone,2012-03-01,2,0,0,3,0,5
Sierra Leone,2012-03-01,9,0,0,3,0,12
Sierra Leone,2012-03-01,-3,0,0,0,1,-2
Sierra Leone,2012-03-01,6,0,0,0,1,7
Sierra Leone,2012-03-01,2,0,0,0,0,2
Sierra Leone,2012-03-01,2,0,0,0,0,2
Sierra Leone,2012-03-01,2,0,1,0,0,3
Sierra Leone,2012-03-01,10,0,0,15,3,28
Sierra Leone,2012-03-01,4,0,0,0,0,4
Sierra Leone,2012-03-01,7,0,0,0,0,7
Sierra Leone,2012-03-01,23,0,0,0,0,23
Sierra Leone,2012-03-01,20,0,0,9,4,33
Sierra Leone,2012-03-01,-2,0,0,3,0,1
Sierra Leone,2012-03-01,3,0,0,0,0,3
Sierra Leone,2012-03-01,6,0,0,0,2,8
Sierra Leone,2012-03-01,15,0,0,0,0,15
Sierra Leone,2012-03-01,8,0,0,0,0,8
Sierra Leone,2012-03-01,9,0,0,0,7,16
Sierra Leone,2012-03-01,1,0,0,-2,1,0
Sierra Leone,2012-03-01,7,0,0,3,2,12
Sierra Leone,2012-03-01,5,0,0,0,0,5
Sierra Leone,2012-03-01,0,0,0,0,0,0
Sierra Leone,2012-03-01,10,0,0,0,0,10
Sierra Leone,2012-03-01,4,0,0,-4,0,0
Sierra Leone,2012-03-01,11,0,0,0,0,11
Sierra Leone,2012-03-01,4,0,0,0,0,4
Sierra Leone,2012-03-01,0,0,0,0,0,0
Sierra Leone,2012-03-01,0,0,0,0,0,0
Sierra Leone,2012-03-01,1,0,0,3,0,4
Somalia,2012-03-01,89,0,0,21,31,141
Somalia,2012-03-01,46,0,0,3,12,61
Somalia,2012-03-01,51,0,0,34,16,101
Somalia,2012-03-01,61,0,0,20,8,89
Somalia,2012-03-01,86,4,1,66,5,162
Somalia,2012-03-01,55,2,2,26,8,93
Somalia,2012-03-01,53,2,0,63,11,129
Somalia,2012-03-01,82,0,-1,60,7,148
Somalia,2012-03-01,60,2,1,14,4,81
Somalia,2012-03-01,109,0,0,0,21,130
Somalia,2012-03-01,149,0,0,43,37,229
Somalia,2012-03-01,191,0,1,101,14,307
Somalia,2012-03-01,117,2,0,54,7,180
Somalia,2012-03-01,163,2,-4,26,34,221
Somalia,2012-03-01,102,2,0,35,3,142
Somalia,2012-03-01,63,2,-1,40,9,113
Somalia,2012-03-01,53,0,0,54,4,111
Somalia,2012-03-01,53,0,0,24,2,79
Somalia,2012-03-01,99,0,-6,8,3,104
Somalia,2012-03-01,105,0,-3,40,2,144
Somalia,2012-03-01,152,0,-1,16,25,192
Somalia,2012-03-01,109,0,-2,34,9,150
Somalia,2012-03-01,115,12,-4,15,13,151
Somalia,2012-03-01,36,0,0,5,7,48
Somalia,2012-03-01,39,0,-4,18,5,58
Somalia,2012-03-01,60,0,-4,39,11,106
Somalia,2012-03-01,90,0,-2,18,5,111
Somalia,2012-03-01,74,0,0,24,8,106
Somalia,2012-03-01,91,0,0,39,9,139
Somalia,2012-03-01,33,0,-2,6,1,38
Somalia,2012-03-01,103,0,0,0,15,118
Syria,2012-03-01,269,0,1,74,61,405
Syria,2012-03-01,308,4,1,68,30,411
Syria,2012-03-01,202,0,0,11,37,250
Syria,2012-03-01,201,6,-2,17,37,259
Syria,2012-03-01,347,4,-9,92,35,469
Syria,2012-03-01,352,10,-10,56,28,436
Syria,2012-03-01,367,10,-26,58,69,478
Syria,2012-03-01,501,0,-36,32,44,541
Syria,2012-03-01,508,4,-18,45,62,601
Syria,2012-03-01,272,0,-2,14,30,314
Syria,2012-03-01,99,0,-19,6,12,98
Syria,2012-03-01,540,0,-3,98,57,692
Syria,2012-03-01,532,2,-10,98,39,661
Syria,2012-03-01,309,2,-12,198,52,549
Syria,2012-03-01,314,4,4,97,55,474
Syria,2012-03-01,193,4,-4,52,30,275
Syria,2012-03-01,159,0,-8,46,20,217
Syria,2012-03-01,139,0,-4,65,10,210
Syria,2012-03-01,284,0,-6,32,28,338
Syria,2012-03-01,161,0,-1,72,21,253
Syria,2012-03-01,192,2,1,30,25,250
Syria,2012-03-01,249,0,-14,50,20,305
Syria,2012-03-01,254,14,-9,143,40,442
Syria,2012-03-01,154,10,-5,18,17,194
Syria,2012-03-01,150,2,1,29,11,193
Syria,2012-03-01,349,2,4,56,18,429
Syria,2012-03-01,474,12,-5,54,45,580
Syria,2012-03-01,265,0,-31,9,33,276
Syria,2012-03-01,291,2,-20,73,29,375
Syria,2012-03-01,157,0,-2,14,11,180
Syria,2012-03-01,136,0,-18,-6,17,129
Yemen,2012-03-01,23,0,1,9,2,35
Yemen,2012-03-01,17,0,0,3,3,23
Yemen,2012-03-01,8,0,0,8,8,24
Yemen,2012-03-01,49,0,0,-1,0,48
Yemen,2012-03-01,99,0,3,27,7,136
Yemen,2012-03-01,77,0,0,-3,3,77
Yemen,2012-03-01,44,0,0,1,11,56
Yemen,2012-03-01,18,2,0,-11,0,9
Yemen,2012-03-01,71,2,0,-7,11,77
Yemen,2012-03-01,86,0,0,20,15,121
Yemen,2012-03-01,22,2,0,7,0,31
Yemen,2012-03-01,41,0,0,1,1,43
Yemen,2012-03-01,55,0,0,3,10,68
Yemen,2012-03-01,57,0,0,16,4,77
Yemen,2012-03-01,33,0,-2,29,9,69
Yemen,2012-03-01,33,0,0,40,3,76
Yemen,2012-03-01,29,0,1,18,8,56
Yemen,2012-03-01,111,0,-6,4,12,121
Yemen,2012-03-01,105,0,0,27,10,142
Yemen,2012-03-01,45,0,0,12,2,59
Yemen,2012-03-01,65,0,-10,0,2,57
Yemen,2012-03-01,58,0,0,16,3,77
Yemen,2012-03-01,44,0,-2,6,1,49
Yemen,2012-03-01,15,0,-2,18,1,32
Yemen,2012-03-01,37,0,0,0,0,37
Yemen,2012-03-01,25,0,-8,6,2,25
Yemen,2012-03-01,49,0,-2,17,2,66
Yemen,2012-03-01,45,2,0,62,5,114
Yemen,2012-03-01,72,8,0,25,0,105
Yemen,2012-03-01,29,0,0,2,3,34
Yemen,2012-03-01,37,0,0,3,0,40
Afghanistan,2010-01-01,528,6,-1,29,64,626
Afghanistan,2010-01-01,362,0,0,73,29,464
Afghanistan,2010-01-01,272,0,0,39,27,338
Afghanistan,2010-01-01,411,2,0,64,16,493
Afghanistan,2010-01-01,363,2,1,49,40,455
Afghanistan,2010-01-01,414,8,-1,58,55,534
Afghanistan,2010-01-01,213,4,-1,69,48,333
Afghanistan,2010-01-01,339,0,-17,61,44,427
Afghanistan,2010-01-01,332,2,-11,62,68,453
Afghanistan,2010-01-01,298,4,-1,108,59,468
Afghanistan,2010-01-01,407,2,-2,114,27,548
Afghanistan,2010-01-01,389,4,1,82,41,517
Afghanistan,2010-01-01,372,6,2,116,41,537
Afghanistan,2010-01-01,455,6,0,32,35,528
Afghanistan,2010-01-01,308,2,0,38,30,378
Afghanistan,2010-01-01,296,4,0,3,52,355
Afghanistan,2010-01-01,263,0,1,10,6,280
Afghanistan,2010-01-01,226,2,0,94,24,346
Afghanistan,2010-01-01,319,4,2,65,9,399
Afghanistan,2010-01-01,243,6,-4,46,23,314
Afghanistan,2010-01-01,281,2,2,39,27,351
Afghanistan,2010-01-01,301,0,-4,77,29,403
Afghanistan,2010-01-01,231,0,-5,44,101,371
Afghanistan,2010-01-01,383,6,0,51,45,485
Afghanistan,2010-01-01,360,4,-5,33,31,423
Afghanistan,2010-01-01,285,18,-7,32,35,363
Afghanistan,2010-01-01,253,6,-18,47,54,342
Afghanistan,2010-01-01,288,24,-6,86,36,428
Afghanistan,2010-01-01,338,6,-10,110,28,472
Afghanistan,2010-01-01,260,2,0,39,31,332
Afghanistan,2010-01-01,213,2,-3,16,22,250
Albania,2010-01-01,63,0,0,3,0,66
Albania,2010-01-01,6,0,0,0,0,6
Albania,2010-01-01,0,0,0,0,0,0
Albania,2010-01-01,0,0,0,0,0,0
Albania,2010-01-01,6,0,0,-4,5,7
Albania,2010-01-01,38,0,-6,-2,6,36
Albania,2010-01-01,12,0,0,-2,8,18
Albania,2010-01-01,13,0,-2,6,3,20
Albania,2010-01-01,0,2,0,0,0,2
Albania,2010-01-01,-1,0,0,0,0,-1
Albania,2010-01-01,2,0,0,-2,0,0
Albania,2010-01-01,6,0,-2,4,0,8
Albania,2010-01-01,1,0,0,-2,0,-1
Albania,2010-01-01,14,0,0,0,1,15
Albania,2010-01-01,4,0,0,0,0,4
Albania,2010-01-01,0,2,0,0,0,2
Albania,2010-01-01,3,0,0,0,1,4
Albania,2010-01-01,10,2,0,0,0,12
Albania,2010-01-01,0,0,2,6,0,8
Albania,2010-01-01,6,0,0,0,0,6
Albania,2010-01-01,7,0,0,9,3,19
Albania,2010-01-01,3,0,0,0,5,8
Albania,2010-01-01,7,0,-3,0,0,4
Albania,2010-01-01,7,0,0,0,0,7
Albania,2010-01-01,2,0,0,-4,3,1
Albania,2010-01-01,6,0,0,15,5,26
Albania,2010-01-01,1,0,0,3,0,4
Albania,2010-01-01,5,0,-1,3,0,7
Albania,2010-01-01,9,0,-4,0,0,5
Algeria,2010-01-01,3,0,0,-4,0,-1
Algeria,2010-01-01,0,0,0,6,0,6
Algeria,2010-01-01,12,0,0,6,0,18
Algeria,2010-01-01,6,0,0,3,0,9
Algeria,2010-01-01,7,0,0,0,5,12
Algeria,2010-01-01,6,0,0,9,15,30
Algeria,2010-01-01,15,0,0,8,0,23
Algeria,2010-01-01,4,0,0,0,0,4
Algeria,2010-01-01,10,0,0,9,0,19
Algeria,2010-01-01,19,0,0,0,4,23
Algeria,2010-01-01,27,0,0,40,5,72
Algeria,2010-01-01,27,0,0,12,2,41
Algeria,2010-01-01,1,0,0,6,2,9
Algeria,2010-01-01,17,2,1,6,0,26
Algeria,2010-01-01,35,0,0,0,0,35
Algeria,2010-01-01,6,0,0,0,0,6
Algeria,2010-01-01,2,0,2,-4,0,0
Algeria,2010-01-01,-2,0,0,0,4,2
Algeria,2010-01-01,2,0,0,-4,0,-2
Algeria,2010-01-01,9,0,0,-7,0,2
Algeria,2010-01-01,4,0,0,28,0,32
Algeria,2010-01-01,8,0,0,17,2,27
Algeria,2010-01-01,4,0,0,7,5,16
Algeria,2010-01-01,3,0,0,0,1,4
Algeria,2010-01-01,17,0,0,9,0,26
Algeria,2010-01-01,13,0,0,0,0,13
Algeria,2010-01-01,0,0,0,3,0,3
Algeria,2010-01-01,2,0,0,0,0,2
Algeria,2010-01-01,6,0,0,0,0,6
Algeria,2010-01-01,0,0,0,0,0,0
Algeria,2010-01-01,14,0,0,3,2,19
Bangladesh,2010-01-01,7,0,0,9,0,16
Bangladesh,2010-01-01,13,0,0,0,0,13
Bangladesh,2010-01-01,4,0,0,-2,1,3
Bangladesh,2010-01-01,11,0,2,13,0,26
Bangladesh,2010-01-01,37,0,1,9,5,52
Bangladesh,2010-01-01,26,0,0,18,3,47
Bangladesh,2010-01-01,17,0,0,4,1,22
Bangladesh,2010-01-01,24,0,0,30,8,62
Bangladesh,2010-01-01,10,0,0,19,2,31
Bangladesh,2010-01-01,28,0,0,18,3,49
Bangladesh,2010-01-01,26,2,0,14,2,44
Bangladesh,2010-01-01,20,0,1,21,0,42
Bangladesh,2010-01-01,14,0,0,8,3,25
Bangladesh,2010-01-01,42,0,0,-1,6,47
Bangladesh,2010-01-01,0,0,0,3,0,3
Bangladesh,2010-01-01,8,0,0,15,0,23
Bangladesh,2010-01-01,55,0,2,-3,2,56
Bangladesh,2010-01-01,36,0,0,5,0,41
Bangladesh,2010-01-01,44,0,0,35,3,82
Bangladesh,2010-01-01,10,0,0,11,1,22
Bangladesh,2010-01-01,9,0,0,3,0,12
Bangladesh,2010-01-01,16,0,0,18,0,34
Bangladesh,2010-01-01,24,0,-2,13,2,37
Bangladesh,2010-01-01,7,0,0,12,2,21
Bangladesh,2010-01-01,7,0,0,20,5,32
Bangladesh,2010-01-01,26,0,0,20,0,46
Bangladesh,2010-01-01,18,0,1,10,0,29
Bangladesh,2010-01-01,28,0,0,-1,0,27
Bangladesh,2010-01-01,10,2,0,-1,3,14
Bangladesh,2010-01-01,15,0,1,7,5,28
Bangladesh,2010-01-01,8,0,0,23,3,34
Cameroon,2010-01-01,0,0,0,0,0,0
Cameroon,2010-01-01,0,0,0,3,0,3
Cameroon,2010-01-01,0,0,0,0,0,0
Cameroon,2010-01-01,3,0,0,0,0,3
Cameroon,2010-01-01,0,0,0,0,0,0
Cameroon,2010-01-01,3,0,0,0,0,3
Cameroon,2010-01-01,9,0,0,0,0,9
Cameroon,2010-01-01,4,0,0,0,0,4
Cameroon,2010-01-01,0,0,0,-2,0,-2
Cameroon,2010-01-01,18,0,0,0,3,21
Cameroon,2010-01-01,0,0,0,0,0,0
Cameroon,2010-01-01,3,0,0,0,0,3
Cameroon,2010-01-01,0,0,0,0,0,0
Cameroon,2010-01-01,0,0,0,0,0,0
Cameroon,2010-01-01,2,0,0,0,3,5
Cameroon,2010-01-01,0,0,0,3,0,3
Cameroon,2010-01-01,72,0,0,0,0,72
Cameroon,2010-01-01,10,0,0,-2,1,9
Cameroon,2010-01-01,2,0,0,0,1,3
Cameroon,2010-01-01,0,0,0,0,0,0
Cameroon,2010-01-01,0,0,0,0,0,0
Cameroon,2010-01-01,1,0,0,0,0,1
Cameroon,2010-01-01,2,0,0,0,0,2
Cameroon,2010-01-01,6,0,0,0,0,6
Cameroon,2010-01-01,6,0,0,0,0,6
Cameroon,2010-01-01,0,0,0,0,0,0
China,2010-01-01,42,0,1,35,5,83
China,2010-01-01,62,0,0,32,7,101
China,2010-01-01,78,0,2,79,7,166
China,2010-01-01,107,0,-4,80,8,191
China,2010-01-01,118,6,-10,43,5,162
China,2010-01-01,131,6,0,112,11,260
China,2010-01-01,131,0,0,31,21,183
China,2010-01-01,139,0,-2,43,30,210
China,2010-01-01,93,2,4,-4,11,106
China,2010-01-01,109,0,28,58,8,203
China,2010-01-01,121,0,7,72,15,215
China,2010-01-01,239,2,9,134,23,407
China,2010-01-01,418,2,0,195,43,658
China,2010-01-01,246,6,-3,156,43,448
China,2010-01-01,161,0,-2,78,10,247
China,2010-01-01,106,8,1,-4,12,123
China,2010-01-01,101,4,7,113,6,231
China,2010-01-01,140,0,-5,80,14,229
China,2010-01-01,150,2,2,100,21,275
China,2010-01-01,159,0,2,43,13,217
China,2010-01-01,214,6,-10,112,26,348
China,2010-01-01,107,0,1,91,8,207
China,2010-01-01,66,0,5,44,10,125
China,2010-01-01,78,2,-4,23,20,119
China,2010-01-01,82,0,-6,65,13,154
China,2010-01-01,136,0,-1,80,16,231
China,2010-01-01,124,8,-1,53,9,193
China,2010-01-01,186,1,1,81,11,280
China,2010-01-01,152,10,4,116,7,289
China,2010-01-01,111,6,-1,26,14,156
China,2010-01-01,113,0,0,37,11,161
Egypt,2010-01-01,5,0,0,6,2,13
Egypt,2010-01-01,59,0,0,26,5,90
Egypt,2010-01-01,22,0,-3,27,3,49
Egypt,2010-01-01,59,2,0,0,6,67
Egypt,2010-01-01,58,0,0,15,4,77
Egypt,2010-01-01,177,0,-1,72,41,289
Egypt,2010-01-01,283,2,0,60,36,381
Egypt,2010-01-01,128,0,0,19,10,157
Egypt,2010-01-01,47,0,4,17,11,79
Egypt,2010-01-01,104,0,0,33,13,150
Egypt,2010-01-01,77,0,-1,28,8,112
Egypt,2010-01-01,108,0,2,31,6,147
Egypt,2010-01-01,54,0,0,10,8,72
Egypt,2010-01-01,84,0,0,22,7,113
Egypt,2010-01-01,53,0,2,33,2,90
Egypt,2010-01-01,76,0,-4,30,6,108
Egypt,2010-01-01,34,0,0,30,4,68
Egypt,2010-01-01,38,0,1,13,2,54
Egypt,2010-01-01,18,0,3,3,-2,22
Egypt,2010-01-01,30,0,1,31,2,64
Egypt,2010-01-01,49,0,0,52,8,109
Egypt,2010-01-01,47,0,0,16,1,64
Egypt,2010-01-01,15,0,0,22,19,56
Egypt,2010-01-01,46,0,0,12,0,58
Egypt,2010-01-01,40,0,3,13,0,56
Egypt,2010-01-01,55,2,0,6,3,66
Egypt,2010-01-01,32,0,1,19,1,53
Egypt,2010-01-01,33,2,0,21,0,56
Egypt,2010-01-01,25,0,0,2,0,27
Egypt,2010-01-01,20,0,0,6,1,27
Egypt,2010-01-01,33,0,0,10,1,44
Eritrea,2010-01-01,0,0,0,0,0,0
Eritrea,2010-01-01,9,0,0,15,0,24
Eritrea,2010-01-01,23,0,0,36,4,63
Eritrea,2010-01-01,2,0,0,-2,0,0
Eritrea,2010-01-01,4,0,0,-1,0,3
Eritrea,2010-01-01,11,0,0,0,1,12
Eritrea,2010-01-01,6,0,0,0,1,7
Eritrea,2010-01-01,9,0,0,3,0,12
Eritrea,2010-01-01,6,0,0,0,0,6
Eritrea,2010-01-01,7,0,0,6,0,13
Eritrea,2010-01-01,1,0,0,12,2,15
Eritrea,2010-01-01,0,0,0,0,0,0
Eritrea,2010-01-01,12,0,0,0,0,12
Eritrea,2010-01-01,2,0,0,-4,0,-2
Eritrea,2010-01-01,1,0,0,0,0,1
Eritrea,2010-01-01,0,0,1,0,0,1
Eritrea,2010-01-01,0,0,0,0,0,0
Eritrea,2010-01-01,17,0,0,0,0,17
Eritrea,2010-01-01,2,0,0,1,0,3
Eritrea,2010-01-01,12,0,0,0,0,12
Eritrea,2010-01-01,19,0,0,47,0,66
Eritrea,2010-01-01,0,0,0,3,0,3
Eritrea,2010-01-01,0,0,0,12,0,12
Eritrea,2010-01-01,0,0,0,0,0,0
Eritrea,2010-01-01,2,0,0,0,0,2
Eritrea,2010-01-01,0,0,0,0,1,1
Eritrea,2010-01-01,3,0,0,0,0,3
Eritrea,2010-01-01,0,0,0,0,0,0
Eritrea,2010-01-01,0,0,1,0,0,1
Eritrea,2010-01-01,3,0,0,0,0,3
Eritrea,2010-01-01,0,2,0,0,0,2
Georgia,2010-01-01,7,0,0,2,4,13
Georgia,2010-01-01,22,0,0,24,2,48
Georgia,2010-01-01,7,0,0,10,1,18
Georgia,2010-01-01,35,0,-2,10,4,47
Georgia,2010-01-01,26,0,-2,-4,4,24
Georgia,2010-01-01,21,0,-1,14,3,37
Georgia,2010-01-01,33,0,6,18,5,62
Georgia,2010-01-01,20,4,0,9,1,34
Georgia,2010-01-01,16,0,-2,16,0,30
Georgia,2010-01-01,0,0,0,3,0,3
Georgia,2010-01-01,22,0,2,3,5,32
Georgia,2010-01-01,68,0,-2,26,7,99
Georgia,2010-01-01,67,0,3,21,3,94
Georgia,2010-01-01,25,0,-1,8,0,32
Georgia,2010-01-01,52,0,0,9,5,66
Georgia,2010-01-01,16,0,0,11,2,29
Georgia,2010-01-01,14,0,1,9,5,29
Georgia,2010-01-01,11,0,-1,6,4,20
Georgia,2010-01-01,39,0,1,26,0,66
Georgia,2010-01-01,26,0,0,17,2,45
Georgia,2010-01-01,25,0,1,0,2,28
Georgia,2010-01-01,34,0,-1,23,4,60
Georgia,2010-01-01,33,0,0,1,6,40
Georgia,2010-01-01,13,0,0,3,2,18
Georgia,2010-01-01,40,0,0,34,7,81
Georgia,2010-01-01,25,0,1,7,5,38
Georgia,2010-01-01,36,0,1,18,3,58
Georgia,2010-01-01,10,0,0,21,1,32
Georgia,2010-01-01,13,2,0,34,2,51
Georgia,2010-01-01,12,0,-1,6,2,19
Georgia,2010-01-01,18,0,-2,3,1,20
India,2010-01-01,39,2,0,-3,7,45
India,2010-01-01,64,0,0,12,6,82
India,2010-01-01,54,0,0,4,3,61
India,2010-01-01,76,0,-1,8,4,87
India,2010-01-01,37,0,0,41,3,81
India,2010-01-01,120,2,-5,5,19,141
India,2010-01-01,110,0,-1,12,10,131
India,2010-01-01,48,0,2,15,12,77
India,2010-01-01,45,0,2,6,29,82
India,2010-01-01,35,4,1,36,3,79
India,2010-01-01,61,2,-5,34,8,100
India,2010-01-01,68,0,-3,14,4,83
India,2010-01-01,42,2,-1,39,3,85
India,2010-01-01,55,6,1,30,7,99
India,2010-01-01,56,0,-3,21,21,95
India,2010-01-01,49,4,-2,2,11,64
India,2010-01-01,64,0,-1,23,8,94
India,2010-01-01,74,0,-1,2,10,85
India,2010-01-01,136,4,0,22,11,173
India,2010-01-01,62,0,0,11,10,83
India,2010-01-01,67,0,0,16,13,96
India,2010-01-01,65,0,-1,7,9,80
India,2010-01-01,39,4,0,4,0,47
India,2010-01-01,82,0,-1,33,5,119
India,2010-01-01,62,0,-2,37,3,100
India,2010-01-01,80,0,-4,28,16,120
India,2010-01-01,122,6,-1,12,12,151
India,2010-01-01,71,0,-1,23,13,106
India,2010-01-01,52,0,1,9,12,74
India,2010-01-01,35,2,-1,13,4,53
India,2010-01-01,58,0,-3,1,2,58
Iran,2010-01-01,148,2,-1,82,12,243
Iran,2010-01-01,93,0,0,12,3,108
Iran,2010-01-01,75,0,7,73,4,159
Iran,2010-01-01,87,0,3,116,7,213
Iran,2010-01-01,86,0,-1,95,16,196
Iran,2010-01-01,43,0,0,25,12,80
Iran,2010-01-01,32,0,0,37,6,75
Iran,2010-01-01,55,0,-2,45,2,100
Iran,2010-01-01,28,0,0,-6,8,30
Iran,2010-01-01,27,0,-2,0,5,30
Iran,2010-01-01,22,0,3,24,7,56
Iran,2010-01-01,61,0,1,25,1,88
Iran,2010-01-01,142,0,2,52,5,201
Iran,2010-01-01,30,0,4,83,1,118
Iran,2010-01-01,46,0,-2,50,10,104
Iran,2010-01-01,67,2,3,11,13,96
Iran,2010-01-01,52,0,2,48,3,105
Iran,2010-01-01,57,0,2,61,6,126
Iran,2010-01-01,49,0,0,47,6,102
Iran,2010-01-01,80,4,-2,26,6,114
Iran,2010-01-01,108,0,-1,49,18,174
Iran,2010-01-01,103,0,0,43,7,153
Iran,2010-01-01,21,0,0,18,4,43
Iran,2010-01-01,37,0,1,27,47,112
Iran,2010-01-01,94,0,0,33,49,176
Iran,2010-01-01,72,0,1,26,16,115
Iran,2010-01-01,200,0,-2,98,31,327
Iran,2010-01-01,117,0,1,51,19,188
Iran,2010-01-01,176,0,-1,28,23,226
Iran,2010-01-01,136,0,0,24,14,174
Iran,2010-01-01,55,0,-3,12,12,76
Iraq,2010-01-01,108,2,-1,9,5,123
Iraq,2010-01-01,71,0,0,5,5,81
Iraq,2010-01-01,54,0,0,23,4,81
Iraq,2010-01-01,202,2,1,50,21,276
Iraq,2010-01-01,165,0,0,21,16,202
Iraq,2010-01-01,129,2,0,10,12,153
Iraq,2010-01-01,148,2,0,21,18,189
Iraq,2010-01-01,69,0,2,54,18,143
Iraq,2010-01-01,72,2,0,25,14,113
Iraq,2010-01-01,91,4,0,14,4,113
Iraq,2010-01-01,127,4,-5,29,1,156
Iraq,2010-01-01,373,4,-1,33,25,434
Iraq,2010-01-01,195,18,7,47,24,291
Iraq,2010-01-01,90,0,0,62,10,162
Iraq,2010-01-01,93,2,2,44,9,150
Iraq,2010-01-01,87,0,3,28,17,135
Iraq,2010-01-01,127,4,1,46,12,190
Iraq,2010-01-01,179,2,0,59,17,257
Iraq,2010-01-01,210,2,-3,4,15,228
Iraq,2010-01-01,115,2,1,49,7,174
Iraq,2010-01-01,64,4,2,6,11,87
Iraq,2010-01-01,56,2,0,63,20,141
Iraq,2010-01-01,76,0,0,37,5,118
Iraq,2010-01-01,95,8,-2,42,18,161
Iraq,2010-01-01,112,0,0,28,11,151
Iraq,2010-01-01,211,4,8,57,37,317
Iraq,2010-01-01,235,0,-2,103,14,350
Iraq,2010-01-01,113,0,1,44,22,180
Iraq,2010-01-01,256,0,-6,84,45,379
Iraq,2010-01-01,112,0,4,36,21,173
Iraq,2010-01-01,90,0,1,5,11,107
Morocco,2010-01-01,0,0,0,0,0,0
Morocco,2010-01-01,0,0,0,0,0,0
Morocco,2010-01-01,-3,0,0,6,0,3
Morocco,2010-01-01,16,0,0,3,1,20
Morocco,2010-01-01,0,0,1,11,0,12
Morocco,2010-01-01,32,0,1,6,0,39
Morocco,2010-01-01,18,0,0,9,4,31
Morocco,2010-01-01,34,0,0,0,0,34
Morocco,2010-01-01,29,0,0,3,0,32
Morocco,2010-01-01,0,0,0,9,0,9
Morocco,2010-01-01,2,0,0,3,0,5
Morocco,2010-01-01,5,0,0,0,4,9
Morocco,2010-01-01,40,0,0,21,8,69
Morocco,2010-01-01,15,0,0,6,0,21
Morocco,2010-01-01,9,0,0,39,0,48
Morocco,2010-01-01,5,0,0,12,0,17
Morocco,2010-01-01,19,0,0,0,0,19
Morocco,2010-01-01,12,0,0,-4,0,8
Morocco,2010-01-01,10,0,0,6,1,17
Morocco,2010-01-01,2,0,0,12,5,19
Morocco,2010-01-01,4,0,0,16,0,20
Morocco,2010-01-01,22,0,0,15,0,37
Morocco,2010-01-01,0,0,0,0,0,0
Morocco,2010-01-01,0,0,0,6,0,6
Morocco,2010-01-01,24,0,0,9,0,33
Morocco,2010-01-01,3,0,0,3,0,6
Morocco,2010-01-01,8,0,0,12,0,20
Morocco,2010-01-01,9,2,0,8,2,21
Morocco,2010-01-01,-1,0,0,4,1,4
Morocco,2010-01-01,17,0,0,3,0,20
Morocco,2010-01-01,11,0,0,0,0,11
Nigeria,2010-01-01,78,0,1,17,19,115
Nigeria,2010-01-01,86,0,-3,27,9,119
Nigeria,2010-01-01,124,0,-5,56,12,187
Nigeria,2010-01-01,132,0,2,76,54,264
Nigeria,2010-01-01,158,2,-1,57,39,255
Nigeria,2010-01-01,215,0,0,136,21,372
Nigeria,2010-01-01,154,0,0,82,37,273
Nigeria,2010-01-01,137,0,4,116,22,279
Nigeria,2010-01-01,96,6,3,104,20,229
Nigeria,2010-01-01,64,0,0,20,12,96
Nigeria,2010-01-01,80,0,1,37,10,128
Nigeria,2010-01-01,112,2,0,16,19,149
Nigeria,2010-01-01,93,0,1,34,11,139
Nigeria,2010-01-01,137,0,-6,23,6,160
Nigeria,2010-01-01,94,0,0,28,7,129
Nigeria,2010-01-01,68,0,0,14,4,86
Nigeria,2010-01-01,130,0,1,8,4,143
Nigeria,2010-01-01,86,4,1,12,16,119
Nigeria,2010-01-01,122,0,-1,37,17,175
Nigeria,2010-01-01,160,0,-1,22,12,193
Nigeria,2010-01-01,116,0,-2,38,8,160
Nigeria,2010-01-01,75,0,-3,43,14,129
Nigeria,2010-01-01,58,0,1,16,2,77
Nigeria,2010-01-01,70,0,0,11,43,124
Nigeria,2010-01-01,76,0,-2,24,28,126
Nigeria,2010-01-01,39,0,-2,3,7,47
Nigeria,2010-01-01,62,0,0,36,5,103
Nigeria,2010-01-01,40,2,2,28,10,82
Nigeria,2010-01-01,54,2,-1,70,2,127
Nigeria,2010-01-01,40,2,-9,57,0,90
Nigeria,2010-01-01,52,0,0,9,2,63
Pakistan,2010-01-01,136,6,0,18,18,178
Pakistan,2010-01-01,202,0,2,27,32,263
Pakistan,2010-01-01,83,0,2,55,40,180
Pakistan,2010-01-01,154,0,-1,58,11,222
Pakistan,2010-01-01,120,0,1,21,43,185
Pakistan,2010-01-01,209,0,0,27,19,255
Pakistan,2010-01-01,350,2,1,22,91,466
Pakistan,2010-01-01,149,0,0,51,22,222
Pakistan,2010-01-01,240,0,0,73,110,423
Pakistan,2010-01-01,121,6,0,24,47,198
Pakistan,2010-01-01,76,2,0,6,2,86
Pakistan,2010-01-01,143,0,0,33,22,198
Pakistan,2010-01-01,141,0,0,36,18,195
Pakistan,2010-01-01,143,0,1,80,4,228
Pakistan,2010-01-01,117,0,-1,56,5,177
Pakistan,2010-01-01,75,2,1,9,9,96
Pakistan,2010-01-01,98,0,1,17,8,124
Pakistan,2010-01-01,129,0,0,78,24,231
Pakistan,2010-01-01,155,2,5,66,15,243
Pakistan,2010-01-01,92,0,1,10,12,115
Pakistan,2010-01-01,113,2,-5,21,7,138
Pakistan,2010-01-01,116,0,0,28,28,172
Pakistan,2010-01-01,98,2,0,30,18,148
Pakistan,2010-01-01,145,0,-1,30,10,184
Pakistan,2010-01-01,103,0,1,99,13,216
Pakistan,2010-01-01,115,0,4,38,3,160
Pakistan,2010-01-01,201,0,4,43,15,263
Pakistan,2010-01-01,167,0,0,34,6,207
Pakistan,2010-01-01,114,0,0,51,4,169
Pakistan,2010-01-01,70,2,1,40,18,131
Pakistan,2010-01-01,64,0,0,11,6,81
Sierra Leone,2010-01-01,2,0,0,3,0,5
Sierra Leone,2010-01-01,0,0,0,0,0,0
Sierra Leone,2010-01-01,2,0,0,3,0,5
Sierra Leone,2010-01-01,2,0,0,0,0,2
Sierra Leone,2010-01-01,0,0,0,3,0,3
Sierra Leone,2010-01-01,0,0,0,3,0,3
Sierra Leone,2010-01-01,22,0,0,-7,2,17
Sierra Leone,2010-01-01,0,0,0,0,0,0
Sierra Leone,2010-01-01,0,0,0,0,0,0
Sierra Leone,2010-01-01,0,0,0,0,0,0
Sierra Leone,2010-01-01,38,0,0,5,0,43
Sierra Leone,2010-01-01,9,0,0,0,0,9
Sierra Leone,2010-01-01,2,0,0,0,0,2
Sierra Leone,2010-01-01,6,0,0,0,0,6
Sierra Leone,2010-01-01,2,0,0,0,0,2
Sierra Leone,2010-01-01,0,0,0,0,0,0
Sierra Leone,2010-01-01,0,0,0,0,0,0
Sierra Leone,2010-01-01,4,0,0,0,2,6
Sierra Leone,2010-01-01,-4,0,0,0,-1,-5
Sierra Leone,2010-01-01,-1,0,0,3,1,3
Sierra Leone,2010-01-01,5,0,0,12,0,17
Sierra Leone,2010-01-01,0,0,0,0,1,1
Sierra Leone,2010-01-01,0,0,0,6,1,7
Sierra Leone,2010-01-01,5,0,0,0,0,5
Sierra Leone,2010-01-01,3,0,0,0,0,3
Sierra Leone,2010-01-01,2,0,0,3,0,5
Sierra Leone,2010-01-01,13,0,0,0,0,13
Sierra Leone,2010-01-01,2,0,0,0,0,2
Sierra Leone,2010-01-01,0,0,0,6,0,6
Sierra Leone,2010-01-01,6,0,0,6,0,12
Sierra Leone,2010-01-01,0,0,0,0,0,0
Somalia,2010-01-01,63,0,0,-2,3,64
Somalia,2010-01-01,271,0,1,79,29,380
Somalia,2010-01-01,215,0,0,63,13,291
Somalia,2010-01-01,185,0,1,43,7,236
Somalia,2010-01-01,118,0,0,22,4,144
Somalia,2010-01-01,95,0,0,6,2,103
Somalia,2010-01-01,77,0,0,4,3,84
Somalia,2010-01-01,62,0,0,28,3,93
Somalia,2010-01-01,21,0,0,21,0,42
Somalia,2010-01-01,83,2,0,13,3,101
Somalia,2010-01-01,151,0,0,23,3,177
Somalia,2010-01-01,146,2,-1,21,7,175
Somalia,2010-01-01,110,0,1,16,11,138
Somalia,2010-01-01,91,0,0,12,0,103
Somalia,2010-01-01,115,0,0,66,10,191
Somalia,2010-01-01,29,0,0,13,6,48
Somalia,2010-01-01,55,0,0,55,6,116
Somalia,2010-01-01,155,2,0,26,29,212
Somalia,2010-01-01,138,2,0,41,8,189
Somalia,2010-01-01,80,0,0,59,6,145
Somalia,2010-01-01,93,2,0,40,9,144
Somalia,2010-01-01,68,0,0,69,5,142
Somalia,2010-01-01,11,0,0,7,3,21
Somalia,2010-01-01,41,6,0,11,6,64
Somalia,2010-01-01,39,0,0,2,2,43
Somalia,2010-01-01,51,0,0,13,4,68
Somalia,2010-01-01,52,10,0,36,10,108
Somalia,2010-01-01,38,0,0,22,5,65
Somalia,2010-01-01,37,0,0,7,8,52
Somalia,2010-01-01,35,0,0,9,0,44
Somalia,2010-01-01,21,4,0,12,13,50
Syria,2010-01-01,2,0,0,9,0,11
Syria,2010-01-01,7,0,0,3,0,10
Syria,2010-01-01,-14,0,0,1,3,-10
Syria,2010-01-01,15,0,0,13,1,29
Syria,2010-01-01,13,0,0,18,1,32
Syria,2010-01-01,30,0,0,-1,5,34
Syria,2010-01-01,17,0,0,9,1,27
Syria,2010-01-01,32,0,1,16,10,59
Syria,2010-01-01,20,0,0,20,10,50
Syria,2010-01-01,10,0,0,35,3,48
Syria,2010-01-01,11,0,0,18,3,32
Syria,2010-01-01,12,0,0,9,4,25
Syria,2010-01-01,29,4,0,4,2,39
Syria,2010-01-01,19,0,0,25,4,48
Syria,2010-01-01,13,0,0,12,0,25
Syria,2010-01-01,4,0,-2,0,13,15
Syria,2010-01-01,22,0,0,3,0,25
Syria,2010-01-01,11,0,0,36,0,47
Syria,2010-01-01,18,0,0,9,0,27
Syria,2010-01-01,4,0,0,29,0,33
Syria,2010-01-01,11,0,-4,24,15,46
Syria,2010-01-01,20,0,0,25,0,45
Syria,2010-01-01,16,0,0,7,0,23
Syria,2010-01-01,20,0,0,12,25,57
Syria,2010-01-01,13,0,0,6,22,41
Syria,2010-01-01,55,2,0,45,8,110
Syria,2010-01-01,14,2,0,10,0,26
Syria,2010-01-01,60,0,0,72,0,132
Syria,2010-01-01,23,0,0,67,0,90
Syria,2010-01-01,12,0,0,24,0,36
Syria,2010-01-01,3,0,0,3,0,6
Yemen,2010-01-01,146,6,-3,-8,9,150
Yemen,2010-01-01,297,4,1,14,12,328
Yemen,2010-01-01,321,0,0,41,20,382
Yemen,2010-01-01,319,0,3,22,36,380
Yemen,2010-01-01,312,0,5,61,24,402
Yemen,2010-01-01,258,0,1,75,23,357
Yemen,2010-01-01,255,0,0,84,5,344
Yemen,2010-01-01,162,4,0,77,17,260
Yemen,2010-01-01,172,2,-2,18,17,207
Yemen,2010-01-01,128,0,1,7,12,148
Yemen,2010-01-01,176,0,0,16,16,208
Yemen,2010-01-01,127,0,0,31,11,169
Yemen,2010-01-01,287,0,0,8,17,312
Yemen,2010-01-01,121,4,1,15,18,159
Yemen,2010-01-01,288,0,2,14,15,319
Yemen,2010-01-01,157,2,0,29,3,191
Yemen,2010-01-01,77,0,0,-2,4,79
Yemen,2010-01-01,102,0,0,-15,8,95
Yemen,2010-01-01,42,2,0,39,13,96
Yemen,2010-01-01,107,0,2,27,7,143
Yemen,2010-01-01,169,0,0,20,4,193
Yemen,2010-01-01,115,0,0,25,5,145
Yemen,2010-01-01,94,0,0,5,4,103
Yemen,2010-01-01,121,0,0,19,28,168
Yemen,2010-01-01,71,0,-2,23,21,113
Yemen,2010-01-01,118,2,1,48,13,182
Yemen,2010-01-01,275,4,2,14,4,299
Yemen,2010-01-01,78,0,-2,45,4,125
Yemen,2010-01-01,71,0,0,25,10,106
Yemen,2010-01-01,50,0,-1,13,0,62
Yemen,2010-01-01,42,4,1,8,2,57
Afghanistan,2008-07-01,221,2,0,16,2,241
Afghanistan,2008-07-01,157,2,0,20,10,189
Afghanistan,2008-07-01,117,0,0,41,0,158
Afghanistan,2008-07-01,137,4,3,81,9,234
Afghanistan,2008-07-01,120,0,-1,-2,5,122
Afghanistan,2008-07-01,136,0,0,23,5,164
Afghanistan,2008-07-01,224,0,1,18,20,263
Afghanistan,2008-07-01,153,0,0,-2,21,172
Afghanistan,2008-07-01,155,0,0,23,20,198
Afghanistan,2008-07-01,195,6,0,27,6,234
Afghanistan,2008-07-01,146,0,0,38,13,197
Afghanistan,2008-07-01,97,0,0,18,17,132
Afghanistan,2008-07-01,194,0,-1,10,20,223
Afghanistan,2008-07-01,126,0,-3,23,18,164
Afghanistan,2008-07-01,151,0,0,27,11,189
Afghanistan,2008-07-01,303,4,1,71,14,393
Afghanistan,2008-07-01,282,4,1,103,11,401
Afghanistan,2008-07-01,206,0,2,77,11,296
Afghanistan,2008-07-01,94,0,-6,9,13,110
Afghanistan,2008-07-01,259,0,1,11,4,275
Afghanistan,2008-07-01,183,2,0,118,15,318
Afghanistan,2008-07-01,162,0,1,77,13,253
Afghanistan,2008-07-01,221,0,0,32,17,270
Afghanistan,2008-07-01,172,0,0,43,11,226
Afghanistan,2008-07-01,199,0,0,21,4,224
Afghanistan,2008-07-01,170,2,0,18,2,192
Afghanistan,2008-07-01,113,0,0,14,8,135
Afghanistan,2008-07-01,234,0,0,6,15,255
Afghanistan,2008-07-01,169,0,0,38,4,211
Afghanistan,2008-07-01,118,4,0,40,12,174
Afghanistan,2008-07-01,187,0,3,34,12,236
Albania,2008-07-01,0,0,0,0,0,0
Albania,2008-07-01,4,0,1,12,4,21
Albania,2008-07-01,4,0,0,12,2,18
Albania,2008-07-01,25,0,0,0,0,25
Albania,2008-07-01,1,0,0,0,0,1
Albania,2008-07-01,0,0,0,0,0,0
Albania,2008-07-01,11,0,0,9,0,20
Albania,2008-07-01,11,0,0,6,0,17
Albania,2008-07-01,8,0,0,3,0,11
Albania,2008-07-01,16,0,0,18,2,36
Albania,2008-07-01,15,0,0,17,0,32
Albania,2008-07-01,15,0,0,-4,0,11
Albania,2008-07-01,0,0,0,0,0,0
Albania,2008-07-01,5,0,0,10,0,15
Albania,2008-07-01,7,0,0,0,0,7
Albania,2008-07-01,0,0,0,0,1,1
Albania,2008-07-01,3,0,-2,0,0,1
Albania,2008-07-01,0,0,0,0,2,2
Albania,2008-07-01,0,0,0,15,0,15
Albania,2008-07-01,0,0,0,6,2,8
Albania,2008-07-01,0,0,0,0,0,0
Albania,2008-07-01,0,0,-2,6,10,14
Albania,2008-07-01,6,0,0,6,0,12
Albania,2008-07-01,6,0,0,0,0,6
Albania,2008-07-01,10,0,-2,3,0,11
Albania,2008-07-01,4,0,0,0,0,4
Albania,2008-07-01,11,0,0,0,0,11
Albania,2008-07-01,-3,0,0,6,0,3
Albania,2008-07-01,19,0,0,0,4,23
Albania,2008-07-01,0,0,-2,0,0,-2
Albania,2008-07-01,5,0,-3,3,0,5
Algeria,2008-07-01,16,0,0,3,0,19
Algeria,2008-07-01,11,0,0,18,2,31
Algeria,2008-07-01,8,0,0,4,2,14
Algeria,2008-07-01,11,0,0,10,0,21
Algeria,2008-07-01,-3,0,0,0,0,-3
Algeria,2008-07-01,0,0,0,-1,0,-1
Algeria,2008-07-01,5,2,0,3,0,10
Algeria,2008-07-01,-1,0,0,0,0,-1
Algeria,2008-07-01,0,0,0,2,0,2
Algeria,2008-07-01,0,0,0,0,0,0
Algeria,2008-07-01,2,0,0,3,0,5
Algeria,2008-07-01,1,0,0,-2,0,-1
Algeria,2008-07-01,8,0,0,0,1,9
Algeria,2008-07-01,4,0,0,0,0,4
Algeria,2008-07-01,3,0,0,-1,1,3
Algeria,2008-07-01,1,0,0,3,0,4
Algeria,2008-07-01,12,0,0,3,0,15
Algeria,2008-07-01,-1,0,0,0,3,2
Algeria,2008-07-01,7,0,0,0,3,10
Algeria,2008-07-01,1,0,0,0,0,1
Algeria,2008-07-01,0,0,0,3,0,3
Algeria,2008-07-01,0,0,0,0,0,0
Algeria,2008-07-01,13,0,1,2,0,16
Algeria,2008-07-01,1,0,0,9,0,10
Algeria,2008-07-01,3,0,0,0,0,3
Algeria,2008-07-01,0,0,0,0,0,0
Algeria,2008-07-01,4,0,0,15,0,19
Algeria,2008-07-01,2,0,0,3,0,5
Algeria,2008-07-01,0,0,0,4,0,4
Algeria,2008-07-01,0,0,0,0,0,0
Algeria,2008-07-01,8,0,0,6,0,14
Bangladesh,2008-07-01,19,0,0,1,2,22
Bangladesh,2008-07-01,34,0,0,4,3,41
Bangladesh,2008-07-01,5,0,0,0,0,5
Bangladesh,2008-07-01,6,0,0,-4,0,2
Bangladesh,2008-07-01,3,0,0,13,0,16
Bangladesh,2008-07-01,8,0,2,6,0,16
Bangladesh,2008-07-01,4,0,0,3,2,9
Bangladesh,2008-07-01,22,0,0,6,1,29
Bangladesh,2008-07-01,4,0,0,1,0,5
Bangladesh,2008-07-01,-1,0,0,0,0,-1
Bangladesh,2008-07-01,3,0,1,3,0,7
Bangladesh,2008-07-01,0,0,0,3,1,4
Bangladesh,2008-07-01,8,0,0,6,0,14
Bangladesh,2008-07-01,3,0,0,9,0,12
Bangladesh,2008-07-01,15,0,0,8,2,25
Bangladesh,2008-07-01,7,0,-4,10,5,18
Bangladesh,2008-07-01,23,0,0,8,0,31
Bangladesh,2008-07-01,-1,2,0,-2,2,1
Bangladesh,2008-07-01,-1,0,0,3,0,2
Bangladesh,2008-07-01,0,0,0,2,1,3
Bangladesh,2008-07-01,0,0,0,4,0,4
Bangladesh,2008-07-01,-3,0,0,6,0,3
Bangladesh,2008-07-01,18,0,0,3,1,22
Bangladesh,2008-07-01,6,0,0,4,2,12
Bangladesh,2008-07-01,12,0,0,1,0,13
Bangladesh,2008-07-01,8,0,0,7,7,22
Bangladesh,2008-07-01,7,0,0,-2,0,5
Bangladesh,2008-07-01,13,0,1,13,9,36
Bangladesh,2008-07-01,2,0,0,-3,0,-1
Bangladesh,2008-07-01,-1,0,1,5,2,7
Bangladesh,2008-07-01,12,0,0,-6,3,9
Cameroon,2008-07-01,0,0,0,0,0,0
Cameroon,2008-07-01,4,0,0,0,0,4
Cameroon,2008-07-01,1,0,0,0,0,1
Cameroon,2008-07-01,0,0,0,0,0,0
Cameroon,2008-07-01,1,0,0,0,0,1
Cameroon,2008-07-01,2,0,0,6,0,8
Cameroon,2008-07-01,0,0,0,0,0,0
Cameroon,2008-07-01,0,0,0,0,0,0
Cameroon,2008-07-01,6,0,0,3,2,11
Cameroon,2008-07-01,4,0,0,3,0,7
Cameroon,2008-07-01,0,0,0,3,0,3
Cameroon,2008-07-01,-8,0,0,0,0,-8
Cameroon,2008-07-01,0,0,0,0,0,0
Cameroon,2008-07-01,1,0,0,0,0,1
Cameroon,2008-07-01,0,0,0,6,0,6
Cameroon,2008-07-01,3,0,0,3,0,6
Cameroon,2008-07-01,4,0,0,0,0,4
Cameroon,2008-07-01,-2,0,0,0,0,-2
Cameroon,2008-07-01,2,0,0,3,0,5
Cameroon,2008-07-01,0,0,0,0,0,0
Cameroon,2008-07-01,0,0,0,3,0,3
Cameroon,2008-07-01,2,0,0,6,0,8
China,2008-07-01,80,0,-2,29,21,128
China,2008-07-01,78,0,-4,24,13,111
China,2008-07-01,111,0,0,47,12,170
China,2008-07-01,36,0,0,6,8,50
China,2008-07-01,26,0,-2,-6,2,20
China,2008-07-01,24,0,0,0,5,29
China,2008-07-01,20,0,0,9,1,30
China,2008-07-01,41,0,0,41,8,90
China,2008-07-01,85,0,0,57,14,156
China,2008-07-01,57,0,-2,16,11,82
China,2008-07-01,103,0,-7,73,17,186
China,2008-07-01,80,6,1,55,7,149
China,2008-07-01,46,4,0,14,6,70
China,2008-07-01,48,0,2,30,9,89
China,2008-07-01,70,0,-1,17,14,100
China,2008-07-01,57,2,0,67,12,138
China,2008-07-01,97,2,-3,21,12,129
China,2008-07-01,35,0,-1,41,13,88
China,2008-07-01,34,0,-1,21,1,55
China,2008-07-01,54,4,0,16,9,83
China,2008-07-01,70,0,2,-5,15,82
China,2008-07-01,66,0,0,9,7,82
China,2008-07-01,62,0,-2,11,5,76
China,2008-07-01,75,0,2,3,4,84
China,2008-07-01,56,0,0,38,8,102
China,2008-07-01,38,0,0,13,5,56
China,2008-07-01,39,0,0,-2,8,45
China,2008-07-01,53,0,0,48,4,105
China,2008-07-01,53,0,0,18,6,77
China,2008-07-01,77,0,-3,21,6,101
China,2008-07-01,46,2,3,49,5,105
Egypt,2008-07-01,44,0,-6,24,2,64
Egypt,2008-07-01,124,0,0,19,12,155
Egypt,2008-07-01,47,0,0,11,3,61
Egypt,2008-07-01,35,0,0,18,1,54
Egypt,2008-07-01,5,0,0,6,0,11
Egypt,2008-07-01,9,0,0,15,0,24
Egypt,2008-07-01,36,0,1,21,0,58
Egypt,2008-07-01,69,2,0,25,2,98
Egypt,2008-07-01,39,0,0,24,0,63
Egypt,2008-07-01,-7,0,2,21,2,18
Egypt,2008-07-01,16,0,0,13,2,31
Egypt,2008-07-01,9,0,0,0,0,9
Egypt,2008-07-01,9,0,0,3,0,12
Egypt,2008-07-01,15,0,0,-2,0,13
Egypt,2008-07-01,24,0,0,10,6,40
Egypt,2008-07-01,14,0,0,2,6,22
Egypt,2008-07-01,48,0,0,22,0,70
Egypt,2008-07-01,22,0,0,40,0,62
Egypt,2008-07-01,18,0,0,15,2,35
Egypt,2008-07-01,4,0,0,0,0,4
Egypt,2008-07-01,11,0,0,6,0,17
Egypt,2008-07-01,28,0,0,13,4,45
Egypt,2008-07-01,30,0,0,13,1,44
Egypt,2008-07-01,3,0,0,7,0,10
Egypt,2008-07-01,10,0,0,1,2,13
Egypt,2008-07-01,-3,0,1,9,0,7
Egypt,2008-07-01,9,0,-2,3,0,10
Egypt,2008-07-01,31,0,0,2,3,36
Egypt,2008-07-01,53,0,1,8,0,62
Egypt,2008-07-01,2,0,0,9,5,16
Egypt,2008-07-01,6,0,0,12,0,18
Eritrea,2008-07-01,10,0,0,3,0,13
Eritrea,2008-07-01,21,0,0,3,0,24
Eritrea,2008-07-01,6,0,0,0,0,6
Eritrea,2008-07-01,8,0,0,0,1,9
Eritrea,2008-07-01,0,0,0,3,0,3
Eritrea,2008-07-01,15,0,0,0,0,15
Eritrea,2008-07-01,5,0,0,21,0,26
Eritrea,2008-07-01,0,0,0,1,0,1
Eritrea,2008-07-01,13,0,0,0,2,15
Eritrea,2008-07-01,6,0,0,-2,2,6
Eritrea,2008-07-01,9,0,0,12,1,22
Eritrea,2008-07-01,6,0,0,0,0,6
Eritrea,2008-07-01,0,0,0,3,1,4
Eritrea,2008-07-01,15,0,0,-6,1,10
Eritrea,2008-07-01,3,0,0,2,6,11
Eritrea,2008-07-01,8,0,0,-9,1,0
Eritrea,2008-07-01,0,0,0,0,1,1
Eritrea,2008-07-01,1,0,0,6,0,7
Eritrea,2008-07-01,-1,0,0,0,0,-1
Eritrea,2008-07-01,6,0,0,3,0,9
Eritrea,2008-07-01,2,0,0,0,0,2
Eritrea,2008-07-01,2,0,0,0,1,3
Eritrea,2008-07-01,4,0,0,0,2,6
Eritrea,2008-07-01,24,0,0,-2,0,22
Eritrea,2008-07-01,3,0,0,0,0,3
Eritrea,2008-07-01,2,0,0,3,3,8
Eritrea,2008-07-01,0,0,0,3,0,3
Eritrea,2008-07-01,0,0,0,3,0,3
Eritrea,2008-07-01,0,0,0,0,1,1
Georgia,2008-07-01,18,0,0,17,2,37
Georgia,2008-07-01,9,0,-1,17,2,27
Georgia,2008-07-01,12,0,0,-1,0,11
Georgia,2008-07-01,11,0,1,6,0,18
Georgia,2008-07-01,2,0,0,3,0,5
Georgia,2008-07-01,0,0,0,0,0,0
Georgia,2008-07-01,2,0,0,0,0,2
Georgia,2008-07-01,16,0,0,1,0,17
Georgia,2008-07-01,11,0,0,5,0,16
Georgia,2008-07-01,9,0,0,15,2,26
Georgia,2008-07-01,4,0,0,-2,0,2
Georgia,2008-07-01,0,0,0,3,0,3
Georgia,2008-07-01,3,0,0,0,-4,-1
Georgia,2008-07-01,-2,0,0,0,0,-2
Georgia,2008-07-01,8,0,0,0,0,8
Georgia,2008-07-01,3,0,0,-1,0,2
Georgia,2008-07-01,6,0,1,-3,0,4
Georgia,2008-07-01,5,0,0,3,1,9
Georgia,2008-07-01,0,0,0,0,0,0
Georgia,2008-07-01,5,0,0,0,0,5
Georgia,2008-07-01,11,0,0,3,1,15
Georgia,2008-07-01,2,0,0,0,1,3
Georgia,2008-07-01,14,0,0,1,0,15
Georgia,2008-07-01,5,0,0,3,3,11
Georgia,2008-07-01,7,0,0,0,0,7
Georgia,2008-07-01,2,0,0,6,0,8
Georgia,2008-07-01,2,0,0,0,0,2
Georgia,2008-07-01,3,0,0,0,3,6
Georgia,2008-07-01,5,0,0,0,0,5
Georgia,2008-07-01,5,0,0,3,0,8
Georgia,2008-07-01,6,0,0,-2,0,4
India,2008-07-01,25,0,0,-7,4,22
India,2008-07-01,37,0,0,-2,3,38
India,2008-07-01,4,2,0,3,2,11
India,2008-07-01,27,0,0,13,4,44
India,2008-07-01,24,2,0,10,6,42
India,2008-07-01,23,0,0,14,7,44
India,2008-07-01,104,0,0,1,26,131
India,2008-07-01,88,0,-1,6,15,108
India,2008-07-01,86,0,0,15,4,105
India,2008-07-01,102,2,4,38,14,160
India,2008-07-01,21,0,0,4,4,29
India,2008-07-01,25,0,0,14,9,48
India,2008-07-01,23,0,0,7,1,31
India,2008-07-01,21,0,0,-2,20,39
India,2008-07-01,9,0,1,3,15,28
India,2008-07-01,31,0,1,8,7,47
India,2008-07-01,45,0,0,9,6,60
India,2008-07-01,34,0,0,3,1,38
India,2008-07-01,72,0,0,3,6,81
India,2008-07-01,38,0,-1,-6,3,34
India,2008-07-01,44,0,-2,18,5,65
India,2008-07-01,32,0,-5,7,0,34
India,2008-07-01,22,10,0,25,14,71
India,2008-07-01,5,0,0,19,5,29
India,2008-07-01,22,2,0,14,6,44
India,2008-07-01,54,2,0,28,2,86
India,2008-07-01,10,0,0,3,0,13
India,2008-07-01,29,2,0,-3,4,32
India,2008-07-01,29,0,0,-2,2,29
India,2008-07-01,29,0,0,9,4,42
India,2008-07-01,76,0,-1,14,7,96
Iran,2008-07-01,67,0,0,17,2,86
Iran,2008-07-01,85,0,1,12,1,99
Iran,2008-07-01,91,0,0,35,3,129
Iran,2008-07-01,44,0,-6,38,2,78
Iran,2008-07-01,43,0,0,35,0,78
Iran,2008-07-01,17,0,-2,22,5,42
Iran,2008-07-01,95,0,2,18,17,132
Iran,2008-07-01,127,0,-3,22,16,162
Iran,2008-07-01,250,2,2,35,10,299
Iran,2008-07-01,338,0,6,27,27,398
Iran,2008-07-01,206,0,-1,10,15,230
Iran,2008-07-01,67,0,1,30,4,102
Iran,2008-07-01,39,0,-2,11,10,58
Iran,2008-07-01,54,0,0,11,5,70
Iran,2008-07-01,77,0,-2,10,4,89
Iran,2008-07-01,39,0,-1,10,3,51
Iran,2008-07-01,49,0,3,10,4,66
Iran,2008-07-01,29,0,3,21,4,57
Iran,2008-07-01,22,0,1,1,0,24
Iran,2008-07-01,27,0,-4,53,12,88
Iran,2008-07-01,48,0,0,13,4,65
Iran,2008-07-01,30,0,2,27,2,61
Iran,2008-07-01,62,0,-2,15,7,82
Iran,2008-07-01,26,4,1,33,17,81
Iran,2008-07-01,16,2,0,20,5,43
Iran,2008-07-01,22,0,0,15,1,38
Iran,2008-07-01,51,0,1,6,2,60
Iran,2008-07-01,11,0,0,13,1,25
Iran,2008-07-01,-7,0,2,15,4,14
Iran,2008-07-01,-9,0,-1,9,0,-1
Iran,2008-07-01,40,2,3,25,2,72
Iraq,2008-07-01,175,2,0,59,11,247
Iraq,2008-07-01,150,2,2,41,8,203
Iraq,2008-07-01,82,0,0,7,20,109
Iraq,2008-07-01,75,0,1,3,10,89
Iraq,2008-07-01,54,0,0,-4,0,50
Iraq,2008-07-01,150,0,-2,1,4,153
Iraq,2008-07-01,86,0,1,-5,28,110
Iraq,2008-07-01,163,4,0,20,9,196
Iraq,2008-07-01,75,0,2,24,19,120
Iraq,2008-07-01,115,0,6,82,12,215
Iraq,2008-07-01,188,4,-2,78,3,271
Iraq,2008-07-01,54,0,0,23,20,97
Iraq,2008-07-01,106,2,0,5,24,137
Iraq,2008-07-01,181,0,6,26,22,235
Iraq,2008-07-01,228,2,6,75,12,323
Iraq,2008-07-01,177,0,-1,44,21,241
Iraq,2008-07-01,121,0,0,17,4,142
Iraq,2008-07-01,98,4,2,18,10,132
Iraq,2008-07-01,2,2,0,13,3,20
Iraq,2008-07-01,150,0,3,33,29,215
Iraq,2008-07-01,121,0,0,17,21,159
Iraq,2008-07-01,82,4,-3,39,16,138
Iraq,2008-07-01,134,0,3,14,24,175
Iraq,2008-07-01,172,0,1,-4,20,189
Iraq,2008-07-01,58,0,-1,34,30,121
Iraq,2008-07-01,57,0,2,3,2,64
Iraq,2008-07-01,129,0,-4,31,4,160
Iraq,2008-07-01,128,2,0,54,19,203
Iraq,2008-07-01,131,0,2,24,16,173
Iraq,2008-07-01,22,0,-2,3,4,27
Iraq,2008-07-01,104,0,2,-5,14,115
Morocco,2008-07-01,0,0,0,0,0,0
Morocco,2008-07-01,0,0,0,18,2,20
Morocco,2008-07-01,0,0,-1,0,0,-1
Morocco,2008-07-01,0,0,0,0,0,0
Morocco,2008-07-01,6,0,0,0,0,6
Morocco,2008-07-01,4,0,0,6,2,12
Morocco,2008-07-01,0,0,0,3,0,3
Morocco,2008-07-01,2,0,0,3,0,5
Morocco,2008-07-01,4,0,0,6,0,10
Morocco,2008-07-01,0,0,0,3,2,5
Morocco,2008-07-01,8,0,0,0,1,9
Morocco,2008-07-01,0,0,0,3,0,3
Morocco,2008-07-01,8,0,0,-4,2,6
Morocco,2008-07-01,0,0,0,0,0,0
Morocco,2008-07-01,0,0,0,0,0,0
Morocco,2008-07-01,4,0,0,-2,0,2
Morocco,2008-07-01,5,0,0,12,0,17
Morocco,2008-07-01,0,0,0,3,14,17
Morocco,2008-07-01,2,0,0,0,0,2
Morocco,2008-07-01,0,0,0,0,0,0
Morocco,2008-07-01,6,0,1,3,0,10
Morocco,2008-07-01,7,0,0,3,0,10
Morocco,2008-07-01,3,0,0,0,0,3
Morocco,2008-07-01,1,0,0,-3,0,-2
Morocco,2008-07-01,0,0,0,-7,0,-7
Morocco,2008-07-01,3,0,0,-4,0,-1
Morocco,2008-07-01,2,0,0,8,0,10
Morocco,2008-07-01,2,0,1,3,0,6
Morocco,2008-07-01,0,0,0,-4,0,-4
Morocco,2008-07-01,1,0,1,3,4,9
Morocco,2008-07-01,0,2,0,-4,2,0
Nigeria,2008-07-01,16,0,0,2,0,18
Nigeria,2008-07-01,5,0,0,9,0,14
Nigeria,2008-07-01,3,0,0,0,0,3
Nigeria,2008-07-01,5,0,0,0,0,5
Nigeria,2008-07-01,8,0,0,0,0,8
Nigeria,2008-07-01,0,0,0,9,0,9
Nigeria,2008-07-01,16,0,-3,18,1,32
Nigeria,2008-07-01,-3,0,0,18,1,16
Nigeria,2008-07-01,33,0,0,3,4,40
Nigeria,2008-07-01,12,0,0,0,0,12
Nigeria,2008-07-01,15,0,0,-1,4,18
Nigeria,2008-07-01,4,0,0,3,2,9
Nigeria,2008-07-01,3,0,0,0,0,3
Nigeria,2008-07-01,0,0,0,2,2,4
Nigeria,2008-07-01,7,0,0,0,0,7
Nigeria,2008-07-01,41,0,0,6,0,47
Nigeria,2008-07-01,71,0,-2,15,0,84
Nigeria,2008-07-01,14,0,0,12,0,26
Nigeria,2008-07-01,8,0,0,9,4,21
Nigeria,2008-07-01,7,0,0,6,2,15
Nigeria,2008-07-01,3,0,0,1,3,7
Nigeria,2008-07-01,59,0,-2,25,5,87
Nigeria,2008-07-01,26,0,-2,21,7,52
Nigeria,2008-07-01,15,0,-2,-2,1,12
Nigeria,2008-07-01,4,0,0,12,2,18
Nigeria,2008-07-01,10,0,0,7,0,17
Nigeria,2008-07-01,6,0,0,0,0,6
Nigeria,2008-07-01,22,0,0,15,1,38
Nigeria,2008-07-01,0,0,0,0,2,2
Nigeria,2008-07-01,9,0,0,6,0,15
Nigeria,2008-07-01,4,0,0,6,0,10
Pakistan,2008-07-01,102,0,0,3,9,114
Pakistan,2008-07-01,119,0,0,10,11,140
Pakistan,2008-07-01,27,0,0,11,3,41
Pakistan,2008-07-01,70,0,0,3,10,83
Pakistan,2008-07-01,47,0,0,3,3,53
Pakistan,2008-07-01,31,0,0,8,2,41
Pakistan,2008-07-01,89,0,-1,6,3,97
Pakistan,2008-07-01,118,0,0,20,3,141
Pakistan,2008-07-01,88,0,0,16,7,111
Pakistan,2008-07-01,98,0,-10,6,1,95
Pakistan,2008-07-01,45,0,-6,-2,4,41
Pakistan,2008-07-01,79,0,-6,2,26,101
Pakistan,2008-07-01,140,0,1,21,7,169
Pakistan,2008-07-01,155,0,2,11,24,192
Pakistan,2008-07-01,112,0,0,17,7,136
Pakistan,2008-07-01,133,0,-1,13,6,151
Pakistan,2008-07-01,101,0,1,0,12,114
Pakistan,2008-07-01,69,0,0,6,3,78
Pakistan,2008-07-01,40,0,0,12,29,81
Pakistan,2008-07-01,119,0,-2,21,3,141
Pakistan,2008-07-01,56,0,0,18,1,75
Pakistan,2008-07-01,37,0,0,-2,5,40
Pakistan,2008-07-01,36,0,0,14,1,51
Pakistan,2008-07-01,121,0,0,22,18,161
Pakistan,2008-07-01,41,0,1,32,8,82
Pakistan,2008-07-01,61,4,0,6,1,72
Pakistan,2008-07-01,140,0,0,19,14,173
Pakistan,2008-07-01,78,0,3,14,18,113
Pakistan,2008-07-01,62,0,0,18,8,88
Pakistan,2008-07-01,45,0,2,6,6,59
Pakistan,2008-07-01,115,0,-2,48,15,176
Sierra Leone,2008-07-01,7,0,0,8,1,16
Sierra Leone,2008-07-01,18,0,0,0,0,18
Sierra Leone,2008-07-01,0,0,0,0,0,0
Sierra Leone,2008-07-01,0,0,0,0,0,0
Sierra Leone,2008-07-01,0,0,0,0,0,0
Sierra Leone,2008-07-01,0,0,0,3,0,3
Sierra Leone,2008-07-01,0,0,0,0,0,0
Sierra Leone,2008-07-01,0,0,0,3,0,3
Sierra Leone,2008-07-01,0,0,0,0,0,0
Sierra Leone,2008-07-01,1,0,0,15,0,16
Sierra Leone,2008-07-01,0,0,0,6,0,6
Sierra Leone,2008-07-01,7,0,0,6,2,15
Sierra Leone,2008-07-01,6,0,0,21,4,31
Sierra Leone,2008-07-01,2,0,0,3,2,7
Sierra Leone,2008-07-01,2,0,0,0,0,2
Sierra Leone,2008-07-01,0,0,0,3,0,3
Sierra Leone,2008-07-01,2,0,0,3,0,5
Sierra Leone,2008-07-01,2,0,0,3,0,5
Sierra Leone,2008-07-01,0,0,0,3,0,3
Sierra Leone,2008-07-01,4,0,0,3,2,9
Sierra Leone,2008-07-01,2,0,0,5,0,7
Sierra Leone,2008-07-01,3,0,0,0,0,3
Sierra Leone,2008-07-01,0,0,0,2,0,2
Sierra Leone,2008-07-01,0,0,0,0,0,0
Sierra Leone,2008-07-01,0,0,0,-6,0,-6
Sierra Leone,2008-07-01,7,0,0,3,0,10
Sierra Leone,2008-07-01,2,0,0,0,0,2
Somalia,2008-07-01,35,0,0,4,3,42
Somalia,2008-07-01,-1,0,0,0,1,0
Somalia,2008-07-01,12,0,3,15,6,36
Somalia,2008-07-01,8,0,0,0,2,10
Somalia,2008-07-01,3,0,0,9,0,12
Somalia,2008-07-01,0,0,0,-6,-2,-8
Somalia,2008-07-01,42,0,3,6,0,51
Somalia,2008-07-01,0,0,0,0,6,6
Somalia,2008-07-01,18,0,1,-5,4,18
Somalia,2008-07-01,4,0,0,0,0,4
Somalia,2008-07-01,29,0,0,0,3,32
Somalia,2008-07-01,0,0,0,0,0,0
Somalia,2008-07-01,0,0,0,0,0,0
Somalia,2008-07-01,3,0,0,0,0,3
Somalia,2008-07-01,2,0,0,0,5,7
Somalia,2008-07-01,2,0,0,6,0,8
Somalia,2008-07-01,5,0,0,6,0,11
Somalia,2008-07-01,9,0,0,3,0,12
Somalia,2008-07-01,22,0,0,0,0,22
Somalia,2008-07-01,6,0,0,8,0,14
Somalia,2008-07-01,36,0,0,9,2,47
Somalia,2008-07-01,16,0,0,6,0,22
Somalia,2008-07-01,47,4,0,1,1,53
Somalia,2008-07-01,50,2,0,9,0,61
Somalia,2008-07-01,57,2,0,2,2,63
Somalia,2008-07-01,36,6,0,6,0,48
Somalia,2008-07-01,7,0,0,3,0,10
Somalia,2008-07-01,29,0,0,7,5,41
Somalia,2008-07-01,2,0,0,3,0,5
Somalia,2008-07-01,10,0,-12,0,1,-1
Somalia,2008-07-01,21,0,-2,1,0,20
Syria,2008-07-01,23,0,0,11,0,34
Syria,2008-07-01,16,0,0,0,0,16
Syria,2008-07-01,14,0,0,6,0,20
Syria,2008-07-01,6,0,0,-1,0,5
Syria,2008-07-01,15,0,0,9,0,24
Syria,2008-07-01,0,0,1,13,0,14
Syria,2008-07-01,-1,2,0,7,0,8
Syria,2008-07-01,17,2,0,9,0,28
Syria,2008-07-01,25,0,0,1,1,27
Syria,2008-07-01,3,0,0,-8,0,-5
Syria,2008-07-01,5,0,-11,6,4,4
Syria,2008-07-01,12,0,1,0,0,13
Syria,2008-07-01,26,4,0,-9,4,25
Syria,2008-07-01,26,0,0,6,3,35
Syria,2008-07-01,8,0,0,6,7,21
Syria,2008-07-01,14,0,0,-1,9,22
Syria,2008-07-01,23,0,1,-3,4,25
Syria,2008-07-01,30,0,0,20,0,50
Syria,2008-07-01,-2,0,0,4,1,3
Syria,2008-07-01,1,0,0,36,0,37
Syria,2008-07-01,19,0,0,9,2,30
Syria,2008-07-01,10,0,0,1,0,11
Syria,2008-07-01,-2,0,0,25,9,32
Syria,2008-07-01,11,0,0,13,0,24
Syria,2008-07-01,31,0,0,-3,0,28
Syria,2008-07-01,19,0,0,0,0,19
Syria,2008-07-01,24,0,0,9,0,33
Syria,2008-07-01,11,0,0,-2,0,9
Syria,2008-07-01,15,0,0,0,0,15
Syria,2008-07-01,-3,0,-3,18,0,12
Syria,2008-07-01,21,0,-4,0,1,18
Yemen,2008-07-01,24,0,0,15,1,40
Yemen,2008-07-01,8,0,0,3,0,11
Yemen,2008-07-01,5,0,0,14,1,20
Yemen,2008-07-01,4,0,0,15,0,19
Yemen,2008-07-01,0,0,0,-2,1,-1
Yemen,2008-07-01,2,0,0,0,0,2
Yemen,2008-07-01,8,0,0,15,3,26
Yemen,2008-07-01,3,0,0,20,0,23
Yemen,2008-07-01,3,0,0,13,0,16
Yemen,2008-07-01,0,0,0,3,0,3
Yemen,2008-07-01,0,0,0,0,0,0
Yemen,2008-07-01,0,0,0,0,0,0
Yemen,2008-07-01,0,0,0,-2,1,-1
Yemen,2008-07-01,12,0,0,-2,1,11
Yemen,2008-07-01,6,0,0,18,0,24
Yemen,2008-07-01,4,0,0,15,0,19
Yemen,2008-07-01,6,0,1,30,0,37
Yemen,2008-07-01,3,0,1,19,0,23
Yemen,2008-07-01,5,0,1,9,0,15
Yemen,2008-07-01,0,0,0,2,0,2
Yemen,2008-07-01,26,0,0,27,0,53
Yemen,2008-07-01,15,0,0,26,0,41
Yemen,2008-07-01,39,0,0,23,0,62
Yemen,2008-07-01,8,0,0,9,3,20
Yemen,2008-07-01,10,0,0,-1,9,18
Yemen,2008-07-01,3,0,0,0,0,3
Yemen,2008-07-01,14,0,0,6,2,22
Yemen,2008-07-01,10,0,0,0,2,12
Yemen,2008-07-01,1,0,0,2,0,3
Yemen,2008-07-01,5,0,0,9,0,14
Yemen,2008-07-01,17,0,0,36,1,54
Afghanistan,2006-08-01,40,2,0,-1,9,50
Afghanistan,2006-08-01,65,0,0,2,7,74
Afghanistan,2006-08-01,100,0,0,18,21,139
Afghanistan,2006-08-01,30,0,4,3,5,42
Afghanistan,2006-08-01,21,0,0,6,9,36
Afghanistan,2006-08-01,45,0,0,4,4,53
Afghanistan,2006-08-01,13,0,0,6,2,21
Afghanistan,2006-08-01,47,0,-1,3,6,55
Afghanistan,2006-08-01,19,0,0,12,2,33
Afghanistan,2006-08-01,28,0,0,6,1,35
Afghanistan,2006-08-01,28,0,0,23,8,59
Afghanistan,2006-08-01,44,0,0,20,3,67
Afghanistan,2006-08-01,38,0,0,9,8,55
Afghanistan,2006-08-01,33,0,0,12,6,51
Afghanistan,2006-08-01,18,2,0,9,4,33
Afghanistan,2006-08-01,30,0,0,15,2,47
Afghanistan,2006-08-01,67,0,0,34,19,120
Afghanistan,2006-08-01,22,2,0,6,9,39
Afghanistan,2006-08-01,6,0,1,18,7,32
Afghanistan,2006-08-01,129,0,0,3,6,138
Afghanistan,2006-08-01,38,0,0,25,0,63
Afghanistan,2006-08-01,25,0,-2,5,7,35
Afghanistan,2006-08-01,55,0,0,14,13,82
Afghanistan,2006-08-01,48,0,0,39,3,90
Afghanistan,2006-08-01,28,0,0,1,0,29
Afghanistan,2006-08-01,27,0,0,10,6,43
Afghanistan,2006-08-01,66,0,0,0,2,68
Afghanistan,2006-08-01,35,0,0,18,1,54
Afghanistan,2006-08-01,33,0,1,12,2,48
Afghanistan,2006-08-01,59,0,0,43,3,105
Afghanistan,2006-08-01,2,0,0,3,1,6
Albania,2006-08-01,0,0,0,0,2,2
Albania,2006-08-01,15,0,0,0,1,16
Albania,2006-08-01,12,0,0,3,1,16
Albania,2006-08-01,9,0,0,0,2,11
Albania,2006-08-01,3,0,0,-2,0,1
Albania,2006-08-01,0,0,0,0,0,0
Albania,2006-08-01,16,0,0,0,2,18
Albania,2006-08-01,4,0,-2,6,2,10
Albania,2006-08-01,13,0,1,-2,1,13
Albania,2006-08-01,1,0,0,6,1,8
Albania,2006-08-01,0,0,0,12,0,12
Albania,2006-08-01,22,0,0,0,0,22
Albania,2006-08-01,12,0,0,0,0,12
Albania,2006-08-01,23,0,0,0,1,24
Albania,2006-08-01,16,0,-2,0,0,14
Albania,2006-08-01,4,0,0,-4,0,0
Albania,2006-08-01,0,0,0,0,-4,-4
Albania,2006-08-01,3,0,0,15,0,18
Albania,2006-08-01,6,0,0,0,0,6
Albania,2006-08-01,2,0,0,0,0,2
Albania,2006-08-01,3,0,0,3,0,6
Albania,2006-08-01,0,0,0,0,0,0
Albania,2006-08-01,2,0,0,0,1,3
Albania,2006-08-01,6,0,0,3,1,10
Albania,2006-08-01,9,0,0,0,3,12
Albania,2006-08-01,7,0,0,0,3,10
Albania,2006-08-01,18,0,-2,0,2,18
Albania,2006-08-01,4,0,-1,7,3,13
Albania,2006-08-01,0,0,0,3,0,3
Albania,2006-08-01,2,0,0,0,3,5
Albania,2006-08-01,5,0,0,-2,0,3
Algeria,2006-08-01,-1,0,0,0,0,-1
Algeria,2006-08-01,0,0,0,0,0,0
Algeria,2006-08-01,-1,0,0,3,0,2
Algeria,2006-08-01,3,0,0,0,0,3
Algeria,2006-08-01,0,0,0,0,0,0
Algeria,2006-08-01,2,0,0,0,0,2
Algeria,2006-08-01,0,0,0,0,0,0
Algeria,2006-08-01,-1,0,0,0,1,0
Algeria,2006-08-01,4,0,0,3,0,7
Algeria,2006-08-01,0,0,0,3,0,3
Algeria,2006-08-01,-2,0,0,3,0,1
Algeria,2006-08-01,0,0,0,3,0,3
Algeria,2006-08-01,3,0,0,3,2,8
Algeria,2006-08-01,2,0,0,0,0,2
Algeria,2006-08-01,0,0,0,0,0,0
Algeria,2006-08-01,4,0,0,1,0,5
Algeria,2006-08-01,2,0,0,7,0,9
Algeria,2006-08-01,-1,0,0,12,0,11
Algeria,2006-08-01,0,0,0,0,0,0
Algeria,2006-08-01,0,0,0,0,0,0
Algeria,2006-08-01,0,0,0,0,0,0
Algeria,2006-08-01,0,0,0,-2,0,-2
Algeria,2006-08-01,8,0,0,24,0,32
Algeria,2006-08-01,2,0,0,0,0,2
Algeria,2006-08-01,-1,0,0,-2,0,-3
Algeria,2006-08-01,-2,0,0,0,1,-1
Algeria,2006-08-01,0,0,0,0,0,0
Algeria,2006-08-01,7,0,0,0,2,9
Algeria,2006-08-01,0,0,0,0,0,0
Bangladesh,2006-08-01,-9,0,0,0,1,-8
Bangladesh,2006-08-01,3,0,-2,0,0,1
Bangladesh,2006-08-01,16,0,0,3,1,20
Bangladesh,2006-08-01,6,0,0,6,1,13
Bangladesh,2006-08-01,0,0,0,0,0,0
Bangladesh,2006-08-01,0,0,0,0,0,0
Bangladesh,2006-08-01,13,0,0,3,0,16
Bangladesh,2006-08-01,15,0,0,0,3,18
Bangladesh,2006-08-01,-4,0,0,6,0,2
Bangladesh,2006-08-01,0,0,0,0,0,0
Bangladesh,2006-08-01,0,0,0,0,0,0
Bangladesh,2006-08-01,8,0,0,15,0,23
Bangladesh,2006-08-01,12,0,0,3,0,15
Bangladesh,2006-08-01,10,0,0,0,0,10
Bangladesh,2006-08-01,11,0,0,4,0,15
Bangladesh,2006-08-01,4,0,0,2,0,6
Bangladesh,2006-08-01,3,0,0,-4,0,-1
Bangladesh,2006-08-01,19,0,0,9,1,29
Bangladesh,2006-08-01,16,0,0,3,0,19
Bangladesh,2006-08-01,0,0,0,-2,0,-2
Bangladesh,2006-08-01,1,0,0,0,0,1
Bangladesh,2006-08-01,10,0,0,1,2,13
Bangladesh,2006-08-01,7,0,0,4,0,11
Bangladesh,2006-08-01,3,0,0,10,0,13
Bangladesh,2006-08-01,5,0,0,-1,0,4
Bangladesh,2006-08-01,3,0,0,-2,0,1
Bangladesh,2006-08-01,9,0,0,0,0,9
Bangladesh,2006-08-01,7,0,0,0,0,7
Bangladesh,2006-08-01,3,0,0,3,0,6
Bangladesh,2006-08-01,1,0,0,0,0,1
Bangladesh,2006-08-01,5,0,1,0,0,6
Cameroon,2006-08-01,0,0,0,0,0,0
Cameroon,2006-08-01,4,0,0,3,2,9
Cameroon,2006-08-01,0,0,0,0,0,0
Cameroon,2006-08-01,2,0,0,0,2,4
Cameroon,2006-08-01,2,0,0,0,0,2
Cameroon,2006-08-01,0,0,0,0,0,0
Cameroon,2006-08-01,3,0,0,0,0,3
Cameroon,2006-08-01,3,0,0,0,1,4
Cameroon,2006-08-01,-2,0,0,-4,0,-6
Cameroon,2006-08-01,-3,0,0,0,0,-3
Cameroon,2006-08-01,2,0,0,0,0,2
Cameroon,2006-08-01,-3,0,0,0,0,-3
Cameroon,2006-08-01,0,0,0,0,0,0
Cameroon,2006-08-01,0,0,0,-2,0,-2
Cameroon,2006-08-01,1,0,-1,4,0,4
Cameroon,2006-08-01,3,0,0,0,0,3
Cameroon,2006-08-01,9,0,0,6,0,15
Cameroon,2006-08-01,7,0,0,0,0,7
Cameroon,2006-08-01,0,0,0,-2,0,-2
Cameroon,2006-08-01,0,0,0,0,0,0
Cameroon,2006-08-01,0,0,0,0,0,0
Cameroon,2006-08-01,6,0,0,0,0,6
Cameroon,2006-08-01,0,0,0,0,0,0
Cameroon,2006-08-01,2,0,0,0,0,2
China,2006-08-01,15,0,0,3,12,30
China,2006-08-01,37,0,0,10,4,51
China,2006-08-01,45,0,-2,25,1,69
China,2006-08-01,20,0,0,6,2,28
China,2006-08-01,5,0,1,15,1,22
China,2006-08-01,42,0,0,0,4,46
China,2006-08-01,40,0,0,16,12,68
China,2006-08-01,23,0,-4,18,3,40
China,2006-08-01,45,0,0,60,6,111
China,2006-08-01,12,0,-1,15,0,26
China,2006-08-01,45,0,0,2,0,47
China,2006-08-01,7,0,0,2,1,10
China,2006-08-01,21,0,0,3,8,32
China,2006-08-01,13,0,1,18,4,36
China,2006-08-01,25,0,0,7,6,38
China,2006-08-01,11,0,-2,19,6,34
China,2006-08-01,9,2,-1,12,3,25
China,2006-08-01,23,0,2,9,1,35
China,2006-08-01,51,0,0,27,2,80
China,2006-08-01,19,2,0,10,1,32
China,2006-08-01,63,0,2,35,2,102
China,2006-08-01,49,0,0,26,12,87
China,2006-08-01,21,0,0,10,4,35
China,2006-08-01,29,0,-1,23,13,64
China,2006-08-01,35,0,-2,11,3,47
China,2006-08-01,43,0,0,17,1,61
China,2006-08-01,20,0,0,4,0,24
China,2006-08-01,44,0,0,7,4,55
China,2006-08-01,28,0,0,27,5,60
China,2006-08-01,10,0,1,12,4,27
China,2006-08-01,19,0,2,33,7,61
Egypt,2006-08-01,19,0,0,2,0,21
Egypt,2006-08-01,-1,0,0,6,0,5
Egypt,2006-08-01,24,0,0,9,0,33
Egypt,2006-08-01,22,0,0,0,1,23
Egypt,2006-08-01,14,2,0,0,0,16
Egypt,2006-08-01,31,0,0,19,10,60
Egypt,2006-08-01,16,0,0,6,1,23
Egypt,2006-08-01,11,0,0,0,0,11
Egypt,2006-08-01,9,0,0,0,2,11
Egypt,2006-08-01,28,0,0,10,0,38
Egypt,2006-08-01,11,0,0,6,0,17
Egypt,2006-08-01,8,0,0,14,0,22
Egypt,2006-08-01,29,0,0,-7,0,22
Egypt,2006-08-01,36,0,0,3,0,39
Egypt,2006-08-01,-3,0,0,0,0,-3
Egypt,2006-08-01,5,0,0,-2,1,4
Egypt,2006-08-01,6,0,0,6,1,13
Egypt,2006-08-01,8,0,0,21,6,35
Egypt,2006-08-01,12,0,0,6,0,18
Egypt,2006-08-01,12,0,0,9,0,21
Egypt,2006-08-01,13,0,1,5,2,21
Egypt,2006-08-01,9,0,0,0,0,9
Egypt,2006-08-01,35,0,0,14,0,49
Egypt,2006-08-01,6,0,0,10,0,16
Egypt,2006-08-01,3,0,0,3,0,6
Egypt,2006-08-01,-1,0,0,0,0,-1
Egypt,2006-08-01,0,0,0,3,2,5
Egypt,2006-08-01,1,0,0,-5,0,-4
Egypt,2006-08-01,8,0,0,0,0,8
Egypt,2006-08-01,10,0,0,1,2,13
Egypt,2006-08-01,-6,0,0,0,0,-6
Eritrea,2006-08-01,6,0,-4,-6,0,-4
Eritrea,2006-08-01,4,0,0,0,0,4
Eritrea,2006-08-01,2,0,0,0,0,2
Eritrea,2006-08-01,13,0,0,0,0,13
Eritrea,2006-08-01,6,0,0,0,0,6
Eritrea,2006-08-01,0,0,0,0,0,0
Eritrea,2006-08-01,-1,0,0,1,0,0
Eritrea,2006-08-01,4,0,0,0,0,4
Eritrea,2006-08-01,8,0,0,0,0,8
Eritrea,2006-08-01,1,0,0,3,0,4
Eritrea,2006-08-01,0,0,0,1,0,1
Eritrea,2006-08-01,9,0,0,0,0,9
Eritrea,2006-08-01,0,0,0,0,0,0
Eritrea,2006-08-01,11,0,0,0,0,11
Eritrea,2006-08-01,0,0,0,0,0,0
Eritrea,2006-08-01,2,0,0,0,0,2
Eritrea,2006-08-01,3,0,0,0,0,3
Eritrea,2006-08-01,4,0,0,0,3,7
Eritrea,2006-08-01,0,0,0,0,0,0
Eritrea,2006-08-01,0,0,0,0,0,0
Eritrea,2006-08-01,0,0,0,0,0,0
Eritrea,2006-08-01,0,0,0,6,2,8
Eritrea,2006-08-01,0,0,0,9,0,9
Eritrea,2006-08-01,0,0,0,0,0,0
Eritrea,2006-08-01,3,0,0,5,1,9
Georgia,2006-08-01,0,0,0,3,0,3
Georgia,2006-08-01,-1,0,0,3,0,2
Georgia,2006-08-01,7,0,-2,-2,0,3
Georgia,2006-08-01,0,0,0,3,0,3
Georgia,2006-08-01,4,0,0,9,0,13
Georgia,2006-08-01,2,0,0,-2,0,0
Georgia,2006-08-01,3,0,0,0,0,3
Georgia,2006-08-01,0,0,0,0,0,0
Georgia,2006-08-01,0,0,0,3,0,3
Georgia,2006-08-01,6,0,0,0,0,6
Georgia,2006-08-01,2,0,0,9,0,11
Georgia,2006-08-01,0,0,0,0,0,0
Georgia,2006-08-01,4,0,0,0,1,5
Georgia,2006-08-01,2,0,0,0,4,6
Georgia,2006-08-01,9,0,0,6,0,15
Georgia,2006-08-01,1,0,-4,6,0,3
Georgia,2006-08-01,10,0,0,0,0,10
Georgia,2006-08-01,3,0,0,0,0,3
Georgia,2006-08-01,10,0,0,0,1,11
Georgia,2006-08-01,0,0,1,0,2,3
Georgia,2006-08-01,3,0,0,9,0,12
Georgia,2006-08-01,3,0,0,3,0,6
Georgia,2006-08-01,-1,0,0,6,0,5
Georgia,2006-08-01,0,0,0,0,0,0
Georgia,2006-08-01,14,0,0,3,0,17
Georgia,2006-08-01,0,0,0,0,0,0
Georgia,2006-08-01,-1,0,0,0,0,-1
India,2006-08-01,7,0,0,-6,0,1
India,2006-08-01,25,0,0,0,0,25
India,2006-08-01,11,0,0,0,2,13
India,2006-08-01,17,0,-2,6,0,21
India,2006-08-01,6,2,0,3,3,14
India,2006-08-01,5,0,0,6,2,13
India,2006-08-01,3,0,1,-4,2,2
India,2006-08-01,1,0,0,6,2,9
India,2006-08-01,0,0,0,0,0,0
India,2006-08-01,9,0,1,15,0,25
India,2006-08-01,10,0,-1,3,3,15
India,2006-08-01,12,0,0,6,3,21
India,2006-08-01,9,0,0,6,1,16
India,2006-08-01,25,0,0,9,0,34
India,2006-08-01,2,0,0,3,3,8
India,2006-08-01,3,0,0,0,0,3
India,2006-08-01,19,0,0,-1,1,19
India,2006-08-01,13,0,-4,-3,2,8
India,2006-08-01,6,0,-1,24,0,29
India,2006-08-01,5,0,-2,0,0,3
India,2006-08-01,5,0,-2,-2,0,1
India,2006-08-01,20,0,-2,6,1,25
India,2006-08-01,5,0,0,0,0,5
India,2006-08-01,20,0,0,6,2,28
India,2006-08-01,22,2,0,3,6,33
India,2006-08-01,10,0,0,1,0,11
India,2006-08-01,13,0,0,-12,0,1
India,2006-08-01,3,0,-1,-5,1,-2
India,2006-08-01,8,0,0,15,1,24
India,2006-08-01,4,0,0,-2,6,8
India,2006-08-01,8,0,0,1,1,10
Iran,2006-08-01,131,0,0,6,1,138
Iran,2006-08-01,54,0,0,1,0,55
Iran,2006-08-01,23,0,0,4,4,31
Iran,2006-08-01,32,0,0,12,5,49
Iran,2006-08-01,33,0,0,3,2,38
Iran,2006-08-01,37,0,3,12,1,53
Iran,2006-08-01,21,0,0,0,10,31
Iran,2006-08-01,56,0,1,0,2,59
Iran,2006-08-01,27,0,1,7,3,38
Iran,2006-08-01,50,0,-2,22,9,79
Iran,2006-08-01,31,0,0,18,9,58
Iran,2006-08-01,11,0,0,6,0,17
Iran,2006-08-01,28,0,0,6,0,34
Iran,2006-08-01,27,0,-1,16,6,48
Iran,2006-08-01,39,0,0,9,8,56
Iran,2006-08-01,34,0,0,-5,0,29
Iran,2006-08-01,34,0,0,-1,6,39
Iran,2006-08-01,50,0,1,12,1,64
Iran,2006-08-01,47,0,0,0,1,48
Iran,2006-08-01,27,0,0,7,7,41
Iran,2006-08-01,47,0,3,4,5,59
Iran,2006-08-01,83,0,1,11,3,98
Iran,2006-08-01,41,0,1,4,7,53
Iran,2006-08-01,22,0,0,12,10,44
Iran,2006-08-01,24,0,0,12,4,40
Iran,2006-08-01,37,0,0,-2,2,37
Iran,2006-08-01,54,0,0,4,3,61
Iran,2006-08-01,33,0,0,33,1,67
Iran,2006-08-01,56,2,1,-1,3,61
Iran,2006-08-01,33,0,-2,4,2,37
Iran,2006-08-01,19,0,5,23,5,52
Iraq,2006-08-01,95,0,-1,22,12,128
Iraq,2006-08-01,46,2,1,2,11,62
Iraq,2006-08-01,59,2,1,27,2,91
Iraq,2006-08-01,37,0,1,41,21,100
Iraq,2006-08-01,33,2,0,22,11,68
Iraq,2006-08-01,59,0,-4,31,14,100
Iraq,2006-08-01,26,2,-2,9,19,54
Iraq,2006-08-01,55,4,1,-6,2,56
Iraq,2006-08-01,108,0,1,9,5,123
Iraq,2006-08-01,50,0,1,23,3,77
Iraq,2006-08-01,53,0,1,-2,5,57
Iraq,2006-08-01,46,0,-2,3,8,55
Iraq,2006-08-01,35,0,0,18,4,57
Iraq,2006-08-01,55,0,0,12,2,69
Iraq,2006-08-01,53,0,4,18,12,87
Iraq,2006-08-01,37,0,0,6,2,45
Iraq,2006-08-01,58,0,2,59,7,126
Iraq,2006-08-01,45,0,0,16,1,62
Iraq,2006-08-01,16,0,0,7,2,25
Iraq,2006-08-01,22,0,0,18,6,46
Iraq,2006-08-01,83,0,0,36,6,125
Iraq,2006-08-01,37,0,1,10,4,52
Iraq,2006-08-01,72,0,2,26,7,107
Iraq,2006-08-01,81,0,1,36,4,122
Iraq,2006-08-01,73,0,0,33,1,107
Iraq,2006-08-01,43,0,0,21,1,65
Iraq,2006-08-01,76,0,2,6,12,96
Iraq,2006-08-01,78,0,0,12,8,98
Iraq,2006-08-01,91,0,1,15,3,110
Iraq,2006-08-01,77,0,0,22,4,103
Iraq,2006-08-01,58,0,-1,9,10,76
Morocco,2006-08-01,0,0,0,3,0,3
Morocco,2006-08-01,0,0,0,0,0,0
Morocco,2006-08-01,0,0,0,0,0,0
Morocco,2006-08-01,0,0,0,0,0,0
Morocco,2006-08-01,0,0,0,0,0,0
Morocco,2006-08-01,0,0,0,3,1,4
Morocco,2006-08-01,0,0,0,0,0,0
Morocco,2006-08-01,-1,0,0,-5,0,-6
Morocco,2006-08-01,-1,0,0,0,0,-1
Morocco,2006-08-01,0,0,0,6,0,6
Morocco,2006-08-01,24,0,0,12,0,36
Morocco,2006-08-01,-1,0,0,6,0,5
Morocco,2006-08-01,8,0,0,0,0,8
Morocco,2006-08-01,-13,0,0,12,0,-1
Morocco,2006-08-01,8,0,0,4,0,12
Morocco,2006-08-01,-5,0,0,0,1,-4
Morocco,2006-08-01,0,0,0,3,0,3
Morocco,2006-08-01,0,0,0,6,0,6
Morocco,2006-08-01,0,0,0,3,0,3
Morocco,2006-08-01,0,0,0,2,0,2
Morocco,2006-08-01,3,0,0,0,0,3
Morocco,2006-08-01,0,0,0,0,0,0
Morocco,2006-08-01,1,0,0,6,0,7
Morocco,2006-08-01,0,0,0,3,0,3
Morocco,2006-08-01,0,0,0,0,0,0
Morocco,2006-08-01,3,0,0,0,0,3
Morocco,2006-08-01,6,0,0,0,0,6
Morocco,2006-08-01,0,0,0,9,0,9
Morocco,2006-08-01,0,0,0,9,0,9
Morocco,2006-08-01,1,0,0,1,0,2
Nigeria,2006-08-01,25,0,0,-4,5,26
Nigeria,2006-08-01,16,4,-2,2,1,21
Nigeria,2006-08-01,34,0,-12,3,0,25
Nigeria,2006-08-01,35,0,-6,0,0,29
Nigeria,2006-08-01,1,0,0,0,0,1
Nigeria,2006-08-01,4,0,-2,0,0,2
Nigeria,2006-08-01,30,0,-1,2,2,33
Nigeria,2006-08-01,11,0,-1,1,1,12
Nigeria,2006-08-01,9,0,1,28,3,41
Nigeria,2006-08-01,14,0,-2,21,1,34
Nigeria,2006-08-01,24,0,0,-1,0,23
Nigeria,2006-08-01,1,0,0,-1,0,0
Nigeria,2006-08-01,8,0,0,1,0,9
Nigeria,2006-08-01,3,0,0,2,0,5
Nigeria,2006-08-01,26,0,0,17,5,48
Nigeria,2006-08-01,30,0,0,6,3,39
Nigeria,2006-08-01,13,0,1,12,0,26
Nigeria,2006-08-01,15,0,0,2,2,19
Nigeria,2006-08-01,8,0,0,-3,0,5
Nigeria,2006-08-01,5,0,0,0,7,12
Nigeria,2006-08-01,18,0,2,9,0,29
Nigeria,2006-08-01,11,0,0,-8,0,3
Nigeria,2006-08-01,0,0,0,1,1,2
Nigeria,2006-08-01,10,0,0,14,1,25
Nigeria,2006-08-01,3,0,0,3,1,7
Nigeria,2006-08-01,0,0,0,3,0,3
Nigeria,2006-08-01,9,0,0,6,3,18
Nigeria,2006-08-01,12,0,0,4,-2,14
Nigeria,2006-08-01,12,0,-2,1,1,12
Nigeria,2006-08-01,-5,0,-2,2,2,-3
Nigeria,2006-08-01,12,0,-1,2,6,19
Pakistan,2006-08-01,30,0,0,6,1,37
Pakistan,2006-08-01,9,0,0,3,3,15
Pakistan,2006-08-01,32,0,0,1,5,38
Pakistan,2006-08-01,11,0,0,21,0,32
Pakistan,2006-08-01,7,0,0,9,3,19
Pakistan,2006-08-01,7,0,0,17,0,24
Pakistan,2006-08-01,7,0,0,3,1,11
Pakistan,2006-08-01,32,0,0,2,0,34
Pakistan,2006-08-01,28,0,0,14,0,42
Pakistan,2006-08-01,37,0,0,21,0,58
Pakistan,2006-08-01,42,0,-1,70,0,111
Pakistan,2006-08-01,38,0,2,39,3,82
Pakistan,2006-08-01,58,2,0,61,0,121
Pakistan,2006-08-01,67,0,0,1,9,77
Pakistan,2006-08-01,33,2,0,48,4,87
Pakistan,2006-08-01,23,0,0,45,4,72
Pakistan,2006-08-01,21,0,0,22,6,49
Pakistan,2006-08-01,14,0,0,45,2,61
Pakistan,2006-08-01,9,0,0,21,5,35
Pakistan,2006-08-01,11,0,0,9,0,20
Pakistan,2006-08-01,38,0,0,8,1,47
Pakistan,2006-08-01,61,0,0,34,8,103
Pakistan,2006-08-01,35,0,0,42,3,80
Pakistan,2006-08-01,43,2,0,28,3,76
Pakistan,2006-08-01,16,0,0,24,2,42
Pakistan,2006-08-01,10,0,0,7,0,17
Pakistan,2006-08-01,16,0,0,2,0,18
Pakistan,2006-08-01,18,0,0,13,2,33
Pakistan,2006-08-01,6,0,0,11,0,17
Pakistan,2006-08-01,23,0,0,28,2,53
Pakistan,2006-08-01,7,0,2,21,4,34
Sierra Leone,2006-08-01,0,0,0,3,0,3
Sierra Leone,2006-08-01,2,0,0,3,0,5
Sierra Leone,2006-08-01,-1,0,0,0,0,-1
Sierra Leone,2006-08-01,19,0,0,15,1,35
Sierra Leone,2006-08-01,9,0,0,0,1,10
Sierra Leone,2006-08-01,0,0,0,0,0,0
Sierra Leone,2006-08-01,0,0,0,0,0,0
Sierra Leone,2006-08-01,2,0,0,0,0,2
Sierra Leone,2006-08-01,0,0,0,0,0,0
Sierra Leone,2006-08-01,0,0,0,0,0,0
Sierra Leone,2006-08-01,2,0,0,0,0,2
Sierra Leone,2006-08-01,2,0,0,0,0,2
Sierra Leone,2006-08-01,2,0,0,3,0,5
Sierra Leone,2006-08-01,0,0,0,0,0,0
Sierra Leone,2006-08-01,3,0,0,0,0,3
Sierra Leone,2006-08-01,0,0,0,0,0,0
Sierra Leone,2006-08-01,0,0,0,0,0,0
Sierra Leone,2006-08-01,0,0,0,0,0,0
Sierra Leone,2006-08-01,0,0,0,0,0,0
Sierra Leone,2006-08-01,0,0,0,0,0,0
Sierra Leone,2006-08-01,1,0,0,0,0,1
Sierra Leone,2006-08-01,0,0,0,0,0,0
Somalia,2006-08-01,3,0,-6,6,0,3
Somalia,2006-08-01,10,0,0,0,0,10
Somalia,2006-08-01,1,0,-4,9,0,6
Somalia,2006-08-01,4,0,-2,0,0,2
Somalia,2006-08-01,-2,0,0,8,0,6
Somalia,2006-08-01,2,0,0,-1,0,1
Somalia,2006-08-01,1,0,0,0,0,1
Somalia,2006-08-01,0,0,0,0,0,0
Somalia,2006-08-01,2,2,0,-3,0,1
Somalia,2006-08-01,16,0,0,0,0,16
Somalia,2006-08-01,3,0,0,0,0,3
Somalia,2006-08-01,1,0,0,0,0,1
Somalia,2006-08-01,0,0,0,0,0,0
Somalia,2006-08-01,7,0,0,0,0,7
Somalia,2006-08-01,2,0,0,0,0,2
Somalia,2006-08-01,1,0,0,-2,0,-1
Somalia,2006-08-01,1,0,0,6,2,9
Somalia,2006-08-01,24,0,0,0,0,24
Somalia,2006-08-01,2,0,0,0,0,2
Somalia,2006-08-01,7,0,0,-2,0,5
Somalia,2006-08-01,4,0,0,0,0,4
Somalia,2006-08-01,6,0,0,0,0,6
Somalia,2006-08-01,2,0,0,0,0,2
Somalia,2006-08-01,2,0,0,0,0,2
Somalia,2006-08-01,0,0,0,3,0,3
Somalia,2006-08-01,2,0,0,12,0,14
Somalia,2006-08-01,14,0,0,0,0,14
Somalia,2006-08-01,10,0,0,9,2,21
Somalia,2006-08-01,9,2,0,0,0,11
Somalia,2006-08-01,5,0,0,0,0,5
Somalia,2006-08-01,13,0,0,0,1,14
Syria,2006-08-01,46,0,0,8,3,57
Syria,2006-08-01,84,0,0,9,2,95
Syria,2006-08-01,43,0,0,0,1,44
Syria,2006-08-01,58,0,0,3,10,71
Syria,2006-08-01,60,0,0,0,2,62
Syria,2006-08-01,95,0,5,2,2,104
Syria,2006-08-01,58,0,3,3,7,71
Syria,2006-08-01,23,0,1,0,0,24
Syria,2006-08-01,16,0,0,7,3,26
Syria,2006-08-01,27,0,0,4,1,32
Syria,2006-08-01,65,0,0,4,0,69
Syria,2006-08-01,14,0,0,6,0,20
Syria,2006-08-01,13,0,0,39,1,53
Syria,2006-08-01,45,8,1,0,2,56
Syria,2006-08-01,12,0,0,3,2,17
Syria,2006-08-01,14,0,3,3,3,23
Syria,2006-08-01,12,0,0,14,0,26
Syria,2006-08-01,20,0,0,-2,0,18
Syria,2006-08-01,54,0,0,0,0,54
Syria,2006-08-01,62,0,1,0,0,63
Syria,2006-08-01,33,0,0,3,2,38
Syria,2006-08-01,24,0,0,9,9,42
Syria,2006-08-01,40,0,0,25,6,71
Syria,2006-08-01,43,0,0,34,8,85
Syria,2006-08-01,32,0,0,13,5,50
Syria,2006-08-01,13,0,0,6,1,20
Syria,2006-08-01,15,0,0,6,2,23
Syria,2006-08-01,5,0,0,6,5,16
Syria,2006-08-01,9,0,0,17,3,29
Syria,2006-08-01,-4,0,0,-5,4,-5
Syria,2006-08-01,24,0,0,18,3,45
Yemen,2006-08-01,0,0,0,0,0,0
Yemen,2006-08-01,5,0,0,0,0,5
Yemen,2006-08-01,5,0,0,0,0,5
Yemen,2006-08-01,8,0,0,0,0,8
Yemen,2006-08-01,4,0,0,0,0,4
Yemen,2006-08-01,0,0,0,0,0,0
Yemen,2006-08-01,7,0,0,0,0,7
Yemen,2006-08-01,0,0,0,0,0,0
Yemen,2006-08-01,2,0,0,0,0,2
Yemen,2006-08-01,0,0,0,0,0,0
Yemen,2006-08-01,-1,0,0,0,0,-1
Yemen,2006-08-01,0,0,0,0,0,0
Yemen,2006-08-01,0,0,0,0,0,0
Yemen,2006-08-01,0,0,0,0,0,0
Yemen,2006-08-01,3,0,0,3,0,6
Yemen,2006-08-01,0,0,0,0,0,0
Yemen,2006-08-01,-3,0,0,0,0,-3
Yemen,2006-08-01,0,0,0,3,0,3
Yemen,2006-08-01,24,0,0,0,0,24
Yemen,2006-08-01,0,0,0,0,0,0
Yemen,2006-08-01,0,0,0,0,0,0
Yemen,2006-08-01,0,0,0,0,0,0
Yemen,2006-08-01,0,0,0,0,0,0
Yemen,2006-08-01,0,0,0,0,0,0
Yemen,2006-08-01,0,0,0,0,0,0
Yemen,2006-08-01,0,0,0,0,0,0
Yemen,2006-08-01,0,0,0,3,0,3
Yemen,2006-08-01,0,0,0,0,0,0
Afghanistan,2011-12-01,181,8,0,31,20,240
Afghanistan,2011-12-01,254,0,-2,-10,18,260
Afghanistan,2011-12-01,160,4,0,35,39,238
Afghanistan,2011-12-01,253,4,0,15,19,291
Afghanistan,2011-12-01,223,12,-1,11,13,258
Afghanistan,2011-12-01,174,2,-1,44,21,240
Afghanistan,2011-12-01,141,12,-2,8,11,170
Afghanistan,2011-12-01,166,0,1,25,15,207
Afghanistan,2011-12-01,134,0,1,45,22,202
Afghanistan,2011-12-01,78,0,0,46,12,136
Afghanistan,2011-12-01,101,4,0,2,3,110
Afghanistan,2011-12-01,136,0,-3,49,3,185
Afghanistan,2011-12-01,115,2,0,49,12,178
Afghanistan,2011-12-01,99,2,-1,25,18,143
Afghanistan,2011-12-01,119,0,0,4,12,135
Afghanistan,2011-12-01,131,4,14,58,23,230
Afghanistan,2011-12-01,127,0,3,16,2,148
Afghanistan,2011-12-01,174,4,0,20,6,204
Afghanistan,2011-12-01,88,16,4,-2,12,118
Afghanistan,2011-12-01,60,10,0,13,8,91
Afghanistan,2011-12-01,206,0,-2,49,24,277
Afghanistan,2011-12-01,116,0,-8,8,10,126
Afghanistan,2011-12-01,156,0,0,26,5,187
Afghanistan,2011-12-01,80,0,0,8,6,94
Afghanistan,2011-12-01,115,0,2,10,11,138
Afghanistan,2011-12-01,136,4,2,25,7,174
Afghanistan,2011-12-01,170,0,0,27,11,208
Afghanistan,2011-12-01,197,2,0,5,22,226
Afghanistan,2011-12-01,129,0,-2,1,10,138
Afghanistan,2011-12-01,201,0,0,24,31,256
Afghanistan,2011-12-01,91,4,-1,33,5,132
Albania,2011-12-01,10,0,0,6,2,18
Albania,2011-12-01,0,0,0,5,6,11
Albania,2011-12-01,3,0,0,0,0,3
Albania,2011-12-01,6,0,0,6,1,13
Albania,2011-12-01,5,0,-1,9,0,13
Albania,2011-12-01,24,0,0,9,0,33
Albania,2011-12-01,23,0,0,3,0,26
Albania,2011-12-01,-1,0,0,0,0,-1
Albania,2011-12-01,0,0,0,0,0,0
Albania,2011-12-01,0,0,0,0,3,3
Albania,2011-12-01,1,0,1,0,0,2
Albania,2011-12-01,22,0,-2,0,1,21
Albania,2011-12-01,30,0,-1,3,0,32
Albania,2011-12-01,8,0,2,21,0,31
Albania,2011-12-01,2,0,-1,0,2,3
Albania,2011-12-01,8,0,0,0,0,8
Albania,2011-12-01,0,0,0,0,0,0
Albania,2011-12-01,26,0,-2,3,0,27
Albania,2011-12-01,8,0,0,2,0,10
Albania,2011-12-01,14,0,0,3,0,17
Albania,2011-12-01,-1,0,0,0,0,-1
Albania,2011-12-01,2,0,0,0,0,2
Albania,2011-12-01,0,0,0,0,0,0
Albania,2011-12-01,7,0,0,0,0,7
Albania,2011-12-01,2,0,0,6,0,8
Albania,2011-12-01,-1,0,0,-2,0,-3
Albania,2011-12-01,7,0,0,3,0,10
Albania,2011-12-01,3,0,-3,0,1,1
Albania,2011-12-01,4,0,0,0,0,4
Algeria,2011-12-01,10,0,0,16,0,26
Algeria,2011-12-01,5,0,0,6,3,14
Algeria,2011-12-01,5,0,0,0,0,5
Algeria,2011-12-01,4,0,0,-2,0,2
Algeria,2011-12-01,4,0,0,16,0,20
Algeria,2011-12-01,8,0,0,6,6,20
Algeria,2011-12-01,8,0,0,12,0,20
Algeria,2011-12-01,12,0,0,0,4,16
Algeria,2011-12-01,7,0,0,3,2,12
Algeria,2011-12-01,10,0,0,0,2,12
Algeria,2011-12-01,4,0,0,3,0,7
Algeria,2011-12-01,0,0,0,10,0,10
Algeria,2011-12-01,14,0,-1,4,3,20
Algeria,2011-12-01,13,0,0,23,2,38
Algeria,2011-12-01,7,0,0,27,10,44
Algeria,2011-12-01,29,0,1,3,0,33
Algeria,2011-12-01,44,0,1,7,4,56
Algeria,2011-12-01,30,0,1,-4,0,27
Algeria,2011-12-01,-1,0,0,0,0,-1
Algeria,2011-12-01,8,0,1,0,1,10
Algeria,2011-12-01,50,0,0,7,0,57
Algeria,2011-12-01,46,0,0,3,3,52
Algeria,2011-12-01,61,0,0,15,8,84
Algeria,2011-12-01,16,0,0,0,0,16
Algeria,2011-12-01,17,0,0,0,0,17
Algeria,2011-12-01,16,0,0,-3,0,13
Algeria,2011-12-01,1,0,0,-3,0,-2
Algeria,2011-12-01,8,0,0,0,4,12
Algeria,2011-12-01,10,0,0,0,0,10
Algeria,2011-12-01,6,0,0,9,3,18
Algeria,2011-12-01,10,0,-2,0,4,12
Bangladesh,2011-12-01,4,0,0,6,0,10
Bangladesh,2011-12-01,13,0,0,1,1,15
Bangladesh,2011-12-01,14,0,0,-4,0,10
Bangladesh,2011-12-01,15,0,0,13,1,29
Bangladesh,2011-12-01,1,0,0,0,0,1
Bangladesh,2011-12-01,14,0,-2,1,14,27
Bangladesh,2011-12-01,7,0,0,4,5,16
Bangladesh,2011-12-01,13,0,-1,4,0,16
Bangladesh,2011-12-01,7,0,0,-3,2,6
Bangladesh,2011-12-01,17,0,-2,-6,2,11
Bangladesh,2011-12-01,11,0,-2,4,0,13
Bangladesh,2011-12-01,3,0,-2,0,0,1
Bangladesh,2011-12-01,10,0,0,6,0,16
Bangladesh,2011-12-01,5,0,0,3,4,12
Bangladesh,2011-12-01,23,0,0,5,1,29
Bangladesh,2011-12-01,24,0,2,15,3,44
Bangladesh,2011-12-01,19,0,-2,3,0,20
Bangladesh,2011-12-01,10,0,1,12,0,23
Bangladesh,2011-12-01,6,2,0,0,1,9
Bangladesh,2011-12-01,5,0,0,5,3,13
Bangladesh,2011-12-01,6,0,0,4,-2,8
Bangladesh,2011-12-01,6,0,0,-2,1,5
Bangladesh,2011-12-01,7,0,0,3,0,10
Bangladesh,2011-12-01,21,0,0,-1,0,20
Bangladesh,2011-12-01,2,0,0,4,1,7
Bangladesh,2011-12-01,8,2,0,0,0,10
Bangladesh,2011-12-01,22,0,1,16,1,40
Bangladesh,2011-12-01,20,0,0,9,1,30
Bangladesh,2011-12-01,18,0,-4,6,0,20
Bangladesh,2011-12-01,2,0,0,0,0,2
Bangladesh,2011-12-01,13,0,0,3,2,18
Cameroon,2011-12-01,0,0,0,0,2,2
Cameroon,2011-12-01,0,0,-6,0,0,-6
Cameroon,2011-12-01,0,0,0,0,0,0
Cameroon,2011-12-01,0,2,0,0,0,2
Cameroon,2011-12-01,0,0,-2,0,0,-2
Cameroon,2011-12-01,2,0,0,0,0,2
Cameroon,2011-12-01,0,0,0,0,4,4
Cameroon,2011-12-01,2,0,0,3,0,5
Cameroon,2011-12-01,1,0,0,0,0,1
Cameroon,2011-12-01,0,0,0,0,0,0
Cameroon,2011-12-01,1,0,0,0,0,1
Cameroon,2011-12-01,0,0,0,0,0,0
Cameroon,2011-12-01,0,0,0,3,0,3
Cameroon,2011-12-01,0,0,0,0,0,0
Cameroon,2011-12-01,3,2,0,0,0,5
Cameroon,2011-12-01,0,0,0,0,0,0
Cameroon,2011-12-01,3,0,0,0,0,3
Cameroon,2011-12-01,15,0,0,0,0,15
Cameroon,2011-12-01,-3,0,0,0,2,-1
Cameroon,2011-12-01,0,0,0,1,0,1
Cameroon,2011-12-01,0,0,0,-2,0,-2
Cameroon,2011-12-01,0,0,0,0,0,0
Cameroon,2011-12-01,0,0,0,0,0,0
Cameroon,2011-12-01,0,0,0,0,0,0
Cameroon,2011-12-01,-1,0,0,0,0,-1
Cameroon,2011-12-01,0,0,0,-2,0,-2
Cameroon,2011-12-01,0,0,0,0,0,0
Cameroon,2011-12-01,0,0,0,0,0,0
China,2011-12-01,155,3,2,54,17,231
China,2011-12-01,139,0,4,63,16,222
China,2011-12-01,125,0,2,35,20,182
China,2011-12-01,68,6,5,39,11,129
China,2011-12-01,68,4,-9,37,4,104
China,2011-12-01,150,0,-3,79,17,243
China,2011-12-01,118,10,1,88,11,228
China,2011-12-01,144,0,0,160,8,312
China,2011-12-01,102,0,1,88,28,219
China,2011-12-01,84,2,1,57,13,157
China,2011-12-01,61,0,-2,50,4,113
China,2011-12-01,146,2,1,100,26,275
China,2011-12-01,186,2,-4,72,10,266
China,2011-12-01,115,0,1,38,20,174
China,2011-12-01,91,0,0,116,13,220
China,2011-12-01,147,0,-1,82,13,241
China,2011-12-01,57,0,2,37,7,103
China,2011-12-01,67,0,2,22,1,92
China,2011-12-01,84,2,0,30,18,134
China,2011-12-01,100,4,-2,82,12,196
China,2011-12-01,172,0,2,88,16,278
China,2011-12-01,66,4,1,29,12,112
China,2011-12-01,78,0,2,54,16,150
China,2011-12-01,46,2,1,26,5,80
China,2011-12-01,97,2,-1,44,1,143
China,2011-12-01,43,0,-1,27,13,82
China,2011-12-01,82,0,-4,99,21,198
China,2011-12-01,80,2,1,41,23,147
China,2011-12-01,114,2,2,57,19,194
China,2011-12-01,44,0,3,117,21,185
China,2011-12-01,57,2,2,15,18,94
Egypt,2011-12-01,75,0,-5,19,8,97
Egypt,2011-12-01,44,0,-2,2,26,70
Egypt,2011-12-01,90,0,1,12,22,125
Egypt,2011-12-01,93,0,-12,5,11,97
Egypt,2011-12-01,26,2,0,4,7,39
Egypt,2011-12-01,95,0,-14,-14,12,79
Egypt,2011-12-01,122,0,-12,20,27,157
Egypt,2011-12-01,177,0,-1,20,18,214
Egypt,2011-12-01,110,0,-2,21,11,140
Egypt,2011-12-01,51,0,0,-12,7,46
Egypt,2011-12-01,53,2,-4,-2,5,54
Egypt,2011-12-01,55,0,0,4,12,71
Egypt,2011-12-01,26,0,0,23,23,72
Egypt,2011-12-01,40,0,0,37,10,87
Egypt,2011-12-01,28,4,-7,71,18,114
Egypt,2011-12-01,85,2,-2,64,41,190
Egypt,2011-12-01,115,2,-9,32,54,194
Egypt,2011-12-01,89,0,-8,-5,14,90
Egypt,2011-12-01,107,0,-2,-3,25,127
Egypt,2011-12-01,113,0,-6,30,28,165
Egypt,2011-12-01,47,0,-12,26,14,75
Egypt,2011-12-01,50,4,-2,9,11,72
Egypt,2011-12-01,53,2,-2,21,15,89
Egypt,2011-12-01,19,0,-2,0,13,30
Egypt,2011-12-01,85,0,2,-9,17,95
Egypt,2011-12-01,69,0,7,12,33,121
Egypt,2011-12-01,92,2,3,44,28,169
Egypt,2011-12-01,86,0,6,43,28,163
Egypt,2011-12-01,209,0,0,10,8,227
Egypt,2011-12-01,198,0,-2,30,14,240
Egypt,2011-12-01,302,2,-8,61,41,398
Eritrea,2011-12-01,35,0,0,0,0,35
Eritrea,2011-12-01,11,0,0,3,0,14
Eritrea,2011-12-01,-2,0,0,12,0,10
Eritrea,2011-12-01,0,0,0,0,1,1
Eritrea,2011-12-01,1,0,0,0,0,1
Eritrea,2011-12-01,13,0,0,6,0,19
Eritrea,2011-12-01,1,0,0,15,0,16
Eritrea,2011-12-01,2,0,0,31,0,33
Eritrea,2011-12-01,0,0,0,7,0,7
Eritrea,2011-12-01,6,0,0,3,0,9
Eritrea,2011-12-01,21,0,0,0,0,21
Eritrea,2011-12-01,8,0,0,0,0,8
Eritrea,2011-12-01,0,0,0,16,0,16
Eritrea,2011-12-01,0,0,0,0,0,0
Eritrea,2011-12-01,4,0,0,0,0,4
Eritrea,2011-12-01,0,0,0,0,0,0
Eritrea,2011-12-01,0,0,0,9,0,9
Eritrea,2011-12-01,2,0,0,0,0,2
Eritrea,2011-12-01,3,0,0,0,0,3
Eritrea,2011-12-01,0,0,0,0,0,0
Eritrea,2011-12-01,9,0,0,-2,0,7
Eritrea,2011-12-01,9,0,0,3,0,12
Eritrea,2011-12-01,3,0,0,-6,1,-2
Eritrea,2011-12-01,0,0,0,0,0,0
Eritrea,2011-12-01,9,0,0,0,0,9
Eritrea,2011-12-01,2,0,0,0,0,2
Eritrea,2011-12-01,0,0,0,0,0,0
Eritrea,2011-12-01,0,0,0,0,0,0
Georgia,2011-12-01,17,0,-4,9,1,23
Georgia,2011-12-01,17,0,0,25,5,47
Georgia,2011-12-01,7,0,0,21,3,31
Georgia,2011-12-01,4,0,0,9,1,14
Georgia,2011-12-01,7,0,2,18,4,31
Georgia,2011-12-01,34,0,8,8,14,64
Georgia,2011-12-01,27,0,-2,37,6,68
Georgia,2011-12-01,20,2,-1,54,2,77
Georgia,2011-12-01,26,0,0,5,3,34
Georgia,2011-12-01,8,0,0,36,1,45
Georgia,2011-12-01,0,0,0,0,0,0
Georgia,2011-12-01,14,4,0,17,10,45
Georgia,2011-12-01,25,0,0,14,7,46
Georgia,2011-12-01,7,0,0,7,6,20
Georgia,2011-12-01,6,0,0,0,0,6
Georgia,2011-12-01,13,0,0,6,0,19
Georgia,2011-12-01,16,0,0,1,0,17
Georgia,2011-12-01,16,0,0,3,1,20
Georgia,2011-12-01,15,0,5,0,1,21
Georgia,2011-12-01,32,0,3,9,3,47
Georgia,2011-12-01,3,0,-2,3,4,8
Georgia,2011-12-01,7,0,0,2,0,9
Georgia,2011-12-01,19,0,0,11,4,34
Georgia,2011-12-01,6,0,0,3,0,9
Georgia,2011-12-01,9,0,0,0,0,9
Georgia,2011-12-01,42,0,0,0,2,44
Georgia,2011-12-01,16,0,-1,-8,0,7
Georgia,2011-12-01,38,4,0,6,4,52
Georgia,2011-12-01,6,0,0,6,4,16
Georgia,2011-12-01,23,0,0,9,0,32
Georgia,2011-12-01,7,0,0,3,1,11
India,2011-12-01,47,0,-1,19,8,73
India,2011-12-01,40,0,0,18,13,71
India,2011-12-01,30,0,-2,0,3,31
India,2011-12-01,67,4,-4,29,4,100
India,2011-12-01,52,0,-6,15,2,63
India,2011-12-01,55,0,0,13,3,71
India,2011-12-01,72,0,1,22,6,101
India,2011-12-01,30,0,0,7,1,38
India,2011-12-01,57,0,0,16,15,88
India,2011-12-01,44,0,1,3,8,56
India,2011-12-01,30,0,0,6,8,44
India,2011-12-01,29,0,-2,-4,2,25
India,2011-12-01,24,2,0,-3,3,26
India,2011-12-01,25,0,-2,-1,1,23
India,2011-12-01,41,2,0,7,7,57
India,2011-12-01,35,0,0,9,1,45
India,2011-12-01,18,0,-1,18,2,37
India,2011-12-01,43,0,1,0,1,45
India,2011-12-01,26,0,0,24,6,56
India,2011-12-01,15,0,0,42,9,66
India,2011-12-01,29,2,0,12,7,50
India,2011-12-01,48,0,-2,17,3,66
India,2011-12-01,25,0,0,4,7,36
India,2011-12-01,38,0,1,4,7,50
India,2011-12-01,41,0,-20,17,15,53
India,2011-12-01,41,0,-6,2,0,37
India,2011-12-01,36,0,1,40,2,79
India,2011-12-01,63,0,1,23,7,94
India,2011-12-01,33,0,0,13,12,58
India,2011-12-01,39,0,-6,7,6,46
India,2011-12-01,47,0,0,30,1,78
Iran,2011-12-01,75,0,-4,25,4,100
Iran,2011-12-01,108,0,-6,18,6,126
Iran,2011-12-01,55,0,-4,16,10,77
Iran,2011-12-01,140,2,-2,13,-2,151
Iran,2011-12-01,114,0,0,29,5,148
Iran,2011-12-01,96,0,0,27,3,126
Iran,2011-12-01,72,0,3,37,9,121
Iran,2011-12-01,99,0,-2,56,11,164
Iran,2011-12-01,95,4,0,20,9,128
Iran,2011-12-01,76,4,0,26,5,111
Iran,2011-12-01,46,0,0,11,2,59
Iran,2011-12-01,68,0,-2,22,6,94
Iran,2011-12-01,97,0,-7,28,18,136
Iran,2011-12-01,92,8,-1,22,5,126
Iran,2011-12-01,78,2,1,51,4,136
Iran,2011-12-01,114,0,4,38,10,166
Iran,2011-12-01,82,6,0,54,5,147
Iran,2011-12-01,73,0,-2,32,1,104
Iran,2011-12-01,50,2,2,20,10,84
Iran,2011-12-01,73,0,-2,2,9,82
Iran,2011-12-01,99,2,7,29,11,148
Iran,2011-12-01,95,4,0,-13,6,92
Iran,2011-12-01,71,0,1,19,3,94
Iran,2011-12-01,69,0,4,38,5,116
Iran,2011-12-01,91,0,2,37,10,140
Iran,2011-12-01,415,2,9,180,88,694
Iran,2011-12-01,169,2,3,94,29,297
Iran,2011-12-01,102,0,4,53,11,170
Iran,2011-12-01,142,2,0,72,7,223
Iran,2011-12-01,77,0,-6,14,23,108
Iran,2011-12-01,102,0,3,3,6,114
Iraq,2011-12-01,75,12,0,6,10,103
Iraq,2011-12-01,22,2,0,4,2,30
Iraq,2011-12-01,44,0,-3,1,3,45
Iraq,2011-12-01,60,0,0,-1,3,62
Iraq,2011-12-01,93,0,1,20,10,124
Iraq,2011-12-01,100,0,0,21,12,133
Iraq,2011-12-01,56,0,0,30,15,101
Iraq,2011-12-01,58,0,-2,0,2,58
Iraq,2011-12-01,75,0,0,59,5,139
Iraq,2011-12-01,63,0,0,36,7,106
Iraq,2011-12-01,36,2,0,0,2,40
Iraq,2011-12-01,79,0,-12,37,5,109
Iraq,2011-12-01,64,4,-7,28,9,98
Iraq,2011-12-01,92,2,0,8,6,108
Iraq,2011-12-01,84,2,2,15,5,108
Iraq,2011-12-01,654,8,-11,434,129,1214
Iraq,2011-12-01,154,4,-3,69,16,240
Iraq,2011-12-01,152,4,0,53,9,218
Iraq,2011-12-01,164,6,4,112,37,323
Iraq,2011-12-01,112,0,2,102,9,225
Iraq,2011-12-01,98,0,5,39,14,156
Iraq,2011-12-01,73,0,-2,43,11,125
Iraq,2011-12-01,58,0,3,24,9,94
Iraq,2011-12-01,93,2,-1,15,6,115
Iraq,2011-12-01,88,4,-1,3,17,111
Iraq,2011-12-01,99,2,1,5,33,140
Iraq,2011-12-01,116,0,7,9,16,148
Iraq,2011-12-01,86,6,6,21,6,125
Iraq,2011-12-01,278,0,-8,0,31,301
Iraq,2011-12-01,178,0,1,101,17,297
Iraq,2011-12-01,84,0,0,19,19,122
Morocco,2011-12-01,8,0,0,3,0,11
Morocco,2011-12-01,3,0,0,6,0,9
Morocco,2011-12-01,11,0,0,3,0,14
Morocco,2011-12-01,9,0,0,0,0,9
Morocco,2011-12-01,12,0,-2,9,1,20
Morocco,2011-12-01,13,0,0,2,3,18
Morocco,2011-12-01,11,0,0,-1,0,10
Morocco,2011-12-01,-7,0,0,6,0,-1
Morocco,2011-12-01,7,0,0,14,0,21
Morocco,2011-12-01,3,0,-1,3,0,5
Morocco,2011-12-01,5,0,0,0,0,5
Morocco,2011-12-01,2,0,0,0,0,2
Morocco,2011-12-01,5,0,0,0,0,5
Morocco,2011-12-01,8,0,-2,15,9,30
Morocco,2011-12-01,5,0,0,21,3,29
Morocco,2011-12-01,1,0,0,18,0,19
Morocco,2011-12-01,0,0,0,0,0,0
Morocco,2011-12-01,6,0,0,6,1,13
Morocco,2011-12-01,3,0,0,12,4,19
Morocco,2011-12-01,9,0,0,3,3,15
Morocco,2011-12-01,2,0,0,16,0,18
Morocco,2011-12-01,0,0,0,0,0,0
Morocco,2011-12-01,0,0,0,6,0,6
Morocco,2011-12-01,4,0,0,3,0,7
Morocco,2011-12-01,4,0,0,9,0,13
Morocco,2011-12-01,-6,0,0,3,0,-3
Morocco,2011-12-01,15,0,0,9,0,24
Morocco,2011-12-01,1,0,0,-2,0,-1
Morocco,2011-12-01,24,0,1,5,0,30
Morocco,2011-12-01,1,0,0,2,0,3
Morocco,2011-12-01,24,0,0,3,0,27
Nigeria,2011-12-01,25,0,-4,4,0,25
Nigeria,2011-12-01,31,2,0,3,1,37
Nigeria,2011-12-01,12,0,0,0,0,12
Nigeria,2011-12-01,31,0,0,0,2,33
Nigeria,2011-12-01,14,0,0,0,1,15
Nigeria,2011-12-01,31,0,1,11,3,46
Nigeria,2011-12-01,20,0,2,30,1,53
Nigeria,2011-12-01,9,0,2,15,1,27
Nigeria,2011-12-01,10,0,1,28,0,39
Nigeria,2011-12-01,5,0,0,0,4,9
Nigeria,2011-12-01,6,0,0,0,2,8
Nigeria,2011-12-01,16,0,0,12,0,28
Nigeria,2011-12-01,48,0,0,17,1,66
Nigeria,2011-12-01,9,0,0,22,1,32
Nigeria,2011-12-01,11,2,0,0,4,17
Nigeria,2011-12-01,19,0,-2,6,1,24
Nigeria,2011-12-01,16,0,0,6,3,25
Nigeria,2011-12-01,11,0,-1,-1,0,9
Nigeria,2011-12-01,40,0,1,1,4,46
Nigeria,2011-12-01,23,0,0,9,7,39
Nigeria,2011-12-01,16,0,0,-2,2,16
Nigeria,2011-12-01,21,0,0,7,4,32
Nigeria,2011-12-01,18,0,0,6,4,28
Nigeria,2011-12-01,17,0,0,-1,2,18
Nigeria,2011-12-01,92,0,0,8,13,113
Nigeria,2011-12-01,47,0,2,30,4,83
Nigeria,2011-12-01,27,0,1,18,2,48
Nigeria,2011-12-01,46,0,1,9,18,74
Nigeria,2011-12-01,22,0,-2,7,1,28
Nigeria,2011-12-01,8,0,0,14,2,24
Nigeria,2011-12-01,49,0,0,12,2,63
Pakistan,2011-12-01,83,0,-1,87,5,174
Pakistan,2011-12-01,164,0,0,104,36,304
Pakistan,2011-12-01,153,0,-2,50,11,212
Pakistan,2011-12-01,119,0,0,33,4,156
Pakistan,2011-12-01,142,0,0,-7,9,144
Pakistan,2011-12-01,175,2,0,25,18,220
Pakistan,2011-12-01,177,4,-10,40,17,228
Pakistan,2011-12-01,157,4,-2,39,21,219
Pakistan,2011-12-01,101,0,-2,63,12,174
Pakistan,2011-12-01,97,0,-3,26,11,131
Pakistan,2011-12-01,75,0,1,9,9,94
Pakistan,2011-12-01,86,0,1,37,1,125
Pakistan,2011-12-01,108,0,2,35,4,149
Pakistan,2011-12-01,101,0,-4,36,0,133
Pakistan,2011-12-01,37,0,1,-6,10,42
Pakistan,2011-12-01,46,4,1,9,7,67
Pakistan,2011-12-01,43,4,1,17,9,74
Pakistan,2011-12-01,68,0,1,21,4,94
Pakistan,2011-12-01,69,8,-1,36,3,115
Pakistan,2011-12-01,78,4,-1,44,7,132
Pakistan,2011-12-01,67,0,0,21,3,91
Pakistan,2011-12-01,92,0,-1,9,8,108
Pakistan,2011-12-01,144,0,-7,12,8,157
Pakistan,2011-12-01,93,0,-6,8,10,105
Pakistan,2011-12-01,56,0,-2,25,20,99
Pakistan,2011-12-01,92,0,-4,19,4,111
Pakistan,2011-12-01,87,0,-2,11,1,97
Pakistan,2011-12-01,97,0,1,11,8,117
Pakistan,2011-12-01,52,0,-3,10,8,67
Pakistan,2011-12-01,93,0,-2,12,24,127
Pakistan,2011-12-01,66,0,2,26,14,108
Sierra Leone,2011-12-01,0,0,0,6,0,6
Sierra Leone,2011-12-01,11,0,0,0,1,12
Sierra Leone,2011-12-01,0,0,0,0,1,1
Sierra Leone,2011-12-01,0,0,0,0,0,0
Sierra Leone,2011-12-01,-4,0,0,0,1,-3
Sierra Leone,2011-12-01,7,0,-6,3,1,5
Sierra Leone,2011-12-01,0,0,0,0,0,0
Sierra Leone,2011-12-01,1,0,0,3,0,4
Sierra Leone,2011-12-01,8,0,0,3,0,11
Sierra Leone,2011-12-01,2,0,0,0,0,2
Sierra Leone,2011-12-01,0,0,0,0,0,0
Sierra Leone,2011-12-01,2,0,0,0,0,2
Sierra Leone,2011-12-01,-2,0,0,9,0,7
Sierra Leone,2011-12-01,8,0,0,0,2,10
Sierra Leone,2011-12-01,2,2,0,0,0,4
Sierra Leone,2011-12-01,1,0,0,6,0,7
Sierra Leone,2011-12-01,0,0,0,0,0,0
Sierra Leone,2011-12-01,0,0,0,3,0,3
Sierra Leone,2011-12-01,2,0,0,0,0,2
Sierra Leone,2011-12-01,7,0,0,0,3,10
Sierra Leone,2011-12-01,0,0,0,0,0,0
Sierra Leone,2011-12-01,7,0,0,3,0,10
Sierra Leone,2011-12-01,-1,0,0,0,0,-1
Sierra Leone,2011-12-01,0,0,0,6,0,6
Sierra Leone,2011-12-01,4,0,0,0,0,4
Sierra Leone,2011-12-01,0,0,0,0,0,0
Sierra Leone,2011-12-01,2,0,0,0,0,2
Sierra Leone,2011-12-01,0,0,0,3,2,5
Sierra Leone,2011-12-01,3,0,0,0,0,3
Somalia,2011-12-01,46,0,0,77,0,123
Somalia,2011-12-01,27,0,0,31,0,58
Somalia,2011-12-01,16,0,0,21,0,37
Somalia,2011-12-01,11,0,0,6,1,18
Somalia,2011-12-01,37,0,2,0,0,39
Somalia,2011-12-01,60,2,-3,30,9,98
Somalia,2011-12-01,29,0,0,22,0,51
Somalia,2011-12-01,15,0,0,-7,1,9
Somalia,2011-12-01,17,0,0,6,0,23
Somalia,2011-12-01,4,0,-4,18,0,18
Somalia,2011-12-01,23,0,0,13,0,36
Somalia,2011-12-01,25,0,0,15,3,43
Somalia,2011-12-01,25,0,0,15,0,40
Somalia,2011-12-01,48,0,0,15,0,63
Somalia,2011-12-01,18,0,0,39,0,57
Somalia,2011-12-01,38,0,0,17,7,62
Somalia,2011-12-01,-2,0,0,9,3,10
Somalia,2011-12-01,32,2,0,6,10,50
Somalia,2011-12-01,41,0,0,21,5,67
Somalia,2011-12-01,15,0,0,4,0,19
Somalia,2011-12-01,74,0,0,18,5,97
Somalia,2011-12-01,68,2,0,13,1,84
Somalia,2011-12-01,37,0,2,27,4,70
Somalia,2011-12-01,85,0,0,9,8,102
Somalia,2011-12-01,106,0,0,16,1,123
Somalia,2011-12-01,36,0,0,-4,0,32
Somalia,2011-12-01,52,0,0,106,7,165
Somalia,2011-12-01,38,0,0,49,14,101
Somalia,2011-12-01,42,0,0,6,4,52
Somalia,2011-12-01,51,0,0,16,7,74
Somalia,2011-12-01,67,10,0,4,15,96
Syria,2011-12-01,142,0,1,52,14,209
Syria,2011-12-01,213,2,6,90,38,349
Syria,2011-12-01,105,0,0,37,11,153
Syria,2011-12-01,107,0,0,29,20,156
Syria,2011-12-01,83,0,0,63,11,157
Syria,2011-12-01,166,4,0,48,10,228
Syria,2011-12-01,203,0,-4,26,20,245
Syria,2011-12-01,203,2,2,49,33,289
Syria,2011-12-01,148,0,2,49,24,223
Syria,2011-12-01,127,0,2,-1,20,148
Syria,2011-12-01,159,0,0,6,19,184
Syria,2011-12-01,247,0,-20,13,29,269
Syria,2011-12-01,162,0,-21,31,14,186
Syria,2011-12-01,168,0,0,15,23,206
Syria,2011-12-01,247,0,3,37,14,301
Syria,2011-12-01,225,0,-6,59,23,301
Syria,2011-12-01,84,6,-2,6,18,112
Syria,2011-12-01,108,0,-2,10,14,130
Syria,2011-12-01,85,0,-2,-13,10,80
Syria,2011-12-01,98,0,-1,30,2,129
Syria,2011-12-01,144,6,0,29,14,193
Syria,2011-12-01,94,0,-8,30,22,138
Syria,2011-12-01,200,0,-3,26,15,238
Syria,2011-12-01,81,0,-6,10,17,102
Syria,2011-12-01,80,0,-2,15,9,102
Syria,2011-12-01,204,0,2,11,13,230
Syria,2011-12-01,132,0,1,68,24,225
Syria,2011-12-01,138,0,0,-1,30,167
Syria,2011-12-01,154,0,-4,20,13,183
Syria,2011-12-01,633,16,-15,189,355,1178
Syria,2011-12-01,329,2,-11,68,185,573
Yemen,2011-12-01,14,0,0,17,-3,28
Yemen,2011-12-01,18,0,-2,8,5,29
Yemen,2011-12-01,7,0,-2,6,2,13
Yemen,2011-12-01,24,0,0,3,0,27
Yemen,2011-12-01,0,0,0,5,0,5
Yemen,2011-12-01,9,0,0,-4,3,8
Yemen,2011-12-01,19,0,0,12,5,36
Yemen,2011-12-01,17,0,-6,10,7,28
Yemen,2011-12-01,38,0,0,-1,5,42
Yemen,2011-12-01,41,0,0,-15,3,29
Yemen,2011-12-01,11,0,0,0,1,12
Yemen,2011-12-01,23,0,0,21,8,52
Yemen,2011-12-01,8,0,-2,1,4,11
Yemen,2011-12-01,5,0,0,3,0,8
Yemen,2011-12-01,10,0,0,3,9,22
Yemen,2011-12-01,28,0,0,-4,4,28
Yemen,2011-12-01,8,0,0,0,3,11
Yemen,2011-12-01,14,10,0,10,1,35
Yemen,2011-12-01,18,4,0,-2,4,24
Yemen,2011-12-01,4,0,0,11,4,19
Yemen,2011-12-01,2,0,0,14,3,19
Yemen,2011-12-01,18,0,0,0,1,19
Yemen,2011-12-01,27,0,-6,1,0,22
Yemen,2011-12-01,41,0,1,9,8,59
Yemen,2011-12-01,27,0,-4,6,5,34
Yemen,2011-12-01,53,0,-2,19,26,96
Yemen,2011-12-01,49,0,0,29,15,93
Yemen,2011-12-01,16,0,0,-4,14,26
Yemen,2011-12-01,5,0,-2,-2,2,3
Yemen,2011-12-01,19,0,0,7,6,32
Yemen,2011-12-01,19,0,-10,-2,2,9
Afghanistan,2011-06-01,107,10,1,7,13,138
Afghanistan,2011-06-01,324,0,-2,35,23,380
Afghanistan,2011-06-01,435,4,0,29,14,482
Afghanistan,2011-06-01,298,0,-2,28,40,364
Afghanistan,2011-06-01,329,2,3,15,22,371
Afghanistan,2011-06-01,367,2,-2,-6,23,384
Afghanistan,2011-06-01,163,0,-8,49,22,226
Afghanistan,2011-06-01,200,2,-4,18,16,232
Afghanistan,2011-06-01,224,4,0,6,26,260
Afghanistan,2011-06-01,230,18,0,31,29,308
Afghanistan,2011-06-01,170,28,-2,15,12,223
Afghanistan,2011-06-01,79,4,0,-3,15,95
Afghanistan,2011-06-01,41,2,0,1,12,56
Afghanistan,2011-06-01,179,0,3,44,22,248
Afghanistan,2011-06-01,238,0,-5,-4,40,269
Afghanistan,2011-06-01,149,0,0,17,3,169
Afghanistan,2011-06-01,342,6,1,21,13,383
Afghanistan,2011-06-01,148,2,-2,25,4,177
Afghanistan,2011-06-01,176,0,0,2,35,213
Afghanistan,2011-06-01,254,2,-3,61,32,346
Afghanistan,2011-06-01,91,6,1,19,21,138
Afghanistan,2011-06-01,186,8,4,67,38,303
Afghanistan,2011-06-01,82,0,8,145,50,285
Afghanistan,2011-06-01,80,0,5,55,19,159
Afghanistan,2011-06-01,156,0,-2,28,41,223
Afghanistan,2011-06-01,162,6,4,40,19,231
Afghanistan,2011-06-01,627,12,-20,249,69,937
Afghanistan,2011-06-01,220,2,-9,33,24,270
Afghanistan,2011-06-01,233,0,-4,14,24,267
Afghanistan,2011-06-01,206,8,-3,29,11,251
Albania,2011-06-01,3,0,0,6,0,9
Albania,2011-06-01,18,0,0,6,1,25
Albania,2011-06-01,0,0,-2,0,1,-1
Albania,2011-06-01,1,0,0,0,3,4
Albania,2011-06-01,4,0,2,3,7,16
Albania,2011-06-01,14,0,-1,6,3,22
Albania,2011-06-01,3,0,0,0,0,3
Albania,2011-06-01,5,0,1,8,6,20
Albania,2011-06-01,0,0,2,6,0,8
Albania,2011-06-01,10,0,0,0,0,10
Albania,2011-06-01,8,0,0,3,0,11
Albania,2011-06-01,3,0,0,0,8,11
Albania,2011-06-01,2,0,-1,9,1,11
Albania,2011-06-01,13,0,-2,12,-1,22
Albania,2011-06-01,8,0,-1,4,4,15
Albania,2011-06-01,0,0,0,0,0,0
Albania,2011-06-01,2,0,0,0,0,2
Albania,2011-06-01,31,0,0,21,0,52
Albania,2011-06-01,2,0,0,0,0,2
Albania,2011-06-01,9,0,-1,0,0,8
Albania,2011-06-01,9,0,-1,6,0,14
Albania,2011-06-01,7,0,-4,0,14,17
Albania,2011-06-01,1,0,0,3,1,5
Albania,2011-06-01,9,0,0,-6,0,3
Albania,2011-06-01,0,0,0,0,0,0
Albania,2011-06-01,0,0,0,0,0,0
Albania,2011-06-01,4,0,-2,13,2,17
Albania,2011-06-01,17,0,0,13,8,38
Albania,2011-06-01,2,0,0,-1,2,3
Albania,2011-06-01,6,0,-1,9,1,15
Algeria,2011-06-01,-6,0,0,0,0,-6
Algeria,2011-06-01,2,0,0,0,0,2
Algeria,2011-06-01,9,0,0,10,0,19
Algeria,2011-06-01,2,0,0,0,0,2
Algeria,2011-06-01,10,0,0,0,0,10
Algeria,2011-06-01,11,0,0,3,6,20
Algeria,2011-06-01,3,0,0,-4,0,-1
Algeria,2011-06-01,-6,0,0,0,0,-6
Algeria,2011-06-01,18,0,0,2,0,20
Algeria,2011-06-01,2,0,0,-2,1,1
Algeria,2011-06-01,22,0,0,0,0,22
Algeria,2011-06-01,7,0,0,-7,2,2
Algeria,2011-06-01,24,0,2,-8,0,18
Algeria,2011-06-01,2,0,0,4,1,7
Algeria,2011-06-01,2,0,0,20,8,30
Algeria,2011-06-01,0,0,0,0,0,0
Algeria,2011-06-01,6,0,1,0,4,11
Algeria,2011-06-01,15,0,0,-4,0,11
Algeria,2011-06-01,0,0,0,9,0,9
Algeria,2011-06-01,12,0,0,15,0,27
Algeria,2011-06-01,5,0,0,11,2,18
Algeria,2011-06-01,-1,0,0,15,0,14
Algeria,2011-06-01,6,0,0,0,0,6
Algeria,2011-06-01,9,0,0,0,0,9
Algeria,2011-06-01,21,0,0,-2,0,19
Algeria,2011-06-01,15,0,0,12,0,27
Algeria,2011-06-01,6,0,0,18,2,26
Algeria,2011-06-01,0,0,0,6,1,7
Algeria,2011-06-01,1,0,0,0,0,1
Algeria,2011-06-01,26,0,0,3,0,29
Bangladesh,2011-06-01,12,0,0,12,0,24
Bangladesh,2011-06-01,20,0,0,10,4,34
Bangladesh,2011-06-01,11,0,0,6,9,26
Bangladesh,2011-06-01,35,0,0,3,-4,34
Bangladesh,2011-06-01,11,0,0,18,1,30
Bangladesh,2011-06-01,27,0,0,1,5,33
Bangladesh,2011-06-01,10,0,0,1,4,15
Bangladesh,2011-06-01,46,0,0,6,6,58
Bangladesh,2011-06-01,1,0,0,28,5,34
Bangladesh,2011-06-01,32,0,0,-3,4,33
Bangladesh,2011-06-01,24,0,-2,2,9,33
Bangladesh,2011-06-01,16,2,0,-2,2,18
Bangladesh,2011-06-01,29,0,0,0,1,30
Bangladesh,2011-06-01,18,0,0,21,2,41
Bangladesh,2011-06-01,20,0,0,18,0,38
Bangladesh,2011-06-01,2,0,-2,0,1,1
Bangladesh,2011-06-01,12,2,0,2,2,18
Bangladesh,2011-06-01,11,0,0,-2,0,9
Bangladesh,2011-06-01,8,0,0,3,3,14
Bangladesh,2011-06-01,11,0,0,10,3,24
Bangladesh,2011-06-01,13,0,0,24,1,38
Bangladesh,2011-06-01,50,0,0,-9,4,45
Bangladesh,2011-06-01,21,0,0,19,1,41
Bangladesh,2011-06-01,45,0,-6,14,4,57
Bangladesh,2011-06-01,20,0,0,0,2,22
Bangladesh,2011-06-01,4,0,1,15,1,21
Bangladesh,2011-06-01,10,0,0,18,0,28
Bangladesh,2011-06-01,32,0,-2,30,6,66
Bangladesh,2011-06-01,37,0,1,21,4,63
Bangladesh,2011-06-01,42,0,-5,37,9,83
Cameroon,2011-06-01,1,0,0,1,0,2
Cameroon,2011-06-01,0,0,0,0,0,0
Cameroon,2011-06-01,7,0,0,0,1,8
Cameroon,2011-06-01,2,0,0,0,1,3
Cameroon,2011-06-01,2,0,0,-6,0,-4
Cameroon,2011-06-01,0,0,-1,0,0,-1
Cameroon,2011-06-01,0,0,0,0,0,0
Cameroon,2011-06-01,2,0,0,3,0,5
Cameroon,2011-06-01,0,0,0,12,2,14
Cameroon,2011-06-01,0,0,0,12,0,12
Cameroon,2011-06-01,0,0,0,0,0,0
Cameroon,2011-06-01,0,0,0,0,0,0
Cameroon,2011-06-01,3,0,0,0,0,3
Cameroon,2011-06-01,9,0,0,0,0,9
Cameroon,2011-06-01,3,0,0,0,0,3
Cameroon,2011-06-01,0,0,1,5,0,6
Cameroon,2011-06-01,0,0,0,0,0,0
Cameroon,2011-06-01,4,0,0,0,0,4
Cameroon,2011-06-01,3,0,0,0,0,3
Cameroon,2011-06-01,10,0,0,0,0,10
Cameroon,2011-06-01,0,0,0,0,0,0
Cameroon,2011-06-01,1,0,0,0,0,1
Cameroon,2011-06-01,0,0,0,0,1,1
Cameroon,2011-06-01,18,0,0,0,0,18
Cameroon,2011-06-01,1,0,0,1,0,2
Cameroon,2011-06-01,1,0,-1,-2,2,0
Cameroon,2011-06-01,4,0,0,0,0,4
China,2011-06-01,69,0,-6,18,12,93
China,2011-06-01,91,2,4,53,25,175
China,2011-06-01,271,0,-3,60,24,352
China,2011-06-01,192,0,-4,21,27,236
China,2011-06-01,168,0,0,14,27,209
China,2011-06-01,137,2,-4,49,29,213
China,2011-06-01,137,6,3,46,17,209
China,2011-06-01,117,2,-5,58,24,196
China,2011-06-01,164,0,-4,103,12,275
China,2011-06-01,173,4,-2,151,23,349
China,2011-06-01,80,16,-3,47,6,146
China,2011-06-01,109,0,-4,20,19,144
China,2011-06-01,169,0,-9,70,17,247
China,2011-06-01,212,10,-3,58,20,297
China,2011-06-01,175,2,4,66,15,262
China,2011-06-01,63,0,-4,19,3,81
China,2011-06-01,154,2,1,22,24,203
China,2011-06-01,127,0,0,1,11,139
China,2011-06-01,114,0,-4,42,9,161
China,2011-06-01,129,0,-2,-6,17,138
China,2011-06-01,187,8,-13,64,22,268
China,2011-06-01,151,2,-4,70,21,240
China,2011-06-01,158,6,-8,45,14,215
China,2011-06-01,165,0,-7,23,10,191
China,2011-06-01,101,2,-3,31,25,156
China,2011-06-01,94,0,-4,-12,16,94
China,2011-06-01,232,4,1,86,30,353
China,2011-06-01,128,0,-5,31,15,169
China,2011-06-01,118,8,1,81,22,230
China,2011-06-01,200,0,0,93,13,306
Egypt,2011-06-01,48,0,-1,68,29,144
Egypt,2011-06-01,63,0,1,28,12,104
Egypt,2011-06-01,89,0,1,37,16,143
Egypt,2011-06-01,67,0,-8,37,9,105
Egypt,2011-06-01,70,0,-4,46,19,131
Egypt,2011-06-01,127,0,2,29,34,192
Egypt,2011-06-01,99,0,-2,48,19,164
Egypt,2011-06-01,46,0,0,22,13,81
Egypt,2011-06-01,110,0,1,27,24,162
Egypt,2011-06-01,81,0,-1,40,8,128
Egypt,2011-06-01,21,0,0,30,37,88
Egypt,2011-06-01,69,0,0,8,24,101
Egypt,2011-06-01,81,2,-6,79,28,184
Egypt,2011-06-01,79,0,-7,67,10,149
Egypt,2011-06-01,60,0,-5,81,6,142
Egypt,2011-06-01,44,0,-2,52,1,95
Egypt,2011-06-01,110,0,5,81,9,205
Egypt,2011-06-01,38,0,0,95,12,145
Egypt,2011-06-01,46,2,-5,101,22,166
Egypt,2011-06-01,66,0,-16,63,15,128
Egypt,2011-06-01,68,0,1,43,7,119
Egypt,2011-06-01,85,0,-8,32,4,113
Egypt,2011-06-01,65,0,-4,85,8,154
Egypt,2011-06-01,47,0,0,67,34,148
Egypt,2011-06-01,51,10,0,53,13,127
Egypt,2011-06-01,58,12,-2,25,3,96
Egypt,2011-06-01,27,0,-10,54,16,87
Egypt,2011-06-01,101,0,-4,74,28,199
Egypt,2011-06-01,71,0,-5,36,18,120
Egypt,2011-06-01,76,0,0,90,25,191
Eritrea,2011-06-01,0,0,0,0,24,24
Eritrea,2011-06-01,0,0,0,9,0,9
Eritrea,2011-06-01,0,0,0,0,2,2
Eritrea,2011-06-01,0,0,0,0,0,0
Eritrea,2011-06-01,3,0,0,3,0,6
Eritrea,2011-06-01,-1,0,0,0,0,-1
Eritrea,2011-06-01,3,0,0,9,0,12
Eritrea,2011-06-01,0,0,0,0,0,0
Eritrea,2011-06-01,5,0,0,0,4,9
Eritrea,2011-06-01,1,0,0,93,0,94
Eritrea,2011-06-01,0,0,0,7,0,7
Eritrea,2011-06-01,9,0,0,6,0,15
Eritrea,2011-06-01,4,0,0,0,0,4
Eritrea,2011-06-01,3,0,0,0,0,3
Eritrea,2011-06-01,0,0,0,0,0,0
Eritrea,2011-06-01,0,0,0,0,0,0
Eritrea,2011-06-01,0,0,0,0,0,0
Eritrea,2011-06-01,0,0,0,0,0,0
Eritrea,2011-06-01,2,0,0,0,0,2
Eritrea,2011-06-01,7,0,0,6,0,13
Eritrea,2011-06-01,27,2,0,-2,1,28
Eritrea,2011-06-01,2,0,0,3,1,6
Eritrea,2011-06-01,1,0,0,3,0,4
Eritrea,2011-06-01,0,0,0,3,0,3
Eritrea,2011-06-01,-1,0,0,3,1,3
Eritrea,2011-06-01,0,0,-1,0,0,-1
Eritrea,2011-06-01,3,0,0,9,1,13
Eritrea,2011-06-01,-1,0,-2,6,0,3
Georgia,2011-06-01,8,0,0,9,1,18
Georgia,2011-06-01,22,2,0,10,7,41
Georgia,2011-06-01,34,2,0,11,5,52
Georgia,2011-06-01,34,4,0,28,3,69
Georgia,2011-06-01,8,0,0,6,0,14
Georgia,2011-06-01,54,0,3,27,2,86
Georgia,2011-06-01,25,0,1,27,2,55
Georgia,2011-06-01,18,0,0,1,2,21
Georgia,2011-06-01,40,0,0,40,7,87
Georgia,2011-06-01,43,0,0,9,5,57
Georgia,2011-06-01,18,0,0,3,1,22
Georgia,2011-06-01,18,0,0,9,1,28
Georgia,2011-06-01,57,0,3,19,9,88
Georgia,2011-06-01,45,0,0,10,4,59
Georgia,2011-06-01,38,0,0,7,9,54
Georgia,2011-06-01,6,0,0,3,7,16
Georgia,2011-06-01,37,0,0,24,5,66
Georgia,2011-06-01,17,0,0,11,0,28
Georgia,2011-06-01,18,0,0,3,2,23
Georgia,2011-06-01,36,0,0,15,2,53
Georgia,2011-06-01,35,0,-1,39,3,76
Georgia,2011-06-01,47,0,3,6,3,59
Georgia,2011-06-01,48,2,1,35,6,92
Georgia,2011-06-01,34,0,2,12,5,53
Georgia,2011-06-01,53,6,0,25,0,84
Georgia,2011-06-01,24,0,0,7,8,39
Georgia,2011-06-01,45,4,0,16,0,65
Georgia,2011-06-01,55,4,1,26,10,96
Georgia,2011-06-01,42,0,-1,9,8,58
Georgia,2011-06-01,26,4,1,32,4,67
India,2011-06-01,34,0,0,10,9,53
India,2011-06-01,37,0,1,12,1,51
India,2011-06-01,39,0,-2,20,6,63
India,2011-06-01,93,0,0,19,11,123
India,2011-06-01,40,0,1,0,17,58
India,2011-06-01,87,2,-2,0,6,93
India,2011-06-01,91,6,-1,17,3,116
India,2011-06-01,30,0,0,4,4,38
India,2011-06-01,80,2,0,33,9,124
India,2011-06-01,102,2,3,40,6,153
India,2011-06-01,38,0,2,0,8,48
India,2011-06-01,32,0,0,-6,1,27
India,2011-06-01,64,4,-9,1,11,71
India,2011-06-01,63,0,-6,6,15,78
India,2011-06-01,45,2,2,16,6,71
India,2011-06-01,24,0,-2,5,2,29
India,2011-06-01,51,0,0,23,12,86
India,2011-06-01,46,0,0,29,6,81
India,2011-06-01,66,0,1,6,6,79
India,2011-06-01,44,2,0,13,8,67
India,2011-06-01,85,2,-3,14,11,109
India,2011-06-01,45,0,3,21,6,75
India,2011-06-01,77,2,1,-3,7,84
India,2011-06-01,44,0,1,48,18,111
India,2011-06-01,60,2,0,18,14,94
India,2011-06-01,40,4,-2,6,13,61
India,2011-06-01,42,0,0,0,9,51
India,2011-06-01,83,0,0,20,12,115
India,2011-06-01,60,0,-1,31,11,101
India,2011-06-01,76,2,1,34,12,125
Iran,2011-06-01,66,0,0,18,2,86
Iran,2011-06-01,342,4,-6,211,39,590
Iran,2011-06-01,118,2,-1,84,21,224
Iran,2011-06-01,53,0,-1,36,20,108
Iran,2011-06-01,85,0,1,33,10,129
Iran,2011-06-01,50,0,-2,33,5,86
Iran,2011-06-01,64,2,0,18,5,89
Iran,2011-06-01,78,0,0,30,15,123
Iran,2011-06-01,54,0,3,65,27,149
Iran,2011-06-01,83,0,-1,73,5,160
Iran,2011-06-01,70,0,1,52,4,127
Iran,2011-06-01,31,0,0,51,6,88
Iran,2011-06-01,39,0,-1,12,24,74
Iran,2011-06-01,111,0,-6,18,25,148
Iran,2011-06-01,127,0,2,50,35,214
Iran,2011-06-01,11,0,-1,3,2,15
Iran,2011-06-01,53,0,0,48,5,106
Iran,2011-06-01,70,0,0,32,6,108
Iran,2011-06-01,52,0,0,31,4,87
Iran,2011-06-01,51,2,-1,29,10,91
Iran,2011-06-01,99,0,-11,74,6,168
Iran,2011-06-01,84,0,1,37,8,130
Iran,2011-06-01,90,0,1,89,13,193
Iran,2011-06-01,22,0,-2,23,1,44
Iran,2011-06-01,55,0,-1,23,14,91
Iran,2011-06-01,62,0,1,5,18,86
Iran,2011-06-01,70,0,1,37,1,109
Iran,2011-06-01,59,0,0,13,2,74
Iran,2011-06-01,115,0,-2,32,11,156
Iran,2011-06-01,52,0,0,58,4,114
Iraq,2011-06-01,53,0,-4,46,4,99
Iraq,2011-06-01,52,0,-2,13,6,69
Iraq,2011-06-01,90,2,-2,9,37,136
Iraq,2011-06-01,67,0,0,33,22,122
Iraq,2011-06-01,65,0,-16,11,10,70
Iraq,2011-06-01,76,6,0,53,37,172
Iraq,2011-06-01,102,6,0,18,2,128
Iraq,2011-06-01,120,0,1,14,7,142
Iraq,2011-06-01,220,0,2,14,14,250
Iraq,2011-06-01,138,0,0,16,18,172
Iraq,2011-06-01,37,0,0,3,10,50
Iraq,2011-06-01,61,2,0,12,8,83
Iraq,2011-06-01,107,0,2,40,36,185
Iraq,2011-06-01,148,0,0,26,25,199
Iraq,2011-06-01,140,2,0,0,12,154
Iraq,2011-06-01,16,0,0,9,2,27
Iraq,2011-06-01,93,0,0,23,8,124
Iraq,2011-06-01,57,0,0,6,12,75
Iraq,2011-06-01,106,4,-4,5,19,130
Iraq,2011-06-01,90,6,0,15,11,122
Iraq,2011-06-01,109,4,1,43,31,188
Iraq,2011-06-01,86,10,0,32,8,136
Iraq,2011-06-01,61,2,-2,4,28,93
Iraq,2011-06-01,60,0,2,17,19,98
Iraq,2011-06-01,54,2,1,24,6,87
Iraq,2011-06-01,68,6,0,12,18,104
Iraq,2011-06-01,113,2,-1,35,15,164
Iraq,2011-06-01,67,0,-2,19,9,93
Iraq,2011-06-01,101,2,0,13,14,130
Iraq,2011-06-01,83,0,-4,24,6,109
Morocco,2011-06-01,2,0,0,3,1,6
Morocco,2011-06-01,5,0,0,3,0,8
Morocco,2011-06-01,3,0,-4,4,2,5
Morocco,2011-06-01,6,0,0,0,2,8
Morocco,2011-06-01,3,0,0,13,7,23
Morocco,2011-06-01,13,0,0,12,3,28
Morocco,2011-06-01,-1,0,0,9,0,8
Morocco,2011-06-01,-2,0,0,0,2,0
Morocco,2011-06-01,23,0,0,36,3,62
Morocco,2011-06-01,5,0,1,18,10,34
Morocco,2011-06-01,5,0,0,0,0,5
Morocco,2011-06-01,0,0,0,0,1,1
Morocco,2011-06-01,5,0,0,0,0,5
Morocco,2011-06-01,-3,0,0,0,0,-3
Morocco,2011-06-01,4,0,0,19,0,23
Morocco,2011-06-01,2,0,0,9,0,11
Morocco,2011-06-01,4,0,-6,3,12,13
Morocco,2011-06-01,17,0,-6,-16,12,7
Morocco,2011-06-01,2,0,-2,-4,0,-4
Morocco,2011-06-01,9,0,3,3,7,22
Morocco,2011-06-01,5,0,0,-4,5,6
Morocco,2011-06-01,5,0,-4,1,4,6
Morocco,2011-06-01,21,0,-3,2,2,22
Morocco,2011-06-01,4,0,-4,0,2,2
Morocco,2011-06-01,6,0,0,-2,2,6
Morocco,2011-06-01,0,0,1,0,2,3
Morocco,2011-06-01,7,0,0,1,4,12
Morocco,2011-06-01,12,0,0,0,-2,10
Morocco,2011-06-01,3,0,0,6,1,10
Morocco,2011-06-01,1,0,0,4,7,12
Nigeria,2011-06-01,22,0,-2,7,0,27
Nigeria,2011-06-01,5,0,0,6,1,12
Nigeria,2011-06-01,20,0,1,3,0,24
Nigeria,2011-06-01,15,0,0,0,0,15
Nigeria,2011-06-01,15,0,-3,6,3,21
Nigeria,2011-06-01,27,0,0,15,3,45
Nigeria,2011-06-01,8,0,-6,18,1,21
Nigeria,2011-06-01,15,2,1,13,1,32
Nigeria,2011-06-01,14,0,0,24,0,38
Nigeria,2011-06-01,7,2,1,12,0,22
Nigeria,2011-06-01,5,0,0,13,4,22
Nigeria,2011-06-01,4,2,0,16,0,22
Nigeria,2011-06-01,33,0,-2,25,4,60
Nigeria,2011-06-01,43,0,0,0,12,55
Nigeria,2011-06-01,15,0,3,7,0,25
Nigeria,2011-06-01,0,0,0,3,0,3
Nigeria,2011-06-01,30,0,1,10,4,45
Nigeria,2011-06-01,1,0,-1,-2,0,-2
Nigeria,2011-06-01,14,0,0,12,5,31
Nigeria,2011-06-01,29,0,0,-8,4,25
Nigeria,2011-06-01,19,2,-2,10,6,35
Nigeria,2011-06-01,7,0,1,1,4,13
Nigeria,2011-06-01,20,0,0,-2,3,21
Nigeria,2011-06-01,29,2,0,4,3,38
Nigeria,2011-06-01,9,0,0,0,0,9
Nigeria,2011-06-01,9,0,-4,0,2,7
Nigeria,2011-06-01,25,0,0,17,7,49
Nigeria,2011-06-01,25,4,-1,16,1,45
Nigeria,2011-06-01,3,0,0,27,4,34
Nigeria,2011-06-01,16,0,1,16,0,33
Pakistan,2011-06-01,113,2,1,11,1,128
Pakistan,2011-06-01,146,0,0,23,8,177
Pakistan,2011-06-01,157,0,2,26,13,198
Pakistan,2011-06-01,206,2,2,20,18,248
Pakistan,2011-06-01,117,0,0,38,19,174
Pakistan,2011-06-01,223,0,-3,-1,15,234
Pakistan,2011-06-01,124,0,0,24,11,159
Pakistan,2011-06-01,116,0,-4,21,14,147
Pakistan,2011-06-01,180,0,0,102,12,294
Pakistan,2011-06-01,232,4,-10,122,16,364
Pakistan,2011-06-01,131,0,3,4,29,167
Pakistan,2011-06-01,156,0,0,12,20,188
Pakistan,2011-06-01,147,2,0,18,15,182
Pakistan,2011-06-01,149,2,-4,28,7,182
Pakistan,2011-06-01,240,2,0,68,37,347
Pakistan,2011-06-01,155,0,0,31,3,189
Pakistan,2011-06-01,318,0,0,30,4,352
Pakistan,2011-06-01,140,0,-2,58,16,212
Pakistan,2011-06-01,111,0,0,10,11,132
Pakistan,2011-06-01,135,0,-4,29,18,178
Pakistan,2011-06-01,135,2,1,16,19,173
Pakistan,2011-06-01,148,0,-2,8,8,162
Pakistan,2011-06-01,74,0,3,34,9,120
Pakistan,2011-06-01,123,0,-12,4,10,125
Pakistan,2011-06-01,156,0,-6,20,27,197
Pakistan,2011-06-01,133,0,-4,-15,17,131
Pakistan,2011-06-01,135,0,2,17,3,157
Pakistan,2011-06-01,187,2,0,87,10,286
Pakistan,2011-06-01,154,0,0,28,12,194
Pakistan,2011-06-01,152,0,-5,31,12,190
Sierra Leone,2011-06-01,0,0,0,3,0,3
Sierra Leone,2011-06-01,4,0,0,0,1,5
Sierra Leone,2011-06-01,8,0,0,0,0,8
Sierra Leone,2011-06-01,3,0,0,0,0,3
Sierra Leone,2011-06-01,-1,0,0,3,0,2
Sierra Leone,2011-06-01,4,0,0,3,0,7
Sierra Leone,2011-06-01,9,0,0,0,0,9
Sierra Leone,2011-06-01,9,0,0,9,0,18
Sierra Leone,2011-06-01,-1,0,0,9,0,8
Sierra Leone,2011-06-01,0,0,0,0,0,0
Sierra Leone,2011-06-01,0,0,0,3,0,3
Sierra Leone,2011-06-01,0,0,0,0,0,0
Sierra Leone,2011-06-01,3,0,1,9,2,15
Sierra Leone,2011-06-01,8,0,0,6,0,14
Sierra Leone,2011-06-01,14,0,-10,9,1,14
Sierra Leone,2011-06-01,9,0,0,3,1,13
Sierra Leone,2011-06-01,11,0,0,0,2,13
Sierra Leone,2011-06-01,4,0,0,0,0,4
Sierra Leone,2011-06-01,0,0,0,0,0,0
Sierra Leone,2011-06-01,2,0,0,6,0,8
Sierra Leone,2011-06-01,-2,0,0,0,0,-2
Sierra Leone,2011-06-01,1,0,0,0,0,1
Sierra Leone,2011-06-01,0,0,0,5,0,5
Sierra Leone,2011-06-01,9,0,0,6,0,15
Sierra Leone,2011-06-01,8,0,-2,3,0,9
Sierra Leone,2011-06-01,0,0,0,3,0,3
Sierra Leone,2011-06-01,2,0,0,6,0,8
Sierra Leone,2011-06-01,4,0,0,0,0,4
Sierra Leone,2011-06-01,3,0,0,9,1,13
Sierra Leone,2011-06-01,4,0,0,0,2,6
Somalia,2011-06-01,24,0,0,18,0,42
Somalia,2011-06-01,37,0,0,10,6,53
Somalia,2011-06-01,48,0,1,-2,9,56
Somalia,2011-06-01,15,0,0,0,2,17
Somalia,2011-06-01,35,0,0,12,0,47
Somalia,2011-06-01,29,0,0,4,4,37
Somalia,2011-06-01,26,0,2,15,1,44
Somalia,2011-06-01,53,0,1,10,3,67
Somalia,2011-06-01,52,0,-13,32,6,77
Somalia,2011-06-01,58,0,-8,14,31,95
Somalia,2011-06-01,106,0,0,2,5,113
Somalia,2011-06-01,132,0,0,-14,3,121
Somalia,2011-06-01,103,0,0,42,2,147
Somalia,2011-06-01,187,0,-4,43,39,265
Somalia,2011-06-01,695,10,-12,198,116,1007
Somalia,2011-06-01,23,0,-4,-14,2,7
Somalia,2011-06-01,36,0,0,-21,9,24
Somalia,2011-06-01,22,0,0,-56,29,-5
Somalia,2011-06-01,9,6,-12,-10,1,-6
Somalia,2011-06-01,12,0,1,1,12,26
Somalia,2011-06-01,21,2,0,7,20,50
Somalia,2011-06-01,37,0,0,23,19,79
Somalia,2011-06-01,9,0,0,9,0,18
Somalia,2011-06-01,47,0,0,23,4,74
Somalia,2011-06-01,17,0,0,2,0,19
Somalia,2011-06-01,13,0,0,15,0,28
Somalia,2011-06-01,15,0,-3,19,2,33
Somalia,2011-06-01,13,8,-7,13,0,27
Somalia,2011-06-01,56,4,0,16,6,82
Somalia,2011-06-01,16,0,3,18,0,37
Syria,2011-06-01,96,0,-1,40,17,152
Syria,2011-06-01,108,0,-1,11,9,127
Syria,2011-06-01,94,0,-14,9,15,104
Syria,2011-06-01,170,0,-2,43,35,246
Syria,2011-06-01,153,0,0,34,37,224
Syria,2011-06-01,182,0,4,22,43,251
Syria,2011-06-01,181,0,-3,42,35,255
Syria,2011-06-01,237,2,1,70,27,337
Syria,2011-06-01,373,0,-5,64,61,493
Syria,2011-06-01,381,0,-16,49,58,472
Syria,2011-06-01,280,0,0,53,68,401
Syria,2011-06-01,319,0,1,37,32,389
Syria,2011-06-01,345,0,1,85,13,444
Syria,2011-06-01,171,0,4,54,68,297
Syria,2011-06-01,313,0,-7,13,27,346
Syria,2011-06-01,145,0,-6,33,8,180
Syria,2011-06-01,296,0,-2,40,22,356
Syria,2011-06-01,223,0,-5,43,18,279
Syria,2011-06-01,148,0,-6,19,13,174
Syria,2011-06-01,224,0,-25,25,28,252
Syria,2011-06-01,178,2,1,39,35,255
Syria,2011-06-01,133,0,1,44,35,213
Syria,2011-06-01,265,0,2,110,28,405
Syria,2011-06-01,211,2,0,50,16,279
Syria,2011-06-01,99,0,0,32,4,135
Syria,2011-06-01,24,0,0,-4,4,24
Syria,2011-06-01,80,4,-4,5,5,90
Syria,2011-06-01,103,4,9,44,13,173
Syria,2011-06-01,102,2,4,3,26,137
Syria,2011-06-01,125,0,-12,38,14,165
Yemen,2011-06-01,30,0,-14,-2,2,16
Yemen,2011-06-01,77,0,-7,3,11,84
Yemen,2011-06-01,166,0,-2,5,5,174
Yemen,2011-06-01,146,0,-8,9,8,155
Yemen,2011-06-01,84,0,-2,-6,11,87
Yemen,2011-06-01,117,0,-1,10,4,130
Yemen,2011-06-01,113,0,-4,1,0,110
Yemen,2011-06-01,99,0,0,-1,10,108
Yemen,2011-06-01,120,0,-12,4,10,122
Yemen,2011-06-01,62,0,0,4,17,83
Yemen,2011-06-01,57,2,-7,13,9,74
Yemen,2011-06-01,70,0,0,7,0,77
Yemen,2011-06-01,71,0,-4,19,5,91
Yemen,2011-06-01,132,0,0,5,9,146
Yemen,2011-06-01,122,0,1,5,7,135
Yemen,2011-06-01,26,0,0,18,7,51
Yemen,2011-06-01,57,0,-1,19,4,79
Yemen,2011-06-01,39,0,0,4,7,50
Yemen,2011-06-01,32,0,-2,1,1,32
Yemen,2011-06-01,21,0,0,10,0,31
Yemen,2011-06-01,20,0,0,1,4,25
Yemen,2011-06-01,42,0,0,38,4,84
Yemen,2011-06-01,44,0,-3,4,5,50
Yemen,2011-06-01,165,2,-4,49,10,222
Yemen,2011-06-01,86,0,0,41,26,153
Yemen,2011-06-01,83,0,-2,38,24,143
Yemen,2011-06-01,38,0,-2,36,9,81
Yemen,2011-06-01,29,0,0,15,1,45
Yemen,2011-06-01,23,0,0,-40,0,-17
Yemen,2011-06-01,55,0,1,11,8,75
Afghanistan,2011-07-01,137,0,-19,7,0,125
Afghanistan,2011-07-01,115,2,0,-8,8,117
Afghanistan,2011-07-01,79,0,1,20,3,103
Afghanistan,2011-07-01,272,6,-5,1,20,294
Afghanistan,2011-07-01,263,0,-2,44,9,314
Afghanistan,2011-07-01,321,0,-4,48,24,389
Afghanistan,2011-07-01,496,0,-8,57,24,569
Afghanistan,2011-07-01,303,2,-7,33,16,347
Afghanistan,2011-07-01,272,6,0,12,16,306
Afghanistan,2011-07-01,191,10,-12,19,13,221
Afghanistan,2011-07-01,255,2,-2,37,29,321
Afghanistan,2011-07-01,611,0,0,39,33,683
Afghanistan,2011-07-01,455,4,0,20,34,513
Afghanistan,2011-07-01,460,0,4,70,87,621
Afghanistan,2011-07-01,253,2,0,22,34,311
Afghanistan,2011-07-01,177,0,-2,14,24,213
Afghanistan,2011-07-01,767,4,-1,84,39,893
Afghanistan,2011-07-01,778,4,-3,103,37,919
Afghanistan,2011-07-01,323,2,-12,37,29,379
Afghanistan,2011-07-01,302,2,-7,36,27,360
Afghanistan,2011-07-01,208,10,3,161,12,394
Afghanistan,2011-07-01,346,0,0,113,35,494
Afghanistan,2011-07-01,184,0,0,12,7,203
Afghanistan,2011-07-01,124,0,0,24,14,162
Afghanistan,2011-07-01,149,0,1,25,10,185
Afghanistan,2011-07-01,153,22,1,62,13,251
Afghanistan,2011-07-01,400,4,-2,141,94,637
Afghanistan,2011-07-01,355,0,0,164,45,564
Afghanistan,2011-07-01,200,0,-15,68,11,264
Afghanistan,2011-07-01,136,2,-8,50,29,209
Afghanistan,2011-07-01,131,0,-2,17,13,159
Albania,2011-07-01,2,0,0,9,3,14
Albania,2011-07-01,0,0,0,0,0,0
Albania,2011-07-01,6,0,0,0,1,7
Albania,2011-07-01,0,0,-1,0,0,-1
Albania,2011-07-01,3,0,0,8,0,11
Albania,2011-07-01,-4,0,0,0,0,-4
Albania,2011-07-01,7,0,-1,3,0,9
Albania,2011-07-01,13,0,1,9,0,23
Albania,2011-07-01,0,0,0,0,0,0
Albania,2011-07-01,0,0,0,13,0,13
Albania,2011-07-01,8,0,0,9,0,17
Albania,2011-07-01,10,0,-1,0,0,9
Albania,2011-07-01,1,0,0,3,0,4
Albania,2011-07-01,2,0,0,0,2,4
Albania,2011-07-01,21,0,-2,2,0,21
Albania,2011-07-01,4,0,0,-9,0,-5
Albania,2011-07-01,0,0,0,0,0,0
Albania,2011-07-01,0,0,0,3,0,3
Albania,2011-07-01,0,0,0,0,3,3
Albania,2011-07-01,4,0,-2,3,4,9
Albania,2011-07-01,6,0,-1,0,0,5
Albania,2011-07-01,4,0,0,16,0,20
Albania,2011-07-01,0,0,0,0,0,0
Albania,2011-07-01,16,0,0,3,0,19
Albania,2011-07-01,4,0,-2,3,6,11
Albania,2011-07-01,9,0,-2,6,18,31
Albania,2011-07-01,24,0,-3,7,16,44
Albania,2011-07-01,28,0,-4,8,0,32
Albania,2011-07-01,38,0,-4,15,1,50
Albania,2011-07-01,1,0,-12,0,0,-11
Albania,2011-07-01,3,0,-5,-2,0,-4
Algeria,2011-07-01,13,0,0,10,2,25
Algeria,2011-07-01,1,0,0,18,0,19
Algeria,2011-07-01,2,0,0,0,0,2
Algeria,2011-07-01,14,0,0,0,0,14
Algeria,2011-07-01,13,0,0,12,1,26
Algeria,2011-07-01,8,0,0,13,0,21
Algeria,2011-07-01,12,0,0,12,2,26
Algeria,2011-07-01,6,0,0,0,0,6
Algeria,2011-07-01,3,0,0,0,0,3
Algeria,2011-07-01,8,0,0,0,0,8
Algeria,2011-07-01,25,0,-5,3,3,26
Algeria,2011-07-01,21,0,-4,3,3,23
Algeria,2011-07-01,4,0,0,1,0,5
Algeria,2011-07-01,3,0,0,9,0,12
Algeria,2011-07-01,0,0,0,0,0,0
Algeria,2011-07-01,9,0,0,3,0,12
Algeria,2011-07-01,13,0,0,0,1,14
Algeria,2011-07-01,3,0,0,3,1,7
Algeria,2011-07-01,9,0,0,18,1,28
Algeria,2011-07-01,30,0,0,6,0,36
Algeria,2011-07-01,3,0,1,-4,0,0
Algeria,2011-07-01,33,0,0,2,0,35
Algeria,2011-07-01,18,0,0,3,0,21
Algeria,2011-07-01,5,0,0,1,0,6
Algeria,2011-07-01,17,0,0,0,6,23
Algeria,2011-07-01,11,0,0,0,0,11
Algeria,2011-07-01,6,0,0,6,0,12
Algeria,2011-07-01,11,0,0,0,0,11
Algeria,2011-07-01,13,0,0,0,0,13
Algeria,2011-07-01,14,0,1,9,0,24
Algeria,2011-07-01,6,0,0,0,0,6
Bangladesh,2011-07-01,18,0,-6,-6,9,15
Bangladesh,2011-07-01,12,0,-4,3,3,14
Bangladesh,2011-07-01,33,0,-2,15,12,58
Bangladesh,2011-07-01,16,0,0,18,4,38
Bangladesh,2011-07-01,9,0,0,12,6,27
Bangladesh,2011-07-01,22,0,0,13,2,37
Bangladesh,2011-07-01,27,0,-3,-2,5,27
Bangladesh,2011-07-01,41,0,0,9,0,50
Bangladesh,2011-07-01,9,0,0,7,6,22
Bangladesh,2011-07-01,22,0,-6,9,5,30
Bangladesh,2011-07-01,33,0,-7,3,2,31
Bangladesh,2011-07-01,11,0,0,11,8,30
Bangladesh,2011-07-01,22,0,-2,24,13,57
Bangladesh,2011-07-01,37,0,0,8,10,55
Bangladesh,2011-07-01,11,0,-4,0,2,9
Bangladesh,2011-07-01,26,0,-2,3,1,28
Bangladesh,2011-07-01,4,2,0,6,4,16
Bangladesh,2011-07-01,19,0,0,26,4,49
Bangladesh,2011-07-01,28,0,0,-1,6,33
Bangladesh,2011-07-01,16,0,0,19,1,36
Bangladesh,2011-07-01,36,0,1,10,2,49
Bangladesh,2011-07-01,16,0,0,-2,4,18
Bangladesh,2011-07-01,9,0,0,1,0,10
Bangladesh,2011-07-01,12,0,0,1,0,13
Bangladesh,2011-07-01,10,0,0,-6,0,4
Bangladesh,2011-07-01,12,0,0,33,0,45
Bangladesh,2011-07-01,13,2,0,16,0,31
Bangladesh,2011-07-01,3,0,0,-3,0,0
Bangladesh,2011-07-01,3,0,0,-10,0,-7
Bangladesh,2011-07-01,5,0,0,3,0,8
Bangladesh,2011-07-01,8,0,0,5,0,13
Cameroon,2011-07-01,13,0,0,3,2,18
Cameroon,2011-07-01,0,0,0,0,0,0
Cameroon,2011-07-01,4,0,0,0,2,6
Cameroon,2011-07-01,0,0,0,3,0,3
Cameroon,2011-07-01,7,0,0,0,0,7
Cameroon,2011-07-01,3,0,0,0,0,3
Cameroon,2011-07-01,0,0,0,0,0,0
Cameroon,2011-07-01,6,0,0,0,0,6
Cameroon,2011-07-01,2,0,0,0,0,2
Cameroon,2011-07-01,0,0,0,0,0,0
Cameroon,2011-07-01,2,0,0,3,0,5
Cameroon,2011-07-01,10,0,0,0,2,12
Cameroon,2011-07-01,0,0,0,0,0,0
Cameroon,2011-07-01,0,0,0,0,0,0
Cameroon,2011-07-01,1,0,0,0,0,1
Cameroon,2011-07-01,0,0,-2,0,0,-2
Cameroon,2011-07-01,0,0,0,0,0,0
Cameroon,2011-07-01,1,0,0,0,0,1
Cameroon,2011-07-01,3,0,0,0,0,3
Cameroon,2011-07-01,-3,0,0,0,0,-3
Cameroon,2011-07-01,1,0,0,6,0,7
Cameroon,2011-07-01,-2,0,0,3,0,1
Cameroon,2011-07-01,-2,0,0,0,0,-2
Cameroon,2011-07-01,-1,0,0,0,0,-1
Cameroon,2011-07-01,0,0,0,12,0,12
Cameroon,2011-07-01,2,0,0,3,0,5
Cameroon,2011-07-01,0,0,0,0,1,1
Cameroon,2011-07-01,1,0,0,0,0,1
Cameroon,2011-07-01,0,0,0,0,0,0
China,2011-07-01,187,0,2,4,23,216
China,2011-07-01,50,0,-16,51,6,91
China,2011-07-01,72,0,-2,17,4,91
China,2011-07-01,106,2,0,40,8,156
China,2011-07-01,127,2,5,109,34,277
China,2011-07-01,181,0,-3,124,37,339
China,2011-07-01,148,2,1,100,14,265
China,2011-07-01,138,2,0,77,7,224
China,2011-07-01,49,2,-3,38,15,101
China,2011-07-01,96,0,-13,59,8,150
China,2011-07-01,131,0,-13,62,27,207
China,2011-07-01,127,2,-3,35,15,176
China,2011-07-01,117,0,-3,12,11,137
China,2011-07-01,147,0,4,37,13,201
China,2011-07-01,166,6,3,52,17,244
China,2011-07-01,44,0,2,6,3,55
China,2011-07-01,78,2,-6,32,12,118
China,2011-07-01,137,0,-2,26,4,165
China,2011-07-01,198,0,-3,43,26,264
China,2011-07-01,213,2,-1,63,24,301
China,2011-07-01,121,4,-4,66,19,206
China,2011-07-01,179,2,-6,83,12,270
China,2011-07-01,157,0,3,9,12,181
China,2011-07-01,130,0,-1,31,6,166
China,2011-07-01,154,2,-3,110,5,268
China,2011-07-01,143,2,-4,46,18,205
China,2011-07-01,109,4,2,39,26,180
China,2011-07-01,128,6,-1,24,8,165
China,2011-07-01,171,2,-4,34,15,218
China,2011-07-01,83,0,-6,37,15,129
China,2011-07-01,133,0,-10,17,16,156
Egypt,2011-07-01,81,2,-9,58,21,153
Egypt,2011-07-01,87,0,2,42,19,150
Egypt,2011-07-01,52,2,-1,50,10,113
Egypt,2011-07-01,76,4,0,22,17,119
Egypt,2011-07-01,50,4,1,93,9,157
Egypt,2011-07-01,63,2,1,55,11,132
Egypt,2011-07-01,96,0,1,35,21,153
Egypt,2011-07-01,67,0,-2,13,12,90
Egypt,2011-07-01,38,0,0,40,13,91
Egypt,2011-07-01,35,0,-11,20,20,64
Egypt,2011-07-01,39,0,-7,46,16,94
Egypt,2011-07-01,56,0,-19,77,15,129
Egypt,2011-07-01,50,0,-11,1,15,55
Egypt,2011-07-01,33,0,-1,38,8,78
Egypt,2011-07-01,13,0,0,14,17,44
Egypt,2011-07-01,21,2,-1,16,13,51
Egypt,2011-07-01,77,0,-39,34,24,96
Egypt,2011-07-01,36,0,-12,39,28,91
Egypt,2011-07-01,38,0,-7,39,4,74
Egypt,2011-07-01,66,0,-4,22,8,92
Egypt,2011-07-01,50,0,-10,32,10,82
Egypt,2011-07-01,49,0,-1,23,8,79
Egypt,2011-07-01,30,0,-1,15,11,55
Egypt,2011-07-01,75,0,-1,20,19,113
Egypt,2011-07-01,75,0,-3,55,7,134
Egypt,2011-07-01,47,0,4,24,11,86
Egypt,2011-07-01,55,2,-4,20,13,86
Egypt,2011-07-01,28,0,1,22,9,60
Egypt,2011-07-01,54,0,-3,18,11,80
Egypt,2011-07-01,78,0,2,6,5,91
Egypt,2011-07-01,49,0,-3,18,6,70
Eritrea,2011-07-01,1,0,0,3,0,4
Eritrea,2011-07-01,0,0,0,0,0,0
Eritrea,2011-07-01,6,0,0,0,1,7
Eritrea,2011-07-01,13,0,0,11,0,24
Eritrea,2011-07-01,10,0,0,3,0,13
Eritrea,2011-07-01,2,0,0,3,0,5
Eritrea,2011-07-01,1,0,0,0,2,3
Eritrea,2011-07-01,1,0,0,-2,0,-1
Eritrea,2011-07-01,1,0,0,0,0,1
Eritrea,2011-07-01,0,0,0,0,0,0
Eritrea,2011-07-01,4,0,0,0,0,4
Eritrea,2011-07-01,-1,0,0,3,0,2
Eritrea,2011-07-01,0,0,0,6,0,6
Eritrea,2011-07-01,0,0,0,0,0,0
Eritrea,2011-07-01,4,0,0,-2,0,2
Eritrea,2011-07-01,2,0,0,-1,0,1
Eritrea,2011-07-01,2,0,0,-1,0,1
Eritrea,2011-07-01,0,0,0,0,0,0
Eritrea,2011-07-01,14,0,0,3,0,17
Eritrea,2011-07-01,1,0,0,0,0,1
Eritrea,2011-07-01,1,0,0,15,0,16
Eritrea,2011-07-01,0,0,0,0,0,0
Eritrea,2011-07-01,0,0,0,-2,0,-2
Eritrea,2011-07-01,0,0,0,0,0,0
Eritrea,2011-07-01,11,0,0,7,0,18
Eritrea,2011-07-01,5,4,0,6,2,17
Eritrea,2011-07-01,12,0,0,4,0,16
Eritrea,2011-07-01,13,0,0,-2,0,11
Eritrea,2011-07-01,2,0,0,16,0,18
Eritrea,2011-07-01,2,0,0,0,0,2
Georgia,2011-07-01,8,2,0,12,2,24
Georgia,2011-07-01,14,2,0,12,4,32
Georgia,2011-07-01,28,2,0,8,4,42
Georgia,2011-07-01,8,0,0,12,4,24
Georgia,2011-07-01,30,0,1,7,0,38
Georgia,2011-07-01,27,2,0,8,9,46
Georgia,2011-07-01,63,2,1,39,11,116
Georgia,2011-07-01,57,0,0,65,4,126
Georgia,2011-07-01,4,0,0,11,5,20
Georgia,2011-07-01,12,0,1,9,3,25
Georgia,2011-07-01,34,2,-2,21,14,69
Georgia,2011-07-01,41,0,3,-3,6,47
Georgia,2011-07-01,45,0,0,9,13,67
Georgia,2011-07-01,24,4,1,10,13,52
Georgia,2011-07-01,58,2,-2,29,5,92
Georgia,2011-07-01,16,0,0,27,8,51
Georgia,2011-07-01,15,0,0,13,1,29
Georgia,2011-07-01,15,0,0,9,12,36
Georgia,2011-07-01,32,0,0,19,2,53
Georgia,2011-07-01,63,2,1,20,1,87
Georgia,2011-07-01,89,0,-3,42,10,138
Georgia,2011-07-01,47,0,0,55,4,106
Georgia,2011-07-01,18,0,0,9,2,29
Georgia,2011-07-01,8,2,0,3,2,15
Georgia,2011-07-01,10,0,-4,24,0,30
Georgia,2011-07-01,52,4,-3,26,8,87
Georgia,2011-07-01,16,0,0,23,7,46
Georgia,2011-07-01,57,0,-4,17,4,74
Georgia,2011-07-01,33,0,0,9,5,47
Georgia,2011-07-01,20,0,0,21,8,49
Georgia,2011-07-01,40,0,0,2,3,45
India,2011-07-01,42,2,0,33,5,82
India,2011-07-01,38,2,1,19,2,62
India,2011-07-01,29,2,0,10,4,45
India,2011-07-01,24,0,-2,19,5,46
India,2011-07-01,42,2,-2,18,8,68
India,2011-07-01,38,4,-5,28,5,70
India,2011-07-01,62,0,-7,23,2,80
India,2011-07-01,56,2,-1,42,4,103
India,2011-07-01,51,0,-2,-12,6,43
India,2011-07-01,71,0,-6,6,2,73
India,2011-07-01,57,0,-8,12,14,75
India,2011-07-01,60,2,-2,16,4,80
India,2011-07-01,46,2,-1,19,14,80
India,2011-07-01,107,0,-6,16,19,136
India,2011-07-01,26,0,-4,-6,11,27
India,2011-07-01,54,0,0,1,6,61
India,2011-07-01,36,4,-1,29,4,72
India,2011-07-01,45,0,-1,15,9,68
India,2011-07-01,72,0,-1,27,3,101
India,2011-07-01,61,0,0,32,5,98
India,2011-07-01,78,10,-6,51,10,143
India,2011-07-01,58,0,1,26,14,99
India,2011-07-01,38,4,-3,37,9,85
India,2011-07-01,75,0,-3,11,11,94
India,2011-07-01,26,0,0,24,4,54
India,2011-07-01,42,2,-2,13,4,59
India,2011-07-01,51,0,-1,23,13,86
India,2011-07-01,61,0,-6,11,5,71
India,2011-07-01,85,0,-2,9,11,103
India,2011-07-01,81,0,1,16,3,101
India,2011-07-01,73,2,-16,21,18,98
Iran,2011-07-01,88,4,-2,119,8,217
Iran,2011-07-01,65,0,0,93,3,161
Iran,2011-07-01,51,0,-6,53,13,111
Iran,2011-07-01,118,0,-3,41,3,159
Iran,2011-07-01,123,0,0,36,7,166
Iran,2011-07-01,107,0,0,57,11,175
Iran,2011-07-01,92,0,-8,53,5,142
Iran,2011-07-01,56,0,0,114,1,171
Iran,2011-07-01,30,0,0,64,0,94
Iran,2011-07-01,54,0,-7,40,8,95
Iran,2011-07-01,176,0,-18,52,17,227
Iran,2011-07-01,79,0,-6,8,10,91
Iran,2011-07-01,42,2,-2,14,15,71
Iran,2011-07-01,67,0,0,16,13,96
Iran,2011-07-01,54,0,-4,18,8,76
Iran,2011-07-01,35,2,-1,13,9,58
Iran,2011-07-01,32,2,-4,4,12,46
Iran,2011-07-01,110,0,-10,30,8,138
Iran,2011-07-01,108,0,-19,16,8,113
Iran,2011-07-01,66,4,-14,11,5,72
Iran,2011-07-01,71,0,-7,36,10,110
Iran,2011-07-01,98,0,-9,36,6,131
Iran,2011-07-01,114,0,0,12,2,128
Iran,2011-07-01,44,0,0,28,1,73
Iran,2011-07-01,56,0,0,63,1,120
Iran,2011-07-01,81,0,0,9,8,98
Iran,2011-07-01,47,0,-8,28,9,76
Iran,2011-07-01,77,0,-14,21,9,93
Iran,2011-07-01,125,0,-4,74,6,201
Iran,2011-07-01,217,0,-5,16,8,236
Iran,2011-07-01,68,0,-6,62,8,132
Iraq,2011-07-01,127,0,-9,19,11,148
Iraq,2011-07-01,65,0,-4,28,20,109
Iraq,2011-07-01,119,2,-2,36,17,172
Iraq,2011-07-01,55,0,-2,5,16,74
Iraq,2011-07-01,71,0,0,42,7,120
Iraq,2011-07-01,155,0,0,4,15,174
Iraq,2011-07-01,125,4,4,37,12,182
Iraq,2011-07-01,124,0,0,52,31,207
Iraq,2011-07-01,71,0,-3,10,6,84
Iraq,2011-07-01,63,2,-1,14,7,85
Iraq,2011-07-01,119,0,-13,27,4,137
Iraq,2011-07-01,134,0,-3,57,5,193
Iraq,2011-07-01,183,4,3,20,8,218
Iraq,2011-07-01,229,4,0,29,18,280
Iraq,2011-07-01,189,2,0,28,11,230
Iraq,2011-07-01,67,4,1,10,5,87
Iraq,2011-07-01,111,0,-2,42,5,156
Iraq,2011-07-01,212,0,-10,14,11,227
Iraq,2011-07-01,157,0,1,33,8,199
Iraq,2011-07-01,115,0,0,29,4,148
Iraq,2011-07-01,37,0,-1,21,10,67
Iraq,2011-07-01,149,2,0,16,18,185
Iraq,2011-07-01,96,0,-1,8,11,114
Iraq,2011-07-01,416,10,-4,150,65,637
Iraq,2011-07-01,202,6,1,30,29,268
Iraq,2011-07-01,98,10,-5,55,18,176
Iraq,2011-07-01,139,4,1,43,8,195
Iraq,2011-07-01,162,0,0,50,19,231
Iraq,2011-07-01,472,16,7,216,88,799
Iraq,2011-07-01,316,10,0,143,48,517
Iraq,2011-07-01,113,2,0,30,7,152
Morocco,2011-07-01,15,0,-2,-3,9,19
Morocco,2011-07-01,4,0,0,-1,6,9
Morocco,2011-07-01,9,0,0,-2,3,10
Morocco,2011-07-01,4,0,0,1,5,10
Morocco,2011-07-01,9,0,0,0,1,10
Morocco,2011-07-01,11,0,0,0,1,12
Morocco,2011-07-01,11,0,0,-5,0,6
Morocco,2011-07-01,3,0,1,0,1,5
Morocco,2011-07-01,13,0,0,3,4,20
Morocco,2011-07-01,4,0,1,0,1,6
Morocco,2011-07-01,2,0,0,3,1,6
Morocco,2011-07-01,6,0,-6,0,0,0
Morocco,2011-07-01,10,0,-2,10,0,18
Morocco,2011-07-01,6,0,0,-2,0,4
Morocco,2011-07-01,9,0,0,0,5,14
Morocco,2011-07-01,4,0,0,0,1,5
Morocco,2011-07-01,2,0,0,6,0,8
Morocco,2011-07-01,7,0,0,1,2,10
Morocco,2011-07-01,32,0,0,13,7,52
Morocco,2011-07-01,15,0,0,1,0,16
Morocco,2011-07-01,10,0,0,0,0,10
Morocco,2011-07-01,3,0,0,6,0,9
Morocco,2011-07-01,0,0,0,3,0,3
Morocco,2011-07-01,0,0,0,0,0,0
Morocco,2011-07-01,2,0,0,0,0,2
Morocco,2011-07-01,23,0,0,6,0,29
Morocco,2011-07-01,15,0,0,0,0,15
Morocco,2011-07-01,18,0,0,9,0,27
Morocco,2011-07-01,1,0,0,-3,2,0
Morocco,2011-07-01,8,0,4,17,11,40
Morocco,2011-07-01,3,0,2,0,2,7
Nigeria,2011-07-01,16,0,1,15,4,36
Nigeria,2011-07-01,12,0,-2,9,3,22
Nigeria,2011-07-01,2,0,0,9,0,11
Nigeria,2011-07-01,14,0,-2,5,7,24
Nigeria,2011-07-01,7,4,0,22,2,35
Nigeria,2011-07-01,19,0,0,13,9,41
Nigeria,2011-07-01,18,0,0,37,8,63
Nigeria,2011-07-01,13,2,0,13,4,32
Nigeria,2011-07-01,11,0,0,0,0,11
Nigeria,2011-07-01,5,0,0,3,8,16
Nigeria,2011-07-01,20,0,1,-2,5,24
Nigeria,2011-07-01,4,0,0,15,5,24
Nigeria,2011-07-01,12,0,0,15,10,37
Nigeria,2011-07-01,35,0,0,12,1,48
Nigeria,2011-07-01,23,0,0,10,0,33
Nigeria,2011-07-01,9,0,0,9,2,20
Nigeria,2011-07-01,12,0,0,1,0,13
Nigeria,2011-07-01,28,0,-2,31,0,57
Nigeria,2011-07-01,45,0,0,23,3,71
Nigeria,2011-07-01,36,0,0,7,12,55
Nigeria,2011-07-01,16,0,-3,19,0,32
Nigeria,2011-07-01,3,0,0,14,1,18
Nigeria,2011-07-01,11,0,0,16,2,29
Nigeria,2011-07-01,3,0,0,9,2,14
Nigeria,2011-07-01,20,4,0,15,10,49
Nigeria,2011-07-01,31,0,1,15,4,51
Nigeria,2011-07-01,32,0,0,8,3,43
Nigeria,2011-07-01,28,0,0,5,4,37
Nigeria,2011-07-01,22,0,-4,18,15,51
Nigeria,2011-07-01,14,0,0,-2,1,13
Nigeria,2011-07-01,36,0,0,12,0,48
Pakistan,2011-07-01,56,0,0,24,12,92
Pakistan,2011-07-01,271,0,-4,32,28,327
Pakistan,2011-07-01,150,0,0,30,15,195
Pakistan,2011-07-01,139,0,-1,45,19,202
Pakistan,2011-07-01,136,2,2,34,23,197
Pakistan,2011-07-01,158,0,0,50,15,223
Pakistan,2011-07-01,146,0,-4,11,17,170
Pakistan,2011-07-01,174,0,-4,76,17,263
Pakistan,2011-07-01,95,0,-2,63,12,168
Pakistan,2011-07-01,127,4,-7,16,9,149
Pakistan,2011-07-01,80,0,-7,10,19,102
Pakistan,2011-07-01,122,0,1,31,7,161
Pakistan,2011-07-01,258,4,0,53,52,367
Pakistan,2011-07-01,248,0,0,24,45,317
Pakistan,2011-07-01,131,4,-2,32,8,173
Pakistan,2011-07-01,72,0,0,6,11,89
Pakistan,2011-07-01,92,0,-6,45,10,141
Pakistan,2011-07-01,147,0,-2,21,6,172
Pakistan,2011-07-01,266,2,0,66,11,345
Pakistan,2011-07-01,252,2,3,55,5,317
Pakistan,2011-07-01,179,2,-2,80,12,271
Pakistan,2011-07-01,130,0,0,18,6,154
Pakistan,2011-07-01,100,0,-2,34,8,140
Pakistan,2011-07-01,112,0,-2,22,8,140
Pakistan,2011-07-01,62,0,0,18,5,85
Pakistan,2011-07-01,93,6,0,39,9,147
Pakistan,2011-07-01,155,0,4,34,33,226
Pakistan,2011-07-01,95,6,0,37,12,150
Pakistan,2011-07-01,190,4,-9,51,7,243
Pakistan,2011-07-01,201,2,2,18,22,245
Pakistan,2011-07-01,75,0,-2,37,9,119
Sierra Leone,2011-07-01,4,0,0,18,10,32
Sierra Leone,2011-07-01,23,0,0,0,0,23
Sierra Leone,2011-07-01,0,0,0,0,0,0
Sierra Leone,2011-07-01,0,0,0,0,0,0
Sierra Leone,2011-07-01,3,0,0,0,0,3
Sierra Leone,2011-07-01,0,0,0,0,0,0
Sierra Leone,2011-07-01,2,0,0,0,0,2
Sierra Leone,2011-07-01,0,0,0,3,0,3
Sierra Leone,2011-07-01,0,0,0,0,0,0
Sierra Leone,2011-07-01,2,0,0,0,0,2
Sierra Leone,2011-07-01,-1,0,0,0,0,-1
Sierra Leone,2011-07-01,-1,0,0,0,0,-1
Sierra Leone,2011-07-01,2,0,0,0,0,2
Sierra Leone,2011-07-01,0,0,0,0,0,0
Sierra Leone,2011-07-01,2,0,0,3,1,6
Sierra Leone,2011-07-01,0,0,0,9,0,9
Sierra Leone,2011-07-01,6,0,0,6,0,12
Sierra Leone,2011-07-01,-2,0,0,0,1,-1
Sierra Leone,2011-07-01,-3,0,0,0,0,-3
Sierra Leone,2011-07-01,2,0,0,0,0,2
Sierra Leone,2011-07-01,1,0,0,0,0,1
Sierra Leone,2011-07-01,-1,0,0,0,0,-1
Sierra Leone,2011-07-01,-1,0,0,-4,0,-5
Sierra Leone,2011-07-01,4,0,0,6,3,13
Sierra Leone,2011-07-01,8,0,0,0,2,10
Sierra Leone,2011-07-01,0,0,0,0,0,0
Sierra Leone,2011-07-01,11,0,0,0,1,12
Sierra Leone,2011-07-01,5,0,0,0,1,6
Somalia,2011-07-01,48,0,0,29,4,81
Somalia,2011-07-01,25,0,0,39,0,64
Somalia,2011-07-01,-3,0,0,12,2,11
Somalia,2011-07-01,39,4,1,38,4,86
Somalia,2011-07-01,101,0,-2,72,3,174
Somalia,2011-07-01,89,14,0,162,2,267
Somalia,2011-07-01,113,10,0,66,1,190
Somalia,2011-07-01,181,4,0,46,2,233
Somalia,2011-07-01,29,4,0,9,0,42
Somalia,2011-07-01,49,4,-4,6,0,55
Somalia,2011-07-01,44,6,-4,11,3,60
Somalia,2011-07-01,64,4,0,-10,2,60
Somalia,2011-07-01,42,2,0,34,3,81
Somalia,2011-07-01,48,0,0,-9,1,40
Somalia,2011-07-01,70,0,0,-27,3,46
Somalia,2011-07-01,36,0,0,12,0,48
Somalia,2011-07-01,44,6,-4,15,3,64
Somalia,2011-07-01,74,0,0,6,0,80
Somalia,2011-07-01,77,10,-1,29,2,117
Somalia,2011-07-01,135,16,-2,9,3,161
Somalia,2011-07-01,70,6,0,29,3,108
Somalia,2011-07-01,147,2,1,47,4,201
Somalia,2011-07-01,43,0,0,10,0,53
Somalia,2011-07-01,33,2,0,12,2,49
Somalia,2011-07-01,54,2,0,31,2,89
Somalia,2011-07-01,47,0,-3,42,2,88
Somalia,2011-07-01,83,2,2,56,6,149
Somalia,2011-07-01,91,6,0,16,3,116
Somalia,2011-07-01,96,10,0,24,8,138
Somalia,2011-07-01,24,0,0,24,5,53
Somalia,2011-07-01,52,0,0,13,6,71
Syria,2011-07-01,57,0,0,29,8,94
Syria,2011-07-01,33,0,-5,19,11,58
Syria,2011-07-01,12,0,1,11,16,40
Syria,2011-07-01,51,0,0,12,23,86
Syria,2011-07-01,133,0,-1,54,15,201
Syria,2011-07-01,138,0,2,36,25,201
Syria,2011-07-01,110,0,0,34,4,148
Syria,2011-07-01,80,0,2,26,18,126
Syria,2011-07-01,76,2,0,18,4,100
Syria,2011-07-01,44,0,-10,6,6,46
Syria,2011-07-01,110,0,-22,11,31,130
Syria,2011-07-01,112,0,-2,29,44,183
Syria,2011-07-01,60,0,-1,30,28,117
Syria,2011-07-01,80,1,1,32,12,126
Syria,2011-07-01,25,0,-1,1,17,42
Syria,2011-07-01,59,0,1,5,8,73
Syria,2011-07-01,65,0,1,16,4,86
Syria,2011-07-01,78,0,-6,0,10,82
Syria,2011-07-01,105,0,-8,22,4,123
Syria,2011-07-01,124,0,-4,31,8,159
Syria,2011-07-01,16,0,0,14,0,30
Syria,2011-07-01,84,0,5,13,12,114
Syria,2011-07-01,58,0,1,15,14,88
Syria,2011-07-01,39,0,0,-2,1,38
Syria,2011-07-01,0,0,3,21,25,49
Syria,2011-07-01,24,0,2,34,9,69
Syria,2011-07-01,75,0,-1,37,14,125
Syria,2011-07-01,148,0,-4,43,5,192
Syria,2011-07-01,79,0,0,7,18,104
Syria,2011-07-01,82,0,1,-8,6,81
Syria,2011-07-01,400,0,-2,36,128,562
Yemen,2011-07-01,410,10,-16,332,89,825
Yemen,2011-07-01,195,2,-1,102,8,306
Yemen,2011-07-01,26,2,-1,6,1,34
Yemen,2011-07-01,12,0,1,6,1,20
Yemen,2011-07-01,32,0,0,47,2,81
Yemen,2011-07-01,208,8,-3,189,40,442
Yemen,2011-07-01,335,10,-5,210,46,596
Yemen,2011-07-01,53,0,1,7,14,75
Yemen,2011-07-01,99,0,-3,-4,9,101
Yemen,2011-07-01,32,0,-4,1,3,32
Yemen,2011-07-01,19,0,-22,9,4,10
Yemen,2011-07-01,11,0,0,14,4,29
Yemen,2011-07-01,29,0,0,39,1,69
Yemen,2011-07-01,40,0,0,12,9,61
Yemen,2011-07-01,30,0,0,11,9,50
Yemen,2011-07-01,21,0,0,3,2,26
Yemen,2011-07-01,27,0,0,10,8,45
Yemen,2011-07-01,21,0,0,11,5,37
Yemen,2011-07-01,47,0,-6,14,4,59
Yemen,2011-07-01,120,0,1,18,9,148
Yemen,2011-07-01,35,0,0,29,10,74
Yemen,2011-07-01,34,0,0,0,4,38
Yemen,2011-07-01,13,0,0,-2,0,11
Yemen,2011-07-01,17,0,0,-1,8,24
Yemen,2011-07-01,67,0,0,28,3,98
Yemen,2011-07-01,560,24,-5,338,57,974
Yemen,2011-07-01,28,0,2,27,2,59
Yemen,2011-07-01,30,0,-2,6,5,39
Yemen,2011-07-01,10,0,0,-4,2,8
Yemen,2011-07-01,24,0,0,6,6,36
Yemen,2011-07-01,14,0,-2,-4,1,9
Afghanistan,2006-09-01,19,0,0,6,1,26
Afghanistan,2006-09-01,71,0,0,3,1,75
Afghanistan,2006-09-01,156,0,0,5,2,163
Afghanistan,2006-09-01,120,0,0,21,2,143
Afghanistan,2006-09-01,83,0,0,17,4,104
Afghanistan,2006-09-01,118,0,0,30,7,155
Afghanistan,2006-09-01,73,0,-2,30,3,104
Afghanistan,2006-09-01,125,0,0,38,8,171
Afghanistan,2006-09-01,94,0,-2,9,3,104
Afghanistan,2006-09-01,134,0,-5,9,11,149
Afghanistan,2006-09-01,146,0,0,26,11,183
Afghanistan,2006-09-01,136,0,0,-4,11,143
Afghanistan,2006-09-01,119,4,0,45,12,180
Afghanistan,2006-09-01,28,0,0,6,6,40
Afghanistan,2006-09-01,129,0,0,16,15,160
Afghanistan,2006-09-01,62,0,0,16,10,88
Afghanistan,2006-09-01,41,2,0,9,19,71
Afghanistan,2006-09-01,67,0,0,9,29,105
Afghanistan,2006-09-01,108,0,0,24,18,150
Afghanistan,2006-09-01,86,4,0,2,11,103
Afghanistan,2006-09-01,131,0,1,3,6,141
Afghanistan,2006-09-01,177,0,0,30,11,218
Afghanistan,2006-09-01,102,0,0,9,14,125
Afghanistan,2006-09-01,73,0,0,-1,9,81
Afghanistan,2006-09-01,78,0,0,-2,4,80
Afghanistan,2006-09-01,107,0,0,30,24,161
Afghanistan,2006-09-01,56,2,1,12,4,75
Afghanistan,2006-09-01,96,0,0,14,3,113
Afghanistan,2006-09-01,125,0,1,19,6,151
Afghanistan,2006-09-01,47,0,0,-12,17,52
Albania,2006-09-01,5,0,0,4,0,9
Albania,2006-09-01,0,0,0,0,0,0
Albania,2006-09-01,2,0,0,0,0,2
Albania,2006-09-01,0,0,0,0,0,0
Albania,2006-09-01,4,0,0,3,3,10
Albania,2006-09-01,0,0,0,0,0,0
Albania,2006-09-01,0,0,0,12,0,12
Albania,2006-09-01,5,0,0,3,0,8
Albania,2006-09-01,0,0,0,6,0,6
Albania,2006-09-01,1,2,0,15,1,19
Albania,2006-09-01,1,0,0,18,0,19
Albania,2006-09-01,-4,0,0,0,0,-4
Albania,2006-09-01,30,0,1,12,6,49
Albania,2006-09-01,4,0,0,3,0,7
Albania,2006-09-01,17,0,0,-2,1,16
Albania,2006-09-01,16,0,0,0,0,16
Albania,2006-09-01,1,0,0,0,0,1
Albania,2006-09-01,7,0,0,33,1,41
Albania,2006-09-01,4,0,1,12,5,22
Albania,2006-09-01,3,0,0,-4,2,1
Albania,2006-09-01,10,0,0,3,0,13
Albania,2006-09-01,5,0,0,3,0,8
Albania,2006-09-01,0,0,0,0,0,0
Albania,2006-09-01,10,0,0,3,0,13
Albania,2006-09-01,16,0,-4,0,0,12
Albania,2006-09-01,10,0,0,0,0,10
Albania,2006-09-01,8,0,0,3,0,11
Albania,2006-09-01,7,0,0,0,0,7
Albania,2006-09-01,2,0,-2,-6,0,-6
Albania,2006-09-01,3,0,1,6,5,15
Algeria,2006-09-01,0,0,0,3,0,3
Algeria,2006-09-01,6,0,0,3,0,9
Algeria,2006-09-01,0,0,0,0,0,0
Algeria,2006-09-01,7,0,0,0,0,7
Algeria,2006-09-01,5,0,0,0,0,5
Algeria,2006-09-01,0,0,0,0,0,0
Algeria,2006-09-01,0,0,0,0,0,0
Algeria,2006-09-01,0,0,0,6,0,6
Algeria,2006-09-01,0,0,0,0,0,0
Algeria,2006-09-01,2,0,0,3,0,5
Algeria,2006-09-01,0,0,0,0,0,0
Algeria,2006-09-01,2,0,0,0,0,2
Algeria,2006-09-01,11,0,0,0,0,11
Algeria,2006-09-01,4,0,0,0,0,4
Algeria,2006-09-01,4,0,0,0,0,4
Algeria,2006-09-01,0,0,0,3,0,3
Algeria,2006-09-01,0,0,0,-10,0,-10
Algeria,2006-09-01,0,0,-1,3,0,2
Algeria,2006-09-01,0,0,0,3,0,3
Algeria,2006-09-01,1,0,0,10,0,11
Algeria,2006-09-01,4,0,0,6,0,10
Algeria,2006-09-01,1,0,0,-2,0,-1
Algeria,2006-09-01,6,0,0,0,0,6
Algeria,2006-09-01,0,0,0,0,0,0
Algeria,2006-09-01,1,0,0,6,0,7
Algeria,2006-09-01,6,0,0,0,3,9
Algeria,2006-09-01,0,0,0,7,0,7
Algeria,2006-09-01,3,0,0,0,0,3
Algeria,2006-09-01,0,0,0,0,0,0
Bangladesh,2006-09-01,14,0,0,0,4,18
Bangladesh,2006-09-01,5,0,0,3,0,8
Bangladesh,2006-09-01,0,0,0,-1,1,0
Bangladesh,2006-09-01,13,0,0,0,0,13
Bangladesh,2006-09-01,8,0,0,9,0,17
Bangladesh,2006-09-01,2,0,0,0,0,2
Bangladesh,2006-09-01,11,0,0,3,2,16
Bangladesh,2006-09-01,0,0,0,0,0,0
Bangladesh,2006-09-01,4,0,0,0,0,4
Bangladesh,2006-09-01,6,0,0,-2,2,6
Bangladesh,2006-09-01,8,0,2,0,2,12
Bangladesh,2006-09-01,1,0,0,0,0,1
Bangladesh,2006-09-01,4,0,0,0,0,4
Bangladesh,2006-09-01,-2,0,0,6,1,5
Bangladesh,2006-09-01,2,0,0,3,1,6
Bangladesh,2006-09-01,4,0,0,11,0,15
Bangladesh,2006-09-01,2,0,0,0,0,2
Bangladesh,2006-09-01,5,0,0,6,3,14
Bangladesh,2006-09-01,5,0,0,0,0,5
Bangladesh,2006-09-01,0,0,0,0,1,1
Bangladesh,2006-09-01,4,2,0,3,0,9
Bangladesh,2006-09-01,4,0,0,0,0,4
Bangladesh,2006-09-01,5,0,0,0,1,6
Bangladesh,2006-09-01,8,0,0,0,1,9
Bangladesh,2006-09-01,7,0,0,3,0,10
Bangladesh,2006-09-01,2,0,0,3,0,5
Bangladesh,2006-09-01,14,0,0,0,3,17
Bangladesh,2006-09-01,-1,0,-2,6,0,3
Bangladesh,2006-09-01,2,0,-4,9,0,7
Bangladesh,2006-09-01,9,0,-2,0,0,7
Cameroon,2006-09-01,0,0,0,3,0,3
Cameroon,2006-09-01,3,0,0,3,0,6
Cameroon,2006-09-01,0,0,0,0,0,0
Cameroon,2006-09-01,2,0,0,0,0,2
Cameroon,2006-09-01,5,0,0,-2,0,3
Cameroon,2006-09-01,0,0,0,0,0,0
Cameroon,2006-09-01,4,0,0,6,0,10
Cameroon,2006-09-01,0,0,0,3,0,3
Cameroon,2006-09-01,4,0,0,3,0,7
Cameroon,2006-09-01,2,0,0,0,2,4
Cameroon,2006-09-01,2,0,0,3,0,5
Cameroon,2006-09-01,0,0,0,0,0,0
Cameroon,2006-09-01,0,0,0,-6,0,-6
Cameroon,2006-09-01,0,0,0,0,0,0
Cameroon,2006-09-01,0,0,0,0,0,0
Cameroon,2006-09-01,15,0,0,0,0,15
Cameroon,2006-09-01,3,0,0,3,0,6
Cameroon,2006-09-01,1,0,0,0,0,1
Cameroon,2006-09-01,0,0,0,0,0,0
Cameroon,2006-09-01,0,0,0,0,0,0
Cameroon,2006-09-01,5,0,0,0,2,7
Cameroon,2006-09-01,0,0,0,0,0,0
Cameroon,2006-09-01,0,0,0,0,0,0
China,2006-09-01,38,0,0,10,6,54
China,2006-09-01,45,0,0,14,4,63
China,2006-09-01,29,0,0,2,1,32
China,2006-09-01,45,0,-3,7,4,53
China,2006-09-01,45,0,0,9,6,60
China,2006-09-01,49,2,2,4,2,59
China,2006-09-01,53,2,0,3,2,60
China,2006-09-01,22,0,-1,0,0,21
China,2006-09-01,10,0,-3,9,0,16
China,2006-09-01,13,0,-8,4,1,10
China,2006-09-01,39,0,0,8,2,49
China,2006-09-01,38,0,-6,15,25,72
China,2006-09-01,46,2,-6,6,15,63
China,2006-09-01,9,0,-1,3,1,12
China,2006-09-01,41,0,0,14,4,59
China,2006-09-01,40,0,-2,4,0,42
China,2006-09-01,21,0,-4,-2,1,16
China,2006-09-01,35,0,0,-3,6,38
China,2006-09-01,30,0,0,11,1,42
China,2006-09-01,23,0,-1,6,3,31
China,2006-09-01,20,0,0,9,1,30
China,2006-09-01,22,0,3,20,3,48
China,2006-09-01,43,0,0,3,0,46
China,2006-09-01,9,0,2,0,0,11
China,2006-09-01,3,0,0,19,1,23
China,2006-09-01,11,0,-1,6,1,17
China,2006-09-01,12,4,0,6,1,23
China,2006-09-01,38,0,-1,6,1,44
China,2006-09-01,13,0,1,19,4,37
China,2006-09-01,-2,0,0,2,4,4
Egypt,2006-09-01,5,0,0,-8,0,-3
Egypt,2006-09-01,8,0,0,-2,1,7
Egypt,2006-09-01,31,0,0,5,0,36
Egypt,2006-09-01,7,0,0,-8,0,-1
Egypt,2006-09-01,23,0,0,-6,0,17
Egypt,2006-09-01,30,0,0,10,2,42
Egypt,2006-09-01,3,0,3,12,0,18
Egypt,2006-09-01,3,0,-3,8,0,8
Egypt,2006-09-01,2,0,0,7,2,11
Egypt,2006-09-01,8,0,0,6,0,14
Egypt,2006-09-01,6,0,0,4,0,10
Egypt,2006-09-01,8,0,0,1,0,9
Egypt,2006-09-01,8,0,0,0,0,8
Egypt,2006-09-01,3,0,0,0,0,3
Egypt,2006-09-01,23,0,0,9,0,32
Egypt,2006-09-01,36,0,0,13,0,49
Egypt,2006-09-01,13,0,0,3,0,16
Egypt,2006-09-01,17,0,0,11,2,30
Egypt,2006-09-01,14,0,0,11,1,26
Egypt,2006-09-01,16,0,0,4,3,23
Egypt,2006-09-01,20,0,0,10,0,30
Egypt,2006-09-01,42,0,1,4,14,61
Egypt,2006-09-01,10,0,1,0,0,11
Egypt,2006-09-01,11,0,0,21,0,32
Egypt,2006-09-01,9,0,1,24,0,34
Egypt,2006-09-01,11,0,1,0,1,13
Egypt,2006-09-01,22,0,0,-27,4,-1
Egypt,2006-09-01,18,0,0,13,2,33
Egypt,2006-09-01,40,0,0,20,6,66
Egypt,2006-09-01,11,0,0,0,2,13
Eritrea,2006-09-01,0,0,0,-4,0,-4
Eritrea,2006-09-01,1,0,0,0,0,1
Eritrea,2006-09-01,1,0,0,0,0,1
Eritrea,2006-09-01,0,0,0,0,0,0
Eritrea,2006-09-01,9,0,0,6,0,15
Eritrea,2006-09-01,-5,0,0,18,0,13
Eritrea,2006-09-01,0,0,0,0,0,0
Eritrea,2006-09-01,0,0,0,0,0,0
Eritrea,2006-09-01,0,0,0,0,0,0
Eritrea,2006-09-01,0,0,0,6,0,6
Eritrea,2006-09-01,2,0,0,0,0,2
Eritrea,2006-09-01,9,0,0,0,0,9
Eritrea,2006-09-01,16,0,0,0,0,16
Eritrea,2006-09-01,-1,0,0,0,0,-1
Eritrea,2006-09-01,3,0,0,0,0,3
Eritrea,2006-09-01,6,0,0,0,0,6
Eritrea,2006-09-01,3,0,0,0,0,3
Eritrea,2006-09-01,3,0,0,0,0,3
Eritrea,2006-09-01,0,0,0,3,6,9
Eritrea,2006-09-01,0,0,0,0,0,0
Eritrea,2006-09-01,2,0,1,12,0,15
Eritrea,2006-09-01,2,0,0,0,0,2
Eritrea,2006-09-01,0,0,0,0,0,0
Eritrea,2006-09-01,0,0,0,0,0,0
Eritrea,2006-09-01,0,0,0,0,0,0
Georgia,2006-09-01,0,0,0,0,0,0
Georgia,2006-09-01,0,0,0,0,0,0
Georgia,2006-09-01,0,0,0,0,0,0
Georgia,2006-09-01,0,0,1,0,0,1
Georgia,2006-09-01,3,0,0,6,3,12
Georgia,2006-09-01,3,0,0,4,0,7
Georgia,2006-09-01,0,0,0,0,0,0
Georgia,2006-09-01,0,0,0,0,0,0
Georgia,2006-09-01,0,2,0,-2,0,0
Georgia,2006-09-01,0,0,0,0,0,0
Georgia,2006-09-01,3,0,0,0,0,3
Georgia,2006-09-01,2,0,0,0,0,2
Georgia,2006-09-01,0,0,0,0,0,0
Georgia,2006-09-01,6,0,0,9,2,17
Georgia,2006-09-01,5,0,0,0,0,5
Georgia,2006-09-01,-3,0,0,6,0,3
Georgia,2006-09-01,3,0,0,6,0,9
Georgia,2006-09-01,6,0,0,0,0,6
Georgia,2006-09-01,3,0,0,0,0,3
Georgia,2006-09-01,10,0,0,0,0,10
Georgia,2006-09-01,1,0,0,0,0,1
Georgia,2006-09-01,0,0,0,0,0,0
Georgia,2006-09-01,1,0,0,0,0,1
Georgia,2006-09-01,0,0,0,0,1,1
Georgia,2006-09-01,0,0,0,-2,0,-2
Georgia,2006-09-01,0,0,0,3,8,11
Georgia,2006-09-01,8,0,2,12,0,22
Georgia,2006-09-01,-2,0,0,0,0,-2
India,2006-09-01,6,0,0,6,0,12
India,2006-09-01,13,0,0,3,4,20
India,2006-09-01,1,0,0,6,2,9
India,2006-09-01,4,0,0,0,0,4
India,2006-09-01,25,0,0,19,4,48
India,2006-09-01,2,0,0,-2,0,0
India,2006-09-01,8,0,-2,-3,0,3
India,2006-09-01,13,0,0,6,5,24
India,2006-09-01,-2,0,-1,0,1,-2
India,2006-09-01,11,0,0,0,2,13
India,2006-09-01,14,0,0,-5,2,11
India,2006-09-01,1,0,0,-2,1,0
India,2006-09-01,9,0,0,4,2,15
India,2006-09-01,3,0,0,0,6,9
India,2006-09-01,31,2,1,1,2,37
India,2006-09-01,2,0,0,6,2,10
India,2006-09-01,7,0,0,3,1,11
India,2006-09-01,36,0,0,-2,0,34
India,2006-09-01,25,0,0,6,8,39
India,2006-09-01,37,0,0,0,3,40
India,2006-09-01,21,0,0,0,0,21
India,2006-09-01,9,0,0,0,2,11
India,2006-09-01,18,0,0,4,3,25
India,2006-09-01,0,0,0,0,0,0
India,2006-09-01,56,0,-2,0,3,57
India,2006-09-01,29,0,0,3,0,32
India,2006-09-01,14,0,0,5,2,21
India,2006-09-01,3,0,-6,6,0,3
India,2006-09-01,6,0,0,0,3,9
India,2006-09-01,0,0,-4,3,0,-1
Iran,2006-09-01,37,0,6,32,4,79
Iran,2006-09-01,27,0,0,3,2,32
Iran,2006-09-01,32,2,0,-2,0,32
Iran,2006-09-01,25,0,0,6,3,34
Iran,2006-09-01,42,6,2,17,16,83
Iran,2006-09-01,80,0,0,9,0,89
Iran,2006-09-01,38,0,0,2,5,45
Iran,2006-09-01,42,0,0,6,4,52
Iran,2006-09-01,76,0,0,19,7,102
Iran,2006-09-01,30,0,0,3,5,38
Iran,2006-09-01,67,0,1,5,10,83
Iran,2006-09-01,26,0,0,20,2,48
Iran,2006-09-01,28,0,-9,30,10,59
Iran,2006-09-01,10,0,0,9,0,19
Iran,2006-09-01,109,0,0,26,3,138
Iran,2006-09-01,48,0,0,1,0,49
Iran,2006-09-01,27,0,0,1,5,33
Iran,2006-09-01,80,0,1,16,11,108
Iran,2006-09-01,120,0,-5,16,23,154
Iran,2006-09-01,58,0,-2,19,4,79
Iran,2006-09-01,49,0,1,38,18,106
Iran,2006-09-01,49,2,1,6,5,63
Iran,2006-09-01,22,0,1,13,5,41
Iran,2006-09-01,7,0,2,0,0,9
Iran,2006-09-01,16,0,0,35,1,52
Iran,2006-09-01,26,0,0,8,2,36
Iran,2006-09-01,35,0,0,4,0,39
Iran,2006-09-01,29,0,0,22,7,58
Iran,2006-09-01,4,0,0,3,5,12
Iran,2006-09-01,15,0,0,0,1,16
Iraq,2006-09-01,60,0,1,-3,7,65
Iraq,2006-09-01,48,0,1,27,0,76
Iraq,2006-09-01,81,0,-2,27,6,112
Iraq,2006-09-01,116,0,0,19,21,156
Iraq,2006-09-01,120,0,-6,32,25,171
Iraq,2006-09-01,111,0,-13,5,14,117
Iraq,2006-09-01,133,0,-6,70,17,214
Iraq,2006-09-01,72,0,-3,11,8,88
Iraq,2006-09-01,54,0,0,0,7,61
Iraq,2006-09-01,73,0,-10,11,14,88
Iraq,2006-09-01,119,0,0,24,28,171
Iraq,2006-09-01,122,0,0,30,29,181
Iraq,2006-09-01,142,2,-14,31,14,175
Iraq,2006-09-01,41,0,0,5,0,46
Iraq,2006-09-01,65,0,-1,9,3,76
Iraq,2006-09-01,85,0,3,15,5,108
Iraq,2006-09-01,71,2,0,3,4,80
Iraq,2006-09-01,85,0,0,57,34,176
Iraq,2006-09-01,108,0,0,49,32,189
Iraq,2006-09-01,86,0,-1,53,14,152
Iraq,2006-09-01,97,2,0,58,18,175
Iraq,2006-09-01,71,2,4,42,6,125
Iraq,2006-09-01,100,0,2,16,11,129
Iraq,2006-09-01,118,0,0,10,1,129
Iraq,2006-09-01,95,0,1,22,11,129
Iraq,2006-09-01,186,0,3,46,7,242
Iraq,2006-09-01,103,0,0,21,4,128
Iraq,2006-09-01,130,0,-1,63,14,206
Iraq,2006-09-01,78,0,-1,2,16,95
Iraq,2006-09-01,88,0,0,33,14,135
Morocco,2006-09-01,3,0,0,9,0,12
Morocco,2006-09-01,0,0,0,0,0,0
Morocco,2006-09-01,2,0,0,3,0,5
Morocco,2006-09-01,2,0,0,3,1,6
Morocco,2006-09-01,0,6,0,0,0,6
Morocco,2006-09-01,0,0,0,6,0,6
Morocco,2006-09-01,3,0,0,18,0,21
Morocco,2006-09-01,0,0,0,0,0,0
Morocco,2006-09-01,3,0,0,0,0,3
Morocco,2006-09-01,3,0,0,0,0,3
Morocco,2006-09-01,0,0,0,0,1,1
Morocco,2006-09-01,1,0,0,6,0,7
Morocco,2006-09-01,10,0,0,0,0,10
Morocco,2006-09-01,14,0,0,0,1,15
Morocco,2006-09-01,11,0,0,0,4,15
Morocco,2006-09-01,7,0,0,0,0,7
Morocco,2006-09-01,4,0,0,11,0,15
Morocco,2006-09-01,0,0,0,3,0,3
Morocco,2006-09-01,0,0,0,9,0,9
Morocco,2006-09-01,0,0,0,0,0,0
Morocco,2006-09-01,0,0,0,0,0,0
Morocco,2006-09-01,0,0,0,0,0,0
Morocco,2006-09-01,3,0,0,-2,0,1
Morocco,2006-09-01,8,0,0,-2,0,6
Morocco,2006-09-01,3,0,0,0,0,3
Morocco,2006-09-01,2,0,0,-8,1,-5
Morocco,2006-09-01,9,0,0,0,0,9
Morocco,2006-09-01,7,0,0,0,2,9
Nigeria,2006-09-01,2,0,-1,3,3,7
Nigeria,2006-09-01,1,0,0,9,0,10
Nigeria,2006-09-01,10,2,0,0,0,12
Nigeria,2006-09-01,8,0,-2,6,0,12
Nigeria,2006-09-01,-5,2,1,-2,1,-3
Nigeria,2006-09-01,4,0,0,4,0,8
Nigeria,2006-09-01,11,0,-2,4,4,17
Nigeria,2006-09-01,26,0,2,2,0,30
Nigeria,2006-09-01,6,0,1,0,1,8
Nigeria,2006-09-01,6,0,0,6,0,12
Nigeria,2006-09-01,30,0,0,9,2,41
Nigeria,2006-09-01,19,0,0,9,2,30
Nigeria,2006-09-01,11,0,0,9,2,22
Nigeria,2006-09-01,8,0,0,4,2,14
Nigeria,2006-09-01,4,0,0,0,0,4
Nigeria,2006-09-01,2,0,0,0,1,3
Nigeria,2006-09-01,0,0,0,0,0,0
Nigeria,2006-09-01,16,0,0,3,0,19
Nigeria,2006-09-01,18,0,0,3,2,23
Nigeria,2006-09-01,25,0,-1,2,7,33
Nigeria,2006-09-01,18,0,-4,10,1,25
Nigeria,2006-09-01,1,0,5,4,1,11
Nigeria,2006-09-01,6,0,0,0,1,7
Nigeria,2006-09-01,4,0,1,3,0,8
Nigeria,2006-09-01,8,0,0,9,0,17
Nigeria,2006-09-01,15,0,1,10,0,26
Nigeria,2006-09-01,8,0,1,9,1,19
Nigeria,2006-09-01,10,0,0,21,1,32
Nigeria,2006-09-01,12,0,0,12,1,25
Nigeria,2006-09-01,4,0,0,0,0,4
Pakistan,2006-09-01,10,0,0,3,0,13
Pakistan,2006-09-01,83,0,0,4,27,114
Pakistan,2006-09-01,46,0,0,9,8,63
Pakistan,2006-09-01,30,0,0,13,4,47
Pakistan,2006-09-01,36,0,0,11,0,47
Pakistan,2006-09-01,39,0,0,18,8,65
Pakistan,2006-09-01,30,0,0,48,1,79
Pakistan,2006-09-01,29,0,0,27,0,56
Pakistan,2006-09-01,24,0,0,28,4,56
Pakistan,2006-09-01,28,0,0,10,0,38
Pakistan,2006-09-01,13,0,0,24,4,41
Pakistan,2006-09-01,28,0,0,12,7,47
Pakistan,2006-09-01,37,0,0,6,0,43
Pakistan,2006-09-01,11,0,0,15,7,33
Pakistan,2006-09-01,33,0,0,60,12,105
Pakistan,2006-09-01,49,0,0,39,3,91
Pakistan,2006-09-01,38,0,0,-2,4,40
Pakistan,2006-09-01,39,0,0,22,3,64
Pakistan,2006-09-01,54,0,0,9,3,66
Pakistan,2006-09-01,42,0,0,9,2,53
Pakistan,2006-09-01,40,0,-1,30,5,74
Pakistan,2006-09-01,141,0,0,39,4,184
Pakistan,2006-09-01,60,0,0,18,15,93
Pakistan,2006-09-01,38,0,0,-3,2,37
Pakistan,2006-09-01,56,0,0,-6,3,53
Pakistan,2006-09-01,36,0,0,13,4,53
Pakistan,2006-09-01,52,0,-2,5,1,56
Pakistan,2006-09-01,35,0,0,-1,6,40
Pakistan,2006-09-01,21,0,-1,6,7,33
Pakistan,2006-09-01,17,0,0,0,0,17
Sierra Leone,2006-09-01,0,0,0,0,0,0
Sierra Leone,2006-09-01,2,0,0,0,0,2
Sierra Leone,2006-09-01,0,0,0,0,0,0
Sierra Leone,2006-09-01,1,0,0,0,0,1
Sierra Leone,2006-09-01,2,0,0,0,0,2
Sierra Leone,2006-09-01,0,0,0,0,0,0
Sierra Leone,2006-09-01,0,0,0,0,0,0
Sierra Leone,2006-09-01,0,0,0,0,0,0
Sierra Leone,2006-09-01,2,0,0,0,0,2
Sierra Leone,2006-09-01,0,0,0,6,1,7
Sierra Leone,2006-09-01,3,0,0,6,0,9
Sierra Leone,2006-09-01,2,0,0,6,0,8
Sierra Leone,2006-09-01,0,0,0,0,0,0
Sierra Leone,2006-09-01,1,0,0,3,0,4
Sierra Leone,2006-09-01,0,0,0,0,0,0
Sierra Leone,2006-09-01,-1,0,0,0,0,-1
Sierra Leone,2006-09-01,2,0,0,1,0,3
Sierra Leone,2006-09-01,1,0,0,0,6,7
Sierra Leone,2006-09-01,1,0,0,0,6,7
Sierra Leone,2006-09-01,0,0,0,3,0,3
Sierra Leone,2006-09-01,6,0,0,0,0,6
Sierra Leone,2006-09-01,10,0,0,0,5,15
Sierra Leone,2006-09-01,10,0,0,-2,5,13
Sierra Leone,2006-09-01,2,0,0,-6,0,-4
Sierra Leone,2006-09-01,0,0,0,0,0,0
Somalia,2006-09-01,-2,0,0,0,0,-2
Somalia,2006-09-01,5,0,0,0,0,5
Somalia,2006-09-01,5,0,0,0,0,5
Somalia,2006-09-01,12,2,0,5,0,19
Somalia,2006-09-01,9,2,0,9,1,21
Somalia,2006-09-01,5,6,0,0,0,11
Somalia,2006-09-01,8,0,0,0,0,8
Somalia,2006-09-01,2,0,0,0,2,4
Somalia,2006-09-01,10,0,0,3,1,14
Somalia,2006-09-01,8,0,0,3,0,11
Somalia,2006-09-01,0,0,0,0,0,0
Somalia,2006-09-01,11,0,0,3,0,14
Somalia,2006-09-01,0,0,0,0,0,0
Somalia,2006-09-01,6,0,0,0,0,6
Somalia,2006-09-01,7,0,0,18,8,33
Somalia,2006-09-01,12,0,0,3,0,15
Somalia,2006-09-01,18,0,0,0,0,18
Somalia,2006-09-01,43,0,0,3,0,46
Somalia,2006-09-01,46,0,0,0,6,52
Somalia,2006-09-01,46,2,0,15,2,65
Somalia,2006-09-01,10,0,0,6,0,16
Somalia,2006-09-01,18,0,0,13,0,31
Somalia,2006-09-01,4,0,0,10,0,14
Somalia,2006-09-01,4,0,0,-3,0,1
Somalia,2006-09-01,13,0,0,3,0,16
Somalia,2006-09-01,5,0,2,3,0,10
Somalia,2006-09-01,6,0,0,6,0,12
Somalia,2006-09-01,3,0,0,9,0,12
Somalia,2006-09-01,3,0,0,0,1,4
Somalia,2006-09-01,20,0,0,0,0,20
Syria,2006-09-01,-3,0,0,9,0,6
Syria,2006-09-01,11,0,0,12,0,23
Syria,2006-09-01,6,0,0,3,1,10
Syria,2006-09-01,19,0,-2,-2,2,17
Syria,2006-09-01,53,0,0,0,6,59
Syria,2006-09-01,36,0,0,3,0,39
Syria,2006-09-01,6,0,0,12,0,18
Syria,2006-09-01,26,0,0,3,2,31
Syria,2006-09-01,20,0,0,0,0,20
Syria,2006-09-01,33,0,0,24,14,71
Syria,2006-09-01,12,0,0,7,6,25
Syria,2006-09-01,8,0,0,1,5,14
Syria,2006-09-01,20,0,0,0,2,22
Syria,2006-09-01,0,0,0,0,2,2
Syria,2006-09-01,31,0,1,12,3,47
Syria,2006-09-01,2,0,0,1,0,3
Syria,2006-09-01,3,4,0,4,3,14
Syria,2006-09-01,9,0,0,-1,0,8
Syria,2006-09-01,23,0,0,53,0,76
Syria,2006-09-01,7,0,0,24,3,34
Syria,2006-09-01,16,0,0,12,2,30
Syria,2006-09-01,15,0,0,0,0,15
Syria,2006-09-01,-5,0,0,6,4,5
Syria,2006-09-01,7,0,0,4,13,24
Syria,2006-09-01,22,0,1,1,7,31
Syria,2006-09-01,-2,0,1,-12,1,-12
Syria,2006-09-01,21,0,2,7,2,32
Syria,2006-09-01,12,0,0,10,0,22
Syria,2006-09-01,3,0,0,6,0,9
Syria,2006-09-01,4,0,0,6,7,17
Yemen,2006-09-01,0,0,0,0,0,0
Yemen,2006-09-01,0,0,0,0,0,0
Yemen,2006-09-01,0,0,0,0,0,0
Yemen,2006-09-01,0,0,0,0,0,0
Yemen,2006-09-01,2,0,0,3,3,8
Yemen,2006-09-01,12,0,0,12,2,26
Yemen,2006-09-01,0,0,0,12,4,16
Yemen,2006-09-01,5,0,0,9,0,14
Yemen,2006-09-01,6,0,0,9,0,15
Yemen,2006-09-01,0,0,0,6,5,11
Yemen,2006-09-01,24,0,0,18,0,42
Yemen,2006-09-01,4,0,0,0,3,7
Yemen,2006-09-01,0,0,0,15,1,16
Yemen,2006-09-01,1,0,0,0,2,3
Yemen,2006-09-01,10,0,0,6,0,16
Yemen,2006-09-01,24,0,0,9,6,39
Yemen,2006-09-01,28,0,0,6,0,34
Yemen,2006-09-01,4,0,0,0,0,4
Yemen,2006-09-01,-2,0,0,3,0,1
Yemen,2006-09-01,0,0,0,5,1,6
Yemen,2006-09-01,0,0,0,0,0,0
Yemen,2006-09-01,2,0,0,-2,0,0
Yemen,2006-09-01,0,0,0,0,2,2
Yemen,2006-09-01,10,0,0,0,3,13
Yemen,2006-09-01,1,0,0,0,0,1
Yemen,2006-09-01,0,0,-2,0,0,-2
Yemen,2006-09-01,-3,0,0,-3,0,-6
Yemen,2006-09-01,1,0,0,0,0,1
Yemen,2006-09-01,0,0,0,0,0,0
Yemen,2006-09-01,2,0,0,0,0,2
Afghanistan,2008-12-01,210,0,-2,66,23,297
Afghanistan,2008-12-01,50,0,-16,-1,7,40
Afghanistan,2008-12-01,133,0,0,20,5,158
Afghanistan,2008-12-01,162,0,-16,16,11,173
Afghanistan,2008-12-01,217,0,0,27,35,279
Afghanistan,2008-12-01,175,2,0,18,0,195
Afghanistan,2008-12-01,197,4,-1,35,11,246
Afghanistan,2008-12-01,340,0,2,45,16,403
Afghanistan,2008-12-01,86,2,0,23,16,127
Afghanistan,2008-12-01,73,2,1,15,7,98
Afghanistan,2008-12-01,251,0,1,51,14,317
Afghanistan,2008-12-01,239,2,3,40,33,317
Afghanistan,2008-12-01,215,0,-4,5,17,233
Afghanistan,2008-12-01,115,4,0,21,18,158
Afghanistan,2008-12-01,148,0,0,37,19,204
Afghanistan,2008-12-01,316,2,5,56,13,392
Afghanistan,2008-12-01,150,0,3,21,8,182
Afghanistan,2008-12-01,170,0,2,22,12,206
Afghanistan,2008-12-01,150,0,0,17,9,176
Afghanistan,2008-12-01,107,0,1,17,7,132
Afghanistan,2008-12-01,111,0,-2,22,1,132
Afghanistan,2008-12-01,154,0,-1,61,3,217
Afghanistan,2008-12-01,152,0,1,38,14,205
Afghanistan,2008-12-01,115,0,0,28,16,159
Afghanistan,2008-12-01,107,0,0,9,11,127
Afghanistan,2008-12-01,140,0,0,29,3,172
Afghanistan,2008-12-01,154,0,1,14,16,185
Afghanistan,2008-12-01,112,2,0,19,29,162
Afghanistan,2008-12-01,220,0,1,13,5,239
Afghanistan,2008-12-01,214,2,1,37,14,268
Afghanistan,2008-12-01,171,8,0,21,10,210
Albania,2008-12-01,4,0,0,0,0,4
Albania,2008-12-01,5,0,0,6,4,15
Albania,2008-12-01,3,0,0,-6,2,-1
Albania,2008-12-01,5,0,0,0,0,5
Albania,2008-12-01,3,0,0,0,0,3
Albania,2008-12-01,2,0,0,0,0,2
Albania,2008-12-01,0,0,0,0,0,0
Albania,2008-12-01,11,0,0,3,3,17
Albania,2008-12-01,2,0,-1,0,3,4
Albania,2008-12-01,9,0,0,-1,0,8
Albania,2008-12-01,0,0,0,4,0,4
Albania,2008-12-01,6,0,0,0,0,6
Albania,2008-12-01,0,0,0,3,0,3
Albania,2008-12-01,0,0,0,9,0,9
Albania,2008-12-01,3,0,1,6,0,10
Albania,2008-12-01,0,0,0,9,0,9
Albania,2008-12-01,-14,0,0,9,0,-5
Albania,2008-12-01,-9,0,0,0,1,-8
Albania,2008-12-01,0,0,0,0,0,0
Albania,2008-12-01,1,0,0,6,0,7
Albania,2008-12-01,14,0,0,15,4,33
Albania,2008-12-01,23,0,1,12,1,37
Albania,2008-12-01,6,0,0,1,1,8
Albania,2008-12-01,7,0,0,0,0,7
Albania,2008-12-01,33,0,0,28,6,67
Albania,2008-12-01,8,0,0,16,0,24
Albania,2008-12-01,21,0,0,7,13,41
Albania,2008-12-01,12,0,0,5,10,27
Albania,2008-12-01,45,0,0,23,11,79
Albania,2008-12-01,8,0,0,-3,8,13
Algeria,2008-12-01,9,0,0,-2,0,7
Algeria,2008-12-01,2,0,0,0,0,2
Algeria,2008-12-01,11,0,0,18,0,29
Algeria,2008-12-01,6,0,0,5,0,11
Algeria,2008-12-01,2,0,0,6,0,8
Algeria,2008-12-01,0,0,0,3,0,3
Algeria,2008-12-01,1,0,0,0,0,1
Algeria,2008-12-01,7,0,0,0,0,7
Algeria,2008-12-01,4,0,1,3,0,8
Algeria,2008-12-01,1,4,0,0,0,5
Algeria,2008-12-01,10,0,0,13,0,23
Algeria,2008-12-01,11,0,0,3,1,15
Algeria,2008-12-01,1,0,0,0,0,1
Algeria,2008-12-01,0,0,0,0,0,0
Algeria,2008-12-01,3,0,0,0,0,3
Algeria,2008-12-01,20,0,0,3,0,23
Algeria,2008-12-01,16,0,0,-7,1,10
Algeria,2008-12-01,22,2,0,1,0,25
Algeria,2008-12-01,21,0,0,-2,0,19
Algeria,2008-12-01,16,0,0,6,4,26
Algeria,2008-12-01,6,0,0,-4,4,6
Algeria,2008-12-01,-5,0,0,0,2,-3
Algeria,2008-12-01,-1,0,0,0,0,-1
Algeria,2008-12-01,1,0,0,0,0,1
Algeria,2008-12-01,2,0,0,0,0,2
Algeria,2008-12-01,0,0,0,6,0,6
Algeria,2008-12-01,4,0,0,0,0,4
Algeria,2008-12-01,10,0,0,10,0,20
Algeria,2008-12-01,0,0,0,0,0,0
Algeria,2008-12-01,4,0,0,3,6,13
Algeria,2008-12-01,9,0,0,4,0,13
Bangladesh,2008-12-01,18,0,0,14,1,33
Bangladesh,2008-12-01,3,0,0,20,5,28
Bangladesh,2008-12-01,8,0,0,6,2,16
Bangladesh,2008-12-01,20,0,0,18,0,38
Bangladesh,2008-12-01,40,0,1,19,1,61
Bangladesh,2008-12-01,15,0,-2,-1,0,12
Bangladesh,2008-12-01,6,0,0,0,0,6
Bangladesh,2008-12-01,18,0,0,4,0,22
Bangladesh,2008-12-01,0,0,0,0,1,1
Bangladesh,2008-12-01,-1,0,1,0,0,0
Bangladesh,2008-12-01,5,0,1,0,0,6
Bangladesh,2008-12-01,7,0,1,3,0,11
Bangladesh,2008-12-01,0,0,0,0,0,0
Bangladesh,2008-12-01,0,0,0,6,0,6
Bangladesh,2008-12-01,4,0,0,2,0,6
Bangladesh,2008-12-01,7,0,0,1,2,10
Bangladesh,2008-12-01,-1,0,0,2,1,2
Bangladesh,2008-12-01,6,0,0,5,0,11
Bangladesh,2008-12-01,10,0,3,4,1,18
Bangladesh,2008-12-01,24,0,0,8,6,38
Bangladesh,2008-12-01,12,0,0,0,0,12
Bangladesh,2008-12-01,4,0,-4,0,1,1
Bangladesh,2008-12-01,7,0,-1,17,0,23
Bangladesh,2008-12-01,12,0,0,6,7,25
Bangladesh,2008-12-01,1,0,-2,19,1,19
Bangladesh,2008-12-01,9,0,0,3,1,13
Bangladesh,2008-12-01,18,0,1,7,5,31
Bangladesh,2008-12-01,21,0,-4,22,6,45
Bangladesh,2008-12-01,57,0,-2,28,12,95
Bangladesh,2008-12-01,28,0,-2,-3,6,29
Bangladesh,2008-12-01,38,2,-4,2,2,40
Cameroon,2008-12-01,13,0,0,0,0,13
Cameroon,2008-12-01,0,0,0,3,0,3
Cameroon,2008-12-01,1,0,0,3,0,4
Cameroon,2008-12-01,0,0,0,6,0,6
Cameroon,2008-12-01,0,0,0,3,0,3
Cameroon,2008-12-01,0,0,0,3,0,3
Cameroon,2008-12-01,3,0,0,3,0,6
Cameroon,2008-12-01,3,0,0,0,0,3
Cameroon,2008-12-01,3,0,0,0,0,3
Cameroon,2008-12-01,0,0,0,3,0,3
Cameroon,2008-12-01,0,0,0,0,0,0
Cameroon,2008-12-01,0,0,0,0,0,0
Cameroon,2008-12-01,0,0,0,0,0,0
Cameroon,2008-12-01,0,0,0,1,0,1
Cameroon,2008-12-01,5,0,0,24,0,29
Cameroon,2008-12-01,16,0,0,6,0,22
Cameroon,2008-12-01,0,0,0,0,0,0
Cameroon,2008-12-01,0,0,0,0,0,0
Cameroon,2008-12-01,2,0,0,0,0,2
Cameroon,2008-12-01,0,0,0,6,1,7
Cameroon,2008-12-01,0,0,0,9,0,9
Cameroon,2008-12-01,2,0,0,0,0,2
China,2008-12-01,52,0,-2,10,13,73
China,2008-12-01,46,0,0,7,2,55
China,2008-12-01,63,0,1,46,6,116
China,2008-12-01,74,2,2,37,6,121
China,2008-12-01,34,0,1,21,3,59
China,2008-12-01,52,0,2,19,7,80
China,2008-12-01,68,0,0,29,15,112
China,2008-12-01,120,0,-3,21,22,160
China,2008-12-01,128,2,5,55,9,199
China,2008-12-01,129,0,1,38,17,185
China,2008-12-01,85,2,-1,43,5,134
China,2008-12-01,89,2,-3,67,11,166
China,2008-12-01,47,0,-11,50,3,89
China,2008-12-01,88,2,0,11,11,112
China,2008-12-01,61,0,0,15,7,83
China,2008-12-01,48,2,-1,74,9,132
China,2008-12-01,112,0,-2,72,17,199
China,2008-12-01,122,0,-2,56,10,186
China,2008-12-01,50,4,1,19,14,88
China,2008-12-01,59,2,1,19,5,86
China,2008-12-01,44,0,0,12,2,58
China,2008-12-01,90,2,1,36,8,137
China,2008-12-01,115,0,1,67,11,194
China,2008-12-01,99,0,0,85,18,202
China,2008-12-01,109,0,-4,64,1,170
China,2008-12-01,70,0,0,36,7,113
China,2008-12-01,40,0,-2,-6,5,37
China,2008-12-01,118,0,0,6,8,132
China,2008-12-01,169,4,-2,3,10,184
China,2008-12-01,74,10,0,38,19,141
China,2008-12-01,134,6,-3,117,6,260
Egypt,2008-12-01,12,0,0,5,1,18
Egypt,2008-12-01,6,0,0,21,0,27
Egypt,2008-12-01,12,0,2,40,2,56
Egypt,2008-12-01,21,4,0,26,4,55
Egypt,2008-12-01,12,4,0,3,0,19
Egypt,2008-12-01,41,0,-1,9,4,53
Egypt,2008-12-01,23,0,0,0,0,23
Egypt,2008-12-01,20,0,0,-5,3,18
Egypt,2008-12-01,11,0,0,-2,0,9
Egypt,2008-12-01,38,0,0,27,6,71
Egypt,2008-12-01,21,4,0,4,1,30
Egypt,2008-12-01,36,4,0,0,2,42
Egypt,2008-12-01,52,4,0,15,0,71
Egypt,2008-12-01,46,0,0,-7,2,41
Egypt,2008-12-01,22,0,0,-4,0,18
Egypt,2008-12-01,25,0,-4,1,4,26
Egypt,2008-12-01,16,0,0,-1,0,15
Egypt,2008-12-01,44,2,0,18,0,64
Egypt,2008-12-01,36,0,1,10,4,51
Egypt,2008-12-01,130,0,0,8,1,139
Egypt,2008-12-01,43,0,0,21,2,66
Egypt,2008-12-01,154,0,0,-1,13,166
Egypt,2008-12-01,64,0,1,18,4,87
Egypt,2008-12-01,43,0,0,7,3,53
Egypt,2008-12-01,54,0,0,12,0,66
Egypt,2008-12-01,29,0,0,9,2,40
Egypt,2008-12-01,56,0,0,8,6,70
Egypt,2008-12-01,488,0,13,86,40,627
Egypt,2008-12-01,467,0,8,31,70,576
Egypt,2008-12-01,268,4,4,49,56,381
Egypt,2008-12-01,217,4,-1,30,23,273
Eritrea,2008-12-01,4,0,0,0,0,4
Eritrea,2008-12-01,6,0,0,0,2,8
Eritrea,2008-12-01,3,0,0,9,0,12
Eritrea,2008-12-01,-3,0,0,15,1,13
Eritrea,2008-12-01,0,0,0,9,0,9
Eritrea,2008-12-01,2,0,0,12,0,14
Eritrea,2008-12-01,0,0,0,3,0,3
Eritrea,2008-12-01,0,0,0,0,0,0
Eritrea,2008-12-01,2,0,0,0,0,2
Eritrea,2008-12-01,1,0,0,0,0,1
Eritrea,2008-12-01,8,0,0,6,0,14
Eritrea,2008-12-01,-2,0,0,0,0,-2
Eritrea,2008-12-01,5,0,0,0,0,5
Eritrea,2008-12-01,1,0,0,0,1,2
Eritrea,2008-12-01,0,0,0,0,0,0
Eritrea,2008-12-01,0,0,0,0,0,0
Eritrea,2008-12-01,8,0,0,4,0,12
Eritrea,2008-12-01,8,0,0,-2,0,6
Eritrea,2008-12-01,3,0,0,5,0,8
Eritrea,2008-12-01,2,0,0,0,0,2
Eritrea,2008-12-01,3,0,0,0,0,3
Eritrea,2008-12-01,12,0,0,0,0,12
Eritrea,2008-12-01,6,0,0,3,0,9
Eritrea,2008-12-01,5,0,0,2,0,7
Eritrea,2008-12-01,6,0,0,0,0,6
Eritrea,2008-12-01,-1,0,0,0,0,-1
Georgia,2008-12-01,10,0,0,-2,0,8
Georgia,2008-12-01,23,0,0,0,2,25
Georgia,2008-12-01,20,0,0,0,1,21
Georgia,2008-12-01,14,0,0,0,4,18
Georgia,2008-12-01,3,0,-4,0,4,3
Georgia,2008-12-01,13,0,0,12,0,25
Georgia,2008-12-01,2,0,0,0,0,2
Georgia,2008-12-01,7,0,-4,-4,0,-1
Georgia,2008-12-01,2,0,0,10,0,12
Georgia,2008-12-01,8,2,-2,9,0,17
Georgia,2008-12-01,15,0,0,3,1,19
Georgia,2008-12-01,2,0,0,15,5,22
Georgia,2008-12-01,3,0,0,0,0,3
Georgia,2008-12-01,5,0,0,1,1,7
Georgia,2008-12-01,6,0,0,9,1,16
Georgia,2008-12-01,13,0,0,6,1,20
Georgia,2008-12-01,0,0,0,6,0,6
Georgia,2008-12-01,12,0,0,21,0,33
Georgia,2008-12-01,12,0,0,6,0,18
Georgia,2008-12-01,2,0,0,3,0,5
Georgia,2008-12-01,0,0,0,0,0,0
Georgia,2008-12-01,0,0,0,3,0,3
Georgia,2008-12-01,7,0,0,1,0,8
Georgia,2008-12-01,6,0,0,3,0,9
Georgia,2008-12-01,0,0,0,6,0,6
Georgia,2008-12-01,2,0,0,3,0,5
Georgia,2008-12-01,0,0,0,0,0,0
Georgia,2008-12-01,4,0,0,-2,0,2
Georgia,2008-12-01,3,0,0,-6,2,-1
Georgia,2008-12-01,-1,0,-2,-4,1,-6
Georgia,2008-12-01,29,0,0,-2,0,27
India,2008-12-01,20,4,-2,-6,4,20
India,2008-12-01,12,0,0,2,2,16
India,2008-12-01,36,0,-2,-1,6,39
India,2008-12-01,17,0,-3,11,0,25
India,2008-12-01,9,2,0,-4,0,7
India,2008-12-01,21,0,-4,-1,4,20
India,2008-12-01,26,0,-1,5,6,36
India,2008-12-01,13,2,1,2,5,23
India,2008-12-01,23,0,0,1,5,29
India,2008-12-01,13,0,0,3,0,16
India,2008-12-01,15,0,1,16,-2,30
India,2008-12-01,11,0,0,11,3,25
India,2008-12-01,14,0,0,14,0,28
India,2008-12-01,16,0,0,3,1,20
India,2008-12-01,28,2,0,2,0,32
India,2008-12-01,26,0,-2,13,0,37
India,2008-12-01,13,0,0,7,1,21
India,2008-12-01,29,0,0,5,4,38
India,2008-12-01,23,8,-2,3,0,32
India,2008-12-01,21,0,0,4,3,28
India,2008-12-01,17,0,0,12,2,31
India,2008-12-01,14,0,1,1,0,16
India,2008-12-01,33,0,1,24,1,59
India,2008-12-01,23,0,0,25,3,51
India,2008-12-01,29,0,-1,19,2,49
India,2008-12-01,24,0,0,4,4,32
India,2008-12-01,21,0,0,-3,2,20
India,2008-12-01,42,0,-4,13,7,58
India,2008-12-01,71,0,-2,2,13,84
India,2008-12-01,69,4,-1,6,3,81
India,2008-12-01,48,0,-2,27,1,74
Iran,2008-12-01,51,0,0,12,2,65
Iran,2008-12-01,11,0,0,15,0,26
Iran,2008-12-01,31,0,0,-1,1,31
Iran,2008-12-01,51,2,0,44,5,102
Iran,2008-12-01,21,2,0,3,2,28
Iran,2008-12-01,46,0,0,9,0,55
Iran,2008-12-01,32,0,2,32,26,92
Iran,2008-12-01,73,0,0,21,8,102
Iran,2008-12-01,30,0,0,10,0,40
Iran,2008-12-01,6,2,1,34,0,43
Iran,2008-12-01,17,0,0,21,2,40
Iran,2008-12-01,19,0,-2,1,0,18
Iran,2008-12-01,10,0,-6,7,4,15
Iran,2008-12-01,33,0,0,6,8,47
Iran,2008-12-01,25,0,0,-1,6,30
Iran,2008-12-01,47,0,0,26,6,79
Iran,2008-12-01,48,0,0,15,2,65
Iran,2008-12-01,23,0,0,52,0,75
Iran,2008-12-01,24,0,-2,19,8,49
Iran,2008-12-01,23,2,1,26,2,54
Iran,2008-12-01,15,0,0,4,4,23
Iran,2008-12-01,17,0,0,11,2,30
Iran,2008-12-01,7,0,1,12,2,22
Iran,2008-12-01,13,8,0,50,1,72
Iran,2008-12-01,15,6,0,12,2,35
Iran,2008-12-01,41,0,0,15,6,62
Iran,2008-12-01,92,0,-4,3,2,93
Iran,2008-12-01,122,0,2,22,14,160
Iran,2008-12-01,129,0,0,17,16,162
Iran,2008-12-01,149,0,-2,23,14,184
Iran,2008-12-01,116,0,0,1,18,135
Iraq,2008-12-01,82,0,1,7,24,114
Iraq,2008-12-01,79,0,-2,34,7,118
Iraq,2008-12-01,55,0,0,48,8,111
Iraq,2008-12-01,93,0,2,49,17,161
Iraq,2008-12-01,70,0,1,32,17,120
Iraq,2008-12-01,45,2,1,22,9,79
Iraq,2008-12-01,40,0,5,9,4,58
Iraq,2008-12-01,121,0,4,6,13,144
Iraq,2008-12-01,66,0,0,23,5,94
Iraq,2008-12-01,63,0,4,47,11,125
Iraq,2008-12-01,114,8,-2,46,17,183
Iraq,2008-12-01,100,6,-1,2,4,111
Iraq,2008-12-01,49,0,0,15,1,65
Iraq,2008-12-01,62,0,2,30,15,109
Iraq,2008-12-01,136,0,-6,67,39,236
Iraq,2008-12-01,216,0,0,45,22,283
Iraq,2008-12-01,205,0,-1,76,40,320
Iraq,2008-12-01,90,0,0,136,25,251
Iraq,2008-12-01,113,4,0,36,14,167
Iraq,2008-12-01,72,0,0,18,25,115
Iraq,2008-12-01,88,0,-1,8,19,114
Iraq,2008-12-01,121,4,-2,77,15,215
Iraq,2008-12-01,56,2,-7,32,10,93
Iraq,2008-12-01,48,2,-2,6,15,69
Iraq,2008-12-01,62,0,-1,-6,9,64
Iraq,2008-12-01,58,0,0,16,3,77
Iraq,2008-12-01,76,0,0,26,3,105
Iraq,2008-12-01,103,2,0,59,58,222
Iraq,2008-12-01,123,2,-1,55,39,218
Iraq,2008-12-01,132,2,2,73,36,245
Iraq,2008-12-01,155,0,1,33,23,212
Morocco,2008-12-01,18,0,0,0,0,18
Morocco,2008-12-01,9,0,0,3,1,13
Morocco,2008-12-01,14,0,0,12,0,26
Morocco,2008-12-01,10,0,0,21,6,37
Morocco,2008-12-01,1,0,0,10,0,11
Morocco,2008-12-01,0,0,0,0,0,0
Morocco,2008-12-01,4,0,0,0,0,4
Morocco,2008-12-01,3,0,0,3,0,6
Morocco,2008-12-01,3,0,0,19,2,24
Morocco,2008-12-01,0,0,0,6,0,6
Morocco,2008-12-01,14,0,0,12,0,26
Morocco,2008-12-01,12,0,0,0,3,15
Morocco,2008-12-01,0,0,0,0,0,0
Morocco,2008-12-01,1,0,0,0,0,1
Morocco,2008-12-01,4,0,0,0,0,4
Morocco,2008-12-01,5,0,0,0,0,5
Morocco,2008-12-01,0,0,0,0,1,1
Morocco,2008-12-01,0,0,0,9,0,9
Morocco,2008-12-01,8,0,0,15,0,23
Morocco,2008-12-01,0,0,0,0,0,0
Morocco,2008-12-01,0,0,0,0,0,0
Morocco,2008-12-01,-6,0,0,0,0,-6
Morocco,2008-12-01,0,0,0,9,0,9
Morocco,2008-12-01,0,0,0,3,0,3
Morocco,2008-12-01,-2,0,0,0,0,-2
Morocco,2008-12-01,0,0,0,0,0,0
Morocco,2008-12-01,1,0,0,0,0,1
Morocco,2008-12-01,0,0,0,0,2,2
Morocco,2008-12-01,9,0,0,7,0,16
Morocco,2008-12-01,3,0,0,3,0,6
Morocco,2008-12-01,1,0,0,0,2,3
Nigeria,2008-12-01,21,0,0,3,0,24
Nigeria,2008-12-01,11,0,0,2,0,13
Nigeria,2008-12-01,1,0,0,4,0,5
Nigeria,2008-12-01,15,0,0,1,3,19
Nigeria,2008-12-01,12,0,0,0,0,12
Nigeria,2008-12-01,10,0,0,9,0,19
Nigeria,2008-12-01,7,0,0,8,0,15
Nigeria,2008-12-01,14,0,-2,2,2,16
Nigeria,2008-12-01,14,4,0,9,5,32
Nigeria,2008-12-01,15,2,0,13,5,35
Nigeria,2008-12-01,12,0,3,6,2,23
Nigeria,2008-12-01,11,2,-3,0,0,10
Nigeria,2008-12-01,0,0,0,0,0,0
Nigeria,2008-12-01,-4,0,0,15,0,11
Nigeria,2008-12-01,6,0,0,-7,0,-1
Nigeria,2008-12-01,11,0,0,9,0,20
Nigeria,2008-12-01,14,0,0,0,0,14
Nigeria,2008-12-01,6,0,0,0,0,6
Nigeria,2008-12-01,4,0,0,0,0,4
Nigeria,2008-12-01,18,2,0,3,0,23
Nigeria,2008-12-01,15,0,0,3,1,19
Nigeria,2008-12-01,13,0,0,3,2,18
Nigeria,2008-12-01,-1,0,0,3,0,2
Nigeria,2008-12-01,3,0,0,6,0,9
Nigeria,2008-12-01,0,0,0,21,0,21
Nigeria,2008-12-01,11,0,0,9,0,20
Nigeria,2008-12-01,6,0,0,3,0,9
Nigeria,2008-12-01,14,0,0,6,0,20
Nigeria,2008-12-01,14,0,-2,3,1,16
Nigeria,2008-12-01,16,0,0,-4,2,14
Nigeria,2008-12-01,14,0,1,6,2,23
Pakistan,2008-12-01,143,0,1,55,27,226
Pakistan,2008-12-01,88,0,-1,48,5,140
Pakistan,2008-12-01,177,0,-5,70,13,255
Pakistan,2008-12-01,97,0,0,53,8,158
Pakistan,2008-12-01,96,0,-2,60,9,163
Pakistan,2008-12-01,101,0,-4,52,9,158
Pakistan,2008-12-01,91,0,1,28,10,130
Pakistan,2008-12-01,121,0,1,51,6,179
Pakistan,2008-12-01,96,4,3,35,5,143
Pakistan,2008-12-01,117,0,2,165,11,295
Pakistan,2008-12-01,69,0,-4,83,1,149
Pakistan,2008-12-01,43,6,1,51,9,110
Pakistan,2008-12-01,61,12,0,17,5,95
Pakistan,2008-12-01,89,2,3,36,3,133
Pakistan,2008-12-01,71,4,1,24,12,112
Pakistan,2008-12-01,75,2,-2,33,4,112
Pakistan,2008-12-01,47,0,0,49,14,110
Pakistan,2008-12-01,76,0,0,123,4,203
Pakistan,2008-12-01,85,4,-8,59,13,153
Pakistan,2008-12-01,45,0,-6,2,12,53
Pakistan,2008-12-01,35,0,-4,28,1,60
Pakistan,2008-12-01,127,6,-2,7,4,142
Pakistan,2008-12-01,126,0,-2,40,16,180
Pakistan,2008-12-01,77,0,0,30,3,110
Pakistan,2008-12-01,16,2,1,6,0,25
Pakistan,2008-12-01,107,0,3,11,5,126
Pakistan,2008-12-01,67,0,0,11,5,83
Pakistan,2008-12-01,99,4,0,34,6,143
Pakistan,2008-12-01,205,0,0,42,25,272
Pakistan,2008-12-01,143,0,2,17,13,175
Pakistan,2008-12-01,166,2,0,48,6,222
Sierra Leone,2008-12-01,0,0,0,0,0,0
Sierra Leone,2008-12-01,4,0,0,3,0,7
Sierra Leone,2008-12-01,0,0,0,0,1,1
Sierra Leone,2008-12-01,-3,0,0,3,0,0
Sierra Leone,2008-12-01,0,0,0,0,0,0
Sierra Leone,2008-12-01,2,0,0,3,0,5
Sierra Leone,2008-12-01,3,0,0,3,1,7
Sierra Leone,2008-12-01,0,0,0,0,0,0
Sierra Leone,2008-12-01,2,0,0,1,0,3
Sierra Leone,2008-12-01,1,0,0,0,0,1
Sierra Leone,2008-12-01,0,0,0,6,0,6
Sierra Leone,2008-12-01,0,0,0,0,0,0
Sierra Leone,2008-12-01,0,0,0,0,0,0
Sierra Leone,2008-12-01,0,0,0,0,0,0
Sierra Leone,2008-12-01,-2,0,0,0,0,-2
Sierra Leone,2008-12-01,0,0,0,0,0,0
Sierra Leone,2008-12-01,0,0,0,-2,0,-2
Sierra Leone,2008-12-01,0,0,0,0,0,0
Sierra Leone,2008-12-01,0,0,0,0,0,0
Sierra Leone,2008-12-01,2,0,0,-2,0,0
Sierra Leone,2008-12-01,1,0,0,1,0,2
Sierra Leone,2008-12-01,4,0,0,9,1,14
Sierra Leone,2008-12-01,0,0,0,0,1,1
Sierra Leone,2008-12-01,0,0,0,0,0,0
Sierra Leone,2008-12-01,0,0,0,0,0,0
Sierra Leone,2008-12-01,7,0,0,6,0,13
Sierra Leone,2008-12-01,0,0,1,3,0,4
Sierra Leone,2008-12-01,1,0,-1,1,0,1
Sierra Leone,2008-12-01,0,0,0,0,0,0
Somalia,2008-12-01,36,2,-1,-16,2,23
Somalia,2008-12-01,56,2,0,13,0,71
Somalia,2008-12-01,55,0,0,-11,4,48
Somalia,2008-12-01,108,0,0,19,2,129
Somalia,2008-12-01,57,2,-2,20,6,83
Somalia,2008-12-01,37,0,0,16,3,56
Somalia,2008-12-01,21,0,0,36,8,65
Somalia,2008-12-01,45,0,0,20,8,73
Somalia,2008-12-01,54,0,0,12,50,116
Somalia,2008-12-01,36,0,0,-30,12,18
Somalia,2008-12-01,55,0,2,8,5,70
Somalia,2008-12-01,82,0,0,9,9,100
Somalia,2008-12-01,104,0,0,28,13,145
Somalia,2008-12-01,53,0,0,1,0,54
Somalia,2008-12-01,17,0,0,18,4,39
Somalia,2008-12-01,117,0,1,39,10,167
Somalia,2008-12-01,168,0,-4,27,26,217
Somalia,2008-12-01,189,0,0,61,19,269
Somalia,2008-12-01,49,0,-2,24,0,71
Somalia,2008-12-01,48,2,0,19,1,70
Somalia,2008-12-01,61,0,-1,7,8,75
Somalia,2008-12-01,19,0,-2,6,1,24
Somalia,2008-12-01,54,0,-1,25,10,88
Somalia,2008-12-01,47,0,-12,8,4,47
Somalia,2008-12-01,68,0,-4,15,12,91
Somalia,2008-12-01,29,0,-8,24,6,51
Somalia,2008-12-01,17,0,-2,-4,2,13
Somalia,2008-12-01,58,0,-10,10,3,61
Somalia,2008-12-01,88,0,-23,47,12,124
Somalia,2008-12-01,73,0,-13,24,11,95
Somalia,2008-12-01,22,0,-4,3,0,21
Syria,2008-12-01,2,0,0,0,0,2
Syria,2008-12-01,11,0,0,3,0,14
Syria,2008-12-01,5,0,0,0,0,5
Syria,2008-12-01,12,0,0,-4,2,10
Syria,2008-12-01,-13,0,0,0,0,-13
Syria,2008-12-01,1,0,0,0,0,1
Syria,2008-12-01,16,0,-1,0,2,17
Syria,2008-12-01,13,0,0,4,4,21
Syria,2008-12-01,17,0,0,0,5,22
Syria,2008-12-01,18,0,0,15,1,34
Syria,2008-12-01,22,0,0,-4,0,18
Syria,2008-12-01,0,0,0,0,4,4
Syria,2008-12-01,14,0,0,7,1,22
Syria,2008-12-01,15,2,1,8,1,27
Syria,2008-12-01,16,0,0,0,7,23
Syria,2008-12-01,26,0,0,20,10,56
Syria,2008-12-01,66,2,-3,51,6,122
Syria,2008-12-01,7,0,0,3,0,10
Syria,2008-12-01,7,0,0,9,0,16
Syria,2008-12-01,3,0,0,3,1,7
Syria,2008-12-01,0,0,0,0,0,0
Syria,2008-12-01,4,0,2,0,0,6
Syria,2008-12-01,10,0,-2,12,3,23
Syria,2008-12-01,11,0,0,-2,1,10
Syria,2008-12-01,5,0,0,3,2,10
Syria,2008-12-01,3,0,0,0,0,3
Syria,2008-12-01,44,0,0,3,2,49
Syria,2008-12-01,48,0,0,13,32,93
Syria,2008-12-01,73,0,0,21,28,122
Syria,2008-12-01,33,0,0,6,7,46
Syria,2008-12-01,11,0,-1,-1,1,10
Yemen,2008-12-01,12,0,0,-12,0,0
Yemen,2008-12-01,1,0,0,2,0,3
Yemen,2008-12-01,22,0,0,-11,6,17
Yemen,2008-12-01,6,0,0,-5,2,3
Yemen,2008-12-01,4,0,0,10,4,18
Yemen,2008-12-01,0,0,0,0,0,0
Yemen,2008-12-01,10,0,0,0,0,10
Yemen,2008-12-01,10,0,0,0,6,16
Yemen,2008-12-01,7,0,0,0,0,7
Yemen,2008-12-01,21,0,0,6,3,30
Yemen,2008-12-01,22,0,0,9,2,33
Yemen,2008-12-01,26,0,0,4,0,30
Yemen,2008-12-01,13,0,0,47,0,60
Yemen,2008-12-01,18,0,0,9,1,28
Yemen,2008-12-01,2,0,0,52,2,56
Yemen,2008-12-01,0,0,0,9,0,9
Yemen,2008-12-01,3,0,0,9,2,14
Yemen,2008-12-01,10,0,0,17,0,27
Yemen,2008-12-01,-1,0,0,2,3,4
Yemen,2008-12-01,12,0,0,10,0,22
Yemen,2008-12-01,5,0,0,6,0,11
Yemen,2008-12-01,-4,0,0,0,0,-4
Yemen,2008-12-01,1,0,0,-7,0,-6
Yemen,2008-12-01,14,0,0,0,1,15
Yemen,2008-12-01,3,0,0,6,0,9
Yemen,2008-12-01,2,0,0,6,1,9
Yemen,2008-12-01,13,0,0,-6,0,7
Yemen,2008-12-01,42,0,2,32,37,113
Yemen,2008-12-01,13,0,0,0,14,27
Yemen,2008-12-01,5,0,0,12,21,38
Yemen,2008-12-01,4,0,0,2,4,10
Afghanistan,2008-06-01,65,0,0,19,0,84
Afghanistan,2008-06-01,136,0,0,41,26,203
Afghanistan,2008-06-01,177,0,-2,36,7,218
Afghanistan,2008-06-01,112,2,-1,8,7,128
Afghanistan,2008-06-01,111,2,0,26,29,168
Afghanistan,2008-06-01,90,0,-3,15,8,110
Afghanistan,2008-06-01,73,2,0,12,4,91
Afghanistan,2008-06-01,72,0,-2,3,5,78
Afghanistan,2008-06-01,178,0,0,5,26,209
Afghanistan,2008-06-01,101,10,3,-5,6,115
Afghanistan,2008-06-01,441,0,-1,74,9,523
Afghanistan,2008-06-01,238,20,0,20,6,284
Afghanistan,2008-06-01,127,0,1,-17,18,129
Afghanistan,2008-06-01,183,0,0,28,45,256
Afghanistan,2008-06-01,137,0,1,36,10,184
Afghanistan,2008-06-01,200,0,0,43,21,264
Afghanistan,2008-06-01,160,2,3,1,6,172
Afghanistan,2008-06-01,260,0,-2,21,14,293
Afghanistan,2008-06-01,165,0,2,29,10,206
Afghanistan,2008-06-01,6,0,0,12,9,27
Afghanistan,2008-06-01,136,2,2,34,13,187
Afghanistan,2008-06-01,79,0,-2,12,2,91
Afghanistan,2008-06-01,105,4,0,18,6,133
Afghanistan,2008-06-01,134,6,-7,35,9,177
Afghanistan,2008-06-01,230,0,0,16,6,252
Afghanistan,2008-06-01,93,4,0,13,9,119
Afghanistan,2008-06-01,56,0,0,2,6,64
Afghanistan,2008-06-01,258,0,1,17,5,281
Afghanistan,2008-06-01,97,2,0,13,13,125
Afghanistan,2008-06-01,150,0,-2,29,6,183
Albania,2008-06-01,172,4,3,20,12,211
Albania,2008-06-01,95,0,4,25,13,137
Albania,2008-06-01,52,0,3,21,0,76
Albania,2008-06-01,6,2,0,14,1,23
Albania,2008-06-01,30,0,-1,3,8,40
Albania,2008-06-01,38,0,0,0,6,44
Albania,2008-06-01,17,0,-8,21,3,33
Albania,2008-06-01,15,0,-2,1,2,16
Albania,2008-06-01,19,0,-2,-4,2,15
Albania,2008-06-01,7,0,0,9,0,16
Albania,2008-06-01,17,0,0,-4,0,13
Albania,2008-06-01,9,0,-2,9,0,16
Albania,2008-06-01,6,0,-2,-6,0,-2
Albania,2008-06-01,40,0,-1,3,3,45
Albania,2008-06-01,62,0,-21,10,11,62
Albania,2008-06-01,14,0,-1,-8,2,7
Albania,2008-06-01,5,0,-11,3,0,-3
Albania,2008-06-01,15,0,-7,-2,2,8
Albania,2008-06-01,9,0,0,0,0,9
Albania,2008-06-01,9,0,-4,0,1,6
Albania,2008-06-01,4,0,0,6,1,11
Albania,2008-06-01,3,0,-1,0,0,2
Albania,2008-06-01,25,0,0,8,3,36
Albania,2008-06-01,18,0,0,-8,3,13
Albania,2008-06-01,2,0,-1,0,1,2
Albania,2008-06-01,8,0,0,6,0,14
Albania,2008-06-01,4,0,1,-2,0,3
Albania,2008-06-01,59,0,-3,6,0,62
Albania,2008-06-01,9,0,-1,3,0,11
Albania,2008-06-01,-3,0,1,0,0,-2
Algeria,2008-06-01,0,0,0,3,0,3
Algeria,2008-06-01,14,0,0,17,4,35
Algeria,2008-06-01,5,0,0,0,0,5
Algeria,2008-06-01,2,0,0,0,0,2
Algeria,2008-06-01,2,0,0,3,0,5
Algeria,2008-06-01,0,0,0,18,0,18
Algeria,2008-06-01,0,0,0,0,4,4
Algeria,2008-06-01,1,0,0,3,5,9
Algeria,2008-06-01,12,0,0,3,2,17
Algeria,2008-06-01,8,0,0,30,0,38
Algeria,2008-06-01,4,0,0,-1,0,3
Algeria,2008-06-01,1,0,0,24,0,25
Algeria,2008-06-01,4,0,0,3,0,7
Algeria,2008-06-01,0,0,0,24,0,24
Algeria,2008-06-01,10,0,0,4,0,14
Algeria,2008-06-01,1,0,0,0,0,1
Algeria,2008-06-01,0,0,0,0,0,0
Algeria,2008-06-01,0,0,0,3,0,3
Algeria,2008-06-01,-1,0,0,9,0,8
Algeria,2008-06-01,0,0,0,0,0,0
Algeria,2008-06-01,3,0,0,-2,0,1
Algeria,2008-06-01,3,0,0,-2,2,3
Algeria,2008-06-01,1,0,0,0,1,2
Algeria,2008-06-01,3,0,0,0,0,3
Algeria,2008-06-01,2,0,0,0,0,2
Algeria,2008-06-01,1,0,1,30,0,32
Algeria,2008-06-01,0,0,0,0,0,0
Algeria,2008-06-01,3,0,0,6,0,9
Algeria,2008-06-01,5,0,0,-1,0,4
Algeria,2008-06-01,2,0,0,9,0,11
Bangladesh,2008-06-01,11,0,0,1,2,14
Bangladesh,2008-06-01,11,0,0,12,2,25
Bangladesh,2008-06-01,30,0,0,27,2,59
Bangladesh,2008-06-01,4,0,0,22,2,28
Bangladesh,2008-06-01,17,2,0,15,0,34
Bangladesh,2008-06-01,11,0,1,5,0,17
Bangladesh,2008-06-01,6,0,0,-4,0,2
Bangladesh,2008-06-01,12,2,0,-13,0,1
Bangladesh,2008-06-01,3,0,0,8,0,11
Bangladesh,2008-06-01,4,0,0,3,0,7
Bangladesh,2008-06-01,6,0,0,-13,0,-7
Bangladesh,2008-06-01,4,0,0,-5,3,2
Bangladesh,2008-06-01,0,0,0,5,-2,3
Bangladesh,2008-06-01,17,0,0,2,0,19
Bangladesh,2008-06-01,7,0,0,-4,0,3
Bangladesh,2008-06-01,3,0,0,-7,0,-4
Bangladesh,2008-06-01,20,0,-2,7,0,25
Bangladesh,2008-06-01,12,0,-2,-1,4,13
Bangladesh,2008-06-01,23,0,0,6,0,29
Bangladesh,2008-06-01,-1,0,0,0,0,-1
Bangladesh,2008-06-01,19,0,0,27,2,48
Bangladesh,2008-06-01,3,0,0,9,0,12
Bangladesh,2008-06-01,0,0,0,3,0,3
Bangladesh,2008-06-01,26,0,-3,-2,0,21
Bangladesh,2008-06-01,9,0,0,4,0,13
Bangladesh,2008-06-01,5,0,0,3,0,8
Bangladesh,2008-06-01,16,0,0,0,0,16
Bangladesh,2008-06-01,8,0,-2,-2,0,4
Bangladesh,2008-06-01,3,0,0,1,0,4
Bangladesh,2008-06-01,31,0,-2,9,2,40
Cameroon,2008-06-01,-1,0,0,0,0,-1
Cameroon,2008-06-01,0,0,0,3,0,3
Cameroon,2008-06-01,2,0,0,3,0,5
Cameroon,2008-06-01,0,0,0,0,0,0
Cameroon,2008-06-01,2,0,0,3,0,5
Cameroon,2008-06-01,0,0,0,0,0,0
Cameroon,2008-06-01,12,0,0,0,0,12
Cameroon,2008-06-01,1,0,0,6,0,7
Cameroon,2008-06-01,9,0,0,0,0,9
Cameroon,2008-06-01,6,0,0,0,2,8
Cameroon,2008-06-01,0,0,0,3,0,3
Cameroon,2008-06-01,66,0,0,0,0,66
Cameroon,2008-06-01,6,0,0,12,1,19
Cameroon,2008-06-01,0,0,0,0,0,0
Cameroon,2008-06-01,0,0,0,0,0,0
Cameroon,2008-06-01,3,0,0,0,0,3
Cameroon,2008-06-01,1,0,0,0,0,1
Cameroon,2008-06-01,0,0,0,0,0,0
Cameroon,2008-06-01,0,0,-4,0,0,-4
Cameroon,2008-06-01,2,0,0,0,0,2
China,2008-06-01,44,2,0,6,1,53
China,2008-06-01,49,0,0,9,8,66
China,2008-06-01,85,0,-3,17,5,104
China,2008-06-01,22,0,-1,59,4,84
China,2008-06-01,31,4,0,36,2,73
China,2008-06-01,49,0,0,16,9,74
China,2008-06-01,25,0,0,26,4,55
China,2008-06-01,45,0,2,57,13,117
China,2008-06-01,32,4,-4,17,9,58
China,2008-06-01,51,0,-6,35,13,93
China,2008-06-01,83,2,2,33,22,142
China,2008-06-01,36,0,0,43,4,83
China,2008-06-01,46,0,2,9,2,59
China,2008-06-01,58,0,-1,5,6,68
China,2008-06-01,62,0,4,14,4,84
China,2008-06-01,18,4,1,22,2,47
China,2008-06-01,24,4,-2,20,5,51
China,2008-06-01,176,0,3,28,20,227
China,2008-06-01,38,0,0,75,21,134
China,2008-06-01,2,0,0,7,0,9
China,2008-06-01,54,0,0,58,17,129
China,2008-06-01,53,4,0,13,6,76
China,2008-06-01,38,2,0,18,2,60
China,2008-06-01,103,0,-2,76,11,188
China,2008-06-01,60,2,-1,62,6,129
China,2008-06-01,45,0,-13,7,7,46
China,2008-06-01,32,0,-3,20,6,55
China,2008-06-01,25,0,0,12,4,41
China,2008-06-01,60,0,-2,46,23,127
China,2008-06-01,66,0,-6,30,9,99
Egypt,2008-06-01,8,0,0,0,0,8
Egypt,2008-06-01,10,0,0,15,1,26
Egypt,2008-06-01,11,0,1,-5,1,8
Egypt,2008-06-01,19,0,1,-1,0,19
Egypt,2008-06-01,101,0,2,-18,6,91
Egypt,2008-06-01,52,0,0,12,2,66
Egypt,2008-06-01,10,0,0,6,9,25
Egypt,2008-06-01,13,0,0,18,3,34
Egypt,2008-06-01,35,0,0,16,2,53
Egypt,2008-06-01,67,0,0,1,1,69
Egypt,2008-06-01,53,0,0,4,7,64
Egypt,2008-06-01,45,0,0,-12,4,37
Egypt,2008-06-01,4,0,0,9,4,17
Egypt,2008-06-01,13,0,0,7,3,23
Egypt,2008-06-01,25,0,0,8,1,34
Egypt,2008-06-01,45,0,0,21,6,72
Egypt,2008-06-01,107,2,-1,2,5,115
Egypt,2008-06-01,65,2,0,41,2,110
Egypt,2008-06-01,84,0,0,17,2,103
Egypt,2008-06-01,10,0,0,0,1,11
Egypt,2008-06-01,60,0,0,10,0,70
Egypt,2008-06-01,8,0,0,4,3,15
Egypt,2008-06-01,24,0,0,3,0,27
Egypt,2008-06-01,49,0,0,-6,0,43
Egypt,2008-06-01,48,0,-1,5,0,52
Egypt,2008-06-01,32,0,0,8,1,41
Egypt,2008-06-01,8,0,0,5,0,13
Egypt,2008-06-01,43,0,2,0,0,45
Egypt,2008-06-01,35,0,0,1,8,44
Egypt,2008-06-01,62,2,-5,20,2,81
Eritrea,2008-06-01,2,0,0,13,3,18
Eritrea,2008-06-01,8,0,0,6,3,17
Eritrea,2008-06-01,14,0,0,1,0,15
Eritrea,2008-06-01,31,0,0,2,2,35
Eritrea,2008-06-01,19,0,-2,8,4,29
Eritrea,2008-06-01,9,0,0,9,6,24
Eritrea,2008-06-01,12,0,0,1,0,13
Eritrea,2008-06-01,10,0,0,6,2,18
Eritrea,2008-06-01,4,0,0,0,3,7
Eritrea,2008-06-01,24,0,0,6,2,32
Eritrea,2008-06-01,49,0,0,0,2,51
Eritrea,2008-06-01,47,0,0,6,0,53
Eritrea,2008-06-01,25,0,0,0,0,25
Eritrea,2008-06-01,42,0,0,3,0,45
Eritrea,2008-06-01,23,0,1,3,2,29
Eritrea,2008-06-01,15,0,0,-2,5,18
Eritrea,2008-06-01,7,0,0,0,0,7
Eritrea,2008-06-01,15,0,0,9,2,26
Eritrea,2008-06-01,3,0,0,3,0,6
Eritrea,2008-06-01,7,0,0,0,0,7
Eritrea,2008-06-01,4,0,0,0,1,5
Eritrea,2008-06-01,9,0,0,1,4,14
Eritrea,2008-06-01,0,0,0,3,0,3
Eritrea,2008-06-01,7,0,0,0,0,7
Eritrea,2008-06-01,13,0,0,1,2,16
Eritrea,2008-06-01,18,0,0,0,0,18
Eritrea,2008-06-01,21,0,0,0,0,21
Eritrea,2008-06-01,0,0,0,3,0,3
Eritrea,2008-06-01,15,0,0,5,0,20
Eritrea,2008-06-01,27,0,0,-3,0,24
Georgia,2008-06-01,0,0,0,0,0,0
Georgia,2008-06-01,0,0,0,1,0,1
Georgia,2008-06-01,8,0,-4,-1,0,3
Georgia,2008-06-01,-3,0,0,0,0,-3
Georgia,2008-06-01,22,2,1,2,2,29
Georgia,2008-06-01,5,0,0,3,0,8
Georgia,2008-06-01,-1,0,0,0,0,-1
Georgia,2008-06-01,3,0,0,0,1,4
Georgia,2008-06-01,5,0,1,1,0,7
Georgia,2008-06-01,10,0,0,4,0,14
Georgia,2008-06-01,5,0,0,-2,0,3
Georgia,2008-06-01,1,0,0,0,0,1
Georgia,2008-06-01,2,0,0,0,0,2
Georgia,2008-06-01,0,0,0,0,0,0
Georgia,2008-06-01,0,0,0,9,0,9
Georgia,2008-06-01,9,0,0,17,2,28
Georgia,2008-06-01,1,0,0,3,2,6
Georgia,2008-06-01,0,0,0,6,0,6
Georgia,2008-06-01,0,0,0,15,0,15
Georgia,2008-06-01,0,0,0,0,0,0
Georgia,2008-06-01,12,0,0,6,1,19
Georgia,2008-06-01,9,0,0,3,2,14
Georgia,2008-06-01,5,0,0,0,0,5
Georgia,2008-06-01,10,0,0,3,0,13
Georgia,2008-06-01,22,0,0,21,1,44
Georgia,2008-06-01,10,0,0,6,0,16
Georgia,2008-06-01,11,0,0,9,0,20
Georgia,2008-06-01,24,0,0,-1,2,25
Georgia,2008-06-01,6,0,0,0,2,8
Georgia,2008-06-01,10,0,0,9,3,22
India,2008-06-01,36,0,0,-4,0,32
India,2008-06-01,60,0,0,2,6,68
India,2008-06-01,58,0,-2,13,0,69
India,2008-06-01,43,0,0,11,5,59
India,2008-06-01,51,0,0,26,19,96
India,2008-06-01,42,0,-2,36,6,82
India,2008-06-01,22,0,1,9,1,33
India,2008-06-01,17,0,2,21,4,44
India,2008-06-01,36,0,1,-2,2,37
India,2008-06-01,21,0,-2,-2,10,27
India,2008-06-01,43,0,0,25,9,77
India,2008-06-01,19,0,0,0,2,21
India,2008-06-01,15,2,0,3,0,20
India,2008-06-01,9,0,1,-2,3,11
India,2008-06-01,26,0,0,10,1,37
India,2008-06-01,9,2,0,7,3,21
India,2008-06-01,24,0,0,5,4,33
India,2008-06-01,22,0,0,5,6,33
India,2008-06-01,16,2,0,0,8,26
India,2008-06-01,1,0,0,0,0,1
India,2008-06-01,12,0,-2,22,0,32
India,2008-06-01,36,0,0,6,3,45
India,2008-06-01,27,0,-2,7,1,33
India,2008-06-01,44,0,0,4,0,48
India,2008-06-01,18,4,0,3,3,28
India,2008-06-01,36,0,-7,10,4,43
India,2008-06-01,38,0,-5,13,6,52
India,2008-06-01,26,0,0,6,6,38
India,2008-06-01,29,0,0,12,4,45
India,2008-06-01,23,0,-1,30,16,68
Iran,2008-06-01,49,0,0,6,74,129
Iran,2008-06-01,68,0,1,23,25,117
Iran,2008-06-01,57,0,1,39,13,110
Iran,2008-06-01,133,0,2,11,16,162
Iran,2008-06-01,96,2,2,4,7,111
Iran,2008-06-01,43,0,2,3,6,54
Iran,2008-06-01,36,2,2,21,8,69
Iran,2008-06-01,62,0,-4,9,5,72
Iran,2008-06-01,38,0,0,9,5,52
Iran,2008-06-01,82,0,-3,29,8,116
Iran,2008-06-01,103,0,1,16,16,136
Iran,2008-06-01,21,0,0,4,1,26
Iran,2008-06-01,7,0,0,0,0,7
Iran,2008-06-01,40,0,-2,5,2,45
Iran,2008-06-01,32,0,-10,23,5,50
Iran,2008-06-01,23,0,-3,19,4,43
Iran,2008-06-01,79,0,0,40,7,126
Iran,2008-06-01,62,0,-2,25,2,87
Iran,2008-06-01,27,4,0,12,2,45
Iran,2008-06-01,17,0,0,20,0,37
Iran,2008-06-01,88,0,2,21,5,116
Iran,2008-06-01,60,0,0,7,5,72
Iran,2008-06-01,30,0,-2,39,2,69
Iran,2008-06-01,53,0,-3,48,5,103
Iran,2008-06-01,61,0,-2,4,0,63
Iran,2008-06-01,40,0,-2,26,4,68
Iran,2008-06-01,10,0,0,6,1,17
Iran,2008-06-01,24,0,-6,10,7,35
Iran,2008-06-01,47,0,0,-6,10,51
Iran,2008-06-01,42,4,0,67,6,119
Iraq,2008-06-01,66,2,0,13,8,89
Iraq,2008-06-01,112,0,1,54,34,201
Iraq,2008-06-01,87,0,0,20,9,116
Iraq,2008-06-01,197,0,0,108,13,318
Iraq,2008-06-01,314,2,0,78,14,408
Iraq,2008-06-01,101,2,3,17,4,127
Iraq,2008-06-01,43,2,0,7,5,57
Iraq,2008-06-01,102,2,-6,13,14,125
Iraq,2008-06-01,177,0,-2,27,25,227
Iraq,2008-06-01,158,2,-8,50,12,214
Iraq,2008-06-01,165,4,7,53,37,266
Iraq,2008-06-01,111,0,11,23,18,163
Iraq,2008-06-01,69,0,2,13,0,84
Iraq,2008-06-01,52,0,1,17,10,80
Iraq,2008-06-01,35,0,1,13,44,93
Iraq,2008-06-01,91,0,-5,33,29,148
Iraq,2008-06-01,231,2,3,79,4,319
Iraq,2008-06-01,139,10,1,36,13,199
Iraq,2008-06-01,39,6,0,47,2,94
Iraq,2008-06-01,-1,0,0,21,0,20
Iraq,2008-06-01,109,8,0,48,10,175
Iraq,2008-06-01,41,2,0,1,15,59
Iraq,2008-06-01,71,2,10,-7,14,90
Iraq,2008-06-01,59,2,5,20,7,93
Iraq,2008-06-01,148,0,5,7,8,168
Iraq,2008-06-01,133,0,-1,-5,16,143
Iraq,2008-06-01,72,0,-1,7,20,98
Iraq,2008-06-01,85,2,0,7,5,99
Iraq,2008-06-01,57,0,-5,-2,8,58
Iraq,2008-06-01,97,2,0,27,21,147
Morocco,2008-06-01,6,0,0,0,0,6
Morocco,2008-06-01,4,0,0,12,0,16
Morocco,2008-06-01,2,0,0,0,0,2
Morocco,2008-06-01,0,0,0,2,0,2
Morocco,2008-06-01,0,0,0,3,2,5
Morocco,2008-06-01,-2,0,0,3,0,1
Morocco,2008-06-01,0,0,0,-2,0,-2
Morocco,2008-06-01,0,0,0,0,0,0
Morocco,2008-06-01,0,0,0,0,0,0
Morocco,2008-06-01,5,0,0,0,0,5
Morocco,2008-06-01,4,0,0,15,0,19
Morocco,2008-06-01,-2,0,0,0,1,-1
Morocco,2008-06-01,3,0,0,0,0,3
Morocco,2008-06-01,0,0,0,9,0,9
Morocco,2008-06-01,0,0,0,3,0,3
Morocco,2008-06-01,6,0,0,0,0,6
Morocco,2008-06-01,4,0,0,-2,0,2
Morocco,2008-06-01,0,0,0,6,0,6
Morocco,2008-06-01,4,0,0,6,0,10
Morocco,2008-06-01,-1,0,0,0,0,-1
Morocco,2008-06-01,0,0,0,0,2,2
Morocco,2008-06-01,2,2,0,0,0,4
Morocco,2008-06-01,3,0,0,6,0,9
Morocco,2008-06-01,0,0,0,0,0,0
Morocco,2008-06-01,1,0,-2,0,0,-1
Morocco,2008-06-01,3,0,1,6,0,10
Morocco,2008-06-01,0,0,0,0,0,0
Morocco,2008-06-01,-1,0,0,0,0,-1
Morocco,2008-06-01,3,0,0,0,0,3
Morocco,2008-06-01,17,0,0,12,2,31
Nigeria,2008-06-01,4,0,0,0,0,4
Nigeria,2008-06-01,47,0,0,0,4,51
Nigeria,2008-06-01,14,0,0,6,5,25
Nigeria,2008-06-01,6,2,0,5,3,16
Nigeria,2008-06-01,8,0,0,9,0,17
Nigeria,2008-06-01,4,2,0,6,0,12
Nigeria,2008-06-01,-2,4,0,0,0,2
Nigeria,2008-06-01,3,0,0,0,0,3
Nigeria,2008-06-01,14,4,0,3,0,21
Nigeria,2008-06-01,18,0,0,22,8,48
Nigeria,2008-06-01,12,0,0,3,0,15
Nigeria,2008-06-01,7,0,0,4,0,11
Nigeria,2008-06-01,2,0,0,0,1,3
Nigeria,2008-06-01,3,0,0,3,0,6
Nigeria,2008-06-01,3,0,0,-6,0,-3
Nigeria,2008-06-01,2,0,0,0,0,2
Nigeria,2008-06-01,4,0,0,1,0,5
Nigeria,2008-06-01,3,0,0,15,0,18
Nigeria,2008-06-01,11,0,0,-1,0,10
Nigeria,2008-06-01,2,0,0,0,0,2
Nigeria,2008-06-01,16,0,0,0,3,19
Nigeria,2008-06-01,13,0,0,6,0,19
Nigeria,2008-06-01,28,2,0,9,2,41
Nigeria,2008-06-01,-16,0,0,0,0,-16
Nigeria,2008-06-01,-7,0,-1,4,0,-4
Nigeria,2008-06-01,44,0,0,30,0,74
Nigeria,2008-06-01,12,0,2,24,0,38
Nigeria,2008-06-01,13,0,0,0,1,14
Nigeria,2008-06-01,17,0,0,6,0,23
Nigeria,2008-06-01,35,0,0,3,0,38
Pakistan,2008-06-01,42,2,1,35,0,80
Pakistan,2008-06-01,77,2,1,31,8,119
Pakistan,2008-06-01,42,0,2,24,6,74
Pakistan,2008-06-01,58,0,-1,33,13,103
Pakistan,2008-06-01,50,0,0,96,6,152
Pakistan,2008-06-01,47,2,0,57,6,112
Pakistan,2008-06-01,45,2,0,17,8,72
Pakistan,2008-06-01,40,0,-5,1,10,46
Pakistan,2008-06-01,79,0,0,10,7,96
Pakistan,2008-06-01,50,0,0,8,5,63
Pakistan,2008-06-01,164,0,1,10,9,184
Pakistan,2008-06-01,82,2,0,4,1,89
Pakistan,2008-06-01,48,0,0,27,0,75
Pakistan,2008-06-01,38,0,0,6,12,56
Pakistan,2008-06-01,129,0,-5,37,16,177
Pakistan,2008-06-01,121,2,-4,67,7,193
Pakistan,2008-06-01,92,0,0,16,4,112
Pakistan,2008-06-01,55,0,2,8,1,66
Pakistan,2008-06-01,42,6,-10,12,4,54
Pakistan,2008-06-01,3,0,0,-4,0,-1
Pakistan,2008-06-01,41,0,-3,15,2,55
Pakistan,2008-06-01,95,0,-2,8,3,104
Pakistan,2008-06-01,116,0,3,25,12,156
Pakistan,2008-06-01,179,0,0,7,15,201
Pakistan,2008-06-01,72,4,0,8,12,96
Pakistan,2008-06-01,84,0,0,37,9,130
Pakistan,2008-06-01,63,0,-2,8,3,72
Pakistan,2008-06-01,49,0,-4,24,9,78
Pakistan,2008-06-01,27,0,0,9,3,39
Pakistan,2008-06-01,89,0,0,25,8,122
Sierra Leone,2008-06-01,0,0,0,3,0,3
Sierra Leone,2008-06-01,0,0,0,3,0,3
Sierra Leone,2008-06-01,0,0,0,0,0,0
Sierra Leone,2008-06-01,0,0,0,0,0,0
Sierra Leone,2008-06-01,2,0,0,0,0,2
Sierra Leone,2008-06-01,0,0,0,0,0,0
Sierra Leone,2008-06-01,0,0,0,0,0,0
Sierra Leone,2008-06-01,2,0,0,0,2,4
Sierra Leone,2008-06-01,0,0,0,6,0,6
Sierra Leone,2008-06-01,0,0,0,0,0,0
Sierra Leone,2008-06-01,-1,0,0,9,0,8
Sierra Leone,2008-06-01,0,0,0,-1,0,-1
Sierra Leone,2008-06-01,0,0,0,0,0,0
Sierra Leone,2008-06-01,13,0,0,6,0,19
Sierra Leone,2008-06-01,20,0,0,8,0,28
Sierra Leone,2008-06-01,3,0,0,3,0,6
Sierra Leone,2008-06-01,0,0,0,0,0,0
Sierra Leone,2008-06-01,0,0,0,0,0,0
Sierra Leone,2008-06-01,0,0,0,0,0,0
Sierra Leone,2008-06-01,0,0,0,6,0,6
Sierra Leone,2008-06-01,4,0,0,9,0,13
Sierra Leone,2008-06-01,2,0,0,0,0,2
Sierra Leone,2008-06-01,-1,0,0,-4,0,-5
Sierra Leone,2008-06-01,0,0,0,0,0,0
Sierra Leone,2008-06-01,2,0,0,0,1,3
Sierra Leone,2008-06-01,1,0,0,0,1,2
Somalia,2008-06-01,12,0,0,-14,0,-2
Somalia,2008-06-01,113,0,-1,21,25,158
Somalia,2008-06-01,97,10,-1,9,10,125
Somalia,2008-06-01,53,0,0,2,4,59
Somalia,2008-06-01,14,0,0,0,8,22
Somalia,2008-06-01,-2,0,0,9,0,7
Somalia,2008-06-01,48,0,0,6,19,73
Somalia,2008-06-01,72,0,0,15,16,103
Somalia,2008-06-01,19,0,0,5,4,28
Somalia,2008-06-01,67,2,0,3,6,78
Somalia,2008-06-01,16,0,0,8,0,24
Somalia,2008-06-01,42,0,0,0,1,43
Somalia,2008-06-01,15,0,0,0,0,15
Somalia,2008-06-01,9,0,0,0,0,9
Somalia,2008-06-01,9,0,0,0,0,9
Somalia,2008-06-01,8,0,0,0,2,10
Somalia,2008-06-01,25,6,0,0,0,31
Somalia,2008-06-01,-19,0,0,0,4,-15
Somalia,2008-06-01,2,0,0,-2,0,0
Somalia,2008-06-01,1,0,0,3,0,4
Somalia,2008-06-01,5,0,0,0,0,5
Somalia,2008-06-01,6,0,0,21,2,29
Somalia,2008-06-01,21,0,0,4,1,26
Somalia,2008-06-01,2,0,0,3,1,6
Somalia,2008-06-01,15,0,0,-7,2,10
Somalia,2008-06-01,1,0,0,-1,0,0
Somalia,2008-06-01,7,0,0,-2,1,6
Somalia,2008-06-01,12,4,0,23,0,39
Somalia,2008-06-01,13,0,0,3,6,22
Somalia,2008-06-01,21,0,0,-6,1,16
Syria,2008-06-01,21,0,0,1,2,24
Syria,2008-06-01,23,0,-2,7,1,29
Syria,2008-06-01,35,0,0,-2,0,33
Syria,2008-06-01,49,0,-6,25,7,75
Syria,2008-06-01,11,0,1,15,0,27
Syria,2008-06-01,10,0,1,19,0,30
Syria,2008-06-01,3,0,0,-1,0,2
Syria,2008-06-01,5,0,0,0,0,5
Syria,2008-06-01,32,0,0,-2,1,31
Syria,2008-06-01,10,0,0,15,2,27
Syria,2008-06-01,9,0,0,0,0,9
Syria,2008-06-01,8,0,0,12,3,23
Syria,2008-06-01,-3,0,0,3,-2,-2
Syria,2008-06-01,8,0,0,6,6,20
Syria,2008-06-01,-5,0,0,12,2,9
Syria,2008-06-01,-3,0,-4,-6,0,-13
Syria,2008-06-01,13,0,0,3,0,16
Syria,2008-06-01,29,0,0,1,6,36
Syria,2008-06-01,18,0,0,5,0,23
Syria,2008-06-01,0,0,0,0,3,3
Syria,2008-06-01,18,0,0,-1,0,17
Syria,2008-06-01,28,0,0,7,0,35
Syria,2008-06-01,19,0,0,-8,0,11
Syria,2008-06-01,23,0,0,1,0,24
Syria,2008-06-01,18,0,-2,0,0,16
Syria,2008-06-01,14,0,0,-4,0,10
Syria,2008-06-01,-1,0,0,0,2,1
Syria,2008-06-01,24,0,0,0,1,25
Syria,2008-06-01,7,0,0,0,0,7
Syria,2008-06-01,24,0,0,26,1,51
Yemen,2008-06-01,24,0,0,0,0,24
Yemen,2008-06-01,2,0,0,-2,0,0
Yemen,2008-06-01,5,0,0,8,0,13
Yemen,2008-06-01,12,0,0,0,3,15
Yemen,2008-06-01,37,0,0,6,0,43
Yemen,2008-06-01,6,0,0,3,0,9
Yemen,2008-06-01,1,0,-2,0,0,-1
Yemen,2008-06-01,-2,0,0,0,0,-2
Yemen,2008-06-01,42,0,0,55,4,101
Yemen,2008-06-01,8,0,0,2,0,10
Yemen,2008-06-01,12,0,0,6,0,18
Yemen,2008-06-01,3,0,0,7,0,10
Yemen,2008-06-01,0,0,0,-2,0,-2
Yemen,2008-06-01,0,0,0,0,0,0
Yemen,2008-06-01,-1,0,0,-2,4,1
Yemen,2008-06-01,2,0,0,6,0,8
Yemen,2008-06-01,0,0,-3,3,0,0
Yemen,2008-06-01,0,0,0,3,0,3
Yemen,2008-06-01,1,0,0,-4,0,-3
Yemen,2008-06-01,6,0,0,0,0,6
Yemen,2008-06-01,32,0,0,18,0,50
Yemen,2008-06-01,0,0,0,9,0,9
Yemen,2008-06-01,3,0,0,0,0,3
Yemen,2008-06-01,13,0,-2,9,0,20
Yemen,2008-06-01,10,0,0,12,0,22
Yemen,2008-06-01,0,0,0,0,0,0
Yemen,2008-06-01,2,0,0,34,2,38
Yemen,2008-06-01,0,0,0,12,0,12
Yemen,2008-06-01,0,0,0,1,1,2
Yemen,2008-06-01,66,0,0,21,1,88
Afghanistan,2008-10-01,219,0,1,10,8,238
Afghanistan,2008-10-01,166,0,0,9,23,198
Afghanistan,2008-10-01,176,2,0,53,15,246
Afghanistan,2008-10-01,91,0,0,9,9,109
Afghanistan,2008-10-01,193,0,0,29,9,231
Afghanistan,2008-10-01,267,0,-2,47,12,324
Afghanistan,2008-10-01,92,0,-2,3,11,104
Afghanistan,2008-10-01,191,2,0,7,11,211
Afghanistan,2008-10-01,258,2,-2,26,5,289
Afghanistan,2008-10-01,157,0,-4,24,23,200
Afghanistan,2008-10-01,110,0,-5,11,11,127
Afghanistan,2008-10-01,240,0,2,3,19,264
Afghanistan,2008-10-01,270,0,0,49,18,337
Afghanistan,2008-10-01,241,0,0,102,2,345
Afghanistan,2008-10-01,179,2,-1,27,21,228
Afghanistan,2008-10-01,150,0,0,42,9,201
Afghanistan,2008-10-01,136,0,1,6,7,150
Afghanistan,2008-10-01,86,0,0,8,8,102
Afghanistan,2008-10-01,120,0,0,12,5,137
Afghanistan,2008-10-01,129,0,0,13,22,164
Afghanistan,2008-10-01,83,0,0,21,25,129
Afghanistan,2008-10-01,136,2,-2,59,10,205
Afghanistan,2008-10-01,255,0,0,48,14,317
Afghanistan,2008-10-01,113,0,-2,29,13,153
Afghanistan,2008-10-01,161,0,0,84,8,253
Afghanistan,2008-10-01,237,0,2,58,7,304
Afghanistan,2008-10-01,219,0,0,23,7,249
Afghanistan,2008-10-01,133,8,0,23,5,169
Afghanistan,2008-10-01,237,0,0,46,7,290
Afghanistan,2008-10-01,74,0,1,30,12,117
Afghanistan,2008-10-01,190,0,-3,45,51,283
Albania,2008-10-01,2,0,0,-2,0,0
Albania,2008-10-01,6,0,0,0,1,7
Albania,2008-10-01,18,0,-4,0,0,14
Albania,2008-10-01,0,0,0,0,0,0
Albania,2008-10-01,0,0,0,0,0,0
Albania,2008-10-01,0,0,0,0,0,0
Albania,2008-10-01,4,0,-1,-1,0,2
Albania,2008-10-01,6,4,-3,-7,2,2
Albania,2008-10-01,26,0,0,7,1,34
Albania,2008-10-01,19,0,-5,3,2,19
Albania,2008-10-01,0,0,0,0,0,0
Albania,2008-10-01,0,0,0,0,0,0
Albania,2008-10-01,7,0,0,3,0,10
Albania,2008-10-01,5,0,0,0,0,5
Albania,2008-10-01,0,0,-3,6,0,3
Albania,2008-10-01,0,0,-2,3,0,1
Albania,2008-10-01,4,0,0,6,-2,8
Albania,2008-10-01,6,0,0,-2,0,4
Albania,2008-10-01,3,0,0,0,0,3
Albania,2008-10-01,9,0,0,0,1,10
Albania,2008-10-01,2,0,0,9,0,11
Albania,2008-10-01,9,0,0,0,0,9
Albania,2008-10-01,-2,0,0,3,1,2
Albania,2008-10-01,1,0,0,0,1,2
Albania,2008-10-01,4,0,0,-4,0,0
Albania,2008-10-01,0,0,0,3,0,3
Albania,2008-10-01,9,0,0,3,0,12
Albania,2008-10-01,2,0,0,0,0,2
Albania,2008-10-01,9,0,0,0,0,9
Albania,2008-10-01,12,0,0,6,5,23
Albania,2008-10-01,8,0,-2,3,0,9
Algeria,2008-10-01,6,0,0,0,0,6
Algeria,2008-10-01,2,0,0,6,0,8
Algeria,2008-10-01,1,0,0,0,0,1
Algeria,2008-10-01,0,0,0,0,0,0
Algeria,2008-10-01,0,0,0,0,0,0
Algeria,2008-10-01,-2,0,0,-2,0,-4
Algeria,2008-10-01,-1,0,0,12,0,11
Algeria,2008-10-01,0,0,-2,-5,0,-7
Algeria,2008-10-01,2,0,0,0,0,2
Algeria,2008-10-01,0,0,0,0,1,1
Algeria,2008-10-01,0,0,0,0,0,0
Algeria,2008-10-01,0,0,0,6,0,6
Algeria,2008-10-01,0,0,0,0,0,0
Algeria,2008-10-01,0,0,0,0,0,0
Algeria,2008-10-01,-2,0,0,3,5,6
Algeria,2008-10-01,1,0,0,20,0,21
Algeria,2008-10-01,0,0,0,0,0,0
Algeria,2008-10-01,0,0,0,3,0,3
Algeria,2008-10-01,3,0,0,0,0,3
Algeria,2008-10-01,2,0,0,12,0,14
Algeria,2008-10-01,15,0,0,12,0,27
Algeria,2008-10-01,14,0,0,9,0,23
Algeria,2008-10-01,8,0,0,4,1,13
Algeria,2008-10-01,5,0,0,0,0,5
Algeria,2008-10-01,1,0,0,0,0,1
Algeria,2008-10-01,2,0,0,0,0,2
Algeria,2008-10-01,0,0,0,0,0,0
Algeria,2008-10-01,0,0,0,0,0,0
Algeria,2008-10-01,-1,0,0,0,0,-1
Algeria,2008-10-01,1,0,0,0,0,1
Algeria,2008-10-01,4,0,0,33,0,37
Bangladesh,2008-10-01,10,0,0,0,0,10
Bangladesh,2008-10-01,7,0,0,3,1,11
Bangladesh,2008-10-01,2,0,0,10,2,14
Bangladesh,2008-10-01,0,0,0,2,0,2
Bangladesh,2008-10-01,30,0,0,0,4,34
Bangladesh,2008-10-01,100,2,0,0,0,102
Bangladesh,2008-10-01,35,0,0,9,10,54
Bangladesh,2008-10-01,21,0,0,0,1,22
Bangladesh,2008-10-01,5,0,0,0,0,5
Bangladesh,2008-10-01,13,0,0,16,2,31
Bangladesh,2008-10-01,13,0,0,6,0,19
Bangladesh,2008-10-01,21,0,0,9,1,31
Bangladesh,2008-10-01,5,0,1,-2,0,4
Bangladesh,2008-10-01,28,0,0,9,2,39
Bangladesh,2008-10-01,9,0,-2,0,6,13
Bangladesh,2008-10-01,2,0,0,-4,0,-2
Bangladesh,2008-10-01,48,0,0,43,0,91
Bangladesh,2008-10-01,0,0,-2,1,0,-1
Bangladesh,2008-10-01,1,0,0,3,1,5
Bangladesh,2008-10-01,4,0,0,14,0,18
Bangladesh,2008-10-01,4,0,0,3,1,8
Bangladesh,2008-10-01,4,0,0,3,0,7
Bangladesh,2008-10-01,1,0,0,9,0,10
Bangladesh,2008-10-01,-4,0,0,11,0,7
Bangladesh,2008-10-01,37,0,0,9,0,46
Bangladesh,2008-10-01,29,0,0,-2,0,27
Bangladesh,2008-10-01,7,0,0,0,0,7
Bangladesh,2008-10-01,4,0,0,6,0,10
Bangladesh,2008-10-01,15,0,0,9,1,25
Bangladesh,2008-10-01,91,0,0,12,12,115
Bangladesh,2008-10-01,68,0,-4,23,7,94
Cameroon,2008-10-01,0,0,0,0,0,0
Cameroon,2008-10-01,0,0,0,0,0,0
Cameroon,2008-10-01,0,0,0,3,0,3
Cameroon,2008-10-01,1,0,0,3,0,4
Cameroon,2008-10-01,3,0,0,0,0,3
Cameroon,2008-10-01,0,0,0,3,0,3
Cameroon,2008-10-01,5,0,0,0,0,5
Cameroon,2008-10-01,13,0,0,0,0,13
Cameroon,2008-10-01,-1,0,0,0,0,-1
Cameroon,2008-10-01,0,0,0,0,0,0
Cameroon,2008-10-01,0,0,0,0,0,0
Cameroon,2008-10-01,0,0,0,0,0,0
Cameroon,2008-10-01,0,0,0,3,0,3
Cameroon,2008-10-01,0,0,0,3,0,3
Cameroon,2008-10-01,3,0,0,0,0,3
Cameroon,2008-10-01,0,0,0,0,0,0
Cameroon,2008-10-01,0,0,0,0,0,0
Cameroon,2008-10-01,6,0,0,-2,0,4
Cameroon,2008-10-01,4,0,0,0,0,4
Cameroon,2008-10-01,4,0,0,0,0,4
Cameroon,2008-10-01,0,0,0,0,0,0
Cameroon,2008-10-01,0,0,0,0,0,0
Cameroon,2008-10-01,11,0,4,-1,0,14
China,2008-10-01,77,2,-1,33,13,124
China,2008-10-01,64,0,3,66,17,150
China,2008-10-01,74,0,1,95,12,182
China,2008-10-01,47,0,0,34,4,85
China,2008-10-01,34,0,0,45,7,86
China,2008-10-01,121,4,0,49,19,193
China,2008-10-01,85,4,1,33,14,137
China,2008-10-01,65,4,-15,32,9,95
China,2008-10-01,91,0,-3,56,10,154
China,2008-10-01,78,4,1,37,7,127
China,2008-10-01,56,0,-7,3,11,63
China,2008-10-01,34,2,1,22,0,59
China,2008-10-01,49,0,-4,37,7,89
China,2008-10-01,68,2,1,11,7,89
China,2008-10-01,60,2,-5,40,21,118
China,2008-10-01,46,0,-4,38,6,86
China,2008-10-01,70,0,-8,34,15,111
China,2008-10-01,55,2,3,39,4,103
China,2008-10-01,29,2,-2,22,7,58
China,2008-10-01,58,2,-2,26,10,94
China,2008-10-01,55,0,-4,13,7,71
China,2008-10-01,57,8,0,23,5,93
China,2008-10-01,70,4,1,24,22,121
China,2008-10-01,57,0,-1,-9,32,79
China,2008-10-01,27,0,1,18,7,53
China,2008-10-01,58,0,0,21,23,102
China,2008-10-01,107,4,-4,98,12,217
China,2008-10-01,135,2,0,98,22,257
China,2008-10-01,129,4,1,77,23,234
China,2008-10-01,101,0,0,52,20,173
China,2008-10-01,144,0,0,89,20,253
Egypt,2008-10-01,30,0,0,3,2,35
Egypt,2008-10-01,2,0,-2,15,6,21
Egypt,2008-10-01,20,0,1,-3,0,18
Egypt,2008-10-01,2,0,0,0,0,2
Egypt,2008-10-01,18,0,0,-2,6,22
Egypt,2008-10-01,24,0,0,21,1,46
Egypt,2008-10-01,17,0,2,15,0,34
Egypt,2008-10-01,42,0,0,17,11,70
Egypt,2008-10-01,25,0,0,30,2,57
Egypt,2008-10-01,18,0,0,4,0,22
Egypt,2008-10-01,20,0,0,7,0,27
Egypt,2008-10-01,60,0,-1,3,0,62
Egypt,2008-10-01,24,0,0,0,2,26
Egypt,2008-10-01,27,0,0,7,0,34
Egypt,2008-10-01,22,0,-1,9,0,30
Egypt,2008-10-01,17,0,0,4,8,29
Egypt,2008-10-01,15,0,0,15,6,36
Egypt,2008-10-01,19,0,0,9,10,38
Egypt,2008-10-01,13,0,-2,6,0,17
Egypt,2008-10-01,24,0,-1,0,2,25
Egypt,2008-10-01,36,0,0,2,0,38
Egypt,2008-10-01,74,0,0,-5,3,72
Egypt,2008-10-01,35,0,1,13,4,53
Egypt,2008-10-01,27,0,0,20,0,47
Egypt,2008-10-01,46,0,-1,0,0,45
Egypt,2008-10-01,36,0,3,9,4,52
Egypt,2008-10-01,27,0,2,0,0,29
Egypt,2008-10-01,51,0,0,32,0,83
Egypt,2008-10-01,37,0,0,16,5,58
Egypt,2008-10-01,49,0,-2,-16,5,36
Egypt,2008-10-01,24,0,-2,0,7,29
Eritrea,2008-10-01,3,0,0,0,0,3
Eritrea,2008-10-01,0,0,0,0,0,0
Eritrea,2008-10-01,0,0,0,0,0,0
Eritrea,2008-10-01,0,0,0,0,0,0
Eritrea,2008-10-01,3,0,0,0,0,3
Eritrea,2008-10-01,0,0,0,0,0,0
Eritrea,2008-10-01,2,0,0,9,0,11
Eritrea,2008-10-01,2,0,0,0,0,2
Eritrea,2008-10-01,2,0,0,0,0,2
Eritrea,2008-10-01,0,0,0,12,0,12
Eritrea,2008-10-01,2,0,0,3,0,5
Eritrea,2008-10-01,9,0,0,0,0,9
Eritrea,2008-10-01,-1,0,0,0,0,-1
Eritrea,2008-10-01,1,0,0,-2,1,0
Eritrea,2008-10-01,0,0,0,0,0,0
Eritrea,2008-10-01,3,0,0,0,0,3
Eritrea,2008-10-01,2,0,0,0,0,2
Eritrea,2008-10-01,0,0,0,9,0,9
Eritrea,2008-10-01,3,0,0,0,0,3
Eritrea,2008-10-01,14,0,0,0,0,14
Eritrea,2008-10-01,15,0,0,0,0,15
Eritrea,2008-10-01,4,0,0,0,0,4
Eritrea,2008-10-01,0,0,0,0,0,0
Eritrea,2008-10-01,2,0,0,-1,0,1
Eritrea,2008-10-01,2,0,0,0,0,2
Eritrea,2008-10-01,3,0,0,0,0,3
Eritrea,2008-10-01,0,0,0,0,0,0
Eritrea,2008-10-01,0,0,0,0,0,0
Georgia,2008-10-01,10,2,-1,6,1,18
Georgia,2008-10-01,-2,4,0,0,0,2
Georgia,2008-10-01,5,0,0,6,0,11
Georgia,2008-10-01,7,0,0,3,0,10
Georgia,2008-10-01,0,0,0,0,2,2
Georgia,2008-10-01,15,0,0,-8,1,8
Georgia,2008-10-01,8,0,0,-2,0,6
Georgia,2008-10-01,3,2,0,0,0,5
Georgia,2008-10-01,14,0,0,0,2,16
Georgia,2008-10-01,8,0,0,-6,0,2
Georgia,2008-10-01,11,0,0,0,10,21
Georgia,2008-10-01,5,0,0,0,0,5
Georgia,2008-10-01,1,0,0,0,1,2
Georgia,2008-10-01,1,0,-1,0,0,0
Georgia,2008-10-01,11,0,1,21,1,34
Georgia,2008-10-01,6,0,0,-3,1,4
Georgia,2008-10-01,4,0,0,0,3,7
Georgia,2008-10-01,3,0,0,0,0,3
Georgia,2008-10-01,0,0,0,0,1,1
Georgia,2008-10-01,1,0,0,8,0,9
Georgia,2008-10-01,1,0,0,0,0,1
Georgia,2008-10-01,10,0,0,9,1,20
Georgia,2008-10-01,9,0,0,-10,1,0
Georgia,2008-10-01,21,2,1,5,3,32
Georgia,2008-10-01,8,0,0,3,1,12
Georgia,2008-10-01,0,0,0,9,0,9
Georgia,2008-10-01,19,0,0,0,1,20
Georgia,2008-10-01,6,0,0,3,1,10
Georgia,2008-10-01,0,0,0,0,1,1
Georgia,2008-10-01,18,0,0,9,5,32
Georgia,2008-10-01,9,0,1,3,0,13
India,2008-10-01,33,2,-6,10,2,41
India,2008-10-01,33,2,-3,15,0,47
India,2008-10-01,46,0,-2,13,10,67
India,2008-10-01,19,2,-1,3,10,33
India,2008-10-01,57,0,-2,19,3,77
India,2008-10-01,35,0,-1,8,1,43
India,2008-10-01,10,0,-2,11,12,31
India,2008-10-01,35,2,0,31,4,72
India,2008-10-01,5,0,0,18,3,26
India,2008-10-01,36,0,1,0,2,39
India,2008-10-01,17,2,-2,8,0,25
India,2008-10-01,58,0,0,12,9,79
India,2008-10-01,44,2,2,17,0,65
India,2008-10-01,29,0,-4,16,1,42
India,2008-10-01,47,0,0,17,3,67
India,2008-10-01,19,0,0,0,1,20
India,2008-10-01,10,0,0,1,6,17
India,2008-10-01,16,0,0,9,3,28
India,2008-10-01,0,0,0,0,2,2
India,2008-10-01,11,0,0,15,2,28
India,2008-10-01,18,0,1,6,2,27
India,2008-10-01,48,0,0,16,4,68
India,2008-10-01,31,0,1,21,5,58
India,2008-10-01,26,0,0,7,10,43
India,2008-10-01,19,0,0,13,5,37
India,2008-10-01,28,0,0,17,2,47
India,2008-10-01,19,2,0,22,19,62
India,2008-10-01,33,0,0,12,4,49
India,2008-10-01,102,0,-4,-3,4,99
India,2008-10-01,50,0,0,19,24,93
India,2008-10-01,68,0,0,20,4,92
Iran,2008-10-01,34,0,0,-2,12,44
Iran,2008-10-01,24,0,0,0,10,34
Iran,2008-10-01,16,0,0,-2,5,19
Iran,2008-10-01,43,0,0,6,0,49
Iran,2008-10-01,33,0,0,1,5,39
Iran,2008-10-01,30,0,0,7,1,38
Iran,2008-10-01,40,2,0,5,1,48
Iran,2008-10-01,20,0,0,0,0,20
Iran,2008-10-01,45,2,1,14,13,75
Iran,2008-10-01,10,0,-4,2,9,17
Iran,2008-10-01,33,0,0,-11,5,27
Iran,2008-10-01,16,0,0,6,1,23
Iran,2008-10-01,13,0,0,19,0,32
Iran,2008-10-01,20,0,0,8,3,31
Iran,2008-10-01,23,0,0,0,9,32
Iran,2008-10-01,13,0,1,24,5,43
Iran,2008-10-01,32,0,0,1,3,36
Iran,2008-10-01,35,0,0,14,4,53
Iran,2008-10-01,4,0,0,12,5,21
Iran,2008-10-01,10,0,0,12,3,25
Iran,2008-10-01,33,0,0,12,4,49
Iran,2008-10-01,61,0,0,10,1,72
Iran,2008-10-01,29,0,-1,6,5,39
Iran,2008-10-01,38,0,0,12,1,51
Iran,2008-10-01,19,0,0,5,11,35
Iran,2008-10-01,11,0,2,6,0,19
Iran,2008-10-01,26,0,0,24,20,70
Iran,2008-10-01,36,0,2,15,4,57
Iran,2008-10-01,34,0,-3,3,2,36
Iran,2008-10-01,42,0,0,4,3,49
Iran,2008-10-01,41,0,1,18,2,62
Iraq,2008-10-01,147,0,-1,24,7,177
Iraq,2008-10-01,68,0,1,6,2,77
Iraq,2008-10-01,177,0,-1,28,3,207
Iraq,2008-10-01,298,0,0,49,10,357
Iraq,2008-10-01,409,2,1,42,15,469
Iraq,2008-10-01,357,0,1,22,27,407
Iraq,2008-10-01,197,0,0,11,8,216
Iraq,2008-10-01,256,0,0,27,16,299
Iraq,2008-10-01,165,0,0,36,7,208
Iraq,2008-10-01,157,0,-2,19,23,197
Iraq,2008-10-01,148,2,-2,7,10,165
Iraq,2008-10-01,239,0,-1,39,4,281
Iraq,2008-10-01,212,2,0,29,22,265
Iraq,2008-10-01,107,0,0,23,12,142
Iraq,2008-10-01,183,0,0,27,5,215
Iraq,2008-10-01,145,2,-1,73,2,221
Iraq,2008-10-01,154,0,-3,49,12,212
Iraq,2008-10-01,48,0,-2,11,2,59
Iraq,2008-10-01,38,0,0,9,11,58
Iraq,2008-10-01,72,0,-6,45,4,115
Iraq,2008-10-01,78,4,0,23,6,111
Iraq,2008-10-01,94,0,-1,7,8,108
Iraq,2008-10-01,168,6,-1,17,15,205
Iraq,2008-10-01,121,0,0,4,6,131
Iraq,2008-10-01,100,0,0,10,19,129
Iraq,2008-10-01,193,0,3,20,6,222
Iraq,2008-10-01,423,0,2,19,24,468
Iraq,2008-10-01,372,0,-6,50,23,439
Iraq,2008-10-01,262,0,-1,57,22,340
Iraq,2008-10-01,225,0,-1,62,35,321
Iraq,2008-10-01,216,0,0,33,24,273
Morocco,2008-10-01,4,0,0,-6,0,-2
Morocco,2008-10-01,0,0,0,0,0,0
Morocco,2008-10-01,6,0,0,9,0,15
Morocco,2008-10-01,1,0,0,0,0,1
Morocco,2008-10-01,2,0,0,3,0,5
Morocco,2008-10-01,4,0,0,3,3,10
Morocco,2008-10-01,18,0,0,4,0,22
Morocco,2008-10-01,2,0,0,0,0,2
Morocco,2008-10-01,19,0,0,-2,0,17
Morocco,2008-10-01,3,0,0,0,0,3
Morocco,2008-10-01,2,0,0,0,0,2
Morocco,2008-10-01,1,0,0,0,0,1
Morocco,2008-10-01,2,0,0,0,1,3
Morocco,2008-10-01,2,0,0,8,0,10
Morocco,2008-10-01,75,0,0,4,0,79
Morocco,2008-10-01,54,0,0,15,2,71
Morocco,2008-10-01,3,0,0,9,0,12
Morocco,2008-10-01,3,0,0,0,0,3
Morocco,2008-10-01,0,0,0,0,4,4
Morocco,2008-10-01,0,0,0,0,0,0
Morocco,2008-10-01,10,0,0,24,1,35
Morocco,2008-10-01,0,0,0,12,0,12
Morocco,2008-10-01,0,0,0,0,0,0
Morocco,2008-10-01,3,0,0,6,0,9
Morocco,2008-10-01,6,0,0,6,0,12
Morocco,2008-10-01,0,0,0,0,0,0
Morocco,2008-10-01,5,0,0,12,0,17
Morocco,2008-10-01,0,0,0,0,0,0
Morocco,2008-10-01,3,0,0,3,0,6
Morocco,2008-10-01,0,0,0,12,0,12
Morocco,2008-10-01,15,0,0,56,1,72
Nigeria,2008-10-01,5,0,0,0,0,5
Nigeria,2008-10-01,-3,0,0,0,1,-2
Nigeria,2008-10-01,-1,0,0,0,0,-1
Nigeria,2008-10-01,0,0,0,0,0,0
Nigeria,2008-10-01,6,0,0,0,0,6
Nigeria,2008-10-01,1,0,0,-8,0,-7
Nigeria,2008-10-01,6,0,0,9,4,19
Nigeria,2008-10-01,17,0,0,9,0,26
Nigeria,2008-10-01,12,0,1,-3,3,13
Nigeria,2008-10-01,13,2,0,3,0,18
Nigeria,2008-10-01,3,0,0,6,0,9
Nigeria,2008-10-01,3,0,0,-2,1,2
Nigeria,2008-10-01,0,0,0,-2,0,-2
Nigeria,2008-10-01,1,0,0,-1,2,2
Nigeria,2008-10-01,8,0,0,-4,0,4
Nigeria,2008-10-01,15,2,0,-2,6,21
Nigeria,2008-10-01,0,0,0,0,0,0
Nigeria,2008-10-01,11,0,0,6,0,17
Nigeria,2008-10-01,0,2,0,0,0,2
Nigeria,2008-10-01,1,0,0,9,7,17
Nigeria,2008-10-01,7,0,0,0,0,7
Nigeria,2008-10-01,4,0,2,6,0,12
Nigeria,2008-10-01,2,0,0,21,2,25
Nigeria,2008-10-01,7,0,0,17,0,24
Nigeria,2008-10-01,-4,0,0,3,0,-1
Nigeria,2008-10-01,25,4,0,3,0,32
Nigeria,2008-10-01,24,0,2,4,1,31
Nigeria,2008-10-01,0,0,0,9,0,9
Nigeria,2008-10-01,21,0,0,3,18,42
Nigeria,2008-10-01,14,0,0,1,2,17
Pakistan,2008-10-01,82,4,1,7,5,99
Pakistan,2008-10-01,55,0,0,-2,3,56
Pakistan,2008-10-01,42,0,1,23,0,66
Pakistan,2008-10-01,55,0,2,15,1,73
Pakistan,2008-10-01,31,4,0,22,0,57
Pakistan,2008-10-01,92,4,-2,23,17,134
Pakistan,2008-10-01,22,0,-3,-8,0,11
Pakistan,2008-10-01,70,0,-6,-6,0,58
Pakistan,2008-10-01,24,0,-1,-24,10,9
Pakistan,2008-10-01,78,2,0,14,1,95
Pakistan,2008-10-01,37,2,0,1,8,48
Pakistan,2008-10-01,54,0,0,10,3,67
Pakistan,2008-10-01,72,0,0,6,0,78
Pakistan,2008-10-01,62,0,2,36,2,102
Pakistan,2008-10-01,47,6,0,42,4,99
Pakistan,2008-10-01,46,2,0,23,0,71
Pakistan,2008-10-01,14,0,0,0,13,27
Pakistan,2008-10-01,5,0,0,-9,0,-4
Pakistan,2008-10-01,29,0,0,0,4,33
Pakistan,2008-10-01,16,0,0,12,0,28
Pakistan,2008-10-01,18,0,0,30,0,48
Pakistan,2008-10-01,64,0,0,31,1,96
Pakistan,2008-10-01,106,0,0,100,12,218
Pakistan,2008-10-01,75,0,0,21,3,99
Pakistan,2008-10-01,95,2,0,10,3,110
Pakistan,2008-10-01,31,0,0,-2,3,32
Pakistan,2008-10-01,40,0,0,12,21,73
Pakistan,2008-10-01,82,0,-3,3,3,85
Pakistan,2008-10-01,82,4,0,70,9,165
Pakistan,2008-10-01,69,6,1,24,16,116
Pakistan,2008-10-01,97,6,0,41,31,175
Sierra Leone,2008-10-01,7,0,0,27,0,34
Sierra Leone,2008-10-01,2,0,0,12,0,14
Sierra Leone,2008-10-01,0,0,0,9,0,9
Sierra Leone,2008-10-01,0,0,0,18,0,18
Sierra Leone,2008-10-01,0,0,0,9,0,9
Sierra Leone,2008-10-01,1,0,0,3,0,4
Sierra Leone,2008-10-01,0,0,0,0,0,0
Sierra Leone,2008-10-01,0,0,0,0,0,0
Sierra Leone,2008-10-01,0,0,0,0,0,0
Sierra Leone,2008-10-01,4,0,0,21,0,25
Sierra Leone,2008-10-01,15,0,0,0,0,15
Sierra Leone,2008-10-01,10,0,0,-4,0,6
Sierra Leone,2008-10-01,8,0,0,0,0,8
Sierra Leone,2008-10-01,4,0,0,0,0,4
Sierra Leone,2008-10-01,2,0,0,0,0,2
Sierra Leone,2008-10-01,0,0,0,0,2,2
Sierra Leone,2008-10-01,0,0,0,0,1,1
Sierra Leone,2008-10-01,0,0,1,0,0,1
Sierra Leone,2008-10-01,0,0,0,0,0,0
Sierra Leone,2008-10-01,0,0,0,0,0,0
Sierra Leone,2008-10-01,0,0,0,0,0,0
Sierra Leone,2008-10-01,0,0,0,6,0,6
Sierra Leone,2008-10-01,0,0,0,3,0,3
Sierra Leone,2008-10-01,1,0,0,3,0,4
Somalia,2008-10-01,92,2,0,38,4,136
Somalia,2008-10-01,57,2,1,15,3,78
Somalia,2008-10-01,28,0,0,17,0,45
Somalia,2008-10-01,13,0,0,4,2,19
Somalia,2008-10-01,9,0,0,18,1,28
Somalia,2008-10-01,52,0,0,43,6,101
Somalia,2008-10-01,59,0,1,3,8,71
Somalia,2008-10-01,25,0,0,7,3,35
Somalia,2008-10-01,57,0,0,-48,4,13
Somalia,2008-10-01,68,0,0,-9,5,64
Somalia,2008-10-01,19,0,0,-2,2,19
Somalia,2008-10-01,8,0,0,0,2,10
Somalia,2008-10-01,44,2,0,7,4,57
Somalia,2008-10-01,43,0,0,6,3,52
Somalia,2008-10-01,41,0,0,-6,0,35
Somalia,2008-10-01,10,0,0,-1,4,13
Somalia,2008-10-01,26,2,0,16,4,48
Somalia,2008-10-01,4,0,0,9,2,15
Somalia,2008-10-01,10,0,5,-4,0,11
Somalia,2008-10-01,19,0,0,0,8,27
Somalia,2008-10-01,35,0,0,0,1,36
Somalia,2008-10-01,29,2,0,5,2,38
Somalia,2008-10-01,21,2,0,-1,0,22
Somalia,2008-10-01,21,0,0,12,3,36
Somalia,2008-10-01,9,0,0,12,0,21
Somalia,2008-10-01,10,0,0,6,0,16
Somalia,2008-10-01,5,0,0,9,1,15
Somalia,2008-10-01,18,0,0,4,2,24
Somalia,2008-10-01,79,0,0,-12,28,95
Somalia,2008-10-01,43,0,0,15,4,62
Somalia,2008-10-01,3,0,0,5,2,10
Syria,2008-10-01,8,2,0,0,1,11
Syria,2008-10-01,7,0,0,12,5,24
Syria,2008-10-01,3,8,0,21,0,32
Syria,2008-10-01,10,2,0,0,0,12
Syria,2008-10-01,34,0,1,0,0,35
Syria,2008-10-01,22,2,0,0,0,24
Syria,2008-10-01,7,0,2,6,1,16
Syria,2008-10-01,19,0,0,0,1,20
Syria,2008-10-01,24,0,0,16,0,40
Syria,2008-10-01,29,2,0,7,2,40
Syria,2008-10-01,12,0,0,-2,1,11
Syria,2008-10-01,24,0,0,13,2,39
Syria,2008-10-01,23,0,0,6,4,33
Syria,2008-10-01,15,0,0,2,2,19
Syria,2008-10-01,22,0,0,1,0,23
Syria,2008-10-01,-2,0,0,0,0,-2
Syria,2008-10-01,-5,0,0,15,1,11
Syria,2008-10-01,7,2,0,0,0,9
Syria,2008-10-01,4,0,0,9,2,15
Syria,2008-10-01,12,0,0,18,2,32
Syria,2008-10-01,31,0,0,9,0,40
Syria,2008-10-01,6,0,1,27,2,36
Syria,2008-10-01,16,0,0,30,6,52
Syria,2008-10-01,16,0,0,24,1,41
Syria,2008-10-01,5,0,0,24,2,31
Syria,2008-10-01,81,0,2,6,0,89
Syria,2008-10-01,464,0,3,28,36,531
Syria,2008-10-01,285,0,-1,7,12,303
Syria,2008-10-01,112,0,1,0,8,121
Syria,2008-10-01,66,0,-1,2,10,77
Syria,2008-10-01,49,0,0,3,0,52
Yemen,2008-10-01,1,0,0,7,3,11
Yemen,2008-10-01,0,0,0,3,0,3
Yemen,2008-10-01,10,0,0,45,0,55
Yemen,2008-10-01,7,0,0,16,0,23
Yemen,2008-10-01,15,0,0,5,0,20
Yemen,2008-10-01,4,0,0,3,0,7
Yemen,2008-10-01,1,0,0,3,0,4
Yemen,2008-10-01,0,0,0,0,0,0
Yemen,2008-10-01,15,0,0,0,0,15
Yemen,2008-10-01,0,0,0,0,0,0
Yemen,2008-10-01,0,0,0,-2,0,-2
Yemen,2008-10-01,2,0,0,6,0,8
Yemen,2008-10-01,0,0,0,0,0,0
Yemen,2008-10-01,0,0,0,0,0,0
Yemen,2008-10-01,0,0,0,10,0,10
Yemen,2008-10-01,0,0,0,0,0,0
Yemen,2008-10-01,10,0,0,3,0,13
Yemen,2008-10-01,0,0,0,0,0,0
Yemen,2008-10-01,0,0,0,0,0,0
Yemen,2008-10-01,2,0,0,3,0,5
Yemen,2008-10-01,1,0,0,21,0,22
Yemen,2008-10-01,0,0,0,6,0,6
Yemen,2008-10-01,6,0,0,63,16,85
Yemen,2008-10-01,25,0,0,12,9,46
Yemen,2008-10-01,1,0,0,0,0,1
Yemen,2008-10-01,33,0,0,34,0,67
Yemen,2008-10-01,50,0,0,6,3,59
Yemen,2008-10-01,16,0,0,9,0,25
Yemen,2008-10-01,28,0,0,39,0,67
Yemen,2008-10-01,16,0,0,33,7,56
Afghanistan,2008-04-01,100,0,0,21,9,130
Afghanistan,2008-04-01,39,0,0,3,1,43
Afghanistan,2008-04-01,32,0,-1,1,23,55
Afghanistan,2008-04-01,17,0,-3,7,4,25
Afghanistan,2008-04-01,219,2,0,49,12,282
Afghanistan,2008-04-01,39,0,0,12,0,51
Afghanistan,2008-04-01,104,0,0,62,0,166
Afghanistan,2008-04-01,145,0,-3,58,9,209
Afghanistan,2008-04-01,96,0,0,23,23,142
Afghanistan,2008-04-01,139,0,-2,39,82,258
Afghanistan,2008-04-01,70,0,-4,54,4,124
Afghanistan,2008-04-01,62,0,1,21,7,91
Afghanistan,2008-04-01,67,0,0,16,6,89
Afghanistan,2008-04-01,176,2,-6,28,6,206
Afghanistan,2008-04-01,98,0,0,17,29,144
Afghanistan,2008-04-01,151,2,-7,-1,13,158
Afghanistan,2008-04-01,168,4,0,64,16,252
Afghanistan,2008-04-01,166,2,0,46,20,234
Afghanistan,2008-04-01,63,2,0,42,6,113
Afghanistan,2008-04-01,103,0,2,17,6,128
Afghanistan,2008-04-01,143,2,0,55,11,211
Afghanistan,2008-04-01,142,10,1,18,30,201
Afghanistan,2008-04-01,137,8,1,29,25,200
Afghanistan,2008-04-01,132,2,-4,43,5,178
Afghanistan,2008-04-01,121,0,-2,22,34,175
Afghanistan,2008-04-01,69,0,0,11,3,83
Afghanistan,2008-04-01,42,2,0,27,4,75
Afghanistan,2008-04-01,135,0,-10,-5,6,126
Afghanistan,2008-04-01,52,0,1,18,3,74
Afghanistan,2008-04-01,170,8,0,29,14,221
Albania,2008-04-01,11,0,-2,3,0,12
Albania,2008-04-01,11,0,0,20,0,31
Albania,2008-04-01,0,0,-5,30,17,42
Albania,2008-04-01,21,0,-1,15,1,36
Albania,2008-04-01,27,0,-3,27,2,53
Albania,2008-04-01,0,0,-2,0,0,-2
Albania,2008-04-01,8,0,-2,6,1,13
Albania,2008-04-01,8,0,0,4,1,13
Albania,2008-04-01,24,0,-7,2,0,19
Albania,2008-04-01,17,0,-1,-2,2,16
Albania,2008-04-01,-4,0,0,-2,0,-6
Albania,2008-04-01,17,0,0,16,3,36
Albania,2008-04-01,8,0,0,0,0,8
Albania,2008-04-01,7,0,-2,3,0,8
Albania,2008-04-01,8,0,0,6,0,14
Albania,2008-04-01,13,0,0,18,0,31
Albania,2008-04-01,19,0,0,6,0,25
Albania,2008-04-01,29,0,0,3,0,32
Albania,2008-04-01,0,0,0,0,-4,-4
Albania,2008-04-01,2,0,0,0,0,2
Albania,2008-04-01,3,0,0,0,0,3
Albania,2008-04-01,7,0,-2,9,2,16
Albania,2008-04-01,5,0,0,6,0,11
Albania,2008-04-01,0,0,0,0,0,0
Albania,2008-04-01,0,0,0,0,0,0
Albania,2008-04-01,0,0,0,0,0,0
Albania,2008-04-01,4,0,0,0,0,4
Albania,2008-04-01,6,0,0,2,0,8
Albania,2008-04-01,0,0,0,0,1,1
Albania,2008-04-01,12,0,0,-2,0,10
Algeria,2008-04-01,7,0,0,3,0,10
Algeria,2008-04-01,5,0,0,7,0,12
Algeria,2008-04-01,0,0,0,0,0,0
Algeria,2008-04-01,2,0,0,0,0,2
Algeria,2008-04-01,8,0,0,0,3,11
Algeria,2008-04-01,2,0,0,3,3,8
Algeria,2008-04-01,13,0,0,2,8,23
Algeria,2008-04-01,21,0,0,23,0,44
Algeria,2008-04-01,16,0,0,3,0,19
Algeria,2008-04-01,9,0,0,6,0,15
Algeria,2008-04-01,4,0,0,0,0,4
Algeria,2008-04-01,0,0,0,0,0,0
Algeria,2008-04-01,2,0,0,-1,0,1
Algeria,2008-04-01,2,0,0,0,1,3
Algeria,2008-04-01,2,0,0,0,0,2
Algeria,2008-04-01,8,0,0,6,0,14
Algeria,2008-04-01,0,0,0,0,1,1
Algeria,2008-04-01,0,0,0,-2,0,-2
Algeria,2008-04-01,2,0,0,0,0,2
Algeria,2008-04-01,15,0,0,0,1,16
Algeria,2008-04-01,0,0,0,0,0,0
Algeria,2008-04-01,1,0,0,-4,0,-3
Algeria,2008-04-01,2,0,0,-4,2,0
Algeria,2008-04-01,0,0,0,6,0,6
Algeria,2008-04-01,6,0,0,0,0,6
Algeria,2008-04-01,2,0,0,0,2,4
Algeria,2008-04-01,4,0,1,0,0,5
Algeria,2008-04-01,2,0,0,0,0,2
Algeria,2008-04-01,26,0,0,0,1,27
Bangladesh,2008-04-01,3,0,0,6,0,9
Bangladesh,2008-04-01,3,0,0,6,0,9
Bangladesh,2008-04-01,0,0,0,9,0,9
Bangladesh,2008-04-01,0,0,0,0,0,0
Bangladesh,2008-04-01,9,0,0,0,0,9
Bangladesh,2008-04-01,0,0,0,3,0,3
Bangladesh,2008-04-01,-1,0,0,6,0,5
Bangladesh,2008-04-01,24,0,-4,2,0,22
Bangladesh,2008-04-01,8,0,0,9,0,17
Bangladesh,2008-04-01,3,0,0,9,0,12
Bangladesh,2008-04-01,-1,0,0,10,1,10
Bangladesh,2008-04-01,2,0,0,0,0,2
Bangladesh,2008-04-01,0,0,-2,3,0,1
Bangladesh,2008-04-01,11,0,0,6,0,17
Bangladesh,2008-04-01,4,0,0,0,1,5
Bangladesh,2008-04-01,9,0,1,4,2,16
Bangladesh,2008-04-01,15,4,0,-6,3,16
Bangladesh,2008-04-01,0,0,0,0,0,0
Bangladesh,2008-04-01,0,2,0,3,0,5
Bangladesh,2008-04-01,4,2,0,3,0,9
Bangladesh,2008-04-01,14,0,0,9,1,24
Bangladesh,2008-04-01,49,0,0,3,8,60
Bangladesh,2008-04-01,14,2,1,9,1,27
Bangladesh,2008-04-01,7,2,0,0,0,9
Bangladesh,2008-04-01,6,0,0,3,1,10
Bangladesh,2008-04-01,9,0,0,3,0,12
Bangladesh,2008-04-01,8,0,-2,3,0,9
Bangladesh,2008-04-01,8,0,0,3,2,13
Bangladesh,2008-04-01,-1,0,0,2,0,1
Bangladesh,2008-04-01,10,0,0,0,11,21
Cameroon,2008-04-01,4,0,0,0,0,4
Cameroon,2008-04-01,3,0,0,3,0,6
Cameroon,2008-04-01,1,0,0,0,0,1
Cameroon,2008-04-01,4,0,0,-4,2,2
Cameroon,2008-04-01,0,0,0,0,0,0
Cameroon,2008-04-01,0,0,0,3,0,3
Cameroon,2008-04-01,0,0,-3,0,5,2
Cameroon,2008-04-01,3,0,0,-2,1,2
Cameroon,2008-04-01,2,0,0,0,0,2
Cameroon,2008-04-01,9,0,0,-2,2,9
Cameroon,2008-04-01,0,0,0,-8,0,-8
Cameroon,2008-04-01,0,0,0,0,0,0
Cameroon,2008-04-01,2,0,0,27,4,33
Cameroon,2008-04-01,0,0,0,0,0,0
Cameroon,2008-04-01,3,0,0,3,1,7
Cameroon,2008-04-01,0,0,0,0,0,0
Cameroon,2008-04-01,0,0,0,0,0,0
Cameroon,2008-04-01,0,0,0,-2,0,-2
Cameroon,2008-04-01,0,0,0,0,0,0
Cameroon,2008-04-01,2,0,0,3,0,5
Cameroon,2008-04-01,8,2,0,3,0,13
Cameroon,2008-04-01,2,0,0,0,0,2
Cameroon,2008-04-01,0,0,0,0,1,1
Cameroon,2008-04-01,1,0,0,0,0,1
Cameroon,2008-04-01,0,0,0,0,0,0
Cameroon,2008-04-01,0,0,0,0,0,0
China,2008-04-01,64,2,-1,50,18,133
China,2008-04-01,11,0,0,4,0,15
China,2008-04-01,8,0,0,3,6,17
China,2008-04-01,12,0,0,9,3,24
China,2008-04-01,56,0,1,47,19,123
China,2008-04-01,2,0,0,11,4,17
China,2008-04-01,62,8,-4,36,9,111
China,2008-04-01,114,2,-2,36,22,172
China,2008-04-01,150,0,2,23,10,185
China,2008-04-01,75,0,-2,12,18,103
China,2008-04-01,81,2,1,58,20,162
China,2008-04-01,48,0,0,14,9,71
China,2008-04-01,34,0,0,28,5,67
China,2008-04-01,53,0,1,19,18,91
China,2008-04-01,127,6,1,70,30,234
China,2008-04-01,87,0,-2,45,35,165
China,2008-04-01,98,2,4,45,25,174
China,2008-04-01,83,0,2,17,14,116
China,2008-04-01,43,4,0,32,10,89
China,2008-04-01,42,0,3,0,10,55
China,2008-04-01,56,0,2,58,22,138
China,2008-04-01,106,0,4,72,33,215
China,2008-04-01,64,0,2,36,4,106
China,2008-04-01,42,0,0,28,12,82
China,2008-04-01,103,0,-2,82,27,210
China,2008-04-01,102,0,-2,6,6,112
China,2008-04-01,38,2,0,12,11,63
China,2008-04-01,70,4,-2,58,7,137
China,2008-04-01,36,0,2,28,0,66
China,2008-04-01,42,0,0,19,2,63
Egypt,2008-04-01,55,0,1,16,2,74
Egypt,2008-04-01,-1,0,0,9,0,8
Egypt,2008-04-01,9,0,0,0,1,10
Egypt,2008-04-01,7,0,0,15,1,23
Egypt,2008-04-01,8,0,0,9,2,19
Egypt,2008-04-01,12,0,0,1,0,13
Egypt,2008-04-01,44,0,1,24,3,72
Egypt,2008-04-01,99,0,13,13,15,140
Egypt,2008-04-01,73,0,13,10,4,100
Egypt,2008-04-01,50,0,9,4,6,69
Egypt,2008-04-01,28,0,-1,18,4,49
Egypt,2008-04-01,11,0,2,1,1,15
Egypt,2008-04-01,32,0,0,7,0,39
Egypt,2008-04-01,42,0,-2,24,3,67
Egypt,2008-04-01,42,0,1,39,7,89
Egypt,2008-04-01,61,4,0,40,15,120
Egypt,2008-04-01,80,4,0,49,3,136
Egypt,2008-04-01,53,0,0,15,5,73
Egypt,2008-04-01,38,0,1,4,4,47
Egypt,2008-04-01,50,4,3,3,8,68
Egypt,2008-04-01,79,0,0,11,13,103
Egypt,2008-04-01,122,4,0,7,3,136
Egypt,2008-04-01,132,0,3,10,3,148
Egypt,2008-04-01,62,0,0,3,1,66
Egypt,2008-04-01,43,0,1,3,5,52
Egypt,2008-04-01,19,0,0,5,1,25
Egypt,2008-04-01,30,0,0,4,0,34
Egypt,2008-04-01,69,0,0,12,8,89
Egypt,2008-04-01,7,0,0,12,0,19
Egypt,2008-04-01,13,0,0,0,2,15
Eritrea,2008-04-01,0,0,0,0,0,0
Eritrea,2008-04-01,0,0,0,2,0,2
Eritrea,2008-04-01,1,0,0,6,0,7
Eritrea,2008-04-01,-1,0,0,0,0,-1
Eritrea,2008-04-01,9,0,0,3,2,14
Eritrea,2008-04-01,-12,0,0,3,2,-7
Eritrea,2008-04-01,0,0,1,6,0,7
Eritrea,2008-04-01,19,0,0,0,0,19
Eritrea,2008-04-01,26,0,0,0,0,26
Eritrea,2008-04-01,0,0,0,15,0,15
Eritrea,2008-04-01,0,0,0,0,0,0
Eritrea,2008-04-01,0,0,1,0,0,1
Eritrea,2008-04-01,4,0,0,0,0,4
Eritrea,2008-04-01,6,0,0,0,0,6
Eritrea,2008-04-01,3,0,0,0,0,3
Eritrea,2008-04-01,20,0,0,27,0,47
Eritrea,2008-04-01,7,0,0,15,0,22
Eritrea,2008-04-01,16,0,0,0,0,16
Eritrea,2008-04-01,0,0,0,-6,0,-6
Eritrea,2008-04-01,0,0,0,0,0,0
Eritrea,2008-04-01,0,0,0,0,0,0
Eritrea,2008-04-01,0,0,0,0,0,0
Eritrea,2008-04-01,12,0,0,3,0,15
Georgia,2008-04-01,0,0,0,7,1,8
Georgia,2008-04-01,7,0,1,0,0,8
Georgia,2008-04-01,2,0,0,3,0,5
Georgia,2008-04-01,-1,0,0,0,0,-1
Georgia,2008-04-01,24,0,0,1,2,27
Georgia,2008-04-01,0,0,0,0,0,0
Georgia,2008-04-01,0,0,0,-2,0,-2
Georgia,2008-04-01,3,0,0,-4,2,1
Georgia,2008-04-01,14,0,0,0,1,15
Georgia,2008-04-01,4,0,0,3,1,8
Georgia,2008-04-01,12,0,0,9,2,23
Georgia,2008-04-01,6,0,1,6,0,13
Georgia,2008-04-01,0,0,0,9,2,11
Georgia,2008-04-01,9,0,0,-4,0,5
Georgia,2008-04-01,9,0,0,0,3,12
Georgia,2008-04-01,5,0,0,3,0,8
Georgia,2008-04-01,15,0,0,0,0,15
Georgia,2008-04-01,1,0,-2,3,1,3
Georgia,2008-04-01,2,0,0,3,2,7
Georgia,2008-04-01,6,0,0,0,0,6
Georgia,2008-04-01,9,0,0,14,1,24
Georgia,2008-04-01,15,2,0,3,0,20
Georgia,2008-04-01,17,0,0,7,3,27
Georgia,2008-04-01,24,0,0,-2,0,22
Georgia,2008-04-01,6,0,0,1,0,7
Georgia,2008-04-01,4,0,0,0,0,4
Georgia,2008-04-01,4,0,0,0,0,4
Georgia,2008-04-01,6,0,0,0,0,6
Georgia,2008-04-01,6,0,0,0,0,6
Georgia,2008-04-01,13,0,0,-7,3,9
India,2008-04-01,10,2,1,27,5,45
India,2008-04-01,0,0,0,0,0,0
India,2008-04-01,5,0,0,12,0,17
India,2008-04-01,10,0,0,3,0,13
India,2008-04-01,36,0,-2,15,5,54
India,2008-04-01,3,0,0,0,0,3
India,2008-04-01,20,4,0,4,4,32
India,2008-04-01,57,0,-2,11,5,71
India,2008-04-01,19,0,-2,14,9,40
India,2008-04-01,56,0,-1,21,19,95
India,2008-04-01,43,0,2,26,10,81
India,2008-04-01,27,0,0,14,9,50
India,2008-04-01,5,0,-1,0,2,6
India,2008-04-01,33,2,-4,6,5,42
India,2008-04-01,23,0,-1,8,4,34
India,2008-04-01,42,0,0,23,9,74
India,2008-04-01,42,0,0,14,14,70
India,2008-04-01,65,0,0,37,7,109
India,2008-04-01,52,2,-1,12,5,70
India,2008-04-01,24,0,-4,19,3,42
India,2008-04-01,14,0,-4,15,6,31
India,2008-04-01,29,0,0,14,5,48
India,2008-04-01,41,0,0,2,4,47
India,2008-04-01,14,0,0,22,1,37
India,2008-04-01,33,0,1,22,7,63
India,2008-04-01,24,0,0,0,0,24
India,2008-04-01,7,0,0,1,1,9
India,2008-04-01,45,0,-4,21,5,67
India,2008-04-01,12,0,0,10,0,22
India,2008-04-01,48,0,-2,16,2,64
Iran,2008-04-01,29,0,3,6,2,40
Iran,2008-04-01,8,0,0,0,2,10
Iran,2008-04-01,11,0,-1,8,0,18
Iran,2008-04-01,5,0,0,0,1,6
Iran,2008-04-01,74,0,-3,21,10,102
Iran,2008-04-01,35,0,0,0,1,36
Iran,2008-04-01,80,0,-2,23,5,106
Iran,2008-04-01,119,0,0,49,-3,165
Iran,2008-04-01,98,0,-4,28,1,123
Iran,2008-04-01,118,0,3,20,4,145
Iran,2008-04-01,93,0,-2,21,5,117
Iran,2008-04-01,85,0,0,12,9,106
Iran,2008-04-01,40,0,0,17,19,76
Iran,2008-04-01,90,0,0,15,22,127
Iran,2008-04-01,70,0,2,24,6,102
Iran,2008-04-01,29,0,1,9,4,43
Iran,2008-04-01,96,0,3,9,22,130
Iran,2008-04-01,46,0,0,8,4,58
Iran,2008-04-01,74,4,0,7,1,86
Iran,2008-04-01,165,0,0,7,0,172
Iran,2008-04-01,71,0,6,9,5,91
Iran,2008-04-01,114,0,-4,11,10,131
Iran,2008-04-01,70,0,-5,19,13,97
Iran,2008-04-01,63,0,1,12,4,80
Iran,2008-04-01,124,2,-1,22,6,153
Iran,2008-04-01,58,0,0,11,2,71
Iran,2008-04-01,92,0,4,0,0,96
Iran,2008-04-01,78,2,-2,17,2,97
Iran,2008-04-01,14,0,-1,6,0,19
Iran,2008-04-01,57,4,-1,28,0,88
Iraq,2008-04-01,68,0,0,12,0,80
Iraq,2008-04-01,46,0,0,12,3,61
Iraq,2008-04-01,30,0,1,24,5,60
Iraq,2008-04-01,78,2,0,10,10,100
Iraq,2008-04-01,118,0,3,15,18,154
Iraq,2008-04-01,28,0,0,11,4,43
Iraq,2008-04-01,119,2,3,42,18,184
Iraq,2008-04-01,147,4,1,23,26,201
Iraq,2008-04-01,106,2,0,14,39,161
Iraq,2008-04-01,142,0,1,58,28,229
Iraq,2008-04-01,187,0,-2,72,14,271
Iraq,2008-04-01,79,18,0,12,12,121
Iraq,2008-04-01,88,8,1,37,10,144
Iraq,2008-04-01,152,6,-2,-14,18,160
Iraq,2008-04-01,125,4,2,32,19,182
Iraq,2008-04-01,186,6,0,7,11,210
Iraq,2008-04-01,166,0,5,36,31,238
Iraq,2008-04-01,93,4,5,60,9,171
Iraq,2008-04-01,127,8,1,42,9,187
Iraq,2008-04-01,118,8,1,9,10,146
Iraq,2008-04-01,112,6,1,31,9,159
Iraq,2008-04-01,113,8,1,16,17,155
Iraq,2008-04-01,136,2,-8,73,13,216
Iraq,2008-04-01,92,0,1,29,20,142
Iraq,2008-04-01,139,2,0,31,1,173
Iraq,2008-04-01,129,0,0,20,33,182
Iraq,2008-04-01,51,0,0,-13,13,51
Iraq,2008-04-01,162,0,0,39,21,222
Iraq,2008-04-01,51,4,0,5,5,65
Iraq,2008-04-01,211,4,0,20,14,249
Morocco,2008-04-01,0,0,0,0,0,0
Morocco,2008-04-01,6,0,0,9,6,21
Morocco,2008-04-01,0,0,0,3,2,5
Morocco,2008-04-01,0,0,0,0,3,3
Morocco,2008-04-01,0,0,0,0,1,1
Morocco,2008-04-01,6,0,1,0,0,7
Morocco,2008-04-01,21,0,0,0,10,31
Morocco,2008-04-01,0,0,0,0,2,2
Morocco,2008-04-01,0,0,0,0,0,0
Morocco,2008-04-01,0,0,0,6,0,6
Morocco,2008-04-01,0,0,0,0,0,0
Morocco,2008-04-01,0,0,0,0,0,0
Morocco,2008-04-01,4,0,0,0,0,4
Morocco,2008-04-01,-2,0,0,0,0,-2
Morocco,2008-04-01,3,0,0,0,0,3
Morocco,2008-04-01,0,0,0,0,0,0
Morocco,2008-04-01,5,0,0,9,0,14
Morocco,2008-04-01,1,0,0,3,0,4
Morocco,2008-04-01,0,0,0,0,0,0
Morocco,2008-04-01,7,0,0,0,1,8
Morocco,2008-04-01,1,0,0,0,0,1
Morocco,2008-04-01,2,0,0,0,0,2
Morocco,2008-04-01,26,0,0,0,0,26
Morocco,2008-04-01,2,0,0,0,0,2
Morocco,2008-04-01,6,0,0,0,0,6
Morocco,2008-04-01,0,0,0,3,0,3
Morocco,2008-04-01,3,0,1,0,2,6
Morocco,2008-04-01,0,0,0,0,0,0
Nigeria,2008-04-01,-1,0,0,6,0,5
Nigeria,2008-04-01,0,0,0,0,0,0
Nigeria,2008-04-01,6,0,0,3,0,9
Nigeria,2008-04-01,3,0,0,0,0,3
Nigeria,2008-04-01,2,0,0,3,4,9
Nigeria,2008-04-01,0,0,0,0,2,2
Nigeria,2008-04-01,15,0,0,33,0,48
Nigeria,2008-04-01,19,0,-1,9,0,27
Nigeria,2008-04-01,5,0,0,-1,0,4
Nigeria,2008-04-01,10,0,0,6,1,17
Nigeria,2008-04-01,2,0,0,3,0,5
Nigeria,2008-04-01,11,0,0,3,0,14
Nigeria,2008-04-01,17,0,0,33,2,52
Nigeria,2008-04-01,21,0,2,9,1,33
Nigeria,2008-04-01,9,2,-2,15,1,25
Nigeria,2008-04-01,-1,0,-2,0,0,-3
Nigeria,2008-04-01,1,0,0,0,7,8
Nigeria,2008-04-01,5,0,0,6,2,13
Nigeria,2008-04-01,4,0,0,0,0,4
Nigeria,2008-04-01,7,0,0,-12,0,-5
Nigeria,2008-04-01,34,0,0,10,2,46
Nigeria,2008-04-01,45,2,1,9,2,59
Nigeria,2008-04-01,38,0,1,6,2,47
Nigeria,2008-04-01,4,0,0,24,2,30
Nigeria,2008-04-01,5,0,-12,0,0,-7
Nigeria,2008-04-01,6,0,-12,0,2,-4
Nigeria,2008-04-01,15,0,0,3,2,20
Nigeria,2008-04-01,6,0,0,3,0,9
Nigeria,2008-04-01,9,0,0,0,0,9
Nigeria,2008-04-01,0,0,0,0,1,1
Pakistan,2008-04-01,31,0,0,12,4,47
Pakistan,2008-04-01,17,0,0,9,2,28
Pakistan,2008-04-01,14,0,0,16,0,30
Pakistan,2008-04-01,0,0,0,6,4,10
Pakistan,2008-04-01,41,0,2,22,8,73
Pakistan,2008-04-01,32,0,0,36,2,70
Pakistan,2008-04-01,31,0,0,39,11,81
Pakistan,2008-04-01,44,0,-4,35,6,81
Pakistan,2008-04-01,69,0,-2,31,17,115
Pakistan,2008-04-01,65,2,0,25,6,98
Pakistan,2008-04-01,-1,0,0,43,6,48
Pakistan,2008-04-01,18,0,0,0,15,33
Pakistan,2008-04-01,26,0,0,0,3,29
Pakistan,2008-04-01,45,2,0,11,6,64
Pakistan,2008-04-01,39,0,0,11,10,60
Pakistan,2008-04-01,28,2,1,13,7,51
Pakistan,2008-04-01,51,0,2,23,5,81
Pakistan,2008-04-01,35,0,0,-10,5,30
Pakistan,2008-04-01,73,0,0,69,3,145
Pakistan,2008-04-01,24,0,0,15,1,40
Pakistan,2008-04-01,52,0,0,66,4,122
Pakistan,2008-04-01,46,2,0,13,9,70
Pakistan,2008-04-01,96,0,0,16,12,124
Pakistan,2008-04-01,26,0,0,9,0,35
Pakistan,2008-04-01,51,0,1,20,22,94
Pakistan,2008-04-01,27,0,0,19,5,51
Pakistan,2008-04-01,42,0,-4,8,5,51
Pakistan,2008-04-01,64,0,-1,24,9,96
Pakistan,2008-04-01,38,0,0,9,4,51
Pakistan,2008-04-01,100,0,0,15,11,126
Sierra Leone,2008-04-01,4,0,0,0,0,4
Sierra Leone,2008-04-01,0,0,0,0,0,0
Sierra Leone,2008-04-01,0,0,0,0,0,0
Sierra Leone,2008-04-01,0,0,0,0,0,0
Sierra Leone,2008-04-01,2,0,0,0,0,2
Sierra Leone,2008-04-01,8,0,0,0,0,8
Sierra Leone,2008-04-01,0,0,0,0,0,0
Sierra Leone,2008-04-01,0,0,0,0,0,0
Sierra Leone,2008-04-01,1,0,0,0,0,1
Sierra Leone,2008-04-01,0,0,0,0,0,0
Sierra Leone,2008-04-01,0,0,0,0,0,0
Sierra Leone,2008-04-01,0,0,0,0,0,0
Sierra Leone,2008-04-01,0,0,0,0,0,0
Sierra Leone,2008-04-01,0,0,0,0,0,0
Sierra Leone,2008-04-01,-1,0,-2,0,2,-1
Sierra Leone,2008-04-01,0,0,0,0,0,0
Sierra Leone,2008-04-01,0,0,0,0,0,0
Sierra Leone,2008-04-01,0,0,0,0,0,0
Sierra Leone,2008-04-01,0,0,0,0,0,0
Sierra Leone,2008-04-01,-3,0,0,0,0,-3
Sierra Leone,2008-04-01,6,0,0,0,0,6
Sierra Leone,2008-04-01,0,0,0,6,0,6
Sierra Leone,2008-04-01,-1,0,-2,0,0,-3
Sierra Leone,2008-04-01,0,0,0,0,0,0
Sierra Leone,2008-04-01,1,0,0,0,0,1
Sierra Leone,2008-04-01,1,0,0,0,0,1
Sierra Leone,2008-04-01,12,0,0,0,0,12
Somalia,2008-04-01,9,0,0,5,0,14
Somalia,2008-04-01,0,0,0,0,0,0
Somalia,2008-04-01,3,0,0,21,0,24
Somalia,2008-04-01,13,0,0,12,0,25
Somalia,2008-04-01,54,0,-1,45,1,99
Somalia,2008-04-01,3,0,0,0,0,3
Somalia,2008-04-01,14,2,0,12,2,30
Somalia,2008-04-01,16,2,0,7,0,25
Somalia,2008-04-01,9,0,0,3,4,16
Somalia,2008-04-01,3,0,0,2,0,5
Somalia,2008-04-01,24,0,0,4,0,28
Somalia,2008-04-01,45,6,0,5,1,57
Somalia,2008-04-01,25,0,0,9,4,38
Somalia,2008-04-01,19,0,0,16,0,35
Somalia,2008-04-01,11,0,1,9,1,22
Somalia,2008-04-01,38,0,1,21,0,60
Somalia,2008-04-01,33,0,1,7,0,41
Somalia,2008-04-01,5,0,1,-1,4,9
Somalia,2008-04-01,9,0,0,1,0,10
Somalia,2008-04-01,28,0,0,26,0,54
Somalia,2008-04-01,81,0,0,18,0,99
Somalia,2008-04-01,56,0,0,14,4,74
Somalia,2008-04-01,37,0,0,25,0,62
Somalia,2008-04-01,2,0,-6,6,0,2
Somalia,2008-04-01,10,0,0,18,0,28
Somalia,2008-04-01,25,0,0,-15,0,10
Somalia,2008-04-01,16,0,1,2,0,19
Somalia,2008-04-01,42,4,1,-6,0,41
Somalia,2008-04-01,9,0,1,5,1,16
Somalia,2008-04-01,20,0,0,0,2,22
Syria,2008-04-01,14,0,0,1,3,18
Syria,2008-04-01,3,0,0,0,1,4
Syria,2008-04-01,0,0,0,0,0,0
Syria,2008-04-01,2,0,0,0,0,2
Syria,2008-04-01,23,0,0,42,3,68
Syria,2008-04-01,5,0,0,0,0,5
Syria,2008-04-01,14,8,0,18,0,40
Syria,2008-04-01,40,0,0,14,0,54
Syria,2008-04-01,2,0,0,-1,2,3
Syria,2008-04-01,28,0,0,21,0,49
Syria,2008-04-01,9,2,0,0,0,11
Syria,2008-04-01,6,0,0,3,0,9
Syria,2008-04-01,17,0,0,3,5,25
Syria,2008-04-01,7,0,1,3,7,18
Syria,2008-04-01,42,0,0,6,0,48
Syria,2008-04-01,31,4,0,0,0,35
Syria,2008-04-01,2,0,0,6,12,20
Syria,2008-04-01,14,0,0,5,4,23
Syria,2008-04-01,-3,0,0,15,0,12
Syria,2008-04-01,30,0,0,9,0,39
Syria,2008-04-01,46,0,0,21,1,68
Syria,2008-04-01,43,0,-2,0,2,43
Syria,2008-04-01,37,0,0,2,2,41
Syria,2008-04-01,59,0,1,-1,2,61
Syria,2008-04-01,137,0,3,24,28,192
Syria,2008-04-01,42,0,2,15,3,62
Syria,2008-04-01,15,0,-1,-4,0,10
Syria,2008-04-01,27,0,2,41,1,71
Syria,2008-04-01,4,0,0,3,0,7
Syria,2008-04-01,24,0,0,3,2,29
Yemen,2008-04-01,9,0,0,0,4,13
Yemen,2008-04-01,0,0,0,0,0,0
Yemen,2008-04-01,0,0,0,6,0,6
Yemen,2008-04-01,3,0,0,-1,0,2
Yemen,2008-04-01,14,0,0,0,0,14
Yemen,2008-04-01,6,0,0,3,0,9
Yemen,2008-04-01,3,0,0,0,13,16
Yemen,2008-04-01,10,0,3,3,0,16
Yemen,2008-04-01,6,0,1,0,1,8
Yemen,2008-04-01,0,0,0,-2,0,-2
Yemen,2008-04-01,12,0,0,3,1,16
Yemen,2008-04-01,5,0,0,0,3,8
Yemen,2008-04-01,2,0,0,0,0,2
Yemen,2008-04-01,1,0,0,3,0,4
Yemen,2008-04-01,7,0,0,0,3,10
Yemen,2008-04-01,14,0,0,6,2,22
Yemen,2008-04-01,31,0,0,3,2,36
Yemen,2008-04-01,0,0,0,0,0,0
Yemen,2008-04-01,8,0,0,0,0,8
Yemen,2008-04-01,25,4,0,8,0,37
Yemen,2008-04-01,27,0,0,3,0,30
Yemen,2008-04-01,13,0,0,0,0,13
Yemen,2008-04-01,13,0,0,3,0,16
Yemen,2008-04-01,0,0,0,9,0,9
Yemen,2008-04-01,6,0,0,0,0,6
Yemen,2008-04-01,17,0,0,24,0,41
Yemen,2008-04-01,9,0,0,12,0,21
Yemen,2008-04-01,22,2,0,12,7,43
Afghanistan,2011-05-01,195,2,-1,40,26,262
Afghanistan,2011-05-01,1051,6,-4,181,84,1318
Afghanistan,2011-05-01,989,2,0,124,31,1146
Afghanistan,2011-05-01,572,8,4,29,37,650
Afghanistan,2011-05-01,626,4,1,41,40,712
Afghanistan,2011-05-01,607,2,-5,53,49,706
Afghanistan,2011-05-01,704,2,5,29,95,835
Afghanistan,2011-05-01,530,0,2,79,93,704
Afghanistan,2011-05-01,329,0,1,46,57,433
Afghanistan,2011-05-01,141,10,-3,33,22,203
Afghanistan,2011-05-01,234,6,-1,11,17,267
Afghanistan,2011-05-01,177,2,9,-2,7,193
Afghanistan,2011-05-01,115,0,-2,11,0,124
Afghanistan,2011-05-01,149,4,0,18,5,176
Afghanistan,2011-05-01,115,0,0,15,0,130
Afghanistan,2011-05-01,54,0,1,18,4,77
Afghanistan,2011-05-01,245,0,-10,78,16,329
Afghanistan,2011-05-01,374,2,-6,46,31,447
Afghanistan,2011-05-01,408,8,1,63,29,509
Afghanistan,2011-05-01,296,6,1,20,18,341
Afghanistan,2011-05-01,152,2,-2,2,10,164
Afghanistan,2011-05-01,93,6,1,13,18,131
Afghanistan,2011-05-01,349,0,2,43,24,418
Afghanistan,2011-05-01,353,0,-1,7,8,367
Afghanistan,2011-05-01,122,0,-3,23,9,151
Afghanistan,2011-05-01,270,6,-8,70,25,363
Afghanistan,2011-05-01,310,0,2,35,36,383
Afghanistan,2011-05-01,520,0,3,23,108,654
Afghanistan,2011-05-01,447,0,2,21,47,517
Afghanistan,2011-05-01,636,4,-15,43,74,742
Afghanistan,2011-05-01,286,0,1,36,15,338
Albania,2011-05-01,-1,0,0,0,0,-1
Albania,2011-05-01,-1,0,0,1,1,1
Albania,2011-05-01,6,0,0,3,0,9
Albania,2011-05-01,4,0,0,0,0,4
Albania,2011-05-01,6,0,0,-4,2,4
Albania,2011-05-01,4,0,0,3,1,8
Albania,2011-05-01,0,0,0,0,0,0
Albania,2011-05-01,4,0,0,0,1,5
Albania,2011-05-01,11,0,0,0,0,11
Albania,2011-05-01,-2,0,0,4,0,2
Albania,2011-05-01,7,0,0,0,0,7
Albania,2011-05-01,21,0,-1,15,3,38
Albania,2011-05-01,11,0,0,2,0,13
Albania,2011-05-01,8,0,0,0,0,8
Albania,2011-05-01,0,0,-4,0,0,-4
Albania,2011-05-01,2,0,0,0,0,2
Albania,2011-05-01,1,0,0,0,0,1
Albania,2011-05-01,2,0,-1,0,0,1
Albania,2011-05-01,2,0,0,3,3,8
Albania,2011-05-01,-4,0,0,-4,0,-8
Albania,2011-05-01,4,0,0,3,0,7
Albania,2011-05-01,0,0,0,0,0,0
Albania,2011-05-01,11,0,0,3,1,15
Albania,2011-05-01,4,0,-1,4,2,9
Albania,2011-05-01,4,0,-1,3,3,9
Albania,2011-05-01,10,0,0,-2,0,8
Albania,2011-05-01,2,0,-1,4,0,5
Albania,2011-05-01,0,0,0,0,0,0
Albania,2011-05-01,1,0,0,0,0,1
Albania,2011-05-01,0,0,0,6,0,6
Albania,2011-05-01,3,0,-1,0,0,2
Algeria,2011-05-01,8,0,0,0,0,8
Algeria,2011-05-01,15,0,0,18,2,35
Algeria,2011-05-01,8,0,0,-2,2,8
Algeria,2011-05-01,-3,0,0,21,0,18
Algeria,2011-05-01,10,0,0,12,0,22
Algeria,2011-05-01,8,0,0,12,0,20
Algeria,2011-05-01,6,0,0,-4,0,2
Algeria,2011-05-01,0,0,1,6,0,7
Algeria,2011-05-01,6,0,0,9,0,15
Algeria,2011-05-01,11,0,0,10,0,21
Algeria,2011-05-01,9,0,0,8,4,21
Algeria,2011-05-01,7,0,-2,-2,1,4
Algeria,2011-05-01,5,0,0,18,0,23
Algeria,2011-05-01,1,0,0,9,2,12
Algeria,2011-05-01,0,0,0,-5,0,-5
Algeria,2011-05-01,0,0,0,3,0,3
Algeria,2011-05-01,0,0,0,-1,0,-1
Algeria,2011-05-01,70,0,0,12,0,82
Algeria,2011-05-01,38,0,0,19,1,58
Algeria,2011-05-01,7,0,0,3,4,14
Algeria,2011-05-01,22,0,0,0,0,22
Algeria,2011-05-01,10,0,0,3,-1,12
Algeria,2011-05-01,0,0,1,-2,1,0
Algeria,2011-05-01,4,0,0,9,2,15
Algeria,2011-05-01,4,0,1,-7,0,-2
Algeria,2011-05-01,63,0,1,25,0,89
Algeria,2011-05-01,8,0,0,4,0,12
Algeria,2011-05-01,4,0,0,0,0,4
Algeria,2011-05-01,11,0,0,-8,2,5
Algeria,2011-05-01,13,0,0,-1,2,14
Algeria,2011-05-01,0,0,0,1,0,1
Bangladesh,2011-05-01,8,4,0,4,0,16
Bangladesh,2011-05-01,5,0,0,0,0,5
Bangladesh,2011-05-01,16,0,-3,15,4,32
Bangladesh,2011-05-01,7,0,-6,15,1,17
Bangladesh,2011-05-01,54,0,1,8,3,66
Bangladesh,2011-05-01,7,0,0,27,6,40
Bangladesh,2011-05-01,14,0,-7,4,0,11
Bangladesh,2011-05-01,1,0,-2,5,1,5
Bangladesh,2011-05-01,9,0,0,0,3,12
Bangladesh,2011-05-01,27,0,0,28,3,58
Bangladesh,2011-05-01,24,0,2,30,1,57
Bangladesh,2011-05-01,27,0,-2,15,1,41
Bangladesh,2011-05-01,26,0,-10,3,0,19
Bangladesh,2011-05-01,5,0,-2,0,0,3
Bangladesh,2011-05-01,3,0,0,3,0,6
Bangladesh,2011-05-01,-3,0,2,1,2,2
Bangladesh,2011-05-01,16,0,0,27,3,46
Bangladesh,2011-05-01,56,0,-12,15,14,73
Bangladesh,2011-05-01,17,0,-4,6,2,21
Bangladesh,2011-05-01,22,2,0,0,2,26
Bangladesh,2011-05-01,12,0,1,0,0,13
Bangladesh,2011-05-01,16,0,0,28,0,44
Bangladesh,2011-05-01,22,0,0,7,0,29
Bangladesh,2011-05-01,6,0,0,-4,0,2
Bangladesh,2011-05-01,6,0,0,-2,4,8
Bangladesh,2011-05-01,13,0,0,1,1,15
Bangladesh,2011-05-01,10,0,0,11,1,22
Bangladesh,2011-05-01,23,0,0,14,2,39
Bangladesh,2011-05-01,2,0,0,3,0,5
Bangladesh,2011-05-01,4,0,0,15,2,21
Bangladesh,2011-05-01,2,2,0,9,6,19
Cameroon,2011-05-01,0,0,0,0,0,0
Cameroon,2011-05-01,0,0,-2,0,0,-2
Cameroon,2011-05-01,0,0,0,0,0,0
Cameroon,2011-05-01,4,0,0,0,0,4
Cameroon,2011-05-01,3,0,0,0,0,3
Cameroon,2011-05-01,0,0,0,0,0,0
Cameroon,2011-05-01,-1,0,0,0,0,-1
Cameroon,2011-05-01,-2,0,0,0,0,-2
Cameroon,2011-05-01,3,0,0,0,0,3
Cameroon,2011-05-01,0,0,0,0,0,0
Cameroon,2011-05-01,0,0,0,3,2,5
Cameroon,2011-05-01,0,0,0,0,0,0
Cameroon,2011-05-01,9,0,0,18,0,27
Cameroon,2011-05-01,0,0,0,0,0,0
Cameroon,2011-05-01,1,0,0,6,0,7
Cameroon,2011-05-01,7,0,0,15,0,22
Cameroon,2011-05-01,8,0,0,3,0,11
Cameroon,2011-05-01,0,0,-2,2,0,0
Cameroon,2011-05-01,3,0,0,6,0,9
Cameroon,2011-05-01,1,0,0,0,0,1
Cameroon,2011-05-01,0,0,0,0,0,0
Cameroon,2011-05-01,0,0,0,-2,0,-2
Cameroon,2011-05-01,0,0,0,0,0,0
Cameroon,2011-05-01,0,0,0,0,0,0
Cameroon,2011-05-01,0,0,0,0,0,0
Cameroon,2011-05-01,0,0,0,3,1,4
China,2011-05-01,106,2,2,21,24,155
China,2011-05-01,105,2,0,78,11,196
China,2011-05-01,157,2,-4,56,15,226
China,2011-05-01,174,6,0,45,17,242
China,2011-05-01,160,2,-1,91,12,264
China,2011-05-01,177,0,2,51,7,237
China,2011-05-01,105,0,-6,33,16,148
China,2011-05-01,88,8,-1,27,10,132
China,2011-05-01,147,0,0,66,5,218
China,2011-05-01,150,10,-6,72,8,234
China,2011-05-01,132,2,-1,62,13,208
China,2011-05-01,60,0,2,15,1,78
China,2011-05-01,46,0,0,29,12,87
China,2011-05-01,37,0,0,15,3,55
China,2011-05-01,15,0,-2,24,2,39
China,2011-05-01,15,0,0,17,5,37
China,2011-05-01,105,2,0,19,6,132
China,2011-05-01,142,0,-6,38,30,204
China,2011-05-01,175,0,-15,160,29,349
China,2011-05-01,106,0,-11,132,18,245
China,2011-05-01,102,4,-10,43,15,154
China,2011-05-01,65,0,0,34,3,102
China,2011-05-01,126,4,1,57,7,195
China,2011-05-01,194,2,1,62,21,280
China,2011-05-01,48,0,1,15,15,79
China,2011-05-01,96,0,-4,24,16,132
China,2011-05-01,106,0,0,100,14,220
China,2011-05-01,119,6,-2,33,8,164
China,2011-05-01,151,4,-6,40,6,195
China,2011-05-01,93,0,2,116,4,215
China,2011-05-01,100,0,0,53,13,166
Egypt,2011-05-01,185,0,-1,24,24,232
Egypt,2011-05-01,290,0,-4,-7,30,309
Egypt,2011-05-01,164,0,-1,48,18,229
Egypt,2011-05-01,86,0,0,75,18,179
Egypt,2011-05-01,465,10,-9,334,95,895
Egypt,2011-05-01,171,0,2,55,39,267
Egypt,2011-05-01,71,0,1,-6,14,80
Egypt,2011-05-01,111,0,0,19,23,153
Egypt,2011-05-01,133,6,-2,71,23,231
Egypt,2011-05-01,747,10,-13,384,117,1245
Egypt,2011-05-01,93,0,-4,65,16,170
Egypt,2011-05-01,85,0,-6,34,24,137
Egypt,2011-05-01,52,0,0,52,28,132
Egypt,2011-05-01,35,0,0,7,3,45
Egypt,2011-05-01,65,0,-4,29,7,97
Egypt,2011-05-01,38,0,-10,12,7,47
Egypt,2011-05-01,82,0,-13,25,6,100
Egypt,2011-05-01,135,0,-10,48,30,203
Egypt,2011-05-01,204,12,7,84,37,344
Egypt,2011-05-01,111,0,2,18,19,150
Egypt,2011-05-01,74,8,-11,35,11,117
Egypt,2011-05-01,36,0,-4,11,2,45
Egypt,2011-05-01,122,0,0,4,9,135
Egypt,2011-05-01,112,2,-3,111,5,227
Egypt,2011-05-01,91,2,-5,51,7,146
Egypt,2011-05-01,132,0,-3,132,17,278
Egypt,2011-05-01,111,4,-5,64,19,193
Egypt,2011-05-01,93,2,-3,68,19,179
Egypt,2011-05-01,88,0,-2,48,15,149
Egypt,2011-05-01,79,0,-4,42,8,125
Egypt,2011-05-01,63,0,-2,37,29,127
Eritrea,2011-05-01,0,0,0,-2,0,-2
Eritrea,2011-05-01,3,0,0,3,0,6
Eritrea,2011-05-01,0,0,0,3,0,3
Eritrea,2011-05-01,0,0,0,0,0,0
Eritrea,2011-05-01,1,0,0,0,0,1
Eritrea,2011-05-01,0,0,0,0,1,1
Eritrea,2011-05-01,5,0,0,0,0,5
Eritrea,2011-05-01,0,0,0,0,0,0
Eritrea,2011-05-01,2,0,0,-1,1,2
Eritrea,2011-05-01,1,0,0,-1,0,0
Eritrea,2011-05-01,24,0,0,3,0,27
Eritrea,2011-05-01,0,0,0,6,0,6
Eritrea,2011-05-01,4,0,0,0,0,4
Eritrea,2011-05-01,0,0,0,0,0,0
Eritrea,2011-05-01,0,0,0,0,0,0
Eritrea,2011-05-01,0,0,0,3,0,3
Eritrea,2011-05-01,2,0,0,0,0,2
Eritrea,2011-05-01,0,0,0,0,0,0
Eritrea,2011-05-01,0,0,0,0,0,0
Eritrea,2011-05-01,32,0,0,6,11,49
Eritrea,2011-05-01,46,0,0,-2,11,55
Eritrea,2011-05-01,0,0,0,6,0,6
Eritrea,2011-05-01,36,2,0,0,4,42
Eritrea,2011-05-01,3,0,0,12,0,15
Eritrea,2011-05-01,11,0,1,0,0,12
Eritrea,2011-05-01,0,0,0,0,0,0
Georgia,2011-05-01,9,0,2,6,2,19
Georgia,2011-05-01,26,2,1,18,9,56
Georgia,2011-05-01,48,4,2,23,5,82
Georgia,2011-05-01,12,2,1,33,8,56
Georgia,2011-05-01,54,8,0,19,2,83
Georgia,2011-05-01,21,0,-6,36,7,58
Georgia,2011-05-01,15,0,-4,15,0,26
Georgia,2011-05-01,20,0,0,19,1,40
Georgia,2011-05-01,80,2,0,20,6,108
Georgia,2011-05-01,42,0,0,7,6,55
Georgia,2011-05-01,7,0,0,-6,5,6
Georgia,2011-05-01,6,0,0,3,1,10
Georgia,2011-05-01,7,0,0,0,0,7
Georgia,2011-05-01,4,2,0,0,0,6
Georgia,2011-05-01,4,0,0,0,0,4
Georgia,2011-05-01,-1,0,0,0,2,1
Georgia,2011-05-01,8,0,0,6,2,16
Georgia,2011-05-01,54,0,-4,20,2,72
Georgia,2011-05-01,17,2,0,26,11,56
Georgia,2011-05-01,27,0,-4,12,9,44
Georgia,2011-05-01,8,2,-2,18,1,27
Georgia,2011-05-01,14,4,0,11,2,31
Georgia,2011-05-01,10,0,0,6,0,16
Georgia,2011-05-01,23,4,0,21,5,53
Georgia,2011-05-01,6,0,0,13,5,24
Georgia,2011-05-01,20,0,0,15,14,49
Georgia,2011-05-01,52,2,1,27,12,94
Georgia,2011-05-01,19,0,0,10,2,31
Georgia,2011-05-01,30,0,0,-11,0,19
Georgia,2011-05-01,23,0,0,7,0,30
Georgia,2011-05-01,50,0,-4,6,1,53
India,2011-05-01,46,2,-1,2,10,59
India,2011-05-01,122,4,-1,29,19,173
India,2011-05-01,72,0,-2,29,6,105
India,2011-05-01,84,0,-1,17,6,106
India,2011-05-01,20,0,2,23,6,51
India,2011-05-01,57,2,-1,20,6,84
India,2011-05-01,51,2,2,17,9,81
India,2011-05-01,52,0,-7,20,7,72
India,2011-05-01,42,0,-5,19,8,64
India,2011-05-01,72,0,3,15,7,97
India,2011-05-01,94,0,-1,32,8,133
India,2011-05-01,58,10,1,9,2,80
India,2011-05-01,24,0,0,1,3,28
India,2011-05-01,20,0,1,8,2,31
India,2011-05-01,19,0,0,9,8,36
India,2011-05-01,9,0,0,3,0,12
India,2011-05-01,32,0,-2,30,2,62
India,2011-05-01,63,0,-6,9,7,73
India,2011-05-01,79,0,-5,13,4,91
India,2011-05-01,49,2,-2,5,7,61
India,2011-05-01,49,2,1,33,9,94
India,2011-05-01,14,0,-1,3,0,16
India,2011-05-01,43,0,0,2,6,51
India,2011-05-01,88,2,-1,14,11,114
India,2011-05-01,48,4,0,17,5,74
India,2011-05-01,55,0,1,9,8,73
India,2011-05-01,65,2,-3,60,11,135
India,2011-05-01,92,0,0,16,15,123
India,2011-05-01,70,2,-2,16,9,95
India,2011-05-01,56,0,-6,-1,4,53
India,2011-05-01,32,0,-2,7,3,40
Iran,2011-05-01,96,0,-2,25,23,142
Iran,2011-05-01,144,0,0,10,8,162
Iran,2011-05-01,123,0,-1,78,5,205
Iran,2011-05-01,93,0,2,77,4,176
Iran,2011-05-01,112,0,0,51,3,166
Iran,2011-05-01,74,0,-4,30,7,107
Iran,2011-05-01,68,0,-3,34,3,102
Iran,2011-05-01,118,0,0,60,23,201
Iran,2011-05-01,69,0,-1,57,3,128
Iran,2011-05-01,51,0,-2,40,7,96
Iran,2011-05-01,52,0,-2,52,4,106
Iran,2011-05-01,73,0,-2,24,4,99
Iran,2011-05-01,28,0,2,9,4,43
Iran,2011-05-01,12,0,0,18,1,31
Iran,2011-05-01,25,0,2,22,2,51
Iran,2011-05-01,58,0,0,1,9,68
Iran,2011-05-01,41,0,-2,27,8,74
Iran,2011-05-01,111,0,-6,52,22,179
Iran,2011-05-01,148,0,-2,57,29,232
Iran,2011-05-01,80,0,1,24,6,111
Iran,2011-05-01,44,0,-5,34,7,80
Iran,2011-05-01,23,0,0,63,4,90
Iran,2011-05-01,35,0,0,32,8,75
Iran,2011-05-01,99,0,-7,95,12,199
Iran,2011-05-01,28,0,1,46,9,84
Iran,2011-05-01,46,0,0,52,10,108
Iran,2011-05-01,58,0,0,49,8,115
Iran,2011-05-01,20,0,1,31,13,65
Iran,2011-05-01,39,2,3,0,12,56
Iran,2011-05-01,124,2,7,43,6,182
Iran,2011-05-01,48,0,-2,52,9,107
Iraq,2011-05-01,165,4,-6,1,10,174
Iraq,2011-05-01,617,4,-1,40,49,709
Iraq,2011-05-01,457,0,-1,24,22,502
Iraq,2011-05-01,243,2,0,45,17,307
Iraq,2011-05-01,245,2,-3,69,22,335
Iraq,2011-05-01,98,0,1,66,20,185
Iraq,2011-05-01,104,0,0,22,10,136
Iraq,2011-05-01,166,4,1,14,13,198
Iraq,2011-05-01,122,2,-1,63,12,198
Iraq,2011-05-01,125,4,0,21,16,166
Iraq,2011-05-01,133,0,-1,57,4,193
Iraq,2011-05-01,61,0,2,23,5,91
Iraq,2011-05-01,58,0,2,32,9,101
Iraq,2011-05-01,196,0,-5,96,32,319
Iraq,2011-05-01,75,2,0,28,13,118
Iraq,2011-05-01,36,0,0,1,1,38
Iraq,2011-05-01,78,2,0,16,7,103
Iraq,2011-05-01,134,0,0,44,11,189
Iraq,2011-05-01,136,0,1,41,31,209
Iraq,2011-05-01,61,2,2,76,22,163
Iraq,2011-05-01,48,2,-1,3,9,61
Iraq,2011-05-01,39,0,1,24,18,82
Iraq,2011-05-01,63,4,0,-7,8,68
Iraq,2011-05-01,83,0,3,34,4,124
Iraq,2011-05-01,48,0,0,21,18,87
Iraq,2011-05-01,111,0,-10,5,17,123
Iraq,2011-05-01,108,0,1,24,13,146
Iraq,2011-05-01,128,0,-2,19,7,152
Iraq,2011-05-01,196,0,0,33,5,234
Iraq,2011-05-01,321,0,-22,35,15,349
Iraq,2011-05-01,129,0,-6,23,12,158
Morocco,2011-05-01,20,0,0,3,6,29
Morocco,2011-05-01,39,0,-2,11,0,48
Morocco,2011-05-01,27,0,0,4,4,35
Morocco,2011-05-01,10,0,0,6,3,19
Morocco,2011-05-01,5,0,-1,6,3,13
Morocco,2011-05-01,19,0,0,14,1,34
Morocco,2011-05-01,21,0,0,3,10,34
Morocco,2011-05-01,15,0,-2,1,13,27
Morocco,2011-05-01,8,0,0,5,0,13
Morocco,2011-05-01,60,0,0,33,10,103
Morocco,2011-05-01,3,0,0,18,8,29
Morocco,2011-05-01,2,0,-3,6,0,5
Morocco,2011-05-01,17,0,0,3,0,20
Morocco,2011-05-01,9,0,0,0,0,9
Morocco,2011-05-01,0,0,-6,-2,4,-4
Morocco,2011-05-01,0,0,-2,3,0,1
Morocco,2011-05-01,18,0,-2,9,0,25
Morocco,2011-05-01,0,0,-2,3,0,1
Morocco,2011-05-01,3,0,-1,2,0,4
Morocco,2011-05-01,3,4,-1,12,1,19
Morocco,2011-05-01,2,0,0,-2,1,1
Morocco,2011-05-01,0,0,0,3,0,3
Morocco,2011-05-01,31,0,0,0,10,41
Morocco,2011-05-01,16,0,-1,5,0,20
Morocco,2011-05-01,-1,0,0,-2,0,-3
Morocco,2011-05-01,3,0,0,0,0,3
Morocco,2011-05-01,4,0,0,-4,0,0
Morocco,2011-05-01,1,0,0,9,3,13
Morocco,2011-05-01,4,0,-4,2,8,10
Morocco,2011-05-01,4,0,0,0,3,7
Morocco,2011-05-01,3,0,0,6,1,10
Nigeria,2011-05-01,16,0,0,18,3,37
Nigeria,2011-05-01,36,0,0,9,3,48
Nigeria,2011-05-01,38,0,1,37,8,84
Nigeria,2011-05-01,20,0,4,37,1,62
Nigeria,2011-05-01,40,0,1,69,0,110
Nigeria,2011-05-01,48,0,2,56,2,108
Nigeria,2011-05-01,20,0,-6,4,7,25
Nigeria,2011-05-01,19,0,0,14,2,35
Nigeria,2011-05-01,10,0,0,24,10,44
Nigeria,2011-05-01,35,0,-3,14,1,47
Nigeria,2011-05-01,11,0,1,24,1,37
Nigeria,2011-05-01,42,0,0,0,15,57
Nigeria,2011-05-01,38,6,0,6,0,50
Nigeria,2011-05-01,9,0,0,1,0,10
Nigeria,2011-05-01,10,0,0,0,0,10
Nigeria,2011-05-01,12,0,0,0,8,20
Nigeria,2011-05-01,20,0,0,12,23,55
Nigeria,2011-05-01,41,0,0,4,4,49
Nigeria,2011-05-01,32,0,0,30,5,67
Nigeria,2011-05-01,35,0,1,16,13,65
Nigeria,2011-05-01,11,0,0,3,10,24
Nigeria,2011-05-01,4,0,0,0,0,4
Nigeria,2011-05-01,3,0,0,3,2,8
Nigeria,2011-05-01,45,0,-1,21,2,67
Nigeria,2011-05-01,7,0,0,7,0,14
Nigeria,2011-05-01,7,0,-4,0,1,4
Nigeria,2011-05-01,20,0,0,27,12,59
Nigeria,2011-05-01,17,0,0,1,4,22
Nigeria,2011-05-01,5,0,0,0,2,7
Nigeria,2011-05-01,33,0,-4,12,8,49
Nigeria,2011-05-01,12,0,0,3,6,21
Pakistan,2011-05-01,319,0,0,6,46,371
Pakistan,2011-05-01,1851,0,8,136,68,2063
Pakistan,2011-05-01,1526,8,10,102,104,1750
Pakistan,2011-05-01,925,4,1,69,70,1069
Pakistan,2011-05-01,935,4,-2,94,89,1120
Pakistan,2011-05-01,1046,22,2,104,93,1267
Pakistan,2011-05-01,699,8,-9,70,76,844
Pakistan,2011-05-01,831,10,-4,232,96,1165
Pakistan,2011-05-01,424,0,4,98,21,547
Pakistan,2011-05-01,508,8,3,101,46,666
Pakistan,2011-05-01,424,6,-4,37,26,489
Pakistan,2011-05-01,97,6,-6,60,12,169
Pakistan,2011-05-01,180,2,0,34,29,245
Pakistan,2011-05-01,80,0,1,24,4,109
Pakistan,2011-05-01,40,0,-6,9,12,55
Pakistan,2011-05-01,92,2,0,16,3,113
Pakistan,2011-05-01,129,0,-1,8,8,144
Pakistan,2011-05-01,338,2,1,31,43,415
Pakistan,2011-05-01,310,4,1,47,39,401
Pakistan,2011-05-01,240,0,0,28,17,285
Pakistan,2011-05-01,165,0,-2,19,14,196
Pakistan,2011-05-01,196,0,2,34,3,235
Pakistan,2011-05-01,196,0,-1,49,7,251
Pakistan,2011-05-01,315,0,0,59,20,394
Pakistan,2011-05-01,116,2,-1,17,12,146
Pakistan,2011-05-01,148,2,-4,31,20,197
Pakistan,2011-05-01,130,0,-2,47,6,181
Pakistan,2011-05-01,217,0,1,16,42,276
Pakistan,2011-05-01,195,0,0,9,10,214
Pakistan,2011-05-01,190,0,0,12,6,208
Pakistan,2011-05-01,91,0,-2,51,4,144
Sierra Leone,2011-05-01,0,0,0,0,0,0
Sierra Leone,2011-05-01,4,0,0,3,0,7
Sierra Leone,2011-05-01,0,0,0,0,1,1
Sierra Leone,2011-05-01,0,0,0,0,1,1
Sierra Leone,2011-05-01,4,0,0,3,0,7
Sierra Leone,2011-05-01,0,2,0,0,0,2
Sierra Leone,2011-05-01,0,0,0,0,0,0
Sierra Leone,2011-05-01,0,0,0,-2,0,-2
Sierra Leone,2011-05-01,10,0,0,0,1,11
Sierra Leone,2011-05-01,4,0,0,0,0,4
Sierra Leone,2011-05-01,2,0,0,0,0,2
Sierra Leone,2011-05-01,-1,0,0,3,0,2
Sierra Leone,2011-05-01,2,0,0,3,0,5
Sierra Leone,2011-05-01,0,0,0,3,0,3
Sierra Leone,2011-05-01,6,0,0,-2,0,4
Sierra Leone,2011-05-01,4,0,0,-2,1,3
Sierra Leone,2011-05-01,0,0,0,0,0,0
Sierra Leone,2011-05-01,2,0,0,0,0,2
Sierra Leone,2011-05-01,0,0,0,0,0,0
Sierra Leone,2011-05-01,-1,0,0,12,0,11
Sierra Leone,2011-05-01,4,0,0,0,1,5
Sierra Leone,2011-05-01,3,0,0,0,1,4
Sierra Leone,2011-05-01,0,0,0,0,0,0
Sierra Leone,2011-05-01,6,0,0,0,0,6
Sierra Leone,2011-05-01,0,0,0,9,0,9
Sierra Leone,2011-05-01,6,0,0,0,0,6
Sierra Leone,2011-05-01,0,0,0,0,0,0
Sierra Leone,2011-05-01,3,0,0,0,0,3
Sierra Leone,2011-05-01,0,0,0,0,3,3
Sierra Leone,2011-05-01,0,0,0,0,0,0
Sierra Leone,2011-05-01,0,0,0,0,0,0
Somalia,2011-05-01,19,0,0,-2,1,18
Somalia,2011-05-01,145,0,0,3,5,153
Somalia,2011-05-01,78,0,0,128,3,209
Somalia,2011-05-01,39,0,0,68,2,109
Somalia,2011-05-01,56,0,0,8,8,72
Somalia,2011-05-01,45,0,0,49,4,98
Somalia,2011-05-01,30,0,0,15,2,47
Somalia,2011-05-01,30,0,0,15,0,45
Somalia,2011-05-01,28,0,0,27,2,57
Somalia,2011-05-01,34,0,2,27,3,66
Somalia,2011-05-01,51,0,2,26,3,82
Somalia,2011-05-01,60,0,2,6,6,74
Somalia,2011-05-01,16,0,0,21,0,37
Somalia,2011-05-01,12,0,0,2,4,18
Somalia,2011-05-01,19,0,0,22,6,47
Somalia,2011-05-01,11,0,0,9,4,24
Somalia,2011-05-01,51,0,-1,12,0,62
Somalia,2011-05-01,35,0,0,-5,1,31
Somalia,2011-05-01,92,0,-2,3,3,96
Somalia,2011-05-01,84,0,0,4,2,90
Somalia,2011-05-01,58,2,0,27,1,88
Somalia,2011-05-01,6,0,0,33,0,39
Somalia,2011-05-01,18,0,0,22,3,43
Somalia,2011-05-01,49,0,1,14,4,68
Somalia,2011-05-01,45,0,0,0,5,50
Somalia,2011-05-01,81,0,-2,16,7,102
Somalia,2011-05-01,107,0,0,80,18,205
Somalia,2011-05-01,60,0,0,23,11,94
Somalia,2011-05-01,79,2,0,6,0,87
Somalia,2011-05-01,55,0,0,27,1,83
Somalia,2011-05-01,52,0,0,23,2,77
Syria,2011-05-01,159,0,2,32,18,211
Syria,2011-05-01,144,0,-15,37,32,198
Syria,2011-05-01,137,0,-7,61,14,205
Syria,2011-05-01,78,2,-1,27,21,127
Syria,2011-05-01,17,4,-2,37,15,71
Syria,2011-05-01,132,12,4,30,36,214
Syria,2011-05-01,210,0,0,47,35,292
Syria,2011-05-01,66,0,-1,27,9,101
Syria,2011-05-01,95,0,-4,36,6,133
Syria,2011-05-01,136,0,0,54,25,215
Syria,2011-05-01,195,0,-6,45,50,284
Syria,2011-05-01,61,8,-2,-2,16,81
Syria,2011-05-01,80,0,-3,30,25,132
Syria,2011-05-01,24,0,0,19,4,47
Syria,2011-05-01,56,0,-10,-5,7,48
Syria,2011-05-01,84,0,2,12,9,107
Syria,2011-05-01,117,0,-1,17,20,153
Syria,2011-05-01,172,4,-3,61,18,252
Syria,2011-05-01,326,4,-6,28,36,388
Syria,2011-05-01,258,2,-5,36,28,319
Syria,2011-05-01,73,0,-1,15,7,94
Syria,2011-05-01,40,0,1,21,5,67
Syria,2011-05-01,71,0,-8,34,12,109
Syria,2011-05-01,135,0,-2,30,21,184
Syria,2011-05-01,69,0,3,12,10,94
Syria,2011-05-01,103,0,1,28,17,149
Syria,2011-05-01,173,2,2,44,24,245
Syria,2011-05-01,53,0,7,47,9,116
Syria,2011-05-01,22,0,-2,32,10,62
Syria,2011-05-01,35,0,0,8,9,52
Syria,2011-05-01,37,0,-1,32,4,72
Yemen,2011-05-01,99,0,-8,3,14,108
Yemen,2011-05-01,275,0,-7,21,48,337
Yemen,2011-05-01,126,0,-8,20,31,169
Yemen,2011-05-01,101,0,-18,-5,7,85
Yemen,2011-05-01,136,0,-2,14,22,170
Yemen,2011-05-01,150,0,0,12,4,166
Yemen,2011-05-01,201,0,-6,18,11,224
Yemen,2011-05-01,69,0,-6,1,10,74
Yemen,2011-05-01,39,0,0,7,9,55
Yemen,2011-05-01,155,12,-11,26,11,193
Yemen,2011-05-01,169,8,-2,9,17,201
Yemen,2011-05-01,76,4,0,-4,9,85
Yemen,2011-05-01,51,0,-4,5,3,55
Yemen,2011-05-01,25,0,0,3,2,30
Yemen,2011-05-01,29,0,0,6,3,38
Yemen,2011-05-01,19,0,0,0,1,20
Yemen,2011-05-01,42,0,0,29,6,77
Yemen,2011-05-01,69,0,-12,23,8,88
Yemen,2011-05-01,51,0,-5,9,3,58
Yemen,2011-05-01,57,2,-2,13,1,71
Yemen,2011-05-01,42,0,-13,-2,4,31
Yemen,2011-05-01,23,2,-19,9,1,16
Yemen,2011-05-01,61,0,-3,6,5,69
Yemen,2011-05-01,105,2,-4,28,7,138
Yemen,2011-05-01,25,0,0,3,0,28
Yemen,2011-05-01,79,0,1,9,1,90
Yemen,2011-05-01,31,0,-4,13,0,40
Yemen,2011-05-01,26,0,-2,33,7,64
Yemen,2011-05-01,42,0,-2,24,2,66
Yemen,2011-05-01,36,0,-4,9,5,46
Yemen,2011-05-01,59,0,0,10,11,80
Afghanistan,2011-11-01,192,0,6,38,14,250
Afghanistan,2011-11-01,205,2,-4,50,11,264
Afghanistan,2011-11-01,299,0,0,76,42,417
Afghanistan,2011-11-01,139,0,0,67,25,231
Afghanistan,2011-11-01,184,0,0,54,9,247
Afghanistan,2011-11-01,133,0,0,9,4,146
Afghanistan,2011-11-01,166,0,0,44,14,224
Afghanistan,2011-11-01,186,0,-4,65,6,253
Afghanistan,2011-11-01,217,0,0,27,14,258
Afghanistan,2011-11-01,295,0,0,126,2,423
Afghanistan,2011-11-01,379,8,0,232,40,659
Afghanistan,2011-11-01,357,0,0,133,19,509
Afghanistan,2011-11-01,92,0,0,24,1,117
Afghanistan,2011-11-01,231,1,-5,124,11,362
Afghanistan,2011-11-01,301,0,-5,72,7,375
Afghanistan,2011-11-01,332,0,0,27,3,362
Afghanistan,2011-11-01,165,0,2,88,14,269
Afghanistan,2011-11-01,141,0,0,41,12,194
Afghanistan,2011-11-01,125,0,0,71,2,198
Afghanistan,2011-11-01,128,4,0,42,13,187
Afghanistan,2011-11-01,83,2,-3,46,28,156
Afghanistan,2011-11-01,105,0,-2,48,12,163
Afghanistan,2011-11-01,138,0,4,39,8,189
Afghanistan,2011-11-01,105,0,0,13,9,127
Afghanistan,2011-11-01,110,6,0,38,22,176
Afghanistan,2011-11-01,284,0,0,32,15,331
Afghanistan,2011-11-01,273,0,1,36,25,335
Afghanistan,2011-11-01,288,2,-2,60,35,383
Afghanistan,2011-11-01,301,0,2,26,87,416
Afghanistan,2011-11-01,200,2,1,1,22,226
Albania,2011-11-01,14,0,1,9,2,26
Albania,2011-11-01,8,0,0,0,1,9
Albania,2011-11-01,3,0,0,6,0,9
Albania,2011-11-01,4,0,0,6,0,10
Albania,2011-11-01,3,0,0,0,0,3
Albania,2011-11-01,14,0,0,9,3,26
Albania,2011-11-01,2,0,0,9,8,19
Albania,2011-11-01,11,0,0,6,2,19
Albania,2011-11-01,25,0,0,9,4,38
Albania,2011-11-01,34,0,0,27,10,71
Albania,2011-11-01,0,0,0,0,0,0
Albania,2011-11-01,0,0,0,0,0,0
Albania,2011-11-01,-2,0,0,3,2,3
Albania,2011-11-01,2,0,0,0,0,2
Albania,2011-11-01,11,0,0,0,0,11
Albania,2011-11-01,6,0,0,0,0,6
Albania,2011-11-01,9,0,0,0,0,9
Albania,2011-11-01,0,0,-1,0,0,-1
Albania,2011-11-01,4,0,0,0,0,4
Albania,2011-11-01,12,0,0,25,0,37
Albania,2011-11-01,6,0,0,12,0,18
Albania,2011-11-01,28,0,0,12,0,40
Albania,2011-11-01,37,0,-2,-2,0,33
Albania,2011-11-01,7,0,0,0,0,7
Albania,2011-11-01,1,0,0,-2,0,-1
Albania,2011-11-01,9,0,0,-2,0,7
Albania,2011-11-01,24,0,0,-2,1,23
Albania,2011-11-01,15,0,0,0,1,16
Albania,2011-11-01,6,0,0,0,0,6
Algeria,2011-11-01,1,0,0,9,2,12
Algeria,2011-11-01,4,0,-2,15,0,17
Algeria,2011-11-01,16,0,0,0,0,16
Algeria,2011-11-01,10,0,0,9,0,19
Algeria,2011-11-01,6,0,0,0,1,7
Algeria,2011-11-01,0,0,0,6,0,6
Algeria,2011-11-01,9,0,0,0,0,9
Algeria,2011-11-01,13,0,0,10,1,24
Algeria,2011-11-01,18,0,0,-2,0,16
Algeria,2011-11-01,3,0,0,0,1,4
Algeria,2011-11-01,1,0,0,2,3,6
Algeria,2011-11-01,3,0,0,15,2,20
Algeria,2011-11-01,16,0,0,0,1,17
Algeria,2011-11-01,19,0,0,9,0,28
Algeria,2011-11-01,12,0,0,6,3,21
Algeria,2011-11-01,0,0,0,6,0,6
Algeria,2011-11-01,27,0,1,2,1,31
Algeria,2011-11-01,22,0,0,14,0,36
Algeria,2011-11-01,34,0,0,19,1,54
Algeria,2011-11-01,31,0,0,13,3,47
Algeria,2011-11-01,1,0,0,-6,0,-5
Algeria,2011-11-01,8,0,0,-4,0,4
Algeria,2011-11-01,1,0,0,15,0,16
Algeria,2011-11-01,8,0,-2,18,4,28
Algeria,2011-11-01,12,0,0,25,0,37
Algeria,2011-11-01,5,0,0,6,0,11
Algeria,2011-11-01,9,0,-2,24,4,35
Algeria,2011-11-01,9,0,0,11,0,20
Algeria,2011-11-01,17,0,1,9,0,27
Algeria,2011-11-01,14,0,6,13,0,33
Bangladesh,2011-11-01,20,2,0,7,3,32
Bangladesh,2011-11-01,18,0,0,1,4,23
Bangladesh,2011-11-01,18,0,0,6,0,24
Bangladesh,2011-11-01,9,0,0,12,0,21
Bangladesh,2011-11-01,4,0,0,0,0,4
Bangladesh,2011-11-01,4,2,0,12,6,24
Bangladesh,2011-11-01,1,0,0,3,0,4
Bangladesh,2011-11-01,8,0,-1,3,0,10
Bangladesh,2011-11-01,44,0,0,11,4,59
Bangladesh,2011-11-01,10,0,0,0,0,10
Bangladesh,2011-11-01,15,0,5,6,1,27
Bangladesh,2011-11-01,5,0,0,3,0,8
Bangladesh,2011-11-01,10,0,-2,7,0,15
Bangladesh,2011-11-01,15,0,2,7,2,26
Bangladesh,2011-11-01,28,0,0,7,2,37
Bangladesh,2011-11-01,30,0,6,26,0,62
Bangladesh,2011-11-01,3,0,0,3,2,8
Bangladesh,2011-11-01,23,0,0,0,0,23
Bangladesh,2011-11-01,24,0,1,0,1,26
Bangladesh,2011-11-01,10,0,0,7,6,23
Bangladesh,2011-11-01,11,0,2,6,4,23
Bangladesh,2011-11-01,12,0,0,4,5,21
Bangladesh,2011-11-01,15,0,0,3,2,20
Bangladesh,2011-11-01,7,0,0,12,2,21
Bangladesh,2011-11-01,20,0,0,5,3,28
Bangladesh,2011-11-01,26,0,0,3,0,29
Bangladesh,2011-11-01,-1,0,1,0,4,4
Bangladesh,2011-11-01,11,0,-4,0,2,9
Bangladesh,2011-11-01,32,0,0,15,5,52
Bangladesh,2011-11-01,7,0,0,-1,1,7
Cameroon,2011-11-01,1,0,0,0,0,1
Cameroon,2011-11-01,7,0,0,-2,1,6
Cameroon,2011-11-01,3,0,0,6,0,9
Cameroon,2011-11-01,5,0,0,-2,1,4
Cameroon,2011-11-01,2,0,0,5,0,7
Cameroon,2011-11-01,0,2,0,0,0,2
Cameroon,2011-11-01,6,0,0,0,3,9
Cameroon,2011-11-01,0,0,0,0,0,0
Cameroon,2011-11-01,0,0,0,6,0,6
Cameroon,2011-11-01,0,0,0,0,0,0
Cameroon,2011-11-01,3,0,0,0,0,3
Cameroon,2011-11-01,0,0,0,0,0,0
Cameroon,2011-11-01,6,0,0,6,5,17
Cameroon,2011-11-01,1,0,0,0,1,2
Cameroon,2011-11-01,0,0,0,3,0,3
Cameroon,2011-11-01,0,0,0,3,0,3
Cameroon,2011-11-01,5,0,0,0,0,5
Cameroon,2011-11-01,0,0,0,0,0,0
Cameroon,2011-11-01,-6,0,0,0,0,-6
Cameroon,2011-11-01,6,0,0,0,0,6
Cameroon,2011-11-01,4,0,0,3,0,7
Cameroon,2011-11-01,4,0,0,0,0,4
Cameroon,2011-11-01,0,0,-2,0,0,-2
Cameroon,2011-11-01,0,0,0,0,0,0
Cameroon,2011-11-01,0,0,0,3,1,4
Cameroon,2011-11-01,2,0,0,0,0,2
Cameroon,2011-11-01,4,0,0,0,1,5
China,2011-11-01,141,2,3,45,22,213
China,2011-11-01,121,0,-3,58,24,200
China,2011-11-01,142,0,3,23,47,215
China,2011-11-01,145,8,0,38,25,216
China,2011-11-01,151,2,-3,18,6,174
China,2011-11-01,71,0,1,24,21,117
China,2011-11-01,144,4,-8,55,20,215
China,2011-11-01,158,4,-12,86,13,249
China,2011-11-01,154,4,-16,22,10,174
China,2011-11-01,110,4,2,40,57,213
China,2011-11-01,186,2,-1,70,30,287
China,2011-11-01,110,0,-6,48,14,166
China,2011-11-01,93,2,0,49,19,163
China,2011-11-01,217,0,-6,53,11,275
China,2011-11-01,189,8,-8,87,17,293
China,2011-11-01,138,0,-7,28,19,178
China,2011-11-01,203,16,-5,22,15,251
China,2011-11-01,458,6,-10,313,82,849
China,2011-11-01,516,6,-19,218,50,771
China,2011-11-01,86,0,3,39,5,133
China,2011-11-01,109,2,0,31,13,155
China,2011-11-01,121,0,-4,15,14,146
China,2011-11-01,146,0,-8,22,7,167
China,2011-11-01,114,2,-1,32,9,156
China,2011-11-01,151,0,-6,76,4,225
China,2011-11-01,62,0,0,31,4,97
China,2011-11-01,40,0,-1,34,15,88
China,2011-11-01,255,10,-6,74,25,358
China,2011-11-01,155,0,0,32,13,200
China,2011-11-01,142,4,-10,68,14,218
Egypt,2011-11-01,61,0,0,45,9,115
Egypt,2011-11-01,64,0,-12,23,24,99
Egypt,2011-11-01,47,0,-3,12,9,65
Egypt,2011-11-01,71,0,-6,27,17,109
Egypt,2011-11-01,93,0,4,-2,6,101
Egypt,2011-11-01,32,0,0,20,18,70
Egypt,2011-11-01,20,0,-2,34,20,72
Egypt,2011-11-01,141,0,1,15,6,163
Egypt,2011-11-01,31,0,0,18,3,52
Egypt,2011-11-01,36,0,-2,1,23,58
Egypt,2011-11-01,74,6,-2,1,20,99
Egypt,2011-11-01,27,0,-10,1,0,18
Egypt,2011-11-01,78,0,-5,58,8,139
Egypt,2011-11-01,67,0,1,46,16,130
Egypt,2011-11-01,62,0,0,40,16,118
Egypt,2011-11-01,44,0,-8,4,9,49
Egypt,2011-11-01,61,0,-12,8,17,74
Egypt,2011-11-01,42,0,-3,27,48,114
Egypt,2011-11-01,125,0,-7,110,66,294
Egypt,2011-11-01,122,0,-12,37,44,191
Egypt,2011-11-01,187,0,-30,37,39,233
Egypt,2011-11-01,412,4,-34,226,83,691
Egypt,2011-11-01,574,6,-55,240,104,869
Egypt,2011-11-01,269,6,-44,86,77,394
Egypt,2011-11-01,199,0,-38,-7,68,222
Egypt,2011-11-01,140,0,-22,52,22,192
Egypt,2011-11-01,59,0,-13,5,22,73
Egypt,2011-11-01,117,0,-18,28,33,160
Egypt,2011-11-01,85,0,-6,9,18,106
Egypt,2011-11-01,91,0,-3,57,25,170
Eritrea,2011-11-01,25,0,1,3,0,29
Eritrea,2011-11-01,57,0,0,-2,6,61
Eritrea,2011-11-01,10,0,0,18,0,28
Eritrea,2011-11-01,28,0,0,21,1,50
Eritrea,2011-11-01,8,0,0,1,0,9
Eritrea,2011-11-01,18,0,0,0,0,18
Eritrea,2011-11-01,6,0,0,0,0,6
Eritrea,2011-11-01,6,0,0,9,2,17
Eritrea,2011-11-01,0,0,0,-4,0,-4
Eritrea,2011-11-01,0,0,0,6,0,6
Eritrea,2011-11-01,6,0,0,0,0,6
Eritrea,2011-11-01,17,0,0,6,1,24
Eritrea,2011-11-01,24,0,0,10,0,34
Eritrea,2011-11-01,2,0,0,0,0,2
Eritrea,2011-11-01,12,0,1,0,0,13
Eritrea,2011-11-01,2,0,0,6,0,8
Eritrea,2011-11-01,2,0,0,-1,0,1
Eritrea,2011-11-01,3,0,0,-3,0,0
Eritrea,2011-11-01,4,0,0,0,1,5
Eritrea,2011-11-01,1,0,0,-2,0,-1
Eritrea,2011-11-01,-2,0,0,18,2,18
Eritrea,2011-11-01,2,0,0,0,0,2
Eritrea,2011-11-01,0,0,0,0,0,0
Eritrea,2011-11-01,8,0,0,0,0,8
Eritrea,2011-11-01,18,0,0,1,0,19
Eritrea,2011-11-01,3,0,0,-2,0,1
Eritrea,2011-11-01,2,0,0,0,0,2
Eritrea,2011-11-01,0,0,0,6,1,7
Eritrea,2011-11-01,2,0,0,1,0,3
Georgia,2011-11-01,32,2,2,18,1,55
Georgia,2011-11-01,47,0,1,12,11,71
Georgia,2011-11-01,17,0,0,15,6,38
Georgia,2011-11-01,53,0,0,35,12,100
Georgia,2011-11-01,3,0,0,11,4,18
Georgia,2011-11-01,10,0,0,0,0,10
Georgia,2011-11-01,16,0,-2,14,11,39
Georgia,2011-11-01,29,0,-1,16,9,53
Georgia,2011-11-01,22,6,0,16,5,49
Georgia,2011-11-01,16,0,1,15,3,35
Georgia,2011-11-01,3,0,0,0,0,3
Georgia,2011-11-01,18,0,1,4,1,24
Georgia,2011-11-01,9,0,0,3,0,12
Georgia,2011-11-01,12,0,-1,6,4,21
Georgia,2011-11-01,23,0,1,7,1,32
Georgia,2011-11-01,39,0,0,-9,2,32
Georgia,2011-11-01,34,0,0,10,0,44
Georgia,2011-11-01,15,0,0,2,0,17
Georgia,2011-11-01,35,0,0,18,10,63
Georgia,2011-11-01,4,0,-1,9,2,14
Georgia,2011-11-01,16,0,0,10,8,34
Georgia,2011-11-01,38,8,0,1,9,56
Georgia,2011-11-01,50,4,0,33,2,89
Georgia,2011-11-01,8,4,0,1,1,14
Georgia,2011-11-01,22,0,0,1,2,25
Georgia,2011-11-01,16,0,0,12,3,31
Georgia,2011-11-01,5,0,0,6,4,15
Georgia,2011-11-01,42,0,-1,-1,7,47
Georgia,2011-11-01,36,0,1,15,6,58
Georgia,2011-11-01,39,0,0,27,5,71
India,2011-11-01,31,0,1,13,9,54
India,2011-11-01,36,0,2,-1,0,37
India,2011-11-01,52,0,1,9,9,71
India,2011-11-01,21,0,-5,-8,11,19
India,2011-11-01,51,0,0,16,4,71
India,2011-11-01,16,2,0,-8,18,28
India,2011-11-01,35,8,0,16,5,64
India,2011-11-01,67,0,-6,11,7,79
India,2011-11-01,51,2,-1,36,7,95
India,2011-11-01,35,0,0,16,7,58
India,2011-11-01,35,0,-2,10,10,53
India,2011-11-01,46,2,0,7,6,61
India,2011-11-01,35,0,0,0,4,39
India,2011-11-01,55,0,2,53,11,121
India,2011-11-01,66,0,-7,34,8,101
India,2011-11-01,64,2,2,23,5,96
India,2011-11-01,75,0,0,6,5,86
India,2011-11-01,54,2,0,7,8,71
India,2011-11-01,52,0,-1,27,10,88
India,2011-11-01,41,4,0,30,5,80
India,2011-11-01,43,0,0,6,5,54
India,2011-11-01,27,4,-7,20,7,51
India,2011-11-01,89,4,-10,13,7,103
India,2011-11-01,62,2,0,0,8,72
India,2011-11-01,96,4,-3,12,12,121
India,2011-11-01,67,4,-2,5,3,77
India,2011-11-01,29,2,0,8,8,47
India,2011-11-01,58,2,1,-3,9,67
India,2011-11-01,55,0,0,32,7,94
India,2011-11-01,35,0,2,5,9,51
Iran,2011-11-01,104,0,0,26,8,138
Iran,2011-11-01,184,0,1,20,8,213
Iran,2011-11-01,139,0,7,31,13,190
Iran,2011-11-01,152,0,-4,33,16,197
Iran,2011-11-01,82,2,-2,18,11,111
Iran,2011-11-01,404,2,-5,159,55,615
Iran,2011-11-01,463,16,-17,180,71,713
Iran,2011-11-01,189,2,-3,92,25,305
Iran,2011-11-01,386,13,-38,129,53,543
Iran,2011-11-01,488,10,-21,240,64,781
Iran,2011-11-01,111,0,-2,18,20,147
Iran,2011-11-01,119,0,1,21,7,148
Iran,2011-11-01,147,0,0,38,14,199
Iran,2011-11-01,175,2,0,58,20,255
Iran,2011-11-01,134,2,-8,32,2,162
Iran,2011-11-01,84,0,1,28,28,141
Iran,2011-11-01,103,0,1,38,5,147
Iran,2011-11-01,75,0,2,3,9,89
Iran,2011-11-01,79,0,-2,34,9,120
Iran,2011-11-01,129,0,-4,67,4,196
Iran,2011-11-01,146,2,0,63,6,217
Iran,2011-11-01,157,4,0,36,6,203
Iran,2011-11-01,143,2,-1,40,22,206
Iran,2011-11-01,96,0,0,59,24,179
Iran,2011-11-01,117,0,-2,55,20,190
Iran,2011-11-01,65,0,3,26,4,98
Iran,2011-11-01,83,0,0,13,2,98
Iran,2011-11-01,92,0,0,53,2,147
Iran,2011-11-01,298,6,-2,116,27,445
Iran,2011-11-01,95,0,2,107,9,213
Iraq,2011-11-01,100,0,1,47,16,164
Iraq,2011-11-01,97,0,3,33,31,164
Iraq,2011-11-01,167,2,0,61,30,260
Iraq,2011-11-01,126,6,0,26,36,194
Iraq,2011-11-01,80,0,1,13,21,115
Iraq,2011-11-01,65,0,0,-3,2,64
Iraq,2011-11-01,172,0,0,16,14,202
Iraq,2011-11-01,161,2,-2,37,19,217
Iraq,2011-11-01,106,0,-8,9,9,116
Iraq,2011-11-01,135,2,-4,102,22,257
Iraq,2011-11-01,473,6,-17,215,64,741
Iraq,2011-11-01,408,0,-11,167,44,608
Iraq,2011-11-01,68,0,0,9,6,83
Iraq,2011-11-01,183,0,0,36,18,237
Iraq,2011-11-01,100,2,-2,56,14,170
Iraq,2011-11-01,94,0,0,15,6,115
Iraq,2011-11-01,101,0,0,4,8,113
Iraq,2011-11-01,82,0,-6,20,7,103
Iraq,2011-11-01,64,0,0,56,11,131
Iraq,2011-11-01,60,0,2,25,7,94
Iraq,2011-11-01,66,0,8,87,41,202
Iraq,2011-11-01,108,0,5,174,17,304
Iraq,2011-11-01,87,8,-6,97,14,200
Iraq,2011-11-01,96,0,1,13,21,131
Iraq,2011-11-01,105,0,0,18,20,143
Iraq,2011-11-01,74,0,1,5,18,98
Iraq,2011-11-01,66,0,-2,8,10,82
Iraq,2011-11-01,101,0,0,33,14,148
Iraq,2011-11-01,69,0,0,25,7,101
Iraq,2011-11-01,83,2,-4,3,7,91
Morocco,2011-11-01,3,0,0,6,0,9
Morocco,2011-11-01,1,0,0,15,4,20
Morocco,2011-11-01,5,0,0,-1,2,6
Morocco,2011-11-01,2,0,0,1,0,3
Morocco,2011-11-01,12,0,0,-2,1,11
Morocco,2011-11-01,0,0,0,-2,0,-2
Morocco,2011-11-01,3,0,0,-2,1,2
Morocco,2011-11-01,2,0,0,9,2,13
Morocco,2011-11-01,14,0,-2,9,7,28
Morocco,2011-11-01,1,0,0,24,0,25
Morocco,2011-11-01,-1,0,0,12,0,11
Morocco,2011-11-01,3,0,0,3,0,6
Morocco,2011-11-01,3,0,2,0,1,6
Morocco,2011-11-01,7,0,-2,6,5,16
Morocco,2011-11-01,26,0,-4,2,1,25
Morocco,2011-11-01,32,0,-2,6,2,38
Morocco,2011-11-01,31,0,1,-2,7,37
Morocco,2011-11-01,8,0,2,0,1,11
Morocco,2011-11-01,3,6,0,0,0,9
Morocco,2011-11-01,7,0,0,-2,0,5
Morocco,2011-11-01,-1,0,0,6,2,7
Morocco,2011-11-01,10,0,0,-6,0,4
Morocco,2011-11-01,14,0,0,2,2,18
Morocco,2011-11-01,7,2,1,0,2,12
Morocco,2011-11-01,8,2,-3,37,17,61
Morocco,2011-11-01,26,0,-4,1,6,29
Morocco,2011-11-01,28,0,-4,-6,3,21
Morocco,2011-11-01,15,0,0,-5,5,15
Morocco,2011-11-01,6,0,0,9,1,16
Morocco,2011-11-01,8,0,0,-6,6,8
Nigeria,2011-11-01,35,0,2,-1,4,40
Nigeria,2011-11-01,24,0,2,17,3,46
Nigeria,2011-11-01,19,0,0,25,5,49
Nigeria,2011-11-01,11,0,-2,24,4,37
Nigeria,2011-11-01,10,0,-2,16,4,28
Nigeria,2011-11-01,14,0,-3,15,0,26
Nigeria,2011-11-01,33,0,0,37,1,71
Nigeria,2011-11-01,27,0,-2,29,0,54
Nigeria,2011-11-01,39,2,-2,14,4,57
Nigeria,2011-11-01,28,0,0,18,4,50
Nigeria,2011-11-01,10,0,0,1,0,11
Nigeria,2011-11-01,7,0,0,3,1,11
Nigeria,2011-11-01,45,0,0,3,0,48
Nigeria,2011-11-01,42,0,2,17,0,61
Nigeria,2011-11-01,25,0,0,3,2,30
Nigeria,2011-11-01,38,0,0,43,1,82
Nigeria,2011-11-01,46,0,1,67,4,118
Nigeria,2011-11-01,60,2,2,40,12,116
Nigeria,2011-11-01,11,0,0,0,1,12
Nigeria,2011-11-01,20,0,0,5,3,28
Nigeria,2011-11-01,37,0,0,15,1,53
Nigeria,2011-11-01,38,0,0,21,0,59
Nigeria,2011-11-01,41,2,1,3,4,51
Nigeria,2011-11-01,82,0,0,38,9,129
Nigeria,2011-11-01,43,2,-2,39,4,86
Nigeria,2011-11-01,21,0,0,16,0,37
Nigeria,2011-11-01,23,0,-1,3,3,28
Nigeria,2011-11-01,31,0,0,17,0,48
Nigeria,2011-11-01,21,0,0,32,1,54
Nigeria,2011-11-01,37,0,1,21,2,61
Pakistan,2011-11-01,55,2,2,20,9,88
Pakistan,2011-11-01,109,0,0,19,10,138
Pakistan,2011-11-01,121,4,0,49,4,178
Pakistan,2011-11-01,88,2,0,41,13,144
Pakistan,2011-11-01,57,0,-1,10,11,77
Pakistan,2011-11-01,83,0,0,29,10,122
Pakistan,2011-11-01,88,2,0,25,25,140
Pakistan,2011-11-01,75,0,-2,30,1,104
Pakistan,2011-11-01,90,4,-4,12,4,106
Pakistan,2011-11-01,55,4,1,7,0,67
Pakistan,2011-11-01,53,0,0,18,3,74
Pakistan,2011-11-01,30,0,0,9,8,47
Pakistan,2011-11-01,60,0,0,13,5,78
Pakistan,2011-11-01,62,0,-4,67,7,132
Pakistan,2011-11-01,75,0,-4,23,7,101
Pakistan,2011-11-01,93,0,4,7,4,108
Pakistan,2011-11-01,93,0,2,20,3,118
Pakistan,2011-11-01,45,0,0,53,3,101
Pakistan,2011-11-01,53,0,0,34,2,89
Pakistan,2011-11-01,111,6,0,85,4,206
Pakistan,2011-11-01,57,0,2,51,10,120
Pakistan,2011-11-01,65,6,-11,32,5,97
Pakistan,2011-11-01,168,0,-16,30,16,198
Pakistan,2011-11-01,72,0,-7,17,14,96
Pakistan,2011-11-01,44,2,0,30,22,98
Pakistan,2011-11-01,226,0,0,64,30,320
Pakistan,2011-11-01,181,0,1,12,21,215
Pakistan,2011-11-01,181,0,0,43,27,251
Pakistan,2011-11-01,182,0,0,60,32,274
Pakistan,2011-11-01,131,0,3,22,23,179
Sierra Leone,2011-11-01,-1,0,0,0,0,-1
Sierra Leone,2011-11-01,0,0,0,3,0,3
Sierra Leone,2011-11-01,8,0,0,0,2,10
Sierra Leone,2011-11-01,0,0,0,1,0,1
Sierra Leone,2011-11-01,0,0,0,0,0,0
Sierra Leone,2011-11-01,0,0,0,0,0,0
Sierra Leone,2011-11-01,9,0,0,10,0,19
Sierra Leone,2011-11-01,6,0,0,3,0,9
Sierra Leone,2011-11-01,3,0,0,0,0,3
Sierra Leone,2011-11-01,2,0,0,11,1,14
Sierra Leone,2011-11-01,36,0,0,4,4,44
Sierra Leone,2011-11-01,9,0,1,27,0,37
Sierra Leone,2011-11-01,2,0,0,0,1,3
Sierra Leone,2011-11-01,6,2,0,3,0,11
Sierra Leone,2011-11-01,13,0,0,12,0,25
Sierra Leone,2011-11-01,3,0,0,0,0,3
Sierra Leone,2011-11-01,2,0,0,0,1,3
Sierra Leone,2011-11-01,5,2,0,0,0,7
Sierra Leone,2011-11-01,5,0,0,0,0,5
Sierra Leone,2011-11-01,2,0,0,12,0,14
Sierra Leone,2011-11-01,6,0,0,9,0,15
Sierra Leone,2011-11-01,3,0,1,-1,0,3
Sierra Leone,2011-11-01,0,0,1,-2,0,-1
Sierra Leone,2011-11-01,0,0,0,0,0,0
Sierra Leone,2011-11-01,0,0,1,0,0,1
Sierra Leone,2011-11-01,6,0,0,0,0,6
Sierra Leone,2011-11-01,2,0,0,0,0,2
Sierra Leone,2011-11-01,4,0,0,6,0,10
Somalia,2011-11-01,41,0,4,36,4,85
Somalia,2011-11-01,49,2,1,30,5,87
Somalia,2011-11-01,34,0,1,61,9,105
Somalia,2011-11-01,67,2,0,72,28,169
Somalia,2011-11-01,89,0,1,52,41,183
Somalia,2011-11-01,131,0,-2,-1,26,154
Somalia,2011-11-01,83,0,0,59,13,155
Somalia,2011-11-01,75,0,0,38,8,121
Somalia,2011-11-01,43,0,-2,36,5,82
Somalia,2011-11-01,20,0,0,4,11,35
Somalia,2011-11-01,66,0,0,28,4,98
Somalia,2011-11-01,38,2,0,26,2,68
Somalia,2011-11-01,73,0,0,57,6,136
Somalia,2011-11-01,61,0,0,55,2,118
Somalia,2011-11-01,76,0,1,40,3,120
Somalia,2011-11-01,102,6,1,29,10,148
Somalia,2011-11-01,31,0,0,9,13,53
Somalia,2011-11-01,30,0,0,12,0,42
Somalia,2011-11-01,36,0,0,9,22,67
Somalia,2011-11-01,47,0,0,3,10,60
Somalia,2011-11-01,47,0,0,11,0,58
Somalia,2011-11-01,37,0,0,32,4,73
Somalia,2011-11-01,41,0,1,11,2,55
Somalia,2011-11-01,108,0,1,42,6,157
Somalia,2011-11-01,84,0,0,24,5,113
Somalia,2011-11-01,101,0,0,5,7,113
Somalia,2011-11-01,17,0,1,14,4,36
Somalia,2011-11-01,23,4,0,7,0,34
Somalia,2011-11-01,17,2,0,30,3,52
Somalia,2011-11-01,9,0,0,33,2,44
Syria,2011-11-01,72,0,-4,28,9,105
Syria,2011-11-01,71,0,-8,30,23,116
Syria,2011-11-01,155,2,-6,69,21,241
Syria,2011-11-01,95,0,-6,26,18,133
Syria,2011-11-01,90,0,-2,19,14,121
Syria,2011-11-01,36,2,1,1,4,44
Syria,2011-11-01,149,2,4,36,18,209
Syria,2011-11-01,112,4,1,85,27,229
Syria,2011-11-01,117,0,-3,86,5,205
Syria,2011-11-01,53,0,1,44,5,103
Syria,2011-11-01,79,0,1,35,8,123
Syria,2011-11-01,125,0,-2,3,22,148
Syria,2011-11-01,74,0,0,11,10,95
Syria,2011-11-01,229,0,-46,36,6,225
Syria,2011-11-01,245,0,-13,55,24,311
Syria,2011-11-01,341,2,-16,121,32,480
Syria,2011-11-01,589,8,-18,290,97,966
Syria,2011-11-01,323,2,-10,76,38,429
Syria,2011-11-01,295,4,-3,95,26,417
Syria,2011-11-01,548,14,-22,212,102,854
Syria,2011-11-01,197,0,-10,11,14,212
Syria,2011-11-01,162,0,-60,29,17,148
Syria,2011-11-01,180,2,-20,26,10,198
Syria,2011-11-01,161,8,-2,7,21,195
Syria,2011-11-01,124,2,0,24,19,169
Syria,2011-11-01,240,2,-4,81,24,343
Syria,2011-11-01,186,4,0,28,17,235
Syria,2011-11-01,170,4,-5,30,49,248
Syria,2011-11-01,218,1,-1,55,22,295
Syria,2011-11-01,288,0,-2,107,19,412
Yemen,2011-11-01,73,2,-3,-24,6,54
Yemen,2011-11-01,101,4,1,-84,16,38
Yemen,2011-11-01,11,0,0,26,0,37
Yemen,2011-11-01,14,0,0,4,2,20
Yemen,2011-11-01,20,0,-2,7,4,29
Yemen,2011-11-01,10,0,-2,-2,4,10
Yemen,2011-11-01,25,6,0,12,1,44
Yemen,2011-11-01,37,0,0,4,0,41
Yemen,2011-11-01,40,0,0,33,5,78
Yemen,2011-11-01,17,0,0,29,0,46
Yemen,2011-11-01,31,2,0,-5,1,29
Yemen,2011-11-01,10,0,-2,15,2,25
Yemen,2011-11-01,17,0,0,13,3,33
Yemen,2011-11-01,27,0,-2,12,7,44
Yemen,2011-11-01,10,0,-16,-1,4,-3
Yemen,2011-11-01,37,0,0,9,5,51
Yemen,2011-11-01,34,0,0,3,8,45
Yemen,2011-11-01,21,0,0,2,9,32
Yemen,2011-11-01,42,0,-3,2,0,41
Yemen,2011-11-01,35,0,0,9,3,47
Yemen,2011-11-01,16,0,0,6,2,24
Yemen,2011-11-01,6,0,-2,3,0,7
Yemen,2011-11-01,42,0,-62,-3,5,-18
Yemen,2011-11-01,49,0,-20,-3,3,29
Yemen,2011-11-01,56,0,0,9,9,74
Yemen,2011-11-01,40,0,-4,19,11,66
Yemen,2011-11-01,44,0,-1,-1,1,43
Yemen,2011-11-01,49,0,-4,4,1,50
Yemen,2011-11-01,24,0,2,6,0,32
Yemen,2011-11-01,3,0,0,6,1,10
Afghanistan,2011-10-01,22,0,0,-1,1,22
Afghanistan,2011-10-01,182,4,-9,46,21,244
Afghanistan,2011-10-01,217,0,1,7,18,243
Afghanistan,2011-10-01,252,0,0,24,22,298
Afghanistan,2011-10-01,85,0,0,17,32,134
Afghanistan,2011-10-01,19,0,0,0,6,25
Afghanistan,2011-10-01,276,6,0,50,35,367
Afghanistan,2011-10-01,358,6,-13,100,73,524
Afghanistan,2011-10-01,343,4,-7,109,62,511
Afghanistan,2011-10-01,184,0,0,22,25,231
Afghanistan,2011-10-01,213,4,-3,53,18,285
Afghanistan,2011-10-01,139,0,1,42,23,205
Afghanistan,2011-10-01,1053,24,-19,534,119,1711
Afghanistan,2011-10-01,483,0,-41,196,30,668
Afghanistan,2011-10-01,212,0,-13,36,27,262
Afghanistan,2011-10-01,175,0,-1,45,13,232
Afghanistan,2011-10-01,170,0,-10,58,14,232
Afghanistan,2011-10-01,147,0,0,17,17,181
Afghanistan,2011-10-01,146,6,-2,23,18,191
Afghanistan,2011-10-01,208,0,-2,16,18,240
Afghanistan,2011-10-01,274,0,-6,37,8,313
Afghanistan,2011-10-01,110,0,0,56,11,177
Afghanistan,2011-10-01,122,0,0,16,15,153
Afghanistan,2011-10-01,144,0,0,21,12,177
Afghanistan,2011-10-01,158,2,0,73,3,236
Afghanistan,2011-10-01,148,0,0,16,11,175
Afghanistan,2011-10-01,193,0,1,35,15,244
Afghanistan,2011-10-01,196,6,2,34,8,246
Afghanistan,2011-10-01,191,12,-6,-4,11,204
Afghanistan,2011-10-01,183,4,0,37,21,245
Afghanistan,2011-10-01,298,0,-8,41,49,380
Albania,2011-10-01,0,0,0,0,0,0
Albania,2011-10-01,2,0,0,0,4,6
Albania,2011-10-01,1,0,1,-2,0,0
Albania,2011-10-01,20,0,0,3,-2,21
Albania,2011-10-01,2,0,0,0,1,3
Albania,2011-10-01,0,0,0,-1,0,-1
Albania,2011-10-01,12,0,-4,6,2,16
Albania,2011-10-01,0,0,0,0,1,1
Albania,2011-10-01,0,0,0,0,0,0
Albania,2011-10-01,-2,0,0,0,0,-2
Albania,2011-10-01,4,0,-1,6,2,11
Albania,2011-10-01,-1,0,-1,6,2,6
Albania,2011-10-01,15,0,0,6,6,27
Albania,2011-10-01,3,0,-4,6,6,11
Albania,2011-10-01,0,0,0,0,13,13
Albania,2011-10-01,1,0,0,0,12,13
Albania,2011-10-01,9,0,0,-4,14,19
Albania,2011-10-01,13,0,0,33,0,46
Albania,2011-10-01,57,0,-6,36,11,98
Albania,2011-10-01,17,0,0,3,4,24
Albania,2011-10-01,17,0,0,9,2,28
Albania,2011-10-01,35,0,0,5,0,40
Albania,2011-10-01,12,0,0,0,0,12
Albania,2011-10-01,14,0,-3,4,1,16
Albania,2011-10-01,19,0,0,0,1,20
Albania,2011-10-01,6,0,0,0,0,6
Albania,2011-10-01,13,0,-1,6,0,18
Albania,2011-10-01,0,0,0,0,0,0
Albania,2011-10-01,0,0,0,0,0,0
Albania,2011-10-01,30,0,0,0,4,34
Albania,2011-10-01,13,0,0,0,4,17
Algeria,2011-10-01,4,0,0,10,0,14
Algeria,2011-10-01,7,0,0,6,1,14
Algeria,2011-10-01,4,0,0,7,1,12
Algeria,2011-10-01,0,0,0,3,1,4
Algeria,2011-10-01,0,0,0,3,0,3
Algeria,2011-10-01,0,0,0,6,0,6
Algeria,2011-10-01,7,0,-2,18,0,23
Algeria,2011-10-01,13,0,0,9,4,26
Algeria,2011-10-01,0,0,0,0,3,3
Algeria,2011-10-01,2,0,0,-4,0,-2
Algeria,2011-10-01,97,0,0,3,2,102
Algeria,2011-10-01,7,0,0,-4,6,9
Algeria,2011-10-01,27,0,0,1,0,28
Algeria,2011-10-01,12,2,-1,9,0,22
Algeria,2011-10-01,9,0,0,11,2,22
Algeria,2011-10-01,14,0,0,0,0,14
Algeria,2011-10-01,29,0,0,-1,4,32
Algeria,2011-10-01,23,0,0,3,3,29
Algeria,2011-10-01,0,0,0,0,2,2
Algeria,2011-10-01,64,0,0,70,4,138
Algeria,2011-10-01,46,0,0,19,1,66
Algeria,2011-10-01,76,0,0,33,10,119
Algeria,2011-10-01,20,0,0,38,8,66
Algeria,2011-10-01,13,0,0,4,1,18
Algeria,2011-10-01,20,2,0,15,4,41
Algeria,2011-10-01,4,2,0,-2,1,5
Algeria,2011-10-01,19,0,0,50,4,73
Algeria,2011-10-01,12,0,0,27,2,41
Algeria,2011-10-01,9,2,0,11,3,25
Algeria,2011-10-01,6,0,0,10,3,19
Algeria,2011-10-01,7,0,0,4,0,11
Bangladesh,2011-10-01,0,0,0,6,0,6
Bangladesh,2011-10-01,8,0,-2,9,3,18
Bangladesh,2011-10-01,53,2,0,15,3,73
Bangladesh,2011-10-01,18,0,2,0,1,21
Bangladesh,2011-10-01,-4,0,0,3,0,-1
Bangladesh,2011-10-01,0,0,0,0,0,0
Bangladesh,2011-10-01,13,0,0,3,0,16
Bangladesh,2011-10-01,8,0,0,22,0,30
Bangladesh,2011-10-01,2,0,0,19,6,27
Bangladesh,2011-10-01,10,0,0,0,-2,8
Bangladesh,2011-10-01,23,0,1,10,0,34
Bangladesh,2011-10-01,27,0,0,8,4,39
Bangladesh,2011-10-01,34,0,0,4,0,38
Bangladesh,2011-10-01,19,0,-2,4,0,21
Bangladesh,2011-10-01,27,4,0,0,0,31
Bangladesh,2011-10-01,22,0,0,7,3,32
Bangladesh,2011-10-01,11,0,0,0,2,13
Bangladesh,2011-10-01,7,0,1,0,3,11
Bangladesh,2011-10-01,21,0,0,12,14,47
Bangladesh,2011-10-01,4,0,2,-8,1,-1
Bangladesh,2011-10-01,9,0,0,9,0,18
Bangladesh,2011-10-01,8,0,0,9,1,18
Bangladesh,2011-10-01,55,0,0,11,2,68
Bangladesh,2011-10-01,17,0,0,4,2,23
Bangladesh,2011-10-01,21,0,0,12,3,36
Bangladesh,2011-10-01,4,0,2,-2,0,4
Bangladesh,2011-10-01,9,0,0,12,0,21
Bangladesh,2011-10-01,9,0,-1,6,0,14
Bangladesh,2011-10-01,8,0,0,0,0,8
Bangladesh,2011-10-01,2,0,0,22,5,29
Bangladesh,2011-10-01,11,0,3,39,5,58
Cameroon,2011-10-01,1,0,0,3,0,4
Cameroon,2011-10-01,0,0,0,0,0,0
Cameroon,2011-10-01,3,0,-2,3,0,4
Cameroon,2011-10-01,0,0,0,3,0,3
Cameroon,2011-10-01,0,0,0,0,0,0
Cameroon,2011-10-01,8,0,0,6,0,14
Cameroon,2011-10-01,1,0,0,0,0,1
Cameroon,2011-10-01,-1,0,0,0,2,1
Cameroon,2011-10-01,0,0,0,0,2,2
Cameroon,2011-10-01,2,0,0,0,0,2
Cameroon,2011-10-01,1,0,0,0,0,1
Cameroon,2011-10-01,1,0,0,0,0,1
Cameroon,2011-10-01,2,0,0,0,0,2
Cameroon,2011-10-01,3,0,0,0,1,4
Cameroon,2011-10-01,0,0,0,0,0,0
Cameroon,2011-10-01,3,0,0,0,1,4
Cameroon,2011-10-01,0,0,0,-2,5,3
Cameroon,2011-10-01,0,0,0,3,0,3
Cameroon,2011-10-01,16,0,0,0,0,16
Cameroon,2011-10-01,4,0,0,3,0,7
Cameroon,2011-10-01,4,0,0,9,0,13
Cameroon,2011-10-01,1,0,0,0,0,1
Cameroon,2011-10-01,0,0,0,0,0,0
Cameroon,2011-10-01,2,0,0,3,0,5
Cameroon,2011-10-01,-3,0,0,9,6,12
Cameroon,2011-10-01,2,0,-4,0,2,0
Cameroon,2011-10-01,0,0,0,3,0,3
Cameroon,2011-10-01,5,0,0,0,0,5
Cameroon,2011-10-01,6,0,2,0,0,8
China,2011-10-01,0,0,0,0,0,0
China,2011-10-01,118,0,-7,11,15,137
China,2011-10-01,123,0,-3,37,7,164
China,2011-10-01,171,2,-2,46,38,255
China,2011-10-01,155,2,0,6,28,191
China,2011-10-01,49,0,-1,27,1,76
China,2011-10-01,155,2,-4,12,49,214
China,2011-10-01,93,0,-5,28,8,124
China,2011-10-01,68,0,-6,32,14,108
China,2011-10-01,107,0,-6,17,11,129
China,2011-10-01,121,0,-2,27,8,154
China,2011-10-01,134,0,0,11,9,154
China,2011-10-01,207,6,3,24,26,266
China,2011-10-01,159,2,1,37,32,231
China,2011-10-01,134,0,0,6,15,155
China,2011-10-01,62,2,1,24,28,117
China,2011-10-01,152,0,-2,68,38,256
China,2011-10-01,165,0,2,50,38,255
China,2011-10-01,127,4,0,86,26,243
China,2011-10-01,144,2,3,44,12,205
China,2011-10-01,138,6,2,41,12,199
China,2011-10-01,66,0,-2,33,12,109
China,2011-10-01,85,0,0,27,15,127
China,2011-10-01,70,2,-1,39,7,117
China,2011-10-01,126,0,-2,31,29,184
China,2011-10-01,147,0,-8,77,19,235
China,2011-10-01,159,0,-2,38,26,221
China,2011-10-01,105,6,-5,33,23,162
China,2011-10-01,70,2,1,11,8,92
China,2011-10-01,72,0,1,40,2,115
China,2011-10-01,149,4,7,35,23,218
Egypt,2011-10-01,7,0,0,3,0,10
Egypt,2011-10-01,55,0,1,32,11,99
Egypt,2011-10-01,55,0,-4,44,15,110
Egypt,2011-10-01,97,0,2,43,28,170
Egypt,2011-10-01,56,0,-2,7,14,75
Egypt,2011-10-01,0,0,0,4,3,7
Egypt,2011-10-01,90,0,-5,4,15,104
Egypt,2011-10-01,50,0,-6,28,2,74
Egypt,2011-10-01,112,0,-3,54,25,188
Egypt,2011-10-01,165,0,3,45,9,222
Egypt,2011-10-01,240,2,-38,60,55,319
Egypt,2011-10-01,195,6,-6,10,27,232
Egypt,2011-10-01,166,0,0,65,28,259
Egypt,2011-10-01,183,0,-3,-9,14,185
Egypt,2011-10-01,157,0,0,-3,14,168
Egypt,2011-10-01,51,0,-2,-7,11,53
Egypt,2011-10-01,75,0,3,-21,11,68
Egypt,2011-10-01,196,0,-6,-191,6,5
Egypt,2011-10-01,63,0,2,-5,14,74
Egypt,2011-10-01,81,0,-2,-1,31,109
Egypt,2011-10-01,88,0,-4,21,18,123
Egypt,2011-10-01,75,0,-12,7,6,76
Egypt,2011-10-01,35,0,0,42,17,94
Egypt,2011-10-01,74,2,0,-16,17,77
Egypt,2011-10-01,106,0,-3,26,23,152
Egypt,2011-10-01,38,0,-1,23,14,74
Egypt,2011-10-01,61,0,-4,-12,20,65
Egypt,2011-10-01,63,0,-2,41,6,108
Egypt,2011-10-01,69,0,0,23,10,102
Egypt,2011-10-01,127,0,0,26,10,163
Egypt,2011-10-01,96,2,0,69,24,191
Eritrea,2011-10-01,0,0,0,3,0,3
Eritrea,2011-10-01,3,0,0,0,0,3
Eritrea,2011-10-01,0,0,0,0,0,0
Eritrea,2011-10-01,0,0,0,0,0,0
Eritrea,2011-10-01,0,0,0,3,0,3
Eritrea,2011-10-01,0,0,0,0,1,1
Eritrea,2011-10-01,0,0,0,0,0,0
Eritrea,2011-10-01,0,0,0,0,0,0
Eritrea,2011-10-01,0,0,0,0,0,0
Eritrea,2011-10-01,0,0,0,6,0,6
Eritrea,2011-10-01,0,0,0,-2,0,-2
Eritrea,2011-10-01,0,0,0,0,0,0
Eritrea,2011-10-01,0,0,0,0,0,0
Eritrea,2011-10-01,6,0,0,-4,0,2
Eritrea,2011-10-01,0,0,0,6,1,7
Eritrea,2011-10-01,2,0,0,7,1,10
Eritrea,2011-10-01,0,0,0,3,0,3
Eritrea,2011-10-01,2,0,0,0,0,2
Eritrea,2011-10-01,4,0,0,3,0,7
Eritrea,2011-10-01,0,0,0,0,0,0
Eritrea,2011-10-01,3,0,0,0,0,3
Eritrea,2011-10-01,0,0,0,0,0,0
Eritrea,2011-10-01,0,0,0,6,0,6
Eritrea,2011-10-01,0,0,0,15,2,17
Eritrea,2011-10-01,2,0,0,10,0,12
Eritrea,2011-10-01,11,0,0,24,0,35
Eritrea,2011-10-01,0,0,0,0,0,0
Eritrea,2011-10-01,2,0,0,0,0,2
Eritrea,2011-10-01,5,0,0,0,0,5
Georgia,2011-10-01,15,2,-1,16,4,36
Georgia,2011-10-01,46,2,0,15,0,63
Georgia,2011-10-01,90,4,-13,12,9,102
Georgia,2011-10-01,11,0,0,2,6,19
Georgia,2011-10-01,1,0,0,0,1,2
Georgia,2011-10-01,21,0,-2,14,1,34
Georgia,2011-10-01,5,0,0,0,1,6
Georgia,2011-10-01,16,0,0,-4,0,12
Georgia,2011-10-01,10,0,0,6,0,16
Georgia,2011-10-01,21,0,-2,7,1,27
Georgia,2011-10-01,3,0,-2,8,1,10
Georgia,2011-10-01,14,0,1,4,3,22
Georgia,2011-10-01,10,0,-2,13,9,30
Georgia,2011-10-01,12,0,0,1,0,13
Georgia,2011-10-01,17,0,1,11,1,30
Georgia,2011-10-01,36,4,1,22,0,63
Georgia,2011-10-01,29,2,0,4,1,36
Georgia,2011-10-01,9,0,-2,18,7,32
Georgia,2011-10-01,20,0,0,17,4,41
Georgia,2011-10-01,26,4,4,33,4,71
Georgia,2011-10-01,11,0,0,10,0,21
Georgia,2011-10-01,17,0,2,1,5,25
Georgia,2011-10-01,12,0,1,5,4,22
Georgia,2011-10-01,19,0,1,18,10,48
Georgia,2011-10-01,29,2,1,35,7,74
Georgia,2011-10-01,31,0,0,15,1,47
Georgia,2011-10-01,-1,0,1,30,2,32
Georgia,2011-10-01,14,0,1,32,7,54
Georgia,2011-10-01,6,0,0,1,0,7
Georgia,2011-10-01,29,0,2,3,9,43
India,2011-10-01,0,0,0,0,0,0
India,2011-10-01,13,2,-1,7,3,24
India,2011-10-01,24,0,0,25,13,62
India,2011-10-01,41,2,-1,31,14,87
India,2011-10-01,22,0,-4,9,6,33
India,2011-10-01,8,0,0,6,0,14
India,2011-10-01,61,0,-2,19,6,84
India,2011-10-01,28,0,0,0,4,32
India,2011-10-01,17,0,0,16,1,34
India,2011-10-01,46,0,-2,10,6,60
India,2011-10-01,51,0,-2,10,2,61
India,2011-10-01,44,4,-1,11,7,65
India,2011-10-01,37,0,0,23,11,71
India,2011-10-01,51,2,0,13,10,76
India,2011-10-01,41,0,0,15,1,57
India,2011-10-01,30,2,-3,8,8,45
India,2011-10-01,40,0,0,5,9,54
India,2011-10-01,72,0,0,-1,1,72
India,2011-10-01,64,6,0,10,10,90
India,2011-10-01,37,0,1,7,5,50
India,2011-10-01,69,0,1,7,13,90
India,2011-10-01,36,0,0,6,2,44
India,2011-10-01,26,2,0,4,1,33
India,2011-10-01,26,2,0,16,4,48
India,2011-10-01,16,6,0,0,5,27
India,2011-10-01,33,0,0,4,1,38
India,2011-10-01,42,0,0,8,3,53
India,2011-10-01,72,0,-1,1,4,76
India,2011-10-01,17,0,1,3,5,26
India,2011-10-01,23,2,0,20,1,46
India,2011-10-01,41,0,-3,17,7,62
Iran,2011-10-01,4,0,0,6,1,11
Iran,2011-10-01,39,0,1,13,3,56
Iran,2011-10-01,87,0,-2,79,9,173
Iran,2011-10-01,149,0,-10,37,8,184
Iran,2011-10-01,72,0,-1,11,7,89
Iran,2011-10-01,15,0,1,0,0,16
Iran,2011-10-01,64,0,0,64,4,132
Iran,2011-10-01,63,0,0,25,1,89
Iran,2011-10-01,46,2,0,30,2,80
Iran,2011-10-01,28,0,3,13,4,48
Iran,2011-10-01,304,2,3,209,17,535
Iran,2011-10-01,219,8,-1,117,8,351
Iran,2011-10-01,337,4,0,98,20,459
Iran,2011-10-01,158,0,1,63,37,259
Iran,2011-10-01,71,0,0,31,11,113
Iran,2011-10-01,90,0,3,-16,5,82
Iran,2011-10-01,147,0,1,64,3,215
Iran,2011-10-01,101,4,9,26,17,157
Iran,2011-10-01,102,0,0,69,10,181
Iran,2011-10-01,112,0,3,83,21,219
Iran,2011-10-01,111,2,3,47,19,182
Iran,2011-10-01,10,0,0,24,3,37
Iran,2011-10-01,388,2,-18,178,73,623
Iran,2011-10-01,442,6,-8,206,99,745
Iran,2011-10-01,164,0,1,154,43,362
Iran,2011-10-01,66,0,1,77,6,150
Iran,2011-10-01,60,0,0,38,8,106
Iran,2011-10-01,37,0,0,18,2,57
Iran,2011-10-01,18,0,0,15,1,34
Iran,2011-10-01,38,0,2,14,3,57
Iran,2011-10-01,57,0,-3,17,6,77
Iraq,2011-10-01,22,0,0,0,0,22
Iraq,2011-10-01,77,0,-1,37,7,120
Iraq,2011-10-01,64,0,0,16,1,81
Iraq,2011-10-01,72,4,1,9,0,86
Iraq,2011-10-01,77,0,-2,5,3,83
Iraq,2011-10-01,0,0,4,0,0,4
Iraq,2011-10-01,143,0,1,22,12,178
Iraq,2011-10-01,7,0,-2,5,16,26
Iraq,2011-10-01,13,0,1,0,0,14
Iraq,2011-10-01,30,0,-6,12,4,40
Iraq,2011-10-01,91,2,0,16,10,119
Iraq,2011-10-01,51,0,0,11,6,68
Iraq,2011-10-01,139,2,2,21,19,183
Iraq,2011-10-01,76,0,0,33,13,122
Iraq,2011-10-01,53,0,-1,21,14,87
Iraq,2011-10-01,49,0,-1,33,9,90
Iraq,2011-10-01,53,0,2,21,13,89
Iraq,2011-10-01,110,4,0,7,15,136
Iraq,2011-10-01,325,4,0,32,19,380
Iraq,2011-10-01,247,0,0,22,32,301
Iraq,2011-10-01,67,0,-1,31,38,135
Iraq,2011-10-01,152,0,2,28,36,218
Iraq,2011-10-01,29,0,1,20,2,52
Iraq,2011-10-01,22,0,1,28,8,59
Iraq,2011-10-01,83,0,2,36,10,131
Iraq,2011-10-01,109,4,0,47,25,185
Iraq,2011-10-01,114,2,-1,63,27,205
Iraq,2011-10-01,92,0,1,52,55,200
Iraq,2011-10-01,-108,10,0,104,42,48
Iraq,2011-10-01,36,0,1,120,47,204
Iraq,2011-10-01,152,2,8,97,51,310
Morocco,2011-10-01,0,0,0,0,0,0
Morocco,2011-10-01,0,0,0,0,0,0
Morocco,2011-10-01,27,0,0,9,2,38
Morocco,2011-10-01,27,0,0,9,0,36
Morocco,2011-10-01,5,0,0,10,5,20
Morocco,2011-10-01,4,0,0,3,2,9
Morocco,2011-10-01,37,0,1,1,4,43
Morocco,2011-10-01,6,0,0,3,0,9
Morocco,2011-10-01,6,0,0,0,0,6
Morocco,2011-10-01,2,0,0,0,3,5
Morocco,2011-10-01,7,0,1,6,1,15
Morocco,2011-10-01,15,0,0,0,1,16
Morocco,2011-10-01,-3,0,0,18,2,17
Morocco,2011-10-01,4,0,0,-6,0,-2
Morocco,2011-10-01,10,0,2,4,1,17
Morocco,2011-10-01,8,0,0,4,3,15
Morocco,2011-10-01,2,0,0,0,5,7
Morocco,2011-10-01,10,0,0,-2,1,9
Morocco,2011-10-01,5,0,0,15,4,24
Morocco,2011-10-01,-4,0,0,3,4,3
Morocco,2011-10-01,3,0,-1,3,2,7
Morocco,2011-10-01,13,0,0,12,1,26
Morocco,2011-10-01,19,0,-1,51,2,71
Morocco,2011-10-01,5,0,0,3,2,10
Morocco,2011-10-01,4,0,0,-2,8,10
Morocco,2011-10-01,5,0,-2,7,4,14
Morocco,2011-10-01,5,0,-2,1,0,4
Morocco,2011-10-01,5,0,0,21,0,26
Morocco,2011-10-01,5,0,-2,6,0,9
Morocco,2011-10-01,18,0,0,15,0,33
Morocco,2011-10-01,12,0,-2,39,7,56
Nigeria,2011-10-01,2,0,1,6,1,10
Nigeria,2011-10-01,70,0,0,3,4,77
Nigeria,2011-10-01,48,0,0,21,12,81
Nigeria,2011-10-01,56,0,0,67,18,141
Nigeria,2011-10-01,21,0,0,27,2,50
Nigeria,2011-10-01,23,0,0,1,5,29
Nigeria,2011-10-01,253,4,-11,202,37,485
Nigeria,2011-10-01,25,0,2,31,11,69
Nigeria,2011-10-01,8,0,0,3,0,11
Nigeria,2011-10-01,16,0,0,9,0,25
Nigeria,2011-10-01,58,0,2,33,13,106
Nigeria,2011-10-01,161,4,0,37,11,213
Nigeria,2011-10-01,42,0,0,42,10,94
Nigeria,2011-10-01,54,2,0,35,9,100
Nigeria,2011-10-01,13,0,0,-10,0,3
Nigeria,2011-10-01,42,0,0,-2,1,41
Nigeria,2011-10-01,20,0,1,9,8,38
Nigeria,2011-10-01,23,0,-1,54,3,79
Nigeria,2011-10-01,11,0,0,21,6,38
Nigeria,2011-10-01,36,0,0,6,5,47
Nigeria,2011-10-01,9,0,0,2,4,15
Nigeria,2011-10-01,23,0,1,12,0,36
Nigeria,2011-10-01,13,0,-2,1,1,13
Nigeria,2011-10-01,19,0,0,1,3,23
Nigeria,2011-10-01,27,2,0,3,4,36
Nigeria,2011-10-01,13,0,0,1,1,15
Nigeria,2011-10-01,44,0,0,7,1,52
Nigeria,2011-10-01,25,0,0,12,3,40
Nigeria,2011-10-01,11,2,0,4,0,17
Nigeria,2011-10-01,11,0,1,7,1,20
Nigeria,2011-10-01,37,0,4,12,3,56
Pakistan,2011-10-01,29,0,0,-2,2,29
Pakistan,2011-10-01,169,0,-1,59,18,245
Pakistan,2011-10-01,185,2,-6,105,22,308
Pakistan,2011-10-01,214,2,-6,56,47,313
Pakistan,2011-10-01,130,0,-2,41,15,184
Pakistan,2011-10-01,25,0,0,3,0,28
Pakistan,2011-10-01,156,0,0,7,8,171
Pakistan,2011-10-01,196,10,-6,37,18,255
Pakistan,2011-10-01,151,4,3,40,8,206
Pakistan,2011-10-01,74,0,0,21,0,95
Pakistan,2011-10-01,104,0,-1,38,10,151
Pakistan,2011-10-01,81,2,0,31,7,121
Pakistan,2011-10-01,224,2,-1,43,19,287
Pakistan,2011-10-01,80,0,1,29,22,132
Pakistan,2011-10-01,95,0,1,33,12,141
Pakistan,2011-10-01,145,0,1,7,10,163
Pakistan,2011-10-01,164,2,1,42,20,229
Pakistan,2011-10-01,105,0,0,44,0,149
Pakistan,2011-10-01,71,0,0,25,11,107
Pakistan,2011-10-01,139,0,2,64,4,209
Pakistan,2011-10-01,125,2,0,56,5,188
Pakistan,2011-10-01,92,0,1,34,5,132
Pakistan,2011-10-01,76,0,-6,10,9,89
Pakistan,2011-10-01,47,2,0,22,5,76
Pakistan,2011-10-01,132,2,4,33,0,171
Pakistan,2011-10-01,95,0,0,28,2,125
Pakistan,2011-10-01,70,0,1,8,11,90
Pakistan,2011-10-01,148,0,1,-3,1,147
Pakistan,2011-10-01,128,12,0,-7,21,154
Pakistan,2011-10-01,82,2,0,12,9,105
Pakistan,2011-10-01,96,6,2,23,15,142
Sierra Leone,2011-10-01,7,0,1,0,0,8
Sierra Leone,2011-10-01,6,0,0,0,0,6
Sierra Leone,2011-10-01,11,0,0,3,1,15
Sierra Leone,2011-10-01,-1,0,0,0,0,-1
Sierra Leone,2011-10-01,10,0,0,5,0,15
Sierra Leone,2011-10-01,0,0,0,0,0,0
Sierra Leone,2011-10-01,0,0,0,0,0,0
Sierra Leone,2011-10-01,2,0,0,3,2,7
Sierra Leone,2011-10-01,9,0,0,3,0,12
Sierra Leone,2011-10-01,0,0,0,0,-1,-1
Sierra Leone,2011-10-01,12,0,0,3,0,15
Sierra Leone,2011-10-01,0,0,0,3,0,3
Sierra Leone,2011-10-01,0,0,0,24,0,24
Sierra Leone,2011-10-01,5,0,1,19,0,25
Sierra Leone,2011-10-01,0,0,0,-2,0,-2
Sierra Leone,2011-10-01,6,0,0,3,0,9
Sierra Leone,2011-10-01,16,0,0,3,1,20
Sierra Leone,2011-10-01,0,0,0,0,0,0
Sierra Leone,2011-10-01,4,0,0,1,1,6
Sierra Leone,2011-10-01,8,0,-4,3,0,7
Sierra Leone,2011-10-01,4,0,2,-1,2,7
Sierra Leone,2011-10-01,0,0,0,0,2,2
Sierra Leone,2011-10-01,9,0,0,0,3,12
Sierra Leone,2011-10-01,1,0,0,0,0,1
Sierra Leone,2011-10-01,0,0,0,0,0,0
Sierra Leone,2011-10-01,-3,0,0,0,2,-1
Sierra Leone,2011-10-01,-5,0,0,0,0,-5
Sierra Leone,2011-10-01,-3,0,0,0,0,-3
Sierra Leone,2011-10-01,4,0,0,3,3,10
Somalia,2011-10-01,11,0,0,18,7,36
Somalia,2011-10-01,82,0,0,61,10,153
Somalia,2011-10-01,110,16,0,105,3,234
Somalia,2011-10-01,135,6,0,131,4,276
Somalia,2011-10-01,55,4,0,29,10,98
Somalia,2011-10-01,4,0,0,-1,0,3
Somalia,2011-10-01,48,6,0,33,4,91
Somalia,2011-10-01,12,0,0,8,2,22
Somalia,2011-10-01,13,0,0,10,2,25
Somalia,2011-10-01,50,2,0,10,1,63
Somalia,2011-10-01,79,0,0,-1,6,84
Somalia,2011-10-01,41,0,0,25,2,68
Somalia,2011-10-01,114,0,0,249,10,373
Somalia,2011-10-01,124,0,0,176,2,302
Somalia,2011-10-01,84,0,0,85,4,173
Somalia,2011-10-01,87,2,0,60,3,152
Somalia,2011-10-01,112,0,0,62,6,180
Somalia,2011-10-01,102,0,0,78,13,193
Somalia,2011-10-01,114,0,0,183,18,315
Somalia,2011-10-01,112,0,0,220,14,346
Somalia,2011-10-01,89,4,0,92,7,192
Somalia,2011-10-01,44,0,1,31,0,76
Somalia,2011-10-01,61,0,0,9,3,73
Somalia,2011-10-01,94,0,0,-8,3,89
Somalia,2011-10-01,122,0,0,115,8,245
Somalia,2011-10-01,76,2,0,93,21,192
Somalia,2011-10-01,143,2,0,60,15,220
Somalia,2011-10-01,203,2,0,97,10,312
Somalia,2011-10-01,117,0,-1,12,9,137
Somalia,2011-10-01,121,2,-1,4,4,130
Somalia,2011-10-01,65,4,5,20,3,97
Syria,2011-10-01,30,0,0,6,2,38
Syria,2011-10-01,73,0,-2,4,11,86
Syria,2011-10-01,104,4,0,24,31,163
Syria,2011-10-01,235,2,-5,88,40,360
Syria,2011-10-01,254,2,-3,30,40,323
Syria,2011-10-01,35,0,-1,3,2,39
Syria,2011-10-01,410,0,-24,39,54,479
Syria,2011-10-01,254,0,-13,43,68,352
Syria,2011-10-01,185,0,-6,29,74,282
Syria,2011-10-01,157,0,-2,29,18,202
Syria,2011-10-01,235,0,1,50,21,307
Syria,2011-10-01,124,0,-2,98,18,238
Syria,2011-10-01,168,0,-6,22,33,217
Syria,2011-10-01,205,0,0,39,28,272
Syria,2011-10-01,123,0,-4,16,26,161
Syria,2011-10-01,83,0,0,2,10,95
Syria,2011-10-01,164,0,1,12,26,203
Syria,2011-10-01,477,6,-23,186,72,718
Syria,2011-10-01,569,22,-16,246,122,943
Syria,2011-10-01,167,0,-4,21,10,194
Syria,2011-10-01,278,0,-6,15,14,301
Syria,2011-10-01,141,0,-2,20,21,180
Syria,2011-10-01,156,0,-10,6,22,174
Syria,2011-10-01,160,0,0,11,17,188
Syria,2011-10-01,65,0,0,3,11,79
Syria,2011-10-01,57,0,-4,1,14,68
Syria,2011-10-01,95,0,2,-7,24,114
Syria,2011-10-01,100,0,4,25,16,145
Syria,2011-10-01,145,0,-4,51,12,204
Syria,2011-10-01,82,0,0,17,13,112
Syria,2011-10-01,145,0,3,10,12,170
Yemen,2011-10-01,45,0,0,0,2,47
Yemen,2011-10-01,212,0,-8,36,7,247
Yemen,2011-10-01,114,6,-4,24,14,154
Yemen,2011-10-01,165,0,0,40,4,209
Yemen,2011-10-01,29,0,0,5,0,34
Yemen,2011-10-01,20,0,0,0,0,20
Yemen,2011-10-01,147,0,5,13,17,182
Yemen,2011-10-01,71,0,-14,3,9,69
Yemen,2011-10-01,73,0,-13,22,8,90
Yemen,2011-10-01,22,0,-4,13,5,36
Yemen,2011-10-01,67,4,-2,15,14,98
Yemen,2011-10-01,140,2,-2,38,17,195
Yemen,2011-10-01,86,0,-8,37,9,124
Yemen,2011-10-01,18,0,-2,3,7,26
Yemen,2011-10-01,87,0,0,0,3,90
Yemen,2011-10-01,116,0,-6,17,9,136
Yemen,2011-10-01,44,0,0,0,6,50
Yemen,2011-10-01,62,0,-6,-1,2,57
Yemen,2011-10-01,58,0,-7,7,9,67
Yemen,2011-10-01,33,0,-16,10,13,40
Yemen,2011-10-01,102,0,-12,15,8,113
Yemen,2011-10-01,123,0,-16,-3,8,112
Yemen,2011-10-01,28,2,0,0,7,37
Yemen,2011-10-01,42,0,0,27,6,75
Yemen,2011-10-01,13,0,-5,9,3,20
Yemen,2011-10-01,15,0,-6,14,7,30
Yemen,2011-10-01,24,0,0,28,10,62
Yemen,2011-10-01,8,0,2,6,25,41
Yemen,2011-10-01,22,0,0,27,13,62
Yemen,2011-10-01,57,0,0,24,7,88
Yemen,2011-10-01,18,0,0,-2,0,16
Afghanistan,2011-04-01,318,0,-2,47,31,394
Afghanistan,2011-04-01,217,0,2,20,47,286
Afghanistan,2011-04-01,221,0,0,91,57,369
Afghanistan,2011-04-01,252,0,-2,78,42,370
Afghanistan,2011-04-01,216,0,-13,26,24,253
Afghanistan,2011-04-01,188,0,-3,31,28,244
Afghanistan,2011-04-01,275,4,-2,23,50,350
Afghanistan,2011-04-01,310,6,-4,-11,27,328
Afghanistan,2011-04-01,189,6,-2,30,17,240
Afghanistan,2011-04-01,138,2,-2,33,10,181
Afghanistan,2011-04-01,181,4,0,10,6,201
Afghanistan,2011-04-01,198,6,0,39,14,257
Afghanistan,2011-04-01,221,2,0,24,45,292
Afghanistan,2011-04-01,171,0,0,16,24,211
Afghanistan,2011-04-01,178,0,1,21,39,239
Afghanistan,2011-04-01,246,4,-1,-3,43,289
Afghanistan,2011-04-01,156,2,0,14,24,196
Afghanistan,2011-04-01,234,2,4,42,37,319
Afghanistan,2011-04-01,229,2,1,93,37,362
Afghanistan,2011-04-01,460,2,-4,60,33,551
Afghanistan,2011-04-01,342,6,-1,43,31,421
Afghanistan,2011-04-01,390,0,0,45,45,480
Afghanistan,2011-04-01,302,0,5,57,40,404
Afghanistan,2011-04-01,159,0,-1,51,28,237
Afghanistan,2011-04-01,264,8,2,110,24,408
Afghanistan,2011-04-01,343,2,4,110,20,479
Afghanistan,2011-04-01,290,0,-11,94,15,388
Afghanistan,2011-04-01,671,4,-22,299,85,1037
Afghanistan,2011-04-01,341,6,1,99,40,487
Afghanistan,2011-04-01,253,0,3,52,17,325
Albania,2011-04-01,20,0,-2,0,0,18
Albania,2011-04-01,1,0,0,0,0,1
Albania,2011-04-01,5,0,0,3,0,8
Albania,2011-04-01,2,0,3,0,0,5
Albania,2011-04-01,1,0,0,7,2,10
Albania,2011-04-01,15,0,0,-2,0,13
Albania,2011-04-01,-3,0,2,30,0,29
Albania,2011-04-01,1,0,3,1,0,5
Albania,2011-04-01,-1,0,0,3,0,2
Albania,2011-04-01,3,0,0,0,0,3
Albania,2011-04-01,7,0,0,0,0,7
Albania,2011-04-01,12,0,0,0,0,12
Albania,2011-04-01,7,0,0,-2,0,5
Albania,2011-04-01,9,0,0,1,2,12
Albania,2011-04-01,8,0,0,-1,4,11
Albania,2011-04-01,3,0,-4,6,0,5
Albania,2011-04-01,12,0,0,6,0,18
Albania,2011-04-01,7,0,0,3,0,10
Albania,2011-04-01,3,0,0,29,3,35
Albania,2011-04-01,5,0,0,3,0,8
Albania,2011-04-01,9,0,0,0,0,9
Albania,2011-04-01,0,0,-1,0,0,-1
Albania,2011-04-01,5,0,0,3,0,8
Albania,2011-04-01,5,0,0,9,0,14
Albania,2011-04-01,9,0,-3,6,0,12
Albania,2011-04-01,24,0,0,0,4,28
Albania,2011-04-01,10,0,0,0,0,10
Albania,2011-04-01,3,0,1,6,1,11
Albania,2011-04-01,0,0,0,0,0,0
Algeria,2011-04-01,15,0,0,3,2,20
Algeria,2011-04-01,0,0,0,0,0,0
Algeria,2011-04-01,3,0,0,9,1,13
Algeria,2011-04-01,36,0,2,6,5,49
Algeria,2011-04-01,10,0,1,3,5,19
Algeria,2011-04-01,23,0,0,-6,0,17
Algeria,2011-04-01,6,2,0,0,0,8
Algeria,2011-04-01,2,0,0,7,2,11
Algeria,2011-04-01,4,0,0,-6,6,4
Algeria,2011-04-01,21,0,0,6,0,27
Algeria,2011-04-01,38,0,-20,-2,0,16
Algeria,2011-04-01,28,0,-4,0,2,26
Algeria,2011-04-01,26,0,0,3,5,34
Algeria,2011-04-01,30,0,0,2,-1,31
Algeria,2011-04-01,23,0,-7,6,5,27
Algeria,2011-04-01,20,0,-13,3,0,10
Algeria,2011-04-01,30,0,-3,6,3,36
Algeria,2011-04-01,15,0,-2,-6,5,12
Algeria,2011-04-01,7,0,0,1,0,8
Algeria,2011-04-01,5,0,0,3,0,8
Algeria,2011-04-01,19,0,0,12,0,31
Algeria,2011-04-01,12,0,0,3,0,15
Algeria,2011-04-01,12,0,0,0,2,14
Algeria,2011-04-01,-1,0,0,0,0,-1
Algeria,2011-04-01,11,0,0,3,0,14
Algeria,2011-04-01,18,0,-1,9,0,26
Algeria,2011-04-01,10,2,0,7,0,19
Algeria,2011-04-01,6,0,0,21,2,29
Algeria,2011-04-01,39,0,0,11,0,50
Algeria,2011-04-01,15,0,-2,0,0,13
Bangladesh,2011-04-01,9,0,1,8,7,25
Bangladesh,2011-04-01,22,0,0,6,6,34
Bangladesh,2011-04-01,64,0,0,12,15,91
Bangladesh,2011-04-01,17,0,0,6,7,30
Bangladesh,2011-04-01,72,0,15,-1,4,90
Bangladesh,2011-04-01,18,0,0,3,4,25
Bangladesh,2011-04-01,17,0,0,0,3,20
Bangladesh,2011-04-01,16,0,0,15,5,36
Bangladesh,2011-04-01,16,0,0,0,0,16
Bangladesh,2011-04-01,8,0,0,7,1,16
Bangladesh,2011-04-01,11,0,0,10,3,24
Bangladesh,2011-04-01,37,0,0,18,5,60
Bangladesh,2011-04-01,16,0,0,0,3,19
Bangladesh,2011-04-01,15,0,0,3,7,25
Bangladesh,2011-04-01,60,0,0,10,3,73
Bangladesh,2011-04-01,50,2,0,15,11,78
Bangladesh,2011-04-01,53,4,0,9,2,68
Bangladesh,2011-04-01,22,0,0,-2,3,23
Bangladesh,2011-04-01,14,0,0,-1,6,19
Bangladesh,2011-04-01,15,0,1,2,6,24
Bangladesh,2011-04-01,24,0,0,4,0,28
Bangladesh,2011-04-01,28,0,0,7,2,37
Bangladesh,2011-04-01,36,0,0,6,1,43
Bangladesh,2011-04-01,6,0,0,15,0,21
Bangladesh,2011-04-01,19,0,1,-7,2,15
Bangladesh,2011-04-01,24,2,1,4,2,33
Bangladesh,2011-04-01,14,0,0,6,2,22
Bangladesh,2011-04-01,28,2,0,20,0,50
Bangladesh,2011-04-01,14,0,0,6,1,21
Bangladesh,2011-04-01,11,0,-2,-4,0,5
Cameroon,2011-04-01,0,2,0,-4,0,-2
Cameroon,2011-04-01,2,0,0,0,0,2
Cameroon,2011-04-01,0,0,0,0,0,0
Cameroon,2011-04-01,1,0,0,7,0,8
Cameroon,2011-04-01,12,0,0,-1,0,11
Cameroon,2011-04-01,12,0,0,-2,0,10
Cameroon,2011-04-01,0,0,0,-2,0,-2
Cameroon,2011-04-01,5,0,0,-2,0,3
Cameroon,2011-04-01,5,0,0,-2,0,3
Cameroon,2011-04-01,5,0,0,-2,0,3
Cameroon,2011-04-01,0,0,0,-2,0,-2
Cameroon,2011-04-01,5,0,0,-2,0,3
Cameroon,2011-04-01,0,0,0,3,0,3
Cameroon,2011-04-01,0,0,0,3,0,3
Cameroon,2011-04-01,0,0,0,0,1,1
Cameroon,2011-04-01,0,0,0,0,0,0
Cameroon,2011-04-01,1,0,0,0,1,2
Cameroon,2011-04-01,3,0,0,-1,0,2
Cameroon,2011-04-01,0,0,0,0,0,0
Cameroon,2011-04-01,-1,0,0,0,0,-1
Cameroon,2011-04-01,0,0,0,0,0,0
Cameroon,2011-04-01,0,6,0,7,0,13
Cameroon,2011-04-01,0,0,0,0,0,0
Cameroon,2011-04-01,0,0,0,0,0,0
Cameroon,2011-04-01,0,0,0,0,0,0
Cameroon,2011-04-01,0,0,0,0,0,0
Cameroon,2011-04-01,6,0,0,0,0,6
China,2011-04-01,141,6,-5,94,13,249
China,2011-04-01,110,0,-1,57,10,176
China,2011-04-01,86,4,-4,35,8,129
China,2011-04-01,215,8,-1,58,34,314
China,2011-04-01,121,2,-5,82,26,226
China,2011-04-01,132,2,1,131,19,285
China,2011-04-01,167,2,3,48,17,237
China,2011-04-01,145,0,-2,18,10,171
China,2011-04-01,81,2,0,48,30,161
China,2011-04-01,99,6,0,-10,12,107
China,2011-04-01,153,0,-4,12,16,177
China,2011-04-01,115,4,-5,91,25,230
China,2011-04-01,147,2,-4,115,20,280
China,2011-04-01,142,0,-4,79,18,235
China,2011-04-01,147,2,2,55,6,212
China,2011-04-01,75,4,-4,34,15,124
China,2011-04-01,81,2,-4,40,6,125
China,2011-04-01,149,8,2,90,8,257
China,2011-04-01,192,4,-6,83,21,294
China,2011-04-01,123,0,5,43,9,180
China,2011-04-01,125,0,0,26,9,160
China,2011-04-01,105,8,-4,48,20,177
China,2011-04-01,77,0,-4,22,4,99
China,2011-04-01,57,0,-2,35,11,101
China,2011-04-01,89,2,-2,41,14,144
China,2011-04-01,138,1,1,76,16,232
China,2011-04-01,140,0,4,52,19,215
China,2011-04-01,94,0,0,93,16,203
China,2011-04-01,187,11,-7,66,23,280
China,2011-04-01,120,2,-6,10,24,150
Egypt,2011-04-01,89,0,-3,84,8,178
Egypt,2011-04-01,54,0,-5,21,8,78
Egypt,2011-04-01,71,0,-2,17,14,100
Egypt,2011-04-01,58,2,-10,20,21,91
Egypt,2011-04-01,106,10,-6,39,29,178
Egypt,2011-04-01,151,2,-5,63,48,259
Egypt,2011-04-01,120,0,-19,68,25,194
Egypt,2011-04-01,143,2,-3,61,37,240
Egypt,2011-04-01,182,2,-6,52,36,266
Egypt,2011-04-01,149,0,-10,91,54,284
Egypt,2011-04-01,108,0,0,130,37,275
Egypt,2011-04-01,79,2,-16,179,10,254
Egypt,2011-04-01,107,0,-18,103,23,215
Egypt,2011-04-01,146,2,-18,103,22,255
Egypt,2011-04-01,104,6,-5,88,45,238
Egypt,2011-04-01,79,4,4,77,17,181
Egypt,2011-04-01,91,0,-5,74,19,179
Egypt,2011-04-01,120,2,-9,43,33,189
Egypt,2011-04-01,126,2,-19,50,32,191
Egypt,2011-04-01,100,2,-16,55,19,160
Egypt,2011-04-01,73,0,-10,56,33,152
Egypt,2011-04-01,66,0,2,71,13,152
Egypt,2011-04-01,56,4,-10,36,3,89
Egypt,2011-04-01,76,0,-13,63,12,138
Egypt,2011-04-01,119,0,-5,80,20,214
Egypt,2011-04-01,118,2,-3,83,19,219
Egypt,2011-04-01,74,4,-12,22,11,99
Egypt,2011-04-01,58,2,-6,-7,22,69
Egypt,2011-04-01,59,0,-6,21,14,88
Egypt,2011-04-01,90,2,-2,44,17,151
Eritrea,2011-04-01,0,0,0,3,0,3
Eritrea,2011-04-01,6,0,0,0,0,6
Eritrea,2011-04-01,6,0,0,6,0,12
Eritrea,2011-04-01,5,0,0,0,0,5
Eritrea,2011-04-01,1,0,-1,0,0,0
Eritrea,2011-04-01,5,0,0,0,0,5
Eritrea,2011-04-01,0,0,0,-2,0,-2
Eritrea,2011-04-01,0,0,0,0,0,0
Eritrea,2011-04-01,3,0,0,0,0,3
Eritrea,2011-04-01,6,0,1,1,2,10
Eritrea,2011-04-01,8,0,0,6,14,28
Eritrea,2011-04-01,10,0,0,9,0,19
Eritrea,2011-04-01,3,0,0,0,0,3
Eritrea,2011-04-01,0,0,0,0,0,0
Eritrea,2011-04-01,0,0,0,0,0,0
Eritrea,2011-04-01,0,0,0,0,0,0
Eritrea,2011-04-01,0,0,0,0,0,0
Eritrea,2011-04-01,0,0,0,0,0,0
Eritrea,2011-04-01,8,0,0,6,10,24
Eritrea,2011-04-01,5,0,0,9,0,14
Eritrea,2011-04-01,3,0,0,3,0,6
Eritrea,2011-04-01,0,0,0,-4,2,-2
Eritrea,2011-04-01,1,0,0,0,0,1
Eritrea,2011-04-01,0,0,0,0,0,0
Eritrea,2011-04-01,0,0,0,-2,0,-2
Eritrea,2011-04-01,0,0,0,0,0,0
Eritrea,2011-04-01,3,0,0,0,0,3
Eritrea,2011-04-01,-1,0,0,9,0,8
Georgia,2011-04-01,56,2,-2,-8,5,53
Georgia,2011-04-01,14,2,0,6,0,22
Georgia,2011-04-01,5,0,0,15,1,21
Georgia,2011-04-01,40,4,0,30,5,79
Georgia,2011-04-01,51,4,0,71,13,139
Georgia,2011-04-01,22,0,2,27,6,57
Georgia,2011-04-01,58,4,0,18,2,82
Georgia,2011-04-01,62,0,0,24,3,89
Georgia,2011-04-01,7,0,0,6,4,17
Georgia,2011-04-01,20,2,-2,21,3,44
Georgia,2011-04-01,43,10,0,18,14,85
Georgia,2011-04-01,26,2,-7,6,7,34
Georgia,2011-04-01,26,0,-4,28,7,57
Georgia,2011-04-01,48,4,1,5,4,62
Georgia,2011-04-01,35,2,-4,33,1,67
Georgia,2011-04-01,24,0,-4,1,3,24
Georgia,2011-04-01,29,0,0,11,1,41
Georgia,2011-04-01,60,4,0,31,7,102
Georgia,2011-04-01,36,0,1,6,7,50
Georgia,2011-04-01,39,0,0,36,6,81
Georgia,2011-04-01,7,0,0,11,7,25
Georgia,2011-04-01,47,4,1,28,1,81
Georgia,2011-04-01,18,0,0,3,2,23
Georgia,2011-04-01,5,4,0,-4,2,7
Georgia,2011-04-01,11,2,0,14,5,32
Georgia,2011-04-01,26,2,-6,17,9,48
Georgia,2011-04-01,65,2,-6,29,4,94
Georgia,2011-04-01,47,4,1,26,7,85
Georgia,2011-04-01,47,2,1,51,10,111
Georgia,2011-04-01,22,0,0,18,1,41
India,2011-04-01,71,2,-10,7,4,74
India,2011-04-01,23,2,-2,15,5,43
India,2011-04-01,47,2,-2,17,4,68
India,2011-04-01,42,4,-4,20,12,74
India,2011-04-01,95,0,3,24,9,131
India,2011-04-01,76,6,-1,20,10,111
India,2011-04-01,58,10,-7,-5,24,80
India,2011-04-01,77,0,-2,9,11,95
India,2011-04-01,74,2,0,13,9,98
India,2011-04-01,25,4,0,25,5,59
India,2011-04-01,50,2,-7,13,15,73
India,2011-04-01,50,4,-3,8,4,63
India,2011-04-01,59,4,-1,12,16,90
India,2011-04-01,62,0,-2,7,4,71
India,2011-04-01,77,2,-2,22,7,106
India,2011-04-01,56,0,0,3,8,67
India,2011-04-01,54,0,0,31,2,87
India,2011-04-01,61,2,-4,16,9,84
India,2011-04-01,77,0,-14,30,10,103
India,2011-04-01,67,2,-7,10,8,80
India,2011-04-01,51,2,-4,11,9,69
India,2011-04-01,75,0,-3,27,28,127
India,2011-04-01,41,0,1,15,3,60
India,2011-04-01,35,2,0,17,1,55
India,2011-04-01,33,0,-1,15,6,53
India,2011-04-01,70,0,-2,23,9,100
India,2011-04-01,78,0,-4,10,15,99
India,2011-04-01,33,0,0,-1,5,37
India,2011-04-01,98,0,-8,27,5,122
India,2011-04-01,63,0,-2,23,4,88
Iran,2011-04-01,74,0,0,68,13,155
Iran,2011-04-01,101,0,-8,4,2,99
Iran,2011-04-01,55,0,-3,31,26,109
Iran,2011-04-01,65,0,-1,44,9,117
Iran,2011-04-01,28,0,0,30,9,67
Iran,2011-04-01,69,4,0,17,12,102
Iran,2011-04-01,106,0,-8,32,25,155
Iran,2011-04-01,199,0,3,28,17,247
Iran,2011-04-01,78,0,0,21,2,101
Iran,2011-04-01,115,0,2,18,15,150
Iran,2011-04-01,138,0,0,44,13,195
Iran,2011-04-01,81,0,-1,70,17,167
Iran,2011-04-01,64,0,0,44,8,116
Iran,2011-04-01,117,0,1,47,7,172
Iran,2011-04-01,212,2,1,57,9,281
Iran,2011-04-01,41,0,0,25,8,74
Iran,2011-04-01,33,0,-37,-3,0,-7
Iran,2011-04-01,141,0,-10,83,10,224
Iran,2011-04-01,91,4,2,40,5,142
Iran,2011-04-01,80,2,-4,66,22,166
Iran,2011-04-01,68,0,-3,49,9,123
Iran,2011-04-01,101,2,-6,50,23,170
Iran,2011-04-01,66,4,-4,9,10,85
Iran,2011-04-01,89,0,-8,15,11,107
Iran,2011-04-01,90,10,-1,16,15,130
Iran,2011-04-01,131,8,-3,19,17,172
Iran,2011-04-01,99,0,-20,35,3,117
Iran,2011-04-01,65,0,-2,11,21,95
Iran,2011-04-01,78,0,1,28,12,119
Iran,2011-04-01,64,0,-2,34,14,110
Iraq,2011-04-01,126,0,1,11,8,146
Iraq,2011-04-01,109,0,-7,14,10,126
Iraq,2011-04-01,143,0,0,4,13,160
Iraq,2011-04-01,236,0,1,32,8,277
Iraq,2011-04-01,120,0,-3,33,14,164
Iraq,2011-04-01,119,2,-2,29,16,164
Iraq,2011-04-01,94,6,-3,13,20,130
Iraq,2011-04-01,203,2,1,55,24,285
Iraq,2011-04-01,124,0,-1,13,17,153
Iraq,2011-04-01,68,0,1,42,11,122
Iraq,2011-04-01,169,0,0,74,21,264
Iraq,2011-04-01,148,0,1,31,14,194
Iraq,2011-04-01,88,2,-1,34,22,145
Iraq,2011-04-01,172,0,0,46,14,232
Iraq,2011-04-01,148,2,-2,115,32,295
Iraq,2011-04-01,92,6,-8,68,9,167
Iraq,2011-04-01,66,2,-1,26,21,114
Iraq,2011-04-01,101,4,-9,42,32,170
Iraq,2011-04-01,169,0,2,28,24,223
Iraq,2011-04-01,146,0,4,28,24,202
Iraq,2011-04-01,114,6,0,40,17,177
Iraq,2011-04-01,123,0,0,25,30,178
Iraq,2011-04-01,111,0,5,30,21,167
Iraq,2011-04-01,105,0,0,20,14,139
Iraq,2011-04-01,141,0,2,15,17,175
Iraq,2011-04-01,123,0,3,40,10,176
Iraq,2011-04-01,158,0,-3,20,9,184
Iraq,2011-04-01,77,2,-6,33,16,122
Iraq,2011-04-01,107,2,1,55,17,182
Iraq,2011-04-01,119,0,1,-4,19,135
Morocco,2011-04-01,12,0,0,3,0,15
Morocco,2011-04-01,7,0,0,3,1,11
Morocco,2011-04-01,5,0,0,-2,6,9
Morocco,2011-04-01,15,0,0,-2,2,15
Morocco,2011-04-01,3,0,1,0,2,6
Morocco,2011-04-01,4,0,0,6,1,11
Morocco,2011-04-01,6,0,0,-3,1,4
Morocco,2011-04-01,17,0,-8,-8,3,4
Morocco,2011-04-01,5,0,0,9,2,16
Morocco,2011-04-01,4,0,0,4,5,13
Morocco,2011-04-01,15,0,-1,19,1,34
Morocco,2011-04-01,9,0,0,3,1,13
Morocco,2011-04-01,5,2,0,3,0,10
Morocco,2011-04-01,10,0,0,-1,2,11
Morocco,2011-04-01,0,0,-2,4,0,2
Morocco,2011-04-01,1,0,-4,1,0,-2
Morocco,2011-04-01,6,0,-4,-2,1,1
Morocco,2011-04-01,1,0,0,6,1,8
Morocco,2011-04-01,6,0,-1,1,1,7
Morocco,2011-04-01,14,0,0,0,3,17
Morocco,2011-04-01,12,0,0,0,0,12
Morocco,2011-04-01,11,0,0,0,0,11
Morocco,2011-04-01,3,0,-2,-4,1,-2
Morocco,2011-04-01,10,0,0,3,8,21
Morocco,2011-04-01,22,0,1,0,3,26
Morocco,2011-04-01,4,0,-4,4,4,8
Morocco,2011-04-01,5,0,-2,1,2,6
Morocco,2011-04-01,191,0,0,-2,3,192
Morocco,2011-04-01,202,0,0,38,24,264
Morocco,2011-04-01,36,0,0,47,16,99
Nigeria,2011-04-01,36,2,-3,2,5,42
Nigeria,2011-04-01,41,6,-14,15,2,50
Nigeria,2011-04-01,30,2,-2,6,6,42
Nigeria,2011-04-01,16,0,-1,-7,7,15
Nigeria,2011-04-01,39,2,-6,24,3,62
Nigeria,2011-04-01,36,0,1,7,2,46
Nigeria,2011-04-01,52,0,-5,15,3,65
Nigeria,2011-04-01,42,0,1,4,4,51
Nigeria,2011-04-01,17,0,0,3,8,28
Nigeria,2011-04-01,33,0,0,18,1,52
Nigeria,2011-04-01,15,0,0,1,1,17
Nigeria,2011-04-01,24,0,0,3,3,30
Nigeria,2011-04-01,8,0,0,6,4,18
Nigeria,2011-04-01,34,0,-5,18,1,48
Nigeria,2011-04-01,22,0,0,31,1,54
Nigeria,2011-04-01,29,0,1,16,0,46
Nigeria,2011-04-01,9,0,1,10,4,24
Nigeria,2011-04-01,31,0,6,15,9,61
Nigeria,2011-04-01,28,0,4,0,2,34
Nigeria,2011-04-01,62,0,0,31,2,95
Nigeria,2011-04-01,67,0,1,22,6,96
Nigeria,2011-04-01,20,0,0,12,2,34
Nigeria,2011-04-01,22,0,0,21,6,49
Nigeria,2011-04-01,21,4,0,9,3,37
Nigeria,2011-04-01,28,0,0,3,4,35
Nigeria,2011-04-01,14,2,0,17,16,49
Nigeria,2011-04-01,15,0,0,3,13,31
Nigeria,2011-04-01,10,0,0,7,3,20
Nigeria,2011-04-01,20,2,0,13,9,44
Nigeria,2011-04-01,11,0,0,0,1,12
Pakistan,2011-04-01,90,0,-2,35,20,143
Pakistan,2011-04-01,39,4,0,31,10,84
Pakistan,2011-04-01,33,0,0,25,13,71
Pakistan,2011-04-01,48,0,0,77,3,128
Pakistan,2011-04-01,77,0,0,48,5,130
Pakistan,2011-04-01,80,0,0,35,10,125
Pakistan,2011-04-01,146,6,0,42,52,246
Pakistan,2011-04-01,91,0,-4,25,18,130
Pakistan,2011-04-01,49,0,2,15,9,75
Pakistan,2011-04-01,57,2,1,9,9,78
Pakistan,2011-04-01,71,0,0,4,4,79
Pakistan,2011-04-01,172,0,-4,49,15,232
Pakistan,2011-04-01,143,0,-2,61,13,215
Pakistan,2011-04-01,137,0,-6,22,38,191
Pakistan,2011-04-01,105,0,-2,35,14,152
Pakistan,2011-04-01,85,0,0,11,21,117
Pakistan,2011-04-01,111,0,0,-3,5,113
Pakistan,2011-04-01,85,0,1,44,7,137
Pakistan,2011-04-01,82,6,0,27,11,126
Pakistan,2011-04-01,42,2,-6,7,0,45
Pakistan,2011-04-01,104,0,1,19,30,154
Pakistan,2011-04-01,142,6,1,50,14,213
Pakistan,2011-04-01,102,4,2,31,22,161
Pakistan,2011-04-01,46,2,3,17,11,79
Pakistan,2011-04-01,121,2,1,89,10,223
Pakistan,2011-04-01,95,0,0,91,16,202
Pakistan,2011-04-01,77,0,0,33,7,117
Pakistan,2011-04-01,90,0,-8,-6,6,82
Pakistan,2011-04-01,61,0,1,30,8,100
Pakistan,2011-04-01,39,0,1,8,2,50
Sierra Leone,2011-04-01,6,0,0,0,3,9
Sierra Leone,2011-04-01,0,0,0,0,0,0
Sierra Leone,2011-04-01,2,0,0,0,0,2
Sierra Leone,2011-04-01,6,0,0,0,0,6
Sierra Leone,2011-04-01,17,0,0,3,0,20
Sierra Leone,2011-04-01,4,0,0,0,0,4
Sierra Leone,2011-04-01,0,0,0,3,0,3
Sierra Leone,2011-04-01,18,0,0,0,0,18
Sierra Leone,2011-04-01,11,0,0,0,0,11
Sierra Leone,2011-04-01,0,0,0,0,0,0
Sierra Leone,2011-04-01,0,0,0,0,0,0
Sierra Leone,2011-04-01,0,0,0,0,0,0
Sierra Leone,2011-04-01,3,0,0,3,0,6
Sierra Leone,2011-04-01,-2,0,0,0,0,-2
Sierra Leone,2011-04-01,5,0,0,6,2,13
Sierra Leone,2011-04-01,1,0,0,-2,0,-1
Sierra Leone,2011-04-01,0,0,0,0,0,0
Sierra Leone,2011-04-01,1,0,0,3,0,4
Sierra Leone,2011-04-01,4,0,0,9,0,13
Sierra Leone,2011-04-01,3,0,0,3,1,7
Sierra Leone,2011-04-01,0,0,0,0,1,1
Sierra Leone,2011-04-01,0,0,0,0,0,0
Sierra Leone,2011-04-01,1,0,0,0,0,1
Sierra Leone,2011-04-01,0,0,0,0,0,0
Sierra Leone,2011-04-01,0,0,0,0,0,0
Sierra Leone,2011-04-01,1,0,0,0,1,2
Sierra Leone,2011-04-01,8,0,0,6,0,14
Sierra Leone,2011-04-01,0,0,0,0,0,0
Sierra Leone,2011-04-01,3,0,0,3,1,7
Sierra Leone,2011-04-01,3,0,0,3,0,6
Somalia,2011-04-01,64,0,0,5,2,71
Somalia,2011-04-01,47,0,0,27,2,76
Somalia,2011-04-01,31,0,0,2,5,38
Somalia,2011-04-01,50,0,1,4,1,56
Somalia,2011-04-01,64,0,1,30,1,96
Somalia,2011-04-01,42,6,0,23,1,72
Somalia,2011-04-01,39,0,0,40,0,79
Somalia,2011-04-01,13,2,0,-7,7,15
Somalia,2011-04-01,1,0,0,-7,0,-6
Somalia,2011-04-01,15,0,1,10,1,27
Somalia,2011-04-01,89,8,0,73,18,188
Somalia,2011-04-01,61,4,-2,12,13,88
Somalia,2011-04-01,91,0,-4,111,28,226
Somalia,2011-04-01,46,0,-2,62,9,115
Somalia,2011-04-01,46,0,0,31,0,77
Somalia,2011-04-01,31,0,0,-4,1,28
Somalia,2011-04-01,40,0,0,-32,1,9
Somalia,2011-04-01,23,0,0,-1,2,24
Somalia,2011-04-01,30,2,0,-14,0,18
Somalia,2011-04-01,18,0,0,10,7,35
Somalia,2011-04-01,149,0,1,89,15,254
Somalia,2011-04-01,45,0,0,49,0,94
Somalia,2011-04-01,52,0,0,19,2,73
Somalia,2011-04-01,58,0,0,-25,0,33
Somalia,2011-04-01,12,0,0,-3,1,10
Somalia,2011-04-01,12,0,0,-3,7,16
Somalia,2011-04-01,17,0,-1,13,7,36
Somalia,2011-04-01,33,0,0,26,0,59
Somalia,2011-04-01,39,0,0,2,2,43
Somalia,2011-04-01,16,0,0,-1,0,15
Syria,2011-04-01,106,0,-6,37,40,177
Syria,2011-04-01,47,0,0,20,8,75
Syria,2011-04-01,56,0,-4,25,8,85
Syria,2011-04-01,73,0,-8,76,8,149
Syria,2011-04-01,31,0,0,53,8,92
Syria,2011-04-01,37,0,1,38,5,81
Syria,2011-04-01,54,0,-8,23,16,85
Syria,2011-04-01,175,2,-7,49,31,250
Syria,2011-04-01,218,0,0,9,37,264
Syria,2011-04-01,40,0,-8,15,9,56
Syria,2011-04-01,126,0,-4,31,17,170
Syria,2011-04-01,96,0,-4,28,12,132
Syria,2011-04-01,50,0,0,27,24,101
Syria,2011-04-01,112,0,-10,45,15,162
Syria,2011-04-01,80,0,-2,83,29,190
Syria,2011-04-01,72,0,-1,21,28,120
Syria,2011-04-01,44,0,-1,17,13,73
Syria,2011-04-01,137,0,-2,15,31,181
Syria,2011-04-01,236,0,-13,20,25,268
Syria,2011-04-01,96,0,-4,18,15,125
Syria,2011-04-01,498,4,-38,232,82,778
Syria,2011-04-01,450,10,-40,141,93,654
Syria,2011-04-01,205,14,-19,68,29,297
Syria,2011-04-01,246,0,-20,54,36,316
Syria,2011-04-01,382,4,-4,50,35,467
Syria,2011-04-01,397,6,-17,96,44,526
Syria,2011-04-01,521,12,-10,191,75,789
Syria,2011-04-01,499,0,-2,62,38,597
Syria,2011-04-01,368,2,-5,70,80,515
Syria,2011-04-01,291,0,5,27,18,341
Yemen,2011-04-01,31,0,-1,8,11,49
Yemen,2011-04-01,16,0,-2,6,26,46
Yemen,2011-04-01,34,0,-2,-3,23,52
Yemen,2011-04-01,94,0,-11,30,30,143
Yemen,2011-04-01,159,2,-11,-7,21,164
Yemen,2011-04-01,347,8,1,97,56,509
Yemen,2011-04-01,37,0,-16,-1,8,28
Yemen,2011-04-01,83,0,-6,17,12,106
Yemen,2011-04-01,70,0,-2,0,14,82
Yemen,2011-04-01,76,0,-12,4,18,86
Yemen,2011-04-01,104,0,-6,27,6,131
Yemen,2011-04-01,92,0,-8,2,6,92
Yemen,2011-04-01,121,0,-8,48,18,179
Yemen,2011-04-01,66,0,-3,36,9,108
Yemen,2011-04-01,30,0,-9,31,7,59
Yemen,2011-04-01,48,0,-3,3,12,60
Yemen,2011-04-01,53,0,-5,5,10,63
Yemen,2011-04-01,43,0,-10,9,7,49
Yemen,2011-04-01,62,0,-19,7,21,71
Yemen,2011-04-01,101,0,-3,24,18,140
Yemen,2011-04-01,23,0,-18,12,5,22
Yemen,2011-04-01,16,0,-8,12,3,23
Yemen,2011-04-01,101,0,-62,2,22,63
Yemen,2011-04-01,116,0,-67,16,11,76
Yemen,2011-04-01,81,0,-32,22,18,89
Yemen,2011-04-01,71,0,-15,10,5,71
Yemen,2011-04-01,103,0,-24,7,11,97
Yemen,2011-04-01,43,0,-14,9,12,50
Yemen,2011-04-01,40,0,-1,5,8,52
Yemen,2011-04-01,122,0,-12,14,2,126
Afghanistan,2008-05-01,155,2,-4,59,3,215
Afghanistan,2008-05-01,107,0,0,34,10,151
Afghanistan,2008-05-01,88,0,0,4,4,96
Afghanistan,2008-05-01,33,0,0,-2,5,36
Afghanistan,2008-05-01,134,2,-2,8,6,148
Afghanistan,2008-05-01,111,0,0,24,48,183
Afghanistan,2008-05-01,165,0,0,24,9,198
Afghanistan,2008-05-01,105,0,1,41,9,156
Afghanistan,2008-05-01,47,0,2,0,0,49
Afghanistan,2008-05-01,1,0,0,-5,1,-3
Afghanistan,2008-05-01,87,0,-2,51,17,153
Afghanistan,2008-05-01,53,0,0,15,5,73
Afghanistan,2008-05-01,59,0,-6,39,2,94
Afghanistan,2008-05-01,132,4,0,6,3,145
Afghanistan,2008-05-01,152,0,0,47,25,224
Afghanistan,2008-05-01,149,0,-1,22,22,192
Afghanistan,2008-05-01,118,0,1,-23,13,109
Afghanistan,2008-05-01,65,0,1,37,4,107
Afghanistan,2008-05-01,85,0,2,37,3,127
Afghanistan,2008-05-01,63,0,0,65,19,147
Afghanistan,2008-05-01,115,2,-6,21,0,132
Afghanistan,2008-05-01,137,0,0,18,6,161
Afghanistan,2008-05-01,119,0,2,64,12,197
Afghanistan,2008-05-01,77,0,2,37,31,147
Afghanistan,2008-05-01,104,0,-2,24,32,158
Afghanistan,2008-05-01,92,0,1,23,5,121
Afghanistan,2008-05-01,127,2,-4,2,7,134
Afghanistan,2008-05-01,102,0,-6,18,14,128
Afghanistan,2008-05-01,67,0,-2,30,11,106
Afghanistan,2008-05-01,109,0,0,25,14,148
Afghanistan,2008-05-01,71,0,0,10,3,84
Albania,2008-05-01,9,0,-4,4,0,9
Albania,2008-05-01,11,0,0,-9,0,2
Albania,2008-05-01,0,0,0,12,1,13
Albania,2008-05-01,2,0,0,0,0,2
Albania,2008-05-01,6,0,0,0,0,6
Albania,2008-05-01,5,0,0,-2,0,3
Albania,2008-05-01,6,0,0,0,0,6
Albania,2008-05-01,3,0,0,-1,0,2
Albania,2008-05-01,0,0,0,-2,1,-1
Albania,2008-05-01,3,0,1,0,1,5
Albania,2008-05-01,9,0,-2,0,5,12
Albania,2008-05-01,0,0,-1,3,0,2
Albania,2008-05-01,41,0,2,13,4,60
Albania,2008-05-01,3,0,0,3,1,7
Albania,2008-05-01,-1,0,-2,0,0,-3
Albania,2008-05-01,5,0,0,0,0,5
Albania,2008-05-01,0,0,0,0,0,0
Albania,2008-05-01,6,0,0,0,0,6
Albania,2008-05-01,6,0,0,6,3,15
Albania,2008-05-01,9,0,0,0,0,9
Albania,2008-05-01,7,0,0,9,0,16
Albania,2008-05-01,7,0,0,3,5,15
Albania,2008-05-01,2,0,-1,0,0,1
Albania,2008-05-01,-2,0,0,0,0,-2
Albania,2008-05-01,0,0,0,9,0,9
Albania,2008-05-01,16,0,0,0,2,18
Albania,2008-05-01,1,0,0,21,0,22
Albania,2008-05-01,12,0,-4,1,0,9
Albania,2008-05-01,7,0,-6,5,1,7
Albania,2008-05-01,5,0,0,16,2,23
Albania,2008-05-01,8,0,-2,-2,2,6
Algeria,2008-05-01,6,0,0,0,0,6
Algeria,2008-05-01,10,0,0,0,0,10
Algeria,2008-05-01,2,0,0,0,0,2
Algeria,2008-05-01,0,0,0,0,0,0
Algeria,2008-05-01,2,0,0,0,0,2
Algeria,2008-05-01,0,0,0,0,0,0
Algeria,2008-05-01,0,0,0,3,0,3
Algeria,2008-05-01,15,0,0,17,0,32
Algeria,2008-05-01,0,0,0,0,0,0
Algeria,2008-05-01,2,0,0,0,13,15
Algeria,2008-05-01,0,0,0,3,4,7
Algeria,2008-05-01,0,0,0,0,0,0
Algeria,2008-05-01,0,0,0,0,4,4
Algeria,2008-05-01,0,0,0,57,4,61
Algeria,2008-05-01,1,0,0,25,0,26
Algeria,2008-05-01,0,0,-2,6,0,4
Algeria,2008-05-01,1,0,-1,6,0,6
Algeria,2008-05-01,12,0,0,0,1,13
Algeria,2008-05-01,16,0,0,30,1,47
Algeria,2008-05-01,2,0,-2,0,1,1
Algeria,2008-05-01,5,0,0,5,2,12
Algeria,2008-05-01,6,0,0,0,0,6
Algeria,2008-05-01,5,0,0,0,0,5
Algeria,2008-05-01,7,0,0,0,0,7
Algeria,2008-05-01,18,0,0,9,4,31
Algeria,2008-05-01,0,0,0,0,0,0
Algeria,2008-05-01,11,0,0,0,0,11
Algeria,2008-05-01,4,0,0,1,0,5
Algeria,2008-05-01,2,0,0,9,0,11
Algeria,2008-05-01,4,0,0,29,0,33
Algeria,2008-05-01,6,0,0,3,0,9
Bangladesh,2008-05-01,-1,0,-2,3,0,0
Bangladesh,2008-05-01,24,0,0,0,9,33
Bangladesh,2008-05-01,1,0,0,0,0,1
Bangladesh,2008-05-01,1,0,0,0,0,1
Bangladesh,2008-05-01,15,0,0,4,1,20
Bangladesh,2008-05-01,7,0,0,4,0,11
Bangladesh,2008-05-01,7,0,0,15,1,23
Bangladesh,2008-05-01,10,0,0,-2,0,8
Bangladesh,2008-05-01,6,0,0,0,0,6
Bangladesh,2008-05-01,6,0,0,0,0,6
Bangladesh,2008-05-01,7,0,0,-4,0,3
Bangladesh,2008-05-01,5,0,0,5,0,10
Bangladesh,2008-05-01,2,0,0,6,2,10
Bangladesh,2008-05-01,15,0,0,6,1,22
Bangladesh,2008-05-01,4,0,0,8,4,16
Bangladesh,2008-05-01,18,2,0,13,11,44
Bangladesh,2008-05-01,24,0,0,14,0,38
Bangladesh,2008-05-01,5,2,0,18,0,25
Bangladesh,2008-05-01,14,0,0,33,0,47
Bangladesh,2008-05-01,15,0,-1,27,5,46
Bangladesh,2008-05-01,7,0,0,21,4,32
Bangladesh,2008-05-01,6,0,0,0,0,6
Bangladesh,2008-05-01,6,0,0,2,5,13
Bangladesh,2008-05-01,6,0,0,10,2,18
Bangladesh,2008-05-01,5,0,0,3,2,10
Bangladesh,2008-05-01,8,0,0,3,0,11
Bangladesh,2008-05-01,21,0,0,18,0,39
Bangladesh,2008-05-01,6,0,1,12,6,25
Bangladesh,2008-05-01,3,0,0,1,0,4
Bangladesh,2008-05-01,-2,0,0,-2,0,-4
Bangladesh,2008-05-01,5,0,0,13,0,18
Cameroon,2008-05-01,2,0,0,0,0,2
Cameroon,2008-05-01,0,0,0,0,2,2
Cameroon,2008-05-01,-1,0,0,3,1,3
Cameroon,2008-05-01,3,0,0,0,0,3
Cameroon,2008-05-01,0,0,0,0,0,0
Cameroon,2008-05-01,0,0,0,0,0,0
Cameroon,2008-05-01,0,0,0,0,1,1
Cameroon,2008-05-01,0,0,0,0,1,1
Cameroon,2008-05-01,0,0,0,0,0,0
Cameroon,2008-05-01,0,0,0,-2,0,-2
Cameroon,2008-05-01,4,0,0,0,0,4
Cameroon,2008-05-01,0,0,0,0,0,0
Cameroon,2008-05-01,8,0,0,0,0,8
Cameroon,2008-05-01,1,0,0,0,0,1
Cameroon,2008-05-01,0,0,0,0,0,0
Cameroon,2008-05-01,2,0,0,0,0,2
Cameroon,2008-05-01,3,0,0,0,1,4
Cameroon,2008-05-01,3,0,0,0,1,4
Cameroon,2008-05-01,0,0,0,0,0,0
Cameroon,2008-05-01,6,0,0,0,0,6
Cameroon,2008-05-01,2,0,0,0,0,2
Cameroon,2008-05-01,0,0,0,0,0,0
China,2008-05-01,34,0,-2,17,10,59
China,2008-05-01,33,0,1,38,6,78
China,2008-05-01,11,0,0,9,4,24
China,2008-05-01,6,0,0,0,1,7
China,2008-05-01,94,0,-1,38,16,147
China,2008-05-01,52,0,-5,42,8,97
China,2008-05-01,44,0,-7,18,7,62
China,2008-05-01,75,4,-3,31,19,126
China,2008-05-01,3,2,0,7,1,13
China,2008-05-01,19,2,0,2,0,23
China,2008-05-01,83,0,0,58,26,167
China,2008-05-01,168,0,-6,89,22,273
China,2008-05-01,75,6,-2,28,10,117
China,2008-05-01,63,6,0,30,10,109
China,2008-05-01,113,12,-12,76,17,206
China,2008-05-01,139,2,-11,83,25,238
China,2008-05-01,41,0,0,33,8,82
China,2008-05-01,52,2,0,6,4,64
China,2008-05-01,94,4,0,21,6,125
China,2008-05-01,136,0,2,80,13,231
China,2008-05-01,92,0,-11,70,11,162
China,2008-05-01,57,8,-11,59,10,123
China,2008-05-01,85,8,-2,14,9,114
China,2008-05-01,35,0,-11,18,4,46
China,2008-05-01,25,0,0,5,2,32
China,2008-05-01,71,4,2,16,10,103
China,2008-05-01,66,0,0,9,4,79
China,2008-05-01,103,2,-4,75,20,196
China,2008-05-01,88,0,2,79,10,179
China,2008-05-01,49,4,0,19,9,81
China,2008-05-01,36,4,1,2,6,49
Egypt,2008-05-01,56,0,0,9,0,65
Egypt,2008-05-01,26,0,0,16,3,45
Egypt,2008-05-01,5,0,0,0,0,5
Egypt,2008-05-01,4,0,0,0,0,4
Egypt,2008-05-01,17,0,0,19,5,41
Egypt,2008-05-01,40,0,1,3,1,45
Egypt,2008-05-01,51,0,0,6,0,57
Egypt,2008-05-01,35,0,0,22,1,58
Egypt,2008-05-01,44,0,0,15,2,61
Egypt,2008-05-01,3,0,0,3,0,6
Egypt,2008-05-01,31,0,0,9,2,42
Egypt,2008-05-01,58,0,-2,-6,4,54
Egypt,2008-05-01,62,0,0,3,7,72
Egypt,2008-05-01,48,0,0,12,0,60
Egypt,2008-05-01,23,0,-2,22,0,43
Egypt,2008-05-01,12,0,0,6,6,24
Egypt,2008-05-01,18,0,0,18,2,38
Egypt,2008-05-01,6,2,0,3,7,18
Egypt,2008-05-01,52,2,0,6,2,62
Egypt,2008-05-01,56,8,-4,6,0,66
Egypt,2008-05-01,36,0,0,0,2,38
Egypt,2008-05-01,73,0,0,-1,7,79
Egypt,2008-05-01,23,0,1,7,2,33
Egypt,2008-05-01,17,0,0,15,0,32
Egypt,2008-05-01,24,0,1,3,2,30
Egypt,2008-05-01,46,4,3,5,0,58
Egypt,2008-05-01,19,0,1,9,0,29
Egypt,2008-05-01,29,0,0,6,0,35
Egypt,2008-05-01,8,0,0,7,0,15
Egypt,2008-05-01,39,0,0,-1,4,42
Egypt,2008-05-01,8,0,0,-2,0,6
Eritrea,2008-05-01,0,0,0,0,0,0
Eritrea,2008-05-01,0,0,0,-4,0,-4
Eritrea,2008-05-01,4,0,0,0,0,4
Eritrea,2008-05-01,0,0,0,0,0,0
Eritrea,2008-05-01,2,0,0,-2,0,0
Eritrea,2008-05-01,12,0,0,0,0,12
Eritrea,2008-05-01,9,0,0,0,0,9
Eritrea,2008-05-01,2,0,0,0,2,4
Eritrea,2008-05-01,0,0,0,6,0,6
Eritrea,2008-05-01,1,0,0,0,0,1
Eritrea,2008-05-01,5,0,0,0,0,5
Eritrea,2008-05-01,9,0,0,0,0,9
Eritrea,2008-05-01,2,0,0,0,0,2
Eritrea,2008-05-01,0,0,0,-2,0,-2
Eritrea,2008-05-01,0,0,0,3,0,3
Eritrea,2008-05-01,-8,0,0,0,0,-8
Eritrea,2008-05-01,-3,0,0,-6,0,-9
Eritrea,2008-05-01,4,0,0,22,0,26
Eritrea,2008-05-01,-2,0,0,6,0,4
Eritrea,2008-05-01,18,0,1,0,0,19
Eritrea,2008-05-01,3,0,0,0,0,3
Eritrea,2008-05-01,0,0,0,0,0,0
Eritrea,2008-05-01,0,0,0,0,0,0
Eritrea,2008-05-01,11,0,0,0,0,11
Eritrea,2008-05-01,9,0,0,9,9,27
Eritrea,2008-05-01,13,0,0,0,5,18
Eritrea,2008-05-01,11,0,0,6,0,17
Eritrea,2008-05-01,8,0,0,-2,0,6
Georgia,2008-05-01,3,0,0,-3,4,4
Georgia,2008-05-01,16,0,0,18,0,34
Georgia,2008-05-01,12,0,0,0,0,12
Georgia,2008-05-01,13,0,0,0,0,13
Georgia,2008-05-01,28,0,0,-2,4,30
Georgia,2008-05-01,1,0,1,6,0,8
Georgia,2008-05-01,34,0,0,14,3,51
Georgia,2008-05-01,7,0,0,-2,0,5
Georgia,2008-05-01,9,0,0,0,0,9
Georgia,2008-05-01,0,0,0,0,0,0
Georgia,2008-05-01,27,0,0,3,1,31
Georgia,2008-05-01,36,0,0,-2,0,34
Georgia,2008-05-01,1,0,0,0,0,1
Georgia,2008-05-01,3,0,0,15,0,18
Georgia,2008-05-01,8,0,2,6,0,16
Georgia,2008-05-01,9,0,0,-2,0,7
Georgia,2008-05-01,0,0,0,0,0,0
Georgia,2008-05-01,8,0,0,3,0,11
Georgia,2008-05-01,3,0,0,6,0,9
Georgia,2008-05-01,14,2,0,3,2,21
Georgia,2008-05-01,15,0,0,-1,4,18
Georgia,2008-05-01,9,0,-1,-1,0,7
Georgia,2008-05-01,11,0,2,10,1,24
Georgia,2008-05-01,3,0,1,0,0,4
Georgia,2008-05-01,0,0,0,-2,0,-2
Georgia,2008-05-01,16,0,-1,0,0,15
Georgia,2008-05-01,5,0,0,9,4,18
Georgia,2008-05-01,10,0,0,14,4,28
Georgia,2008-05-01,5,0,-1,6,0,10
Georgia,2008-05-01,9,0,0,0,0,9
Georgia,2008-05-01,4,0,0,0,0,4
India,2008-05-01,33,0,0,10,5,48
India,2008-05-01,23,0,-3,-4,0,16
India,2008-05-01,3,0,0,-2,0,1
India,2008-05-01,3,0,0,3,0,6
India,2008-05-01,52,0,0,14,18,84
India,2008-05-01,18,0,0,28,9,55
India,2008-05-01,26,0,0,1,0,27
India,2008-05-01,55,0,-2,20,7,80
India,2008-05-01,5,0,0,6,0,11
India,2008-05-01,0,0,0,3,0,3
India,2008-05-01,78,0,-1,5,1,83
India,2008-05-01,58,4,-1,1,7,69
India,2008-05-01,26,0,3,16,7,52
India,2008-05-01,32,4,0,2,13,51
India,2008-05-01,52,0,3,-5,3,53
India,2008-05-01,7,0,0,3,4,14
India,2008-05-01,29,0,0,-2,10,37
India,2008-05-01,3,2,0,1,1,7
India,2008-05-01,37,2,0,2,7,48
India,2008-05-01,29,2,0,-6,2,27
India,2008-05-01,18,0,1,9,15,43
India,2008-05-01,23,0,0,0,2,25
India,2008-05-01,11,2,-1,-15,1,-2
India,2008-05-01,17,0,-2,4,9,28
India,2008-05-01,9,0,-2,4,1,12
India,2008-05-01,21,0,2,0,7,30
India,2008-05-01,37,0,-13,9,3,36
India,2008-05-01,52,0,-4,8,9,65
India,2008-05-01,35,0,0,-3,2,34
India,2008-05-01,12,0,0,0,0,12
India,2008-05-01,27,2,0,7,2,38
Iran,2008-05-01,88,0,1,31,6,126
Iran,2008-05-01,56,0,-3,4,7,64
Iran,2008-05-01,17,0,0,1,5,23
Iran,2008-05-01,18,0,-2,3,0,19
Iran,2008-05-01,46,0,1,20,4,71
Iran,2008-05-01,55,0,0,3,8,66
Iran,2008-05-01,46,0,0,36,13,95
Iran,2008-05-01,44,0,1,6,1,52
Iran,2008-05-01,3,0,0,10,1,14
Iran,2008-05-01,18,0,-2,0,0,16
Iran,2008-05-01,70,4,2,-10,5,71
Iran,2008-05-01,48,0,-2,21,4,71
Iran,2008-05-01,43,0,0,11,10,64
Iran,2008-05-01,99,2,0,15,2,118
Iran,2008-05-01,230,0,0,20,9,259
Iran,2008-05-01,171,0,0,11,19,201
Iran,2008-05-01,87,0,0,19,3,109
Iran,2008-05-01,44,0,0,1,0,45
Iran,2008-05-01,101,4,0,26,10,141
Iran,2008-05-01,82,0,-7,24,2,101
Iran,2008-05-01,65,0,1,72,2,140
Iran,2008-05-01,59,0,0,38,9,106
Iran,2008-05-01,65,0,0,36,5,106
Iran,2008-05-01,22,0,-12,3,0,13
Iran,2008-05-01,39,0,-3,15,1,52
Iran,2008-05-01,20,0,2,14,2,38
Iran,2008-05-01,52,0,1,13,6,72
Iran,2008-05-01,31,0,-4,17,4,48
Iran,2008-05-01,67,0,-1,11,12,89
Iran,2008-05-01,43,0,0,-5,0,38
Iran,2008-05-01,38,0,0,10,0,48
Iraq,2008-05-01,172,0,0,24,39,235
Iraq,2008-05-01,238,2,0,16,31,287
Iraq,2008-05-01,67,0,-2,6,12,83
Iraq,2008-05-01,69,0,1,9,7,86
Iraq,2008-05-01,193,0,-1,62,30,284
Iraq,2008-05-01,89,0,-1,20,12,120
Iraq,2008-05-01,154,2,0,39,21,216
Iraq,2008-05-01,148,2,1,79,21,251
Iraq,2008-05-01,33,8,-4,23,2,62
Iraq,2008-05-01,39,2,0,0,0,41
Iraq,2008-05-01,212,0,-8,15,24,243
Iraq,2008-05-01,103,0,-7,9,1,106
Iraq,2008-05-01,79,0,-2,10,16,103
Iraq,2008-05-01,93,0,1,42,9,145
Iraq,2008-05-01,156,0,3,50,9,218
Iraq,2008-05-01,93,0,-3,15,23,128
Iraq,2008-05-01,79,0,-2,48,7,132
Iraq,2008-05-01,44,2,0,-1,3,48
Iraq,2008-05-01,105,0,0,30,10,145
Iraq,2008-05-01,97,0,0,52,11,160
Iraq,2008-05-01,130,2,-1,23,7,161
Iraq,2008-05-01,300,8,0,36,24,368
Iraq,2008-05-01,130,0,0,41,11,182
Iraq,2008-05-01,74,0,0,14,12,100
Iraq,2008-05-01,68,0,0,11,3,82
Iraq,2008-05-01,119,0,0,9,5,133
Iraq,2008-05-01,177,8,0,28,12,225
Iraq,2008-05-01,174,10,-1,36,11,230
Iraq,2008-05-01,236,4,-2,18,42,298
Iraq,2008-05-01,127,0,1,20,16,164
Iraq,2008-05-01,56,0,0,17,5,78
Morocco,2008-05-01,6,0,0,-2,0,4
Morocco,2008-05-01,4,0,0,-5,1,0
Morocco,2008-05-01,0,0,0,0,0,0
Morocco,2008-05-01,9,0,0,6,0,15
Morocco,2008-05-01,5,0,0,22,0,27
Morocco,2008-05-01,3,0,0,21,0,24
Morocco,2008-05-01,10,0,0,38,1,49
Morocco,2008-05-01,0,0,0,0,0,0
Morocco,2008-05-01,0,0,0,3,1,4
Morocco,2008-05-01,0,0,0,0,1,1
Morocco,2008-05-01,-1,0,0,3,0,2
Morocco,2008-05-01,1,0,0,4,0,5
Morocco,2008-05-01,0,0,0,3,0,3
Morocco,2008-05-01,17,0,0,6,4,27
Morocco,2008-05-01,16,0,0,9,4,29
Morocco,2008-05-01,-3,0,1,0,0,-2
Morocco,2008-05-01,0,0,0,3,1,4
Morocco,2008-05-01,4,0,0,0,0,4
Morocco,2008-05-01,9,0,0,0,0,9
Morocco,2008-05-01,21,0,0,-4,0,17
Morocco,2008-05-01,8,0,0,3,0,11
Morocco,2008-05-01,3,0,0,12,0,15
Morocco,2008-05-01,0,0,0,0,0,0
Morocco,2008-05-01,9,0,0,0,0,9
Morocco,2008-05-01,0,0,0,-2,0,-2
Morocco,2008-05-01,8,0,0,0,0,8
Morocco,2008-05-01,5,0,0,6,1,12
Morocco,2008-05-01,0,0,0,11,0,11
Morocco,2008-05-01,0,0,0,0,0,0
Nigeria,2008-05-01,6,0,0,-2,0,4
Nigeria,2008-05-01,5,0,0,6,0,11
Nigeria,2008-05-01,0,0,0,0,0,0
Nigeria,2008-05-01,6,0,0,9,0,15
Nigeria,2008-05-01,18,0,0,3,0,21
Nigeria,2008-05-01,18,0,0,12,3,33
Nigeria,2008-05-01,30,0,0,25,1,56
Nigeria,2008-05-01,13,0,0,3,0,16
Nigeria,2008-05-01,3,0,1,0,0,4
Nigeria,2008-05-01,6,0,0,0,0,6
Nigeria,2008-05-01,2,0,0,3,4,9
Nigeria,2008-05-01,13,0,0,3,2,18
Nigeria,2008-05-01,17,0,0,0,0,17
Nigeria,2008-05-01,-1,0,0,9,0,8
Nigeria,2008-05-01,7,0,0,6,0,13
Nigeria,2008-05-01,10,0,0,24,0,34
Nigeria,2008-05-01,0,0,0,12,0,12
Nigeria,2008-05-01,0,0,0,0,0,0
Nigeria,2008-05-01,27,0,0,0,0,27
Nigeria,2008-05-01,24,0,0,15,3,42
Nigeria,2008-05-01,29,0,0,3,9,41
Nigeria,2008-05-01,18,0,0,15,19,52
Nigeria,2008-05-01,19,0,0,5,14,38
Nigeria,2008-05-01,4,0,0,24,8,36
Nigeria,2008-05-01,0,0,0,0,0,0
Nigeria,2008-05-01,5,0,1,3,0,9
Nigeria,2008-05-01,3,0,0,9,0,12
Nigeria,2008-05-01,3,0,0,10,2,15
Nigeria,2008-05-01,37,0,-1,-3,6,39
Nigeria,2008-05-01,8,0,0,8,0,16
Nigeria,2008-05-01,6,0,0,6,0,12
Pakistan,2008-05-01,42,2,-1,64,4,111
Pakistan,2008-05-01,58,0,3,23,0,84
Pakistan,2008-05-01,8,0,0,0,1,9
Pakistan,2008-05-01,-3,0,0,9,2,8
Pakistan,2008-05-01,22,2,0,8,2,34
Pakistan,2008-05-01,46,0,0,22,7,75
Pakistan,2008-05-01,55,0,1,10,4,70
Pakistan,2008-05-01,44,0,0,16,4,64
Pakistan,2008-05-01,5,0,0,9,1,15
Pakistan,2008-05-01,10,0,0,3,0,13
Pakistan,2008-05-01,65,2,-6,6,9,76
Pakistan,2008-05-01,44,0,-6,49,17,104
Pakistan,2008-05-01,124,0,-15,50,10,169
Pakistan,2008-05-01,61,2,-5,28,18,104
Pakistan,2008-05-01,128,0,-2,18,16,160
Pakistan,2008-05-01,52,0,0,17,1,70
Pakistan,2008-05-01,43,0,-2,12,2,55
Pakistan,2008-05-01,35,0,-2,5,1,39
Pakistan,2008-05-01,95,0,-3,27,9,128
Pakistan,2008-05-01,34,0,0,13,2,49
Pakistan,2008-05-01,28,0,0,11,2,41
Pakistan,2008-05-01,61,0,-2,13,8,80
Pakistan,2008-05-01,67,0,-2,49,17,131
Pakistan,2008-05-01,49,0,0,10,2,61
Pakistan,2008-05-01,38,0,-4,6,6,46
Pakistan,2008-05-01,28,0,-2,7,6,39
Pakistan,2008-05-01,13,0,-6,7,4,18
Pakistan,2008-05-01,72,0,-2,2,4,76
Pakistan,2008-05-01,95,0,2,27,12,136
Pakistan,2008-05-01,52,0,0,22,7,81
Pakistan,2008-05-01,49,0,0,29,5,83
Sierra Leone,2008-05-01,6,0,0,0,0,6
Sierra Leone,2008-05-01,0,0,0,0,0,0
Sierra Leone,2008-05-01,1,0,0,0,0,1
Sierra Leone,2008-05-01,4,0,0,0,0,4
Sierra Leone,2008-05-01,3,0,0,3,4,10
Sierra Leone,2008-05-01,0,0,0,0,0,0
Sierra Leone,2008-05-01,0,0,0,0,0,0
Sierra Leone,2008-05-01,0,0,0,3,0,3
Sierra Leone,2008-05-01,0,0,0,9,1,10
Sierra Leone,2008-05-01,4,0,0,3,0,7
Sierra Leone,2008-05-01,10,0,-4,24,2,32
Sierra Leone,2008-05-01,1,0,0,7,12,20
Sierra Leone,2008-05-01,8,0,-4,3,2,9
Sierra Leone,2008-05-01,6,0,0,9,1,16
Sierra Leone,2008-05-01,8,0,0,15,1,24
Sierra Leone,2008-05-01,0,0,0,0,0,0
Sierra Leone,2008-05-01,3,0,0,6,0,9
Sierra Leone,2008-05-01,0,0,0,0,0,0
Sierra Leone,2008-05-01,0,0,0,0,0,0
Sierra Leone,2008-05-01,0,0,0,3,0,3
Sierra Leone,2008-05-01,0,0,0,0,0,0
Sierra Leone,2008-05-01,6,0,0,3,0,9
Sierra Leone,2008-05-01,8,0,0,15,0,23
Sierra Leone,2008-05-01,3,0,0,3,0,6
Somalia,2008-05-01,105,0,0,1,2,108
Somalia,2008-05-01,41,0,0,6,0,47
Somalia,2008-05-01,0,0,0,0,0,0
Somalia,2008-05-01,0,0,0,9,0,9
Somalia,2008-05-01,47,2,0,4,0,53
Somalia,2008-05-01,25,0,0,5,0,30
Somalia,2008-05-01,8,0,0,0,0,8
Somalia,2008-05-01,20,0,0,3,2,25
Somalia,2008-05-01,11,0,0,0,0,11
Somalia,2008-05-01,6,0,0,-2,0,4
Somalia,2008-05-01,15,0,0,1,0,16
Somalia,2008-05-01,10,0,0,0,2,12
Somalia,2008-05-01,24,0,0,9,7,40
Somalia,2008-05-01,32,0,0,-2,5,35
Somalia,2008-05-01,9,0,0,-2,1,8
Somalia,2008-05-01,22,0,-1,10,2,33
Somalia,2008-05-01,18,0,0,0,1,19
Somalia,2008-05-01,3,0,0,9,0,12
Somalia,2008-05-01,19,0,0,3,2,24
Somalia,2008-05-01,31,2,0,3,2,38
Somalia,2008-05-01,26,0,0,6,6,38
Somalia,2008-05-01,17,0,0,10,8,35
Somalia,2008-05-01,42,0,0,15,40,97
Somalia,2008-05-01,35,0,0,8,6,49
Somalia,2008-05-01,8,0,0,0,0,8
Somalia,2008-05-01,5,0,0,-1,13,17
Somalia,2008-05-01,32,0,0,-4,4,32
Somalia,2008-05-01,20,4,0,3,9,36
Somalia,2008-05-01,55,10,1,5,7,78
Somalia,2008-05-01,42,0,0,35,9,86
Somalia,2008-05-01,15,0,0,1,3,19
Syria,2008-05-01,13,0,0,0,0,13
Syria,2008-05-01,8,4,-1,0,0,11
Syria,2008-05-01,0,4,0,0,0,4
Syria,2008-05-01,0,0,0,0,0,0
Syria,2008-05-01,19,0,0,5,0,24
Syria,2008-05-01,0,0,0,-6,4,-2
Syria,2008-05-01,23,0,-4,0,4,23
Syria,2008-05-01,84,0,-8,7,15,98
Syria,2008-05-01,83,0,-14,0,2,71
Syria,2008-05-01,43,0,0,0,16,59
Syria,2008-05-01,93,0,-2,11,15,117
Syria,2008-05-01,69,4,2,6,3,84
Syria,2008-05-01,16,0,0,1,9,26
Syria,2008-05-01,27,0,0,50,0,77
Syria,2008-05-01,48,0,0,16,0,64
Syria,2008-05-01,24,0,0,-3,0,21
Syria,2008-05-01,27,0,-7,12,0,32
Syria,2008-05-01,18,0,-2,9,1,26
Syria,2008-05-01,24,0,2,0,0,26
Syria,2008-05-01,16,0,2,9,0,27
Syria,2008-05-01,20,0,0,24,3,47
Syria,2008-05-01,47,0,0,2,1,50
Syria,2008-05-01,17,0,0,0,1,18
Syria,2008-05-01,5,0,-4,0,0,1
Syria,2008-05-01,24,0,-12,-2,1,11
Syria,2008-05-01,21,0,0,0,2,23
Syria,2008-05-01,12,0,0,8,0,20
Syria,2008-05-01,15,2,-13,10,3,17
Syria,2008-05-01,37,0,-6,6,22,59
Syria,2008-05-01,8,0,0,1,0,9
Syria,2008-05-01,27,0,-3,4,2,30
Yemen,2008-05-01,5,0,0,0,3,8
Yemen,2008-05-01,70,0,0,6,18,94
Yemen,2008-05-01,42,0,0,3,1,46
Yemen,2008-05-01,26,0,0,0,0,26
Yemen,2008-05-01,50,0,0,13,1,64
Yemen,2008-05-01,35,0,0,6,0,41
Yemen,2008-05-01,27,0,0,15,0,42
Yemen,2008-05-01,8,2,0,8,0,18
Yemen,2008-05-01,18,2,0,0,0,20
Yemen,2008-05-01,3,0,0,3,0,6
Yemen,2008-05-01,2,2,0,0,0,4
Yemen,2008-05-01,19,0,1,18,0,38
Yemen,2008-05-01,1,0,0,15,0,16
Yemen,2008-05-01,0,0,0,15,4,19
Yemen,2008-05-01,22,0,0,-4,0,18
Yemen,2008-05-01,2,0,0,33,0,35
Yemen,2008-05-01,0,0,0,-2,0,-2
Yemen,2008-05-01,9,0,0,21,0,30
Yemen,2008-05-01,8,0,0,27,0,35
Yemen,2008-05-01,4,0,-2,0,0,2
Yemen,2008-05-01,0,0,0,0,0,0
Yemen,2008-05-01,0,0,0,0,0,0
Yemen,2008-05-01,0,0,0,0,0,0
Yemen,2008-05-01,8,0,0,3,0,11
Yemen,2008-05-01,3,0,0,0,0,3
Yemen,2008-05-01,5,0,0,-2,0,3
Yemen,2008-05-01,3,0,0,6,0,9
Yemen,2008-05-01,1,0,0,0,0,1
Yemen,2008-05-01,14,0,0,6,0,20
Yemen,2008-05-01,25,0,0,15,11,51
Afghanistan,2008-11-01,129,0,-5,67,26,217
Afghanistan,2008-11-01,93,0,0,66,26,185
Afghanistan,2008-11-01,131,0,-4,68,7,202
Afghanistan,2008-11-01,180,0,0,38,14,232
Afghanistan,2008-11-01,140,6,1,50,6,203
Afghanistan,2008-11-01,101,0,0,15,18,134
Afghanistan,2008-11-01,126,0,0,13,24,163
Afghanistan,2008-11-01,52,0,0,11,4,67
Afghanistan,2008-11-01,162,0,0,22,3,187
Afghanistan,2008-11-01,196,0,-2,-9,26,211
Afghanistan,2008-11-01,222,0,-1,15,14,250
Afghanistan,2008-11-01,318,6,0,49,80,453
Afghanistan,2008-11-01,355,2,1,134,46,538
Afghanistan,2008-11-01,301,0,0,60,16,377
Afghanistan,2008-11-01,38,0,0,20,8,66
Afghanistan,2008-11-01,103,0,3,21,3,130
Afghanistan,2008-11-01,210,0,4,18,29,261
Afghanistan,2008-11-01,126,2,0,18,3,149
Afghanistan,2008-11-01,159,0,0,53,21,233
Afghanistan,2008-11-01,137,6,0,50,13,206
Afghanistan,2008-11-01,57,0,0,16,24,97
Afghanistan,2008-11-01,35,0,0,18,0,53
Afghanistan,2008-11-01,139,2,2,43,26,212
Afghanistan,2008-11-01,181,0,2,36,14,233
Afghanistan,2008-11-01,173,0,4,119,1,297
Afghanistan,2008-11-01,185,0,0,68,10,263
Afghanistan,2008-11-01,143,0,-4,22,11,172
Afghanistan,2008-11-01,142,0,-1,44,16,201
Afghanistan,2008-11-01,82,2,0,2,10,96
Afghanistan,2008-11-01,165,4,0,12,8,189
Albania,2008-11-01,16,0,-4,6,2,20
Albania,2008-11-01,-15,0,0,0,0,-15
Albania,2008-11-01,4,0,0,9,0,13
Albania,2008-11-01,0,0,-1,9,0,8
Albania,2008-11-01,2,0,0,0,0,2
Albania,2008-11-01,3,0,0,0,0,3
Albania,2008-11-01,11,0,0,0,0,11
Albania,2008-11-01,19,0,-4,0,6,21
Albania,2008-11-01,2,0,0,-1,6,7
Albania,2008-11-01,2,0,0,0,0,2
Albania,2008-11-01,6,0,-1,2,7,14
Albania,2008-11-01,14,0,-5,3,0,12
Albania,2008-11-01,9,0,0,2,2,13
Albania,2008-11-01,0,0,0,2,0,2
Albania,2008-11-01,4,0,-1,0,0,3
Albania,2008-11-01,5,0,0,-2,4,7
Albania,2008-11-01,3,0,0,4,3,10
Albania,2008-11-01,10,0,-2,6,2,16
Albania,2008-11-01,-1,0,0,0,0,-1
Albania,2008-11-01,4,0,0,6,0,10
Albania,2008-11-01,5,0,0,2,1,8
Albania,2008-11-01,15,0,0,3,0,18
Albania,2008-11-01,16,0,-1,0,0,15
Albania,2008-11-01,3,0,0,9,0,12
Albania,2008-11-01,15,0,0,-5,3,13
Albania,2008-11-01,11,0,0,14,1,26
Albania,2008-11-01,4,0,-2,-7,0,-5
Albania,2008-11-01,4,0,0,-4,0,0
Algeria,2008-11-01,0,0,0,26,0,26
Algeria,2008-11-01,4,0,0,3,0,7
Algeria,2008-11-01,1,0,-2,3,0,2
Algeria,2008-11-01,6,0,0,-3,0,3
Algeria,2008-11-01,1,0,0,6,0,7
Algeria,2008-11-01,3,0,0,4,0,7
Algeria,2008-11-01,4,0,0,1,0,5
Algeria,2008-11-01,2,0,0,3,0,5
Algeria,2008-11-01,2,0,0,2,0,4
Algeria,2008-11-01,4,0,0,-3,0,1
Algeria,2008-11-01,6,0,-2,-4,2,2
Algeria,2008-11-01,15,0,-4,0,0,11
Algeria,2008-11-01,5,0,0,3,0,8
Algeria,2008-11-01,12,0,0,0,0,12
Algeria,2008-11-01,3,0,-2,0,0,1
Algeria,2008-11-01,4,0,0,0,0,4
Algeria,2008-11-01,11,0,0,1,0,12
Algeria,2008-11-01,5,0,0,0,0,5
Algeria,2008-11-01,-3,0,0,9,1,7
Algeria,2008-11-01,0,0,0,9,0,9
Algeria,2008-11-01,0,0,0,0,0,0
Algeria,2008-11-01,11,0,-2,-7,0,2
Algeria,2008-11-01,2,0,0,4,0,6
Algeria,2008-11-01,9,0,0,-8,1,2
Algeria,2008-11-01,-1,0,0,3,0,2
Algeria,2008-11-01,6,0,0,6,0,12
Algeria,2008-11-01,4,0,0,0,0,4
Algeria,2008-11-01,9,0,0,0,0,9
Algeria,2008-11-01,0,0,0,-2,1,-1
Bangladesh,2008-11-01,23,0,0,11,11,45
Bangladesh,2008-11-01,19,0,0,12,2,33
Bangladesh,2008-11-01,29,0,-4,9,7,41
Bangladesh,2008-11-01,24,0,0,6,8,38
Bangladesh,2008-11-01,4,0,0,0,0,4
Bangladesh,2008-11-01,6,0,0,14,10,30
Bangladesh,2008-11-01,14,0,0,0,0,14
Bangladesh,2008-11-01,15,0,0,6,0,21
Bangladesh,2008-11-01,18,0,-3,9,0,24
Bangladesh,2008-11-01,6,0,0,3,0,9
Bangladesh,2008-11-01,7,0,0,6,3,16
Bangladesh,2008-11-01,-1,0,2,0,5,6
Bangladesh,2008-11-01,6,0,1,24,7,38
Bangladesh,2008-11-01,19,0,1,11,6,37
Bangladesh,2008-11-01,19,0,0,0,1,20
Bangladesh,2008-11-01,3,0,0,6,0,9
Bangladesh,2008-11-01,15,0,0,-8,0,7
Bangladesh,2008-11-01,29,0,0,0,0,29
Bangladesh,2008-11-01,15,0,0,9,0,24
Bangladesh,2008-11-01,4,0,0,0,0,4
Bangladesh,2008-11-01,1,0,0,6,1,8
Bangladesh,2008-11-01,4,0,0,0,0,4
Bangladesh,2008-11-01,22,0,0,6,0,28
Bangladesh,2008-11-01,8,0,0,3,0,11
Bangladesh,2008-11-01,6,0,-2,0,3,7
Bangladesh,2008-11-01,14,0,0,19,4,37
Bangladesh,2008-11-01,25,0,0,-1,5,29
Bangladesh,2008-11-01,10,0,0,6,0,16
Bangladesh,2008-11-01,7,0,0,9,0,16
Bangladesh,2008-11-01,21,0,0,27,9,57
Cameroon,2008-11-01,25,0,0,3,0,28
Cameroon,2008-11-01,2,0,0,12,0,14
Cameroon,2008-11-01,0,0,0,0,0,0
Cameroon,2008-11-01,2,0,0,0,1,3
Cameroon,2008-11-01,3,0,0,0,0,3
Cameroon,2008-11-01,0,0,0,-4,1,-3
Cameroon,2008-11-01,3,0,0,0,1,4
Cameroon,2008-11-01,1,0,0,0,0,1
Cameroon,2008-11-01,5,0,0,1,0,6
Cameroon,2008-11-01,12,0,0,-6,0,6
Cameroon,2008-11-01,8,0,0,0,0,8
Cameroon,2008-11-01,0,0,0,0,0,0
Cameroon,2008-11-01,6,0,0,0,0,6
Cameroon,2008-11-01,0,0,0,0,0,0
Cameroon,2008-11-01,3,0,0,0,0,3
Cameroon,2008-11-01,2,0,0,0,0,2
Cameroon,2008-11-01,3,0,0,0,0,3
Cameroon,2008-11-01,0,0,0,0,1,1
Cameroon,2008-11-01,0,0,0,3,0,3
Cameroon,2008-11-01,0,0,0,0,0,0
China,2008-11-01,74,2,0,30,20,126
China,2008-11-01,67,0,0,34,4,105
China,2008-11-01,90,0,-2,2,7,97
China,2008-11-01,78,0,1,59,9,147
China,2008-11-01,63,0,-1,22,7,91
China,2008-11-01,62,0,-1,47,22,130
China,2008-11-01,78,2,0,14,18,112
China,2008-11-01,25,0,0,29,9,63
China,2008-11-01,48,0,0,26,9,83
China,2008-11-01,98,2,-6,27,14,135
China,2008-11-01,74,0,2,29,9,114
China,2008-11-01,71,0,0,19,8,98
China,2008-11-01,114,4,2,24,13,157
China,2008-11-01,68,2,0,30,6,106
China,2008-11-01,52,2,0,12,4,70
China,2008-11-01,69,2,0,15,3,89
China,2008-11-01,92,6,-7,26,15,132
China,2008-11-01,61,2,0,34,14,111
China,2008-11-01,35,0,1,39,14,89
China,2008-11-01,46,0,0,-1,18,63
China,2008-11-01,6,0,0,0,0,6
China,2008-11-01,3,0,0,9,1,13
China,2008-11-01,108,0,2,40,13,163
China,2008-11-01,119,2,-1,13,4,137
China,2008-11-01,63,2,-4,17,1,79
China,2008-11-01,103,2,3,21,11,140
China,2008-11-01,73,0,-6,24,4,95
China,2008-11-01,52,4,-1,27,6,88
China,2008-11-01,49,2,-2,18,13,80
China,2008-11-01,66,2,-6,-3,16,75
Egypt,2008-11-01,25,0,0,7,1,33
Egypt,2008-11-01,55,0,0,23,2,80
Egypt,2008-11-01,72,0,0,42,0,114
Egypt,2008-11-01,25,0,-1,6,5,35
Egypt,2008-11-01,102,2,2,27,0,133
Egypt,2008-11-01,22,2,1,-5,3,23
Egypt,2008-11-01,19,0,0,18,0,37
Egypt,2008-11-01,26,0,0,1,3,30
Egypt,2008-11-01,17,0,0,-1,1,17
Egypt,2008-11-01,42,0,1,1,2,46
Egypt,2008-11-01,73,0,-1,28,6,106
Egypt,2008-11-01,79,2,-2,9,5,93
Egypt,2008-11-01,80,0,2,10,0,92
Egypt,2008-11-01,52,0,0,6,6,64
Egypt,2008-11-01,9,0,0,0,0,9
Egypt,2008-11-01,42,2,-1,25,5,73
Egypt,2008-11-01,40,0,0,7,3,50
Egypt,2008-11-01,28,0,0,9,3,40
Egypt,2008-11-01,21,2,1,21,4,49
Egypt,2008-11-01,9,0,0,0,4,13
Egypt,2008-11-01,3,0,0,0,0,3
Egypt,2008-11-01,10,0,0,3,9,22
Egypt,2008-11-01,65,0,0,22,14,101
Egypt,2008-11-01,28,0,1,9,1,39
Egypt,2008-11-01,20,0,-9,12,0,23
Egypt,2008-11-01,29,0,0,17,1,47
Egypt,2008-11-01,2,0,0,16,0,18
Egypt,2008-11-01,21,0,0,1,5,27
Egypt,2008-11-01,9,0,0,3,2,14
Egypt,2008-11-01,19,0,0,10,4,33
Eritrea,2008-11-01,0,0,0,0,0,0
Eritrea,2008-11-01,0,0,0,0,0,0
Eritrea,2008-11-01,0,0,0,3,0,3
Eritrea,2008-11-01,1,0,0,6,0,7
Eritrea,2008-11-01,0,0,0,-2,0,-2
Eritrea,2008-11-01,6,0,0,7,0,13
Eritrea,2008-11-01,11,0,0,6,0,17
Eritrea,2008-11-01,4,0,0,3,4,11
Eritrea,2008-11-01,3,0,0,6,4,13
Eritrea,2008-11-01,4,0,0,3,0,7
Eritrea,2008-11-01,10,0,0,0,0,10
Eritrea,2008-11-01,10,0,0,6,0,16
Eritrea,2008-11-01,0,0,0,0,0,0
Eritrea,2008-11-01,4,0,0,0,0,4
Eritrea,2008-11-01,0,0,0,0,0,0
Eritrea,2008-11-01,0,0,0,0,0,0
Eritrea,2008-11-01,0,0,0,0,0,0
Eritrea,2008-11-01,2,0,0,0,0,2
Eritrea,2008-11-01,0,0,0,0,0,0
Eritrea,2008-11-01,0,0,0,0,0,0
Eritrea,2008-11-01,3,0,0,3,0,6
Eritrea,2008-11-01,0,0,0,0,0,0
Eritrea,2008-11-01,0,0,0,0,0,0
Eritrea,2008-11-01,0,0,0,0,0,0
Eritrea,2008-11-01,6,0,0,0,0,6
Eritrea,2008-11-01,15,0,1,3,0,19
Eritrea,2008-11-01,22,0,0,0,0,22
Georgia,2008-11-01,9,0,0,4,0,13
Georgia,2008-11-01,3,0,0,0,2,5
Georgia,2008-11-01,12,0,0,0,3,15
Georgia,2008-11-01,8,0,0,3,2,13
Georgia,2008-11-01,7,0,-2,0,8,13
Georgia,2008-11-01,6,0,0,-2,4,8
Georgia,2008-11-01,5,0,-8,9,6,12
Georgia,2008-11-01,10,0,-4,0,1,7
Georgia,2008-11-01,3,0,0,0,0,3
Georgia,2008-11-01,11,0,0,3,0,14
Georgia,2008-11-01,10,0,0,-2,1,9
Georgia,2008-11-01,7,0,0,3,0,10
Georgia,2008-11-01,25,0,0,18,3,46
Georgia,2008-11-01,8,0,0,3,2,13
Georgia,2008-11-01,4,0,0,0,0,4
Georgia,2008-11-01,1,0,0,0,0,1
Georgia,2008-11-01,15,0,0,0,0,15
Georgia,2008-11-01,1,0,0,3,3,7
Georgia,2008-11-01,9,0,0,-1,0,8
Georgia,2008-11-01,3,0,0,0,0,3
Georgia,2008-11-01,0,0,0,0,0,0
Georgia,2008-11-01,0,0,0,0,0,0
Georgia,2008-11-01,15,0,0,6,1,22
Georgia,2008-11-01,2,0,0,9,2,13
Georgia,2008-11-01,26,0,0,15,2,43
Georgia,2008-11-01,9,0,0,3,0,12
Georgia,2008-11-01,9,0,0,3,0,12
Georgia,2008-11-01,9,0,0,-2,0,7
Georgia,2008-11-01,0,0,0,0,0,0
Georgia,2008-11-01,5,0,0,0,0,5
India,2008-11-01,23,0,0,15,2,40
India,2008-11-01,70,0,-1,27,11,107
India,2008-11-01,35,2,-2,1,1,37
India,2008-11-01,29,0,-1,6,10,44
India,2008-11-01,9,0,-2,-3,2,6
India,2008-11-01,43,0,0,2,6,51
India,2008-11-01,47,2,-1,12,2,62
India,2008-11-01,12,2,0,8,1,23
India,2008-11-01,31,4,-3,14,2,48
India,2008-11-01,26,0,0,17,5,48
India,2008-11-01,50,0,-2,13,6,67
India,2008-11-01,42,0,-2,16,2,58
India,2008-11-01,29,0,0,17,4,50
India,2008-11-01,28,2,-1,13,3,45
India,2008-11-01,28,0,-1,-1,4,30
India,2008-11-01,24,4,0,0,3,31
India,2008-11-01,55,4,0,7,6,72
India,2008-11-01,47,0,0,1,5,53
India,2008-11-01,82,0,-2,10,7,97
India,2008-11-01,39,0,-2,6,14,57
India,2008-11-01,6,0,0,0,0,6
India,2008-11-01,7,0,0,0,0,7
India,2008-11-01,90,2,-2,18,1,109
India,2008-11-01,105,2,1,-23,18,103
India,2008-11-01,95,0,-4,2,4,97
India,2008-11-01,64,0,-2,24,13,99
India,2008-11-01,6,0,0,4,3,13
India,2008-11-01,25,0,-1,-2,2,24
India,2008-11-01,11,0,-4,1,1,9
India,2008-11-01,40,2,0,-5,1,38
Iran,2008-11-01,43,0,0,7,2,52
Iran,2008-11-01,22,0,0,0,2,24
Iran,2008-11-01,30,0,0,4,11,45
Iran,2008-11-01,68,0,-1,16,9,92
Iran,2008-11-01,38,4,0,35,0,77
Iran,2008-11-01,26,0,0,-3,6,29
Iran,2008-11-01,32,0,0,1,2,35
Iran,2008-11-01,7,0,0,3,0,10
Iran,2008-11-01,34,0,0,33,2,69
Iran,2008-11-01,21,0,0,12,5,38
Iran,2008-11-01,32,0,0,27,5,64
Iran,2008-11-01,39,0,-2,-3,2,36
Iran,2008-11-01,96,0,3,72,10,181
Iran,2008-11-01,66,0,0,46,12,124
Iran,2008-11-01,31,0,0,33,3,67
Iran,2008-11-01,32,0,-2,21,5,56
Iran,2008-11-01,25,0,0,27,2,54
Iran,2008-11-01,78,0,0,13,5,96
Iran,2008-11-01,64,0,-2,55,7,124
Iran,2008-11-01,11,0,0,14,3,28
Iran,2008-11-01,8,0,0,-2,1,7
Iran,2008-11-01,3,0,0,6,0,9
Iran,2008-11-01,48,0,0,40,1,89
Iran,2008-11-01,32,0,-2,11,2,43
Iran,2008-11-01,41,0,-6,24,4,63
Iran,2008-11-01,71,2,2,5,5,85
Iran,2008-11-01,43,0,-1,2,0,44
Iran,2008-11-01,66,0,-2,36,0,100
Iran,2008-11-01,28,0,0,16,3,47
Iran,2008-11-01,20,0,0,12,6,38
Iraq,2008-11-01,99,0,4,18,11,132
Iraq,2008-11-01,111,0,1,33,21,166
Iraq,2008-11-01,67,0,-5,45,19,126
Iraq,2008-11-01,83,0,1,15,12,111
Iraq,2008-11-01,137,0,6,41,12,196
Iraq,2008-11-01,120,4,0,-13,8,119
Iraq,2008-11-01,41,0,0,17,16,74
Iraq,2008-11-01,69,0,0,-2,2,69
Iraq,2008-11-01,140,0,-4,25,23,184
Iraq,2008-11-01,87,2,1,19,15,124
Iraq,2008-11-01,111,0,2,17,10,140
Iraq,2008-11-01,166,0,-4,33,4,199
Iraq,2008-11-01,177,0,0,24,3,204
Iraq,2008-11-01,93,0,1,33,14,141
Iraq,2008-11-01,52,0,1,53,4,110
Iraq,2008-11-01,95,0,-1,58,12,164
Iraq,2008-11-01,145,0,-5,29,9,178
Iraq,2008-11-01,150,0,-8,58,20,220
Iraq,2008-11-01,111,0,2,22,24,159
Iraq,2008-11-01,39,0,0,47,2,88
Iraq,2008-11-01,30,0,0,0,2,32
Iraq,2008-11-01,-2,0,0,1,0,-1
Iraq,2008-11-01,84,4,2,25,9,124
Iraq,2008-11-01,55,4,-2,9,3,69
Iraq,2008-11-01,132,0,-1,27,11,169
Iraq,2008-11-01,73,0,1,16,5,95
Iraq,2008-11-01,69,2,0,21,4,96
Iraq,2008-11-01,94,0,1,28,7,130
Iraq,2008-11-01,41,0,0,27,0,68
Iraq,2008-11-01,87,0,1,5,23,116
Morocco,2008-11-01,4,0,0,15,1,20
Morocco,2008-11-01,4,0,0,12,4,20
Morocco,2008-11-01,5,0,1,94,3,103
Morocco,2008-11-01,12,0,0,24,0,36
Morocco,2008-11-01,2,0,0,15,0,17
Morocco,2008-11-01,4,0,0,54,0,58
Morocco,2008-11-01,3,2,0,0,0,5
Morocco,2008-11-01,0,0,0,0,0,0
Morocco,2008-11-01,6,0,0,9,0,15
Morocco,2008-11-01,31,0,0,0,0,31
Morocco,2008-11-01,0,0,0,7,0,7
Morocco,2008-11-01,2,0,0,6,0,8
Morocco,2008-11-01,0,0,0,6,0,6
Morocco,2008-11-01,1,0,0,15,0,16
Morocco,2008-11-01,2,0,0,25,2,29
Morocco,2008-11-01,8,0,0,0,0,8
Morocco,2008-11-01,3,0,0,6,0,9
Morocco,2008-11-01,2,0,0,15,0,17
Morocco,2008-11-01,3,0,0,3,0,6
Morocco,2008-11-01,0,0,0,0,0,0
Morocco,2008-11-01,0,2,0,0,0,2
Morocco,2008-11-01,3,0,0,0,0,3
Morocco,2008-11-01,-11,0,0,15,0,4
Morocco,2008-11-01,0,0,0,0,0,0
Morocco,2008-11-01,6,0,0,9,3,18
Morocco,2008-11-01,4,0,0,0,0,4
Morocco,2008-11-01,0,0,0,0,0,0
Morocco,2008-11-01,6,0,0,0,0,6
Nigeria,2008-11-01,5,0,0,6,0,11
Nigeria,2008-11-01,0,0,0,0,1,1
Nigeria,2008-11-01,25,0,0,9,3,37
Nigeria,2008-11-01,19,0,0,15,0,34
Nigeria,2008-11-01,23,0,0,9,0,32
Nigeria,2008-11-01,-1,0,0,0,1,0
Nigeria,2008-11-01,25,0,0,2,1,28
Nigeria,2008-11-01,0,0,0,0,1,1
Nigeria,2008-11-01,9,0,0,3,0,12
Nigeria,2008-11-01,11,0,0,0,0,11
Nigeria,2008-11-01,31,0,2,10,1,44
Nigeria,2008-11-01,13,0,0,18,0,31
Nigeria,2008-11-01,3,0,0,6,0,9
Nigeria,2008-11-01,1,0,0,24,0,25
Nigeria,2008-11-01,61,0,0,10,5,76
Nigeria,2008-11-01,44,0,0,0,0,44
Nigeria,2008-11-01,23,0,0,9,4,36
Nigeria,2008-11-01,27,0,0,3,8,38
Nigeria,2008-11-01,5,0,0,3,0,8
Nigeria,2008-11-01,15,0,0,3,1,19
Nigeria,2008-11-01,0,0,0,0,0,0
Nigeria,2008-11-01,3,0,0,-2,0,1
Nigeria,2008-11-01,20,0,0,3,2,25
Nigeria,2008-11-01,20,0,0,7,0,27
Nigeria,2008-11-01,24,0,0,0,1,25
Nigeria,2008-11-01,38,0,0,6,0,44
Nigeria,2008-11-01,21,0,0,3,0,24
Nigeria,2008-11-01,37,0,0,6,1,44
Nigeria,2008-11-01,138,0,0,15,11,164
Nigeria,2008-11-01,135,0,-2,21,7,161
Pakistan,2008-11-01,49,0,-7,30,13,85
Pakistan,2008-11-01,45,0,-1,33,9,86
Pakistan,2008-11-01,64,2,0,16,3,85
Pakistan,2008-11-01,99,2,0,15,12,128
Pakistan,2008-11-01,106,0,0,2,1,109
Pakistan,2008-11-01,79,0,0,1,1,81
Pakistan,2008-11-01,43,0,0,30,3,76
Pakistan,2008-11-01,12,0,-1,3,4,18
Pakistan,2008-11-01,47,0,0,7,0,54
Pakistan,2008-11-01,63,0,1,25,6,95
Pakistan,2008-11-01,93,0,0,3,3,99
Pakistan,2008-11-01,21,0,0,14,4,39
Pakistan,2008-11-01,155,2,0,33,2,192
Pakistan,2008-11-01,80,2,-2,26,3,109
Pakistan,2008-11-01,42,0,-2,31,0,71
Pakistan,2008-11-01,19,2,-1,19,1,40
Pakistan,2008-11-01,34,0,0,18,14,66
Pakistan,2008-11-01,85,0,0,24,6,115
Pakistan,2008-11-01,60,0,0,10,3,73
Pakistan,2008-11-01,29,0,0,17,0,46
Pakistan,2008-11-01,4,0,0,1,1,6
Pakistan,2008-11-01,37,0,0,0,0,37
Pakistan,2008-11-01,104,0,0,-4,5,105
Pakistan,2008-11-01,50,4,-2,1,2,55
Pakistan,2008-11-01,45,0,0,16,1,62
Pakistan,2008-11-01,73,0,-1,40,6,118
Pakistan,2008-11-01,81,0,-4,93,8,178
Pakistan,2008-11-01,207,0,0,70,23,300
Pakistan,2008-11-01,136,6,0,31,18,191
Pakistan,2008-11-01,163,0,-2,27,16,204
Sierra Leone,2008-11-01,2,0,0,0,0,2
Sierra Leone,2008-11-01,2,0,0,0,0,2
Sierra Leone,2008-11-01,0,0,0,0,0,0
Sierra Leone,2008-11-01,6,0,0,0,0,6
Sierra Leone,2008-11-01,3,0,0,0,0,3
Sierra Leone,2008-11-01,0,0,0,0,1,1
Sierra Leone,2008-11-01,0,0,0,0,0,0
Sierra Leone,2008-11-01,0,0,0,0,0,0
Sierra Leone,2008-11-01,10,0,0,3,1,14
Sierra Leone,2008-11-01,6,0,0,0,0,6
Sierra Leone,2008-11-01,0,0,0,-4,0,-4
Sierra Leone,2008-11-01,0,0,0,0,0,0
Sierra Leone,2008-11-01,1,0,0,0,0,1
Sierra Leone,2008-11-01,0,0,0,0,0,0
Sierra Leone,2008-11-01,0,0,0,0,0,0
Sierra Leone,2008-11-01,0,0,0,9,0,9
Sierra Leone,2008-11-01,1,0,0,11,0,12
Sierra Leone,2008-11-01,14,0,0,-1,0,13
Sierra Leone,2008-11-01,0,0,0,0,0,0
Somalia,2008-11-01,8,0,0,2,0,10
Somalia,2008-11-01,59,0,0,2,5,66
Somalia,2008-11-01,42,0,-2,31,0,71
Somalia,2008-11-01,33,2,0,24,0,59
Somalia,2008-11-01,12,0,0,55,1,68
Somalia,2008-11-01,6,0,0,24,0,30
Somalia,2008-11-01,19,0,0,0,4,23
Somalia,2008-11-01,5,0,0,12,0,17
Somalia,2008-11-01,62,0,0,6,0,68
Somalia,2008-11-01,108,0,0,92,1,201
Somalia,2008-11-01,81,2,2,30,6,121
Somalia,2008-11-01,111,0,0,23,6,140
Somalia,2008-11-01,99,0,0,12,3,114
Somalia,2008-11-01,37,0,0,13,1,51
Somalia,2008-11-01,19,0,0,5,2,26
Somalia,2008-11-01,52,0,0,-8,4,48
Somalia,2008-11-01,80,0,0,44,6,130
Somalia,2008-11-01,221,0,0,57,19,297
Somalia,2008-11-01,246,0,2,223,10,481
Somalia,2008-11-01,186,4,0,117,8,315
Somalia,2008-11-01,26,0,0,12,9,47
Somalia,2008-11-01,3,0,0,7,2,12
Somalia,2008-11-01,79,0,0,21,5,105
Somalia,2008-11-01,152,0,1,38,30,221
Somalia,2008-11-01,139,0,0,56,9,204
Somalia,2008-11-01,96,0,0,20,3,119
Somalia,2008-11-01,44,0,0,27,0,71
Somalia,2008-11-01,29,0,0,1,5,35
Somalia,2008-11-01,22,0,0,27,1,50
Somalia,2008-11-01,39,0,0,10,0,49
Syria,2008-11-01,73,0,0,5,0,78
Syria,2008-11-01,47,0,0,7,0,54
Syria,2008-11-01,39,0,0,26,8,73
Syria,2008-11-01,14,0,0,0,2,16
Syria,2008-11-01,14,0,0,1,0,15
Syria,2008-11-01,32,4,0,12,0,48
Syria,2008-11-01,24,0,0,6,1,31
Syria,2008-11-01,10,0,0,6,0,16
Syria,2008-11-01,13,0,0,4,3,20
Syria,2008-11-01,51,0,2,24,7,84
Syria,2008-11-01,46,0,0,7,0,53
Syria,2008-11-01,24,0,1,6,0,31
Syria,2008-11-01,-1,0,0,9,0,8
Syria,2008-11-01,12,0,2,3,0,17
Syria,2008-11-01,36,0,0,0,0,36
Syria,2008-11-01,32,0,-1,0,3,34
Syria,2008-11-01,22,0,0,-7,0,15
Syria,2008-11-01,20,0,0,-8,0,12
Syria,2008-11-01,5,0,0,7,2,14
Syria,2008-11-01,17,0,0,3,4,24
Syria,2008-11-01,9,0,0,3,0,12
Syria,2008-11-01,1,0,0,9,0,10
Syria,2008-11-01,16,0,0,1,6,23
Syria,2008-11-01,16,4,0,4,0,24
Syria,2008-11-01,29,2,0,-4,1,28
Syria,2008-11-01,18,0,0,-2,1,17
Syria,2008-11-01,23,0,0,9,2,34
Syria,2008-11-01,22,0,0,18,3,43
Syria,2008-11-01,7,2,0,6,4,19
Syria,2008-11-01,19,0,0,0,0,19
Yemen,2008-11-01,0,0,0,3,2,5
Yemen,2008-11-01,3,0,0,6,3,12
Yemen,2008-11-01,42,0,0,102,2,146
Yemen,2008-11-01,35,0,0,84,7,126
Yemen,2008-11-01,22,0,0,9,0,31
Yemen,2008-11-01,3,0,0,3,0,6
Yemen,2008-11-01,0,0,0,0,0,0
Yemen,2008-11-01,0,0,0,10,0,10
Yemen,2008-11-01,0,0,0,0,0,0
Yemen,2008-11-01,19,0,0,-1,0,18
Yemen,2008-11-01,10,0,0,0,2,12
Yemen,2008-11-01,26,0,0,-2,0,24
Yemen,2008-11-01,29,0,0,6,0,35
Yemen,2008-11-01,3,0,0,9,9,21
Yemen,2008-11-01,16,0,0,27,5,48
Yemen,2008-11-01,0,0,1,21,0,22
Yemen,2008-11-01,4,0,0,6,2,12
Yemen,2008-11-01,4,0,0,8,1,13
Yemen,2008-11-01,21,0,0,10,6,37
Yemen,2008-11-01,28,0,0,3,8,39
Yemen,2008-11-01,0,0,0,0,2,2
Yemen,2008-11-01,0,0,0,-4,0,-4
Yemen,2008-11-01,0,0,0,-2,0,-2
Yemen,2008-11-01,6,0,1,13,2,22
Yemen,2008-11-01,32,0,0,77,4,113
Yemen,2008-11-01,30,0,-1,34,1,64
Yemen,2008-11-01,12,0,0,30,13,55
Yemen,2008-11-01,2,0,0,15,0,17
Yemen,2008-11-01,2,0,0,0,0,2
Yemen,2008-11-01,2,0,0,6,0,8
Afghanistan,2008-01-01,7,0,0,3,0,10
Afghanistan,2008-01-01,140,4,0,49,4,197
Afghanistan,2008-01-01,30,0,-2,7,0,35
Afghanistan,2008-01-01,35,4,0,0,15,54
Afghanistan,2008-01-01,31,4,0,-10,10,35
Afghanistan,2008-01-01,49,0,0,8,7,64
Afghanistan,2008-01-01,106,0,0,15,11,132
Afghanistan,2008-01-01,62,0,1,32,9,104
Afghanistan,2008-01-01,164,0,1,39,7,211
Afghanistan,2008-01-01,180,0,2,67,15,264
Afghanistan,2008-01-01,126,0,2,35,11,174
Afghanistan,2008-01-01,62,0,0,4,6,72
Afghanistan,2008-01-01,88,0,0,-4,2,86
Afghanistan,2008-01-01,199,0,1,28,20,248
Afghanistan,2008-01-01,108,0,0,25,10,143
Afghanistan,2008-01-01,200,0,-1,27,19,245
Afghanistan,2008-01-01,123,0,2,52,26,203
Afghanistan,2008-01-01,167,0,3,59,20,249
Afghanistan,2008-01-01,129,0,-4,42,2,169
Afghanistan,2008-01-01,153,0,0,90,9,252
Afghanistan,2008-01-01,77,0,1,14,11,103
Afghanistan,2008-01-01,200,2,-2,96,14,310
Afghanistan,2008-01-01,213,4,-2,54,8,277
Afghanistan,2008-01-01,213,6,-4,71,19,305
Afghanistan,2008-01-01,94,0,0,24,8,126
Afghanistan,2008-01-01,118,0,0,50,1,169
Afghanistan,2008-01-01,92,0,-4,14,1,103
Afghanistan,2008-01-01,148,0,-4,37,1,182
Afghanistan,2008-01-01,270,0,0,51,8,329
Afghanistan,2008-01-01,186,0,0,23,11,220
Afghanistan,2008-01-01,125,0,0,15,26,166
Albania,2008-01-01,0,0,0,0,0,0
Albania,2008-01-01,6,0,-1,6,1,12
Albania,2008-01-01,6,0,-2,0,0,4
Albania,2008-01-01,4,0,-14,0,1,-9
Albania,2008-01-01,5,0,0,0,0,5
Albania,2008-01-01,-3,0,0,0,0,-3
Albania,2008-01-01,5,0,0,0,0,5
Albania,2008-01-01,5,0,-1,0,0,4
Albania,2008-01-01,18,0,-5,3,0,16
Albania,2008-01-01,25,0,-7,-5,5,18
Albania,2008-01-01,6,0,-1,-8,1,-2
Albania,2008-01-01,13,0,0,0,0,13
Albania,2008-01-01,22,0,-4,0,1,19
Albania,2008-01-01,16,0,1,9,0,26
Albania,2008-01-01,14,0,-8,15,0,21
Albania,2008-01-01,11,0,-7,-4,0,0
Albania,2008-01-01,9,0,-10,6,0,5
Albania,2008-01-01,0,0,-2,0,0,-2
Albania,2008-01-01,3,0,-4,6,1,6
Albania,2008-01-01,3,0,-22,3,13,-3
Albania,2008-01-01,6,0,-5,1,0,2
Albania,2008-01-01,19,0,-8,0,0,11
Albania,2008-01-01,23,0,-7,0,4,20
Albania,2008-01-01,13,0,-6,9,2,18
Albania,2008-01-01,2,0,-1,0,2,3
Albania,2008-01-01,7,0,-2,0,0,5
Albania,2008-01-01,7,0,-3,-1,0,3
Albania,2008-01-01,8,0,-3,18,1,24
Albania,2008-01-01,6,0,-6,20,0,20
Albania,2008-01-01,10,0,-2,3,1,12
Algeria,2008-01-01,3,0,0,0,0,3
Algeria,2008-01-01,8,0,0,0,3,11
Algeria,2008-01-01,2,0,0,0,0,2
Algeria,2008-01-01,0,0,0,3,0,3
Algeria,2008-01-01,6,0,0,0,-4,2
Algeria,2008-01-01,3,0,0,0,0,3
Algeria,2008-01-01,-1,0,0,0,0,-1
Algeria,2008-01-01,12,0,0,2,0,14
Algeria,2008-01-01,8,0,0,0,0,8
Algeria,2008-01-01,5,0,0,12,0,17
Algeria,2008-01-01,3,0,0,12,0,15
Algeria,2008-01-01,3,0,0,0,0,3
Algeria,2008-01-01,2,0,0,3,0,5
Algeria,2008-01-01,0,0,0,0,0,0
Algeria,2008-01-01,0,0,0,0,0,0
Algeria,2008-01-01,4,0,0,3,0,7
Algeria,2008-01-01,3,0,0,0,0,3
Algeria,2008-01-01,0,0,0,6,0,6
Algeria,2008-01-01,0,0,0,0,0,0
Algeria,2008-01-01,5,0,0,0,0,5
Algeria,2008-01-01,5,0,0,9,1,15
Algeria,2008-01-01,2,0,0,0,0,2
Algeria,2008-01-01,2,0,0,1,0,3
Algeria,2008-01-01,6,0,0,0,1,7
Algeria,2008-01-01,2,0,0,0,0,2
Algeria,2008-01-01,0,0,0,0,0,0
Algeria,2008-01-01,1,0,0,0,0,1
Algeria,2008-01-01,20,0,0,6,0,26
Algeria,2008-01-01,9,0,0,1,0,10
Algeria,2008-01-01,1,0,0,0,0,1
Bangladesh,2008-01-01,5,0,0,0,0,5
Bangladesh,2008-01-01,10,2,0,3,0,15
Bangladesh,2008-01-01,0,0,0,-2,0,-2
Bangladesh,2008-01-01,2,0,0,0,0,2
Bangladesh,2008-01-01,6,0,0,0,0,6
Bangladesh,2008-01-01,18,0,-2,9,3,28
Bangladesh,2008-01-01,14,0,0,1,0,15
Bangladesh,2008-01-01,10,0,-2,0,0,8
Bangladesh,2008-01-01,10,2,0,4,0,16
Bangladesh,2008-01-01,8,0,-3,27,0,32
Bangladesh,2008-01-01,16,0,2,0,2,20
Bangladesh,2008-01-01,2,0,-2,3,3,6
Bangladesh,2008-01-01,12,0,-2,16,0,26
Bangladesh,2008-01-01,14,0,0,3,2,19
Bangladesh,2008-01-01,6,0,0,8,2,16
Bangladesh,2008-01-01,44,0,-4,13,4,57
Bangladesh,2008-01-01,13,0,-1,12,9,33
Bangladesh,2008-01-01,19,0,0,0,1,20
Bangladesh,2008-01-01,7,0,0,-3,2,6
Bangladesh,2008-01-01,24,4,1,7,0,36
Bangladesh,2008-01-01,4,2,-4,0,1,3
Bangladesh,2008-01-01,14,0,0,0,0,14
Bangladesh,2008-01-01,38,0,0,12,0,50
Bangladesh,2008-01-01,13,0,0,3,2,18
Bangladesh,2008-01-01,10,0,0,6,3,19
Bangladesh,2008-01-01,0,0,0,6,0,6
Bangladesh,2008-01-01,9,0,0,6,0,15
Bangladesh,2008-01-01,3,0,0,9,0,12
Bangladesh,2008-01-01,22,0,0,3,0,25
Bangladesh,2008-01-01,3,0,0,16,0,19
Bangladesh,2008-01-01,3,0,0,9,3,15
Cameroon,2008-01-01,-2,0,0,-2,0,-4
Cameroon,2008-01-01,0,0,0,0,0,0
Cameroon,2008-01-01,0,0,0,0,0,0
Cameroon,2008-01-01,1,0,0,0,0,1
Cameroon,2008-01-01,0,0,0,0,0,0
Cameroon,2008-01-01,0,0,0,0,1,1
Cameroon,2008-01-01,0,0,0,0,0,0
Cameroon,2008-01-01,0,0,0,0,0,0
Cameroon,2008-01-01,3,0,0,0,0,3
Cameroon,2008-01-01,-2,0,0,0,0,-2
Cameroon,2008-01-01,0,0,0,9,0,9
Cameroon,2008-01-01,0,0,0,0,0,0
Cameroon,2008-01-01,0,0,0,0,0,0
Cameroon,2008-01-01,9,0,0,0,0,9
Cameroon,2008-01-01,1,0,0,0,0,1
Cameroon,2008-01-01,0,0,0,0,2,2
Cameroon,2008-01-01,1,0,0,3,0,4
Cameroon,2008-01-01,1,0,0,0,0,1
Cameroon,2008-01-01,-1,0,0,0,0,-1
Cameroon,2008-01-01,0,0,0,0,0,0
China,2008-01-01,5,0,0,0,0,5
China,2008-01-01,39,0,-1,71,8,117
China,2008-01-01,36,0,3,29,0,68
China,2008-01-01,31,4,3,52,6,96
China,2008-01-01,9,0,-1,2,4,14
China,2008-01-01,11,0,0,11,4,26
China,2008-01-01,47,0,-4,15,11,69
China,2008-01-01,32,0,0,17,2,51
China,2008-01-01,47,4,-1,27,25,102
China,2008-01-01,76,0,-2,36,12,122
China,2008-01-01,57,4,0,56,7,124
China,2008-01-01,-9,0,-5,35,10,31
China,2008-01-01,16,0,1,6,9,32
China,2008-01-01,49,0,-5,37,6,87
China,2008-01-01,49,0,0,5,2,56
China,2008-01-01,49,2,-2,20,6,75
China,2008-01-01,43,0,-1,12,11,65
China,2008-01-01,61,0,2,18,12,93
China,2008-01-01,22,0,-8,22,0,36
China,2008-01-01,64,0,-8,64,3,123
China,2008-01-01,36,0,-5,10,2,43
China,2008-01-01,10,2,1,10,6,29
China,2008-01-01,60,2,0,17,4,83
China,2008-01-01,39,0,-1,13,0,51
China,2008-01-01,72,0,-2,31,4,105
China,2008-01-01,33,0,-3,36,2,68
China,2008-01-01,12,0,-6,15,3,24
China,2008-01-01,38,2,2,34,2,78
China,2008-01-01,80,0,-2,43,9,130
China,2008-01-01,48,0,0,44,6,98
China,2008-01-01,69,2,-6,22,3,90
Egypt,2008-01-01,8,0,0,12,0,20
Egypt,2008-01-01,38,2,1,6,6,53
Egypt,2008-01-01,22,0,0,3,2,27
Egypt,2008-01-01,19,0,0,19,0,38
Egypt,2008-01-01,13,0,1,1,0,15
Egypt,2008-01-01,9,0,0,9,0,18
Egypt,2008-01-01,11,0,0,22,5,38
Egypt,2008-01-01,44,0,0,2,0,46
Egypt,2008-01-01,14,0,1,-7,1,9
Egypt,2008-01-01,18,0,0,15,1,34
Egypt,2008-01-01,24,0,1,77,1,103
Egypt,2008-01-01,2,0,0,4,0,6
Egypt,2008-01-01,15,0,0,-10,1,6
Egypt,2008-01-01,14,0,0,6,1,21
Egypt,2008-01-01,40,0,3,12,6,61
Egypt,2008-01-01,48,0,-2,-5,1,42
Egypt,2008-01-01,34,0,1,3,3,41
Egypt,2008-01-01,19,0,1,-8,0,12
Egypt,2008-01-01,31,0,0,9,0,40
Egypt,2008-01-01,25,0,0,12,2,39
Egypt,2008-01-01,62,0,-1,-4,6,63
Egypt,2008-01-01,145,2,-2,58,48,251
Egypt,2008-01-01,216,0,7,81,32,336
Egypt,2008-01-01,267,2,8,52,17,346
Egypt,2008-01-01,327,0,17,83,34,461
Egypt,2008-01-01,91,0,14,24,11,140
Egypt,2008-01-01,27,0,4,13,9,53
Egypt,2008-01-01,37,0,1,-2,0,36
Egypt,2008-01-01,57,0,4,28,1,90
Egypt,2008-01-01,115,0,3,45,7,170
Egypt,2008-01-01,31,0,4,3,10,48
Eritrea,2008-01-01,2,0,0,0,0,2
Eritrea,2008-01-01,11,0,0,-2,0,9
Eritrea,2008-01-01,0,0,0,3,2,5
Eritrea,2008-01-01,0,0,0,0,0,0
Eritrea,2008-01-01,0,0,0,0,1,1
Eritrea,2008-01-01,0,0,1,0,0,1
Eritrea,2008-01-01,4,0,0,0,0,4
Eritrea,2008-01-01,2,0,0,-3,0,-1
Eritrea,2008-01-01,6,0,0,0,0,6
Eritrea,2008-01-01,0,0,0,0,0,0
Eritrea,2008-01-01,0,0,0,3,0,3
Eritrea,2008-01-01,14,0,0,0,0,14
Eritrea,2008-01-01,0,0,0,3,0,3
Eritrea,2008-01-01,0,0,0,-4,0,-4
Eritrea,2008-01-01,0,0,0,0,0,0
Eritrea,2008-01-01,0,0,0,0,0,0
Eritrea,2008-01-01,4,0,0,3,0,7
Eritrea,2008-01-01,21,0,0,0,0,21
Eritrea,2008-01-01,27,0,0,0,0,27
Eritrea,2008-01-01,0,0,0,0,0,0
Eritrea,2008-01-01,2,0,0,0,0,2
Eritrea,2008-01-01,0,0,0,0,0,0
Eritrea,2008-01-01,0,0,0,0,0,0
Eritrea,2008-01-01,5,0,0,3,0,8
Eritrea,2008-01-01,8,0,0,0,1,9
Georgia,2008-01-01,-3,0,0,0,0,-3
Georgia,2008-01-01,0,0,0,3,0,3
Georgia,2008-01-01,3,0,0,3,0,6
Georgia,2008-01-01,4,0,0,12,2,18
Georgia,2008-01-01,0,0,0,6,3,9
Georgia,2008-01-01,4,0,2,3,2,11
Georgia,2008-01-01,2,0,-2,6,1,7
Georgia,2008-01-01,3,0,1,9,2,15
Georgia,2008-01-01,21,0,1,2,0,24
Georgia,2008-01-01,8,0,-1,7,0,14
Georgia,2008-01-01,22,0,0,12,2,36
Georgia,2008-01-01,9,0,0,3,4,16
Georgia,2008-01-01,3,0,1,-2,1,3
Georgia,2008-01-01,10,0,0,4,1,15
Georgia,2008-01-01,12,0,0,3,0,15
Georgia,2008-01-01,30,0,0,12,8,50
Georgia,2008-01-01,11,0,0,9,4,24
Georgia,2008-01-01,14,0,0,-1,2,15
Georgia,2008-01-01,2,0,0,-2,2,2
Georgia,2008-01-01,3,0,4,0,8,15
Georgia,2008-01-01,18,0,-2,3,4,23
Georgia,2008-01-01,25,0,0,0,0,25
Georgia,2008-01-01,8,0,0,0,0,8
Georgia,2008-01-01,11,0,0,5,2,18
Georgia,2008-01-01,13,0,-6,3,2,12
Georgia,2008-01-01,5,0,0,3,1,9
Georgia,2008-01-01,3,0,0,0,1,4
Georgia,2008-01-01,0,0,0,0,0,0
Georgia,2008-01-01,11,0,1,1,3,16
Georgia,2008-01-01,14,0,1,0,0,15
Georgia,2008-01-01,27,0,0,22,1,50
India,2008-01-01,4,0,0,0,1,5
India,2008-01-01,143,0,1,54,13,211
India,2008-01-01,28,0,0,-1,6,33
India,2008-01-01,25,0,0,11,2,38
India,2008-01-01,19,0,-2,1,0,18
India,2008-01-01,25,0,0,6,1,32
India,2008-01-01,25,0,0,15,2,42
India,2008-01-01,23,0,1,-3,5,26
India,2008-01-01,12,0,0,15,4,31
India,2008-01-01,31,0,0,58,11,100
India,2008-01-01,36,0,0,2,4,42
India,2008-01-01,23,0,0,0,1,24
India,2008-01-01,26,0,1,0,2,29
India,2008-01-01,26,0,1,17,6,50
India,2008-01-01,38,0,0,34,4,76
India,2008-01-01,44,0,-1,0,0,43
India,2008-01-01,21,2,-1,18,3,43
India,2008-01-01,44,0,-4,10,2,52
India,2008-01-01,24,0,0,6,0,30
India,2008-01-01,5,0,0,6,0,11
India,2008-01-01,55,0,-1,4,7,65
India,2008-01-01,21,2,-1,12,2,36
India,2008-01-01,28,0,0,15,6,49
India,2008-01-01,34,0,-2,13,3,48
India,2008-01-01,44,0,-6,12,4,54
India,2008-01-01,21,0,-6,22,1,38
India,2008-01-01,16,0,2,13,1,32
India,2008-01-01,22,0,1,30,1,54
India,2008-01-01,8,0,0,2,0,10
India,2008-01-01,37,0,0,30,1,68
India,2008-01-01,39,0,0,7,2,48
Iran,2008-01-01,5,0,0,3,0,8
Iran,2008-01-01,77,0,-3,23,1,98
Iran,2008-01-01,32,0,-2,28,2,60
Iran,2008-01-01,47,0,-4,27,2,72
Iran,2008-01-01,16,0,0,22,5,43
Iran,2008-01-01,5,0,3,-1,0,7
Iran,2008-01-01,22,0,0,30,2,54
Iran,2008-01-01,72,2,0,-1,10,83
Iran,2008-01-01,113,0,1,-3,17,128
Iran,2008-01-01,68,0,-2,11,12,89
Iran,2008-01-01,97,0,0,2,10,109
Iran,2008-01-01,92,0,-2,12,8,110
Iran,2008-01-01,45,0,-1,1,4,49
Iran,2008-01-01,108,0,1,-6,5,108
Iran,2008-01-01,77,0,0,1,3,81
Iran,2008-01-01,95,0,0,8,9,112
Iran,2008-01-01,77,0,-2,14,1,90
Iran,2008-01-01,58,0,-7,-11,9,49
Iran,2008-01-01,39,0,0,27,1,67
Iran,2008-01-01,33,0,0,14,4,51
Iran,2008-01-01,42,0,-4,7,9,54
Iran,2008-01-01,30,0,2,34,3,69
Iran,2008-01-01,30,2,1,17,1,51
Iran,2008-01-01,64,0,0,10,2,76
Iran,2008-01-01,8,0,-2,12,2,20
Iran,2008-01-01,39,0,-1,12,6,56
Iran,2008-01-01,9,0,0,7,3,19
Iran,2008-01-01,16,0,0,3,0,19
Iran,2008-01-01,22,0,0,6,3,31
Iran,2008-01-01,29,0,0,9,3,41
Iran,2008-01-01,61,0,0,25,19,105
Iraq,2008-01-01,13,4,0,2,2,21
Iraq,2008-01-01,155,6,1,10,23,195
Iraq,2008-01-01,44,0,-2,20,6,68
Iraq,2008-01-01,127,4,-2,14,21,164
Iraq,2008-01-01,74,4,0,-6,8,80
Iraq,2008-01-01,80,0,1,7,11,99
Iraq,2008-01-01,71,0,1,-14,7,65
Iraq,2008-01-01,152,2,0,2,10,166
Iraq,2008-01-01,173,2,1,25,8,209
Iraq,2008-01-01,149,0,1,50,28,228
Iraq,2008-01-01,107,2,1,-4,13,119
Iraq,2008-01-01,68,0,-2,4,5,75
Iraq,2008-01-01,44,0,0,8,4,56
Iraq,2008-01-01,67,2,1,21,2,93
Iraq,2008-01-01,143,0,0,29,7,179
Iraq,2008-01-01,142,0,0,36,25,203
Iraq,2008-01-01,65,2,0,24,7,98
Iraq,2008-01-01,174,0,1,29,9,213
Iraq,2008-01-01,34,0,1,15,2,52
Iraq,2008-01-01,23,0,1,15,14,53
Iraq,2008-01-01,48,0,1,12,9,70
Iraq,2008-01-01,53,4,-2,21,3,79
Iraq,2008-01-01,96,0,-1,13,5,113
Iraq,2008-01-01,121,0,1,39,20,181
Iraq,2008-01-01,69,2,-4,54,17,138
Iraq,2008-01-01,56,0,-2,-2,15,67
Iraq,2008-01-01,17,0,-2,21,5,41
Iraq,2008-01-01,37,0,1,-1,9,46
Iraq,2008-01-01,170,2,2,32,10,216
Iraq,2008-01-01,96,2,0,18,12,128
Iraq,2008-01-01,213,0,1,27,10,251
Morocco,2008-01-01,1,0,0,4,0,5
Morocco,2008-01-01,0,0,0,0,0,0
Morocco,2008-01-01,0,0,0,3,0,3
Morocco,2008-01-01,0,0,0,0,1,1
Morocco,2008-01-01,0,0,0,0,0,0
Morocco,2008-01-01,6,0,0,12,0,18
Morocco,2008-01-01,3,0,0,0,0,3
Morocco,2008-01-01,10,0,0,3,0,13
Morocco,2008-01-01,9,0,0,0,0,9
Morocco,2008-01-01,0,0,0,0,0,0
Morocco,2008-01-01,0,0,0,0,0,0
Morocco,2008-01-01,0,0,0,0,0,0
Morocco,2008-01-01,11,0,0,4,0,15
Morocco,2008-01-01,2,0,0,0,0,2
Morocco,2008-01-01,15,0,0,0,0,15
Morocco,2008-01-01,6,0,0,0,0,6
Morocco,2008-01-01,21,0,0,-2,1,20
Morocco,2008-01-01,1,0,0,6,0,7
Morocco,2008-01-01,0,0,0,6,0,6
Morocco,2008-01-01,2,0,0,-2,5,5
Morocco,2008-01-01,0,0,0,0,0,0
Morocco,2008-01-01,0,0,0,0,0,0
Morocco,2008-01-01,8,0,0,31,1,40
Morocco,2008-01-01,4,0,0,9,0,13
Morocco,2008-01-01,0,0,0,3,1,4
Morocco,2008-01-01,6,0,0,0,0,6
Morocco,2008-01-01,6,0,0,42,0,48
Morocco,2008-01-01,2,0,0,6,0,8
Morocco,2008-01-01,-1,0,0,0,0,-1
Morocco,2008-01-01,6,0,0,3,0,9
Nigeria,2008-01-01,0,0,0,0,0,0
Nigeria,2008-01-01,9,4,-2,15,2,28
Nigeria,2008-01-01,6,2,0,0,4,12
Nigeria,2008-01-01,6,0,0,0,0,6
Nigeria,2008-01-01,1,0,0,3,0,4
Nigeria,2008-01-01,6,0,0,0,0,6
Nigeria,2008-01-01,24,0,0,3,0,27
Nigeria,2008-01-01,22,0,0,2,0,24
Nigeria,2008-01-01,8,0,0,-4,0,4
Nigeria,2008-01-01,8,0,0,6,1,15
Nigeria,2008-01-01,14,0,0,9,0,23
Nigeria,2008-01-01,0,0,0,0,0,0
Nigeria,2008-01-01,6,0,0,0,0,6
Nigeria,2008-01-01,15,0,-1,-4,0,10
Nigeria,2008-01-01,11,0,2,18,0,31
Nigeria,2008-01-01,12,0,-2,3,3,16
Nigeria,2008-01-01,10,0,0,0,0,10
Nigeria,2008-01-01,8,0,0,-1,0,7
Nigeria,2008-01-01,2,0,0,-3,0,-1
Nigeria,2008-01-01,1,0,0,0,2,3
Nigeria,2008-01-01,11,0,0,6,0,17
Nigeria,2008-01-01,3,0,0,6,3,12
Nigeria,2008-01-01,8,0,0,12,0,20
Nigeria,2008-01-01,8,0,0,6,0,14
Nigeria,2008-01-01,1,0,0,0,1,2
Nigeria,2008-01-01,0,0,0,3,0,3
Nigeria,2008-01-01,1,0,0,6,0,7
Nigeria,2008-01-01,0,0,0,4,0,4
Nigeria,2008-01-01,0,0,0,21,4,25
Nigeria,2008-01-01,3,0,0,-4,0,-1
Nigeria,2008-01-01,2,0,0,0,13,15
Pakistan,2008-01-01,7,0,0,0,2,9
Pakistan,2008-01-01,193,6,-3,34,24,254
Pakistan,2008-01-01,30,0,4,-4,3,33
Pakistan,2008-01-01,40,0,-2,7,8,53
Pakistan,2008-01-01,27,0,0,-1,1,27
Pakistan,2008-01-01,77,2,0,11,4,94
Pakistan,2008-01-01,86,0,0,6,6,98
Pakistan,2008-01-01,20,0,2,23,3,48
Pakistan,2008-01-01,58,0,1,17,1,77
Pakistan,2008-01-01,81,4,0,36,23,144
Pakistan,2008-01-01,79,0,-4,17,10,102
Pakistan,2008-01-01,63,0,1,5,2,71
Pakistan,2008-01-01,22,0,0,3,0,25
Pakistan,2008-01-01,60,0,2,12,5,79
Pakistan,2008-01-01,54,0,0,30,1,85
Pakistan,2008-01-01,67,0,-1,37,3,106
Pakistan,2008-01-01,57,0,0,13,3,73
Pakistan,2008-01-01,72,0,0,-1,5,76
Pakistan,2008-01-01,47,0,1,20,2,70
Pakistan,2008-01-01,19,0,0,9,0,28
Pakistan,2008-01-01,86,0,-4,18,3,103
Pakistan,2008-01-01,56,2,-4,4,7,65
Pakistan,2008-01-01,63,0,0,19,7,89
Pakistan,2008-01-01,81,0,-17,7,3,74
Pakistan,2008-01-01,134,0,-4,18,12,160
Pakistan,2008-01-01,86,0,-8,14,9,101
Pakistan,2008-01-01,66,0,0,6,7,79
Pakistan,2008-01-01,79,0,1,31,7,118
Pakistan,2008-01-01,47,0,0,14,2,63
Pakistan,2008-01-01,46,0,0,22,6,74
Pakistan,2008-01-01,66,0,0,22,19,107
Sierra Leone,2008-01-01,-2,0,0,0,0,-2
Sierra Leone,2008-01-01,0,0,0,0,0,0
Sierra Leone,2008-01-01,5,0,0,0,0,5
Sierra Leone,2008-01-01,5,0,-1,3,0,7
Sierra Leone,2008-01-01,30,0,2,12,8,52
Sierra Leone,2008-01-01,9,0,0,9,10,28
Sierra Leone,2008-01-01,22,0,0,9,5,36
Sierra Leone,2008-01-01,36,0,0,12,3,51
Sierra Leone,2008-01-01,2,0,0,3,6,11
Sierra Leone,2008-01-01,4,0,0,6,0,10
Sierra Leone,2008-01-01,0,0,2,18,0,20
Sierra Leone,2008-01-01,0,0,-2,1,0,-1
Sierra Leone,2008-01-01,2,2,0,0,0,4
Sierra Leone,2008-01-01,9,0,0,0,0,9
Sierra Leone,2008-01-01,6,0,0,0,0,6
Sierra Leone,2008-01-01,-3,0,0,0,0,-3
Sierra Leone,2008-01-01,3,0,0,-4,0,-1
Sierra Leone,2008-01-01,6,0,0,3,0,9
Sierra Leone,2008-01-01,3,0,0,0,0,3
Sierra Leone,2008-01-01,0,0,0,0,0,0
Sierra Leone,2008-01-01,2,0,0,9,0,11
Sierra Leone,2008-01-01,0,0,0,0,0,0
Sierra Leone,2008-01-01,0,0,0,0,0,0
Sierra Leone,2008-01-01,0,0,0,0,0,0
Somalia,2008-01-01,3,0,0,0,0,3
Somalia,2008-01-01,57,0,0,-8,5,54
Somalia,2008-01-01,2,2,0,4,0,8
Somalia,2008-01-01,5,0,-4,-10,0,-9
Somalia,2008-01-01,1,0,1,0,0,2
Somalia,2008-01-01,12,0,0,0,0,12
Somalia,2008-01-01,5,0,2,3,0,10
Somalia,2008-01-01,0,0,0,0,0,0
Somalia,2008-01-01,12,0,0,0,0,12
Somalia,2008-01-01,16,0,0,0,-12,4
Somalia,2008-01-01,11,0,1,3,0,15
Somalia,2008-01-01,2,0,0,0,0,2
Somalia,2008-01-01,6,0,0,0,0,6
Somalia,2008-01-01,25,0,0,1,0,26
Somalia,2008-01-01,10,0,0,-6,2,6
Somalia,2008-01-01,11,0,0,0,1,12
Somalia,2008-01-01,0,0,0,0,0,0
Somalia,2008-01-01,17,0,0,13,0,30
Somalia,2008-01-01,9,0,0,0,1,10
Somalia,2008-01-01,10,0,0,6,1,17
Somalia,2008-01-01,5,0,0,8,0,13
Somalia,2008-01-01,17,0,0,6,1,24
Somalia,2008-01-01,12,0,1,12,3,28
Somalia,2008-01-01,18,0,0,12,2,32
Somalia,2008-01-01,1,0,0,6,8,15
Somalia,2008-01-01,5,0,0,0,0,5
Somalia,2008-01-01,-1,0,0,0,0,-1
Somalia,2008-01-01,4,0,0,4,0,8
Somalia,2008-01-01,6,2,0,0,0,8
Somalia,2008-01-01,22,0,0,0,3,25
Somalia,2008-01-01,14,0,1,-4,1,12
Syria,2008-01-01,0,0,0,0,0,0
Syria,2008-01-01,47,0,0,8,1,56
Syria,2008-01-01,9,0,0,0,0,9
Syria,2008-01-01,29,0,-2,13,2,42
Syria,2008-01-01,12,0,0,-2,1,11
Syria,2008-01-01,3,0,1,0,0,4
Syria,2008-01-01,5,0,0,3,0,8
Syria,2008-01-01,25,0,0,3,1,29
Syria,2008-01-01,18,0,0,6,1,25
Syria,2008-01-01,20,0,0,-2,0,18
Syria,2008-01-01,13,0,0,16,0,29
Syria,2008-01-01,4,0,0,0,0,4
Syria,2008-01-01,0,0,0,0,0,0
Syria,2008-01-01,28,0,0,8,0,36
Syria,2008-01-01,50,0,0,8,19,77
Syria,2008-01-01,62,0,-4,29,8,95
Syria,2008-01-01,7,0,0,39,12,58
Syria,2008-01-01,19,0,1,4,9,33
Syria,2008-01-01,5,0,2,10,0,17
Syria,2008-01-01,25,0,0,21,5,51
Syria,2008-01-01,19,0,0,5,4,28
Syria,2008-01-01,5,0,1,0,1,7
Syria,2008-01-01,4,0,0,3,1,8
Syria,2008-01-01,24,0,0,3,4,31
Syria,2008-01-01,62,2,0,3,22,89
Syria,2008-01-01,21,0,0,3,2,26
Syria,2008-01-01,16,0,0,0,1,17
Syria,2008-01-01,8,0,0,9,9,26
Syria,2008-01-01,32,0,0,30,7,69
Syria,2008-01-01,39,0,0,6,0,45
Syria,2008-01-01,10,0,0,12,2,24
Yemen,2008-01-01,0,0,0,1,0,1
Yemen,2008-01-01,0,0,0,3,0,3
Yemen,2008-01-01,0,0,0,3,0,3
Yemen,2008-01-01,0,0,0,0,0,0
Yemen,2008-01-01,0,0,0,0,0,0
Yemen,2008-01-01,0,0,0,-4,0,-4
Yemen,2008-01-01,9,0,0,3,0,12
Yemen,2008-01-01,5,0,0,3,0,8
Yemen,2008-01-01,11,0,0,3,2,16
Yemen,2008-01-01,14,0,0,6,0,20
Yemen,2008-01-01,8,0,0,-10,0,-2
Yemen,2008-01-01,36,0,0,8,1,45
Yemen,2008-01-01,20,0,0,4,4,28
Yemen,2008-01-01,0,0,0,3,-2,1
Yemen,2008-01-01,9,0,0,0,0,9
Yemen,2008-01-01,0,0,0,0,0,0
Yemen,2008-01-01,22,0,0,4,4,30
Yemen,2008-01-01,17,0,0,3,0,20
Yemen,2008-01-01,6,0,0,0,0,6
Yemen,2008-01-01,3,0,0,0,0,3
Yemen,2008-01-01,17,0,0,9,0,26
Yemen,2008-01-01,2,0,0,6,0,8
Yemen,2008-01-01,3,0,0,9,0,12
Yemen,2008-01-01,3,0,0,9,0,12
Yemen,2008-01-01,7,0,0,6,0,13
Yemen,2008-01-01,5,0,0,0,0,5
Yemen,2008-01-01,5,0,0,-1,0,4
Yemen,2008-01-01,0,0,0,6,0,6
Yemen,2008-01-01,9,0,0,3,0,12
Yemen,2008-01-01,0,0,0,0,0,0
Afghanistan,2013-02-01,85,0,0,37,20,142
Afghanistan,2013-02-01,65,0,-1,27,10,101
Afghanistan,2013-02-01,41,0,-4,24,8,69
Afghanistan,2013-02-01,106,6,0,31,6,149
Afghanistan,2013-02-01,99,0,-1,65,14,177
Afghanistan,2013-02-01,128,0,0,-2,8,134
Afghanistan,2013-02-01,107,0,0,14,7,128
Afghanistan,2013-02-01,202,4,-1,9,13,227
Afghanistan,2013-02-01,79,0,0,-8,1,72
Afghanistan,2013-02-01,164,0,-4,40,10,210
Afghanistan,2013-02-01,163,0,3,36,6,208
Afghanistan,2013-02-01,145,0,0,60,13,218
Afghanistan,2013-02-01,75,0,-8,32,14,113
Afghanistan,2013-02-01,98,4,-5,50,7,154
Afghanistan,2013-02-01,127,0,1,17,14,159
Afghanistan,2013-02-01,16,0,1,1,4,22
Afghanistan,2013-02-01,140,0,1,52,6,199
Afghanistan,2013-02-01,125,0,-1,34,51,209
Afghanistan,2013-02-01,97,4,-5,49,46,191
Afghanistan,2013-02-01,157,2,-5,53,10,217
Afghanistan,2013-02-01,122,0,0,10,29,161
Afghanistan,2013-02-01,200,6,0,13,13,232
Afghanistan,2013-02-01,64,2,0,45,8,119
Afghanistan,2013-02-01,146,2,-10,98,15,251
Afghanistan,2013-02-01,85,2,-1,61,13,160
Afghanistan,2013-02-01,234,2,0,39,48,323
Afghanistan,2013-02-01,120,4,1,65,26,216
Afghanistan,2013-02-01,188,0,-8,14,13,207
Albania,2013-02-01,17,0,0,0,7,24
Albania,2013-02-01,1,0,0,0,0,1
Albania,2013-02-01,-3,0,0,0,0,-3
Albania,2013-02-01,2,0,-2,-2,4,2
Albania,2013-02-01,5,0,0,0,0,5
Albania,2013-02-01,13,0,0,0,0,13
Albania,2013-02-01,0,0,0,0,0,0
Albania,2013-02-01,0,0,0,0,0,0
Albania,2013-02-01,4,0,0,0,0,4
Albania,2013-02-01,3,0,-1,0,0,2
Albania,2013-02-01,4,0,0,0,2,6
Albania,2013-02-01,5,0,0,0,0,5
Albania,2013-02-01,-7,0,0,0,2,-5
Albania,2013-02-01,-2,0,0,0,0,-2
Albania,2013-02-01,0,0,0,3,0,3
Albania,2013-02-01,13,0,0,-2,0,11
Albania,2013-02-01,0,0,-1,0,0,-1
Albania,2013-02-01,13,0,-1,0,2,14
Albania,2013-02-01,22,0,2,0,0,24
Albania,2013-02-01,10,0,0,3,0,13
Albania,2013-02-01,0,0,0,0,0,0
Albania,2013-02-01,14,0,0,0,0,14
Albania,2013-02-01,17,0,0,3,5,25
Albania,2013-02-01,3,0,0,3,4,10
Albania,2013-02-01,8,0,0,16,2,26
Albania,2013-02-01,2,0,0,6,0,8
Albania,2013-02-01,49,0,0,-2,3,50
Algeria,2013-02-01,59,0,1,15,5,80
Algeria,2013-02-01,42,0,0,20,0,62
Algeria,2013-02-01,17,0,0,16,0,33
Algeria,2013-02-01,56,0,0,9,0,65
Algeria,2013-02-01,30,0,0,22,6,58
Algeria,2013-02-01,10,0,0,4,0,14
Algeria,2013-02-01,29,0,0,24,1,54
Algeria,2013-02-01,45,0,0,24,6,75
Algeria,2013-02-01,21,0,0,3,4,28
Algeria,2013-02-01,106,0,0,22,2,130
Algeria,2013-02-01,46,0,0,0,3,49
Algeria,2013-02-01,41,0,0,6,0,47
Algeria,2013-02-01,13,0,0,-6,8,15
Algeria,2013-02-01,35,0,0,6,5,46
Algeria,2013-02-01,18,0,-1,1,7,25
Algeria,2013-02-01,4,0,0,3,2,9
Algeria,2013-02-01,4,0,0,0,1,5
Algeria,2013-02-01,7,4,0,9,0,20
Algeria,2013-02-01,12,0,0,-2,4,14
Algeria,2013-02-01,25,0,0,3,0,28
Algeria,2013-02-01,399,2,-11,152,41,583
Algeria,2013-02-01,52,0,-2,9,0,59
Algeria,2013-02-01,19,0,0,0,0,19
Algeria,2013-02-01,10,0,0,0,0,10
Algeria,2013-02-01,5,0,0,3,0,8
Algeria,2013-02-01,39,0,0,12,0,51
Algeria,2013-02-01,32,0,0,6,3,41
Algeria,2013-02-01,23,0,0,3,8,34
Bangladesh,2013-02-01,27,0,0,6,9,42
Bangladesh,2013-02-01,-1,0,0,-2,0,-3
Bangladesh,2013-02-01,22,0,0,8,0,30
Bangladesh,2013-02-01,27,0,0,12,3,42
Bangladesh,2013-02-01,22,0,0,18,4,44
Bangladesh,2013-02-01,24,2,0,16,7,49
Bangladesh,2013-02-01,50,0,0,15,5,70
Bangladesh,2013-02-01,10,0,0,-5,6,11
Bangladesh,2013-02-01,0,0,0,3,0,3
Bangladesh,2013-02-01,41,0,0,4,7,52
Bangladesh,2013-02-01,27,0,0,15,10,52
Bangladesh,2013-02-01,18,0,-4,9,2,25
Bangladesh,2013-02-01,26,0,0,19,13,58
Bangladesh,2013-02-01,19,0,1,6,5,31
Bangladesh,2013-02-01,20,0,2,33,6,61
Bangladesh,2013-02-01,0,0,0,0,0,0
Bangladesh,2013-02-01,27,0,0,36,8,71
Bangladesh,2013-02-01,42,2,3,30,15,92
Bangladesh,2013-02-01,16,0,0,9,8,33
Bangladesh,2013-02-01,30,0,1,7,6,44
Bangladesh,2013-02-01,30,0,0,6,0,36
Bangladesh,2013-02-01,35,0,0,12,14,61
Bangladesh,2013-02-01,45,4,1,13,8,71
Bangladesh,2013-02-01,5,0,1,9,4,19
Bangladesh,2013-02-01,27,0,0,3,5,35
Bangladesh,2013-02-01,11,0,0,9,4,24
Bangladesh,2013-02-01,25,0,-2,16,3,42
Bangladesh,2013-02-01,108,0,0,83,14,205
Cameroon,2013-02-01,-1,0,0,3,0,2
Cameroon,2013-02-01,0,0,0,12,0,12
Cameroon,2013-02-01,0,0,0,12,0,12
Cameroon,2013-02-01,0,0,0,3,0,3
Cameroon,2013-02-01,0,0,0,0,0,0
Cameroon,2013-02-01,8,0,0,0,0,8
Cameroon,2013-02-01,8,0,0,0,0,8
Cameroon,2013-02-01,1,0,0,12,0,13
Cameroon,2013-02-01,0,2,0,3,0,5
Cameroon,2013-02-01,0,0,0,0,0,0
Cameroon,2013-02-01,1,2,0,0,1,4
Cameroon,2013-02-01,0,0,0,0,1,1
Cameroon,2013-02-01,0,0,0,6,0,6
Cameroon,2013-02-01,0,0,0,0,0,0
Cameroon,2013-02-01,0,0,0,24,0,24
Cameroon,2013-02-01,0,0,0,6,0,6
Cameroon,2013-02-01,0,0,0,6,0,6
Cameroon,2013-02-01,8,0,-4,48,0,52
Cameroon,2013-02-01,4,0,-2,18,0,20
Cameroon,2013-02-01,26,0,0,9,4,39
Cameroon,2013-02-01,4,0,-4,9,0,9
Cameroon,2013-02-01,3,0,0,15,0,18
Cameroon,2013-02-01,0,0,0,3,0,3
Cameroon,2013-02-01,1,0,0,4,0,5
Cameroon,2013-02-01,6,0,0,18,0,24
Cameroon,2013-02-01,0,0,0,0,0,0
Cameroon,2013-02-01,3,0,0,9,0,12
China,2013-02-01,87,2,-6,68,15,166
China,2013-02-01,86,2,3,33,7,131
China,2013-02-01,61,0,-12,13,15,77
China,2013-02-01,151,6,0,72,18,247
China,2013-02-01,86,2,-11,42,15,134
China,2013-02-01,185,2,-4,65,15,263
China,2013-02-01,167,0,-13,62,13,229
China,2013-02-01,68,2,1,53,23,147
China,2013-02-01,43,0,2,13,13,71
China,2013-02-01,102,2,-1,53,7,163
China,2013-02-01,74,0,-10,24,10,98
China,2013-02-01,105,4,3,62,20,194
China,2013-02-01,134,0,0,23,43,200
China,2013-02-01,158,4,-3,25,32,216
China,2013-02-01,103,6,-5,7,12,123
China,2013-02-01,24,0,-2,2,6,30
China,2013-02-01,116,0,-3,57,17,187
China,2013-02-01,181,12,0,31,13,237
China,2013-02-01,176,4,-1,41,10,230
China,2013-02-01,225,2,-7,89,27,336
China,2013-02-01,181,6,-2,100,26,311
China,2013-02-01,85,2,1,76,23,187
China,2013-02-01,74,0,0,72,11,157
China,2013-02-01,98,0,0,28,15,141
China,2013-02-01,50,2,0,15,8,75
China,2013-02-01,120,10,-6,37,21,182
China,2013-02-01,158,6,-1,68,30,261
China,2013-02-01,170,6,-2,18,16,208
Egypt,2013-02-01,100,0,-1,77,59,235
Egypt,2013-02-01,41,0,-2,31,7,77
Egypt,2013-02-01,56,0,-8,30,23,101
Egypt,2013-02-01,115,0,-10,90,31,226
Egypt,2013-02-01,101,0,-18,56,10,149
Egypt,2013-02-01,115,0,-3,26,20,158
Egypt,2013-02-01,638,4,-5,291,123,1051
Egypt,2013-02-01,101,0,0,24,23,148
Egypt,2013-02-01,20,0,0,28,9,57
Egypt,2013-02-01,76,0,1,40,4,121
Egypt,2013-02-01,81,4,-12,50,24,147
Egypt,2013-02-01,56,0,1,35,27,119
Egypt,2013-02-01,68,0,-4,45,25,134
Egypt,2013-02-01,79,0,-1,29,15,122
Egypt,2013-02-01,56,0,-4,21,6,79
Egypt,2013-02-01,12,0,0,15,7,34
Egypt,2013-02-01,28,0,0,22,11,61
Egypt,2013-02-01,51,2,-4,15,11,75
Egypt,2013-02-01,71,0,-5,37,19,122
Egypt,2013-02-01,51,0,1,49,18,119
Egypt,2013-02-01,68,0,4,29,18,119
Egypt,2013-02-01,65,0,6,9,16,96
Egypt,2013-02-01,72,0,-7,29,35,129
Egypt,2013-02-01,39,4,5,28,23,99
Egypt,2013-02-01,32,0,7,25,28,92
Egypt,2013-02-01,96,0,-38,42,27,127
Egypt,2013-02-01,96,0,-11,6,19,110
Egypt,2013-02-01,31,0,-3,54,10,92
Eritrea,2013-02-01,5,0,0,5,1,11
Eritrea,2013-02-01,0,0,0,3,0,3
Eritrea,2013-02-01,0,0,0,0,0,0
Eritrea,2013-02-01,0,0,0,3,0,3
Eritrea,2013-02-01,4,0,0,0,0,4
Eritrea,2013-02-01,1,0,0,0,0,1
Eritrea,2013-02-01,3,0,0,9,0,12
Eritrea,2013-02-01,0,0,0,0,0,0
Eritrea,2013-02-01,3,0,0,0,0,3
Eritrea,2013-02-01,3,0,0,4,0,7
Eritrea,2013-02-01,3,0,0,6,0,9
Eritrea,2013-02-01,0,0,0,0,0,0
Eritrea,2013-02-01,0,0,0,0,0,0
Eritrea,2013-02-01,2,0,0,0,0,2
Eritrea,2013-02-01,2,0,0,3,0,5
Eritrea,2013-02-01,0,0,0,0,0,0
Eritrea,2013-02-01,0,0,0,0,0,0
Eritrea,2013-02-01,1,0,0,0,0,1
Eritrea,2013-02-01,0,0,0,0,0,0
Eritrea,2013-02-01,5,0,0,0,0,5
Eritrea,2013-02-01,3,0,0,0,0,3
Georgia,2013-02-01,3,0,0,0,0,3
Georgia,2013-02-01,7,0,0,0,0,7
Georgia,2013-02-01,0,0,0,6,0,6
Georgia,2013-02-01,0,0,0,9,0,9
Georgia,2013-02-01,4,0,0,0,0,4
Georgia,2013-02-01,5,0,-2,12,0,15
Georgia,2013-02-01,2,0,0,3,0,5
Georgia,2013-02-01,5,0,0,0,0,5
Georgia,2013-02-01,3,0,0,0,0,3
Georgia,2013-02-01,0,0,0,-2,0,-2
Georgia,2013-02-01,1,0,0,0,0,1
Georgia,2013-02-01,0,0,0,0,1,1
Georgia,2013-02-01,0,0,0,15,0,15
Georgia,2013-02-01,3,0,0,15,2,20
Georgia,2013-02-01,0,0,0,15,0,15
Georgia,2013-02-01,0,0,0,6,0,6
Georgia,2013-02-01,-2,0,0,0,0,-2
Georgia,2013-02-01,-2,0,0,0,2,0
Georgia,2013-02-01,6,0,0,3,1,10
Georgia,2013-02-01,-2,0,0,0,1,-1
Georgia,2013-02-01,3,0,0,15,0,18
Georgia,2013-02-01,8,0,0,0,0,8
Georgia,2013-02-01,1,0,0,0,0,1
Georgia,2013-02-01,16,0,0,0,0,16
Georgia,2013-02-01,10,0,0,6,0,16
Georgia,2013-02-01,0,0,0,-6,0,-6
Georgia,2013-02-01,11,0,0,0,0,11
India,2013-02-01,31,0,-4,14,8,49
India,2013-02-01,58,0,1,12,28,99
India,2013-02-01,68,0,0,2,11,81
India,2013-02-01,53,0,0,19,11,83
India,2013-02-01,65,4,-6,34,25,122
India,2013-02-01,70,0,-9,-2,24,83
India,2013-02-01,37,0,-5,44,8,84
India,2013-02-01,71,0,-5,19,12,97
India,2013-02-01,42,0,-2,28,6,74
India,2013-02-01,79,0,-3,15,10,101
India,2013-02-01,67,2,1,17,9,96
India,2013-02-01,80,2,-6,94,18,188
India,2013-02-01,80,0,1,44,46,171
India,2013-02-01,82,0,-4,14,29,121
India,2013-02-01,123,0,-5,26,15,159
India,2013-02-01,13,0,1,8,0,22
India,2013-02-01,33,2,-4,26,5,62
India,2013-02-01,63,2,0,2,13,80
India,2013-02-01,97,0,-3,26,22,142
India,2013-02-01,64,4,1,34,19,122
India,2013-02-01,54,2,2,8,13,79
India,2013-02-01,45,0,0,3,14,62
India,2013-02-01,44,0,-3,4,8,53
India,2013-02-01,60,0,-1,-2,4,61
India,2013-02-01,30,0,0,15,6,51
India,2013-02-01,41,2,2,24,7,76
India,2013-02-01,68,0,-2,28,9,103
India,2013-02-01,67,0,0,31,9,107
Iran,2013-02-01,193,0,-6,33,40,260
Iran,2013-02-01,120,0,2,14,10,146
Iran,2013-02-01,95,0,0,3,13,111
Iran,2013-02-01,195,0,5,34,26,260
Iran,2013-02-01,213,0,-6,71,34,312
Iran,2013-02-01,195,10,-1,-7,14,211
Iran,2013-02-01,162,0,-10,42,6,200
Iran,2013-02-01,96,2,-4,13,26,133
Iran,2013-02-01,165,0,0,30,4,199
Iran,2013-02-01,89,0,4,29,1,123
Iran,2013-02-01,57,0,-10,41,13,101
Iran,2013-02-01,146,4,-5,58,16,219
Iran,2013-02-01,168,0,1,11,4,184
Iran,2013-02-01,180,0,2,18,7,207
Iran,2013-02-01,84,0,2,45,7,138
Iran,2013-02-01,23,0,0,0,0,23
Iran,2013-02-01,113,0,-4,58,19,186
Iran,2013-02-01,48,0,-1,18,8,73
Iran,2013-02-01,58,0,0,60,7,125
Iran,2013-02-01,50,2,-3,64,7,120
Iran,2013-02-01,78,0,2,27,7,114
Iran,2013-02-01,124,0,-1,32,0,155
Iran,2013-02-01,67,2,2,32,2,105
Iran,2013-02-01,78,0,0,18,0,96
Iran,2013-02-01,24,0,1,55,6,86
Iran,2013-02-01,153,0,-1,60,19,231
Iran,2013-02-01,135,0,-4,18,11,160
Iran,2013-02-01,764,8,-24,339,101,1188
Iraq,2013-02-01,118,0,1,29,7,155
Iraq,2013-02-01,42,2,0,16,7,67
Iraq,2013-02-01,135,0,0,16,9,160
Iraq,2013-02-01,249,0,6,71,12,338
Iraq,2013-02-01,150,2,0,53,0,205
Iraq,2013-02-01,82,0,-2,39,8,127
Iraq,2013-02-01,158,0,2,38,25,223
Iraq,2013-02-01,155,0,0,4,21,180
Iraq,2013-02-01,98,0,3,8,11,120
Iraq,2013-02-01,79,0,0,-9,2,72
Iraq,2013-02-01,138,0,0,28,6,172
Iraq,2013-02-01,131,0,1,29,10,171
Iraq,2013-02-01,96,2,0,29,4,131
Iraq,2013-02-01,89,0,0,24,3,116
Iraq,2013-02-01,56,2,4,10,7,79
Iraq,2013-02-01,6,0,2,0,11,19
Iraq,2013-02-01,72,0,3,16,1,92
Iraq,2013-02-01,116,0,6,7,3,132
Iraq,2013-02-01,39,0,0,35,11,85
Iraq,2013-02-01,33,0,2,9,10,54
Iraq,2013-02-01,62,4,2,7,17,92
Iraq,2013-02-01,34,0,2,14,8,58
Iraq,2013-02-01,21,0,3,7,5,36
Iraq,2013-02-01,37,0,2,4,6,49
Iraq,2013-02-01,32,0,0,1,2,35
Iraq,2013-02-01,92,0,1,37,22,152
Iraq,2013-02-01,179,0,-6,22,21,216
Iraq,2013-02-01,180,0,0,63,15,258
Morocco,2013-02-01,2,0,-1,6,0,7
Morocco,2013-02-01,0,0,0,0,0,0
Morocco,2013-02-01,6,0,0,0,0,6
Morocco,2013-02-01,0,0,0,6,0,6
Morocco,2013-02-01,8,0,0,9,2,19
Morocco,2013-02-01,13,0,0,0,4,17
Morocco,2013-02-01,2,0,0,3,0,5
Morocco,2013-02-01,24,0,0,18,0,42
Morocco,2013-02-01,3,0,0,0,0,3
Morocco,2013-02-01,0,0,0,0,0,0
Morocco,2013-02-01,5,0,0,9,0,14
Morocco,2013-02-01,12,0,0,0,0,12
Morocco,2013-02-01,0,0,0,0,0,0
Morocco,2013-02-01,0,0,0,-1,1,0
Morocco,2013-02-01,0,0,0,0,0,0
Morocco,2013-02-01,1,0,-4,21,0,18
Morocco,2013-02-01,-1,0,0,9,5,13
Morocco,2013-02-01,8,0,0,0,0,8
Morocco,2013-02-01,11,0,0,0,15,26
Morocco,2013-02-01,461,0,-18,201,47,691
Morocco,2013-02-01,12,0,0,6,0,18
Morocco,2013-02-01,6,0,0,33,0,39
Morocco,2013-02-01,10,0,0,4,1,15
Morocco,2013-02-01,9,0,0,0,0,9
Morocco,2013-02-01,9,0,0,0,0,9
Morocco,2013-02-01,2,0,0,1,0,3
Morocco,2013-02-01,10,0,0,24,4,38
Nigeria,2013-02-01,10,2,0,17,7,36
Nigeria,2013-02-01,13,0,0,3,1,17
Nigeria,2013-02-01,14,0,0,6,2,22
Nigeria,2013-02-01,38,4,0,4,1,47
Nigeria,2013-02-01,7,2,0,7,1,17
Nigeria,2013-02-01,24,2,0,-20,3,9
Nigeria,2013-02-01,21,2,1,12,2,38
Nigeria,2013-02-01,34,0,0,16,0,50
Nigeria,2013-02-01,9,0,0,-3,3,9
Nigeria,2013-02-01,36,0,5,-1,3,43
Nigeria,2013-02-01,21,0,-2,5,5,29
Nigeria,2013-02-01,47,0,-6,10,3,54
Nigeria,2013-02-01,43,2,0,19,3,67
Nigeria,2013-02-01,16,0,1,24,5,46
Nigeria,2013-02-01,39,0,0,15,1,55
Nigeria,2013-02-01,5,0,0,3,0,8
Nigeria,2013-02-01,32,0,1,37,1,71
Nigeria,2013-02-01,55,0,-6,46,4,99
Nigeria,2013-02-01,63,0,-1,104,5,171
Nigeria,2013-02-01,23,4,-3,82,5,111
Nigeria,2013-02-01,50,0,-4,11,4,61
Nigeria,2013-02-01,32,0,4,18,0,54
Nigeria,2013-02-01,29,0,-4,30,5,60
Nigeria,2013-02-01,14,0,-2,12,0,24
Nigeria,2013-02-01,18,0,0,2,0,20
Nigeria,2013-02-01,58,0,0,3,4,65
Nigeria,2013-02-01,18,0,-4,10,0,24
Nigeria,2013-02-01,39,0,-1,1,1,40
Pakistan,2013-02-01,88,0,-3,19,19,123
Pakistan,2013-02-01,120,0,0,9,10,139
Pakistan,2013-02-01,54,0,0,-3,5,56
Pakistan,2013-02-01,118,4,1,4,4,131
Pakistan,2013-02-01,163,2,-2,94,27,284
Pakistan,2013-02-01,88,0,0,29,10,127
Pakistan,2013-02-01,143,0,3,54,9,209
Pakistan,2013-02-01,151,0,-1,11,14,175
Pakistan,2013-02-01,86,0,0,52,3,141
Pakistan,2013-02-01,76,0,0,24,12,112
Pakistan,2013-02-01,92,0,-2,27,4,121
Pakistan,2013-02-01,84,0,-2,26,10,118
Pakistan,2013-02-01,108,0,-1,21,9,137
Pakistan,2013-02-01,112,0,1,44,13,170
Pakistan,2013-02-01,124,0,-1,13,17,153
Pakistan,2013-02-01,17,0,0,10,2,29
Pakistan,2013-02-01,55,0,-1,69,7,130
Pakistan,2013-02-01,96,0,0,39,10,145
Pakistan,2013-02-01,131,0,-8,97,31,251
Pakistan,2013-02-01,64,0,0,67,22,153
Pakistan,2013-02-01,94,2,0,29,17,142
Pakistan,2013-02-01,80,2,0,56,16,154
Pakistan,2013-02-01,42,2,0,47,17,108
Pakistan,2013-02-01,44,0,1,46,10,101
Pakistan,2013-02-01,42,0,0,12,0,54
Pakistan,2013-02-01,89,0,1,9,3,102
Pakistan,2013-02-01,89,0,1,56,8,154
Pakistan,2013-02-01,141,0,0,197,42,380
Sierra Leone,2013-02-01,0,0,0,0,0,0
Sierra Leone,2013-02-01,0,0,0,0,0,0
Sierra Leone,2013-02-01,0,0,0,0,0,0
Sierra Leone,2013-02-01,5,0,0,12,0,17
Sierra Leone,2013-02-01,0,0,0,12,0,12
Sierra Leone,2013-02-01,0,0,0,0,0,0
Sierra Leone,2013-02-01,3,0,0,0,0,3
Sierra Leone,2013-02-01,0,0,0,0,0,0
Sierra Leone,2013-02-01,0,0,0,6,0,6
Sierra Leone,2013-02-01,0,0,0,0,0,0
Sierra Leone,2013-02-01,0,0,0,0,0,0
Sierra Leone,2013-02-01,0,0,0,3,0,3
Sierra Leone,2013-02-01,9,0,0,18,6,33
Sierra Leone,2013-02-01,1,0,0,6,1,8
Sierra Leone,2013-02-01,0,0,0,3,0,3
Sierra Leone,2013-02-01,0,0,0,0,0,0
Sierra Leone,2013-02-01,0,0,0,3,0,3
Sierra Leone,2013-02-01,5,0,-2,3,0,6
Sierra Leone,2013-02-01,1,0,0,0,0,1
Sierra Leone,2013-02-01,0,0,0,0,0,0
Sierra Leone,2013-02-01,0,0,0,0,0,0
Sierra Leone,2013-02-01,0,0,0,0,0,0
Sierra Leone,2013-02-01,0,0,0,0,0,0
Sierra Leone,2013-02-01,9,0,0,3,0,12
Sierra Leone,2013-02-01,0,0,0,0,2,2
Sierra Leone,2013-02-01,2,0,0,0,0,2
Somalia,2013-02-01,68,0,2,7,9,86
Somalia,2013-02-01,69,0,0,10,1,80
Somalia,2013-02-01,41,0,-4,0,0,37
Somalia,2013-02-01,55,0,0,28,6,89
Somalia,2013-02-01,64,2,0,38,23,127
Somalia,2013-02-01,29,0,1,-1,1,30
Somalia,2013-02-01,48,6,0,21,8,83
Somalia,2013-02-01,47,0,0,2,6,55
Somalia,2013-02-01,22,0,0,9,1,32
Somalia,2013-02-01,19,0,0,6,1,26
Somalia,2013-02-01,13,0,1,0,0,14
Somalia,2013-02-01,11,0,0,0,2,13
Somalia,2013-02-01,7,0,0,3,0,10
Somalia,2013-02-01,18,0,-1,3,0,20
Somalia,2013-02-01,24,0,0,8,0,32
Somalia,2013-02-01,2,0,0,-8,0,-6
Somalia,2013-02-01,20,0,0,6,3,29
Somalia,2013-02-01,7,0,2,-3,0,6
Somalia,2013-02-01,6,0,0,4,0,10
Somalia,2013-02-01,7,0,0,22,0,29
Somalia,2013-02-01,87,0,0,15,1,103
Somalia,2013-02-01,29,2,-3,12,2,42
Somalia,2013-02-01,37,2,-2,48,3,88
Somalia,2013-02-01,6,0,0,15,0,21
Somalia,2013-02-01,0,0,0,6,2,8
Somalia,2013-02-01,0,0,0,5,3,8
Somalia,2013-02-01,40,0,0,20,2,62
Somalia,2013-02-01,27,0,-6,7,2,30
Syria,2013-02-01,405,2,-30,64,88,529
Syria,2013-02-01,192,0,-15,-4,27,200
Syria,2013-02-01,153,0,-5,-14,38,172
Syria,2013-02-01,207,0,-4,63,29,295
Syria,2013-02-01,332,0,-14,38,37,393
Syria,2013-02-01,239,2,-5,70,33,339
Syria,2013-02-01,377,4,-10,74,50,495
Syria,2013-02-01,162,4,-12,10,15,179
Syria,2013-02-01,79,0,0,30,5,114
Syria,2013-02-01,90,0,-2,15,16,119
Syria,2013-02-01,147,0,-8,-2,39,176
Syria,2013-02-01,183,0,-11,49,27,248
Syria,2013-02-01,202,0,-6,21,9,226
Syria,2013-02-01,242,0,-7,27,17,279
Syria,2013-02-01,240,2,0,53,9,304
Syria,2013-02-01,84,0,0,9,5,98
Syria,2013-02-01,247,0,-3,21,37,302
Syria,2013-02-01,203,2,6,67,41,319
Syria,2013-02-01,191,0,4,42,24,261
Syria,2013-02-01,154,0,0,106,19,279
Syria,2013-02-01,151,0,-6,63,19,227
Syria,2013-02-01,85,0,-6,9,21,109
Syria,2013-02-01,78,0,0,9,3,90
Syria,2013-02-01,165,0,-8,30,15,202
Syria,2013-02-01,137,0,-10,10,15,152
Syria,2013-02-01,187,0,2,19,10,218
Syria,2013-02-01,288,12,-2,4,30,332
Syria,2013-02-01,367,6,-24,15,63,427
Yemen,2013-02-01,47,0,0,3,4,54
Yemen,2013-02-01,25,0,1,9,0,35
Yemen,2013-02-01,8,0,1,6,3,18
Yemen,2013-02-01,39,0,0,24,4,67
Yemen,2013-02-01,79,0,2,58,0,139
Yemen,2013-02-01,95,0,0,43,1,139
Yemen,2013-02-01,92,0,-4,13,2,103
Yemen,2013-02-01,110,0,0,19,5,134
Yemen,2013-02-01,33,0,0,3,4,40
Yemen,2013-02-01,18,0,0,13,5,36
Yemen,2013-02-01,28,0,0,8,1,37
Yemen,2013-02-01,26,0,0,5,0,31
Yemen,2013-02-01,16,0,0,4,2,22
Yemen,2013-02-01,35,0,2,6,6,49
Yemen,2013-02-01,16,0,-1,-4,0,11
Yemen,2013-02-01,2,0,0,0,0,2
Yemen,2013-02-01,30,0,0,6,7,43
Yemen,2013-02-01,18,0,0,-4,1,15
Yemen,2013-02-01,5,0,-2,6,0,9
Yemen,2013-02-01,14,0,0,21,2,37
Yemen,2013-02-01,111,0,0,22,4,137
Yemen,2013-02-01,72,0,0,1,4,77
Yemen,2013-02-01,64,0,0,11,16,91
Yemen,2013-02-01,20,0,0,18,10,48
Yemen,2013-02-01,7,0,0,0,0,7
Yemen,2013-02-01,18,0,0,6,0,24
Yemen,2013-02-01,6,0,0,-3,0,3
Yemen,2013-02-01,10,2,0,2,1,15
Afghanistan,2011-01-01,144,2,1,60,17,224
Afghanistan,2011-01-01,252,0,0,8,8,268
Afghanistan,2011-01-01,220,0,-2,15,13,246
Afghanistan,2011-01-01,172,0,-5,65,36,268
Afghanistan,2011-01-01,150,0,-2,97,29,274
Afghanistan,2011-01-01,192,4,-2,64,25,283
Afghanistan,2011-01-01,323,6,0,97,36,462
Afghanistan,2011-01-01,130,0,0,72,22,224
Afghanistan,2011-01-01,119,6,-1,29,6,159
Afghanistan,2011-01-01,174,0,-9,26,11,202
Afghanistan,2011-01-01,186,0,-1,48,20,253
Afghanistan,2011-01-01,238,0,-6,30,40,302
Afghanistan,2011-01-01,226,4,0,55,22,307
Afghanistan,2011-01-01,689,8,-10,208,52,947
Afghanistan,2011-01-01,415,8,1,92,75,591
Afghanistan,2011-01-01,191,4,0,32,21,248
Afghanistan,2011-01-01,165,8,0,61,7,241
Afghanistan,2011-01-01,189,6,0,34,26,255
Afghanistan,2011-01-01,85,2,0,-2,28,113
Afghanistan,2011-01-01,23,0,3,12,2,40
Afghanistan,2011-01-01,54,0,0,-2,5,57
Afghanistan,2011-01-01,221,0,-3,73,15,306
Afghanistan,2011-01-01,282,4,1,83,9,379
Afghanistan,2011-01-01,207,2,0,53,16,278
Afghanistan,2011-01-01,190,4,0,51,45,290
Afghanistan,2011-01-01,171,10,7,26,18,232
Afghanistan,2011-01-01,195,0,0,45,28,268
Afghanistan,2011-01-01,174,0,1,36,24,235
Afghanistan,2011-01-01,191,8,0,14,48,261
Afghanistan,2011-01-01,78,2,-1,9,25,113
Afghanistan,2011-01-01,153,0,6,43,4,206
Albania,2011-01-01,1,0,0,3,0,4
Albania,2011-01-01,3,0,0,0,0,3
Albania,2011-01-01,2,0,0,6,0,8
Albania,2011-01-01,10,0,0,12,0,22
Albania,2011-01-01,3,0,-1,-1,0,1
Albania,2011-01-01,5,0,-1,3,0,7
Albania,2011-01-01,0,0,0,0,0,0
Albania,2011-01-01,3,0,0,4,1,8
Albania,2011-01-01,2,0,0,6,0,8
Albania,2011-01-01,3,0,-1,9,0,11
Albania,2011-01-01,5,0,0,33,0,38
Albania,2011-01-01,6,0,0,3,1,10
Albania,2011-01-01,2,0,0,27,0,29
Albania,2011-01-01,4,0,-11,1,2,-4
Albania,2011-01-01,0,0,-6,3,0,-3
Albania,2011-01-01,0,0,0,0,1,1
Albania,2011-01-01,8,0,-6,4,0,6
Albania,2011-01-01,8,0,-2,18,0,24
Albania,2011-01-01,0,0,0,0,0,0
Albania,2011-01-01,0,0,0,0,0,0
Albania,2011-01-01,6,0,0,3,1,10
Albania,2011-01-01,24,0,-3,21,13,55
Albania,2011-01-01,24,0,0,3,4,31
Albania,2011-01-01,8,0,0,0,0,8
Albania,2011-01-01,11,2,2,8,2,25
Albania,2011-01-01,22,0,-3,3,-6,16
Albania,2011-01-01,6,0,1,3,0,10
Albania,2011-01-01,2,0,2,9,4,17
Albania,2011-01-01,0,0,0,0,0,0
Albania,2011-01-01,6,0,0,0,0,6
Albania,2011-01-01,11,0,1,6,4,22
Algeria,2011-01-01,2,0,0,0,1,3
Algeria,2011-01-01,4,0,0,0,0,4
Algeria,2011-01-01,4,0,0,21,0,25
Algeria,2011-01-01,11,0,0,18,0,29
Algeria,2011-01-01,23,0,0,18,4,45
Algeria,2011-01-01,14,0,0,7,2,23
Algeria,2011-01-01,103,6,2,59,27,197
Algeria,2011-01-01,303,0,-4,64,40,403
Algeria,2011-01-01,215,0,2,45,21,283
Algeria,2011-01-01,68,0,-2,18,12,96
Algeria,2011-01-01,54,0,0,2,5,61
Algeria,2011-01-01,20,0,0,-6,7,21
Algeria,2011-01-01,30,0,0,1,13,44
Algeria,2011-01-01,43,0,-2,10,25,76
Algeria,2011-01-01,2,0,0,9,4,15
Algeria,2011-01-01,10,0,3,6,17,36
Algeria,2011-01-01,55,0,1,5,39,100
Algeria,2011-01-01,35,0,0,33,38,106
Algeria,2011-01-01,2,4,0,21,28,55
Algeria,2011-01-01,0,0,0,0,0,0
Algeria,2011-01-01,2,0,0,10,1,13
Algeria,2011-01-01,14,0,1,55,38,108
Algeria,2011-01-01,23,0,0,0,8,31
Algeria,2011-01-01,3,0,0,4,10,17
Algeria,2011-01-01,14,0,0,19,14,47
Algeria,2011-01-01,26,0,-1,-11,26,40
Algeria,2011-01-01,10,0,-2,6,37,51
Algeria,2011-01-01,18,0,-3,0,15,30
Algeria,2011-01-01,63,0,-6,11,11,79
Algeria,2011-01-01,19,0,0,11,13,43
Algeria,2011-01-01,27,0,-4,3,7,33
Bangladesh,2011-01-01,7,0,0,47,3,57
Bangladesh,2011-01-01,27,0,0,4,1,32
Bangladesh,2011-01-01,7,0,0,4,2,13
Bangladesh,2011-01-01,41,2,0,3,4,50
Bangladesh,2011-01-01,48,0,0,4,4,56
Bangladesh,2011-01-01,25,0,0,4,0,29
Bangladesh,2011-01-01,8,0,0,1,0,9
Bangladesh,2011-01-01,14,0,0,3,0,17
Bangladesh,2011-01-01,12,0,0,15,1,28
Bangladesh,2011-01-01,10,0,-1,5,0,14
Bangladesh,2011-01-01,20,0,0,3,1,24
Bangladesh,2011-01-01,13,0,0,6,3,22
Bangladesh,2011-01-01,17,0,0,12,2,31
Bangladesh,2011-01-01,22,0,0,4,0,26
Bangladesh,2011-01-01,5,0,0,3,0,8
Bangladesh,2011-01-01,8,0,1,2,6,17
Bangladesh,2011-01-01,8,2,0,12,3,25
Bangladesh,2011-01-01,21,0,0,20,3,44
Bangladesh,2011-01-01,4,0,0,6,1,11
Bangladesh,2011-01-01,0,0,0,0,0,0
Bangladesh,2011-01-01,6,0,0,6,6,18
Bangladesh,2011-01-01,6,2,-8,-9,8,-1
Bangladesh,2011-01-01,0,0,-1,3,2,4
Bangladesh,2011-01-01,18,0,0,21,4,43
Bangladesh,2011-01-01,9,0,0,15,5,29
Bangladesh,2011-01-01,14,0,0,5,4,23
Bangladesh,2011-01-01,18,0,0,19,1,38
Bangladesh,2011-01-01,24,0,0,6,4,34
Bangladesh,2011-01-01,10,0,0,-4,3,9
Bangladesh,2011-01-01,5,0,0,-4,2,3
Bangladesh,2011-01-01,10,0,-4,4,2,12
Cameroon,2011-01-01,0,0,1,0,0,1
Cameroon,2011-01-01,0,0,1,0,0,1
Cameroon,2011-01-01,1,0,0,0,0,1
Cameroon,2011-01-01,1,0,0,0,0,1
Cameroon,2011-01-01,-2,0,0,0,0,-2
Cameroon,2011-01-01,0,0,0,0,0,0
Cameroon,2011-01-01,0,0,0,0,0,0
Cameroon,2011-01-01,0,0,0,0,0,0
Cameroon,2011-01-01,6,0,0,0,0,6
Cameroon,2011-01-01,0,0,0,0,0,0
Cameroon,2011-01-01,0,0,0,0,0,0
Cameroon,2011-01-01,1,0,0,0,0,1
Cameroon,2011-01-01,-2,0,0,0,0,-2
Cameroon,2011-01-01,0,0,0,-2,0,-2
Cameroon,2011-01-01,0,0,0,0,0,0
Cameroon,2011-01-01,1,0,0,0,1,2
Cameroon,2011-01-01,0,0,0,-7,1,-6
Cameroon,2011-01-01,6,0,0,3,0,9
Cameroon,2011-01-01,1,0,-2,0,0,-1
Cameroon,2011-01-01,22,0,0,0,0,22
Cameroon,2011-01-01,6,0,0,6,0,12
Cameroon,2011-01-01,2,0,0,3,0,5
Cameroon,2011-01-01,1,0,0,3,0,4
Cameroon,2011-01-01,2,0,0,0,0,2
Cameroon,2011-01-01,0,0,0,0,0,0
Cameroon,2011-01-01,0,0,0,0,0,0
Cameroon,2011-01-01,0,0,0,6,0,6
Cameroon,2011-01-01,1,0,0,0,0,1
China,2011-01-01,44,0,-3,10,10,61
China,2011-01-01,90,2,-3,27,3,119
China,2011-01-01,54,0,-5,17,13,79
China,2011-01-01,129,2,-1,51,7,188
China,2011-01-01,182,0,1,45,15,243
China,2011-01-01,91,8,-6,62,12,167
China,2011-01-01,127,8,0,25,7,167
China,2011-01-01,182,0,0,44,11,237
China,2011-01-01,115,0,-1,41,24,179
China,2011-01-01,115,4,-2,73,15,205
China,2011-01-01,164,0,-1,63,13,239
China,2011-01-01,161,2,-5,65,31,254
China,2011-01-01,159,2,-4,103,19,279
China,2011-01-01,227,6,-1,86,12,330
China,2011-01-01,67,0,-2,15,4,84
China,2011-01-01,134,6,1,127,29,297
China,2011-01-01,52,2,-5,-4,8,53
China,2011-01-01,163,0,-2,14,24,199
China,2011-01-01,96,0,0,-9,12,99
China,2011-01-01,3,0,0,15,0,18
China,2011-01-01,6,0,0,-4,0,2
China,2011-01-01,128,4,3,45,17,197
China,2011-01-01,129,0,-1,57,23,208
China,2011-01-01,135,2,-2,98,19,252
China,2011-01-01,189,4,-7,143,28,357
China,2011-01-01,204,10,0,142,25,381
China,2011-01-01,197,0,-4,70,22,285
China,2011-01-01,165,0,-9,51,27,234
China,2011-01-01,121,2,1,48,8,180
China,2011-01-01,125,2,-3,52,25,201
China,2011-01-01,147,6,-3,75,11,236
Egypt,2011-01-01,107,0,0,18,17,142
Egypt,2011-01-01,111,0,0,13,12,136
Egypt,2011-01-01,84,0,0,-1,5,88
Egypt,2011-01-01,66,0,0,13,4,83
Egypt,2011-01-01,44,0,0,0,6,50
Egypt,2011-01-01,51,0,0,9,4,64
Egypt,2011-01-01,51,0,-2,38,3,90
Egypt,2011-01-01,24,0,-5,36,3,58
Egypt,2011-01-01,28,0,-4,25,1,50
Egypt,2011-01-01,71,0,0,-2,11,80
Egypt,2011-01-01,54,0,0,-5,1,50
Egypt,2011-01-01,54,0,-2,13,8,73
Egypt,2011-01-01,57,0,-2,6,3,64
Egypt,2011-01-01,56,0,-2,25,2,81
Egypt,2011-01-01,8,0,0,13,0,21
Egypt,2011-01-01,56,0,0,29,16,101
Egypt,2011-01-01,36,0,-3,15,79,127
Egypt,2011-01-01,49,0,-2,33,24,104
Egypt,2011-01-01,24,0,0,2,15,41
Egypt,2011-01-01,2,0,0,12,1,15
Egypt,2011-01-01,3,0,0,9,0,12
Egypt,2011-01-01,33,0,0,27,4,64
Egypt,2011-01-01,75,0,-6,21,26,116
Egypt,2011-01-01,79,0,1,41,11,132
Egypt,2011-01-01,37,0,-4,24,25,82
Egypt,2011-01-01,120,0,4,115,92,331
Egypt,2011-01-01,198,0,-15,73,111,367
Egypt,2011-01-01,488,4,-41,165,208,824
Egypt,2011-01-01,452,0,-40,158,201,771
Egypt,2011-01-01,413,0,-20,172,139,704
Egypt,2011-01-01,682,6,-32,368,204,1228
Eritrea,2011-01-01,0,0,0,0,0,0
Eritrea,2011-01-01,0,0,0,-2,0,-2
Eritrea,2011-01-01,11,0,0,-2,0,9
Eritrea,2011-01-01,1,0,0,0,0,1
Eritrea,2011-01-01,0,0,0,-2,1,-1
Eritrea,2011-01-01,0,0,0,0,0,0
Eritrea,2011-01-01,0,0,0,0,3,3
Eritrea,2011-01-01,2,0,2,0,0,4
Eritrea,2011-01-01,3,0,-1,2,0,4
Eritrea,2011-01-01,0,0,0,0,0,0
Eritrea,2011-01-01,7,2,0,3,0,12
Eritrea,2011-01-01,7,0,0,9,2,18
Eritrea,2011-01-01,6,0,0,12,0,18
Eritrea,2011-01-01,0,0,0,0,0,0
Eritrea,2011-01-01,1,0,0,-2,0,-1
Eritrea,2011-01-01,0,0,0,0,0,0
Eritrea,2011-01-01,6,0,0,9,4,19
Eritrea,2011-01-01,10,0,0,0,6,16
Eritrea,2011-01-01,8,0,0,0,0,8
Eritrea,2011-01-01,19,0,0,0,2,21
Eritrea,2011-01-01,0,0,0,0,0,0
Eritrea,2011-01-01,0,0,0,0,0,0
Eritrea,2011-01-01,3,0,0,0,0,3
Eritrea,2011-01-01,0,0,0,0,0,0
Eritrea,2011-01-01,3,0,0,3,0,6
Eritrea,2011-01-01,0,0,0,3,0,3
Georgia,2011-01-01,3,0,1,3,2,9
Georgia,2011-01-01,13,2,0,-1,3,17
Georgia,2011-01-01,19,2,0,27,0,48
Georgia,2011-01-01,19,4,-2,6,1,28
Georgia,2011-01-01,14,0,0,18,2,34
Georgia,2011-01-01,33,0,-2,18,6,55
Georgia,2011-01-01,30,0,0,5,2,37
Georgia,2011-01-01,29,0,-4,4,2,31
Georgia,2011-01-01,17,0,0,16,2,35
Georgia,2011-01-01,55,4,0,7,2,68
Georgia,2011-01-01,14,2,-2,35,2,51
Georgia,2011-01-01,5,0,0,14,0,19
Georgia,2011-01-01,38,0,2,12,3,55
Georgia,2011-01-01,25,0,0,19,5,49
Georgia,2011-01-01,3,0,0,4,4,11
Georgia,2011-01-01,10,0,-2,15,2,25
Georgia,2011-01-01,31,0,-2,8,4,41
Georgia,2011-01-01,38,0,0,34,5,77
Georgia,2011-01-01,11,2,0,4,0,17
Georgia,2011-01-01,0,0,0,0,0,0
Georgia,2011-01-01,0,0,0,0,0,0
Georgia,2011-01-01,37,0,1,10,5,53
Georgia,2011-01-01,17,0,0,9,1,27
Georgia,2011-01-01,33,0,0,17,8,58
Georgia,2011-01-01,51,0,-2,50,9,108
Georgia,2011-01-01,46,6,1,22,5,80
Georgia,2011-01-01,49,0,2,22,6,79
Georgia,2011-01-01,25,0,0,34,11,70
Georgia,2011-01-01,8,0,-6,7,2,11
Georgia,2011-01-01,15,0,2,5,0,22
Georgia,2011-01-01,21,0,0,7,2,30
India,2011-01-01,24,2,0,9,21,56
India,2011-01-01,51,0,-5,13,14,73
India,2011-01-01,61,0,1,17,2,81
India,2011-01-01,29,0,0,11,4,44
India,2011-01-01,12,0,0,2,1,15
India,2011-01-01,62,0,0,24,7,93
India,2011-01-01,71,0,0,26,15,112
India,2011-01-01,53,8,0,3,8,72
India,2011-01-01,47,0,-3,82,11,137
India,2011-01-01,52,0,-2,34,7,91
India,2011-01-01,36,0,-3,22,11,66
India,2011-01-01,49,0,1,24,11,85
India,2011-01-01,59,2,0,28,4,93
India,2011-01-01,38,0,0,-12,3,29
India,2011-01-01,41,0,-1,9,7,56
India,2011-01-01,38,0,-5,41,7,81
India,2011-01-01,41,0,1,11,16,69
India,2011-01-01,73,2,-6,13,18,100
India,2011-01-01,31,0,0,1,8,40
India,2011-01-01,10,0,0,3,0,13
India,2011-01-01,2,0,0,9,0,11
India,2011-01-01,68,0,0,15,12,95
India,2011-01-01,49,2,-1,-3,7,54
India,2011-01-01,79,0,4,29,5,117
India,2011-01-01,96,0,-3,39,4,136
India,2011-01-01,64,0,-1,16,11,90
India,2011-01-01,62,0,5,42,15,124
India,2011-01-01,54,4,2,3,4,67
India,2011-01-01,57,0,-2,38,13,106
India,2011-01-01,36,4,2,12,12,66
India,2011-01-01,65,0,2,22,4,93
Iran,2011-01-01,26,0,0,36,2,64
Iran,2011-01-01,63,2,0,35,2,102
Iran,2011-01-01,88,0,0,53,4,145
Iran,2011-01-01,51,0,-2,58,8,115
Iran,2011-01-01,127,0,1,45,23,196
Iran,2011-01-01,104,0,0,85,19,208
Iran,2011-01-01,91,0,4,75,16,186
Iran,2011-01-01,64,2,0,111,19,196
Iran,2011-01-01,67,0,0,99,7,173
Iran,2011-01-01,105,6,2,172,16,301
Iran,2011-01-01,100,2,1,110,3,216
Iran,2011-01-01,67,0,-51,22,7,45
Iran,2011-01-01,40,2,-11,63,10,104
Iran,2011-01-01,124,2,-4,53,9,184
Iran,2011-01-01,46,0,4,7,3,60
Iran,2011-01-01,293,1,-6,218,60,566
Iran,2011-01-01,136,2,-9,103,12,244
Iran,2011-01-01,128,0,0,14,13,155
Iran,2011-01-01,35,0,1,20,2,58
Iran,2011-01-01,21,0,1,0,5,27
Iran,2011-01-01,3,0,1,4,0,8
Iran,2011-01-01,109,0,-2,55,18,180
Iran,2011-01-01,119,0,0,17,28,164
Iran,2011-01-01,26,0,0,56,20,102
Iran,2011-01-01,65,4,-2,59,20,146
Iran,2011-01-01,52,6,2,47,7,114
Iran,2011-01-01,104,2,0,13,19,138
Iran,2011-01-01,85,0,-2,38,17,138
Iran,2011-01-01,78,2,-4,91,18,185
Iran,2011-01-01,32,0,-8,30,5,59
Iran,2011-01-01,93,0,-3,95,15,200
Iraq,2011-01-01,161,0,2,21,5,189
Iraq,2011-01-01,186,0,0,54,24,264
Iraq,2011-01-01,132,0,-2,27,24,181
Iraq,2011-01-01,146,0,0,16,7,169
Iraq,2011-01-01,143,0,0,37,9,189
Iraq,2011-01-01,92,0,-1,79,12,182
Iraq,2011-01-01,102,0,-2,10,10,120
Iraq,2011-01-01,134,0,-11,44,12,179
Iraq,2011-01-01,129,0,0,28,5,162
Iraq,2011-01-01,180,0,1,32,7,220
Iraq,2011-01-01,240,0,-3,41,13,291
Iraq,2011-01-01,108,0,1,4,15,128
Iraq,2011-01-01,85,0,4,35,4,128
Iraq,2011-01-01,50,0,0,80,10,140
Iraq,2011-01-01,86,0,0,23,7,116
Iraq,2011-01-01,139,0,1,12,24,176
Iraq,2011-01-01,117,0,1,44,9,171
Iraq,2011-01-01,155,0,-2,87,27,267
Iraq,2011-01-01,38,0,0,7,10,55
Iraq,2011-01-01,30,0,1,6,0,37
Iraq,2011-01-01,11,0,0,15,0,26
Iraq,2011-01-01,271,2,-19,151,48,453
Iraq,2011-01-01,92,0,-2,6,18,114
Iraq,2011-01-01,111,0,3,55,9,178
Iraq,2011-01-01,95,0,0,61,17,173
Iraq,2011-01-01,126,42,0,17,13,198
Iraq,2011-01-01,100,10,2,24,5,141
Iraq,2011-01-01,87,0,4,16,8,115
Iraq,2011-01-01,58,2,5,10,2,77
Iraq,2011-01-01,34,0,-1,5,14,52
Iraq,2011-01-01,97,2,0,57,9,165
Morocco,2011-01-01,3,0,0,6,1,10
Morocco,2011-01-01,-1,0,0,0,1,0
Morocco,2011-01-01,0,0,0,3,0,3
Morocco,2011-01-01,6,0,0,5,0,11
Morocco,2011-01-01,11,0,-2,6,1,16
Morocco,2011-01-01,6,0,0,4,8,18
Morocco,2011-01-01,2,0,-2,9,0,9
Morocco,2011-01-01,0,0,0,0,0,0
Morocco,2011-01-01,4,0,0,0,0,4
Morocco,2011-01-01,0,0,0,0,4,4
Morocco,2011-01-01,2,0,0,0,0,2
Morocco,2011-01-01,8,0,0,3,0,11
Morocco,2011-01-01,10,0,2,24,0,36
Morocco,2011-01-01,25,0,0,4,3,32
Morocco,2011-01-01,11,0,0,3,0,14
Morocco,2011-01-01,6,0,0,0,1,7
Morocco,2011-01-01,19,0,0,0,1,20
Morocco,2011-01-01,21,0,0,19,1,41
Morocco,2011-01-01,6,0,0,0,0,6
Morocco,2011-01-01,2,0,0,0,0,2
Morocco,2011-01-01,0,0,0,0,0,0
Morocco,2011-01-01,18,0,0,3,2,23
Morocco,2011-01-01,13,0,-1,0,7,19
Morocco,2011-01-01,22,0,-3,-5,1,15
Morocco,2011-01-01,24,0,0,30,4,58
Morocco,2011-01-01,2,0,0,6,11,19
Morocco,2011-01-01,10,0,-2,1,0,9
Morocco,2011-01-01,2,0,0,10,4,16
Morocco,2011-01-01,23,0,0,0,4,27
Morocco,2011-01-01,1,0,0,15,2,18
Morocco,2011-01-01,5,0,0,18,2,25
Nigeria,2011-01-01,58,0,-4,2,4,60
Nigeria,2011-01-01,15,0,0,5,6,26
Nigeria,2011-01-01,23,0,0,19,2,44
Nigeria,2011-01-01,48,2,-1,20,4,73
Nigeria,2011-01-01,47,2,-4,1,2,48
Nigeria,2011-01-01,51,0,-2,6,8,63
Nigeria,2011-01-01,52,2,1,31,5,91
Nigeria,2011-01-01,58,0,-2,13,14,83
Nigeria,2011-01-01,59,0,-2,35,12,104
Nigeria,2011-01-01,31,0,-4,9,3,39
Nigeria,2011-01-01,82,0,0,37,10,129
Nigeria,2011-01-01,53,0,0,10,2,65
Nigeria,2011-01-01,21,0,0,9,0,30
Nigeria,2011-01-01,32,0,-9,9,2,34
Nigeria,2011-01-01,16,0,0,6,2,24
Nigeria,2011-01-01,29,4,0,1,0,34
Nigeria,2011-01-01,38,0,1,34,2,75
Nigeria,2011-01-01,48,0,-4,12,7,63
Nigeria,2011-01-01,12,0,0,12,2,26
Nigeria,2011-01-01,11,0,0,0,0,11
Nigeria,2011-01-01,0,0,-2,0,0,-2
Nigeria,2011-01-01,56,0,1,12,3,72
Nigeria,2011-01-01,42,2,-2,11,2,55
Nigeria,2011-01-01,93,0,-4,35,12,136
Nigeria,2011-01-01,53,0,0,48,9,110
Nigeria,2011-01-01,44,0,1,64,3,112
Nigeria,2011-01-01,23,0,-1,25,2,49
Nigeria,2011-01-01,54,0,0,24,1,79
Nigeria,2011-01-01,118,2,0,24,17,161
Nigeria,2011-01-01,63,2,1,1,9,76
Nigeria,2011-01-01,12,0,0,2,1,15
Pakistan,2011-01-01,74,0,-3,66,15,152
Pakistan,2011-01-01,101,4,0,36,6,147
Pakistan,2011-01-01,85,2,-1,26,3,115
Pakistan,2011-01-01,164,0,2,44,9,219
Pakistan,2011-01-01,184,0,3,111,11,309
Pakistan,2011-01-01,232,0,1,541,29,803
Pakistan,2011-01-01,410,2,-9,1372,113,1888
Pakistan,2011-01-01,105,2,1,135,11,254
Pakistan,2011-01-01,91,0,1,58,13,163
Pakistan,2011-01-01,151,0,0,15,58,224
Pakistan,2011-01-01,75,0,-2,9,38,120
Pakistan,2011-01-01,124,0,3,68,35,230
Pakistan,2011-01-01,99,2,1,45,14,161
Pakistan,2011-01-01,249,0,-1,91,21,360
Pakistan,2011-01-01,108,10,0,20,15,153
Pakistan,2011-01-01,79,0,1,34,4,118
Pakistan,2011-01-01,80,0,1,9,11,101
Pakistan,2011-01-01,96,0,0,37,24,157
Pakistan,2011-01-01,32,0,0,-3,19,48
Pakistan,2011-01-01,2,0,0,6,0,8
Pakistan,2011-01-01,15,0,0,7,4,26
Pakistan,2011-01-01,52,0,-4,51,6,105
Pakistan,2011-01-01,51,0,0,18,4,73
Pakistan,2011-01-01,40,0,0,22,2,64
Pakistan,2011-01-01,97,4,0,59,6,166
Pakistan,2011-01-01,113,4,2,70,24,213
Pakistan,2011-01-01,80,4,-4,-8,14,86
Pakistan,2011-01-01,68,2,-2,25,6,99
Pakistan,2011-01-01,65,2,1,41,25,134
Pakistan,2011-01-01,61,0,0,21,8,90
Pakistan,2011-01-01,61,0,0,22,5,88
Sierra Leone,2011-01-01,0,0,0,0,2,2
Sierra Leone,2011-01-01,0,0,-2,3,0,1
Sierra Leone,2011-01-01,4,0,-19,-4,0,-19
Sierra Leone,2011-01-01,17,0,-3,9,0,23
Sierra Leone,2011-01-01,20,0,-11,0,0,9
Sierra Leone,2011-01-01,4,0,0,0,0,4
Sierra Leone,2011-01-01,0,2,0,0,0,2
Sierra Leone,2011-01-01,0,0,0,0,0,0
Sierra Leone,2011-01-01,4,0,0,0,4,8
Sierra Leone,2011-01-01,3,0,0,3,0,6
Sierra Leone,2011-01-01,10,0,0,0,0,10
Sierra Leone,2011-01-01,-6,0,0,6,4,4
Sierra Leone,2011-01-01,2,0,0,0,0,2
Sierra Leone,2011-01-01,-3,0,0,6,0,3
Sierra Leone,2011-01-01,0,0,0,0,0,0
Sierra Leone,2011-01-01,8,0,0,6,0,14
Sierra Leone,2011-01-01,2,0,0,3,0,5
Sierra Leone,2011-01-01,10,0,0,3,0,13
Sierra Leone,2011-01-01,0,0,0,0,0,0
Sierra Leone,2011-01-01,0,0,0,0,0,0
Sierra Leone,2011-01-01,6,0,0,0,0,6
Sierra Leone,2011-01-01,11,0,0,0,1,12
Sierra Leone,2011-01-01,1,0,0,0,0,1
Sierra Leone,2011-01-01,-1,0,0,-2,0,-3
Sierra Leone,2011-01-01,9,0,0,-2,0,7
Sierra Leone,2011-01-01,7,0,0,0,1,8
Sierra Leone,2011-01-01,1,0,0,0,0,1
Sierra Leone,2011-01-01,6,0,0,0,0,6
Sierra Leone,2011-01-01,0,0,0,6,0,6
Sierra Leone,2011-01-01,0,0,0,0,0,0
Sierra Leone,2011-01-01,7,0,0,6,0,13
Somalia,2011-01-01,17,0,0,27,4,48
Somalia,2011-01-01,25,0,0,73,3,101
Somalia,2011-01-01,17,4,-2,20,6,45
Somalia,2011-01-01,39,0,0,18,0,57
Somalia,2011-01-01,48,0,0,11,2,61
Somalia,2011-01-01,63,0,0,26,0,89
Somalia,2011-01-01,57,0,-2,5,10,70
Somalia,2011-01-01,31,0,0,30,8,69
Somalia,2011-01-01,7,0,0,2,2,11
Somalia,2011-01-01,13,0,0,54,10,77
Somalia,2011-01-01,36,0,0,20,16,72
Somalia,2011-01-01,20,2,3,17,1,43
Somalia,2011-01-01,49,0,0,63,2,114
Somalia,2011-01-01,34,0,0,38,1,73
Somalia,2011-01-01,18,0,0,-8,0,10
Somalia,2011-01-01,25,0,0,33,0,58
Somalia,2011-01-01,19,0,0,17,0,36
Somalia,2011-01-01,64,0,0,99,1,164
Somalia,2011-01-01,36,0,0,22,0,58
Somalia,2011-01-01,3,0,3,0,0,6
Somalia,2011-01-01,44,0,0,-1,0,43
Somalia,2011-01-01,191,0,2,60,25,278
Somalia,2011-01-01,118,0,0,57,16,191
Somalia,2011-01-01,102,0,0,65,3,170
Somalia,2011-01-01,89,4,0,105,16,214
Somalia,2011-01-01,72,0,0,41,4,117
Somalia,2011-01-01,46,0,-1,27,2,74
Somalia,2011-01-01,43,0,0,49,1,93
Somalia,2011-01-01,87,0,0,49,1,137
Somalia,2011-01-01,159,0,0,79,0,238
Somalia,2011-01-01,70,0,0,78,1,149
Syria,2011-01-01,19,0,0,-2,0,17
Syria,2011-01-01,11,0,0,3,0,14
Syria,2011-01-01,6,0,0,15,1,22
Syria,2011-01-01,6,0,0,6,0,12
Syria,2011-01-01,14,0,-2,45,2,59
Syria,2011-01-01,10,0,0,2,1,13
Syria,2011-01-01,3,0,2,21,5,31
Syria,2011-01-01,5,0,0,-2,2,5
Syria,2011-01-01,4,0,1,2,0,7
Syria,2011-01-01,7,0,0,21,0,28
Syria,2011-01-01,36,0,-4,20,0,52
Syria,2011-01-01,59,0,-46,13,11,37
Syria,2011-01-01,48,0,-20,42,8,78
Syria,2011-01-01,32,0,-2,21,0,51
Syria,2011-01-01,16,0,-1,3,12,30
Syria,2011-01-01,14,0,1,12,6,33
Syria,2011-01-01,28,0,-2,34,3,63
Syria,2011-01-01,31,0,-12,15,3,37
Syria,2011-01-01,38,0,-4,2,0,36
Syria,2011-01-01,4,0,0,-4,0,0
Syria,2011-01-01,4,0,0,3,0,7
Syria,2011-01-01,36,0,0,10,3,49
Syria,2011-01-01,12,0,0,27,1,40
Syria,2011-01-01,34,0,0,14,4,52
Syria,2011-01-01,29,0,-4,18,7,50
Syria,2011-01-01,36,0,0,9,8,53
Syria,2011-01-01,35,0,-2,2,12,47
Syria,2011-01-01,56,0,0,0,5,61
Syria,2011-01-01,22,0,2,-6,1,19
Syria,2011-01-01,12,0,-2,2,1,13
Syria,2011-01-01,21,0,0,-2,9,28
Yemen,2011-01-01,2,0,-8,0,2,-4
Yemen,2011-01-01,15,0,-10,18,1,24
Yemen,2011-01-01,7,0,0,-3,4,8
Yemen,2011-01-01,13,0,0,0,1,14
Yemen,2011-01-01,26,0,-4,15,0,37
Yemen,2011-01-01,17,0,-4,6,0,19
Yemen,2011-01-01,34,0,0,33,2,69
Yemen,2011-01-01,34,0,0,16,4,54
Yemen,2011-01-01,5,0,0,0,1,6
Yemen,2011-01-01,17,0,0,12,2,31
Yemen,2011-01-01,8,0,-4,7,2,13
Yemen,2011-01-01,15,0,0,6,0,21
Yemen,2011-01-01,9,0,0,11,4,24
Yemen,2011-01-01,18,0,0,3,0,21
Yemen,2011-01-01,6,0,0,3,1,10
Yemen,2011-01-01,18,0,0,9,1,28
Yemen,2011-01-01,38,0,1,39,0,78
Yemen,2011-01-01,58,0,6,41,15,120
Yemen,2011-01-01,7,0,0,21,6,34
Yemen,2011-01-01,1,0,0,3,0,4
Yemen,2011-01-01,0,0,0,0,0,0
Yemen,2011-01-01,48,0,0,16,6,70
Yemen,2011-01-01,52,0,0,7,11,70
Yemen,2011-01-01,14,0,-1,3,7,23
Yemen,2011-01-01,7,0,0,40,2,49
Yemen,2011-01-01,27,0,0,28,3,58
Yemen,2011-01-01,29,0,-18,15,31,57
Yemen,2011-01-01,52,0,-15,14,42,93
Yemen,2011-01-01,26,0,3,18,16,63
Yemen,2011-01-01,12,0,2,13,18,45
Yemen,2011-01-01,11,0,-6,19,12,36
Afghanistan,2013-03-01,187,0,-2,51,12,248
Afghanistan,2013-03-01,100,0,0,7,1,108
Afghanistan,2013-03-01,64,2,0,6,9,81
Afghanistan,2013-03-01,80,4,0,10,3,97
Afghanistan,2013-03-01,121,0,0,5,11,137
Afghanistan,2013-03-01,108,2,-1,18,10,137
Afghanistan,2013-03-01,116,0,-2,11,20,145
Afghanistan,2013-03-01,193,0,2,34,19,248
Afghanistan,2013-03-01,226,0,4,25,4,259
Afghanistan,2013-03-01,12,0,0,3,0,15
Afghanistan,2013-03-01,267,2,5,30,26,330
Afghanistan,2013-03-01,210,0,0,34,33,277
Afghanistan,2013-03-01,134,0,0,56,68,258
Afghanistan,2013-03-01,410,2,-5,136,70,613
Afghanistan,2013-03-01,151,0,1,3,3,158
Afghanistan,2013-03-01,153,0,0,7,7,167
Afghanistan,2013-03-01,145,2,0,14,4,165
Afghanistan,2013-03-01,130,2,0,30,17,179
Afghanistan,2013-03-01,103,2,1,39,15,160
Afghanistan,2013-03-01,144,2,0,25,13,184
Afghanistan,2013-03-01,153,4,0,22,12,191
Afghanistan,2013-03-01,88,0,-2,55,6,147
Afghanistan,2013-03-01,142,0,0,54,24,220
Afghanistan,2013-03-01,76,0,0,20,38,134
Afghanistan,2013-03-01,108,0,-2,40,4,150
Afghanistan,2013-03-01,113,0,2,22,14,151
Afghanistan,2013-03-01,177,6,-8,1,14,190
Afghanistan,2013-03-01,96,0,0,8,12,116
Afghanistan,2013-03-01,76,0,0,-4,12,84
Afghanistan,2013-03-01,62,0,0,-6,0,56
Afghanistan,2013-03-01,7,0,0,3,4,14
Albania,2013-03-01,6,0,1,0,1,8
Albania,2013-03-01,-1,0,1,21,18,39
Albania,2013-03-01,3,0,0,12,5,20
Albania,2013-03-01,10,0,-2,12,2,22
Albania,2013-03-01,-2,0,0,0,2,0
Albania,2013-03-01,6,0,0,0,0,6
Albania,2013-03-01,10,0,0,6,1,17
Albania,2013-03-01,10,0,0,6,0,16
Albania,2013-03-01,6,0,0,0,0,6
Albania,2013-03-01,0,0,0,0,0,0
Albania,2013-03-01,1,0,0,1,0,2
Albania,2013-03-01,0,0,0,-2,0,-2
Albania,2013-03-01,2,0,0,0,0,2
Albania,2013-03-01,0,0,0,0,0,0
Albania,2013-03-01,2,0,0,6,0,8
Albania,2013-03-01,5,0,0,30,1,36
Albania,2013-03-01,10,0,-2,2,0,10
Albania,2013-03-01,8,0,0,3,0,11
Albania,2013-03-01,16,0,0,0,0,16
Albania,2013-03-01,4,0,0,0,0,4
Albania,2013-03-01,5,0,0,6,0,11
Albania,2013-03-01,36,0,0,12,0,48
Albania,2013-03-01,8,0,0,0,0,8
Albania,2013-03-01,-2,0,0,9,2,9
Albania,2013-03-01,0,0,0,0,0,0
Albania,2013-03-01,5,0,-1,-4,0,0
Albania,2013-03-01,2,0,0,18,0,20
Albania,2013-03-01,5,0,0,0,0,5
Albania,2013-03-01,6,0,0,0,1,7
Albania,2013-03-01,0,0,0,0,0,0
Algeria,2013-03-01,71,0,0,7,2,80
Algeria,2013-03-01,127,0,0,3,13,143
Algeria,2013-03-01,238,0,0,33,12,283
Algeria,2013-03-01,296,0,0,65,36,397
Algeria,2013-03-01,41,0,-4,3,4,44
Algeria,2013-03-01,65,2,0,3,4,74
Algeria,2013-03-01,24,0,0,0,2,26
Algeria,2013-03-01,6,0,0,0,0,6
Algeria,2013-03-01,0,0,0,0,0,0
Algeria,2013-03-01,7,0,0,15,4,26
Algeria,2013-03-01,1,0,0,0,0,1
Algeria,2013-03-01,128,0,-1,38,31,196
Algeria,2013-03-01,23,0,0,0,0,23
Algeria,2013-03-01,16,0,0,30,0,46
Algeria,2013-03-01,5,0,0,15,0,20
Algeria,2013-03-01,22,0,0,3,0,25
Algeria,2013-03-01,31,0,0,3,2,36
Algeria,2013-03-01,32,0,0,3,2,37
Algeria,2013-03-01,11,0,0,0,2,13
Algeria,2013-03-01,170,0,2,39,23,234
Algeria,2013-03-01,8,0,0,0,0,8
Algeria,2013-03-01,84,0,0,12,4,100
Algeria,2013-03-01,22,0,0,6,0,28
Algeria,2013-03-01,18,0,0,-1,1,18
Algeria,2013-03-01,20,0,-2,-1,1,18
Algeria,2013-03-01,367,0,-4,166,58,587
Algeria,2013-03-01,12,0,-6,0,2,8
Algeria,2013-03-01,2,0,0,3,0,5
Algeria,2013-03-01,309,4,-21,152,27,471
Algeria,2013-03-01,17,0,1,20,1,39
Bangladesh,2013-03-01,68,0,-1,33,18,118
Bangladesh,2013-03-01,62,2,0,67,12,143
Bangladesh,2013-03-01,48,0,0,32,9,89
Bangladesh,2013-03-01,31,2,0,26,6,65
Bangladesh,2013-03-01,35,0,0,16,2,53
Bangladesh,2013-03-01,34,0,0,9,11,54
Bangladesh,2013-03-01,68,0,-1,42,8,117
Bangladesh,2013-03-01,11,0,0,18,8,37
Bangladesh,2013-03-01,22,0,0,34,12,68
Bangladesh,2013-03-01,0,0,0,0,0,0
Bangladesh,2013-03-01,51,0,0,12,6,69
Bangladesh,2013-03-01,18,0,1,19,0,38
Bangladesh,2013-03-01,32,0,0,7,2,41
Bangladesh,2013-03-01,50,0,0,18,4,72
Bangladesh,2013-03-01,39,2,0,12,4,57
Bangladesh,2013-03-01,15,0,0,6,7,28
Bangladesh,2013-03-01,12,0,1,0,12,25
Bangladesh,2013-03-01,14,0,0,4,5,23
Bangladesh,2013-03-01,27,0,1,6,2,36
Bangladesh,2013-03-01,24,0,0,27,2,53
Bangladesh,2013-03-01,27,0,0,4,1,32
Bangladesh,2013-03-01,19,0,0,18,2,39
Bangladesh,2013-03-01,27,0,0,26,4,57
Bangladesh,2013-03-01,12,0,0,0,6,18
Bangladesh,2013-03-01,47,0,0,5,7,59
Bangladesh,2013-03-01,5,0,1,6,5,17
Bangladesh,2013-03-01,21,0,-2,12,5,36
Bangladesh,2013-03-01,19,0,0,-2,0,17
Bangladesh,2013-03-01,13,0,0,-2,1,12
Bangladesh,2013-03-01,11,0,0,6,0,17
Bangladesh,2013-03-01,14,0,0,3,2,19
Cameroon,2013-03-01,8,0,0,13,0,21
Cameroon,2013-03-01,2,0,0,0,0,2
Cameroon,2013-03-01,3,0,0,0,4,7
Cameroon,2013-03-01,10,0,0,0,0,10
Cameroon,2013-03-01,15,0,-2,9,0,22
Cameroon,2013-03-01,0,0,0,15,0,15
Cameroon,2013-03-01,0,0,0,0,0,0
Cameroon,2013-03-01,2,0,0,0,0,2
Cameroon,2013-03-01,8,0,0,0,0,8
Cameroon,2013-03-01,0,0,0,0,4,4
Cameroon,2013-03-01,9,0,0,4,1,14
Cameroon,2013-03-01,5,0,0,-4,0,1
Cameroon,2013-03-01,0,4,0,-2,4,6
Cameroon,2013-03-01,1,0,0,-2,0,-1
Cameroon,2013-03-01,0,0,0,0,0,0
Cameroon,2013-03-01,10,0,0,0,0,10
Cameroon,2013-03-01,0,0,0,0,0,0
Cameroon,2013-03-01,33,0,0,0,0,33
Cameroon,2013-03-01,2,0,0,6,0,8
Cameroon,2013-03-01,0,0,0,3,0,3
Cameroon,2013-03-01,6,0,0,39,0,45
Cameroon,2013-03-01,7,4,0,0,2,13
Cameroon,2013-03-01,18,0,0,0,0,18
Cameroon,2013-03-01,0,0,0,-4,0,-4
Cameroon,2013-03-01,25,0,0,-3,0,22
Cameroon,2013-03-01,19,0,0,5,16,40
Cameroon,2013-03-01,7,0,0,0,4,11
Cameroon,2013-03-01,4,2,0,2,6,14
Cameroon,2013-03-01,21,0,0,0,0,21
Cameroon,2013-03-01,1,0,0,0,0,1
Cameroon,2013-03-01,6,0,0,0,0,6
China,2013-03-01,130,8,-7,56,21,208
China,2013-03-01,54,0,-1,20,7,80
China,2013-03-01,50,0,-3,55,18,120
China,2013-03-01,117,0,-4,53,15,181
China,2013-03-01,109,6,-19,97,21,214
China,2013-03-01,143,4,8,46,25,226
China,2013-03-01,173,2,-2,54,23,250
China,2013-03-01,260,4,-2,80,28,370
China,2013-03-01,184,4,2,34,24,248
China,2013-03-01,3,0,0,-2,0,1
China,2013-03-01,142,2,-14,105,19,254
China,2013-03-01,156,8,1,84,15,264
China,2013-03-01,168,2,-1,97,20,286
China,2013-03-01,195,2,-6,68,25,284
China,2013-03-01,168,0,-4,60,22,246
China,2013-03-01,107,0,-1,27,14,147
China,2013-03-01,86,0,2,10,19,117
China,2013-03-01,139,4,-2,48,11,200
China,2013-03-01,182,2,-6,115,30,323
China,2013-03-01,152,0,-7,83,26,254
China,2013-03-01,140,4,-4,48,23,211
China,2013-03-01,149,4,2,21,19,195
China,2013-03-01,138,0,0,44,14,196
China,2013-03-01,24,0,0,32,8,64
China,2013-03-01,209,6,-4,101,29,341
China,2013-03-01,145,2,-5,74,15,231
China,2013-03-01,107,2,-2,44,15,166
China,2013-03-01,87,10,-1,66,18,180
China,2013-03-01,179,6,-6,58,25,262
China,2013-03-01,47,0,0,4,7,58
China,2013-03-01,24,2,0,22,3,51
Egypt,2013-03-01,22,0,-2,22,10,52
Egypt,2013-03-01,50,6,3,10,21,90
Egypt,2013-03-01,82,0,-1,57,38,176
Egypt,2013-03-01,69,0,-1,69,23,160
Egypt,2013-03-01,58,2,-3,37,13,107
Egypt,2013-03-01,138,0,-1,32,20,189
Egypt,2013-03-01,29,0,-2,15,16,58
Egypt,2013-03-01,48,0,-2,11,10,67
Egypt,2013-03-01,76,0,-8,56,30,154
Egypt,2013-03-01,4,0,0,3,0,7
Egypt,2013-03-01,69,0,-5,40,16,120
Egypt,2013-03-01,60,2,-1,15,13,89
Egypt,2013-03-01,50,0,0,26,12,88
Egypt,2013-03-01,74,2,4,1,6,87
Egypt,2013-03-01,97,2,-3,6,17,119
Egypt,2013-03-01,72,0,-1,4,15,90
Egypt,2013-03-01,26,2,0,11,6,45
Egypt,2013-03-01,39,0,-6,9,10,52
Egypt,2013-03-01,113,2,1,48,25,189
Egypt,2013-03-01,31,0,-3,29,10,67
Egypt,2013-03-01,64,0,0,31,27,122
Egypt,2013-03-01,38,0,0,34,18,90
Egypt,2013-03-01,102,0,-4,32,0,130
Egypt,2013-03-01,13,0,0,17,0,30
Egypt,2013-03-01,63,2,-4,41,11,113
Egypt,2013-03-01,68,0,1,38,6,113
Egypt,2013-03-01,72,4,-1,44,27,146
Egypt,2013-03-01,76,0,3,41,16,136
Egypt,2013-03-01,50,0,-5,22,27,94
Egypt,2013-03-01,47,0,0,18,5,70
Egypt,2013-03-01,46,0,0,-26,5,25
Eritrea,2013-03-01,1,0,0,0,0,1
Eritrea,2013-03-01,0,0,0,1,0,1
Eritrea,2013-03-01,4,0,0,0,0,4
Eritrea,2013-03-01,0,2,0,0,0,2
Eritrea,2013-03-01,-1,0,0,0,0,-1
Eritrea,2013-03-01,3,0,0,-1,2,4
Eritrea,2013-03-01,3,0,0,0,0,3
Eritrea,2013-03-01,0,0,0,0,0,0
Eritrea,2013-03-01,0,0,0,0,0,0
Eritrea,2013-03-01,0,0,0,2,0,2
Eritrea,2013-03-01,0,0,0,6,0,6
Eritrea,2013-03-01,6,0,0,3,2,11
Eritrea,2013-03-01,5,0,0,6,3,14
Eritrea,2013-03-01,0,0,0,0,0,0
Eritrea,2013-03-01,0,0,0,0,0,0
Eritrea,2013-03-01,0,0,0,0,0,0
Eritrea,2013-03-01,1,0,0,0,0,1
Eritrea,2013-03-01,4,4,0,3,0,11
Eritrea,2013-03-01,2,0,0,0,0,2
Eritrea,2013-03-01,0,0,0,3,0,3
Eritrea,2013-03-01,5,0,0,15,0,20
Eritrea,2013-03-01,0,0,0,9,0,9
Georgia,2013-03-01,1,0,0,0,0,1
Georgia,2013-03-01,25,0,0,21,2,48
Georgia,2013-03-01,0,0,0,0,0,0
Georgia,2013-03-01,8,0,0,0,0,8
Georgia,2013-03-01,1,0,0,0,0,1
Georgia,2013-03-01,15,0,0,0,0,15
Georgia,2013-03-01,1,0,0,6,2,9
Georgia,2013-03-01,0,0,0,9,0,9
Georgia,2013-03-01,2,0,0,0,8,10
Georgia,2013-03-01,5,0,0,0,0,5
Georgia,2013-03-01,0,0,0,0,0,0
Georgia,2013-03-01,6,0,0,0,0,6
Georgia,2013-03-01,-2,0,0,3,0,1
Georgia,2013-03-01,4,0,0,0,0,4
Georgia,2013-03-01,-1,0,0,0,0,-1
Georgia,2013-03-01,0,0,0,0,0,0
Georgia,2013-03-01,7,0,0,0,0,7
Georgia,2013-03-01,11,0,-2,0,1,10
Georgia,2013-03-01,3,0,0,0,0,3
Georgia,2013-03-01,8,0,0,6,0,14
Georgia,2013-03-01,6,0,-2,0,0,4
Georgia,2013-03-01,-1,0,-2,-2,0,-5
Georgia,2013-03-01,3,0,-4,0,0,-1
Georgia,2013-03-01,1,0,0,0,1,2
Georgia,2013-03-01,-1,0,0,-1,0,-2
Georgia,2013-03-01,-1,0,0,0,0,-1
Georgia,2013-03-01,0,0,0,0,0,0
India,2013-03-01,75,0,-2,20,19,112
India,2013-03-01,29,8,-1,24,11,71
India,2013-03-01,87,0,4,20,15,126
India,2013-03-01,65,0,-4,24,5,90
India,2013-03-01,76,0,-1,59,18,152
India,2013-03-01,66,6,-3,7,11,87
India,2013-03-01,68,4,0,17,18,107
India,2013-03-01,78,0,-3,28,10,113
India,2013-03-01,36,0,-4,38,30,100
India,2013-03-01,3,0,0,0,0,3
India,2013-03-01,50,0,0,33,23,106
India,2013-03-01,75,0,-4,25,18,114
India,2013-03-01,126,2,-1,24,10,161
India,2013-03-01,62,2,-2,44,18,124
India,2013-03-01,78,0,-2,28,15,119
India,2013-03-01,81,0,-4,26,10,113
India,2013-03-01,48,2,3,23,8,84
India,2013-03-01,66,4,-1,17,11,97
India,2013-03-01,73,2,-3,32,22,126
India,2013-03-01,44,2,-9,6,16,59
India,2013-03-01,80,0,-6,26,25,125
India,2013-03-01,77,0,-2,19,17,111
India,2013-03-01,156,0,2,60,20,238
India,2013-03-01,14,0,0,6,4,24
India,2013-03-01,41,2,-1,20,9,71
India,2013-03-01,109,2,-31,-6,10,84
India,2013-03-01,48,0,-11,4,6,47
India,2013-03-01,99,0,2,33,4,138
India,2013-03-01,81,0,-10,8,20,99
India,2013-03-01,19,0,0,9,6,34
India,2013-03-01,24,0,0,3,5,32
Iran,2013-03-01,46,0,-2,32,10,86
Iran,2013-03-01,52,0,0,13,12,77
Iran,2013-03-01,46,2,1,18,15,82
Iran,2013-03-01,99,0,1,39,5,144
Iran,2013-03-01,79,4,7,96,14,200
Iran,2013-03-01,141,2,-12,103,26,260
Iran,2013-03-01,219,2,-2,220,26,465
Iran,2013-03-01,175,0,-2,150,22,345
Iran,2013-03-01,218,0,4,158,38,418
Iran,2013-03-01,0,0,0,0,0,0
Iran,2013-03-01,143,0,2,169,51,365
Iran,2013-03-01,57,2,6,63,6,134
Iran,2013-03-01,45,0,0,74,7,126
Iran,2013-03-01,139,1,0,66,15,221
Iran,2013-03-01,139,0,0,54,13,206
Iran,2013-03-01,82,0,0,3,2,87
Iran,2013-03-01,82,0,1,35,-2,116
Iran,2013-03-01,82,0,1,22,9,114
Iran,2013-03-01,67,0,-4,5,2,70
Iran,2013-03-01,131,0,1,48,23,203
Iran,2013-03-01,141,0,2,29,15,187
Iran,2013-03-01,98,0,-12,60,13,159
Iran,2013-03-01,118,0,-16,4,10,116
Iran,2013-03-01,35,0,2,-4,0,33
Iran,2013-03-01,74,0,0,9,19,102
Iran,2013-03-01,74,0,0,79,1,154
Iran,2013-03-01,52,0,-3,3,5,57
Iran,2013-03-01,140,0,-2,22,9,169
Iran,2013-03-01,99,0,0,51,7,157
Iran,2013-03-01,6,0,1,12,0,19
Iran,2013-03-01,9,0,0,0,0,9
Iraq,2013-03-01,128,0,-4,47,13,184
Iraq,2013-03-01,164,0,-5,8,3,170
Iraq,2013-03-01,88,0,-3,10,14,109
Iraq,2013-03-01,98,0,-3,19,22,136
Iraq,2013-03-01,142,0,-1,31,13,185
Iraq,2013-03-01,138,0,0,-2,3,139
Iraq,2013-03-01,133,0,-1,34,9,175
Iraq,2013-03-01,64,0,-2,49,0,111
Iraq,2013-03-01,117,0,-12,72,16,193
Iraq,2013-03-01,0,0,0,3,0,3
Iraq,2013-03-01,126,0,0,38,10,174
Iraq,2013-03-01,52,0,0,26,8,86
Iraq,2013-03-01,86,0,2,3,12,103
Iraq,2013-03-01,129,0,0,7,3,139
Iraq,2013-03-01,68,0,2,20,6,96
Iraq,2013-03-01,59,2,1,10,10,82
Iraq,2013-03-01,90,4,0,37,44,175
Iraq,2013-03-01,101,0,-2,46,10,155
Iraq,2013-03-01,181,10,0,54,9,254
Iraq,2013-03-01,142,6,0,46,14,208
Iraq,2013-03-01,247,12,-6,59,38,350
Iraq,2013-03-01,108,4,0,34,8,154
Iraq,2013-03-01,106,12,2,32,8,160
Iraq,2013-03-01,88,0,0,6,8,102
Iraq,2013-03-01,96,0,2,82,12,192
Iraq,2013-03-01,51,0,-5,-1,7,52
Iraq,2013-03-01,109,0,-10,34,7,140
Iraq,2013-03-01,95,0,-2,40,5,138
Iraq,2013-03-01,134,12,0,3,12,161
Iraq,2013-03-01,61,0,0,0,21,82
Iraq,2013-03-01,26,0,2,3,0,31
Morocco,2013-03-01,2,0,0,6,3,11
Morocco,2013-03-01,7,0,0,1,1,9
Morocco,2013-03-01,2,0,0,-3,0,-1
Morocco,2013-03-01,3,0,2,6,2,13
Morocco,2013-03-01,10,0,0,6,0,16
Morocco,2013-03-01,3,0,0,0,0,3
Morocco,2013-03-01,1,0,0,18,0,19
Morocco,2013-03-01,8,0,0,13,0,21
Morocco,2013-03-01,2,0,0,12,0,14
Morocco,2013-03-01,0,0,0,2,0,2
Morocco,2013-03-01,7,0,0,2,0,9
Morocco,2013-03-01,1,0,0,3,0,4
Morocco,2013-03-01,-2,0,0,-2,1,-3
Morocco,2013-03-01,-3,0,3,21,2,23
Morocco,2013-03-01,3,0,0,0,4,7
Morocco,2013-03-01,14,0,0,3,4,21
Morocco,2013-03-01,41,0,0,0,1,42
Morocco,2013-03-01,11,0,0,-6,0,5
Morocco,2013-03-01,1,0,0,0,0,1
Morocco,2013-03-01,-5,0,0,0,0,-5
Morocco,2013-03-01,7,0,0,0,0,7
Morocco,2013-03-01,12,0,0,0,2,14
Morocco,2013-03-01,0,0,0,0,0,0
Morocco,2013-03-01,9,0,0,0,0,9
Morocco,2013-03-01,6,0,0,0,0,6
Morocco,2013-03-01,0,0,0,3,0,3
Morocco,2013-03-01,0,0,0,3,0,3
Morocco,2013-03-01,0,0,0,4,3,7
Morocco,2013-03-01,60,0,0,22,4,86
Morocco,2013-03-01,0,0,0,3,0,3
Nigeria,2013-03-01,26,0,0,20,1,47
Nigeria,2013-03-01,3,0,0,13,2,18
Nigeria,2013-03-01,9,0,-2,15,1,23
Nigeria,2013-03-01,14,0,0,2,7,23
Nigeria,2013-03-01,21,0,0,19,9,49
Nigeria,2013-03-01,9,0,0,20,5,34
Nigeria,2013-03-01,11,0,1,15,1,28
Nigeria,2013-03-01,21,0,1,15,7,44
Nigeria,2013-03-01,84,0,0,6,6,96
Nigeria,2013-03-01,3,0,0,0,0,3
Nigeria,2013-03-01,81,0,-4,3,8,88
Nigeria,2013-03-01,69,0,0,-4,5,70
Nigeria,2013-03-01,30,0,0,19,4,53
Nigeria,2013-03-01,34,0,1,33,-3,65
Nigeria,2013-03-01,53,0,0,42,3,98
Nigeria,2013-03-01,34,0,0,36,2,72
Nigeria,2013-03-01,14,0,0,15,2,31
Nigeria,2013-03-01,34,0,0,23,4,61
Nigeria,2013-03-01,27,0,1,-4,4,28
Nigeria,2013-03-01,20,0,0,12,9,41
Nigeria,2013-03-01,17,4,0,28,4,53
Nigeria,2013-03-01,17,0,-2,10,11,36
Nigeria,2013-03-01,8,0,2,47,14,71
Nigeria,2013-03-01,4,0,0,0,0,4
Nigeria,2013-03-01,34,0,-4,37,7,74
Nigeria,2013-03-01,15,2,-1,34,0,50
Nigeria,2013-03-01,20,0,0,15,2,37
Nigeria,2013-03-01,14,0,1,27,2,44
Nigeria,2013-03-01,6,0,2,4,4,16
Nigeria,2013-03-01,0,0,-6,0,0,-6
Nigeria,2013-03-01,5,0,0,0,0,5
Pakistan,2013-03-01,130,0,-6,56,23,203
Pakistan,2013-03-01,86,0,0,54,6,146
Pakistan,2013-03-01,129,0,0,78,16,223
Pakistan,2013-03-01,138,0,1,136,18,293
Pakistan,2013-03-01,66,0,-2,47,6,117
Pakistan,2013-03-01,106,0,-3,50,34,187
Pakistan,2013-03-01,149,0,-4,58,8,211
Pakistan,2013-03-01,110,0,3,34,9,156
Pakistan,2013-03-01,180,4,4,18,28,234
Pakistan,2013-03-01,-3,0,0,3,0,0
Pakistan,2013-03-01,67,2,-1,36,12,116
Pakistan,2013-03-01,29,0,2,17,13,61
Pakistan,2013-03-01,108,0,2,17,18,145
Pakistan,2013-03-01,88,0,-1,27,21,135
Pakistan,2013-03-01,133,0,2,39,13,187
Pakistan,2013-03-01,131,0,-5,29,22,177
Pakistan,2013-03-01,72,0,-4,7,16,91
Pakistan,2013-03-01,49,0,1,24,10,84
Pakistan,2013-03-01,138,0,-4,4,14,152
Pakistan,2013-03-01,84,0,-1,24,8,115
Pakistan,2013-03-01,93,0,7,57,11,168
Pakistan,2013-03-01,35,4,0,31,10,80
Pakistan,2013-03-01,182,0,2,22,14,220
Pakistan,2013-03-01,50,0,0,18,0,68
Pakistan,2013-03-01,73,0,-2,36,1,108
Pakistan,2013-03-01,89,0,-3,13,31,130
Pakistan,2013-03-01,63,0,0,40,10,113
Pakistan,2013-03-01,116,0,1,60,9,186
Pakistan,2013-03-01,78,0,2,20,16,116
Pakistan,2013-03-01,47,2,0,12,1,62
Pakistan,2013-03-01,19,0,0,1,0,20
Sierra Leone,2013-03-01,1,0,0,0,0,1
Sierra Leone,2013-03-01,2,0,0,0,0,2
Sierra Leone,2013-03-01,0,0,0,0,0,0
Sierra Leone,2013-03-01,0,0,0,0,0,0
Sierra Leone,2013-03-01,1,0,0,0,0,1
Sierra Leone,2013-03-01,2,0,0,0,0,2
Sierra Leone,2013-03-01,9,0,0,0,0,9
Sierra Leone,2013-03-01,3,0,0,3,0,6
Sierra Leone,2013-03-01,0,0,0,0,0,0
Sierra Leone,2013-03-01,0,0,0,3,0,3
Sierra Leone,2013-03-01,0,0,0,4,0,4
Sierra Leone,2013-03-01,0,0,0,0,0,0
Sierra Leone,2013-03-01,0,0,0,0,0,0
Sierra Leone,2013-03-01,0,0,0,0,0,0
Sierra Leone,2013-03-01,2,0,0,0,0,2
Sierra Leone,2013-03-01,0,0,0,0,0,0
Sierra Leone,2013-03-01,0,0,0,0,0,0
Sierra Leone,2013-03-01,-1,0,0,0,0,-1
Sierra Leone,2013-03-01,1,0,0,0,0,1
Sierra Leone,2013-03-01,0,0,0,6,0,6
Sierra Leone,2013-03-01,0,0,0,12,0,12
Sierra Leone,2013-03-01,0,0,0,8,0,8
Sierra Leone,2013-03-01,1,0,0,6,0,7
Sierra Leone,2013-03-01,4,0,0,-6,0,-2
Sierra Leone,2013-03-01,1,0,0,0,0,1
Sierra Leone,2013-03-01,2,0,0,0,0,2
Somalia,2013-03-01,14,0,-2,6,5,23
Somalia,2013-03-01,18,0,-2,10,2,28
Somalia,2013-03-01,5,2,0,14,7,28
Somalia,2013-03-01,86,0,0,29,23,138
Somalia,2013-03-01,44,0,0,26,21,91
Somalia,2013-03-01,57,0,-1,27,8,91
Somalia,2013-03-01,0,0,0,-2,2,0
Somalia,2013-03-01,5,0,0,-3,5,7
Somalia,2013-03-01,50,0,0,-6,6,50
Somalia,2013-03-01,13,0,0,-1,4,16
Somalia,2013-03-01,26,0,0,-5,0,21
Somalia,2013-03-01,31,0,0,10,0,41
Somalia,2013-03-01,16,0,0,-2,1,15
Somalia,2013-03-01,5,0,0,0,1,6
Somalia,2013-03-01,18,0,0,6,0,24
Somalia,2013-03-01,17,0,0,8,10,35
Somalia,2013-03-01,10,0,0,5,6,21
Somalia,2013-03-01,29,0,0,3,0,32
Somalia,2013-03-01,9,0,0,45,3,57
Somalia,2013-03-01,3,0,-2,25,7,33
Somalia,2013-03-01,29,0,0,12,3,44
Somalia,2013-03-01,-6,0,0,-10,6,-10
Somalia,2013-03-01,0,0,0,1,4,5
Somalia,2013-03-01,58,0,0,6,2,66
Somalia,2013-03-01,30,0,0,13,2,45
Somalia,2013-03-01,17,0,0,12,2,31
Somalia,2013-03-01,-6,0,0,15,0,9
Somalia,2013-03-01,10,0,1,6,6,23
Somalia,2013-03-01,3,0,0,9,0,12
Somalia,2013-03-01,3,0,0,0,0,3
Syria,2013-03-01,258,2,-13,45,32,324
Syria,2013-03-01,160,2,-8,-8,13,159
Syria,2013-03-01,214,0,-6,12,5,225
Syria,2013-03-01,352,0,-6,-3,80,423
Syria,2013-03-01,246,4,-1,-4,56,301
Syria,2013-03-01,258,0,-1,-30,45,272
Syria,2013-03-01,181,1,-6,31,35,242
Syria,2013-03-01,183,0,-12,22,16,209
Syria,2013-03-01,156,0,0,-2,8,162
Syria,2013-03-01,8,0,0,3,2,13
Syria,2013-03-01,330,0,-1,25,36,390
Syria,2013-03-01,130,10,3,53,20,216
Syria,2013-03-01,161,4,9,58,19,251
Syria,2013-03-01,282,11,16,23,19,351
Syria,2013-03-01,271,6,-1,4,19,299
Syria,2013-03-01,205,0,-1,21,11,236
Syria,2013-03-01,208,2,-2,10,20,238
Syria,2013-03-01,335,4,0,80,32,451
Syria,2013-03-01,293,8,-2,35,31,365
Syria,2013-03-01,276,0,2,25,16,319
Syria,2013-03-01,167,0,2,-9,9,169
Syria,2013-03-01,300,2,-52,33,10,293
Syria,2013-03-01,308,4,-110,18,14,234
Syria,2013-03-01,207,0,-4,8,54,265
Syria,2013-03-01,290,0,-15,49,21,345
Syria,2013-03-01,132,12,-6,49,24,211
Syria,2013-03-01,263,10,-10,23,31,317
Syria,2013-03-01,292,0,-6,104,43,433
Syria,2013-03-01,180,0,0,95,28,303
Syria,2013-03-01,1,0,1,30,11,43
Syria,2013-03-01,44,0,0,4,19,67
Yemen,2013-03-01,-2,0,0,-2,4,0
Yemen,2013-03-01,47,0,-2,9,0,54
Yemen,2013-03-01,14,0,0,6,0,20
Yemen,2013-03-01,36,0,-1,10,26,71
Yemen,2013-03-01,29,0,0,-4,2,27
Yemen,2013-03-01,63,0,0,7,0,70
Yemen,2013-03-01,50,2,0,22,13,87
Yemen,2013-03-01,22,0,0,6,0,28
Yemen,2013-03-01,42,0,0,14,4,60
Yemen,2013-03-01,2,0,0,3,4,9
Yemen,2013-03-01,11,0,0,9,2,22
Yemen,2013-03-01,51,0,0,6,5,62
Yemen,2013-03-01,6,0,0,2,4,12
Yemen,2013-03-01,23,0,0,13,1,37
Yemen,2013-03-01,24,0,0,-5,5,24
Yemen,2013-03-01,6,2,0,3,4,15
Yemen,2013-03-01,32,0,0,16,3,51
Yemen,2013-03-01,-2,0,0,-14,1,-15
Yemen,2013-03-01,28,0,-3,0,1,26
Yemen,2013-03-01,16,0,0,0,0,16
Yemen,2013-03-01,11,0,0,-4,3,10
Yemen,2013-03-01,36,0,2,6,4,48
Yemen,2013-03-01,8,0,0,6,0,14
Yemen,2013-03-01,26,0,0,24,0,50
Yemen,2013-03-01,18,0,0,11,3,32
Yemen,2013-03-01,15,0,0,21,3,39
Yemen,2013-03-01,30,0,0,20,1,51
Yemen,2013-03-01,0,0,0,3,2,5
Yemen,2013-03-01,9,0,0,0,0,9
Yemen,2013-03-01,0,0,0,12,0,12
Afghanistan,2008-02-01,297,0,1,6,18,322
Afghanistan,2008-02-01,134,0,3,9,16,162
Afghanistan,2008-02-01,89,4,-6,16,6,109
Afghanistan,2008-02-01,244,2,0,79,41,366
Afghanistan,2008-02-01,202,2,0,87,12,303
Afghanistan,2008-02-01,202,0,-8,40,9,243
Afghanistan,2008-02-01,308,2,-1,70,13,392
Afghanistan,2008-02-01,176,0,1,70,8,255
Afghanistan,2008-02-01,125,0,2,14,7,148
Afghanistan,2008-02-01,148,0,2,8,9,167
Afghanistan,2008-02-01,351,0,2,110,33,496
Afghanistan,2008-02-01,134,4,1,62,3,204
Afghanistan,2008-02-01,90,0,2,6,0,98
Afghanistan,2008-02-01,69,0,0,34,3,106
Afghanistan,2008-02-01,62,0,0,26,8,96
Afghanistan,2008-02-01,81,0,0,25,22,128
Afghanistan,2008-02-01,94,0,0,29,25,148
Afghanistan,2008-02-01,134,0,0,49,36,219
Afghanistan,2008-02-01,135,0,-2,33,23,189
Afghanistan,2008-02-01,66,0,0,8,4,78
Afghanistan,2008-02-01,77,0,-1,15,7,98
Afghanistan,2008-02-01,83,0,-6,-2,9,84
Afghanistan,2008-02-01,70,0,1,32,6,109
Afghanistan,2008-02-01,98,2,-2,0,8,106
Afghanistan,2008-02-01,108,4,0,33,21,166
Afghanistan,2008-02-01,149,0,0,67,5,221
Afghanistan,2008-02-01,103,0,0,30,2,135
Afghanistan,2008-02-01,325,0,2,8,13,348
Afghanistan,2008-02-01,224,2,3,86,24,339
Albania,2008-02-01,10,0,-7,3,0,6
Albania,2008-02-01,-1,0,-4,12,0,7
Albania,2008-02-01,3,0,-4,0,3,2
Albania,2008-02-01,30,0,-4,1,0,27
Albania,2008-02-01,17,0,-1,-2,0,14
Albania,2008-02-01,30,0,-3,0,0,27
Albania,2008-02-01,0,0,-7,2,1,-4
Albania,2008-02-01,10,0,-7,4,0,7
Albania,2008-02-01,3,0,-10,12,0,5
Albania,2008-02-01,1,0,-8,0,2,-5
Albania,2008-02-01,34,0,-4,3,3,36
Albania,2008-02-01,6,0,-2,0,1,5
Albania,2008-02-01,29,2,-6,0,8,33
Albania,2008-02-01,67,0,-14,6,3,62
Albania,2008-02-01,100,0,-26,7,17,98
Albania,2008-02-01,96,0,-16,3,9,92
Albania,2008-02-01,153,0,-35,3,23,144
Albania,2008-02-01,109,2,-22,35,29,153
Albania,2008-02-01,67,2,-10,6,23,88
Albania,2008-02-01,64,0,-8,-1,6,61
Albania,2008-02-01,115,0,-4,9,17,137
Albania,2008-02-01,130,0,-3,3,47,177
Albania,2008-02-01,44,0,-2,0,11,53
Albania,2008-02-01,54,0,0,3,8,65
Albania,2008-02-01,65,0,-3,12,21,95
Albania,2008-02-01,48,0,-4,0,7,51
Albania,2008-02-01,36,0,-5,3,1,35
Albania,2008-02-01,22,0,-3,0,0,19
Albania,2008-02-01,8,0,-1,0,2,9
Algeria,2008-02-01,8,0,0,6,0,14
Algeria,2008-02-01,2,0,0,0,0,2
Algeria,2008-02-01,0,0,0,0,0,0
Algeria,2008-02-01,12,0,0,3,1,16
Algeria,2008-02-01,5,0,0,0,3,8
Algeria,2008-02-01,0,0,0,0,0,0
Algeria,2008-02-01,3,0,0,0,1,4
Algeria,2008-02-01,12,0,0,6,2,20
Algeria,2008-02-01,3,0,0,15,3,21
Algeria,2008-02-01,10,0,0,3,3,16
Algeria,2008-02-01,0,0,0,-1,0,-1
Algeria,2008-02-01,-6,0,0,0,2,-4
Algeria,2008-02-01,-1,0,0,0,0,-1
Algeria,2008-02-01,4,0,0,33,2,39
Algeria,2008-02-01,2,0,0,0,0,2
Algeria,2008-02-01,9,2,0,7,0,18
Algeria,2008-02-01,3,0,0,9,0,12
Algeria,2008-02-01,0,0,1,6,1,8
Algeria,2008-02-01,42,0,0,0,3,45
Algeria,2008-02-01,-15,0,0,3,3,-9
Algeria,2008-02-01,0,0,-1,0,0,-1
Algeria,2008-02-01,0,0,0,0,0,0
Algeria,2008-02-01,15,0,0,-4,0,11
Algeria,2008-02-01,5,0,0,0,0,5
Algeria,2008-02-01,14,0,0,0,0,14
Algeria,2008-02-01,0,0,0,12,0,12
Algeria,2008-02-01,5,2,0,27,0,34
Algeria,2008-02-01,1,0,0,12,0,13
Algeria,2008-02-01,18,0,-2,-5,4,15
Bangladesh,2008-02-01,3,0,0,9,0,12
Bangladesh,2008-02-01,4,0,0,3,0,7
Bangladesh,2008-02-01,10,0,0,4,0,14
Bangladesh,2008-02-01,4,0,-4,18,1,19
Bangladesh,2008-02-01,13,0,0,-1,2,14
Bangladesh,2008-02-01,0,0,0,10,0,10
Bangladesh,2008-02-01,5,0,0,8,0,13
Bangladesh,2008-02-01,1,0,0,21,0,22
Bangladesh,2008-02-01,0,0,0,13,0,13
Bangladesh,2008-02-01,11,0,1,9,0,21
Bangladesh,2008-02-01,7,0,0,12,0,19
Bangladesh,2008-02-01,11,0,0,6,1,18
Bangladesh,2008-02-01,7,0,0,6,4,17
Bangladesh,2008-02-01,13,0,0,2,1,16
Bangladesh,2008-02-01,3,0,0,7,1,11
Bangladesh,2008-02-01,-1,0,0,3,0,2
Bangladesh,2008-02-01,0,0,0,9,0,9
Bangladesh,2008-02-01,8,0,0,3,1,12
Bangladesh,2008-02-01,8,0,0,-2,5,11
Bangladesh,2008-02-01,1,0,0,6,0,7
Bangladesh,2008-02-01,7,0,0,12,0,19
Bangladesh,2008-02-01,8,0,0,3,0,11
Bangladesh,2008-02-01,4,0,0,2,1,7
Bangladesh,2008-02-01,12,0,0,12,0,24
Bangladesh,2008-02-01,22,0,0,1,0,23
Bangladesh,2008-02-01,10,0,0,-4,1,7
Bangladesh,2008-02-01,2,0,1,15,0,18
Bangladesh,2008-02-01,9,0,0,3,1,13
Bangladesh,2008-02-01,0,0,0,9,0,9
Cameroon,2008-02-01,0,0,0,0,0,0
Cameroon,2008-02-01,20,0,0,0,0,20
Cameroon,2008-02-01,23,0,0,0,0,23
Cameroon,2008-02-01,30,0,0,0,0,30
Cameroon,2008-02-01,66,0,1,1,1,69
Cameroon,2008-02-01,36,0,0,11,0,47
Cameroon,2008-02-01,18,0,0,6,0,24
Cameroon,2008-02-01,33,0,0,1,0,34
Cameroon,2008-02-01,7,0,-4,0,0,3
Cameroon,2008-02-01,9,0,0,0,0,9
Cameroon,2008-02-01,14,0,0,6,2,22
Cameroon,2008-02-01,0,0,0,6,0,6
Cameroon,2008-02-01,0,0,0,0,0,0
Cameroon,2008-02-01,2,0,0,3,1,6
Cameroon,2008-02-01,0,0,0,6,0,6
Cameroon,2008-02-01,0,0,0,3,0,3
Cameroon,2008-02-01,-9,0,0,1,0,-8
Cameroon,2008-02-01,-1,0,0,6,0,5
Cameroon,2008-02-01,0,0,0,3,0,3
Cameroon,2008-02-01,0,0,0,5,0,5
Cameroon,2008-02-01,21,0,-2,12,2,33
Cameroon,2008-02-01,0,0,0,0,0,0
Cameroon,2008-02-01,0,0,0,0,0,0
Cameroon,2008-02-01,1,0,0,0,0,1
Cameroon,2008-02-01,-4,0,0,0,0,-4
Cameroon,2008-02-01,0,0,0,0,3,3
Cameroon,2008-02-01,2,2,0,0,3,7
Cameroon,2008-02-01,9,0,0,0,0,9
China,2008-02-01,75,0,-2,28,5,106
China,2008-02-01,71,4,0,28,3,106
China,2008-02-01,94,4,0,9,3,110
China,2008-02-01,93,2,1,76,6,178
China,2008-02-01,102,2,-2,48,4,154
China,2008-02-01,72,0,0,44,6,122
China,2008-02-01,73,0,-1,23,6,101
China,2008-02-01,55,0,-4,24,4,79
China,2008-02-01,43,0,0,0,3,46
China,2008-02-01,43,0,-1,34,8,84
China,2008-02-01,18,0,-4,239,3,256
China,2008-02-01,100,0,-3,121,2,220
China,2008-02-01,101,2,3,38,8,152
China,2008-02-01,85,10,-2,33,12,138
China,2008-02-01,112,0,-4,41,12,161
China,2008-02-01,51,0,-4,22,4,73
China,2008-02-01,72,0,4,11,8,95
China,2008-02-01,191,0,1,22,4,218
China,2008-02-01,160,0,-8,37,9,198
China,2008-02-01,140,0,-7,29,17,179
China,2008-02-01,199,0,0,69,14,282
China,2008-02-01,59,2,-7,32,2,88
China,2008-02-01,44,0,-3,22,10,73
China,2008-02-01,38,0,-1,15,9,61
China,2008-02-01,57,4,-1,52,13,125
China,2008-02-01,71,0,5,24,5,105
China,2008-02-01,42,0,9,50,9,110
China,2008-02-01,78,0,2,22,4,106
China,2008-02-01,95,0,-1,70,7,171
Egypt,2008-02-01,41,0,23,-2,5,67
Egypt,2008-02-01,47,0,7,27,6,87
Egypt,2008-02-01,158,0,9,46,9,222
Egypt,2008-02-01,256,0,10,43,75,384
Egypt,2008-02-01,215,0,18,55,37,325
Egypt,2008-02-01,116,0,6,4,5,131
Egypt,2008-02-01,133,4,1,46,19,203
Egypt,2008-02-01,32,0,5,2,0,39
Egypt,2008-02-01,50,0,3,8,3,64
Egypt,2008-02-01,41,0,1,26,3,71
Egypt,2008-02-01,40,0,5,6,2,53
Egypt,2008-02-01,20,0,2,4,0,26
Egypt,2008-02-01,9,4,-1,28,3,43
Egypt,2008-02-01,24,0,4,5,10,43
Egypt,2008-02-01,23,0,0,7,2,32
Egypt,2008-02-01,38,0,0,22,1,61
Egypt,2008-02-01,23,0,0,8,0,31
Egypt,2008-02-01,56,0,-2,7,2,63
Egypt,2008-02-01,44,0,0,18,3,65
Egypt,2008-02-01,8,0,2,24,4,38
Egypt,2008-02-01,16,0,0,9,4,29
Egypt,2008-02-01,11,0,0,2,0,13
Egypt,2008-02-01,8,0,0,22,1,31
Egypt,2008-02-01,58,0,7,9,11,85
Egypt,2008-02-01,122,0,2,13,3,140
Egypt,2008-02-01,30,0,0,34,1,65
Egypt,2008-02-01,56,0,0,-2,2,56
Egypt,2008-02-01,65,0,0,21,0,86
Egypt,2008-02-01,39,0,0,6,0,45
Eritrea,2008-02-01,2,0,1,0,0,3
Eritrea,2008-02-01,1,0,0,0,0,1
Eritrea,2008-02-01,5,0,0,0,2,7
Eritrea,2008-02-01,-2,0,0,3,0,1
Eritrea,2008-02-01,3,0,0,0,0,3
Eritrea,2008-02-01,4,0,0,9,0,13
Eritrea,2008-02-01,0,0,0,0,0,0
Eritrea,2008-02-01,0,0,0,0,0,0
Eritrea,2008-02-01,3,0,0,0,0,3
Eritrea,2008-02-01,8,0,0,0,0,8
Eritrea,2008-02-01,3,0,0,0,0,3
Eritrea,2008-02-01,40,0,0,0,0,40
Eritrea,2008-02-01,14,0,0,0,2,16
Eritrea,2008-02-01,2,0,0,-4,0,-2
Eritrea,2008-02-01,3,0,0,0,0,3
Eritrea,2008-02-01,24,0,0,3,0,27
Eritrea,2008-02-01,3,0,0,9,0,12
Eritrea,2008-02-01,24,0,0,0,0,24
Eritrea,2008-02-01,19,0,0,15,2,36
Eritrea,2008-02-01,0,0,0,-3,0,-3
Eritrea,2008-02-01,6,0,0,-8,0,-2
Eritrea,2008-02-01,9,0,0,2,0,11
Eritrea,2008-02-01,0,0,0,6,0,6
Eritrea,2008-02-01,7,0,0,7,0,14
Eritrea,2008-02-01,1,0,0,0,0,1
Georgia,2008-02-01,17,0,0,21,0,38
Georgia,2008-02-01,4,0,0,6,1,11
Georgia,2008-02-01,7,0,0,7,0,14
Georgia,2008-02-01,16,0,0,5,0,21
Georgia,2008-02-01,16,0,0,8,1,25
Georgia,2008-02-01,20,0,0,6,4,30
Georgia,2008-02-01,17,0,0,3,0,20
Georgia,2008-02-01,4,0,0,3,3,10
Georgia,2008-02-01,6,0,0,0,0,6
Georgia,2008-02-01,9,0,-1,-1,4,11
Georgia,2008-02-01,10,0,-2,5,0,13
Georgia,2008-02-01,19,0,0,9,0,28
Georgia,2008-02-01,28,0,0,9,4,41
Georgia,2008-02-01,39,0,-2,3,2,42
Georgia,2008-02-01,7,0,0,-1,1,7
Georgia,2008-02-01,3,0,0,-2,2,3
Georgia,2008-02-01,12,0,0,-2,2,12
Georgia,2008-02-01,3,0,0,3,1,7
Georgia,2008-02-01,12,0,-2,1,3,14
Georgia,2008-02-01,7,0,0,4,2,13
Georgia,2008-02-01,20,0,-1,4,2,25
Georgia,2008-02-01,3,2,0,4,0,9
Georgia,2008-02-01,0,2,1,3,0,6
Georgia,2008-02-01,0,0,0,0,3,3
Georgia,2008-02-01,5,0,0,13,1,19
Georgia,2008-02-01,4,0,-1,0,2,5
Georgia,2008-02-01,6,0,0,7,0,13
Georgia,2008-02-01,16,0,0,18,0,34
Georgia,2008-02-01,23,0,-1,6,2,30
India,2008-02-01,37,0,0,5,5,47
India,2008-02-01,25,0,1,4,2,32
India,2008-02-01,42,0,0,8,4,54
India,2008-02-01,30,0,0,13,8,51
India,2008-02-01,29,0,-1,14,3,45
India,2008-02-01,27,0,0,9,2,38
India,2008-02-01,34,0,-3,34,3,68
India,2008-02-01,60,0,0,25,10,95
India,2008-02-01,10,0,-1,6,3,18
India,2008-02-01,49,2,-1,13,0,63
India,2008-02-01,31,2,0,15,0,48
India,2008-02-01,28,0,1,12,6,47
India,2008-02-01,31,2,-1,23,4,59
India,2008-02-01,34,0,0,1,2,37
India,2008-02-01,38,0,-2,8,10,54
India,2008-02-01,22,0,0,7,4,33
India,2008-02-01,33,0,0,6,1,40
India,2008-02-01,26,2,-1,1,0,28
India,2008-02-01,13,0,0,3,1,17
India,2008-02-01,24,0,-2,9,6,37
India,2008-02-01,45,2,-5,12,1,55
India,2008-02-01,18,0,0,18,3,39
India,2008-02-01,15,0,-2,0,3,16
India,2008-02-01,15,0,0,8,5,28
India,2008-02-01,32,0,0,4,5,41
India,2008-02-01,25,0,0,7,2,34
India,2008-02-01,18,0,0,17,9,44
India,2008-02-01,13,0,0,3,2,18
India,2008-02-01,18,0,0,16,4,38
Iran,2008-02-01,20,0,1,6,1,28
Iran,2008-02-01,14,0,0,8,3,25
Iran,2008-02-01,35,0,0,24,0,59
Iran,2008-02-01,44,0,-2,15,4,61
Iran,2008-02-01,15,0,1,19,5,40
Iran,2008-02-01,20,0,1,33,3,57
Iran,2008-02-01,26,2,2,11,2,43
Iran,2008-02-01,16,0,0,8,5,29
Iran,2008-02-01,19,0,0,6,2,27
Iran,2008-02-01,35,0,0,18,6,59
Iran,2008-02-01,28,0,0,11,6,45
Iran,2008-02-01,54,0,0,26,3,83
Iran,2008-02-01,107,0,3,14,7,131
Iran,2008-02-01,93,0,0,7,20,120
Iran,2008-02-01,94,0,0,3,26,123
Iran,2008-02-01,42,0,0,10,1,53
Iran,2008-02-01,68,0,1,10,5,84
Iran,2008-02-01,65,0,-7,19,2,79
Iran,2008-02-01,37,0,1,31,2,71
Iran,2008-02-01,47,0,8,-4,17,68
Iran,2008-02-01,70,0,7,12,6,95
Iran,2008-02-01,29,0,4,13,9,55
Iran,2008-02-01,15,0,1,7,10,33
Iran,2008-02-01,17,0,1,0,0,18
Iran,2008-02-01,76,0,1,11,1,89
Iran,2008-02-01,57,0,3,13,0,73
Iran,2008-02-01,48,0,0,26,5,79
Iran,2008-02-01,52,0,0,9,12,73
Iran,2008-02-01,36,2,0,27,4,69
Iraq,2008-02-01,112,0,0,30,8,150
Iraq,2008-02-01,79,2,14,30,2,127
Iraq,2008-02-01,121,0,1,-4,2,120
Iraq,2008-02-01,241,0,5,42,6,294
Iraq,2008-02-01,251,2,2,24,9,288
Iraq,2008-02-01,229,0,-1,16,10,254
Iraq,2008-02-01,71,0,1,34,7,113
Iraq,2008-02-01,85,2,-1,24,25,135
Iraq,2008-02-01,69,0,2,18,8,97
Iraq,2008-02-01,83,0,0,34,20,137
Iraq,2008-02-01,79,0,-2,33,14,124
Iraq,2008-02-01,65,10,13,74,12,174
Iraq,2008-02-01,113,4,1,-6,14,126
Iraq,2008-02-01,126,4,0,29,5,164
Iraq,2008-02-01,128,2,1,28,13,172
Iraq,2008-02-01,66,2,2,5,2,77
Iraq,2008-02-01,71,0,1,16,4,92
Iraq,2008-02-01,107,0,1,6,20,134
Iraq,2008-02-01,108,0,0,15,5,128
Iraq,2008-02-01,89,0,1,15,9,114
Iraq,2008-02-01,175,0,-7,9,19,196
Iraq,2008-02-01,304,0,-2,59,15,376
Iraq,2008-02-01,251,0,-2,21,11,281
Iraq,2008-02-01,288,0,4,43,19,354
Iraq,2008-02-01,323,0,-1,7,8,337
Iraq,2008-02-01,249,0,-1,21,14,283
Iraq,2008-02-01,292,0,-2,51,20,361
Iraq,2008-02-01,332,0,-4,59,31,418
Iraq,2008-02-01,291,14,2,77,25,409
Morocco,2008-02-01,4,0,0,1,0,5
Morocco,2008-02-01,0,0,0,0,0,0
Morocco,2008-02-01,6,0,0,0,0,6
Morocco,2008-02-01,9,0,0,3,0,12
Morocco,2008-02-01,3,0,0,0,0,3
Morocco,2008-02-01,0,0,0,3,0,3
Morocco,2008-02-01,15,0,0,3,0,18
Morocco,2008-02-01,9,0,0,30,0,39
Morocco,2008-02-01,2,0,0,-1,0,1
Morocco,2008-02-01,2,0,0,6,0,8
Morocco,2008-02-01,5,0,0,21,2,28
Morocco,2008-02-01,1,0,0,15,3,19
Morocco,2008-02-01,18,0,1,6,0,25
Morocco,2008-02-01,3,0,1,1,0,5
Morocco,2008-02-01,8,0,0,-8,0,0
Morocco,2008-02-01,1,0,0,10,0,11
Morocco,2008-02-01,5,0,0,0,1,6
Morocco,2008-02-01,11,0,0,16,0,27
Morocco,2008-02-01,6,0,0,18,2,26
Morocco,2008-02-01,13,0,1,18,2,34
Morocco,2008-02-01,0,0,0,3,0,3
Morocco,2008-02-01,4,0,0,15,0,19
Morocco,2008-02-01,-1,0,0,51,1,51
Morocco,2008-02-01,1,0,0,36,0,37
Morocco,2008-02-01,0,0,0,15,0,15
Morocco,2008-02-01,0,0,0,18,3,21
Morocco,2008-02-01,8,0,0,19,0,27
Morocco,2008-02-01,6,0,0,1,0,7
Morocco,2008-02-01,4,0,0,0,0,4
Nigeria,2008-02-01,-9,0,1,0,12,4
Nigeria,2008-02-01,3,0,0,0,0,3
Nigeria,2008-02-01,7,0,0,0,0,7
Nigeria,2008-02-01,42,0,0,0,0,42
Nigeria,2008-02-01,11,0,0,0,0,11
Nigeria,2008-02-01,11,0,0,0,0,11
Nigeria,2008-02-01,53,0,0,0,1,54
Nigeria,2008-02-01,12,0,0,6,0,18
Nigeria,2008-02-01,6,0,0,3,3,12
Nigeria,2008-02-01,8,0,0,0,0,8
Nigeria,2008-02-01,43,0,0,6,0,49
Nigeria,2008-02-01,5,2,0,0,2,9
Nigeria,2008-02-01,18,0,0,3,1,22
Nigeria,2008-02-01,2,0,0,3,0,5
Nigeria,2008-02-01,5,0,0,-6,0,-1
Nigeria,2008-02-01,5,0,0,0,0,5
Nigeria,2008-02-01,4,0,0,3,0,7
Nigeria,2008-02-01,10,0,-2,0,0,8
Nigeria,2008-02-01,3,0,0,0,2,5
Nigeria,2008-02-01,6,0,0,0,0,6
Nigeria,2008-02-01,13,2,0,3,1,19
Nigeria,2008-02-01,17,0,0,6,0,23
Nigeria,2008-02-01,1,0,0,0,1,2
Nigeria,2008-02-01,0,0,0,3,0,3
Nigeria,2008-02-01,4,0,0,12,3,19
Nigeria,2008-02-01,23,0,5,9,3,40
Nigeria,2008-02-01,36,0,0,0,3,39
Nigeria,2008-02-01,12,0,-2,0,1,11
Nigeria,2008-02-01,0,0,0,0,1,1
Pakistan,2008-02-01,88,0,-4,4,7,95
Pakistan,2008-02-01,24,0,-2,6,6,34
Pakistan,2008-02-01,33,0,-2,4,6,41
Pakistan,2008-02-01,69,0,-4,58,16,139
Pakistan,2008-02-01,105,0,-2,61,3,167
Pakistan,2008-02-01,89,0,-2,17,5,109
Pakistan,2008-02-01,82,8,-1,25,10,124
Pakistan,2008-02-01,89,0,0,11,1,101
Pakistan,2008-02-01,39,0,0,7,0,46
Pakistan,2008-02-01,79,0,0,42,12,133
Pakistan,2008-02-01,141,0,0,109,7,257
Pakistan,2008-02-01,75,4,0,26,9,114
Pakistan,2008-02-01,77,0,1,20,2,100
Pakistan,2008-02-01,46,0,0,30,2,78
Pakistan,2008-02-01,65,0,-2,35,12,110
Pakistan,2008-02-01,54,0,-4,41,25,116
Pakistan,2008-02-01,63,0,-1,-2,31,91
Pakistan,2008-02-01,78,0,-6,45,19,136
Pakistan,2008-02-01,102,0,-3,14,10,123
Pakistan,2008-02-01,93,2,-6,8,10,107
Pakistan,2008-02-01,97,0,-6,14,16,121
Pakistan,2008-02-01,21,0,-4,30,2,49
Pakistan,2008-02-01,42,0,-5,18,3,58
Pakistan,2008-02-01,62,0,-3,22,4,85
Pakistan,2008-02-01,43,0,0,59,1,103
Pakistan,2008-02-01,79,0,0,107,11,197
Pakistan,2008-02-01,51,0,-3,47,19,114
Pakistan,2008-02-01,85,0,0,23,6,114
Pakistan,2008-02-01,62,0,2,13,9,86
Sierra Leone,2008-02-01,5,0,0,12,0,17
Sierra Leone,2008-02-01,0,0,0,3,0,3
Sierra Leone,2008-02-01,2,0,0,6,0,8
Sierra Leone,2008-02-01,8,0,0,0,0,8
Sierra Leone,2008-02-01,11,0,0,0,0,11
Sierra Leone,2008-02-01,0,0,0,15,0,15
Sierra Leone,2008-02-01,3,0,0,4,1,8
Sierra Leone,2008-02-01,8,0,0,0,2,10
Sierra Leone,2008-02-01,2,0,0,6,0,8
Sierra Leone,2008-02-01,0,0,0,0,0,0
Sierra Leone,2008-02-01,0,0,0,0,0,0
Sierra Leone,2008-02-01,0,0,0,0,0,0
Sierra Leone,2008-02-01,0,0,0,0,0,0
Sierra Leone,2008-02-01,1,0,0,0,0,1
Sierra Leone,2008-02-01,1,0,0,0,0,1
Sierra Leone,2008-02-01,0,0,0,3,0,3
Sierra Leone,2008-02-01,1,0,1,21,0,23
Sierra Leone,2008-02-01,3,0,0,0,0,3
Sierra Leone,2008-02-01,3,0,0,0,0,3
Sierra Leone,2008-02-01,0,0,0,0,0,0
Sierra Leone,2008-02-01,0,0,0,-6,0,-6
Sierra Leone,2008-02-01,4,0,0,3,0,7
Sierra Leone,2008-02-01,0,0,0,0,0,0
Somalia,2008-02-01,1,0,0,2,2,5
Somalia,2008-02-01,7,0,0,0,0,7
Somalia,2008-02-01,0,0,0,0,0,0
Somalia,2008-02-01,1,0,0,11,0,12
Somalia,2008-02-01,24,0,0,0,0,24
Somalia,2008-02-01,34,0,0,0,0,34
Somalia,2008-02-01,9,0,0,-2,0,7
Somalia,2008-02-01,20,0,0,20,0,40
Somalia,2008-02-01,9,0,0,5,0,14
Somalia,2008-02-01,29,0,0,2,0,31
Somalia,2008-02-01,4,0,0,6,0,10
Somalia,2008-02-01,11,0,0,3,0,14
Somalia,2008-02-01,11,0,0,-4,0,7
Somalia,2008-02-01,17,0,0,0,0,17
Somalia,2008-02-01,7,0,0,4,2,13
Somalia,2008-02-01,9,0,0,0,2,11
Somalia,2008-02-01,9,0,0,2,2,13
Somalia,2008-02-01,2,0,0,3,0,5
Somalia,2008-02-01,-3,0,0,-2,0,-5
Somalia,2008-02-01,-1,0,0,0,0,-1
Somalia,2008-02-01,-1,0,0,0,1,0
Somalia,2008-02-01,2,0,0,3,0,5
Somalia,2008-02-01,5,0,0,3,0,8
Somalia,2008-02-01,5,0,0,0,0,5
Somalia,2008-02-01,6,0,0,3,0,9
Somalia,2008-02-01,8,0,0,3,0,11
Somalia,2008-02-01,18,0,0,3,0,21
Somalia,2008-02-01,61,0,-2,11,2,72
Somalia,2008-02-01,25,2,0,19,0,46
Syria,2008-02-01,36,0,0,3,2,41
Syria,2008-02-01,14,0,0,12,1,27
Syria,2008-02-01,7,0,0,6,0,13
Syria,2008-02-01,2,0,0,6,1,9
Syria,2008-02-01,22,0,0,18,1,41
Syria,2008-02-01,56,0,0,0,1,57
Syria,2008-02-01,25,0,0,0,0,25
Syria,2008-02-01,14,0,1,0,1,16
Syria,2008-02-01,5,0,2,0,0,7
Syria,2008-02-01,63,0,-1,5,5,72
Syria,2008-02-01,29,0,0,6,2,37
Syria,2008-02-01,5,0,0,9,8,22
Syria,2008-02-01,45,0,1,0,14,60
Syria,2008-02-01,55,0,1,0,15,71
Syria,2008-02-01,27,0,0,0,2,29
Syria,2008-02-01,17,0,0,13,0,30
Syria,2008-02-01,9,0,0,1,0,10
Syria,2008-02-01,36,0,0,21,0,57
Syria,2008-02-01,53,0,0,39,0,92
Syria,2008-02-01,26,0,0,9,4,39
Syria,2008-02-01,56,0,0,6,5,67
Syria,2008-02-01,13,0,0,20,11,44
Syria,2008-02-01,18,0,0,11,0,29
Syria,2008-02-01,1,0,0,1,0,2
Syria,2008-02-01,2,0,0,0,0,2
Syria,2008-02-01,19,0,0,0,0,19
Syria,2008-02-01,15,0,0,-1,0,14
Syria,2008-02-01,7,0,-4,18,2,23
Syria,2008-02-01,9,0,0,-9,0,0
Yemen,2008-02-01,13,0,0,0,0,13
Yemen,2008-02-01,6,0,0,0,0,6
Yemen,2008-02-01,0,0,0,0,0,0
Yemen,2008-02-01,3,0,0,0,0,3
Yemen,2008-02-01,13,0,0,0,0,13
Yemen,2008-02-01,14,0,0,15,0,29
Yemen,2008-02-01,29,0,0,27,0,56
Yemen,2008-02-01,31,2,0,21,0,54
Yemen,2008-02-01,12,0,0,15,1,28
Yemen,2008-02-01,9,0,0,12,0,21
Yemen,2008-02-01,11,0,0,0,0,11
Yemen,2008-02-01,0,0,-1,0,2,1
Yemen,2008-02-01,16,0,-1,1,0,16
Yemen,2008-02-01,19,0,0,0,8,27
Yemen,2008-02-01,0,0,0,0,0,0
Yemen,2008-02-01,3,0,0,7,0,10
Yemen,2008-02-01,0,0,-1,0,0,-1
Yemen,2008-02-01,15,0,0,3,0,18
Yemen,2008-02-01,10,0,0,0,4,14
Yemen,2008-02-01,2,0,0,12,3,17
Yemen,2008-02-01,0,0,0,12,0,12
Yemen,2008-02-01,1,0,0,33,0,34
Yemen,2008-02-01,10,0,0,0,0,10
Yemen,2008-02-01,9,0,0,0,0,9
Yemen,2008-02-01,20,0,0,6,2,28
Yemen,2008-02-01,21,0,0,0,2,23
Yemen,2008-02-01,28,0,0,9,1,38
Afghanistan,2013-01-01,81,0,0,-13,4,72
Afghanistan,2013-01-01,112,0,0,32,2,146
Afghanistan,2013-01-01,298,0,0,55,18,371
Afghanistan,2013-01-01,94,0,0,17,12,123
Afghanistan,2013-01-01,52,0,0,10,4,66
Afghanistan,2013-01-01,174,0,-2,-6,21,187
Afghanistan,2013-01-01,182,0,-5,-3,15,189
Afghanistan,2013-01-01,146,0,0,37,19,202
Afghanistan,2013-01-01,71,4,-1,-10,19,83
Afghanistan,2013-01-01,110,2,-3,58,12,179
Afghanistan,2013-01-01,241,0,-13,49,17,294
Afghanistan,2013-01-01,156,0,0,40,10,206
Afghanistan,2013-01-01,121,0,0,20,14,155
Afghanistan,2013-01-01,115,4,-2,14,11,142
Afghanistan,2013-01-01,154,0,0,18,3,175
Afghanistan,2013-01-01,212,0,-2,89,26,325
Afghanistan,2013-01-01,256,2,-1,18,11,286
Afghanistan,2013-01-01,103,4,0,17,4,128
Afghanistan,2013-01-01,88,0,0,29,10,127
Afghanistan,2013-01-01,48,2,0,15,3,68
Afghanistan,2013-01-01,268,0,-4,15,18,297
Afghanistan,2013-01-01,165,0,0,50,7,222
Afghanistan,2013-01-01,66,0,0,21,1,88
Afghanistan,2013-01-01,231,0,1,54,14,300
Afghanistan,2013-01-01,217,2,0,38,33,290
Afghanistan,2013-01-01,115,2,-2,5,6,126
Afghanistan,2013-01-01,78,0,-4,0,14,88
Afghanistan,2013-01-01,114,2,0,15,7,138
Afghanistan,2013-01-01,104,0,-3,4,8,113
Afghanistan,2013-01-01,174,2,-1,18,11,204
Afghanistan,2013-01-01,172,0,-6,33,21,220
Albania,2013-01-01,0,0,-1,3,0,2
Albania,2013-01-01,0,0,0,0,0,0
Albania,2013-01-01,0,0,0,6,0,6
Albania,2013-01-01,0,0,0,9,2,11
Albania,2013-01-01,4,0,0,0,4,8
Albania,2013-01-01,0,0,0,0,1,1
Albania,2013-01-01,6,0,0,0,2,8
Albania,2013-01-01,3,0,0,0,0,3
Albania,2013-01-01,1,0,0,6,0,7
Albania,2013-01-01,0,0,0,3,0,3
Albania,2013-01-01,3,0,-1,0,0,2
Albania,2013-01-01,0,0,0,3,0,3
Albania,2013-01-01,4,0,0,9,0,13
Albania,2013-01-01,5,0,0,3,0,8
Albania,2013-01-01,0,0,0,1,0,1
Albania,2013-01-01,21,0,0,0,0,21
Albania,2013-01-01,9,0,0,0,2,11
Albania,2013-01-01,1,0,0,0,3,4
Albania,2013-01-01,6,0,0,0,0,6
Albania,2013-01-01,18,0,0,0,0,18
Albania,2013-01-01,7,0,0,0,15,22
Albania,2013-01-01,1,0,0,0,4,5
Albania,2013-01-01,4,0,0,0,0,4
Albania,2013-01-01,4,0,0,0,0,4
Albania,2013-01-01,3,0,0,0,2,5
Albania,2013-01-01,2,0,0,0,0,2
Albania,2013-01-01,-1,0,0,0,0,-1
Albania,2013-01-01,0,0,0,0,0,0
Albania,2013-01-01,2,0,0,0,1,3
Albania,2013-01-01,0,0,0,0,0,0
Algeria,2013-01-01,598,2,-4,191,69,856
Algeria,2013-01-01,93,0,0,34,4,131
Algeria,2013-01-01,69,0,-2,14,6,87
Algeria,2013-01-01,714,10,-4,228,67,1015
Algeria,2013-01-01,20,0,-8,3,1,16
Algeria,2013-01-01,-3,0,-2,3,0,-2
Algeria,2013-01-01,226,2,-2,30,43,299
Algeria,2013-01-01,181,0,0,46,17,244
Algeria,2013-01-01,4,0,0,12,0,16
Algeria,2013-01-01,12,0,0,9,0,21
Algeria,2013-01-01,5,0,0,0,0,5
Algeria,2013-01-01,119,0,0,20,9,148
Algeria,2013-01-01,447,10,-4,64,45,562
Algeria,2013-01-01,226,2,0,88,31,347
Algeria,2013-01-01,45,0,0,24,3,72
Algeria,2013-01-01,312,0,0,226,40,578
Algeria,2013-01-01,799,8,1,272,93,1173
Algeria,2013-01-01,751,2,1,206,87,1047
Algeria,2013-01-01,551,0,-2,234,87,870
Algeria,2013-01-01,186,0,0,22,40,248
Algeria,2013-01-01,1061,6,-3,222,162,1448
Algeria,2013-01-01,279,0,0,54,39,372
Algeria,2013-01-01,97,0,0,24,8,129
Algeria,2013-01-01,324,8,-1,73,26,430
Algeria,2013-01-01,127,0,2,48,4,181
Algeria,2013-01-01,86,0,0,6,1,93
Algeria,2013-01-01,60,0,0,1,4,65
Algeria,2013-01-01,64,0,2,21,14,101
Algeria,2013-01-01,76,0,0,10,2,88
Algeria,2013-01-01,57,0,0,-1,3,59
Algeria,2013-01-01,38,0,0,27,6,71
Bangladesh,2013-01-01,22,0,0,0,4,26
Bangladesh,2013-01-01,16,0,0,0,4,20
Bangladesh,2013-01-01,16,0,0,-6,2,12
Bangladesh,2013-01-01,9,0,0,6,5,20
Bangladesh,2013-01-01,8,0,0,6,1,15
Bangladesh,2013-01-01,7,0,0,7,1,15
Bangladesh,2013-01-01,25,0,0,8,0,33
Bangladesh,2013-01-01,17,0,1,7,2,27
Bangladesh,2013-01-01,22,0,0,22,5,49
Bangladesh,2013-01-01,13,0,0,-1,4,16
Bangladesh,2013-01-01,39,0,0,24,1,64
Bangladesh,2013-01-01,11,0,1,22,1,35
Bangladesh,2013-01-01,22,0,1,3,5,31
Bangladesh,2013-01-01,30,0,0,3,1,34
Bangladesh,2013-01-01,31,0,0,14,4,49
Bangladesh,2013-01-01,28,0,0,6,10,44
Bangladesh,2013-01-01,1,0,-4,-1,3,-1
Bangladesh,2013-01-01,5,0,1,6,3,15
Bangladesh,2013-01-01,7,0,0,-4,13,16
Bangladesh,2013-01-01,2,0,0,0,0,2
Bangladesh,2013-01-01,34,2,1,62,25,124
Bangladesh,2013-01-01,43,0,0,36,6,85
Bangladesh,2013-01-01,10,0,0,30,3,43
Bangladesh,2013-01-01,22,0,2,28,11,63
Bangladesh,2013-01-01,3,0,0,-5,1,-1
Bangladesh,2013-01-01,22,0,0,0,0,22
Bangladesh,2013-01-01,31,0,0,10,1,42
Bangladesh,2013-01-01,42,0,0,16,4,62
Bangladesh,2013-01-01,7,0,0,6,1,14
Bangladesh,2013-01-01,29,0,2,-4,8,35
Bangladesh,2013-01-01,13,0,0,15,0,28
Cameroon,2013-01-01,1,0,0,3,0,4
Cameroon,2013-01-01,-4,0,0,1,2,-1
Cameroon,2013-01-01,19,0,0,0,0,19
Cameroon,2013-01-01,1,0,0,0,0,1
Cameroon,2013-01-01,0,0,0,0,0,0
Cameroon,2013-01-01,0,0,0,0,0,0
Cameroon,2013-01-01,0,0,0,2,0,2
Cameroon,2013-01-01,2,0,0,-2,0,0
Cameroon,2013-01-01,0,0,0,17,0,17
Cameroon,2013-01-01,-2,0,0,18,0,16
Cameroon,2013-01-01,0,0,0,0,0,0
Cameroon,2013-01-01,0,0,0,0,0,0
Cameroon,2013-01-01,0,0,0,0,0,0
Cameroon,2013-01-01,2,0,0,3,0,5
Cameroon,2013-01-01,0,0,0,0,0,0
Cameroon,2013-01-01,3,0,0,0,0,3
Cameroon,2013-01-01,0,0,0,0,0,0
Cameroon,2013-01-01,0,0,0,0,0,0
Cameroon,2013-01-01,1,0,0,0,0,1
Cameroon,2013-01-01,0,0,0,0,0,0
Cameroon,2013-01-01,0,0,0,3,0,3
Cameroon,2013-01-01,-1,0,0,0,0,-1
Cameroon,2013-01-01,2,0,0,0,0,2
Cameroon,2013-01-01,-3,0,0,15,0,12
China,2013-01-01,52,0,4,60,4,120
China,2013-01-01,123,0,-3,113,24,257
China,2013-01-01,150,0,1,74,14,239
China,2013-01-01,88,2,0,120,18,228
China,2013-01-01,92,0,-2,52,9,151
China,2013-01-01,60,0,-13,44,6,97
China,2013-01-01,155,2,0,100,15,272
China,2013-01-01,192,2,-4,10,19,219
China,2013-01-01,114,4,-1,95,10,222
China,2013-01-01,163,2,-4,53,15,229
China,2013-01-01,131,2,0,12,8,153
China,2013-01-01,129,0,0,22,4,155
China,2013-01-01,85,0,0,56,12,153
China,2013-01-01,157,2,-3,94,12,262
China,2013-01-01,168,0,-30,50,20,208
China,2013-01-01,157,0,-12,68,27,240
China,2013-01-01,123,0,-10,47,12,172
China,2013-01-01,134,2,-14,51,23,196
China,2013-01-01,69,0,1,45,12,127
China,2013-01-01,32,0,0,15,5,52
China,2013-01-01,130,6,-3,16,6,155
China,2013-01-01,159,4,0,29,11,203
China,2013-01-01,49,0,-4,23,10,78
China,2013-01-01,74,0,-2,37,24,133
China,2013-01-01,108,2,-3,78,25,210
China,2013-01-01,116,0,3,15,11,145
China,2013-01-01,83,2,0,23,2,110
China,2013-01-01,107,2,-6,55,15,173
China,2013-01-01,119,2,-4,52,12,181
China,2013-01-01,93,0,-6,76,23,186
China,2013-01-01,201,4,5,80,20,310
Egypt,2013-01-01,58,0,-1,64,8,129
Egypt,2013-01-01,47,0,-6,83,11,135
Egypt,2013-01-01,46,0,0,43,2,91
Egypt,2013-01-01,79,0,1,24,19,123
Egypt,2013-01-01,37,0,-10,28,20,75
Egypt,2013-01-01,56,4,-4,11,4,71
Egypt,2013-01-01,76,0,-6,11,10,91
Egypt,2013-01-01,76,2,-2,48,18,142
Egypt,2013-01-01,34,0,0,37,14,85
Egypt,2013-01-01,69,0,0,26,0,95
Egypt,2013-01-01,49,0,0,22,1,72
Egypt,2013-01-01,44,0,0,29,4,77
Egypt,2013-01-01,69,0,-2,61,1,129
Egypt,2013-01-01,78,2,0,44,9,133
Egypt,2013-01-01,47,0,1,35,4,87
Egypt,2013-01-01,52,0,0,15,5,72
Egypt,2013-01-01,32,0,0,24,10,66
Egypt,2013-01-01,36,2,0,12,4,54
Egypt,2013-01-01,30,0,1,6,1,38
Egypt,2013-01-01,16,0,0,0,4,20
Egypt,2013-01-01,138,0,-1,41,19,197
Egypt,2013-01-01,53,0,0,45,27,125
Egypt,2013-01-01,20,0,0,-5,12,27
Egypt,2013-01-01,105,0,0,30,33,168
Egypt,2013-01-01,130,0,-2,42,35,205
Egypt,2013-01-01,78,0,1,8,13,100
Egypt,2013-01-01,75,0,0,23,18,116
Egypt,2013-01-01,61,2,1,58,15,137
Egypt,2013-01-01,58,0,-4,54,10,118
Egypt,2013-01-01,61,0,-5,17,16,89
Egypt,2013-01-01,68,0,-3,8,13,86
Eritrea,2013-01-01,6,0,0,25,8,39
Eritrea,2013-01-01,2,0,0,0,1,3
Eritrea,2013-01-01,0,0,0,9,4,13
Eritrea,2013-01-01,3,0,0,0,0,3
Eritrea,2013-01-01,0,0,0,-4,0,-4
Eritrea,2013-01-01,9,0,0,0,0,9
Eritrea,2013-01-01,0,0,0,0,0,0
Eritrea,2013-01-01,0,0,0,3,0,3
Eritrea,2013-01-01,3,0,0,-3,0,0
Eritrea,2013-01-01,0,0,0,0,4,4
Eritrea,2013-01-01,0,0,0,3,0,3
Eritrea,2013-01-01,0,0,0,0,0,0
Eritrea,2013-01-01,0,0,0,0,0,0
Eritrea,2013-01-01,3,0,0,6,0,9
Eritrea,2013-01-01,0,0,0,3,0,3
Eritrea,2013-01-01,0,0,0,-2,0,-2
Eritrea,2013-01-01,0,0,0,4,0,4
Eritrea,2013-01-01,3,0,0,-7,0,-4
Eritrea,2013-01-01,3,0,0,3,0,6
Eritrea,2013-01-01,0,0,0,0,0,0
Eritrea,2013-01-01,0,0,0,1,0,1
Eritrea,2013-01-01,0,0,0,0,0,0
Eritrea,2013-01-01,3,0,0,0,2,5
Eritrea,2013-01-01,0,0,0,0,0,0
Eritrea,2013-01-01,0,0,0,-4,1,-3
Eritrea,2013-01-01,17,0,0,17,1,35
Eritrea,2013-01-01,4,0,0,-2,1,3
Georgia,2013-01-01,0,0,0,0,0,0
Georgia,2013-01-01,0,0,0,-2,0,-2
Georgia,2013-01-01,6,0,0,0,0,6
Georgia,2013-01-01,1,0,-2,0,2,1
Georgia,2013-01-01,0,0,0,0,0,0
Georgia,2013-01-01,0,0,0,0,0,0
Georgia,2013-01-01,-1,0,0,0,0,-1
Georgia,2013-01-01,3,0,0,0,1,4
Georgia,2013-01-01,4,0,0,0,0,4
Georgia,2013-01-01,4,0,0,7,0,11
Georgia,2013-01-01,2,0,0,3,0,5
Georgia,2013-01-01,1,0,0,-3,0,-2
Georgia,2013-01-01,0,0,0,-4,0,-4
Georgia,2013-01-01,6,0,2,-3,0,5
Georgia,2013-01-01,5,0,-2,-5,0,-2
Georgia,2013-01-01,28,0,0,6,1,35
Georgia,2013-01-01,-6,0,0,6,0,0
Georgia,2013-01-01,2,0,0,0,0,2
Georgia,2013-01-01,0,0,0,3,0,3
Georgia,2013-01-01,2,0,0,4,0,6
Georgia,2013-01-01,-1,0,0,1,1,1
Georgia,2013-01-01,5,0,-1,0,1,5
Georgia,2013-01-01,2,0,-4,0,0,-2
Georgia,2013-01-01,5,0,0,-4,2,3
Georgia,2013-01-01,9,0,3,-2,0,10
Georgia,2013-01-01,336,0,4,139,46,525
Georgia,2013-01-01,0,0,0,6,0,6
Georgia,2013-01-01,-2,0,0,-2,0,-4
Georgia,2013-01-01,7,0,0,3,3,13
Georgia,2013-01-01,1,0,0,0,0,1
Georgia,2013-01-01,3,0,0,6,2,11
India,2013-01-01,42,0,1,-2,8,49
India,2013-01-01,47,0,1,20,13,81
India,2013-01-01,52,2,1,5,22,82
India,2013-01-01,53,0,0,6,16,75
India,2013-01-01,60,0,-1,5,11,75
India,2013-01-01,92,2,-1,6,24,123
India,2013-01-01,64,2,-2,19,9,92
India,2013-01-01,77,0,-1,20,8,104
India,2013-01-01,73,2,1,14,18,108
India,2013-01-01,114,0,-1,16,31,160
India,2013-01-01,33,0,0,1,16,50
India,2013-01-01,48,0,-1,10,9,66
India,2013-01-01,48,0,1,31,10,90
India,2013-01-01,60,6,0,15,18,99
India,2013-01-01,69,0,-1,27,24,119
India,2013-01-01,84,2,-2,40,18,142
India,2013-01-01,70,0,2,14,13,99
India,2013-01-01,47,2,-6,3,9,55
India,2013-01-01,47,0,1,13,5,66
India,2013-01-01,15,0,0,9,5,29
India,2013-01-01,53,0,-2,1,13,65
India,2013-01-01,77,0,1,-2,12,88
India,2013-01-01,36,0,-2,19,8,61
India,2013-01-01,90,0,-1,17,17,123
India,2013-01-01,54,0,-2,15,12,79
India,2013-01-01,49,0,0,16,12,77
India,2013-01-01,46,0,-2,8,2,54
India,2013-01-01,72,2,2,25,7,108
India,2013-01-01,62,2,-5,10,6,75
India,2013-01-01,45,0,-6,8,7,54
India,2013-01-01,39,2,-1,0,6,46
Iran,2013-01-01,23,0,0,16,4,43
Iran,2013-01-01,16,0,0,11,2,29
Iran,2013-01-01,42,0,0,42,4,88
Iran,2013-01-01,58,0,1,61,15,135
Iran,2013-01-01,38,4,-1,37,1,79
Iran,2013-01-01,73,0,2,27,3,105
Iran,2013-01-01,119,2,1,24,12,158
Iran,2013-01-01,177,0,-2,94,12,281
Iran,2013-01-01,211,4,-3,22,20,254
Iran,2013-01-01,86,6,-1,37,19,147
Iran,2013-01-01,71,6,1,32,6,116
Iran,2013-01-01,41,0,-1,45,9,94
Iran,2013-01-01,117,0,-2,26,11,152
Iran,2013-01-01,95,2,-8,30,12,131
Iran,2013-01-01,37,0,0,-2,3,38
Iran,2013-01-01,45,0,0,19,12,76
Iran,2013-01-01,38,0,1,-21,10,28
Iran,2013-01-01,25,2,0,20,0,47
Iran,2013-01-01,373,0,-1,179,60,611
Iran,2013-01-01,17,0,0,21,1,39
Iran,2013-01-01,58,0,0,12,12,82
Iran,2013-01-01,43,6,-1,36,20,104
Iran,2013-01-01,31,0,0,2,1,34
Iran,2013-01-01,101,0,0,28,9,138
Iran,2013-01-01,73,0,0,35,8,116
Iran,2013-01-01,78,4,-2,4,6,90
Iran,2013-01-01,102,0,2,78,4,186
Iran,2013-01-01,118,2,-2,71,19,208
Iran,2013-01-01,131,0,2,59,17,209
Iran,2013-01-01,129,0,1,37,21,188
Iran,2013-01-01,492,2,-8,94,33,613
Iraq,2013-01-01,36,0,0,9,13,58
Iraq,2013-01-01,62,0,3,1,12,78
Iraq,2013-01-01,195,0,1,35,1,232
Iraq,2013-01-01,101,0,-1,3,11,114
Iraq,2013-01-01,63,0,-1,12,5,79
Iraq,2013-01-01,71,0,1,6,0,78
Iraq,2013-01-01,132,0,1,24,13,170
Iraq,2013-01-01,141,0,1,62,17,221
Iraq,2013-01-01,63,2,0,93,18,176
Iraq,2013-01-01,56,0,0,28,3,87
Iraq,2013-01-01,59,0,0,33,8,100
Iraq,2013-01-01,56,0,0,25,0,81
Iraq,2013-01-01,53,0,3,18,5,79
Iraq,2013-01-01,64,2,0,13,13,92
Iraq,2013-01-01,74,0,0,12,3,89
Iraq,2013-01-01,74,0,0,66,3,143
Iraq,2013-01-01,154,0,-1,46,21,220
Iraq,2013-01-01,126,0,0,21,9,156
Iraq,2013-01-01,58,0,0,20,0,78
Iraq,2013-01-01,11,0,0,12,0,23
Iraq,2013-01-01,70,0,0,20,7,97
Iraq,2013-01-01,65,0,0,38,3,106
Iraq,2013-01-01,17,0,0,6,2,25
Iraq,2013-01-01,347,2,-5,49,9,402
Iraq,2013-01-01,146,0,-5,24,10,175
Iraq,2013-01-01,85,2,0,23,8,118
Iraq,2013-01-01,44,0,-2,18,7,67
Iraq,2013-01-01,73,0,1,30,9,113
Iraq,2013-01-01,127,2,-1,48,4,180
Iraq,2013-01-01,114,10,0,46,3,173
Iraq,2013-01-01,170,4,0,11,15,200
Morocco,2013-01-01,-2,0,0,0,0,-2
Morocco,2013-01-01,2,0,0,15,5,22
Morocco,2013-01-01,6,0,0,6,1,13
Morocco,2013-01-01,3,0,0,0,0,3
Morocco,2013-01-01,0,0,0,3,0,3
Morocco,2013-01-01,2,0,0,0,0,2
Morocco,2013-01-01,-1,0,0,2,0,1
Morocco,2013-01-01,32,0,0,5,3,40
Morocco,2013-01-01,18,0,0,12,0,30
Morocco,2013-01-01,3,0,0,7,7,17
Morocco,2013-01-01,0,0,0,-2,0,-2
Morocco,2013-01-01,0,0,0,0,1,1
Morocco,2013-01-01,0,0,0,0,3,3
Morocco,2013-01-01,28,0,0,0,3,31
Morocco,2013-01-01,7,0,0,2,1,10
Morocco,2013-01-01,2,2,0,2,0,6
Morocco,2013-01-01,8,0,0,0,0,8
Morocco,2013-01-01,29,0,-2,15,3,45
Morocco,2013-01-01,16,0,0,0,0,16
Morocco,2013-01-01,0,0,0,0,0,0
Morocco,2013-01-01,60,0,-2,2,11,71
Morocco,2013-01-01,16,0,0,-2,0,14
Morocco,2013-01-01,12,0,0,2,2,16
Morocco,2013-01-01,9,0,0,-1,0,8
Morocco,2013-01-01,100,0,-4,23,13,132
Morocco,2013-01-01,11,0,0,0,1,12
Morocco,2013-01-01,9,0,0,5,1,15
Morocco,2013-01-01,41,0,0,22,7,70
Morocco,2013-01-01,4,0,0,0,1,5
Morocco,2013-01-01,6,0,0,3,1,10
Morocco,2013-01-01,8,0,0,12,0,20
Nigeria,2013-01-01,12,0,0,5,2,19
Nigeria,2013-01-01,10,0,0,8,3,21
Nigeria,2013-01-01,12,0,0,12,0,24
Nigeria,2013-01-01,6,0,0,12,3,21
Nigeria,2013-01-01,12,0,0,1,1,14
Nigeria,2013-01-01,18,0,-1,22,0,39
Nigeria,2013-01-01,18,0,-7,-1,6,16
Nigeria,2013-01-01,15,4,-8,-8,2,5
Nigeria,2013-01-01,26,0,1,2,2,31
Nigeria,2013-01-01,32,10,0,13,5,60
Nigeria,2013-01-01,45,0,0,5,3,53
Nigeria,2013-01-01,56,2,0,6,2,66
Nigeria,2013-01-01,27,0,3,-1,7,36
Nigeria,2013-01-01,50,0,0,42,3,95
Nigeria,2013-01-01,90,0,0,0,7,97
Nigeria,2013-01-01,52,0,-1,12,1,64
Nigeria,2013-01-01,86,0,0,27,4,117
Nigeria,2013-01-01,61,0,0,1,1,63
Nigeria,2013-01-01,34,0,0,-2,1,33
Nigeria,2013-01-01,2,0,0,0,0,2
Nigeria,2013-01-01,46,0,0,4,12,62
Nigeria,2013-01-01,66,0,-1,19,9,93
Nigeria,2013-01-01,29,0,0,17,1,47
Nigeria,2013-01-01,25,0,1,2,3,31
Nigeria,2013-01-01,31,0,0,33,3,67
Nigeria,2013-01-01,26,0,0,30,6,62
Nigeria,2013-01-01,23,0,0,34,2,59
Nigeria,2013-01-01,36,0,0,-3,0,33
Nigeria,2013-01-01,19,0,-2,-7,4,14
Nigeria,2013-01-01,88,6,2,11,7,114
Nigeria,2013-01-01,51,0,1,12,7,71
Pakistan,2013-01-01,53,0,0,0,22,75
Pakistan,2013-01-01,100,0,0,46,8,154
Pakistan,2013-01-01,138,0,0,55,4,197
Pakistan,2013-01-01,124,0,2,33,7,166
Pakistan,2013-01-01,65,0,0,10,1,76
Pakistan,2013-01-01,169,0,0,20,35,224
Pakistan,2013-01-01,87,0,0,51,8,146
Pakistan,2013-01-01,105,0,-5,55,12,167
Pakistan,2013-01-01,149,0,0,32,37,218
Pakistan,2013-01-01,164,0,-2,5,9,176
Pakistan,2013-01-01,130,0,-2,27,22,177
Pakistan,2013-01-01,112,6,1,7,22,148
Pakistan,2013-01-01,59,0,0,11,6,76
Pakistan,2013-01-01,84,0,6,32,8,130
Pakistan,2013-01-01,172,2,-4,110,21,301
Pakistan,2013-01-01,83,0,-2,70,12,163
Pakistan,2013-01-01,112,0,-6,119,25,250
Pakistan,2013-01-01,116,2,-3,48,7,170
Pakistan,2013-01-01,72,2,0,25,14,113
Pakistan,2013-01-01,49,0,0,9,3,61
Pakistan,2013-01-01,159,2,-1,65,26,251
Pakistan,2013-01-01,102,0,-2,29,15,144
Pakistan,2013-01-01,50,0,0,27,2,79
Pakistan,2013-01-01,192,0,0,129,14,335
Pakistan,2013-01-01,139,0,2,132,9,282
Pakistan,2013-01-01,55,0,-2,37,4,94
Pakistan,2013-01-01,30,0,-6,41,1,66
Pakistan,2013-01-01,28,0,0,48,6,82
Pakistan,2013-01-01,89,0,-2,20,6,113
Pakistan,2013-01-01,85,0,3,42,9,139
Pakistan,2013-01-01,85,0,1,11,6,103
Sierra Leone,2013-01-01,0,0,0,0,0,0
Sierra Leone,2013-01-01,0,0,0,0,0,0
Sierra Leone,2013-01-01,2,0,0,0,0,2
Sierra Leone,2013-01-01,9,0,0,0,0,9
Sierra Leone,2013-01-01,0,0,0,3,0,3
Sierra Leone,2013-01-01,0,0,0,6,0,6
Sierra Leone,2013-01-01,-1,0,0,0,0,-1
Sierra Leone,2013-01-01,6,0,0,-2,0,4
Sierra Leone,2013-01-01,0,0,0,6,0,6
Sierra Leone,2013-01-01,0,0,0,0,0,0
Sierra Leone,2013-01-01,0,0,0,3,0,3
Sierra Leone,2013-01-01,0,0,0,6,0,6
Sierra Leone,2013-01-01,0,0,0,3,0,3
Sierra Leone,2013-01-01,0,0,0,6,2,8
Sierra Leone,2013-01-01,4,0,0,6,1,11
Sierra Leone,2013-01-01,0,0,0,3,0,3
Sierra Leone,2013-01-01,1,0,-2,0,0,-1
Sierra Leone,2013-01-01,1,0,0,1,0,2
Sierra Leone,2013-01-01,14,0,0,37,4,55
Sierra Leone,2013-01-01,3,0,0,6,0,9
Sierra Leone,2013-01-01,3,0,0,3,1,7
Sierra Leone,2013-01-01,0,0,0,9,0,9
Sierra Leone,2013-01-01,0,0,0,0,2,2
Sierra Leone,2013-01-01,0,0,0,0,1,1
Sierra Leone,2013-01-01,0,2,0,0,0,2
Sierra Leone,2013-01-01,1,0,0,0,0,1
Sierra Leone,2013-01-01,0,0,0,0,0,0
Sierra Leone,2013-01-01,-1,0,0,3,0,2
Somalia,2013-01-01,14,0,0,12,0,26
Somalia,2013-01-01,15,0,0,0,2,17
Somalia,2013-01-01,15,0,0,6,1,22
Somalia,2013-01-01,33,0,0,18,0,51
Somalia,2013-01-01,18,0,0,6,0,24
Somalia,2013-01-01,11,0,0,10,0,21
Somalia,2013-01-01,32,0,0,-4,4,32
Somalia,2013-01-01,28,0,0,15,1,44
Somalia,2013-01-01,11,0,2,-10,0,3
Somalia,2013-01-01,40,0,1,2,2,45
Somalia,2013-01-01,11,0,0,0,0,11
Somalia,2013-01-01,160,2,0,14,6,182
Somalia,2013-01-01,37,0,0,42,2,81
Somalia,2013-01-01,75,0,0,34,6,115
Somalia,2013-01-01,61,0,0,27,5,93
Somalia,2013-01-01,78,0,0,20,0,98
Somalia,2013-01-01,112,0,0,20,4,136
Somalia,2013-01-01,33,0,0,1,0,34
Somalia,2013-01-01,37,2,0,25,3,67
Somalia,2013-01-01,6,4,0,-2,1,9
Somalia,2013-01-01,71,0,0,3,3,77
Somalia,2013-01-01,49,0,2,13,0,64
Somalia,2013-01-01,10,0,0,3,0,13
Somalia,2013-01-01,49,0,0,6,3,58
Somalia,2013-01-01,78,0,0,42,0,120
Somalia,2013-01-01,34,0,0,9,0,43
Somalia,2013-01-01,20,0,-1,7,0,26
Somalia,2013-01-01,34,0,0,0,2,36
Somalia,2013-01-01,32,4,0,11,15,62
Somalia,2013-01-01,24,0,0,-2,0,22
Somalia,2013-01-01,19,0,-4,6,9,30
Syria,2013-01-01,143,0,0,3,0,146
Syria,2013-01-01,177,0,-3,21,12,207
Syria,2013-01-01,127,0,-1,53,6,185
Syria,2013-01-01,109,4,-4,44,10,163
Syria,2013-01-01,53,4,-4,16,10,79
Syria,2013-01-01,199,0,-22,2,9,188
Syria,2013-01-01,196,2,-10,39,5,232
Syria,2013-01-01,222,4,-5,22,15,258
Syria,2013-01-01,148,4,-3,4,13,166
Syria,2013-01-01,158,0,-6,51,4,207
Syria,2013-01-01,184,0,-6,26,17,221
Syria,2013-01-01,69,4,-3,0,2,72
Syria,2013-01-01,90,4,-5,8,15,112
Syria,2013-01-01,140,0,0,16,22,178
Syria,2013-01-01,127,2,-3,21,4,151
Syria,2013-01-01,92,4,0,4,3,103
Syria,2013-01-01,157,10,1,43,17,228
Syria,2013-01-01,147,6,1,6,13,173
Syria,2013-01-01,88,0,-2,11,9,106
Syria,2013-01-01,67,0,0,4,2,73
Syria,2013-01-01,175,0,1,54,24,254
Syria,2013-01-01,152,4,1,16,17,190
Syria,2013-01-01,72,0,0,12,18,102
Syria,2013-01-01,148,2,0,59,10,219
Syria,2013-01-01,147,2,-6,20,7,170
Syria,2013-01-01,169,0,-7,-10,10,162
Syria,2013-01-01,220,0,1,18,5,244
Syria,2013-01-01,186,12,1,58,13,270
Syria,2013-01-01,137,24,-6,19,9,183
Syria,2013-01-01,406,12,1,-7,25,437
Syria,2013-01-01,353,2,-7,1,35,384
Yemen,2013-01-01,0,0,0,3,0,3
Yemen,2013-01-01,10,0,0,18,0,28
Yemen,2013-01-01,30,0,0,3,8,41
Yemen,2013-01-01,31,0,0,9,1,41
Yemen,2013-01-01,21,0,0,9,0,30
Yemen,2013-01-01,13,0,0,7,5,25
Yemen,2013-01-01,54,0,-2,24,6,82
Yemen,2013-01-01,37,0,0,15,5,57
Yemen,2013-01-01,25,0,0,-2,3,26
Yemen,2013-01-01,7,0,0,9,1,17
Yemen,2013-01-01,5,0,0,3,0,8
Yemen,2013-01-01,13,0,-6,-2,2,7
Yemen,2013-01-01,10,0,0,4,1,15
Yemen,2013-01-01,22,0,0,19,5,46
Yemen,2013-01-01,6,0,0,0,2,8
Yemen,2013-01-01,6,0,0,0,2,8
Yemen,2013-01-01,10,0,-2,-2,1,7
Yemen,2013-01-01,45,0,0,6,0,51
Yemen,2013-01-01,238,0,0,103,28,369
Yemen,2013-01-01,27,0,0,1,3,31
Yemen,2013-01-01,56,0,0,13,1,70
Yemen,2013-01-01,69,2,0,0,0,71
Yemen,2013-01-01,21,0,0,0,0,21
Yemen,2013-01-01,107,0,0,3,0,110
Yemen,2013-01-01,29,0,0,21,6,56
Yemen,2013-01-01,4,0,0,7,1,12
Yemen,2013-01-01,3,0,0,-1,0,2
Yemen,2013-01-01,24,0,0,6,3,33
Yemen,2013-01-01,43,0,1,5,0,49
Yemen,2013-01-01,21,0,0,-4,2,19
Yemen,2013-01-01,53,0,0,6,7,66
Afghanistan,2011-03-01,240,8,-28,27,34,281
Afghanistan,2011-03-01,271,4,3,12,31,321
Afghanistan,2011-03-01,457,4,0,24,44,529
Afghanistan,2011-03-01,440,8,-1,57,32,536
Afghanistan,2011-03-01,200,2,0,29,15,246
Afghanistan,2011-03-01,135,2,0,5,16,158
Afghanistan,2011-03-01,234,2,0,47,19,302
Afghanistan,2011-03-01,219,0,0,28,44,291
Afghanistan,2011-03-01,240,4,4,29,26,303
Afghanistan,2011-03-01,322,2,-4,12,29,361
Afghanistan,2011-03-01,174,2,-2,26,16,216
Afghanistan,2011-03-01,119,4,0,6,8,137
Afghanistan,2011-03-01,112,2,0,16,51,181
Afghanistan,2011-03-01,155,2,-4,23,19,195
Afghanistan,2011-03-01,139,0,0,35,21,195
Afghanistan,2011-03-01,283,0,0,19,27,329
Afghanistan,2011-03-01,265,0,-2,25,53,341
Afghanistan,2011-03-01,258,0,-1,42,37,336
Afghanistan,2011-03-01,211,0,1,94,41,347
Afghanistan,2011-03-01,166,0,2,31,17,216
Afghanistan,2011-03-01,292,0,1,78,14,385
Afghanistan,2011-03-01,225,2,-1,78,19,323
Afghanistan,2011-03-01,312,0,3,55,30,400
Afghanistan,2011-03-01,274,0,1,35,24,334
Afghanistan,2011-03-01,192,0,4,42,5,243
Afghanistan,2011-03-01,174,4,-2,13,7,196
Afghanistan,2011-03-01,137,0,0,33,5,175
Afghanistan,2011-03-01,299,2,2,66,41,410
Afghanistan,2011-03-01,845,8,-7,308,139,1293
Afghanistan,2011-03-01,159,0,-3,18,12,186
Afghanistan,2011-03-01,271,0,-10,59,29,349
Albania,2011-03-01,0,0,0,0,0,0
Albania,2011-03-01,28,0,0,1,4,33
Albania,2011-03-01,62,0,0,15,3,80
Albania,2011-03-01,28,0,0,12,4,44
Albania,2011-03-01,-1,0,0,11,6,16
Albania,2011-03-01,11,0,-1,0,1,11
Albania,2011-03-01,9,0,0,12,0,21
Albania,2011-03-01,73,0,0,3,1,77
Albania,2011-03-01,20,0,0,0,0,20
Albania,2011-03-01,10,0,0,0,0,10
Albania,2011-03-01,24,0,0,9,4,37
Albania,2011-03-01,11,0,-1,-4,0,6
Albania,2011-03-01,0,0,0,0,0,0
Albania,2011-03-01,4,0,0,9,0,13
Albania,2011-03-01,6,0,0,0,0,6
Albania,2011-03-01,24,0,0,54,1,79
Albania,2011-03-01,16,0,4,10,4,34
Albania,2011-03-01,33,0,1,12,6,52
Albania,2011-03-01,11,0,1,3,2,17
Albania,2011-03-01,23,0,0,6,0,29
Albania,2011-03-01,3,0,0,12,2,17
Albania,2011-03-01,2,0,1,6,2,11
Albania,2011-03-01,12,0,-1,13,3,27
Albania,2011-03-01,16,0,-2,0,2,16
Albania,2011-03-01,3,0,0,3,2,8
Albania,2011-03-01,-1,0,0,6,0,5
Albania,2011-03-01,11,0,0,0,0,11
Albania,2011-03-01,15,0,0,12,4,31
Albania,2011-03-01,7,0,0,0,1,8
Albania,2011-03-01,16,0,0,3,2,21
Albania,2011-03-01,4,0,-3,9,1,11
Algeria,2011-03-01,9,0,0,0,4,13
Algeria,2011-03-01,32,0,-2,-2,6,34
Algeria,2011-03-01,21,0,0,6,12,39
Algeria,2011-03-01,21,0,0,4,9,34
Algeria,2011-03-01,13,0,0,20,1,34
Algeria,2011-03-01,10,0,0,10,1,21
Algeria,2011-03-01,17,0,0,0,1,18
Algeria,2011-03-01,33,0,0,12,6,51
Algeria,2011-03-01,32,2,-1,-10,1,24
Algeria,2011-03-01,3,0,0,0,6,9
Algeria,2011-03-01,1,0,0,7,5,13
Algeria,2011-03-01,10,0,0,3,1,14
Algeria,2011-03-01,10,0,5,0,0,15
Algeria,2011-03-01,4,0,0,1,0,5
Algeria,2011-03-01,1,0,0,-2,1,0
Algeria,2011-03-01,8,0,0,3,3,14
Algeria,2011-03-01,15,0,0,0,8,23
Algeria,2011-03-01,14,0,-2,-8,0,4
Algeria,2011-03-01,3,0,0,9,1,13
Algeria,2011-03-01,13,0,0,8,0,21
Algeria,2011-03-01,16,0,0,6,0,22
Algeria,2011-03-01,71,0,0,15,1,87
Algeria,2011-03-01,15,0,0,9,2,26
Algeria,2011-03-01,15,0,0,3,3,21
Algeria,2011-03-01,21,0,1,3,3,28
Algeria,2011-03-01,12,0,0,-4,7,15
Algeria,2011-03-01,12,0,0,9,5,26
Algeria,2011-03-01,18,0,0,12,4,34
Algeria,2011-03-01,6,0,0,0,2,8
Algeria,2011-03-01,12,0,0,0,6,18
Algeria,2011-03-01,14,0,1,1,0,16
Bangladesh,2011-03-01,32,2,-1,40,15,88
Bangladesh,2011-03-01,55,0,-7,26,14,88
Bangladesh,2011-03-01,99,0,-4,9,4,108
Bangladesh,2011-03-01,80,0,-3,0,8,85
Bangladesh,2011-03-01,56,0,-4,-3,9,58
Bangladesh,2011-03-01,63,0,0,22,7,92
Bangladesh,2011-03-01,36,0,0,7,2,45
Bangladesh,2011-03-01,80,0,-4,27,7,110
Bangladesh,2011-03-01,45,0,9,7,1,62
Bangladesh,2011-03-01,41,4,-2,11,5,59
Bangladesh,2011-03-01,41,0,0,6,0,47
Bangladesh,2011-03-01,16,0,0,1,9,26
Bangladesh,2011-03-01,6,0,0,19,2,27
Bangladesh,2011-03-01,22,0,1,-11,6,18
Bangladesh,2011-03-01,89,0,0,0,4,93
Bangladesh,2011-03-01,48,0,0,2,4,54
Bangladesh,2011-03-01,49,0,-2,4,8,59
Bangladesh,2011-03-01,44,0,0,108,1,153
Bangladesh,2011-03-01,23,0,0,31,0,54
Bangladesh,2011-03-01,24,0,0,23,1,48
Bangladesh,2011-03-01,29,0,0,16,0,45
Bangladesh,2011-03-01,37,0,0,21,7,65
Bangladesh,2011-03-01,36,0,0,7,14,57
Bangladesh,2011-03-01,28,0,0,21,6,55
Bangladesh,2011-03-01,34,0,1,0,2,37
Bangladesh,2011-03-01,17,0,1,0,1,19
Bangladesh,2011-03-01,17,2,-3,-6,4,14
Bangladesh,2011-03-01,24,0,3,10,0,37
Bangladesh,2011-03-01,24,0,1,6,0,31
Bangladesh,2011-03-01,6,0,0,10,0,16
Bangladesh,2011-03-01,16,0,0,8,8,32
Cameroon,2011-03-01,0,0,0,0,0,0
Cameroon,2011-03-01,8,0,0,0,0,8
Cameroon,2011-03-01,2,0,0,0,0,2
Cameroon,2011-03-01,6,0,0,12,0,18
Cameroon,2011-03-01,6,0,0,13,0,19
Cameroon,2011-03-01,0,0,0,3,0,3
Cameroon,2011-03-01,6,0,0,0,2,8
Cameroon,2011-03-01,1,0,0,6,2,9
Cameroon,2011-03-01,3,2,0,3,0,8
Cameroon,2011-03-01,0,0,0,0,0,0
Cameroon,2011-03-01,0,0,0,0,0,0
Cameroon,2011-03-01,0,0,0,0,0,0
Cameroon,2011-03-01,0,0,0,0,0,0
Cameroon,2011-03-01,0,0,0,0,0,0
Cameroon,2011-03-01,6,0,0,0,0,6
Cameroon,2011-03-01,0,0,0,0,0,0
Cameroon,2011-03-01,0,0,0,0,0,0
Cameroon,2011-03-01,6,0,0,0,0,6
Cameroon,2011-03-01,0,0,0,3,0,3
Cameroon,2011-03-01,3,0,0,0,0,3
Cameroon,2011-03-01,0,0,0,0,0,0
Cameroon,2011-03-01,0,0,0,3,0,3
Cameroon,2011-03-01,0,0,0,0,0,0
Cameroon,2011-03-01,0,0,0,0,1,1
Cameroon,2011-03-01,0,0,0,0,2,2
Cameroon,2011-03-01,2,0,0,0,2,4
Cameroon,2011-03-01,0,0,0,9,0,9
Cameroon,2011-03-01,0,0,0,0,0,0
China,2011-03-01,115,4,17,88,13,237
China,2011-03-01,120,4,5,42,26,197
China,2011-03-01,193,10,0,60,10,273
China,2011-03-01,285,2,-2,73,26,384
China,2011-03-01,102,0,-1,20,8,129
China,2011-03-01,92,0,-10,33,16,131
China,2011-03-01,194,2,-24,26,20,218
China,2011-03-01,218,6,-11,22,21,256
China,2011-03-01,179,2,-37,62,31,237
China,2011-03-01,197,0,-30,81,27,275
China,2011-03-01,166,2,2,32,25,227
China,2011-03-01,58,0,5,12,14,89
China,2011-03-01,82,0,1,32,9,124
China,2011-03-01,173,4,0,15,16,208
China,2011-03-01,75,0,2,53,16,146
China,2011-03-01,163,0,-8,22,12,189
China,2011-03-01,204,2,0,27,35,268
China,2011-03-01,192,0,0,43,16,251
China,2011-03-01,101,4,0,21,4,130
China,2011-03-01,88,6,-9,49,15,149
China,2011-03-01,212,2,-23,71,25,287
China,2011-03-01,164,2,-4,24,33,219
China,2011-03-01,98,4,-6,40,11,147
China,2011-03-01,141,0,3,75,14,233
China,2011-03-01,150,0,0,75,12,237
China,2011-03-01,82,8,1,56,2,149
China,2011-03-01,84,4,0,64,7,159
China,2011-03-01,154,4,7,73,32,270
China,2011-03-01,183,0,0,37,25,245
China,2011-03-01,125,0,-4,83,9,213
China,2011-03-01,181,6,-2,159,13,357
Egypt,2011-03-01,390,6,-16,66,64,510
Egypt,2011-03-01,228,0,-33,43,49,287
Egypt,2011-03-01,227,4,-76,81,40,276
Egypt,2011-03-01,192,2,-36,57,46,261
Egypt,2011-03-01,129,0,-10,55,46,220
Egypt,2011-03-01,155,8,-11,37,30,219
Egypt,2011-03-01,199,10,-2,53,54,314
Egypt,2011-03-01,228,0,5,56,43,332
Egypt,2011-03-01,149,2,-20,53,54,238
Egypt,2011-03-01,154,2,-19,12,45,194
Egypt,2011-03-01,155,4,-12,24,41,212
Egypt,2011-03-01,81,0,-7,15,14,103
Egypt,2011-03-01,104,0,-8,61,12,169
Egypt,2011-03-01,83,0,-6,14,20,111
Egypt,2011-03-01,146,0,-5,50,53,244
Egypt,2011-03-01,228,4,-4,62,45,335
Egypt,2011-03-01,196,6,-21,24,27,232
Egypt,2011-03-01,141,0,0,21,46,208
Egypt,2011-03-01,115,0,-9,24,28,158
Egypt,2011-03-01,74,2,-9,58,38,163
Egypt,2011-03-01,338,2,-11,93,99,521
Egypt,2011-03-01,532,6,-34,211,92,807
Egypt,2011-03-01,97,0,-15,27,32,141
Egypt,2011-03-01,128,2,-14,37,33,186
Egypt,2011-03-01,172,2,-10,85,24,273
Egypt,2011-03-01,98,0,-2,31,12,139
Egypt,2011-03-01,157,0,-18,38,16,193
Egypt,2011-03-01,78,0,-9,10,25,104
Egypt,2011-03-01,95,0,-5,47,31,168
Egypt,2011-03-01,50,0,-24,12,7,45
Egypt,2011-03-01,92,0,-42,57,29,136
Eritrea,2011-03-01,0,6,2,3,2,13
Eritrea,2011-03-01,1,0,0,33,0,34
Eritrea,2011-03-01,21,8,0,51,4,84
Eritrea,2011-03-01,3,0,0,15,2,20
Eritrea,2011-03-01,0,0,0,0,0,0
Eritrea,2011-03-01,0,0,0,0,0,0
Eritrea,2011-03-01,1,2,0,3,1,7
Eritrea,2011-03-01,0,0,0,2,1,3
Eritrea,2011-03-01,4,0,0,3,4,11
Eritrea,2011-03-01,0,0,0,0,0,0
Eritrea,2011-03-01,3,0,0,0,0,3
Eritrea,2011-03-01,12,0,0,0,0,12
Eritrea,2011-03-01,14,0,0,9,0,23
Eritrea,2011-03-01,2,0,-1,2,0,3
Eritrea,2011-03-01,2,0,0,0,0,2
Eritrea,2011-03-01,12,0,0,0,0,12
Eritrea,2011-03-01,17,0,0,-2,0,15
Eritrea,2011-03-01,0,0,0,0,2,2
Eritrea,2011-03-01,2,0,0,0,0,2
Eritrea,2011-03-01,0,0,0,0,0,0
Eritrea,2011-03-01,6,0,0,0,0,6
Eritrea,2011-03-01,3,0,0,0,0,3
Eritrea,2011-03-01,0,0,0,6,0,6
Eritrea,2011-03-01,8,0,0,3,0,11
Eritrea,2011-03-01,0,4,0,-2,2,4
Eritrea,2011-03-01,8,0,0,0,0,8
Eritrea,2011-03-01,7,0,0,0,4,11
Eritrea,2011-03-01,3,0,0,0,0,3
Eritrea,2011-03-01,5,0,0,3,0,8
Georgia,2011-03-01,35,4,-3,49,5,90
Georgia,2011-03-01,50,2,1,36,6,95
Georgia,2011-03-01,48,0,-1,11,11,69
Georgia,2011-03-01,26,2,-2,25,5,56
Georgia,2011-03-01,20,0,0,10,0,30
Georgia,2011-03-01,42,0,0,8,7,57
Georgia,2011-03-01,32,0,-2,37,5,72
Georgia,2011-03-01,45,0,0,4,3,52
Georgia,2011-03-01,37,2,1,36,6,82
Georgia,2011-03-01,-1,0,0,0,0,-1
Georgia,2011-03-01,27,4,0,32,6,69
Georgia,2011-03-01,30,0,0,-2,2,30
Georgia,2011-03-01,7,0,1,3,2,13
Georgia,2011-03-01,29,0,-2,2,1,30
Georgia,2011-03-01,40,0,2,13,3,58
Georgia,2011-03-01,32,6,2,18,3,61
Georgia,2011-03-01,29,2,0,7,8,46
Georgia,2011-03-01,34,0,0,11,2,47
Georgia,2011-03-01,10,0,0,12,5,27
Georgia,2011-03-01,19,0,0,-1,0,18
Georgia,2011-03-01,45,4,0,17,5,71
Georgia,2011-03-01,68,0,2,17,15,102
Georgia,2011-03-01,78,8,-4,17,4,103
Georgia,2011-03-01,44,0,-2,17,8,67
Georgia,2011-03-01,62,0,0,46,10,118
Georgia,2011-03-01,24,0,1,23,7,55
Georgia,2011-03-01,46,0,0,6,0,52
Georgia,2011-03-01,54,0,2,10,2,68
Georgia,2011-03-01,39,4,0,-3,4,44
Georgia,2011-03-01,8,0,0,-2,0,6
Georgia,2011-03-01,40,0,1,44,12,97
India,2011-03-01,90,6,-1,21,18,134
India,2011-03-01,84,0,1,48,9,142
India,2011-03-01,76,2,-5,59,8,140
India,2011-03-01,81,2,-6,44,14,135
India,2011-03-01,53,4,-2,36,8,99
India,2011-03-01,100,4,-2,6,12,120
India,2011-03-01,84,2,-6,16,5,101
India,2011-03-01,57,4,0,14,17,92
India,2011-03-01,42,0,-5,11,14,62
India,2011-03-01,72,2,-15,34,2,95
India,2011-03-01,93,0,-3,15,3,108
India,2011-03-01,33,0,-3,16,4,50
India,2011-03-01,27,2,0,14,8,51
India,2011-03-01,64,0,-3,44,14,119
India,2011-03-01,66,2,-8,19,15,94
India,2011-03-01,29,0,-2,19,10,56
India,2011-03-01,75,4,-20,13,9,81
India,2011-03-01,117,0,0,15,15,147
India,2011-03-01,49,0,3,16,11,79
India,2011-03-01,60,0,-2,13,5,76
India,2011-03-01,98,0,3,35,10,146
India,2011-03-01,104,2,-2,9,15,128
India,2011-03-01,67,0,-6,15,13,89
India,2011-03-01,70,2,0,14,12,98
India,2011-03-01,53,0,0,28,1,82
India,2011-03-01,40,2,-2,18,7,65
India,2011-03-01,29,14,-4,10,6,55
India,2011-03-01,53,8,0,11,11,83
India,2011-03-01,69,0,-9,19,1,80
India,2011-03-01,30,0,-8,14,5,41
India,2011-03-01,39,4,-7,5,3,44
Iran,2011-03-01,65,2,0,47,24,138
Iran,2011-03-01,48,4,-1,11,31,93
Iran,2011-03-01,87,0,0,35,8,130
Iran,2011-03-01,136,4,2,48,20,210
Iran,2011-03-01,219,2,-3,172,55,445
Iran,2011-03-01,14,0,-1,8,3,24
Iran,2011-03-01,71,0,-4,0,7,74
Iran,2011-03-01,65,0,-2,40,11,114
Iran,2011-03-01,134,2,3,87,13,239
Iran,2011-03-01,107,0,-5,58,23,183
Iran,2011-03-01,60,2,0,23,6,91
Iran,2011-03-01,28,0,0,9,3,40
Iran,2011-03-01,54,0,0,13,4,71
Iran,2011-03-01,136,0,1,26,8,171
Iran,2011-03-01,172,0,-3,48,11,228
Iran,2011-03-01,163,0,-3,65,23,248
Iran,2011-03-01,125,0,-2,34,22,179
Iran,2011-03-01,71,0,2,43,7,123
Iran,2011-03-01,50,0,-2,26,15,89
Iran,2011-03-01,62,4,0,52,6,124
Iran,2011-03-01,107,4,-2,52,28,189
Iran,2011-03-01,142,6,0,36,23,207
Iran,2011-03-01,118,0,0,76,5,199
Iran,2011-03-01,153,0,-5,67,1,216
Iran,2011-03-01,107,0,0,47,5,159
Iran,2011-03-01,43,0,-1,20,5,67
Iran,2011-03-01,55,0,0,52,16,123
Iran,2011-03-01,65,2,1,28,3,99
Iran,2011-03-01,95,0,0,25,19,139
Iran,2011-03-01,68,0,1,33,13,115
Iran,2011-03-01,111,0,0,51,13,175
Iraq,2011-03-01,177,4,-2,35,37,251
Iraq,2011-03-01,299,2,-1,107,90,497
Iraq,2011-03-01,288,6,8,69,51,422
Iraq,2011-03-01,166,0,2,49,33,250
Iraq,2011-03-01,89,0,0,75,6,170
Iraq,2011-03-01,79,0,-5,65,28,167
Iraq,2011-03-01,76,6,2,47,17,148
Iraq,2011-03-01,175,0,2,70,35,282
Iraq,2011-03-01,170,2,-2,63,24,257
Iraq,2011-03-01,269,2,-1,74,22,366
Iraq,2011-03-01,101,0,7,24,18,150
Iraq,2011-03-01,101,0,0,8,14,123
Iraq,2011-03-01,37,6,-2,55,2,98
Iraq,2011-03-01,90,0,-6,32,12,128
Iraq,2011-03-01,109,2,-2,42,34,185
Iraq,2011-03-01,65,0,-2,52,26,141
Iraq,2011-03-01,129,2,-2,53,20,202
Iraq,2011-03-01,138,0,2,31,26,197
Iraq,2011-03-01,56,0,0,23,32,111
Iraq,2011-03-01,235,4,-4,28,50,313
Iraq,2011-03-01,320,2,0,45,62,429
Iraq,2011-03-01,303,0,0,19,29,351
Iraq,2011-03-01,158,2,-5,17,24,196
Iraq,2011-03-01,146,0,-2,17,21,182
Iraq,2011-03-01,105,0,-3,14,20,136
Iraq,2011-03-01,94,0,-2,38,31,161
Iraq,2011-03-01,129,0,0,13,25,167
Iraq,2011-03-01,130,0,-3,6,13,146
Iraq,2011-03-01,205,2,-2,-5,16,216
Iraq,2011-03-01,177,0,0,-1,16,192
Iraq,2011-03-01,190,2,-3,16,5,210
Morocco,2011-03-01,14,0,0,4,6,24
Morocco,2011-03-01,8,0,0,7,3,18
Morocco,2011-03-01,7,0,1,-5,3,6
Morocco,2011-03-01,9,0,0,0,4,13
Morocco,2011-03-01,5,0,-12,0,2,-5
Morocco,2011-03-01,5,0,-1,1,5,10
Morocco,2011-03-01,3,0,-4,1,8,8
Morocco,2011-03-01,1,0,0,0,8,9
Morocco,2011-03-01,67,0,-17,-2,8,56
Morocco,2011-03-01,18,0,-20,1,1,0
Morocco,2011-03-01,11,0,0,5,-1,15
Morocco,2011-03-01,12,0,-2,0,0,10
Morocco,2011-03-01,4,0,0,3,0,7
Morocco,2011-03-01,8,0,-1,8,2,17
Morocco,2011-03-01,20,0,-2,9,8,35
Morocco,2011-03-01,9,0,1,4,0,14
Morocco,2011-03-01,11,0,0,6,6,23
Morocco,2011-03-01,3,0,-2,4,2,7
Morocco,2011-03-01,6,0,0,0,0,6
Morocco,2011-03-01,3,0,0,0,2,5
Morocco,2011-03-01,5,0,-14,4,7,2
Morocco,2011-03-01,22,0,0,-4,3,21
Morocco,2011-03-01,2,0,-10,6,4,2
Morocco,2011-03-01,17,0,-8,6,1,16
Morocco,2011-03-01,3,0,0,-4,2,1
Morocco,2011-03-01,7,0,0,-2,4,9
Morocco,2011-03-01,2,0,-3,0,0,-1
Morocco,2011-03-01,7,0,0,0,5,12
Morocco,2011-03-01,-3,0,0,12,0,9
Morocco,2011-03-01,15,0,0,0,0,15
Morocco,2011-03-01,9,0,-2,1,0,8
Nigeria,2011-03-01,60,0,-4,19,5,80
Nigeria,2011-03-01,58,2,-2,10,4,72
Nigeria,2011-03-01,37,0,0,24,6,67
Nigeria,2011-03-01,31,0,-8,32,0,55
Nigeria,2011-03-01,14,0,0,14,10,38
Nigeria,2011-03-01,56,0,1,21,3,81
Nigeria,2011-03-01,57,0,0,11,9,77
Nigeria,2011-03-01,22,0,2,11,4,39
Nigeria,2011-03-01,31,2,-9,10,5,39
Nigeria,2011-03-01,35,0,-1,31,1,66
Nigeria,2011-03-01,57,8,-5,11,2,73
Nigeria,2011-03-01,31,0,-1,-7,3,26
Nigeria,2011-03-01,15,0,0,3,0,18
Nigeria,2011-03-01,79,0,0,12,3,94
Nigeria,2011-03-01,19,0,-2,7,4,28
Nigeria,2011-03-01,27,0,0,-12,2,17
Nigeria,2011-03-01,51,0,1,5,6,63
Nigeria,2011-03-01,55,0,0,9,3,67
Nigeria,2011-03-01,90,0,0,5,2,97
Nigeria,2011-03-01,36,4,0,9,10,59
Nigeria,2011-03-01,31,0,0,6,0,37
Nigeria,2011-03-01,76,0,2,31,5,114
Nigeria,2011-03-01,36,0,0,7,3,46
Nigeria,2011-03-01,22,0,-2,24,9,53
Nigeria,2011-03-01,19,0,-2,15,2,34
Nigeria,2011-03-01,19,0,0,16,0,35
Nigeria,2011-03-01,12,0,0,1,1,14
Nigeria,2011-03-01,22,0,4,36,6,68
Nigeria,2011-03-01,33,0,1,14,1,49
Nigeria,2011-03-01,26,0,-4,4,2,28
Nigeria,2011-03-01,55,0,-6,37,6,92
Pakistan,2011-03-01,101,2,-4,39,19,157
Pakistan,2011-03-01,448,2,-1,130,45,624
Pakistan,2011-03-01,808,0,-36,283,132,1187
Pakistan,2011-03-01,109,2,-7,20,14,138
Pakistan,2011-03-01,44,0,0,40,7,91
Pakistan,2011-03-01,113,0,0,42,14,169
Pakistan,2011-03-01,64,6,2,27,3,102
Pakistan,2011-03-01,98,0,0,23,15,136
Pakistan,2011-03-01,83,2,1,60,10,156
Pakistan,2011-03-01,156,0,1,38,7,202
Pakistan,2011-03-01,24,6,0,2,8,40
Pakistan,2011-03-01,56,0,0,19,2,77
Pakistan,2011-03-01,58,0,1,24,7,90
Pakistan,2011-03-01,99,0,0,98,26,223
Pakistan,2011-03-01,115,0,1,66,19,201
Pakistan,2011-03-01,249,2,-9,-60,7,189
Pakistan,2011-03-01,127,0,-2,-7,10,128
Pakistan,2011-03-01,94,0,-1,14,15,122
Pakistan,2011-03-01,63,4,-1,8,3,77
Pakistan,2011-03-01,44,0,0,9,6,59
Pakistan,2011-03-01,45,0,0,19,14,78
Pakistan,2011-03-01,70,0,-1,34,29,132
Pakistan,2011-03-01,62,0,-3,24,5,88
Pakistan,2011-03-01,80,0,0,16,12,108
Pakistan,2011-03-01,48,2,1,12,8,71
Pakistan,2011-03-01,42,2,-6,6,10,54
Pakistan,2011-03-01,60,2,-2,27,6,93
Pakistan,2011-03-01,89,2,0,7,11,109
Pakistan,2011-03-01,110,0,2,41,7,160
Pakistan,2011-03-01,28,0,0,96,5,129
Pakistan,2011-03-01,69,0,2,51,10,132
Sierra Leone,2011-03-01,11,0,0,6,0,17
Sierra Leone,2011-03-01,0,0,0,1,0,1
Sierra Leone,2011-03-01,14,0,0,3,0,17
Sierra Leone,2011-03-01,-2,2,0,3,0,3
Sierra Leone,2011-03-01,0,0,0,0,0,0
Sierra Leone,2011-03-01,1,0,0,9,0,10
Sierra Leone,2011-03-01,6,0,0,3,2,11
Sierra Leone,2011-03-01,9,0,0,0,2,11
Sierra Leone,2011-03-01,39,0,0,23,0,62
Sierra Leone,2011-03-01,16,0,0,6,0,22
Sierra Leone,2011-03-01,20,0,0,9,12,41
Sierra Leone,2011-03-01,4,0,0,6,6,16
Sierra Leone,2011-03-01,0,0,0,9,0,9
Sierra Leone,2011-03-01,0,0,0,3,1,4
Sierra Leone,2011-03-01,5,0,0,0,0,5
Sierra Leone,2011-03-01,0,0,0,0,2,2
Sierra Leone,2011-03-01,2,0,0,0,0,2
Sierra Leone,2011-03-01,6,0,0,0,0,6
Sierra Leone,2011-03-01,0,0,0,0,2,2
Sierra Leone,2011-03-01,0,0,0,0,0,0
Sierra Leone,2011-03-01,0,0,0,0,0,0
Sierra Leone,2011-03-01,-1,0,0,0,0,-1
Sierra Leone,2011-03-01,7,0,0,0,1,8
Sierra Leone,2011-03-01,1,0,0,3,3,7
Sierra Leone,2011-03-01,10,0,0,15,0,25
Sierra Leone,2011-03-01,4,0,0,0,0,4
Sierra Leone,2011-03-01,1,0,0,0,0,1
Sierra Leone,2011-03-01,2,0,0,0,0,2
Sierra Leone,2011-03-01,8,0,0,0,0,8
Sierra Leone,2011-03-01,0,0,0,7,0,7
Sierra Leone,2011-03-01,4,0,0,9,2,15
Somalia,2011-03-01,92,2,1,53,7,155
Somalia,2011-03-01,95,0,0,90,3,188
Somalia,2011-03-01,109,2,-10,39,1,141
Somalia,2011-03-01,64,0,-2,20,0,82
Somalia,2011-03-01,26,0,0,3,1,30
Somalia,2011-03-01,37,0,0,28,7,72
Somalia,2011-03-01,54,8,0,11,16,89
Somalia,2011-03-01,43,2,-4,13,10,64
Somalia,2011-03-01,57,2,0,23,10,92
Somalia,2011-03-01,132,2,0,77,10,221
Somalia,2011-03-01,80,2,1,56,10,149
Somalia,2011-03-01,30,2,0,25,4,61
Somalia,2011-03-01,12,0,0,4,2,18
Somalia,2011-03-01,87,0,0,87,4,178
Somalia,2011-03-01,63,0,0,69,6,138
Somalia,2011-03-01,43,2,0,37,5,87
Somalia,2011-03-01,46,0,0,-17,2,31
Somalia,2011-03-01,17,0,0,-9,4,12
Somalia,2011-03-01,29,4,0,-8,0,25
Somalia,2011-03-01,13,0,0,6,1,20
Somalia,2011-03-01,54,0,-2,2,1,55
Somalia,2011-03-01,42,0,0,18,1,61
Somalia,2011-03-01,55,0,0,-2,2,55
Somalia,2011-03-01,73,2,0,16,1,92
Somalia,2011-03-01,45,0,2,17,4,68
Somalia,2011-03-01,25,0,3,0,0,28
Somalia,2011-03-01,60,0,-8,65,3,120
Somalia,2011-03-01,76,0,0,8,1,85
Somalia,2011-03-01,51,0,0,4,0,55
Somalia,2011-03-01,85,0,0,40,4,129
Somalia,2011-03-01,54,2,0,28,3,87
Syria,2011-03-01,5,0,0,2,2,9
Syria,2011-03-01,29,0,0,8,3,40
Syria,2011-03-01,48,0,0,22,9,79
Syria,2011-03-01,44,0,3,7,9,63
Syria,2011-03-01,25,0,3,18,6,52
Syria,2011-03-01,46,0,1,2,6,55
Syria,2011-03-01,23,0,0,14,9,46
Syria,2011-03-01,41,0,-4,22,19,78
Syria,2011-03-01,75,0,1,15,4,95
Syria,2011-03-01,48,4,0,18,5,75
Syria,2011-03-01,24,4,0,18,7,53
Syria,2011-03-01,20,0,0,6,3,29
Syria,2011-03-01,65,0,0,21,13,99
Syria,2011-03-01,18,0,0,4,3,25
Syria,2011-03-01,17,0,0,15,5,37
Syria,2011-03-01,39,0,6,20,9,74
Syria,2011-03-01,13,0,3,35,8,59
Syria,2011-03-01,59,0,0,4,8,71
Syria,2011-03-01,58,0,-2,28,14,98
Syria,2011-03-01,104,0,-8,58,19,173
Syria,2011-03-01,153,0,0,50,59,262
Syria,2011-03-01,111,0,5,36,19,171
Syria,2011-03-01,251,2,-3,26,37,313
Syria,2011-03-01,269,0,-6,44,55,362
Syria,2011-03-01,170,0,-19,20,36,207
Syria,2011-03-01,99,0,-7,16,37,145
Syria,2011-03-01,489,22,-15,204,113,813
Syria,2011-03-01,162,0,-5,39,47,243
Syria,2011-03-01,133,0,-30,39,19,161
Syria,2011-03-01,70,0,-10,21,7,88
Syria,2011-03-01,142,0,-22,47,22,189
Yemen,2011-03-01,88,2,-3,33,19,139
Yemen,2011-03-01,33,0,-9,36,26,86
Yemen,2011-03-01,68,0,-12,18,10,84
Yemen,2011-03-01,79,0,-2,12,18,107
Yemen,2011-03-01,19,0,-9,15,16,41
Yemen,2011-03-01,85,0,-2,15,8,106
Yemen,2011-03-01,55,0,-3,38,16,106
Yemen,2011-03-01,80,2,-2,24,12,116
Yemen,2011-03-01,41,2,-6,11,14,62
Yemen,2011-03-01,73,0,-10,20,4,87
Yemen,2011-03-01,80,0,0,9,18,107
Yemen,2011-03-01,81,0,-7,6,20,100
Yemen,2011-03-01,81,0,-2,10,14,103
Yemen,2011-03-01,112,0,-3,32,16,157
Yemen,2011-03-01,91,2,0,21,30,144
Yemen,2011-03-01,69,0,-4,16,10,91
Yemen,2011-03-01,30,2,-2,-8,3,25
Yemen,2011-03-01,143,0,-2,72,23,236
Yemen,2011-03-01,129,6,2,41,32,210
Yemen,2011-03-01,100,6,-37,12,48,129
Yemen,2011-03-01,107,0,-41,20,59,145
Yemen,2011-03-01,252,0,-78,20,40,234
Yemen,2011-03-01,125,0,-19,19,19,144
Yemen,2011-03-01,81,0,-10,31,17,119
Yemen,2011-03-01,249,2,-17,82,52,368
Yemen,2011-03-01,557,12,-30,154,94,787
Yemen,2011-03-01,85,0,-12,14,25,112
Yemen,2011-03-01,117,0,-8,3,18,130
Yemen,2011-03-01,85,0,-2,-10,11,84
Yemen,2011-03-01,83,0,-12,8,6,85
Yemen,2011-03-01,52,0,-4,10,6,64
Afghanistan,2011-02-01,289,4,1,58,5,357
Afghanistan,2011-02-01,251,2,2,68,21,344
Afghanistan,2011-02-01,253,0,0,-9,21,265
Afghanistan,2011-02-01,152,4,0,50,16,222
Afghanistan,2011-02-01,116,0,7,6,11,140
Afghanistan,2011-02-01,136,0,-2,20,6,160
Afghanistan,2011-02-01,254,2,6,45,16,323
Afghanistan,2011-02-01,114,0,0,15,17,146
Afghanistan,2011-02-01,233,2,-7,10,46,284
Afghanistan,2011-02-01,262,2,3,41,73,381
Afghanistan,2011-02-01,200,2,-4,87,42,327
Afghanistan,2011-02-01,371,0,1,44,77,493
Afghanistan,2011-02-01,132,2,1,-8,25,152
Afghanistan,2011-02-01,147,2,1,46,13,209
Afghanistan,2011-02-01,218,0,-15,25,33,261
Afghanistan,2011-02-01,168,0,-14,64,39,257
Afghanistan,2011-02-01,101,2,-10,14,14,121
Afghanistan,2011-02-01,28,0,0,1,7,36
Afghanistan,2011-02-01,279,0,6,51,28,364
Afghanistan,2011-02-01,315,0,0,28,7,350
Afghanistan,2011-02-01,267,0,2,7,58,334
Afghanistan,2011-02-01,81,0,0,32,17,130
Afghanistan,2011-02-01,105,2,0,9,4,120
Afghanistan,2011-02-01,214,4,4,37,17,276
Afghanistan,2011-02-01,214,2,0,20,37,273
Afghanistan,2011-02-01,112,0,0,20,12,144
Afghanistan,2011-02-01,138,0,0,13,31,182
Afghanistan,2011-02-01,187,10,-3,3,24,221
Albania,2011-02-01,15,0,0,0,7,22
Albania,2011-02-01,3,0,0,11,0,14
Albania,2011-02-01,1,0,-1,2,0,2
Albania,2011-02-01,11,2,0,3,6,22
Albania,2011-02-01,1,0,0,3,3,7
Albania,2011-02-01,0,0,0,3,4,7
Albania,2011-02-01,6,0,0,9,0,15
Albania,2011-02-01,11,0,1,12,0,24
Albania,2011-02-01,6,0,-1,21,2,28
Albania,2011-02-01,9,0,0,3,2,14
Albania,2011-02-01,9,0,0,0,4,13
Albania,2011-02-01,4,0,0,-1,0,3
Albania,2011-02-01,10,0,0,0,7,17
Albania,2011-02-01,34,0,0,0,0,34
Albania,2011-02-01,-2,0,1,0,3,2
Albania,2011-02-01,27,0,-2,30,2,57
Albania,2011-02-01,27,0,-2,9,4,38
Albania,2011-02-01,13,0,0,6,0,19
Albania,2011-02-01,1,0,0,9,0,10
Albania,2011-02-01,9,0,3,3,0,15
Albania,2011-02-01,-1,0,0,12,1,12
Albania,2011-02-01,70,0,-5,90,15,170
Albania,2011-02-01,33,2,0,50,1,86
Albania,2011-02-01,1,0,0,0,0,1
Albania,2011-02-01,6,0,0,21,1,28
Albania,2011-02-01,10,0,0,9,0,19
Albania,2011-02-01,14,0,0,3,1,18
Algeria,2011-02-01,27,0,-4,6,16,45
Algeria,2011-02-01,31,0,-2,19,27,75
Algeria,2011-02-01,21,0,-6,18,16,49
Algeria,2011-02-01,19,0,-4,18,26,59
Algeria,2011-02-01,2,0,0,15,4,21
Algeria,2011-02-01,2,0,0,12,4,18
Algeria,2011-02-01,17,0,-3,34,14,62
Algeria,2011-02-01,11,0,0,6,6,23
Algeria,2011-02-01,10,0,0,3,11,24
Algeria,2011-02-01,5,0,0,2,5,12
Algeria,2011-02-01,11,0,-6,12,2,19
Algeria,2011-02-01,49,0,4,27,31,111
Algeria,2011-02-01,17,0,2,29,10,58
Algeria,2011-02-01,18,0,0,5,9,32
Algeria,2011-02-01,50,0,0,4,18,72
Algeria,2011-02-01,15,0,-2,9,7,29
Algeria,2011-02-01,31,0,0,1,4,36
Algeria,2011-02-01,2,0,1,3,6,12
Algeria,2011-02-01,46,0,-2,26,28,98
Algeria,2011-02-01,27,0,0,21,31,79
Algeria,2011-02-01,15,0,0,9,12,36
Algeria,2011-02-01,41,0,0,-3,11,49
Algeria,2011-02-01,27,0,0,4,19,50
Algeria,2011-02-01,27,0,-4,29,8,60
Algeria,2011-02-01,56,0,0,32,17,105
Algeria,2011-02-01,20,0,0,-2,13,31
Algeria,2011-02-01,5,0,0,2,11,18
Algeria,2011-02-01,39,0,0,-2,2,39
Bangladesh,2011-02-01,29,0,1,18,2,50
Bangladesh,2011-02-01,22,0,0,77,1,100
Bangladesh,2011-02-01,8,0,0,13,0,21
Bangladesh,2011-02-01,13,0,0,2,1,16
Bangladesh,2011-02-01,18,0,1,-19,2,2
Bangladesh,2011-02-01,6,0,0,9,0,15
Bangladesh,2011-02-01,2,0,3,18,4,27
Bangladesh,2011-02-01,16,0,0,9,2,27
Bangladesh,2011-02-01,28,0,0,4,3,35
Bangladesh,2011-02-01,33,0,0,27,2,62
Bangladesh,2011-02-01,42,0,0,3,3,48
Bangladesh,2011-02-01,16,0,0,18,0,34
Bangladesh,2011-02-01,12,2,1,21,3,39
Bangladesh,2011-02-01,6,2,0,21,1,30
Bangladesh,2011-02-01,55,0,0,27,0,82
Bangladesh,2011-02-01,32,0,0,15,6,53
Bangladesh,2011-02-01,17,0,-3,9,4,27
Bangladesh,2011-02-01,6,0,0,0,0,6
Bangladesh,2011-02-01,5,0,-1,7,5,16
Bangladesh,2011-02-01,16,0,0,6,6,28
Bangladesh,2011-02-01,34,0,-2,30,12,74
Bangladesh,2011-02-01,39,2,-6,14,11,60
Bangladesh,2011-02-01,16,0,-3,7,9,29
Bangladesh,2011-02-01,16,0,-2,4,1,19
Bangladesh,2011-02-01,7,0,0,6,2,15
Bangladesh,2011-02-01,16,0,0,6,3,25
Bangladesh,2011-02-01,4,0,0,22,2,28
Bangladesh,2011-02-01,132,0,-5,69,19,215
Cameroon,2011-02-01,0,0,0,-1,1,0
Cameroon,2011-02-01,4,0,0,0,0,4
Cameroon,2011-02-01,0,0,0,0,0,0
Cameroon,2011-02-01,3,0,0,3,0,6
Cameroon,2011-02-01,-8,0,0,0,1,-7
Cameroon,2011-02-01,0,0,0,0,0,0
Cameroon,2011-02-01,0,0,0,0,0,0
Cameroon,2011-02-01,5,0,0,6,0,11
Cameroon,2011-02-01,-3,0,0,0,0,-3
Cameroon,2011-02-01,0,0,0,3,0,3
Cameroon,2011-02-01,0,0,0,0,0,0
Cameroon,2011-02-01,1,0,0,3,0,4
Cameroon,2011-02-01,3,0,0,0,3,6
Cameroon,2011-02-01,0,0,0,0,0,0
Cameroon,2011-02-01,1,0,0,0,6,7
Cameroon,2011-02-01,0,0,0,0,3,3
Cameroon,2011-02-01,2,0,0,0,0,2
Cameroon,2011-02-01,2,0,1,0,0,3
Cameroon,2011-02-01,9,0,-1,-2,1,7
Cameroon,2011-02-01,0,0,0,0,0,0
Cameroon,2011-02-01,3,0,0,-4,0,-1
Cameroon,2011-02-01,0,0,0,0,0,0
Cameroon,2011-02-01,22,0,0,0,0,22
Cameroon,2011-02-01,2,0,0,0,0,2
China,2011-02-01,128,12,-7,45,19,197
China,2011-02-01,82,2,-7,66,29,172
China,2011-02-01,138,0,-1,65,11,213
China,2011-02-01,104,0,-10,79,11,184
China,2011-02-01,54,0,0,24,6,84
China,2011-02-01,72,2,-1,45,16,134
China,2011-02-01,144,0,-3,65,11,217
China,2011-02-01,59,1,-7,28,13,94
China,2011-02-01,111,7,1,142,14,275
China,2011-02-01,78,0,-4,94,17,185
China,2011-02-01,109,7,-3,11,21,145
China,2011-02-01,67,3,-1,52,14,135
China,2011-02-01,65,4,1,39,9,118
China,2011-02-01,135,6,-4,106,14,257
China,2011-02-01,163,2,-8,43,14,214
China,2011-02-01,116,2,-6,89,16,217
China,2011-02-01,112,0,-5,38,12,157
China,2011-02-01,3,0,0,9,0,12
China,2011-02-01,99,0,-5,68,21,183
China,2011-02-01,126,8,-4,59,16,205
China,2011-02-01,150,4,1,99,19,273
China,2011-02-01,104,4,-22,76,36,198
China,2011-02-01,166,0,2,89,34,291
China,2011-02-01,100,0,4,98,30,232
China,2011-02-01,153,0,-8,77,22,244
China,2011-02-01,77,0,-6,56,14,141
China,2011-02-01,69,0,-3,3,18,87
China,2011-02-01,127,0,-8,14,18,151
Egypt,2011-02-01,910,6,-104,383,232,1427
Egypt,2011-02-01,829,8,-93,356,247,1347
Egypt,2011-02-01,577,4,-80,226,206,933
Egypt,2011-02-01,583,0,-121,252,184,898
Egypt,2011-02-01,411,4,-117,145,149,592
Egypt,2011-02-01,365,4,-47,95,140,557
Egypt,2011-02-01,374,4,-44,46,96,476
Egypt,2011-02-01,221,6,-30,95,84,376
Egypt,2011-02-01,284,2,-40,101,92,439
Egypt,2011-02-01,322,0,-178,82,135,361
Egypt,2011-02-01,742,10,-234,310,284,1112
Egypt,2011-02-01,670,4,-128,425,328,1299
Egypt,2011-02-01,388,0,-78,174,171,655
Egypt,2011-02-01,402,4,-94,230,184,726
Egypt,2011-02-01,475,6,-79,183,200,785
Egypt,2011-02-01,611,8,-45,175,238,987
Egypt,2011-02-01,272,2,-39,34,94,363
Egypt,2011-02-01,23,0,-6,5,9,31
Egypt,2011-02-01,415,4,-67,78,152,582
Egypt,2011-02-01,342,2,-29,113,138,566
Egypt,2011-02-01,365,0,-55,141,110,561
Egypt,2011-02-01,579,6,-16,159,154,882
Egypt,2011-02-01,688,24,-50,424,189,1275
Egypt,2011-02-01,361,6,-16,193,134,678
Egypt,2011-02-01,302,4,-10,131,97,524
Egypt,2011-02-01,197,0,-21,113,79,368
Egypt,2011-02-01,276,4,-67,145,74,432
Egypt,2011-02-01,210,0,-17,81,69,343
Eritrea,2011-02-01,0,0,0,0,0,0
Eritrea,2011-02-01,0,0,0,0,0,0
Eritrea,2011-02-01,10,0,0,9,3,22
Eritrea,2011-02-01,8,0,0,9,3,20
Eritrea,2011-02-01,10,0,0,9,3,22
Eritrea,2011-02-01,2,0,0,0,0,2
Eritrea,2011-02-01,0,0,0,0,0,0
Eritrea,2011-02-01,0,0,0,6,0,6
Eritrea,2011-02-01,16,0,0,6,0,22
Eritrea,2011-02-01,0,0,0,0,0,0
Eritrea,2011-02-01,5,0,0,12,2,19
Eritrea,2011-02-01,7,0,0,3,0,10
Eritrea,2011-02-01,3,0,0,3,0,6
Eritrea,2011-02-01,0,0,0,-4,0,-4
Eritrea,2011-02-01,0,2,0,0,0,2
Eritrea,2011-02-01,2,0,0,0,0,2
Eritrea,2011-02-01,3,0,0,0,0,3
Eritrea,2011-02-01,4,0,0,0,0,4
Eritrea,2011-02-01,6,0,0,0,0,6
Eritrea,2011-02-01,15,0,0,0,0,15
Eritrea,2011-02-01,2,0,0,12,2,16
Eritrea,2011-02-01,0,0,0,3,0,3
Eritrea,2011-02-01,7,0,0,0,3,10
Eritrea,2011-02-01,7,0,0,9,2,18
Eritrea,2011-02-01,0,0,0,0,0,0
Eritrea,2011-02-01,10,0,2,0,0,12
Georgia,2011-02-01,55,0,-2,35,9,97
Georgia,2011-02-01,20,2,0,23,3,48
Georgia,2011-02-01,23,0,1,6,-2,28
Georgia,2011-02-01,39,2,-1,22,4,66
Georgia,2011-02-01,17,0,-4,7,7,27
Georgia,2011-02-01,17,0,-4,9,2,24
Georgia,2011-02-01,35,0,-2,9,4,46
Georgia,2011-02-01,40,2,0,34,2,78
Georgia,2011-02-01,50,0,0,35,5,90
Georgia,2011-02-01,63,0,0,28,11,102
Georgia,2011-02-01,16,0,0,16,2,34
Georgia,2011-02-01,14,0,-4,7,1,18
Georgia,2011-02-01,7,0,0,12,8,27
Georgia,2011-02-01,37,0,0,24,9,70
Georgia,2011-02-01,26,0,-3,13,3,39
Georgia,2011-02-01,32,2,-1,40,8,81
Georgia,2011-02-01,27,0,0,-2,7,32
Georgia,2011-02-01,7,0,0,0,0,7
Georgia,2011-02-01,9,0,0,8,0,17
Georgia,2011-02-01,19,0,0,4,2,25
Georgia,2011-02-01,76,2,1,68,8,155
Georgia,2011-02-01,51,0,0,28,1,80
Georgia,2011-02-01,48,2,-2,11,7,66
Georgia,2011-02-01,39,0,1,41,3,84
Georgia,2011-02-01,37,0,-2,10,7,52
Georgia,2011-02-01,33,0,0,13,3,49
Georgia,2011-02-01,16,0,0,10,5,31
Georgia,2011-02-01,28,2,-1,2,5,36
India,2011-02-01,20,0,1,16,9,46
India,2011-02-01,82,0,-1,24,10,115
India,2011-02-01,93,0,-4,9,5,103
India,2011-02-01,32,0,0,14,9,55
India,2011-02-01,35,4,2,9,12,62
India,2011-02-01,59,0,-2,20,3,80
India,2011-02-01,67,6,0,46,9,128
India,2011-02-01,94,2,-1,28,4,127
India,2011-02-01,39,0,0,34,8,81
India,2011-02-01,80,0,-5,16,20,111
India,2011-02-01,67,0,-4,18,15,96
India,2011-02-01,50,0,0,5,11,66
India,2011-02-01,44,8,-3,8,12,69
India,2011-02-01,67,0,0,24,7,98
India,2011-02-01,47,0,-2,44,14,103
India,2011-02-01,42,0,-4,13,7,58
India,2011-02-01,46,0,0,9,5,60
India,2011-02-01,0,0,0,0,0,0
India,2011-02-01,88,0,1,37,19,145
India,2011-02-01,64,0,-2,17,17,96
India,2011-02-01,71,2,-9,1,42,107
India,2011-02-01,74,0,-21,12,18,83
India,2011-02-01,56,0,-10,0,16,62
India,2011-02-01,62,2,-4,10,8,78
India,2011-02-01,59,0,0,14,2,75
India,2011-02-01,35,2,-2,21,5,61
India,2011-02-01,58,6,-1,66,11,140
India,2011-02-01,59,2,-5,57,4,117
Iran,2011-02-01,141,0,-4,86,59,282
Iran,2011-02-01,115,0,0,40,16,171
Iran,2011-02-01,132,4,-9,68,16,211
Iran,2011-02-01,159,0,1,80,33,273
Iran,2011-02-01,185,0,-7,79,35,292
Iran,2011-02-01,110,2,-2,96,25,231
Iran,2011-02-01,61,0,-6,22,32,109
Iran,2011-02-01,20,2,0,68,15,105
Iran,2011-02-01,81,4,-6,116,36,231
Iran,2011-02-01,57,0,-10,84,21,152
Iran,2011-02-01,119,0,-26,22,18,133
Iran,2011-02-01,74,0,-3,47,65,183
Iran,2011-02-01,66,4,-3,4,49,120
Iran,2011-02-01,152,0,-11,63,63,267
Iran,2011-02-01,263,0,-7,70,57,383
Iran,2011-02-01,526,0,-18,242,104,854
Iran,2011-02-01,148,0,4,28,32,212
Iran,2011-02-01,8,0,0,3,2,13
Iran,2011-02-01,95,0,2,26,26,149
Iran,2011-02-01,122,4,-3,47,29,199
Iran,2011-02-01,123,0,4,31,25,183
Iran,2011-02-01,133,2,-9,67,34,227
Iran,2011-02-01,81,0,4,39,28,152
Iran,2011-02-01,146,0,1,47,15,209
Iran,2011-02-01,59,0,0,71,9,139
Iran,2011-02-01,51,0,0,42,4,97
Iran,2011-02-01,66,0,-1,29,12,106
Iran,2011-02-01,63,0,-8,16,8,79
Iraq,2011-02-01,142,2,-2,10,14,166
Iraq,2011-02-01,109,4,-4,58,19,186
Iraq,2011-02-01,216,24,-8,102,21,355
Iraq,2011-02-01,385,4,-8,174,58,613
Iraq,2011-02-01,124,0,-4,42,3,165
Iraq,2011-02-01,92,4,-2,103,7,204
Iraq,2011-02-01,60,2,-1,64,7,132
Iraq,2011-02-01,51,0,-2,70,9,128
Iraq,2011-02-01,90,0,-1,18,12,119
Iraq,2011-02-01,114,2,-3,27,7,147
Iraq,2011-02-01,77,2,3,32,8,122
Iraq,2011-02-01,86,0,0,10,38,134
Iraq,2011-02-01,57,0,0,-4,28,81
Iraq,2011-02-01,39,0,-5,-9,3,28
Iraq,2011-02-01,94,0,-10,35,25,144
Iraq,2011-02-01,129,0,-1,16,53,197
Iraq,2011-02-01,180,0,-8,20,21,213
Iraq,2011-02-01,11,0,0,0,1,12
Iraq,2011-02-01,88,2,0,18,13,121
Iraq,2011-02-01,76,4,-1,-2,13,90
Iraq,2011-02-01,95,0,0,-7,20,108
Iraq,2011-02-01,192,10,0,31,32,265
Iraq,2011-02-01,157,2,3,84,23,269
Iraq,2011-02-01,130,0,4,65,32,231
Iraq,2011-02-01,125,0,1,71,28,225
Iraq,2011-02-01,105,0,-3,27,19,148
Iraq,2011-02-01,83,0,-5,15,18,111
Iraq,2011-02-01,152,0,2,77,27,258
Morocco,2011-02-01,4,0,1,3,2,10
Morocco,2011-02-01,7,0,-2,21,6,32
Morocco,2011-02-01,10,0,0,1,2,13
Morocco,2011-02-01,10,0,0,6,2,18
Morocco,2011-02-01,0,0,0,0,2,2
Morocco,2011-02-01,12,0,0,3,0,15
Morocco,2011-02-01,-1,0,-10,0,0,-11
Morocco,2011-02-01,-1,0,0,12,2,13
Morocco,2011-02-01,13,0,-4,15,2,26
Morocco,2011-02-01,9,0,-4,15,0,20
Morocco,2011-02-01,12,0,-4,7,3,18
Morocco,2011-02-01,14,0,0,6,1,21
Morocco,2011-02-01,7,0,0,0,6,13
Morocco,2011-02-01,-3,0,0,-2,3,-2
Morocco,2011-02-01,9,0,0,59,3,71
Morocco,2011-02-01,22,0,0,30,3,55
Morocco,2011-02-01,4,4,0,8,2,18
Morocco,2011-02-01,0,0,0,0,1,1
Morocco,2011-02-01,43,0,-4,12,12,63
Morocco,2011-02-01,42,0,0,12,20,74
Morocco,2011-02-01,54,0,-2,-6,21,67
Morocco,2011-02-01,15,4,1,9,8,37
Morocco,2011-02-01,25,4,0,23,9,61
Morocco,2011-02-01,11,0,0,21,10,42
Morocco,2011-02-01,5,0,0,6,3,14
Morocco,2011-02-01,-5,0,0,0,7,2
Morocco,2011-02-01,8,0,0,0,9,17
Morocco,2011-02-01,8,0,0,4,3,15
Nigeria,2011-02-01,24,0,1,18,6,49
Nigeria,2011-02-01,18,0,2,32,2,54
Nigeria,2011-02-01,18,0,-2,9,2,27
Nigeria,2011-02-01,54,2,-6,7,9,66
Nigeria,2011-02-01,10,2,-3,16,2,27
Nigeria,2011-02-01,10,0,0,3,1,14
Nigeria,2011-02-01,27,0,-4,22,7,52
Nigeria,2011-02-01,21,0,0,55,8,84
Nigeria,2011-02-01,39,0,1,19,2,61
Nigeria,2011-02-01,17,0,1,1,2,21
Nigeria,2011-02-01,25,0,0,18,4,47
Nigeria,2011-02-01,25,0,2,6,7,40
Nigeria,2011-02-01,16,0,0,-6,1,11
Nigeria,2011-02-01,21,2,1,33,16,73
Nigeria,2011-02-01,56,8,0,11,1,76
Nigeria,2011-02-01,89,0,0,22,6,117
Nigeria,2011-02-01,33,0,0,-9,2,26
Nigeria,2011-02-01,0,0,0,0,0,0
Nigeria,2011-02-01,32,0,-3,7,4,40
Nigeria,2011-02-01,19,0,0,6,0,25
Nigeria,2011-02-01,14,0,-2,5,9,26
Nigeria,2011-02-01,150,2,1,8,6,167
Nigeria,2011-02-01,49,0,-2,4,2,53
Nigeria,2011-02-01,76,0,4,21,8,109
Nigeria,2011-02-01,27,0,0,21,6,54
Nigeria,2011-02-01,9,0,0,27,5,41
Nigeria,2011-02-01,19,0,0,24,2,45
Nigeria,2011-02-01,23,2,2,11,6,44
Pakistan,2011-02-01,64,0,3,23,10,100
Pakistan,2011-02-01,88,0,0,28,10,126
Pakistan,2011-02-01,97,2,-2,13,16,126
Pakistan,2011-02-01,109,8,-3,70,5,189
Pakistan,2011-02-01,45,2,0,-7,4,44
Pakistan,2011-02-01,58,0,0,23,23,104
Pakistan,2011-02-01,110,0,0,56,15,181
Pakistan,2011-02-01,146,2,0,52,5,205
Pakistan,2011-02-01,74,6,-25,23,4,82
Pakistan,2011-02-01,105,2,-8,5,43,147
Pakistan,2011-02-01,97,0,-9,75,13,176
Pakistan,2011-02-01,84,0,0,71,9,164
Pakistan,2011-02-01,51,0,-1,29,7,86
Pakistan,2011-02-01,111,0,-8,20,12,135
Pakistan,2011-02-01,154,0,-5,41,14,204
Pakistan,2011-02-01,170,16,0,55,20,261
Pakistan,2011-02-01,55,0,1,35,12,103
Pakistan,2011-02-01,7,0,0,6,0,13
Pakistan,2011-02-01,99,0,-2,22,9,128
Pakistan,2011-02-01,137,2,0,32,14,185
Pakistan,2011-02-01,220,2,16,57,35,330
Pakistan,2011-02-01,56,0,0,26,8,90
Pakistan,2011-02-01,77,0,1,35,6,119
Pakistan,2011-02-01,59,0,0,48,10,117
Pakistan,2011-02-01,64,4,0,60,8,136
Pakistan,2011-02-01,35,0,0,21,7,63
Pakistan,2011-02-01,57,0,-2,18,0,73
Pakistan,2011-02-01,104,0,1,70,3,178
Sierra Leone,2011-02-01,0,0,0,0,0,0
Sierra Leone,2011-02-01,-2,0,0,3,0,1
Sierra Leone,2011-02-01,1,0,0,3,0,4
Sierra Leone,2011-02-01,2,0,0,3,0,5
Sierra Leone,2011-02-01,3,0,0,0,0,3
Sierra Leone,2011-02-01,0,0,0,0,1,1
Sierra Leone,2011-02-01,3,0,1,0,0,4
Sierra Leone,2011-02-01,67,0,2,15,1,85
Sierra Leone,2011-02-01,44,0,4,4,3,55
Sierra Leone,2011-02-01,8,0,0,3,0,11
Sierra Leone,2011-02-01,15,0,1,12,3,31
Sierra Leone,2011-02-01,8,0,0,3,0,11
Sierra Leone,2011-02-01,8,0,0,0,0,8
Sierra Leone,2011-02-01,17,0,0,3,0,20
Sierra Leone,2011-02-01,11,0,0,6,0,17
Sierra Leone,2011-02-01,1,0,0,0,0,1
Sierra Leone,2011-02-01,6,0,0,0,0,6
Sierra Leone,2011-02-01,14,0,0,3,2,19
Sierra Leone,2011-02-01,0,0,0,0,0,0
Sierra Leone,2011-02-01,5,0,-2,0,3,6
Sierra Leone,2011-02-01,2,0,0,0,3,5
Sierra Leone,2011-02-01,5,0,0,-2,0,3
Sierra Leone,2011-02-01,-1,0,3,4,1,7
Sierra Leone,2011-02-01,9,0,0,0,0,9
Sierra Leone,2011-02-01,1,0,0,0,0,1
Sierra Leone,2011-02-01,0,0,0,-4,0,-4
Sierra Leone,2011-02-01,18,0,0,0,0,18
Somalia,2011-02-01,96,0,0,34,11,141
Somalia,2011-02-01,58,0,1,42,7,108
Somalia,2011-02-01,81,0,0,104,25,210
Somalia,2011-02-01,83,0,-2,64,12,157
Somalia,2011-02-01,40,0,0,18,3,61
Somalia,2011-02-01,72,0,0,60,13,145
Somalia,2011-02-01,59,0,0,72,5,136
Somalia,2011-02-01,62,2,-2,23,8,93
Somalia,2011-02-01,121,2,1,-16,18,126
Somalia,2011-02-01,65,0,0,-6,8,67
Somalia,2011-02-01,82,0,1,136,6,225
Somalia,2011-02-01,25,0,0,14,8,47
Somalia,2011-02-01,88,0,-6,16,6,104
Somalia,2011-02-01,44,0,-2,25,4,71
Somalia,2011-02-01,73,0,0,39,5,117
Somalia,2011-02-01,147,0,-16,272,21,424
Somalia,2011-02-01,57,0,-2,103,38,196
Somalia,2011-02-01,0,0,0,24,0,24
Somalia,2011-02-01,100,0,0,143,24,267
Somalia,2011-02-01,69,0,0,72,6,147
Somalia,2011-02-01,62,0,1,28,6,97
Somalia,2011-02-01,294,0,0,108,16,418
Somalia,2011-02-01,393,4,0,121,40,558
Somalia,2011-02-01,1615,12,-8,306,104,2029
Somalia,2011-02-01,92,0,0,54,5,151
Somalia,2011-02-01,69,0,0,49,3,121
Somalia,2011-02-01,48,0,0,32,15,95
Somalia,2011-02-01,155,0,0,45,12,212
Syria,2011-02-01,62,0,-2,21,17,98
Syria,2011-02-01,45,0,-6,23,21,83
Syria,2011-02-01,34,0,-7,33,6,66
Syria,2011-02-01,23,0,-4,8,20,47
Syria,2011-02-01,12,0,0,6,4,22
Syria,2011-02-01,26,0,0,1,4,31
Syria,2011-02-01,22,0,0,0,1,23
Syria,2011-02-01,8,0,0,3,0,11
Syria,2011-02-01,13,0,0,13,4,30
Syria,2011-02-01,20,0,-4,27,2,45
Syria,2011-02-01,22,0,0,12,1,35
Syria,2011-02-01,27,0,0,9,3,39
Syria,2011-02-01,26,0,-2,8,2,34
Syria,2011-02-01,34,0,-2,28,0,60
Syria,2011-02-01,-3,0,-2,45,8,48
Syria,2011-02-01,45,0,0,45,3,93
Syria,2011-02-01,25,0,0,15,0,40
Syria,2011-02-01,0,0,0,0,1,1
Syria,2011-02-01,17,0,0,12,23,52
Syria,2011-02-01,18,0,-2,3,8,27
Syria,2011-02-01,18,0,0,6,8,32
Syria,2011-02-01,40,0,0,5,1,46
Syria,2011-02-01,14,0,0,10,2,26
Syria,2011-02-01,7,0,0,11,9,27
Syria,2011-02-01,35,0,2,8,7,52
Syria,2011-02-01,11,0,4,11,9,35
Syria,2011-02-01,17,0,-2,11,12,38
Syria,2011-02-01,18,0,0,5,5,28
Yemen,2011-02-01,53,0,-1,7,16,75
Yemen,2011-02-01,65,0,-15,32,27,109
Yemen,2011-02-01,84,0,-20,23,19,106
Yemen,2011-02-01,37,0,-6,3,16,50
Yemen,2011-02-01,16,0,-8,9,13,30
Yemen,2011-02-01,46,0,-2,5,10,59
Yemen,2011-02-01,31,0,-12,12,3,34
Yemen,2011-02-01,4,0,0,3,1,8
Yemen,2011-02-01,32,0,0,8,7,47
Yemen,2011-02-01,26,0,-2,0,10,34
Yemen,2011-02-01,19,0,0,6,5,30
Yemen,2011-02-01,37,0,0,7,12,56
Yemen,2011-02-01,89,0,-5,5,8,97
Yemen,2011-02-01,85,0,-11,28,20,122
Yemen,2011-02-01,192,0,-12,-1,30,209
Yemen,2011-02-01,159,0,1,33,26,219
Yemen,2011-02-01,122,2,2,35,22,183
Yemen,2011-02-01,29,0,0,18,9,56
Yemen,2011-02-01,159,0,-1,52,51,261
Yemen,2011-02-01,96,0,-4,54,50,196
Yemen,2011-02-01,84,2,-1,25,53,163
Yemen,2011-02-01,73,0,-11,47,25,134
Yemen,2011-02-01,39,2,-9,37,22,91
Yemen,2011-02-01,39,0,-6,7,14,54
Yemen,2011-02-01,48,0,-8,0,17,57
Yemen,2011-02-01,45,0,-6,3,4,46
Yemen,2011-02-01,10,0,-8,-2,25,25
Yemen,2011-02-01,97,0,-14,58,23,164
Afghanistan,2008-03-01,142,2,2,21,2,169
Afghanistan,2008-03-01,165,6,1,31,20,223
Afghanistan,2008-03-01,130,2,1,7,11,151
Afghanistan,2008-03-01,121,4,0,21,25,171
Afghanistan,2008-03-01,90,2,0,49,17,158
Afghanistan,2008-03-01,154,2,0,69,23,248
Afghanistan,2008-03-01,132,0,0,33,6,171
Afghanistan,2008-03-01,45,0,-4,10,15,66
Afghanistan,2008-03-01,36,0,-1,5,1,41
Afghanistan,2008-03-01,73,0,0,10,10,93
Afghanistan,2008-03-01,125,0,-4,9,59,189
Afghanistan,2008-03-01,237,0,-15,47,116,385
Afghanistan,2008-03-01,78,0,0,15,9,102
Afghanistan,2008-03-01,106,0,-2,81,7,192
Afghanistan,2008-03-01,51,0,0,45,14,110
Afghanistan,2008-03-01,141,0,0,44,11,196
Afghanistan,2008-03-01,132,0,1,13,57,203
Afghanistan,2008-03-01,134,2,0,-1,23,158
Afghanistan,2008-03-01,59,0,0,11,4,74
Afghanistan,2008-03-01,74,0,0,3,19,96
Afghanistan,2008-03-01,119,0,0,23,10,152
Afghanistan,2008-03-01,24,0,1,6,3,34
Afghanistan,2008-03-01,37,0,0,25,3,65
Afghanistan,2008-03-01,73,0,-1,28,7,107
Afghanistan,2008-03-01,102,6,0,77,5,190
Afghanistan,2008-03-01,55,0,0,7,3,65
Afghanistan,2008-03-01,120,0,1,25,11,157
Afghanistan,2008-03-01,208,0,0,9,7,224
Afghanistan,2008-03-01,139,4,-4,10,11,160
Afghanistan,2008-03-01,66,0,-1,38,12,115
Afghanistan,2008-03-01,77,2,1,55,10,145
Albania,2008-03-01,4,0,-2,0,0,2
Albania,2008-03-01,9,2,0,0,0,11
Albania,2008-03-01,26,0,0,0,0,26
Albania,2008-03-01,38,0,2,9,0,49
Albania,2008-03-01,8,0,0,3,2,13
Albania,2008-03-01,23,0,0,39,0,62
Albania,2008-03-01,23,0,-2,14,0,35
Albania,2008-03-01,47,0,-1,54,3,103
Albania,2008-03-01,6,0,0,0,0,6
Albania,2008-03-01,34,0,1,48,0,83
Albania,2008-03-01,24,0,0,4,0,28
Albania,2008-03-01,2,0,0,0,2,4
Albania,2008-03-01,6,0,-1,18,0,23
Albania,2008-03-01,34,0,0,18,-3,49
Albania,2008-03-01,18,0,0,0,0,18
Albania,2008-03-01,2,0,0,0,1,3
Albania,2008-03-01,84,0,-15,53,5,127
Albania,2008-03-01,72,0,-19,32,11,96
Albania,2008-03-01,43,0,-1,22,0,64
Albania,2008-03-01,27,0,0,-10,2,19
Albania,2008-03-01,35,0,0,2,0,37
Albania,2008-03-01,0,0,-1,0,0,-1
Albania,2008-03-01,5,0,0,0,0,5
Albania,2008-03-01,24,0,-1,-5,0,18
Albania,2008-03-01,7,0,-1,7,1,14
Albania,2008-03-01,0,0,-1,12,6,17
Albania,2008-03-01,6,0,-3,6,0,9
Albania,2008-03-01,17,0,0,6,0,23
Albania,2008-03-01,7,0,0,0,0,7
Albania,2008-03-01,17,0,0,0,5,22
Albania,2008-03-01,0,0,-2,3,1,2
Algeria,2008-03-01,0,0,0,0,0,0
Algeria,2008-03-01,-1,0,0,-1,1,-1
Algeria,2008-03-01,0,0,0,2,0,2
Algeria,2008-03-01,6,0,0,0,0,6
Algeria,2008-03-01,7,0,0,3,0,10
Algeria,2008-03-01,2,0,0,0,0,2
Algeria,2008-03-01,6,0,0,-1,0,5
Algeria,2008-03-01,0,0,-2,-4,0,-6
Algeria,2008-03-01,2,0,0,6,0,8
Algeria,2008-03-01,10,0,0,12,3,25
Algeria,2008-03-01,12,0,0,4,0,16
Algeria,2008-03-01,-2,0,2,9,0,9
Algeria,2008-03-01,9,0,2,4,0,15
Algeria,2008-03-01,13,0,0,31,0,44
Algeria,2008-03-01,2,0,0,22,0,24
Algeria,2008-03-01,9,0,0,34,0,43
Algeria,2008-03-01,16,2,0,48,0,66
Algeria,2008-03-01,0,2,0,34,0,36
Algeria,2008-03-01,2,0,0,6,0,8
Algeria,2008-03-01,6,0,0,3,0,9
Algeria,2008-03-01,-3,0,-2,9,0,4
Algeria,2008-03-01,6,0,0,35,0,41
Algeria,2008-03-01,9,0,0,14,2,25
Algeria,2008-03-01,2,0,0,43,0,45
Algeria,2008-03-01,0,0,0,17,0,17
Algeria,2008-03-01,0,0,0,-16,0,-16
Algeria,2008-03-01,0,4,0,6,1,11
Algeria,2008-03-01,5,0,0,6,0,11
Algeria,2008-03-01,0,0,0,0,0,0
Algeria,2008-03-01,0,0,0,0,0,0
Algeria,2008-03-01,1,0,0,7,0,8
Bangladesh,2008-03-01,0,0,0,0,0,0
Bangladesh,2008-03-01,0,0,0,0,0,0
Bangladesh,2008-03-01,8,4,0,6,3,21
Bangladesh,2008-03-01,2,0,-2,3,0,3
Bangladesh,2008-03-01,0,0,-8,3,7,2
Bangladesh,2008-03-01,3,0,0,20,0,23
Bangladesh,2008-03-01,19,0,-2,15,0,32
Bangladesh,2008-03-01,3,4,0,3,1,11
Bangladesh,2008-03-01,6,0,0,0,0,6
Bangladesh,2008-03-01,2,0,0,0,0,2
Bangladesh,2008-03-01,41,0,-2,14,4,57
Bangladesh,2008-03-01,20,0,0,12,1,33
Bangladesh,2008-03-01,2,0,0,6,0,8
Bangladesh,2008-03-01,5,0,-2,3,0,6
Bangladesh,2008-03-01,6,0,0,0,0,6
Bangladesh,2008-03-01,0,0,0,-4,0,-4
Bangladesh,2008-03-01,6,0,-2,3,0,7
Bangladesh,2008-03-01,14,0,0,15,0,29
Bangladesh,2008-03-01,8,0,0,8,0,16
Bangladesh,2008-03-01,8,0,-2,3,3,12
Bangladesh,2008-03-01,5,0,0,4,3,12
Bangladesh,2008-03-01,14,0,0,0,2,16
Bangladesh,2008-03-01,17,0,0,3,4,24
Bangladesh,2008-03-01,6,0,-1,16,1,22
Bangladesh,2008-03-01,0,0,0,6,2,8
Bangladesh,2008-03-01,11,0,0,-2,2,11
Bangladesh,2008-03-01,6,0,0,0,0,6
Bangladesh,2008-03-01,4,0,0,0,0,4
Bangladesh,2008-03-01,19,0,0,0,12,31
Bangladesh,2008-03-01,8,0,0,1,4,13
Bangladesh,2008-03-01,20,0,-2,9,2,29
Cameroon,2008-03-01,0,0,0,0,3,3
Cameroon,2008-03-01,2,0,0,0,3,5
Cameroon,2008-03-01,3,0,0,3,2,8
Cameroon,2008-03-01,6,0,0,6,2,14
Cameroon,2008-03-01,1,0,0,6,0,7
Cameroon,2008-03-01,8,0,0,0,4,12
Cameroon,2008-03-01,3,4,0,0,0,7
Cameroon,2008-03-01,-1,0,0,0,0,-1
Cameroon,2008-03-01,1,0,0,3,0,4
Cameroon,2008-03-01,3,0,0,3,0,6
Cameroon,2008-03-01,0,0,0,0,2,2
Cameroon,2008-03-01,3,0,0,0,0,3
Cameroon,2008-03-01,3,0,0,0,0,3
Cameroon,2008-03-01,0,0,0,0,2,2
Cameroon,2008-03-01,0,0,0,0,0,0
Cameroon,2008-03-01,0,0,0,0,0,0
Cameroon,2008-03-01,0,0,0,3,2,5
Cameroon,2008-03-01,0,0,0,0,0,0
Cameroon,2008-03-01,0,0,0,0,0,0
Cameroon,2008-03-01,3,0,0,0,2,5
Cameroon,2008-03-01,3,0,0,0,0,3
Cameroon,2008-03-01,0,0,0,0,0,0
Cameroon,2008-03-01,0,0,0,0,0,0
Cameroon,2008-03-01,3,0,0,0,0,3
China,2008-03-01,34,4,4,42,10,94
China,2008-03-01,28,0,0,2,14,44
China,2008-03-01,96,0,-8,53,2,143
China,2008-03-01,83,4,-2,25,12,122
China,2008-03-01,104,0,-3,47,13,161
China,2008-03-01,124,0,3,29,19,175
China,2008-03-01,74,2,0,6,11,93
China,2008-03-01,47,0,0,18,8,73
China,2008-03-01,29,0,2,0,5,36
China,2008-03-01,38,4,-2,36,16,92
China,2008-03-01,13,0,-2,22,8,41
China,2008-03-01,71,0,-3,55,9,132
China,2008-03-01,79,0,0,37,13,129
China,2008-03-01,166,0,2,59,40,267
China,2008-03-01,118,0,4,53,30,205
China,2008-03-01,148,2,2,35,24,211
China,2008-03-01,66,0,-2,49,18,131
China,2008-03-01,145,0,-16,59,51,239
China,2008-03-01,59,0,-12,5,12,64
China,2008-03-01,139,0,0,16,18,173
China,2008-03-01,111,0,-6,74,35,214
China,2008-03-01,53,0,-1,24,17,93
China,2008-03-01,81,0,-9,14,8,94
China,2008-03-01,121,0,0,62,31,214
China,2008-03-01,78,0,-11,44,25,136
China,2008-03-01,42,0,-5,21,4,62
China,2008-03-01,61,2,0,5,14,82
China,2008-03-01,60,0,1,36,9,106
China,2008-03-01,25,6,-2,45,13,87
China,2008-03-01,52,2,-4,21,8,79
China,2008-03-01,45,0,-4,13,10,64
Egypt,2008-03-01,16,2,0,7,0,25
Egypt,2008-03-01,34,0,2,0,1,37
Egypt,2008-03-01,65,0,1,-1,9,74
Egypt,2008-03-01,32,0,1,21,0,54
Egypt,2008-03-01,20,0,0,7,2,29
Egypt,2008-03-01,31,0,1,21,9,62
Egypt,2008-03-01,20,0,1,1,5,27
Egypt,2008-03-01,24,0,1,0,0,25
Egypt,2008-03-01,54,0,0,0,3,57
Egypt,2008-03-01,49,0,0,6,0,55
Egypt,2008-03-01,114,0,-2,-12,6,106
Egypt,2008-03-01,49,0,0,-9,2,42
Egypt,2008-03-01,23,0,0,9,2,34
Egypt,2008-03-01,14,0,0,3,1,18
Egypt,2008-03-01,9,0,0,19,2,30
Egypt,2008-03-01,6,0,0,6,4,16
Egypt,2008-03-01,18,0,0,-4,0,14
Egypt,2008-03-01,68,0,0,10,0,78
Egypt,2008-03-01,3,0,0,3,1,7
Egypt,2008-03-01,2,0,0,0,1,3
Egypt,2008-03-01,21,0,0,4,5,30
Egypt,2008-03-01,7,0,0,0,0,7
Egypt,2008-03-01,42,0,3,1,5,51
Egypt,2008-03-01,27,0,0,-5,5,27
Egypt,2008-03-01,21,2,1,15,2,41
Egypt,2008-03-01,56,0,0,34,4,94
Egypt,2008-03-01,57,0,0,18,4,79
Egypt,2008-03-01,51,0,1,35,0,87
Egypt,2008-03-01,8,0,0,9,0,17
Egypt,2008-03-01,-1,0,0,37,4,40
Egypt,2008-03-01,26,0,0,-19,1,8
Eritrea,2008-03-01,3,0,0,12,0,15
Eritrea,2008-03-01,0,0,0,0,0,0
Eritrea,2008-03-01,10,0,0,0,0,10
Eritrea,2008-03-01,0,0,0,0,0,0
Eritrea,2008-03-01,0,0,0,0,0,0
Eritrea,2008-03-01,3,0,0,0,0,3
Eritrea,2008-03-01,1,0,0,0,0,1
Eritrea,2008-03-01,24,2,1,33,0,60
Eritrea,2008-03-01,45,0,0,30,0,75
Eritrea,2008-03-01,-6,0,0,0,4,-2
Eritrea,2008-03-01,9,0,0,0,0,9
Eritrea,2008-03-01,7,0,0,0,0,7
Eritrea,2008-03-01,20,0,0,3,0,23
Eritrea,2008-03-01,0,0,0,0,0,0
Eritrea,2008-03-01,0,0,0,6,0,6
Eritrea,2008-03-01,3,0,0,3,0,6
Eritrea,2008-03-01,2,0,0,-8,0,-6
Eritrea,2008-03-01,-7,0,0,0,0,-7
Eritrea,2008-03-01,-9,0,0,0,0,-9
Eritrea,2008-03-01,16,0,0,15,0,31
Eritrea,2008-03-01,17,0,0,0,0,17
Eritrea,2008-03-01,0,0,0,6,0,6
Eritrea,2008-03-01,0,0,0,0,0,0
Eritrea,2008-03-01,8,0,0,3,4,15
Eritrea,2008-03-01,3,0,0,0,0,3
Georgia,2008-03-01,25,0,0,-4,2,23
Georgia,2008-03-01,3,0,0,0,0,3
Georgia,2008-03-01,7,0,0,3,2,12
Georgia,2008-03-01,11,0,0,3,2,16
Georgia,2008-03-01,7,2,0,0,2,11
Georgia,2008-03-01,29,0,0,0,2,31
Georgia,2008-03-01,43,2,-1,4,4,52
Georgia,2008-03-01,8,0,0,18,0,26
Georgia,2008-03-01,-3,0,0,-2,0,-5
Georgia,2008-03-01,0,0,0,0,1,1
Georgia,2008-03-01,2,0,-1,2,0,3
Georgia,2008-03-01,2,0,0,4,0,6
Georgia,2008-03-01,4,0,0,13,3,20
Georgia,2008-03-01,17,0,-2,9,0,24
Georgia,2008-03-01,4,0,0,6,1,11
Georgia,2008-03-01,3,0,0,6,0,9
Georgia,2008-03-01,2,0,0,3,0,5
Georgia,2008-03-01,11,0,0,3,4,18
Georgia,2008-03-01,0,0,0,0,0,0
Georgia,2008-03-01,6,0,0,0,0,6
Georgia,2008-03-01,9,0,0,0,0,9
Georgia,2008-03-01,3,0,0,3,0,6
Georgia,2008-03-01,1,0,0,0,2,3
Georgia,2008-03-01,21,0,0,15,2,38
Georgia,2008-03-01,9,0,0,8,2,19
Georgia,2008-03-01,26,0,0,-6,2,22
Georgia,2008-03-01,14,0,0,6,2,22
Georgia,2008-03-01,55,0,0,0,2,57
Georgia,2008-03-01,21,0,0,6,0,27
Georgia,2008-03-01,6,0,0,-6,1,1
Georgia,2008-03-01,5,0,0,-2,0,3
India,2008-03-01,13,0,0,-3,2,12
India,2008-03-01,23,0,0,7,5,35
India,2008-03-01,7,2,0,34,1,44
India,2008-03-01,25,4,0,36,9,74
India,2008-03-01,41,2,0,4,1,48
India,2008-03-01,28,4,0,5,5,42
India,2008-03-01,25,0,0,6,2,33
India,2008-03-01,11,2,0,-3,13,23
India,2008-03-01,10,0,0,-4,1,7
India,2008-03-01,30,0,0,13,13,56
India,2008-03-01,17,0,0,9,11,37
India,2008-03-01,22,0,-2,18,4,42
India,2008-03-01,5,0,0,-3,3,5
India,2008-03-01,72,0,-3,65,22,156
India,2008-03-01,39,0,0,37,3,79
India,2008-03-01,41,0,2,22,5,70
India,2008-03-01,38,0,0,16,3,57
India,2008-03-01,108,0,-6,7,11,120
India,2008-03-01,27,0,0,3,4,34
India,2008-03-01,33,0,0,35,4,72
India,2008-03-01,51,0,-4,10,3,60
India,2008-03-01,20,0,0,18,0,38
India,2008-03-01,37,0,0,11,5,53
India,2008-03-01,66,0,4,22,10,102
India,2008-03-01,41,0,1,9,9,60
India,2008-03-01,24,2,1,-1,7,33
India,2008-03-01,22,0,-4,10,6,34
India,2008-03-01,26,0,0,29,14,69
India,2008-03-01,34,0,0,13,7,54
India,2008-03-01,79,2,0,13,9,103
India,2008-03-01,19,0,0,15,1,35
Iran,2008-03-01,64,2,0,27,8,101
Iran,2008-03-01,119,0,0,20,21,160
Iran,2008-03-01,117,0,1,42,11,171
Iran,2008-03-01,98,0,2,29,9,138
Iran,2008-03-01,46,2,1,7,4,60
Iran,2008-03-01,51,0,1,17,16,85
Iran,2008-03-01,53,0,-3,10,3,63
Iran,2008-03-01,34,0,0,12,2,48
Iran,2008-03-01,22,0,0,34,6,62
Iran,2008-03-01,40,0,0,24,3,67
Iran,2008-03-01,67,0,-14,69,4,126
Iran,2008-03-01,96,0,-12,13,10,107
Iran,2008-03-01,27,0,0,37,3,67
Iran,2008-03-01,141,0,6,49,17,213
Iran,2008-03-01,24,0,2,-1,13,38
Iran,2008-03-01,52,0,1,9,13,75
Iran,2008-03-01,54,0,0,13,8,75
Iran,2008-03-01,83,0,0,6,9,98
Iran,2008-03-01,33,0,0,6,2,41
Iran,2008-03-01,25,0,0,36,1,62
Iran,2008-03-01,30,0,-2,6,2,36
Iran,2008-03-01,30,0,1,3,2,36
Iran,2008-03-01,82,0,3,7,4,96
Iran,2008-03-01,26,0,-2,6,3,33
Iran,2008-03-01,115,0,-2,9,5,127
Iran,2008-03-01,67,2,-2,34,6,107
Iran,2008-03-01,43,0,-1,10,3,55
Iran,2008-03-01,58,0,0,28,0,86
Iran,2008-03-01,93,0,-1,16,18,126
Iran,2008-03-01,71,0,-2,21,5,95
Iran,2008-03-01,21,0,0,10,6,37
Iraq,2008-03-01,71,0,1,24,10,106
Iraq,2008-03-01,180,0,-4,22,14,212
Iraq,2008-03-01,149,0,-3,38,29,213
Iraq,2008-03-01,141,0,-5,21,20,177
Iraq,2008-03-01,149,0,1,9,6,165
Iraq,2008-03-01,129,4,0,28,27,188
Iraq,2008-03-01,102,6,-1,33,15,155
Iraq,2008-03-01,55,6,-4,41,26,124
Iraq,2008-03-01,65,2,0,13,8,88
Iraq,2008-03-01,99,0,0,25,9,133
Iraq,2008-03-01,158,2,2,9,23,194
Iraq,2008-03-01,143,0,-10,-9,3,127
Iraq,2008-03-01,39,0,-4,48,3,86
Iraq,2008-03-01,145,2,-5,55,13,210
Iraq,2008-03-01,57,0,0,43,15,115
Iraq,2008-03-01,135,2,-4,43,26,202
Iraq,2008-03-01,153,2,-2,25,18,196
Iraq,2008-03-01,136,12,2,19,22,191
Iraq,2008-03-01,84,4,-1,-4,12,95
Iraq,2008-03-01,201,2,1,51,17,272
Iraq,2008-03-01,73,2,0,26,12,113
Iraq,2008-03-01,64,2,1,14,6,87
Iraq,2008-03-01,122,0,0,16,20,158
Iraq,2008-03-01,55,0,2,45,11,113
Iraq,2008-03-01,141,10,2,83,8,244
Iraq,2008-03-01,172,0,0,53,8,233
Iraq,2008-03-01,128,6,9,50,17,210
Iraq,2008-03-01,193,4,5,41,22,265
Iraq,2008-03-01,182,0,0,60,10,252
Iraq,2008-03-01,140,4,-2,5,8,155
Iraq,2008-03-01,55,0,-2,15,19,87
Morocco,2008-03-01,4,0,0,3,0,7
Morocco,2008-03-01,10,0,0,0,0,10
Morocco,2008-03-01,6,0,0,-3,2,5
Morocco,2008-03-01,-1,0,0,6,2,7
Morocco,2008-03-01,24,0,0,3,0,27
Morocco,2008-03-01,0,0,-2,9,0,7
Morocco,2008-03-01,2,0,0,7,0,9
Morocco,2008-03-01,0,0,0,0,0,0
Morocco,2008-03-01,0,0,0,6,0,6
Morocco,2008-03-01,5,0,0,3,0,8
Morocco,2008-03-01,3,0,0,3,0,6
Morocco,2008-03-01,12,0,0,9,0,21
Morocco,2008-03-01,6,0,0,3,0,9
Morocco,2008-03-01,4,0,0,0,0,4
Morocco,2008-03-01,0,0,0,0,0,0
Morocco,2008-03-01,25,0,0,3,1,29
Morocco,2008-03-01,0,0,0,-2,0,-2
Morocco,2008-03-01,15,0,0,-1,0,14
Morocco,2008-03-01,1,0,0,21,1,23
Morocco,2008-03-01,1,0,0,6,0,7
Morocco,2008-03-01,8,0,0,0,0,8
Morocco,2008-03-01,3,0,0,0,0,3
Morocco,2008-03-01,5,0,0,3,0,8
Morocco,2008-03-01,3,0,0,6,0,9
Morocco,2008-03-01,0,0,0,0,0,0
Morocco,2008-03-01,0,0,0,0,0,0
Morocco,2008-03-01,16,0,0,9,1,26
Morocco,2008-03-01,4,0,0,0,1,5
Morocco,2008-03-01,4,0,0,9,0,13
Morocco,2008-03-01,1,0,0,-2,1,0
Nigeria,2008-03-01,-1,0,-2,4,2,3
Nigeria,2008-03-01,-1,0,0,-2,0,-3
Nigeria,2008-03-01,3,0,0,3,0,6
Nigeria,2008-03-01,4,0,0,3,1,8
Nigeria,2008-03-01,16,0,0,6,2,24
Nigeria,2008-03-01,2,0,1,0,0,3
Nigeria,2008-03-01,-4,0,0,4,0,0
Nigeria,2008-03-01,10,0,0,0,0,10
Nigeria,2008-03-01,0,0,0,0,0,0
Nigeria,2008-03-01,-2,0,0,9,0,7
Nigeria,2008-03-01,20,0,0,10,0,30
Nigeria,2008-03-01,1,2,0,0,1,4
Nigeria,2008-03-01,4,0,0,3,1,8
Nigeria,2008-03-01,13,0,0,9,10,32
Nigeria,2008-03-01,-2,0,0,0,0,-2
Nigeria,2008-03-01,0,0,0,3,0,3
Nigeria,2008-03-01,9,0,0,-2,5,12
Nigeria,2008-03-01,14,0,0,-4,4,14
Nigeria,2008-03-01,2,0,0,6,0,8
Nigeria,2008-03-01,16,0,4,3,0,23
Nigeria,2008-03-01,7,0,0,9,3,19
Nigeria,2008-03-01,5,0,0,0,9,14
Nigeria,2008-03-01,2,0,0,0,0,2
Nigeria,2008-03-01,29,0,0,0,2,31
Nigeria,2008-03-01,1,0,-4,0,1,-2
Nigeria,2008-03-01,-1,0,0,3,0,2
Nigeria,2008-03-01,0,0,0,0,0,0
Nigeria,2008-03-01,2,0,0,3,0,5
Nigeria,2008-03-01,0,0,0,1,0,1
Nigeria,2008-03-01,0,0,0,0,0,0
Nigeria,2008-03-01,-1,0,0,12,1,12
Pakistan,2008-03-01,24,0,0,9,5,38
Pakistan,2008-03-01,29,0,-2,1,9,37
Pakistan,2008-03-01,59,0,0,44,4,107
Pakistan,2008-03-01,35,0,0,25,1,61
Pakistan,2008-03-01,25,0,0,15,0,40
Pakistan,2008-03-01,30,0,0,35,10,75
Pakistan,2008-03-01,70,2,-6,55,4,125
Pakistan,2008-03-01,21,0,0,13,5,39
Pakistan,2008-03-01,9,0,0,3,3,15
Pakistan,2008-03-01,65,0,-4,33,1,95
Pakistan,2008-03-01,82,0,-3,42,9,130
Pakistan,2008-03-01,11,0,-2,42,5,56
Pakistan,2008-03-01,26,0,1,11,4,42
Pakistan,2008-03-01,25,0,2,34,10,71
Pakistan,2008-03-01,14,0,1,3,3,21
Pakistan,2008-03-01,37,0,0,7,2,46
Pakistan,2008-03-01,41,0,-2,4,8,51
Pakistan,2008-03-01,32,0,0,54,2,88
Pakistan,2008-03-01,31,0,-2,5,19,53
Pakistan,2008-03-01,97,2,0,11,4,114
Pakistan,2008-03-01,77,0,0,1,6,84
Pakistan,2008-03-01,7,0,0,-6,2,3
Pakistan,2008-03-01,23,0,0,14,3,40
Pakistan,2008-03-01,18,0,1,24,5,48
Pakistan,2008-03-01,66,0,2,48,8,124
Pakistan,2008-03-01,59,0,0,13,1,73
Pakistan,2008-03-01,47,0,0,-9,8,46
Pakistan,2008-03-01,24,0,0,15,5,44
Pakistan,2008-03-01,104,0,0,4,11,119
Pakistan,2008-03-01,33,0,0,7,4,44
Pakistan,2008-03-01,36,0,0,37,7,80
Sierra Leone,2008-03-01,0,0,0,0,0,0
Sierra Leone,2008-03-01,-2,0,0,-4,0,-6
Sierra Leone,2008-03-01,2,0,0,0,0,2
Sierra Leone,2008-03-01,4,0,0,0,0,4
Sierra Leone,2008-03-01,0,0,0,3,0,3
Sierra Leone,2008-03-01,3,0,0,10,0,13
Sierra Leone,2008-03-01,0,0,0,3,0,3
Sierra Leone,2008-03-01,0,0,0,6,0,6
Sierra Leone,2008-03-01,-2,0,0,6,0,4
Sierra Leone,2008-03-01,-2,0,0,15,0,13
Sierra Leone,2008-03-01,3,0,1,0,4,8
Sierra Leone,2008-03-01,4,0,0,0,0,4
Sierra Leone,2008-03-01,0,0,0,3,2,5
Sierra Leone,2008-03-01,-1,0,0,0,0,-1
Sierra Leone,2008-03-01,4,0,0,0,0,4
Sierra Leone,2008-03-01,2,0,0,6,0,8
Sierra Leone,2008-03-01,3,0,0,6,0,9
Sierra Leone,2008-03-01,-2,0,0,9,0,7
Sierra Leone,2008-03-01,0,0,0,3,2,5
Sierra Leone,2008-03-01,1,0,0,0,0,1
Sierra Leone,2008-03-01,1,0,0,0,0,1
Sierra Leone,2008-03-01,0,0,0,0,2,2
Sierra Leone,2008-03-01,2,0,0,0,0,2
Somalia,2008-03-01,26,0,0,5,0,31
Somalia,2008-03-01,2,0,0,0,0,2
Somalia,2008-03-01,85,0,0,1,12,98
Somalia,2008-03-01,72,0,0,6,8,86
Somalia,2008-03-01,35,2,0,12,2,51
Somalia,2008-03-01,39,2,1,3,0,45
Somalia,2008-03-01,15,0,0,3,3,21
Somalia,2008-03-01,23,0,0,9,4,36
Somalia,2008-03-01,0,0,0,0,0,0
Somalia,2008-03-01,2,0,0,0,0,2
Somalia,2008-03-01,13,0,0,6,1,20
Somalia,2008-03-01,3,4,0,-2,1,6
Somalia,2008-03-01,13,0,0,0,0,13
Somalia,2008-03-01,16,0,1,6,0,23
Somalia,2008-03-01,7,0,0,0,2,9
Somalia,2008-03-01,6,0,0,-8,0,-2
Somalia,2008-03-01,13,0,0,-2,0,11
Somalia,2008-03-01,47,0,0,0,0,47
Somalia,2008-03-01,19,0,0,0,0,19
Somalia,2008-03-01,40,0,0,0,0,40
Somalia,2008-03-01,25,0,0,0,0,25
Somalia,2008-03-01,0,0,0,0,0,0
Somalia,2008-03-01,30,0,0,0,0,30
Somalia,2008-03-01,15,0,0,6,0,21
Somalia,2008-03-01,18,0,0,0,0,18
Somalia,2008-03-01,13,0,0,3,2,18
Somalia,2008-03-01,12,0,1,0,0,13
Somalia,2008-03-01,16,0,0,10,0,26
Somalia,2008-03-01,2,0,0,2,0,4
Somalia,2008-03-01,2,0,0,0,1,3
Somalia,2008-03-01,12,0,0,0,6,18
Syria,2008-03-01,-8,0,0,0,0,-8
Syria,2008-03-01,0,0,0,4,24,28
Syria,2008-03-01,18,0,0,3,13,34
Syria,2008-03-01,-3,0,0,9,7,13
Syria,2008-03-01,9,0,1,0,1,11
Syria,2008-03-01,70,0,2,12,1,85
Syria,2008-03-01,30,0,0,8,1,39
Syria,2008-03-01,10,0,0,3,6,19
Syria,2008-03-01,20,0,0,0,0,20
Syria,2008-03-01,7,0,0,6,1,14
Syria,2008-03-01,23,0,0,-17,0,6
Syria,2008-03-01,25,0,0,8,3,36
Syria,2008-03-01,5,0,0,3,0,8
Syria,2008-03-01,8,0,0,16,11,35
Syria,2008-03-01,23,0,0,0,14,37
Syria,2008-03-01,17,0,0,10,1,28
Syria,2008-03-01,0,0,0,0,0,0
Syria,2008-03-01,13,0,0,12,1,26
Syria,2008-03-01,12,0,0,3,1,16
Syria,2008-03-01,22,0,0,9,6,37
Syria,2008-03-01,27,0,0,6,16,49
Syria,2008-03-01,16,0,0,1,6,23
Syria,2008-03-01,1,0,0,9,1,11
Syria,2008-03-01,40,0,1,9,2,52
Syria,2008-03-01,42,2,0,3,1,48
Syria,2008-03-01,7,0,0,12,1,20
Syria,2008-03-01,34,2,0,0,0,36
Syria,2008-03-01,2,0,0,7,0,9
Syria,2008-03-01,-1,0,0,9,6,14
Syria,2008-03-01,14,0,0,0,2,16
Syria,2008-03-01,9,0,0,3,0,12
Yemen,2008-03-01,9,0,0,0,1,10
Yemen,2008-03-01,-2,0,0,2,0,0
Yemen,2008-03-01,6,4,0,0,1,11
Yemen,2008-03-01,8,2,0,0,2,12
Yemen,2008-03-01,16,0,0,12,2,30
Yemen,2008-03-01,3,0,0,0,4,7
Yemen,2008-03-01,5,0,0,3,0,8
Yemen,2008-03-01,0,0,0,0,0,0
Yemen,2008-03-01,2,0,0,0,0,2
Yemen,2008-03-01,6,0,0,0,0,6
Yemen,2008-03-01,-2,0,0,0,0,-2
Yemen,2008-03-01,1,0,0,-2,0,-1
Yemen,2008-03-01,0,0,0,9,0,9
Yemen,2008-03-01,5,0,3,48,0,56
Yemen,2008-03-01,0,0,0,0,0,0
Yemen,2008-03-01,9,0,0,6,0,15
Yemen,2008-03-01,10,0,1,0,0,11
Yemen,2008-03-01,19,0,0,0,6,25
Yemen,2008-03-01,4,0,0,0,5,9
Yemen,2008-03-01,18,0,1,6,3,28
Yemen,2008-03-01,22,0,0,0,0,22
Yemen,2008-03-01,25,0,1,9,0,35
Yemen,2008-03-01,42,0,0,18,4,64
Yemen,2008-03-01,17,0,0,0,0,17
Yemen,2008-03-01,25,0,0,0,1,26
Yemen,2008-03-01,58,0,0,3,2,63
Yemen,2008-03-01,34,0,0,3,4,41
Yemen,2008-03-01,4,0,1,3,5,13
Yemen,2008-03-01,6,0,2,9,0,17
Yemen,2008-03-01,7,0,0,0,6,13
Yemen,2008-03-01,1,0,0,0,0,1
Afghanistan,2006-01-01,2,0,-3,4,0,3
Afghanistan,2006-01-01,16,0,0,6,0,22
Afghanistan,2006-01-01,3,0,0,-6,8,5
Afghanistan,2006-01-01,31,0,0,11,0,42
Afghanistan,2006-01-01,21,0,0,1,2,24
Afghanistan,2006-01-01,17,0,0,0,2,19
Afghanistan,2006-01-01,49,0,0,6,4,59
Afghanistan,2006-01-01,13,0,0,9,5,27
Afghanistan,2006-01-01,41,0,-1,8,5,53
Afghanistan,2006-01-01,50,0,0,6,1,57
Afghanistan,2006-01-01,29,0,0,-2,3,30
Afghanistan,2006-01-01,24,0,0,33,1,58
Afghanistan,2006-01-01,32,0,0,19,2,53
Afghanistan,2006-01-01,68,0,0,1,0,69
Afghanistan,2006-01-01,48,0,1,3,27,79
Afghanistan,2006-01-01,64,0,0,3,18,85
Afghanistan,2006-01-01,21,0,0,10,1,32
Afghanistan,2006-01-01,38,0,1,0,5,44
Afghanistan,2006-01-01,53,0,0,7,3,63
Afghanistan,2006-01-01,23,0,0,7,3,33
Afghanistan,2006-01-01,18,0,0,14,0,32
Afghanistan,2006-01-01,16,0,0,-4,0,12
Afghanistan,2006-01-01,27,0,0,1,3,31
Afghanistan,2006-01-01,17,0,0,1,0,18
Afghanistan,2006-01-01,7,0,0,0,0,7
Afghanistan,2006-01-01,14,0,0,0,0,14
Afghanistan,2006-01-01,7,0,0,3,1,11
Afghanistan,2006-01-01,17,0,0,3,0,20
Afghanistan,2006-01-01,10,0,0,1,2,13
Afghanistan,2006-01-01,38,0,0,12,4,54
Afghanistan,2006-01-01,59,2,0,21,8,90
Albania,2006-01-01,9,0,0,6,0,15
Albania,2006-01-01,5,0,0,0,0,5
Albania,2006-01-01,0,0,0,3,0,3
Albania,2006-01-01,5,0,0,3,0,8
Albania,2006-01-01,1,0,0,0,0,1
Albania,2006-01-01,8,0,-1,0,0,7
Albania,2006-01-01,6,0,0,3,0,9
Albania,2006-01-01,1,0,0,0,0,1
Albania,2006-01-01,10,0,0,0,0,10
Albania,2006-01-01,2,0,-4,0,0,-2
Albania,2006-01-01,4,0,0,0,0,4
Albania,2006-01-01,0,0,0,0,0,0
Albania,2006-01-01,-1,0,0,0,0,-1
Albania,2006-01-01,4,0,-1,0,1,4
Albania,2006-01-01,-2,0,0,0,1,-1
Albania,2006-01-01,0,0,0,0,2,2
Albania,2006-01-01,-1,0,-1,9,0,7
Albania,2006-01-01,4,0,0,0,0,4
Albania,2006-01-01,0,0,0,0,0,0
Albania,2006-01-01,0,0,0,0,0,0
Albania,2006-01-01,31,0,-9,10,2,34
Albania,2006-01-01,19,0,0,1,0,20
Albania,2006-01-01,18,0,0,6,0,24
Albania,2006-01-01,2,0,0,3,1,6
Albania,2006-01-01,10,0,0,0,3,13
Albania,2006-01-01,2,0,0,8,1,11
Albania,2006-01-01,0,0,0,-2,0,-2
Albania,2006-01-01,0,0,0,0,0,0
Albania,2006-01-01,7,0,0,0,0,7
Albania,2006-01-01,6,0,0,0,0,6
Albania,2006-01-01,2,0,0,0,0,2
Algeria,2006-01-01,0,0,0,-2,0,-2
Algeria,2006-01-01,6,0,0,0,0,6
Algeria,2006-01-01,3,0,0,3,0,6
Algeria,2006-01-01,3,0,0,0,0,3
Algeria,2006-01-01,0,0,0,0,0,0
Algeria,2006-01-01,0,0,0,0,0,0
Algeria,2006-01-01,0,0,0,0,2,2
Algeria,2006-01-01,0,0,0,0,0,0
Algeria,2006-01-01,3,0,0,0,0,3
Algeria,2006-01-01,0,0,0,3,6,9
Algeria,2006-01-01,1,0,0,6,3,10
Algeria,2006-01-01,0,0,0,0,0,0
Algeria,2006-01-01,7,0,0,0,5,12
Algeria,2006-01-01,0,0,0,0,0,0
Algeria,2006-01-01,1,0,0,6,0,7
Algeria,2006-01-01,4,0,0,0,0,4
Algeria,2006-01-01,0,0,0,0,0,0
Algeria,2006-01-01,3,0,0,0,0,3
Algeria,2006-01-01,0,0,0,0,0,0
Algeria,2006-01-01,0,0,0,0,0,0
Algeria,2006-01-01,4,0,0,3,0,7
Algeria,2006-01-01,0,0,0,0,0,0
Algeria,2006-01-01,4,0,0,3,0,7
Algeria,2006-01-01,0,0,0,9,1,10
Algeria,2006-01-01,0,0,0,0,0,0
Algeria,2006-01-01,0,0,0,0,0,0
Algeria,2006-01-01,0,0,0,0,0,0
Algeria,2006-01-01,0,0,0,4,0,4
Algeria,2006-01-01,4,0,0,0,0,4
Bangladesh,2006-01-01,6,0,0,0,0,6
Bangladesh,2006-01-01,3,0,0,0,0,3
Bangladesh,2006-01-01,17,0,0,0,0,17
Bangladesh,2006-01-01,3,0,0,3,0,6
Bangladesh,2006-01-01,0,0,0,3,0,3
Bangladesh,2006-01-01,3,0,0,0,0,3
Bangladesh,2006-01-01,6,0,0,6,2,14
Bangladesh,2006-01-01,9,0,0,0,0,9
Bangladesh,2006-01-01,14,0,0,0,0,14
Bangladesh,2006-01-01,3,0,0,6,0,9
Bangladesh,2006-01-01,18,0,0,12,6,36
Bangladesh,2006-01-01,18,0,0,0,0,18
Bangladesh,2006-01-01,3,0,0,0,0,3
Bangladesh,2006-01-01,0,0,0,-2,0,-2
Bangladesh,2006-01-01,0,0,0,0,0,0
Bangladesh,2006-01-01,7,0,0,3,2,12
Bangladesh,2006-01-01,22,0,0,18,0,40
Bangladesh,2006-01-01,20,0,0,10,2,32
Bangladesh,2006-01-01,17,0,0,3,0,20
Bangladesh,2006-01-01,9,0,0,0,0,9
Bangladesh,2006-01-01,0,0,0,0,0,0
Bangladesh,2006-01-01,2,0,0,3,0,5
Bangladesh,2006-01-01,5,0,0,0,0,5
Cameroon,2006-01-01,2,0,0,0,0,2
Cameroon,2006-01-01,0,0,0,0,4,4
Cameroon,2006-01-01,0,0,0,0,0,0
Cameroon,2006-01-01,4,0,0,0,0,4
Cameroon,2006-01-01,0,0,0,0,0,0
Cameroon,2006-01-01,0,0,0,0,0,0
Cameroon,2006-01-01,0,0,0,0,0,0
Cameroon,2006-01-01,0,0,0,0,0,0
Cameroon,2006-01-01,0,0,0,0,0,0
Cameroon,2006-01-01,6,0,0,0,0,6
Cameroon,2006-01-01,3,0,0,0,0,3
Cameroon,2006-01-01,2,0,0,0,0,2
Cameroon,2006-01-01,0,0,0,0,0,0
Cameroon,2006-01-01,0,0,0,0,0,0
Cameroon,2006-01-01,0,0,0,0,0,0
Cameroon,2006-01-01,0,0,0,-2,0,-2
Cameroon,2006-01-01,0,0,0,-2,0,-2
Cameroon,2006-01-01,9,0,0,0,1,10
Cameroon,2006-01-01,0,0,0,0,0,0
Cameroon,2006-01-01,0,0,0,0,0,0
Cameroon,2006-01-01,4,0,0,0,0,4
China,2006-01-01,11,0,0,6,2,19
China,2006-01-01,14,0,0,9,0,23
China,2006-01-01,6,0,0,27,0,33
China,2006-01-01,2,0,0,45,0,47
China,2006-01-01,8,0,0,-1,3,10
China,2006-01-01,10,0,0,7,1,18
China,2006-01-01,3,0,0,-4,1,0
China,2006-01-01,5,0,-1,0,0,4
China,2006-01-01,28,0,2,7,2,39
China,2006-01-01,38,0,0,0,3,41
China,2006-01-01,19,0,0,4,0,23
China,2006-01-01,15,0,0,-2,3,16
China,2006-01-01,5,0,0,12,6,23
China,2006-01-01,3,0,0,0,0,3
China,2006-01-01,11,0,0,0,0,11
China,2006-01-01,15,0,0,6,1,22
China,2006-01-01,27,0,0,16,3,46
China,2006-01-01,12,0,0,12,1,25
China,2006-01-01,15,0,0,7,1,23
China,2006-01-01,22,0,0,0,0,22
China,2006-01-01,4,0,0,-2,2,4
China,2006-01-01,22,0,0,-4,1,19
China,2006-01-01,30,0,-2,9,1,38
China,2006-01-01,13,0,0,0,1,14
China,2006-01-01,28,0,-4,17,4,45
China,2006-01-01,15,0,1,11,1,28
China,2006-01-01,18,0,0,3,2,23
China,2006-01-01,12,0,0,9,4,25
China,2006-01-01,6,0,-2,1,5,10
China,2006-01-01,6,0,0,9,0,15
China,2006-01-01,13,0,0,9,0,22
Egypt,2006-01-01,0,0,0,15,0,15
Egypt,2006-01-01,15,0,0,0,0,15
Egypt,2006-01-01,6,0,1,9,8,24
Egypt,2006-01-01,47,0,2,14,8,71
Egypt,2006-01-01,16,0,0,10,2,28
Egypt,2006-01-01,21,0,0,3,2,26
Egypt,2006-01-01,19,0,0,17,0,36
Egypt,2006-01-01,3,0,0,0,0,3
Egypt,2006-01-01,26,0,0,4,1,31
Egypt,2006-01-01,18,0,0,21,0,39
Egypt,2006-01-01,9,0,0,0,0,9
Egypt,2006-01-01,5,0,0,9,0,14
Egypt,2006-01-01,7,0,0,4,0,11
Egypt,2006-01-01,14,0,0,-6,5,13
Egypt,2006-01-01,6,0,0,0,0,6
Egypt,2006-01-01,1,0,0,-2,1,0
Egypt,2006-01-01,7,0,0,6,0,13
Egypt,2006-01-01,10,0,0,3,5,18
Egypt,2006-01-01,41,0,0,-6,3,38
Egypt,2006-01-01,1,0,0,0,0,1
Egypt,2006-01-01,0,0,0,0,2,2
Egypt,2006-01-01,0,0,0,0,0,0
Egypt,2006-01-01,7,0,0,0,0,7
Egypt,2006-01-01,7,0,0,3,0,10
Egypt,2006-01-01,0,0,0,3,0,3
Egypt,2006-01-01,1,0,0,-2,0,-1
Egypt,2006-01-01,-3,0,0,0,0,-3
Egypt,2006-01-01,0,0,0,2,0,2
Egypt,2006-01-01,-1,0,0,6,0,5
Egypt,2006-01-01,12,0,0,12,2,26
Egypt,2006-01-01,14,0,0,63,0,77
Eritrea,2006-01-01,0,0,0,0,0,0
Eritrea,2006-01-01,81,0,0,0,0,81
Eritrea,2006-01-01,0,0,0,0,0,0
Eritrea,2006-01-01,84,0,0,0,0,84
Eritrea,2006-01-01,1,0,0,0,0,1
Eritrea,2006-01-01,0,0,0,3,0,3
Eritrea,2006-01-01,0,0,0,0,0,0
Eritrea,2006-01-01,22,0,0,9,0,31
Eritrea,2006-01-01,13,0,0,3,0,16
Eritrea,2006-01-01,10,0,0,0,0,10
Eritrea,2006-01-01,3,0,0,0,1,4
Eritrea,2006-01-01,5,0,0,0,0,5
Eritrea,2006-01-01,4,0,0,0,0,4
Eritrea,2006-01-01,0,0,0,0,0,0
Eritrea,2006-01-01,0,0,0,0,0,0
Eritrea,2006-01-01,0,0,0,0,0,0
Eritrea,2006-01-01,1,0,0,0,0,1
Eritrea,2006-01-01,9,0,0,0,0,9
Eritrea,2006-01-01,0,0,0,0,0,0
Eritrea,2006-01-01,0,0,0,0,0,0
Eritrea,2006-01-01,2,0,0,0,0,2
Eritrea,2006-01-01,-1,0,0,0,0,-1
Eritrea,2006-01-01,0,0,0,0,0,0
Eritrea,2006-01-01,0,0,0,0,0,0
Eritrea,2006-01-01,8,0,0,0,0,8
Georgia,2006-01-01,0,0,0,0,0,0
Georgia,2006-01-01,0,0,0,0,0,0
Georgia,2006-01-01,2,0,0,0,0,2
Georgia,2006-01-01,15,0,0,0,0,15
Georgia,2006-01-01,0,0,0,0,0,0
Georgia,2006-01-01,-2,0,0,0,0,-2
Georgia,2006-01-01,0,0,0,15,0,15
Georgia,2006-01-01,0,0,0,6,0,6
Georgia,2006-01-01,0,0,0,0,0,0
Georgia,2006-01-01,2,0,0,0,0,2
Georgia,2006-01-01,0,0,0,3,0,3
Georgia,2006-01-01,0,0,0,0,0,0
Georgia,2006-01-01,0,0,0,0,0,0
Georgia,2006-01-01,0,0,0,0,4,4
Georgia,2006-01-01,0,0,0,0,0,0
Georgia,2006-01-01,3,0,0,3,0,6
Georgia,2006-01-01,1,0,0,0,0,1
Georgia,2006-01-01,4,0,0,0,1,5
Georgia,2006-01-01,2,0,0,0,0,2
Georgia,2006-01-01,3,0,0,0,0,3
Georgia,2006-01-01,0,0,0,0,1,1
Georgia,2006-01-01,0,0,0,0,0,0
Georgia,2006-01-01,-2,0,0,9,0,7
Georgia,2006-01-01,2,0,0,0,0,2
India,2006-01-01,0,0,0,0,2,2
India,2006-01-01,0,0,0,3,1,4
India,2006-01-01,0,0,0,0,0,0
India,2006-01-01,2,0,0,0,0,2
India,2006-01-01,24,0,0,3,0,27
India,2006-01-01,4,0,0,6,0,10
India,2006-01-01,5,0,1,6,0,12
India,2006-01-01,6,0,0,2,0,8
India,2006-01-01,2,0,0,0,2,4
India,2006-01-01,8,0,0,0,1,9
India,2006-01-01,5,0,0,0,0,5
India,2006-01-01,10,0,-1,9,0,18
India,2006-01-01,7,0,1,0,4,12
India,2006-01-01,7,0,0,0,1,8
India,2006-01-01,2,0,0,3,0,5
India,2006-01-01,3,0,0,0,0,3
India,2006-01-01,5,0,0,0,0,5
India,2006-01-01,8,0,0,7,0,15
India,2006-01-01,2,0,0,12,0,14
India,2006-01-01,0,0,0,9,0,9
India,2006-01-01,7,0,0,0,1,8
India,2006-01-01,14,0,0,0,0,14
India,2006-01-01,4,0,0,0,0,4
India,2006-01-01,21,0,-2,0,2,21
India,2006-01-01,4,0,0,0,0,4
India,2006-01-01,4,0,0,0,0,4
India,2006-01-01,4,0,0,3,0,7
India,2006-01-01,1,0,0,3,0,4
India,2006-01-01,20,0,0,9,0,29
India,2006-01-01,5,2,1,3,0,11
Iran,2006-01-01,1,0,0,3,0,4
Iran,2006-01-01,8,0,0,25,1,34
Iran,2006-01-01,2,0,0,3,0,5
Iran,2006-01-01,6,0,0,7,0,13
Iran,2006-01-01,27,0,0,-2,6,31
Iran,2006-01-01,26,0,0,18,0,44
Iran,2006-01-01,16,0,0,9,1,26
Iran,2006-01-01,0,0,0,12,0,12
Iran,2006-01-01,15,0,0,16,1,32
Iran,2006-01-01,30,0,0,3,1,34
Iran,2006-01-01,12,0,1,3,0,16
Iran,2006-01-01,31,0,1,6,1,39
Iran,2006-01-01,45,0,0,7,6,58
Iran,2006-01-01,-4,0,0,6,0,2
Iran,2006-01-01,6,0,-2,6,0,10
Iran,2006-01-01,33,0,0,3,0,36
Iran,2006-01-01,28,0,0,0,2,30
Iran,2006-01-01,41,0,0,4,2,47
Iran,2006-01-01,23,0,0,23,2,48
Iran,2006-01-01,16,0,2,3,4,25
Iran,2006-01-01,1,0,0,1,0,2
Iran,2006-01-01,9,2,-1,0,0,10
Iran,2006-01-01,17,4,-1,30,26,76
Iran,2006-01-01,11,0,0,19,2,32
Iran,2006-01-01,25,0,0,6,2,33
Iran,2006-01-01,24,0,1,6,0,31
Iran,2006-01-01,12,0,0,15,0,27
Iran,2006-01-01,38,0,1,11,3,53
Iran,2006-01-01,10,0,0,-10,1,1
Iran,2006-01-01,13,0,0,9,2,24
Iran,2006-01-01,13,0,2,26,1,42
Iraq,2006-01-01,20,0,0,1,6,27
Iraq,2006-01-01,17,0,-4,-3,2,12
Iraq,2006-01-01,26,0,1,12,1,40
Iraq,2006-01-01,48,0,-1,6,3,56
Iraq,2006-01-01,27,0,0,10,6,43
Iraq,2006-01-01,21,4,1,-12,5,19
Iraq,2006-01-01,28,0,0,10,3,41
Iraq,2006-01-01,27,0,0,0,7,34
Iraq,2006-01-01,27,0,-8,39,8,66
Iraq,2006-01-01,29,0,5,20,3,57
Iraq,2006-01-01,29,2,-4,14,0,41
Iraq,2006-01-01,65,0,-2,42,7,112
Iraq,2006-01-01,16,0,0,20,4,40
Iraq,2006-01-01,39,4,-5,6,2,46
Iraq,2006-01-01,7,0,0,24,3,34
Iraq,2006-01-01,35,0,0,42,2,79
Iraq,2006-01-01,65,0,0,44,1,110
Iraq,2006-01-01,38,4,1,-5,4,42
Iraq,2006-01-01,76,4,-6,11,5,90
Iraq,2006-01-01,34,0,-4,7,12,49
Iraq,2006-01-01,25,0,0,6,0,31
Iraq,2006-01-01,45,0,-1,16,0,60
Iraq,2006-01-01,25,0,-1,5,9,38
Iraq,2006-01-01,10,0,-4,18,2,26
Iraq,2006-01-01,24,0,0,18,3,45
Iraq,2006-01-01,28,0,0,31,4,63
Iraq,2006-01-01,29,0,0,0,3,32
Iraq,2006-01-01,35,2,0,5,8,50
Iraq,2006-01-01,18,0,-2,0,11,27
Iraq,2006-01-01,22,0,1,27,5,55
Iraq,2006-01-01,35,0,0,11,5,51
Morocco,2006-01-01,3,0,0,-3,0,0
Morocco,2006-01-01,0,0,0,6,0,6
Morocco,2006-01-01,0,0,0,2,0,2
Morocco,2006-01-01,0,0,0,9,0,9
Morocco,2006-01-01,4,0,0,0,2,6
Morocco,2006-01-01,2,0,0,6,0,8
Morocco,2006-01-01,4,0,0,0,0,4
Morocco,2006-01-01,0,0,0,0,0,0
Morocco,2006-01-01,4,0,0,0,0,4
Morocco,2006-01-01,-3,0,0,0,0,-3
Morocco,2006-01-01,-3,0,0,9,0,6
Morocco,2006-01-01,1,0,0,6,0,7
Morocco,2006-01-01,3,0,0,21,0,24
Morocco,2006-01-01,3,0,1,39,3,46
Morocco,2006-01-01,0,0,0,12,2,14
Morocco,2006-01-01,-1,0,0,3,0,2
Morocco,2006-01-01,0,0,0,-2,0,-2
Morocco,2006-01-01,12,0,0,6,0,18
Morocco,2006-01-01,3,0,0,6,0,9
Morocco,2006-01-01,1,0,0,0,0,1
Morocco,2006-01-01,0,0,0,15,0,15
Morocco,2006-01-01,3,0,0,34,6,43
Morocco,2006-01-01,9,0,0,3,0,12
Morocco,2006-01-01,0,0,0,0,0,0
Morocco,2006-01-01,0,0,0,0,0,0
Morocco,2006-01-01,0,0,0,0,0,0
Morocco,2006-01-01,1,0,0,3,7,11
Nigeria,2006-01-01,0,0,0,0,0,0
Nigeria,2006-01-01,17,0,0,3,0,20
Nigeria,2006-01-01,8,0,0,6,1,15
Nigeria,2006-01-01,5,0,0,-4,1,2
Nigeria,2006-01-01,12,0,-2,-3,3,10
Nigeria,2006-01-01,1,0,0,0,0,1
Nigeria,2006-01-01,11,0,0,0,-2,9
Nigeria,2006-01-01,4,0,-2,8,0,10
Nigeria,2006-01-01,12,0,1,9,0,22
Nigeria,2006-01-01,9,0,0,-2,1,8
Nigeria,2006-01-01,5,0,2,-4,2,5
Nigeria,2006-01-01,3,0,0,3,0,6
Nigeria,2006-01-01,4,0,1,6,0,11
Nigeria,2006-01-01,3,0,0,3,1,7
Nigeria,2006-01-01,4,0,0,0,0,4
Nigeria,2006-01-01,12,0,0,-1,1,12
Nigeria,2006-01-01,12,0,0,2,1,15
Nigeria,2006-01-01,23,0,0,0,1,24
Nigeria,2006-01-01,17,0,0,7,4,28
Nigeria,2006-01-01,23,0,0,6,3,32
Nigeria,2006-01-01,1,0,0,7,0,8
Nigeria,2006-01-01,6,0,0,0,0,6
Nigeria,2006-01-01,6,0,0,7,1,14
Nigeria,2006-01-01,19,0,-10,0,0,9
Nigeria,2006-01-01,8,0,-2,-2,0,4
Nigeria,2006-01-01,4,0,0,3,0,7
Nigeria,2006-01-01,13,0,0,11,6,30
Nigeria,2006-01-01,-1,0,0,3,2,4
Nigeria,2006-01-01,2,0,0,-2,0,0
Nigeria,2006-01-01,14,0,0,1,0,15
Nigeria,2006-01-01,9,0,1,6,0,16
Pakistan,2006-01-01,3,0,0,6,0,9
Pakistan,2006-01-01,8,0,0,1,0,9
Pakistan,2006-01-01,5,0,0,9,0,14
Pakistan,2006-01-01,9,0,0,5,0,14
Pakistan,2006-01-01,5,0,0,3,0,8
Pakistan,2006-01-01,1,0,0,7,3,11
Pakistan,2006-01-01,1,0,0,0,0,1
Pakistan,2006-01-01,-1,0,0,-2,0,-3
Pakistan,2006-01-01,10,6,0,9,0,25
Pakistan,2006-01-01,6,0,-8,3,0,1
Pakistan,2006-01-01,5,0,-8,3,0,0
Pakistan,2006-01-01,9,0,0,0,0,9
Pakistan,2006-01-01,37,0,0,13,0,50
Pakistan,2006-01-01,44,0,0,0,7,51
Pakistan,2006-01-01,22,0,0,0,0,22
Pakistan,2006-01-01,23,0,0,3,2,28
Pakistan,2006-01-01,8,0,0,1,0,9
Pakistan,2006-01-01,12,0,0,-4,2,10
Pakistan,2006-01-01,26,0,1,6,2,35
Pakistan,2006-01-01,7,0,0,0,0,7
Pakistan,2006-01-01,9,0,0,9,3,21
Pakistan,2006-01-01,17,0,0,0,6,23
Pakistan,2006-01-01,11,2,0,9,5,27
Pakistan,2006-01-01,1,0,0,0,0,1
Pakistan,2006-01-01,30,0,0,3,9,42
Pakistan,2006-01-01,17,0,0,21,0,38
Pakistan,2006-01-01,7,0,0,0,0,7
Pakistan,2006-01-01,4,0,0,0,0,4
Pakistan,2006-01-01,18,0,0,9,0,27
Pakistan,2006-01-01,18,0,0,-4,5,19
Pakistan,2006-01-01,5,0,0,14,0,19
Sierra Leone,2006-01-01,3,0,0,0,0,3
Sierra Leone,2006-01-01,0,0,0,0,0,0
Sierra Leone,2006-01-01,2,0,0,0,0,2
Sierra Leone,2006-01-01,0,0,0,0,0,0
Sierra Leone,2006-01-01,0,0,0,0,0,0
Sierra Leone,2006-01-01,4,0,0,0,0,4
Sierra Leone,2006-01-01,0,0,0,3,0,3
Sierra Leone,2006-01-01,0,0,0,0,0,0
Sierra Leone,2006-01-01,4,0,0,0,0,4
Sierra Leone,2006-01-01,0,0,0,0,0,0
Sierra Leone,2006-01-01,0,0,0,0,0,0
Sierra Leone,2006-01-01,0,0,2,0,2,4
Sierra Leone,2006-01-01,0,0,0,-2,0,-2
Sierra Leone,2006-01-01,1,0,0,13,0,14
Sierra Leone,2006-01-01,0,0,0,3,0,3
Sierra Leone,2006-01-01,3,0,0,12,0,15
Sierra Leone,2006-01-01,0,0,0,0,0,0
Sierra Leone,2006-01-01,3,0,1,3,0,7
Sierra Leone,2006-01-01,0,0,0,0,0,0
Sierra Leone,2006-01-01,0,0,0,9,0,9
Sierra Leone,2006-01-01,4,0,0,3,0,7
Sierra Leone,2006-01-01,5,0,0,3,1,9
Sierra Leone,2006-01-01,2,0,0,0,0,2
Sierra Leone,2006-01-01,-2,0,0,0,0,-2
Sierra Leone,2006-01-01,3,0,0,0,0,3
Somalia,2006-01-01,38,0,0,0,0,38
Somalia,2006-01-01,3,0,0,0,0,3
Somalia,2006-01-01,27,0,0,0,0,27
Somalia,2006-01-01,2,0,0,0,1,3
Somalia,2006-01-01,0,0,0,0,0,0
Somalia,2006-01-01,5,0,0,27,0,32
Somalia,2006-01-01,0,0,0,0,0,0
Somalia,2006-01-01,-4,0,0,0,0,-4
Somalia,2006-01-01,1,0,0,0,3,4
Somalia,2006-01-01,2,0,0,-4,0,-2
Somalia,2006-01-01,0,0,0,0,0,0
Somalia,2006-01-01,2,2,0,0,0,4
Somalia,2006-01-01,0,0,0,0,0,0
Somalia,2006-01-01,0,0,0,3,0,3
Somalia,2006-01-01,0,2,0,3,0,5
Somalia,2006-01-01,7,0,0,6,0,13
Somalia,2006-01-01,0,0,0,5,0,5
Somalia,2006-01-01,3,2,0,0,0,5
Somalia,2006-01-01,9,0,0,0,1,10
Somalia,2006-01-01,4,0,0,0,0,4
Somalia,2006-01-01,0,0,0,3,0,3
Somalia,2006-01-01,17,0,0,-8,0,9
Somalia,2006-01-01,3,0,0,0,2,5
Somalia,2006-01-01,3,2,0,0,0,5
Somalia,2006-01-01,4,0,0,-2,0,2
Somalia,2006-01-01,0,0,0,-2,0,-2
Somalia,2006-01-01,0,0,0,0,0,0
Somalia,2006-01-01,6,0,0,3,0,9
Somalia,2006-01-01,1,0,0,-2,0,-1
Somalia,2006-01-01,4,0,0,3,0,7
Syria,2006-01-01,1,0,0,15,0,16
Syria,2006-01-01,10,0,-2,-2,0,6
Syria,2006-01-01,23,0,0,3,0,26
Syria,2006-01-01,6,0,1,0,0,7
Syria,2006-01-01,2,0,-4,9,0,7
Syria,2006-01-01,-4,0,0,3,0,-1
Syria,2006-01-01,8,0,0,3,0,11
Syria,2006-01-01,-1,0,0,0,0,-1
Syria,2006-01-01,17,0,0,0,0,17
Syria,2006-01-01,9,0,0,4,1,14
Syria,2006-01-01,25,0,0,6,0,31
Syria,2006-01-01,15,0,0,3,0,18
Syria,2006-01-01,3,0,0,1,4,8
Syria,2006-01-01,0,0,-6,1,4,-1
Syria,2006-01-01,1,0,0,0,0,1
Syria,2006-01-01,2,0,0,0,0,2
Syria,2006-01-01,8,0,0,1,0,9
Syria,2006-01-01,9,0,0,0,0,9
Syria,2006-01-01,0,0,0,1,1,2
Syria,2006-01-01,0,0,0,0,1,1
Syria,2006-01-01,2,0,0,0,0,2
Syria,2006-01-01,11,2,-4,3,-2,10
Syria,2006-01-01,4,0,0,0,0,4
Syria,2006-01-01,3,0,0,0,0,3
Syria,2006-01-01,0,0,0,0,1,1
Syria,2006-01-01,2,0,0,12,0,14
Syria,2006-01-01,2,0,5,17,0,24
Syria,2006-01-01,4,0,0,0,1,5
Syria,2006-01-01,6,0,0,0,0,6
Syria,2006-01-01,0,0,0,0,0,0
Yemen,2006-01-01,0,0,0,5,0,5
Yemen,2006-01-01,1,0,0,2,0,3
Yemen,2006-01-01,7,0,0,6,0,13
Yemen,2006-01-01,-1,0,0,0,0,-1
Yemen,2006-01-01,-5,0,0,0,0,-5
Yemen,2006-01-01,12,4,0,-2,0,14
Yemen,2006-01-01,0,0,0,0,0,0
Yemen,2006-01-01,0,0,0,0,0,0
Yemen,2006-01-01,0,0,0,0,3,3
Yemen,2006-01-01,1,0,0,12,0,13
Yemen,2006-01-01,7,0,0,0,1,8
Yemen,2006-01-01,3,0,0,9,0,12
Yemen,2006-01-01,1,0,0,0,0,1
Yemen,2006-01-01,6,0,0,0,0,6
Yemen,2006-01-01,0,0,0,0,0,0
Yemen,2006-01-01,-1,0,0,0,0,-1
Yemen,2006-01-01,0,0,0,0,0,0
Yemen,2006-01-01,6,0,0,-2,0,4
Yemen,2006-01-01,13,0,0,0,9,22
Yemen,2006-01-01,0,0,0,0,0,0
Yemen,2006-01-01,0,0,0,0,0,0
Yemen,2006-01-01,0,0,0,6,0,6
Yemen,2006-01-01,0,0,0,1,0,1
Yemen,2006-01-01,0,0,0,0,0,0
Yemen,2006-01-01,-1,0,0,0,0,-1
Yemen,2006-01-01,0,0,0,0,0,0
Yemen,2006-01-01,0,0,0,0,0,0
Yemen,2006-01-01,0,0,0,0,0,0
Yemen,2006-01-01,0,0,0,0,0,0
Afghanistan,2006-02-01,16,2,0,12,3,33
Afghanistan,2006-02-01,13,2,0,3,2,20
Afghanistan,2006-02-01,28,0,0,14,7,49
Afghanistan,2006-02-01,18,0,0,0,4,22
Afghanistan,2006-02-01,19,0,0,10,8,37
Afghanistan,2006-02-01,11,0,0,13,8,32
Afghanistan,2006-02-01,30,0,0,21,17,68
Afghanistan,2006-02-01,13,0,0,30,9,52
Afghanistan,2006-02-01,52,0,0,30,15,97
Afghanistan,2006-02-01,32,0,0,4,4,40
Afghanistan,2006-02-01,55,0,0,3,2,60
Afghanistan,2006-02-01,26,0,0,9,2,37
Afghanistan,2006-02-01,25,0,0,24,2,51
Afghanistan,2006-02-01,34,0,0,15,0,49
Afghanistan,2006-02-01,28,0,0,10,0,38
Afghanistan,2006-02-01,37,0,0,25,6,68
Afghanistan,2006-02-01,9,0,0,10,2,21
Afghanistan,2006-02-01,6,0,0,-3,4,7
Afghanistan,2006-02-01,20,0,0,15,1,36
Afghanistan,2006-02-01,11,0,0,-3,0,8
Afghanistan,2006-02-01,38,0,0,13,11,62
Afghanistan,2006-02-01,17,0,2,0,8,27
Afghanistan,2006-02-01,9,0,0,15,2,26
Afghanistan,2006-02-01,-1,0,0,13,0,12
Afghanistan,2006-02-01,18,0,0,1,2,21
Afghanistan,2006-02-01,5,0,0,-2,0,3
Afghanistan,2006-02-01,16,0,0,10,0,26
Afghanistan,2006-02-01,17,6,0,9,2,34
Albania,2006-02-01,2,0,0,0,0,2
Albania,2006-02-01,0,0,0,0,0,0
Albania,2006-02-01,9,0,0,3,3,15
Albania,2006-02-01,3,0,0,0,3,6
Albania,2006-02-01,8,0,2,0,0,10
Albania,2006-02-01,0,0,0,3,1,4
Albania,2006-02-01,1,0,-1,0,0,0
Albania,2006-02-01,0,0,-6,0,1,-5
Albania,2006-02-01,0,0,0,0,0,0
Albania,2006-02-01,4,0,0,0,1,5
Albania,2006-02-01,2,0,0,0,0,2
Albania,2006-02-01,0,0,0,0,0,0
Albania,2006-02-01,2,0,0,0,0,2
Albania,2006-02-01,2,0,0,0,0,2
Albania,2006-02-01,12,0,0,0,0,12
Albania,2006-02-01,19,0,0,-2,0,17
Albania,2006-02-01,2,0,0,0,3,5
Albania,2006-02-01,0,0,0,4,0,4
Albania,2006-02-01,2,0,0,0,0,2
Albania,2006-02-01,16,0,0,3,0,19
Albania,2006-02-01,3,0,0,6,0,9
Albania,2006-02-01,0,0,0,0,0,0
Albania,2006-02-01,2,4,0,7,0,13
Albania,2006-02-01,2,0,0,-2,0,0
Albania,2006-02-01,6,0,-1,0,0,5
Albania,2006-02-01,3,0,0,0,2,5
Albania,2006-02-01,17,0,0,3,0,20
Albania,2006-02-01,17,0,0,3,0,20
Algeria,2006-02-01,6,0,0,0,4,10
Algeria,2006-02-01,0,0,1,0,0,1
Algeria,2006-02-01,0,0,0,0,0,0
Algeria,2006-02-01,0,0,0,0,0,0
Algeria,2006-02-01,1,0,0,0,2,3
Algeria,2006-02-01,-3,0,0,0,0,-3
Algeria,2006-02-01,1,0,0,0,0,1
Algeria,2006-02-01,3,0,0,0,2,5
Algeria,2006-02-01,0,0,0,6,0,6
Algeria,2006-02-01,-11,0,0,0,0,-11
Algeria,2006-02-01,2,0,0,0,0,2
Algeria,2006-02-01,7,0,0,-2,1,6
Algeria,2006-02-01,7,0,0,3,0,10
Algeria,2006-02-01,0,0,1,0,0,1
Algeria,2006-02-01,1,0,0,3,1,5
Algeria,2006-02-01,0,0,0,0,0,0
Algeria,2006-02-01,1,0,0,-1,1,1
Algeria,2006-02-01,6,0,0,3,0,9
Algeria,2006-02-01,0,0,0,0,0,0
Algeria,2006-02-01,1,0,-1,0,0,0
Algeria,2006-02-01,9,0,0,12,0,21
Algeria,2006-02-01,0,0,0,0,0,0
Algeria,2006-02-01,1,0,0,0,0,1
Algeria,2006-02-01,40,0,0,3,0,43
Bangladesh,2006-02-01,7,0,0,3,0,10
Bangladesh,2006-02-01,0,0,0,9,2,11
Bangladesh,2006-02-01,0,0,0,0,1,1
Bangladesh,2006-02-01,0,0,0,0,1,1
Bangladesh,2006-02-01,0,0,0,0,0,0
Bangladesh,2006-02-01,6,0,0,3,2,11
Bangladesh,2006-02-01,3,0,1,0,0,4
Bangladesh,2006-02-01,0,0,0,0,0,0
Bangladesh,2006-02-01,12,0,0,6,0,18
Bangladesh,2006-02-01,0,0,0,0,2,2
Bangladesh,2006-02-01,0,0,0,0,1,1
Bangladesh,2006-02-01,0,0,0,0,3,3
Bangladesh,2006-02-01,-1,0,0,6,0,5
Bangladesh,2006-02-01,6,0,0,0,1,7
Bangladesh,2006-02-01,2,0,0,6,0,8
Bangladesh,2006-02-01,0,0,0,0,1,1
Bangladesh,2006-02-01,4,0,0,6,0,10
Bangladesh,2006-02-01,0,0,0,0,0,0
Bangladesh,2006-02-01,13,2,0,3,1,19
Bangladesh,2006-02-01,0,0,0,9,4,13
Bangladesh,2006-02-01,6,0,0,1,0,7
Bangladesh,2006-02-01,2,0,0,0,0,2
Bangladesh,2006-02-01,0,0,0,15,0,15
Bangladesh,2006-02-01,9,0,0,0,0,9
Bangladesh,2006-02-01,0,0,0,-2,0,-2
Bangladesh,2006-02-01,2,0,0,3,0,5
Cameroon,2006-02-01,2,0,0,0,0,2
Cameroon,2006-02-01,0,0,0,-4,1,-3
Cameroon,2006-02-01,10,0,0,0,1,11
Cameroon,2006-02-01,0,0,0,0,0,0
Cameroon,2006-02-01,3,0,0,3,0,6
Cameroon,2006-02-01,2,0,0,-1,0,1
Cameroon,2006-02-01,0,0,0,0,0,0
Cameroon,2006-02-01,0,0,0,0,0,0
Cameroon,2006-02-01,0,0,0,0,0,0
Cameroon,2006-02-01,7,2,0,0,0,9
Cameroon,2006-02-01,2,0,0,9,0,11
Cameroon,2006-02-01,0,2,0,0,0,2
Cameroon,2006-02-01,5,0,0,2,0,7
Cameroon,2006-02-01,0,0,0,0,0,0
Cameroon,2006-02-01,0,0,0,0,0,0
Cameroon,2006-02-01,0,0,0,0,0,0
Cameroon,2006-02-01,0,0,0,0,1,1
Cameroon,2006-02-01,0,0,0,0,0,0
Cameroon,2006-02-01,0,0,0,0,0,0
Cameroon,2006-02-01,0,0,0,0,0,0
Cameroon,2006-02-01,0,0,0,0,0,0
Cameroon,2006-02-01,3,0,0,0,0,3
Cameroon,2006-02-01,0,0,0,0,0,0
Cameroon,2006-02-01,2,0,0,0,0,2
Cameroon,2006-02-01,0,0,0,0,0,0
China,2006-02-01,-10,0,0,3,0,-7
China,2006-02-01,11,0,0,11,3,25
China,2006-02-01,13,0,0,-3,0,10
China,2006-02-01,3,0,0,3,3,9
China,2006-02-01,5,0,0,3,0,8
China,2006-02-01,30,0,0,4,2,36
China,2006-02-01,49,0,0,4,2,55
China,2006-02-01,15,0,0,36,0,51
China,2006-02-01,1,0,1,22,0,24
China,2006-02-01,21,0,0,6,6,33
China,2006-02-01,15,0,0,4,0,19
China,2006-02-01,5,2,0,18,1,26
China,2006-02-01,20,8,0,18,5,51
China,2006-02-01,19,0,0,11,6,36
China,2006-02-01,58,0,1,15,6,80
China,2006-02-01,49,0,-1,19,4,71
China,2006-02-01,25,0,1,22,0,48
China,2006-02-01,20,0,0,5,0,25
China,2006-02-01,28,2,0,-1,0,29
China,2006-02-01,18,0,0,16,0,34
China,2006-02-01,30,0,-1,11,13,53
China,2006-02-01,26,0,-2,14,4,42
China,2006-02-01,19,0,0,4,4,27
China,2006-02-01,24,0,1,9,3,37
China,2006-02-01,8,0,1,3,1,13
China,2006-02-01,7,0,-1,0,2,8
China,2006-02-01,18,0,0,33,1,52
China,2006-02-01,24,0,0,18,3,45
Egypt,2006-02-01,10,0,0,9,0,19
Egypt,2006-02-01,2,0,0,9,0,11
Egypt,2006-02-01,14,0,0,9,3,26
Egypt,2006-02-01,1,0,0,6,0,7
Egypt,2006-02-01,2,0,-2,0,0,0
Egypt,2006-02-01,6,0,0,0,2,8
Egypt,2006-02-01,-2,2,0,18,6,24
Egypt,2006-02-01,0,0,0,0,2,2
Egypt,2006-02-01,30,0,0,35,3,68
Egypt,2006-02-01,23,0,0,61,14,98
Egypt,2006-02-01,30,0,0,51,4,85
Egypt,2006-02-01,-1,0,0,0,2,1
Egypt,2006-02-01,9,0,0,0,0,9
Egypt,2006-02-01,10,0,0,0,0,10
Egypt,2006-02-01,2,0,0,0,0,2
Egypt,2006-02-01,1,0,0,3,2,6
Egypt,2006-02-01,1,0,0,0,0,1
Egypt,2006-02-01,0,0,0,3,0,3
Egypt,2006-02-01,5,0,-6,0,1,0
Egypt,2006-02-01,6,0,0,0,0,6
Egypt,2006-02-01,3,0,0,0,0,3
Egypt,2006-02-01,15,0,0,0,0,15
Egypt,2006-02-01,2,0,0,0,0,2
Egypt,2006-02-01,1,0,0,7,0,8
Egypt,2006-02-01,0,0,0,0,0,0
Egypt,2006-02-01,0,0,0,1,0,1
Egypt,2006-02-01,-1,0,0,3,0,2
Egypt,2006-02-01,9,0,0,0,0,9
Eritrea,2006-02-01,0,0,0,0,0,0
Eritrea,2006-02-01,7,0,0,0,0,7
Eritrea,2006-02-01,0,0,0,0,0,0
Eritrea,2006-02-01,0,0,0,0,0,0
Eritrea,2006-02-01,10,0,0,3,0,13
Eritrea,2006-02-01,6,0,0,0,0,6
Eritrea,2006-02-01,0,0,0,0,0,0
Eritrea,2006-02-01,-1,0,0,0,0,-1
Eritrea,2006-02-01,0,0,0,0,0,0
Eritrea,2006-02-01,0,0,0,0,4,4
Eritrea,2006-02-01,0,0,0,0,0,0
Eritrea,2006-02-01,0,0,0,3,0,3
Eritrea,2006-02-01,0,0,0,0,0,0
Eritrea,2006-02-01,3,0,0,0,0,3
Eritrea,2006-02-01,75,0,0,0,0,75
Eritrea,2006-02-01,63,0,0,0,0,63
Eritrea,2006-02-01,66,0,0,0,0,66
Eritrea,2006-02-01,3,0,0,0,0,3
Eritrea,2006-02-01,5,0,0,0,0,5
Eritrea,2006-02-01,2,0,0,0,0,2
Eritrea,2006-02-01,-2,0,0,0,0,-2
Eritrea,2006-02-01,0,0,0,0,0,0
Eritrea,2006-02-01,0,0,0,0,0,0
Georgia,2006-02-01,4,0,1,0,0,5
Georgia,2006-02-01,0,0,0,-2,0,-2
Georgia,2006-02-01,-8,0,0,0,0,-8
Georgia,2006-02-01,10,0,0,6,0,16
Georgia,2006-02-01,0,0,0,3,0,3
Georgia,2006-02-01,0,0,0,0,0,0
Georgia,2006-02-01,0,0,0,0,0,0
Georgia,2006-02-01,0,0,0,0,0,0
Georgia,2006-02-01,-3,0,0,3,0,0
Georgia,2006-02-01,1,0,0,0,2,3
Georgia,2006-02-01,0,0,0,3,2,5
Georgia,2006-02-01,3,0,0,0,1,4
Georgia,2006-02-01,2,0,0,0,0,2
Georgia,2006-02-01,1,0,0,0,0,1
Georgia,2006-02-01,3,0,0,0,0,3
Georgia,2006-02-01,0,0,0,0,0,0
Georgia,2006-02-01,3,0,0,6,0,9
Georgia,2006-02-01,0,0,0,0,0,0
Georgia,2006-02-01,0,0,0,0,0,0
Georgia,2006-02-01,1,0,0,0,0,1
Georgia,2006-02-01,0,0,0,0,0,0
Georgia,2006-02-01,0,0,0,3,0,3
Georgia,2006-02-01,4,0,1,0,0,5
Georgia,2006-02-01,1,0,1,0,0,2
India,2006-02-01,5,0,0,0,0,5
India,2006-02-01,0,2,0,0,0,2
India,2006-02-01,1,0,0,0,0,1
India,2006-02-01,3,0,0,0,0,3
India,2006-02-01,5,0,0,2,1,8
India,2006-02-01,-1,0,0,3,0,2
India,2006-02-01,7,0,0,6,4,17
India,2006-02-01,-1,0,0,0,0,-1
India,2006-02-01,0,0,0,0,0,0
India,2006-02-01,0,0,1,0,2,3
India,2006-02-01,8,0,0,0,0,8
India,2006-02-01,1,0,0,0,0,1
India,2006-02-01,3,0,0,6,1,10
India,2006-02-01,7,0,0,0,2,9
India,2006-02-01,-1,0,0,3,1,3
India,2006-02-01,0,0,0,0,0,0
India,2006-02-01,2,0,0,6,0,8
India,2006-02-01,6,0,0,0,0,6
India,2006-02-01,16,0,0,6,0,22
India,2006-02-01,-1,0,0,0,0,-1
India,2006-02-01,4,6,0,0,3,13
India,2006-02-01,1,0,0,0,0,1
India,2006-02-01,0,0,0,0,0,0
India,2006-02-01,1,0,0,3,0,4
India,2006-02-01,0,0,0,0,0,0
India,2006-02-01,1,0,0,-1,2,2
India,2006-02-01,15,0,0,6,0,21
Iran,2006-02-01,34,0,1,7,0,42
Iran,2006-02-01,14,0,2,4,2,22
Iran,2006-02-01,16,0,0,1,3,20
Iran,2006-02-01,28,0,0,3,5,36
Iran,2006-02-01,18,0,2,1,12,33
Iran,2006-02-01,47,0,3,5,7,62
Iran,2006-02-01,32,0,0,10,9,51
Iran,2006-02-01,14,0,-4,12,0,22
Iran,2006-02-01,26,0,0,12,9,47
Iran,2006-02-01,10,0,2,21,6,39
Iran,2006-02-01,6,0,0,-4,0,2
Iran,2006-02-01,29,0,1,3,3,36
Iran,2006-02-01,21,0,0,2,1,24
Iran,2006-02-01,38,0,3,10,3,54
Iran,2006-02-01,19,2,2,21,3,47
Iran,2006-02-01,33,0,0,4,0,37
Iran,2006-02-01,-2,4,1,0,1,4
Iran,2006-02-01,8,0,0,0,10,18
Iran,2006-02-01,5,0,3,0,3,11
Iran,2006-02-01,23,6,0,9,3,41
Iran,2006-02-01,28,0,0,7,1,36
Iran,2006-02-01,22,0,0,7,3,32
Iran,2006-02-01,36,0,1,3,3,43
Iran,2006-02-01,-7,0,0,1,0,-6
Iran,2006-02-01,6,0,1,0,2,9
Iran,2006-02-01,16,0,1,1,2,20
Iran,2006-02-01,10,0,2,3,3,18
Iran,2006-02-01,23,0,0,2,2,27
Iraq,2006-02-01,55,0,1,49,14,119
Iraq,2006-02-01,33,2,1,3,4,43
Iraq,2006-02-01,50,0,1,10,0,61
Iraq,2006-02-01,43,0,0,7,6,56
Iraq,2006-02-01,30,0,0,3,2,35
Iraq,2006-02-01,28,8,0,19,3,58
Iraq,2006-02-01,63,2,1,22,3,91
Iraq,2006-02-01,36,0,0,34,3,73
Iraq,2006-02-01,45,0,-2,11,4,58
Iraq,2006-02-01,14,0,2,9,2,27
Iraq,2006-02-01,81,0,1,23,0,105
Iraq,2006-02-01,37,0,0,0,22,59
Iraq,2006-02-01,46,2,0,19,4,71
Iraq,2006-02-01,37,0,0,46,3,86
Iraq,2006-02-01,34,0,-1,88,7,128
Iraq,2006-02-01,54,0,0,33,5,92
Iraq,2006-02-01,59,0,0,23,4,86
Iraq,2006-02-01,9,0,0,9,0,18
Iraq,2006-02-01,17,0,0,7,4,28
Iraq,2006-02-01,20,4,1,29,2,56
Iraq,2006-02-01,21,0,0,34,17,72
Iraq,2006-02-01,29,0,0,6,9,44
Iraq,2006-02-01,46,0,0,14,2,62
Iraq,2006-02-01,75,0,0,21,21,117
Iraq,2006-02-01,43,0,0,9,9,61
Iraq,2006-02-01,35,0,1,1,6,43
Iraq,2006-02-01,59,0,0,28,6,93
Iraq,2006-02-01,123,0,1,53,6,183
Morocco,2006-02-01,0,0,0,0,0,0
Morocco,2006-02-01,2,0,1,18,0,21
Morocco,2006-02-01,0,0,0,3,0,3
Morocco,2006-02-01,1,0,0,9,0,10
Morocco,2006-02-01,0,0,0,0,0,0
Morocco,2006-02-01,2,0,0,12,0,14
Morocco,2006-02-01,3,0,0,17,0,20
Morocco,2006-02-01,0,0,0,0,0,0
Morocco,2006-02-01,0,0,0,0,0,0
Morocco,2006-02-01,-6,0,0,0,0,-6
Morocco,2006-02-01,6,0,0,-10,0,-4
Morocco,2006-02-01,4,0,0,6,0,10
Morocco,2006-02-01,1,0,0,0,0,1
Morocco,2006-02-01,1,0,0,0,0,1
Morocco,2006-02-01,-5,0,-1,0,0,-6
Morocco,2006-02-01,-1,0,0,3,0,2
Morocco,2006-02-01,0,0,0,0,0,0
Morocco,2006-02-01,0,2,0,0,0,2
Morocco,2006-02-01,2,0,0,0,0,2
Morocco,2006-02-01,-2,0,0,0,4,2
Morocco,2006-02-01,2,0,0,0,0,2
Morocco,2006-02-01,3,0,0,0,0,3
Morocco,2006-02-01,3,0,0,2,0,5
Morocco,2006-02-01,0,0,0,0,0,0
Morocco,2006-02-01,-1,0,0,0,0,-1
Morocco,2006-02-01,2,0,0,0,0,2
Nigeria,2006-02-01,10,0,0,-2,0,8
Nigeria,2006-02-01,10,0,1,4,2,17
Nigeria,2006-02-01,26,0,1,3,0,30
Nigeria,2006-02-01,0,0,0,-1,0,-1
Nigeria,2006-02-01,5,0,0,2,0,7
Nigeria,2006-02-01,19,0,0,3,3,25
Nigeria,2006-02-01,19,0,0,6,7,32
Nigeria,2006-02-01,15,0,1,3,5,24
Nigeria,2006-02-01,3,0,0,0,0,3
Nigeria,2006-02-01,24,0,2,2,0,28
Nigeria,2006-02-01,-1,0,0,0,2,1
Nigeria,2006-02-01,11,0,0,3,0,14
Nigeria,2006-02-01,16,0,-2,0,0,14
Nigeria,2006-02-01,1,4,0,7,0,12
Nigeria,2006-02-01,4,0,1,10,3,18
Nigeria,2006-02-01,13,0,0,0,0,13
Nigeria,2006-02-01,25,0,0,0,0,25
Nigeria,2006-02-01,4,0,0,0,0,4
Nigeria,2006-02-01,6,0,-2,0,0,4
Nigeria,2006-02-01,22,0,2,9,9,42
Nigeria,2006-02-01,3,0,-3,6,0,6
Nigeria,2006-02-01,2,0,1,6,2,11
Nigeria,2006-02-01,1,0,0,16,0,17
Nigeria,2006-02-01,16,0,0,6,7,29
Nigeria,2006-02-01,2,0,0,-2,0,0
Nigeria,2006-02-01,1,0,0,0,0,1
Nigeria,2006-02-01,22,0,0,1,3,26
Nigeria,2006-02-01,16,0,0,0,2,18
Pakistan,2006-02-01,8,0,0,3,1,12
Pakistan,2006-02-01,9,0,0,9,5,23
Pakistan,2006-02-01,6,0,0,18,2,26
Pakistan,2006-02-01,19,0,0,0,2,21
Pakistan,2006-02-01,3,4,0,-8,7,6
Pakistan,2006-02-01,8,0,0,9,7,24
Pakistan,2006-02-01,6,0,0,12,6,24
Pakistan,2006-02-01,30,0,0,27,8,65
Pakistan,2006-02-01,29,0,0,15,4,48
Pakistan,2006-02-01,9,0,0,3,0,12
Pakistan,2006-02-01,17,0,0,0,0,17
Pakistan,2006-02-01,0,0,0,-1,0,-1
Pakistan,2006-02-01,35,0,0,0,11,46
Pakistan,2006-02-01,9,0,0,10,3,22
Pakistan,2006-02-01,28,0,0,34,1,63
Pakistan,2006-02-01,20,0,0,25,5,50
Pakistan,2006-02-01,27,0,0,-1,1,27
Pakistan,2006-02-01,0,0,0,0,0,0
Pakistan,2006-02-01,25,0,0,0,3,28
Pakistan,2006-02-01,34,0,0,3,5,42
Pakistan,2006-02-01,9,0,0,9,2,20
Pakistan,2006-02-01,24,0,0,3,0,27
Pakistan,2006-02-01,2,0,0,0,0,2
Pakistan,2006-02-01,3,0,0,21,1,25
Pakistan,2006-02-01,1,0,0,1,2,4
Pakistan,2006-02-01,11,0,-1,7,0,17
Pakistan,2006-02-01,10,0,0,27,2,39
Pakistan,2006-02-01,14,0,0,0,0,14
Sierra Leone,2006-02-01,5,0,-6,3,0,2
Sierra Leone,2006-02-01,9,0,0,0,0,9
Sierra Leone,2006-02-01,0,0,0,0,0,0
Sierra Leone,2006-02-01,9,0,0,18,1,28
Sierra Leone,2006-02-01,0,0,0,0,0,0
Sierra Leone,2006-02-01,5,0,0,3,1,9
Sierra Leone,2006-02-01,10,0,0,6,0,16
Sierra Leone,2006-02-01,0,0,0,0,0,0
Sierra Leone,2006-02-01,0,0,0,1,0,1
Sierra Leone,2006-02-01,6,0,0,0,0,6
Sierra Leone,2006-02-01,0,0,0,0,0,0
Sierra Leone,2006-02-01,0,0,0,0,0,0
Sierra Leone,2006-02-01,0,0,0,0,0,0
Sierra Leone,2006-02-01,1,0,0,0,0,1
Sierra Leone,2006-02-01,0,0,0,0,0,0
Sierra Leone,2006-02-01,5,0,0,0,0,5
Sierra Leone,2006-02-01,2,0,0,0,0,2
Sierra Leone,2006-02-01,0,0,0,0,0,0
Somalia,2006-02-01,0,0,0,3,0,3
Somalia,2006-02-01,0,0,0,-1,0,-1
Somalia,2006-02-01,5,0,0,15,3,23
Somalia,2006-02-01,0,0,0,0,0,0
Somalia,2006-02-01,0,0,0,0,0,0
Somalia,2006-02-01,27,0,0,6,12,45
Somalia,2006-02-01,6,0,0,0,1,7
Somalia,2006-02-01,2,0,0,3,0,5
Somalia,2006-02-01,2,0,0,0,0,2
Somalia,2006-02-01,6,0,0,0,0,6
Somalia,2006-02-01,0,0,0,6,0,6
Somalia,2006-02-01,3,0,0,3,1,7
Somalia,2006-02-01,3,0,0,0,2,5
Somalia,2006-02-01,9,0,0,6,0,15
Somalia,2006-02-01,9,0,0,6,0,15
Somalia,2006-02-01,3,2,0,0,0,5
Somalia,2006-02-01,0,0,0,3,0,3
Somalia,2006-02-01,27,0,0,0,2,29
Somalia,2006-02-01,27,0,0,6,3,36
Somalia,2006-02-01,24,0,0,6,0,30
Somalia,2006-02-01,2,0,0,0,0,2
Somalia,2006-02-01,7,0,0,0,0,7
Somalia,2006-02-01,2,4,0,0,0,6
Somalia,2006-02-01,1,0,1,15,0,17
Somalia,2006-02-01,3,0,0,6,0,9
Somalia,2006-02-01,3,0,0,0,1,4
Somalia,2006-02-01,4,0,0,0,0,4
Somalia,2006-02-01,3,0,-2,0,0,1
Syria,2006-02-01,1,0,0,3,0,4
Syria,2006-02-01,16,0,0,0,7,23
Syria,2006-02-01,7,0,0,0,3,10
Syria,2006-02-01,1,0,0,0,4,5
Syria,2006-02-01,22,0,-4,9,5,32
Syria,2006-02-01,14,0,0,30,13,57
Syria,2006-02-01,6,0,0,-2,6,10
Syria,2006-02-01,3,0,0,0,0,3
Syria,2006-02-01,4,0,0,0,10,14
Syria,2006-02-01,1,0,0,9,0,10
Syria,2006-02-01,-1,0,0,17,3,19
Syria,2006-02-01,5,0,-2,4,0,7
Syria,2006-02-01,8,0,0,1,5,14
Syria,2006-02-01,23,0,-4,6,2,27
Syria,2006-02-01,3,0,-4,15,3,17
Syria,2006-02-01,2,0,-3,33,1,33
Syria,2006-02-01,1,0,0,21,1,23
Syria,2006-02-01,13,0,0,0,2,15
Syria,2006-02-01,9,0,0,2,2,13
Syria,2006-02-01,8,0,-2,6,0,12
Syria,2006-02-01,4,0,0,0,0,4
Syria,2006-02-01,-10,0,0,0,0,-10
Syria,2006-02-01,5,0,-6,3,0,2
Syria,2006-02-01,3,0,0,3,2,8
Syria,2006-02-01,0,0,0,0,0,0
Syria,2006-02-01,0,0,0,4,0,4
Syria,2006-02-01,3,0,0,0,0,3
Syria,2006-02-01,7,0,0,-2,5,10
Yemen,2006-02-01,-1,0,0,0,0,-1
Yemen,2006-02-01,0,0,0,0,0,0
Yemen,2006-02-01,-1,0,0,9,0,8
Yemen,2006-02-01,0,0,0,0,0,0
Yemen,2006-02-01,-2,0,0,0,0,-2
Yemen,2006-02-01,10,0,0,10,0,20
Yemen,2006-02-01,12,0,0,0,4,16
Yemen,2006-02-01,2,0,0,6,1,9
Yemen,2006-02-01,7,0,0,10,0,17
Yemen,2006-02-01,2,0,0,1,0,3
Yemen,2006-02-01,1,0,0,3,0,4
Yemen,2006-02-01,5,0,0,9,0,14
Yemen,2006-02-01,11,0,0,6,0,17
Yemen,2006-02-01,7,0,0,12,2,21
Yemen,2006-02-01,9,0,0,21,2,32
Yemen,2006-02-01,0,0,0,3,0,3
Yemen,2006-02-01,3,0,0,12,0,15
Yemen,2006-02-01,9,0,0,0,0,9
Yemen,2006-02-01,5,0,0,0,0,5
Yemen,2006-02-01,0,0,0,3,8,11
Yemen,2006-02-01,1,0,0,3,0,4
Yemen,2006-02-01,0,0,0,0,0,0
Yemen,2006-02-01,6,0,0,6,0,12
Yemen,2006-02-01,0,0,0,0,0,0
Yemen,2006-02-01,5,0,0,12,0,17
Yemen,2006-02-01,6,0,0,3,0,9
Afghanistan,2005-01-01,5,0,0,3,1,9
Afghanistan,2005-01-01,43,2,0,-4,0,41
Afghanistan,2005-01-01,47,0,0,3,0,50
Afghanistan,2005-01-01,33,0,0,3,4,40
Afghanistan,2005-01-01,38,0,-2,3,0,39
Afghanistan,2005-01-01,17,0,0,10,0,27
Afghanistan,2005-01-01,8,0,0,0,0,8
Afghanistan,2005-01-01,12,0,0,6,0,18
Afghanistan,2005-01-01,9,0,0,0,0,9
Afghanistan,2005-01-01,12,0,0,21,2,35
Afghanistan,2005-01-01,5,0,0,10,1,16
Afghanistan,2005-01-01,13,0,0,10,1,24
Afghanistan,2005-01-01,15,0,0,18,3,36
Afghanistan,2005-01-01,7,0,0,12,0,19
Afghanistan,2005-01-01,8,0,0,9,8,25
Afghanistan,2005-01-01,33,0,0,12,1,46
Afghanistan,2005-01-01,9,0,0,22,0,31
Afghanistan,2005-01-01,19,0,0,9,0,28
Afghanistan,2005-01-01,16,0,0,6,2,24
Afghanistan,2005-01-01,13,0,0,0,3,16
Afghanistan,2005-01-01,6,0,0,3,0,9
Afghanistan,2005-01-01,0,0,0,4,0,4
Afghanistan,2005-01-01,18,0,0,9,6,33
Afghanistan,2005-01-01,7,0,0,9,1,17
Afghanistan,2005-01-01,1,8,0,30,0,39
Afghanistan,2005-01-01,14,0,0,7,2,23
Afghanistan,2005-01-01,14,0,1,6,0,21
Afghanistan,2005-01-01,16,0,0,9,4,29
Afghanistan,2005-01-01,6,0,0,9,2,17
Afghanistan,2005-01-01,14,0,0,0,0,14
Afghanistan,2005-01-01,14,2,0,18,1,35
Afghanistan,2005-02-01,6,2,0,-6,2,4
Afghanistan,2005-02-01,9,0,0,24,3,36
Afghanistan,2005-02-01,10,0,0,3,2,15
Afghanistan,2005-02-01,17,0,0,18,2,37
Afghanistan,2005-02-01,12,4,-2,5,9,28
Afghanistan,2005-02-01,3,0,0,0,0,3
Afghanistan,2005-02-01,25,2,2,1,4,34
Afghanistan,2005-02-01,8,0,-4,12,2,18
Afghanistan,2005-02-01,13,0,0,27,0,40
Afghanistan,2005-02-01,12,0,0,1,3,16
Afghanistan,2005-02-01,2,2,0,-6,2,0
Afghanistan,2005-02-01,4,0,0,0,4,8
Afghanistan,2005-02-01,14,0,0,6,0,20
Afghanistan,2005-02-01,13,0,1,0,0,14
Afghanistan,2005-02-01,31,2,-2,10,1,42
Afghanistan,2005-02-01,21,0,0,0,1,22
Afghanistan,2005-02-01,17,0,0,3,0,20
Afghanistan,2005-02-01,3,0,0,0,0,3
Afghanistan,2005-02-01,2,0,0,0,0,2
Afghanistan,2005-02-01,9,0,0,3,0,12
Afghanistan,2005-02-01,12,0,-1,13,1,25
Afghanistan,2005-02-01,0,0,0,1,0,1
Afghanistan,2005-02-01,4,0,0,-4,2,2
Afghanistan,2005-02-01,8,0,0,9,0,17
Afghanistan,2005-02-01,8,0,0,2,0,10
Afghanistan,2005-02-01,11,0,-4,0,2,9
Afghanistan,2005-02-01,17,0,0,9,0,26
Afghanistan,2005-02-01,15,0,0,0,0,15
Afghanistan,2005-03-01,8,0,0,7,0,15
Afghanistan,2005-03-01,13,0,0,9,3,25
Afghanistan,2005-03-01,25,0,0,9,1,35
Afghanistan,2005-03-01,2,0,-2,0,1,1
Afghanistan,2005-03-01,14,0,0,6,0,20
Afghanistan,2005-03-01,13,2,0,-5,6,16
Afghanistan,2005-03-01,21,0,0,-3,0,18
Afghanistan,2005-03-01,16,0,0,0,3,19
Afghanistan,2005-03-01,19,0,0,4,6,29
Afghanistan,2005-03-01,6,0,0,-6,0,0
Afghanistan,2005-03-01,2,0,0,8,0,10
Afghanistan,2005-03-01,13,0,0,0,3,16
Afghanistan,2005-03-01,25,0,0,3,3,31
Afghanistan,2005-03-01,10,0,0,3,3,16
Afghanistan,2005-03-01,20,0,0,12,2,34
Afghanistan,2005-03-01,19,0,1,9,0,29
Afghanistan,2005-03-01,6,0,-4,6,0,8
Afghanistan,2005-03-01,10,0,0,9,1,20
Afghanistan,2005-03-01,-4,0,0,0,4,0
Afghanistan,2005-03-01,7,0,0,0,0,7
Afghanistan,2005-03-01,4,0,0,0,0,4
Afghanistan,2005-03-01,24,0,1,17,6,48
Afghanistan,2005-03-01,8,2,0,3,0,13
Afghanistan,2005-03-01,21,0,0,3,1,25
Afghanistan,2005-03-01,21,0,0,1,3,25
Afghanistan,2005-03-01,7,0,0,2,0,9
Afghanistan,2005-03-01,18,0,0,0,0,18
Afghanistan,2005-03-01,-1,0,0,0,1,0
Afghanistan,2005-03-01,14,0,3,7,1,25
Afghanistan,2005-03-01,17,0,0,12,6,35
Afghanistan,2005-03-01,17,0,0,36,3,56
Afghanistan,2005-04-01,5,0,0,3,0,8
Afghanistan,2005-04-01,7,0,0,0,1,8
Afghanistan,2005-04-01,21,0,0,-3,0,18
Afghanistan,2005-04-01,9,0,-4,6,0,11
Afghanistan,2005-04-01,15,0,0,0,0,15
Afghanistan,2005-04-01,22,0,0,0,5,27
Afghanistan,2005-04-01,12,0,0,6,4,22
Afghanistan,2005-04-01,20,0,0,3,1,24
Afghanistan,2005-04-01,1,0,0,21,0,22
Afghanistan,2005-04-01,0,0,0,9,0,9
Afghanistan,2005-04-01,6,0,0,9,0,15
Afghanistan,2005-04-01,13,0,0,-2,2,13
Afghanistan,2005-04-01,20,0,0,27,1,48
Afghanistan,2005-04-01,30,0,1,6,3,40
Afghanistan,2005-04-01,5,0,0,1,6,12
Afghanistan,2005-04-01,4,0,0,6,0,10
Afghanistan,2005-04-01,0,0,0,0,0,0
Afghanistan,2005-04-01,10,0,0,13,6,29
Afghanistan,2005-04-01,44,0,0,7,0,51
Afghanistan,2005-04-01,30,0,-2,1,1,30
Afghanistan,2005-04-01,5,2,0,6,2,15
Afghanistan,2005-04-01,4,0,0,7,0,11
Afghanistan,2005-04-01,11,0,0,0,0,11
Afghanistan,2005-04-01,16,0,0,1,2,19
Afghanistan,2005-04-01,12,0,0,9,3,24
Afghanistan,2005-04-01,10,0,0,16,0,26
Afghanistan,2005-04-01,5,0,0,26,0,31
Afghanistan,2005-04-01,4,0,0,7,2,13
Afghanistan,2005-04-01,9,0,0,7,0,16
Afghanistan,2005-04-01,0,0,0,0,0,0
Afghanistan,2005-05-01,5,0,0,3,0,8
Afghanistan,2005-05-01,20,0,1,9,2,32
Afghanistan,2005-05-01,-5,0,0,6,1,2
Afghanistan,2005-05-01,31,0,0,-1,6,36
Afghanistan,2005-05-01,66,0,0,3,10,79
Afghanistan,2005-05-01,8,0,0,19,0,27
Afghanistan,2005-05-01,1,0,0,21,1,23
Afghanistan,2005-05-01,44,0,-7,0,0,37
Afghanistan,2005-05-01,-2,0,-2,6,0,2
Afghanistan,2005-05-01,2,0,0,0,0,2
Afghanistan,2005-05-01,13,0,0,2,1,16
Afghanistan,2005-05-01,16,0,0,0,1,17
Afghanistan,2005-05-01,13,0,0,5,5,23
Afghanistan,2005-05-01,22,0,0,1,7,30
Afghanistan,2005-05-01,27,0,0,6,4,37
Afghanistan,2005-05-01,10,0,0,0,8,18
Afghanistan,2005-05-01,22,0,0,24,1,47
Afghanistan,2005-05-01,19,6,0,0,0,25
Afghanistan,2005-05-01,16,0,0,6,0,22
Afghanistan,2005-05-01,12,0,0,0,2,14
Afghanistan,2005-05-01,6,2,0,15,0,23
Afghanistan,2005-05-01,17,0,0,0,7,24
Afghanistan,2005-05-01,33,0,-1,9,4,45
Afghanistan,2005-05-01,10,0,0,12,1,23
Afghanistan,2005-05-01,0,0,0,3,0,3
Afghanistan,2005-05-01,3,0,0,0,5,8
Afghanistan,2005-05-01,4,0,0,-6,9,7
Afghanistan,2005-05-01,0,0,0,6,6,12
Afghanistan,2005-05-01,14,0,0,1,2,17
Afghanistan,2005-05-01,16,0,0,10,0,26
Afghanistan,2005-05-01,13,0,0,0,10,23
Afghanistan,2005-06-01,39,0,0,14,3,56
Afghanistan,2005-06-01,17,0,0,-4,0,13
Afghanistan,2005-06-01,0,0,-2,0,1,-1
Afghanistan,2005-06-01,21,0,0,4,3,28
Afghanistan,2005-06-01,9,0,0,3,0,12
Afghanistan,2005-06-01,9,0,0,1,2,12
Afghanistan,2005-06-01,10,0,0,-4,0,6
Afghanistan,2005-06-01,16,0,0,6,4,26
Afghanistan,2005-06-01,14,0,0,12,3,29
Afghanistan,2005-06-01,11,0,0,9,1,21
Afghanistan,2005-06-01,2,0,0,12,1,15
Afghanistan,2005-06-01,14,0,0,14,2,30
Afghanistan,2005-06-01,11,0,3,9,8,31
Afghanistan,2005-06-01,37,0,0,12,3,52
Afghanistan,2005-06-01,21,0,0,-2,0,19
Afghanistan,2005-06-01,6,0,0,-6,1,1
Afghanistan,2005-06-01,9,0,0,-4,0,5
Afghanistan,2005-06-01,23,0,0,0,1,24
Afghanistan,2005-06-01,10,0,0,0,0,10
Afghanistan,2005-06-01,10,0,0,6,2,18
Afghanistan,2005-06-01,23,0,0,9,0,32
Afghanistan,2005-06-01,43,0,0,10,2,55
Afghanistan,2005-06-01,28,0,0,9,9,46
Afghanistan,2005-06-01,13,0,0,7,2,22
Afghanistan,2005-06-01,28,0,0,0,2,30
Afghanistan,2005-06-01,17,0,-4,0,0,13
Afghanistan,2005-06-01,9,0,-12,36,2,35
Afghanistan,2005-06-01,19,0,-4,11,1,27
Afghanistan,2005-06-01,23,0,0,2,1,26
Afghanistan,2005-06-01,17,0,0,3,2,22
Afghanistan,2005-07-01,10,0,0,3,0,13
Afghanistan,2005-07-01,23,0,0,3,0,26
Afghanistan,2005-07-01,12,0,-2,0,5,15
Afghanistan,2005-07-01,29,0,0,-1,0,28
Afghanistan,2005-07-01,10,0,1,1,4,16
Afghanistan,2005-07-01,26,0,0,2,1,29
Afghanistan,2005-07-01,42,0,-6,12,9,57
Afghanistan,2005-07-01,6,0,-10,0,1,-3
Afghanistan,2005-07-01,22,0,0,-4,0,18
Afghanistan,2005-07-01,13,0,0,12,8,33
Afghanistan,2005-07-01,35,0,1,-2,4,38
Afghanistan,2005-07-01,1,0,0,13,2,16
Afghanistan,2005-07-01,19,0,0,28,2,49
Afghanistan,2005-07-01,14,4,0,3,0,21
Afghanistan,2005-07-01,11,0,0,12,15,38
Afghanistan,2005-07-01,5,0,0,6,0,11
Afghanistan,2005-07-01,36,0,0,12,0,48
Afghanistan,2005-07-01,22,2,0,9,0,33
Afghanistan,2005-07-01,12,0,0,15,1,28
Afghanistan,2005-07-01,16,0,0,14,0,30
Afghanistan,2005-07-01,12,0,0,9,2,23
Afghanistan,2005-07-01,33,0,0,-2,0,31
Afghanistan,2005-07-01,-3,0,0,4,1,2
Afghanistan,2005-07-01,30,0,0,15,1,46
Afghanistan,2005-07-01,27,0,0,21,9,57
Afghanistan,2005-07-01,12,0,0,3,0,15
Afghanistan,2005-07-01,15,0,0,3,0,18
Afghanistan,2005-07-01,16,0,0,19,1,36
Afghanistan,2005-07-01,29,0,0,12,0,41
Afghanistan,2005-07-01,9,0,0,2,2,13
Afghanistan,2005-07-01,3,0,0,3,0,6
Afghanistan,2005-08-01,4,0,0,20,2,26
Afghanistan,2005-08-01,32,0,0,6,0,38
Afghanistan,2005-08-01,-1,0,1,2,1,3
Afghanistan,2005-08-01,15,0,0,6,0,21
Afghanistan,2005-08-01,17,0,0,7,0,24
Afghanistan,2005-08-01,16,0,0,13,2,31
Afghanistan,2005-08-01,27,0,0,9,0,36
Afghanistan,2005-08-01,11,0,0,15,0,26
Afghanistan,2005-08-01,18,0,0,6,0,24
Afghanistan,2005-08-01,18,0,0,0,3,21
Afghanistan,2005-08-01,18,0,0,-2,0,16
Afghanistan,2005-08-01,11,0,0,3,0,14
Afghanistan,2005-08-01,15,2,0,3,0,20
Afghanistan,2005-08-01,22,0,0,7,0,29
Afghanistan,2005-08-01,2,0,0,-2,2,2
Afghanistan,2005-08-01,3,0,0,0,0,3
Afghanistan,2005-08-01,24,0,1,12,0,37
Afghanistan,2005-08-01,17,0,0,9,8,34
Afghanistan,2005-08-01,28,0,0,-4,3,27
Afghanistan,2005-08-01,16,0,0,6,0,22
Afghanistan,2005-08-01,26,0,0,-4,2,24
Afghanistan,2005-08-01,12,0,0,-6,0,6
Afghanistan,2005-08-01,33,0,0,0,0,33
Afghanistan,2005-08-01,23,0,3,-18,0,8
Afghanistan,2005-08-01,10,2,0,9,0,21
Afghanistan,2005-08-01,10,0,0,9,0,19
Afghanistan,2005-08-01,12,0,0,-1,0,11
Afghanistan,2005-08-01,21,0,0,15,4,40
Afghanistan,2005-08-01,12,0,-1,13,7,31
Afghanistan,2005-08-01,4,0,0,0,0,4
Afghanistan,2005-08-01,13,2,1,12,0,28
Afghanistan,2005-09-01,9,0,0,11,8,28
Afghanistan,2005-09-01,18,0,0,6,2,26
Afghanistan,2005-09-01,16,0,0,24,0,40
Afghanistan,2005-09-01,4,0,1,0,0,5
Afghanistan,2005-09-01,6,0,0,6,0,12
Afghanistan,2005-09-01,28,0,1,9,0,38
Afghanistan,2005-09-01,8,0,0,3,0,11
Afghanistan,2005-09-01,9,0,0,-2,1,8
Afghanistan,2005-09-01,13,0,0,3,4,20
Afghanistan,2005-09-01,14,0,0,27,4,45
Afghanistan,2005-09-01,19,0,0,0,0,19
Afghanistan,2005-09-01,11,0,0,2,2,15
Afghanistan,2005-09-01,51,0,0,6,5,62
Afghanistan,2005-09-01,4,0,0,27,2,33
Afghanistan,2005-09-01,22,0,0,3,5,30
Afghanistan,2005-09-01,10,0,-1,3,0,12
Afghanistan,2005-09-01,21,0,0,6,3,30
Afghanistan,2005-09-01,17,0,-1,7,2,25
Afghanistan,2005-09-01,15,0,1,16,4,36
Afghanistan,2005-09-01,36,0,0,1,2,39
Afghanistan,2005-09-01,28,0,-2,0,1,27
Afghanistan,2005-09-01,12,0,-8,6,2,12
Afghanistan,2005-09-01,26,0,0,3,0,29
Afghanistan,2005-09-01,6,0,0,0,0,6
Afghanistan,2005-09-01,5,0,0,6,3,14
Afghanistan,2005-09-01,9,0,0,19,0,28
Afghanistan,2005-09-01,6,0,-6,18,0,18
Afghanistan,2005-09-01,14,0,0,12,7,33
Afghanistan,2005-09-01,14,0,0,25,5,44
Afghanistan,2005-09-01,13,0,0,9,3,25
Afghanistan,2005-10-01,12,0,0,3,0,15
Afghanistan,2005-10-01,7,0,0,3,0,10
Afghanistan,2005-10-01,12,0,0,12,3,27
Afghanistan,2005-10-01,32,0,0,10,1,43
Afghanistan,2005-10-01,16,0,0,33,7,56
Afghanistan,2005-10-01,24,0,0,19,2,45
Afghanistan,2005-10-01,18,0,-2,20,4,40
Afghanistan,2005-10-01,5,0,0,1,0,6
Afghanistan,2005-10-01,34,0,0,7,5,46
Afghanistan,2005-10-01,26,0,0,3,6,35
Afghanistan,2005-10-01,14,0,0,15,11,40
Afghanistan,2005-10-01,51,0,0,3,5,59
Afghanistan,2005-10-01,31,0,0,6,10,47
Afghanistan,2005-10-01,8,0,0,24,1,33
Afghanistan,2005-10-01,11,0,0,6,0,17
Afghanistan,2005-10-01,10,0,0,6,3,19
Afghanistan,2005-10-01,6,0,0,3,5,14
Afghanistan,2005-10-01,5,0,1,3,0,9
Afghanistan,2005-10-01,12,0,0,12,1,25
Afghanistan,2005-10-01,28,0,0,13,0,41
Afghanistan,2005-10-01,11,0,0,0,2,13
Afghanistan,2005-10-01,14,0,0,18,8,40
Afghanistan,2005-10-01,20,0,0,21,3,44
Afghanistan,2005-10-01,27,0,0,0,4,31
Afghanistan,2005-10-01,6,0,0,7,4,17
Afghanistan,2005-10-01,8,0,-1,1,0,8
Afghanistan,2005-10-01,6,0,0,18,2,26
Afghanistan,2005-10-01,3,0,0,18,0,21
Afghanistan,2005-10-01,29,0,1,10,3,43
Afghanistan,2005-10-01,24,0,0,9,0,33
Afghanistan,2005-10-01,3,0,0,8,0,11
Afghanistan,2005-11-01,16,0,0,6,0,22
Afghanistan,2005-11-01,6,0,1,11,2,20
Afghanistan,2005-11-01,13,0,0,4,3,20
Afghanistan,2005-11-01,16,0,0,1,0,17
Afghanistan,2005-11-01,14,0,0,7,0,21
Afghanistan,2005-11-01,13,0,0,5,0,18
Afghanistan,2005-11-01,4,0,0,15,1,20
Afghanistan,2005-11-01,34,0,0,15,0,49
Afghanistan,2005-11-01,18,0,0,6,13,37
Afghanistan,2005-11-01,18,0,0,3,4,25
Afghanistan,2005-11-01,0,0,0,9,2,11
Afghanistan,2005-11-01,6,0,-2,-1,1,4
Afghanistan,2005-11-01,21,0,1,20,2,44
Afghanistan,2005-11-01,4,0,0,8,0,12
Afghanistan,2005-11-01,3,0,0,9,0,12
Afghanistan,2005-11-01,22,0,0,10,0,32
Afghanistan,2005-11-01,21,0,0,14,1,36
Afghanistan,2005-11-01,-4,0,0,6,4,6
Afghanistan,2005-11-01,14,0,0,7,1,22
Afghanistan,2005-11-01,1,0,0,-2,0,-1
Afghanistan,2005-11-01,10,0,0,15,0,25
Afghanistan,2005-11-01,11,0,0,10,1,22
Afghanistan,2005-11-01,5,0,0,1,1,7
Afghanistan,2005-11-01,0,0,0,12,2,14
Afghanistan,2005-11-01,8,0,1,0,3,12
Afghanistan,2005-11-01,21,0,0,-2,4,23
Afghanistan,2005-11-01,12,0,0,12,0,24
Afghanistan,2005-11-01,12,0,0,3,0,15
Afghanistan,2005-11-01,33,2,1,-1,2,37
Afghanistan,2005-11-01,16,0,0,4,0,20
Afghanistan,2005-12-01,4,0,0,3,0,7
Afghanistan,2005-12-01,6,0,0,-2,0,4
Afghanistan,2005-12-01,39,0,0,6,3,48
Afghanistan,2005-12-01,58,0,0,21,3,82
Afghanistan,2005-12-01,18,0,0,6,2,26
Afghanistan,2005-12-01,5,0,0,8,0,13
Afghanistan,2005-12-01,10,0,0,3,1,14
Afghanistan,2005-12-01,34,0,0,18,7,59
Afghanistan,2005-12-01,34,0,0,9,1,44
Afghanistan,2005-12-01,15,0,0,3,2,20
Afghanistan,2005-12-01,26,0,0,3,3,32
Afghanistan,2005-12-01,8,0,0,12,0,20
Afghanistan,2005-12-01,9,0,0,18,1,28
Afghanistan,2005-12-01,28,0,0,20,3,51
Afghanistan,2005-12-01,8,0,0,18,3,29
Afghanistan,2005-12-01,8,2,0,12,0,22
Afghanistan,2005-12-01,27,0,0,9,0,36
Afghanistan,2005-12-01,20,0,0,0,0,20
Afghanistan,2005-12-01,18,0,0,7,2,27
Afghanistan,2005-12-01,26,0,0,15,0,41
Afghanistan,2005-12-01,6,0,0,9,0,15
Afghanistan,2005-12-01,7,0,0,4,1,12
Afghanistan,2005-12-01,17,0,0,12,0,29
Afghanistan,2005-12-01,15,0,0,-2,0,13
Afghanistan,2005-12-01,11,0,0,0,2,13
Afghanistan,2005-12-01,3,0,0,-2,0,1
Afghanistan,2005-12-01,17,0,0,10,0,27
Afghanistan,2005-12-01,9,0,0,6,0,15
Afghanistan,2005-12-01,12,0,0,3,7,22
Afghanistan,2005-12-01,2,0,0,0,0,2
Afghanistan,2005-12-01,28,0,0,7,6,41
Albania,2005-01-01,1,0,0,0,0,1
Albania,2005-01-01,12,0,0,0,0,12
Albania,2005-01-01,3,0,0,0,0,3
Albania,2005-01-01,7,0,0,6,0,13
Albania,2005-01-01,2,0,0,0,1,3
Albania,2005-01-01,15,0,0,0,0,15
Albania,2005-01-01,28,0,0,0,3,31
Albania,2005-01-01,8,0,0,0,5,13
Albania,2005-01-01,32,0,0,12,2,46
Albania,2005-01-01,11,0,-4,0,2,9
Albania,2005-01-01,18,0,-3,9,2,26
Albania,2005-01-01,11,0,1,0,6,18
Albania,2005-01-01,5,0,0,-2,0,3
Albania,2005-01-01,-7,0,0,0,0,-7
Albania,2005-01-01,9,0,0,3,0,12
Albania,2005-01-01,0,0,0,30,2,32
Albania,2005-01-01,28,0,0,0,0,28
Albania,2005-01-01,4,0,0,6,0,10
Albania,2005-01-01,0,0,-1,6,0,5
Albania,2005-01-01,0,0,0,1,0,1
Albania,2005-01-01,9,0,0,0,0,9
Albania,2005-01-01,12,2,-2,9,0,21
Albania,2005-01-01,0,0,0,0,0,0
Albania,2005-01-01,11,0,0,0,0,11
Albania,2005-01-01,10,0,0,-2,0,8
Albania,2005-01-01,21,0,-1,9,0,29
Albania,2005-01-01,7,0,0,0,0,7
Albania,2005-01-01,4,0,0,0,0,4
Albania,2005-01-01,1,0,0,0,0,1
Albania,2005-02-01,0,0,2,8,0,10
Albania,2005-02-01,0,0,0,9,0,9
Albania,2005-02-01,4,0,0,12,0,16
Albania,2005-02-01,3,0,0,0,0,3
Albania,2005-02-01,-1,0,0,0,0,-1
Albania,2005-02-01,13,0,0,4,0,17
Albania,2005-02-01,7,0,-2,0,0,5
Albania,2005-02-01,10,0,-1,0,0,9
Albania,2005-02-01,1,0,0,0,0,1
Albania,2005-02-01,4,0,0,15,0,19
Albania,2005-02-01,0,0,0,3,0,3
Albania,2005-02-01,16,0,0,3,0,19
Albania,2005-02-01,23,0,0,8,0,31
Albania,2005-02-01,-1,0,0,0,0,-1
Albania,2005-02-01,0,0,0,0,2,2
Albania,2005-02-01,0,0,0,0,0,0
Albania,2005-02-01,2,0,0,0,0,2
Albania,2005-02-01,2,0,0,0,0,2
Albania,2005-02-01,6,0,0,0,0,6
Albania,2005-02-01,0,0,0,0,0,0
Albania,2005-02-01,0,0,0,0,0,0
Albania,2005-02-01,2,0,0,0,0,2
Albania,2005-02-01,13,0,0,0,0,13
Albania,2005-02-01,0,0,0,0,0,0
Albania,2005-02-01,0,0,0,2,2,4
Albania,2005-02-01,4,0,0,0,0,4
Albania,2005-03-01,4,0,0,15,1,20
Albania,2005-03-01,0,0,0,3,0,3
Albania,2005-03-01,5,0,0,6,0,11
Albania,2005-03-01,4,0,0,0,0,4
Albania,2005-03-01,5,0,0,0,0,5
Albania,2005-03-01,0,0,0,9,0,9
Albania,2005-03-01,0,0,0,0,0,0
Albania,2005-03-01,15,0,-26,34,6,29
Albania,2005-03-01,11,0,-6,24,1,30
Albania,2005-03-01,2,0,0,27,4,33
Albania,2005-03-01,19,0,-2,18,0,35
Albania,2005-03-01,6,0,-1,0,0,5
Albania,2005-03-01,13,0,-3,4,2,16
Albania,2005-03-01,6,0,0,22,2,30
Albania,2005-03-01,21,0,-6,22,0,37
Albania,2005-03-01,18,0,0,27,0,45
Albania,2005-03-01,13,0,-6,6,0,13
Albania,2005-03-01,1,0,-6,12,0,7
Albania,2005-03-01,3,0,0,12,0,15
Albania,2005-03-01,6,0,0,0,0,6
Albania,2005-03-01,7,0,0,11,0,18
Albania,2005-03-01,0,0,0,3,0,3
Albania,2005-03-01,9,2,-3,16,8,32
Albania,2005-03-01,12,0,0,9,2,23
Albania,2005-03-01,-2,0,0,-4,0,-6
Albania,2005-03-01,1,0,0,0,2,3
Albania,2005-03-01,-3,0,0,9,3,9
Albania,2005-03-01,8,0,-1,3,2,12
Albania,2005-03-01,3,0,0,6,0,9
Albania,2005-03-01,2,0,0,0,0,2
Albania,2005-03-01,6,0,0,1,0,7
Albania,2005-04-01,4,0,0,9,0,13
Albania,2005-04-01,0,0,0,6,0,6
Albania,2005-04-01,5,0,0,0,0,5
Albania,2005-04-01,-2,0,0,6,0,4
Albania,2005-04-01,-3,0,0,0,0,-3
Albania,2005-04-01,3,0,0,9,0,12
Albania,2005-04-01,-2,0,0,6,0,4
Albania,2005-04-01,0,0,0,9,0,9
Albania,2005-04-01,0,0,0,0,0,0
Albania,2005-04-01,0,0,0,3,0,3
Albania,2005-04-01,8,0,0,0,1,9
Albania,2005-04-01,4,0,0,0,2,6
Albania,2005-04-01,0,0,0,0,0,0
Albania,2005-04-01,8,0,0,21,4,33
Albania,2005-04-01,22,0,0,-3,0,19
Albania,2005-04-01,14,0,0,4,0,18
Albania,2005-04-01,10,0,0,9,2,21
Albania,2005-04-01,12,0,0,6,0,18
Albania,2005-04-01,2,0,0,0,0,2
Albania,2005-04-01,0,0,0,3,0,3
Albania,2005-04-01,8,0,0,9,0,17
Albania,2005-04-01,0,0,1,3,6,10
Albania,2005-04-01,-3,0,0,3,2,2
Albania,2005-04-01,9,0,0,0,0,9
Albania,2005-04-01,4,0,0,6,0,10
Albania,2005-04-01,2,0,0,0,0,2
Albania,2005-04-01,0,0,0,0,0,0
Albania,2005-04-01,3,0,0,3,0,6
Albania,2005-05-01,0,0,0,0,0,0
Albania,2005-05-01,2,0,0,0,0,2
Albania,2005-05-01,4,0,0,0,0,4
Albania,2005-05-01,0,0,0,0,0,0
Albania,2005-05-01,8,0,0,1,0,9
Albania,2005-05-01,-3,0,0,-2,0,-5
Albania,2005-05-01,0,0,0,-6,0,-6
Albania,2005-05-01,0,0,0,0,0,0
Albania,2005-05-01,0,0,0,-1,1,0
Albania,2005-05-01,3,0,0,6,0,9
Albania,2005-05-01,2,0,0,-2,0,0
Albania,2005-05-01,5,0,0,0,0,5
Albania,2005-05-01,0,0,1,9,6,16
Albania,2005-05-01,0,0,0,0,0,0
Albania,2005-05-01,0,0,0,7,0,7
Albania,2005-05-01,7,0,0,3,0,10
Albania,2005-05-01,-1,0,-1,3,6,7
Albania,2005-05-01,12,2,-1,3,0,16
Albania,2005-05-01,-1,0,0,0,0,-1
Albania,2005-05-01,0,0,0,0,0,0
Albania,2005-05-01,0,0,0,0,0,0
Albania,2005-05-01,12,0,0,-5,0,7
Albania,2005-05-01,7,0,0,0,0,7
Albania,2005-05-01,0,0,0,0,0,0
Albania,2005-05-01,0,0,0,3,0,3
Albania,2005-05-01,4,0,0,9,0,13
Albania,2005-05-01,15,0,0,3,0,18
Albania,2005-05-01,0,0,0,3,0,3
Albania,2005-06-01,3,0,0,3,0,6
Albania,2005-06-01,1,0,0,6,3,10
Albania,2005-06-01,6,0,0,0,0,6
Albania,2005-06-01,9,0,0,0,0,9
Albania,2005-06-01,0,0,0,0,0,0
Albania,2005-06-01,6,0,0,8,2,16
Albania,2005-06-01,8,0,0,7,2,17
Albania,2005-06-01,4,0,0,3,0,7
Albania,2005-06-01,5,0,0,6,0,11
Albania,2005-06-01,5,0,0,12,1,18
Albania,2005-06-01,-2,0,0,0,0,-2
Albania,2005-06-01,4,0,0,0,0,4
Albania,2005-06-01,6,0,0,3,0,9
Albania,2005-06-01,6,0,0,0,0,6
Albania,2005-06-01,7,0,0,12,0,19
Albania,2005-06-01,2,0,0,0,0,2
Albania,2005-06-01,15,0,0,13,1,29
Albania,2005-06-01,0,0,0,3,0,3
Albania,2005-06-01,0,0,0,6,4,10
Albania,2005-06-01,4,0,-1,2,0,5
Albania,2005-06-01,0,0,0,0,0,0
Albania,2005-06-01,0,0,0,0,0,0
Albania,2005-06-01,16,0,0,-4,1,13
Albania,2005-06-01,7,2,0,8,0,17
Albania,2005-06-01,0,0,0,0,0,0
Albania,2005-06-01,0,0,0,0,2,2
Albania,2005-06-01,12,0,0,15,3,30
Albania,2005-06-01,1,0,0,0,0,1
Albania,2005-06-01,3,0,0,-3,0,0
Albania,2005-06-01,2,0,0,0,1,3
Albania,2005-07-01,3,0,0,3,2,8
Albania,2005-07-01,6,0,-6,6,0,6
Albania,2005-07-01,9,0,1,1,1,12
Albania,2005-07-01,2,0,1,2,1,6
Albania,2005-07-01,0,0,0,-2,0,-2
Albania,2005-07-01,11,0,0,6,0,17
Albania,2005-07-01,0,0,0,-4,0,-4
Albania,2005-07-01,5,0,0,12,0,17
Albania,2005-07-01,-1,0,0,3,0,2
Albania,2005-07-01,33,0,0,3,0,36
Albania,2005-07-01,5,0,0,6,2,13
Albania,2005-07-01,36,0,0,0,0,36
Albania,2005-07-01,4,0,0,6,0,10
Albania,2005-07-01,1,0,0,0,0,1
Albania,2005-07-01,4,0,0,0,0,4
Albania,2005-07-01,2,0,0,6,0,8
Albania,2005-07-01,0,0,0,0,0,0
Albania,2005-07-01,1,0,-2,0,0,-1
Albania,2005-07-01,0,0,0,0,0,0
Albania,2005-07-01,4,0,0,19,1,24
Albania,2005-07-01,9,0,0,3,0,12
Albania,2005-07-01,4,0,0,3,5,12
Albania,2005-07-01,9,0,0,3,2,14
Albania,2005-07-01,2,0,0,3,0,5
Albania,2005-07-01,0,0,1,0,0,1
Albania,2005-07-01,1,0,0,0,0,1
Albania,2005-07-01,0,0,0,0,3,3
Albania,2005-07-01,-1,0,0,9,0,8
Albania,2005-08-01,0,0,-1,3,0,2
Albania,2005-08-01,2,0,-2,0,0,0
Albania,2005-08-01,7,0,0,0,0,7
Albania,2005-08-01,0,0,0,0,0,0
Albania,2005-08-01,0,0,0,0,0,0
Albania,2005-08-01,0,0,0,0,1,1
Albania,2005-08-01,10,0,0,0,0,10
Albania,2005-08-01,7,0,0,-4,0,3
Albania,2005-08-01,13,2,0,-4,0,11
Albania,2005-08-01,-1,0,0,0,0,-1
Albania,2005-08-01,0,0,-1,0,0,-1
Albania,2005-08-01,-1,0,0,0,0,-1
Albania,2005-08-01,2,0,0,0,0,2
Albania,2005-08-01,8,0,0,3,0,11
Albania,2005-08-01,24,0,-1,0,0,23
Albania,2005-08-01,1,0,0,0,0,1
Albania,2005-08-01,0,0,0,0,0,0
Albania,2005-08-01,2,0,0,0,0,2
Albania,2005-08-01,2,0,0,3,6,11
Albania,2005-08-01,3,0,0,0,0,3
Albania,2005-08-01,1,0,0,0,0,1
Albania,2005-08-01,4,0,0,0,0,4
Albania,2005-08-01,4,0,0,0,0,4
Albania,2005-08-01,19,0,0,0,0,19
Albania,2005-08-01,9,0,0,0,0,9
Albania,2005-08-01,0,0,2,3,0,5
Albania,2005-08-01,3,0,0,6,0,9
Albania,2005-09-01,4,0,-3,0,1,2
Albania,2005-09-01,5,0,0,0,0,5
Albania,2005-09-01,0,0,0,0,0,0
Albania,2005-09-01,22,0,-1,4,0,25
Albania,2005-09-01,6,0,0,1,0,7
Albania,2005-09-01,2,0,0,0,0,2
Albania,2005-09-01,17,0,0,0,0,17
Albania,2005-09-01,0,0,1,0,6,7
Albania,2005-09-01,10,0,1,6,2,19
Albania,2005-09-01,0,0,0,0,0,0
Albania,2005-09-01,5,0,2,3,0,10
Albania,2005-09-01,2,0,0,0,0,2
Albania,2005-09-01,0,0,0,3,0,3
Albania,2005-09-01,2,0,0,0,0,2
Albania,2005-09-01,4,0,0,-2,0,2
Albania,2005-09-01,0,0,0,6,0,6
Albania,2005-09-01,3,0,0,18,0,21
Albania,2005-09-01,5,0,0,-1,0,4
Albania,2005-09-01,6,0,0,0,0,6
Albania,2005-09-01,29,2,0,3,3,37
Albania,2005-09-01,12,0,0,0,0,12
Albania,2005-09-01,8,0,0,0,0,8
Albania,2005-09-01,2,0,0,0,0,2
Albania,2005-09-01,0,0,0,6,0,6
Albania,2005-09-01,5,0,0,0,0,5
Albania,2005-09-01,7,0,0,0,0,7
Albania,2005-09-01,5,0,0,0,0,5
Albania,2005-09-01,7,0,0,6,3,16
Albania,2005-09-01,5,0,0,3,0,8
Albania,2005-10-01,9,0,0,0,0,9
Albania,2005-10-01,0,0,0,0,0,0
Albania,2005-10-01,5,0,0,0,0,5
Albania,2005-10-01,1,0,0,2,1,4
Albania,2005-10-01,11,0,0,0,0,11
Albania,2005-10-01,4,0,0,6,0,10
Albania,2005-10-01,26,0,-1,3,0,28
Albania,2005-10-01,4,0,-1,0,0,3
Albania,2005-10-01,0,0,0,0,0,0
Albania,2005-10-01,0,0,0,0,0,0
Albania,2005-10-01,0,0,0,3,3,6
Albania,2005-10-01,6,0,0,6,0,12
Albania,2005-10-01,-1,0,0,3,0,2
Albania,2005-10-01,6,0,-1,0,0,5
Albania,2005-10-01,8,0,0,0,0,8
Albania,2005-10-01,-1,0,0,0,0,-1
Albania,2005-10-01,-2,0,0,0,0,-2
Albania,2005-10-01,0,0,-2,6,0,4
Albania,2005-10-01,17,0,-1,4,2,22
Albania,2005-10-01,9,0,0,0,1,10
Albania,2005-10-01,2,0,-3,0,0,-1
Albania,2005-10-01,6,0,0,0,0,6
Albania,2005-10-01,-2,0,0,0,0,-2
Albania,2005-10-01,2,0,0,0,3,5
Albania,2005-10-01,7,0,-1,18,0,24
Albania,2005-10-01,4,0,-1,3,4,10
Albania,2005-10-01,13,0,-2,0,0,11
Albania,2005-10-01,2,0,0,0,0,2
Albania,2005-10-01,0,0,1,3,3,7
Albania,2005-10-01,5,0,0,0,0,5
Albania,2005-11-01,7,0,-1,0,0,6
Albania,2005-11-01,6,0,0,0,0,6
Albania,2005-11-01,5,0,0,0,0,5
Albania,2005-11-01,2,0,0,0,0,2
Albania,2005-11-01,7,0,0,0,0,7
Albania,2005-11-01,5,0,0,0,0,5
Albania,2005-11-01,12,4,0,6,0,22
Albania,2005-11-01,12,0,0,6,0,18
Albania,2005-11-01,0,0,-2,-2,1,-3
Albania,2005-11-01,0,0,0,0,1,1
Albania,2005-11-01,2,0,-1,0,0,1
Albania,2005-11-01,0,0,-2,0,0,-2
Albania,2005-11-01,3,0,0,0,0,3
Albania,2005-11-01,0,0,0,0,0,0
Albania,2005-11-01,11,0,-2,4,0,13
Albania,2005-11-01,18,0,0,0,0,18
Albania,2005-11-01,11,0,0,3,4,18
Albania,2005-11-01,14,0,0,10,0,24
Albania,2005-11-01,10,0,0,0,1,11
Albania,2005-11-01,0,0,0,0,0,0
Albania,2005-11-01,4,0,-1,3,6,12
Albania,2005-11-01,34,0,0,0,1,35
Albania,2005-11-01,13,0,0,0,1,14
Albania,2005-11-01,2,0,-2,-2,0,-2
Albania,2005-11-01,9,0,0,-1,0,8
Albania,2005-11-01,9,0,0,0,0,9
Albania,2005-11-01,0,0,0,0,1,1
Albania,2005-11-01,4,0,0,7,0,11
Albania,2005-11-01,3,0,-1,9,0,11
Albania,2005-11-01,15,0,0,32,1,48
Albania,2005-12-01,0,0,0,6,0,6
Albania,2005-12-01,2,0,0,0,0,2
Albania,2005-12-01,0,0,0,3,0,3
Albania,2005-12-01,7,0,0,0,0,7
Albania,2005-12-01,0,0,0,3,0,3
Albania,2005-12-01,0,0,0,-4,2,-2
Albania,2005-12-01,9,0,0,3,6,18
Albania,2005-12-01,1,0,0,9,0,10
Albania,2005-12-01,15,0,0,7,0,22
Albania,2005-12-01,0,0,0,0,0,0
Albania,2005-12-01,3,0,0,0,0,3
Albania,2005-12-01,-1,0,-1,3,0,1
Albania,2005-12-01,5,0,-2,1,0,4
Albania,2005-12-01,9,0,0,1,0,10
Albania,2005-12-01,3,0,1,0,0,4
Albania,2005-12-01,4,0,0,0,0,4
Albania,2005-12-01,0,0,0,3,0,3
Albania,2005-12-01,10,0,-1,-6,0,3
Albania,2005-12-01,0,0,0,0,0,0
Albania,2005-12-01,1,0,0,0,0,1
Albania,2005-12-01,-1,0,0,3,0,2
Albania,2005-12-01,1,0,0,0,0,1
Albania,2005-12-01,2,0,0,3,1,6
Albania,2005-12-01,9,0,-3,3,0,9
Albania,2005-12-01,0,0,-3,0,0,-3
Albania,2005-12-01,3,0,0,3,0,6
Albania,2005-12-01,1,0,-2,0,0,-1
Albania,2005-12-01,12,0,0,6,0,18
Albania,2005-12-01,0,0,0,3,0,3
Algeria,2005-01-01,3,0,0,0,0,3
Algeria,2005-01-01,-6,0,0,0,0,-6
Algeria,2005-01-01,0,0,-4,0,0,-4
Algeria,2005-01-01,-6,0,0,0,0,-6
Algeria,2005-01-01,-1,0,0,1,0,0
Algeria,2005-01-01,-2,0,0,0,0,-2
Algeria,2005-01-01,0,0,0,0,0,0
Algeria,2005-01-01,0,0,0,0,0,0
Algeria,2005-01-01,-1,0,0,0,2,1
Algeria,2005-01-01,7,0,0,3,0,10
Algeria,2005-01-01,0,0,0,3,2,5
Algeria,2005-01-01,0,0,0,0,0,0
Algeria,2005-01-01,0,0,0,0,0,0
Algeria,2005-01-01,0,0,0,0,0,0
Algeria,2005-01-01,0,0,0,-1,0,-1
Algeria,2005-01-01,0,0,0,3,0,3
Algeria,2005-01-01,5,0,0,18,0,23
Algeria,2005-01-01,-1,0,0,0,0,-1
Algeria,2005-01-01,0,0,0,9,0,9
Algeria,2005-01-01,0,0,0,0,0,0
Algeria,2005-01-01,0,0,0,0,0,0
Algeria,2005-01-01,0,0,0,0,0,0
Algeria,2005-01-01,3,0,0,0,0,3
Algeria,2005-01-01,5,0,0,6,0,11
Algeria,2005-01-01,2,0,0,0,0,2
Algeria,2005-01-01,4,0,0,2,1,7
Algeria,2005-01-01,4,0,0,0,0,4
Algeria,2005-01-01,3,0,0,0,0,3
Algeria,2005-01-01,3,0,0,0,0,3
Algeria,2005-02-01,5,0,0,3,0,8
Algeria,2005-02-01,3,0,0,0,0,3
Algeria,2005-02-01,0,0,0,0,0,0
Algeria,2005-02-01,-6,0,0,0,0,-6
Algeria,2005-02-01,0,0,0,0,0,0
Algeria,2005-02-01,2,0,0,3,0,5
Algeria,2005-02-01,0,0,0,3,0,3
Algeria,2005-02-01,0,0,0,0,0,0
Algeria,2005-02-01,0,0,0,0,0,0
Algeria,2005-02-01,0,0,0,0,0,0
Algeria,2005-02-01,0,0,0,0,0,0
Algeria,2005-02-01,7,0,0,0,1,8
Algeria,2005-02-01,0,0,0,6,0,6
Algeria,2005-02-01,0,0,0,0,0,0
Algeria,2005-02-01,0,0,0,0,0,0
Algeria,2005-02-01,6,0,0,12,0,18
Algeria,2005-02-01,-1,0,0,0,0,-1
Algeria,2005-02-01,0,0,0,3,0,3
Algeria,2005-02-01,0,0,0,0,0,0
Algeria,2005-02-01,7,0,0,0,0,7
Algeria,2005-02-01,0,0,0,0,0,0
Algeria,2005-02-01,0,0,0,0,0,0
Algeria,2005-02-01,0,0,0,0,0,0
Algeria,2005-02-01,-2,0,0,0,0,-2
Algeria,2005-02-01,-1,0,0,3,0,2
Algeria,2005-02-01,0,0,0,0,0,0
Algeria,2005-02-01,0,0,0,3,0,3
Algeria,2005-02-01,0,0,0,3,0,3
Algeria,2005-03-01,0,0,0,0,0,0
Algeria,2005-03-01,0,0,0,0,0,0
Algeria,2005-03-01,0,0,0,3,0,3
Algeria,2005-03-01,2,0,0,0,0,2
Algeria,2005-03-01,0,0,0,9,0,9
Algeria,2005-03-01,0,0,0,3,0,3
Algeria,2005-03-01,0,0,0,0,0,0
Algeria,2005-03-01,0,0,0,0,0,0
Algeria,2005-03-01,2,0,0,0,0,2
Algeria,2005-03-01,5,0,0,12,0,17
Algeria,2005-03-01,-2,0,0,1,0,-1
Algeria,2005-03-01,0,0,0,9,0,9
Algeria,2005-03-01,0,0,0,0,0,0
Algeria,2005-03-01,3,0,0,0,0,3
Algeria,2005-03-01,0,0,0,6,0,6
Algeria,2005-03-01,-1,0,0,0,0,-1
Algeria,2005-03-01,1,0,0,0,0,1
Algeria,2005-03-01,5,0,0,24,0,29
Algeria,2005-03-01,10,0,0,0,0,10
Algeria,2005-03-01,1,0,0,0,0,1
Algeria,2005-03-01,2,0,-1,0,0,1
Algeria,2005-03-01,1,0,0,0,2,3
Algeria,2005-03-01,7,0,0,0,0,7
Algeria,2005-03-01,10,0,0,3,0,13
Algeria,2005-03-01,0,0,0,0,0,0
Algeria,2005-03-01,3,0,0,0,0,3
Algeria,2005-03-01,0,0,0,0,6,6
Algeria,2005-03-01,0,0,0,0,0,0
Algeria,2005-03-01,2,0,0,0,0,2
Algeria,2005-03-01,3,0,0,3,0,6
Algeria,2005-03-01,-1,0,0,0,0,-1
Algeria,2005-04-01,9,0,1,6,0,16
Algeria,2005-04-01,9,0,0,10,0,19
Algeria,2005-04-01,2,0,0,0,0,2
Algeria,2005-04-01,6,0,1,-2,0,5
Algeria,2005-04-01,4,0,0,0,0,4
Algeria,2005-04-01,-1,0,0,0,0,-1
Algeria,2005-04-01,-2,0,0,0,0,-2
Algeria,2005-04-01,-2,0,0,0,0,-2
Algeria,2005-04-01,0,0,0,0,0,0
Algeria,2005-04-01,-2,0,1,6,0,5
Algeria,2005-04-01,0,0,0,0,0,0
Algeria,2005-04-01,19,0,0,24,0,43
Algeria,2005-04-01,5,0,0,24,0,29
Algeria,2005-04-01,2,0,0,6,0,8
Algeria,2005-04-01,0,0,0,0,0,0
Algeria,2005-04-01,1,0,0,3,0,4
Algeria,2005-04-01,1,0,0,3,0,4
Algeria,2005-04-01,3,0,0,0,0,3
Algeria,2005-04-01,0,0,0,0,0,0
Algeria,2005-04-01,4,0,0,6,0,10
Algeria,2005-04-01,3,0,0,9,0,12
Algeria,2005-04-01,0,0,0,0,0,0
Algeria,2005-04-01,0,0,0,0,0,0
Algeria,2005-04-01,0,0,0,12,0,12
Algeria,2005-04-01,0,0,0,0,0,0
Algeria,2005-04-01,0,0,0,3,2,5
Algeria,2005-04-01,-5,0,0,3,0,-2
Algeria,2005-04-01,0,0,0,0,0,0
Algeria,2005-05-01,1,0,-4,0,0,-3
Algeria,2005-05-01,0,0,0,0,0,0
Algeria,2005-05-01,7,0,0,6,0,13
Algeria,2005-05-01,0,0,0,0,0,0
Algeria,2005-05-01,1,0,0,0,0,1
Algeria,2005-05-01,0,0,0,0,0,0
Algeria,2005-05-01,4,0,0,0,0,4
Algeria,2005-05-01,-1,0,0,0,0,-1
Algeria,2005-05-01,6,0,0,0,0,6
Algeria,2005-05-01,0,0,0,0,0,0
Algeria,2005-05-01,0,0,0,0,0,0
Algeria,2005-05-01,0,0,0,0,0,0
Algeria,2005-05-01,-6,0,0,6,0,0
Algeria,2005-05-01,3,0,0,18,0,21
Algeria,2005-05-01,3,0,0,0,0,3
Algeria,2005-05-01,3,0,0,3,0,6
Algeria,2005-05-01,2,0,0,0,1,3
Algeria,2005-05-01,-5,0,-1,0,3,-3
Algeria,2005-05-01,-5,0,0,0,0,-5
Algeria,2005-05-01,12,0,0,0,2,14
Algeria,2005-05-01,6,0,0,-2,4,8
Algeria,2005-05-01,-2,0,0,0,0,-2
Algeria,2005-05-01,0,0,0,0,0,0
Algeria,2005-05-01,0,0,0,0,0,0
Algeria,2005-05-01,0,0,0,1,0,1
Algeria,2005-05-01,9,0,0,0,2,11
Algeria,2005-06-01,3,0,0,0,0,3
Algeria,2005-06-01,0,0,0,0,0,0
Algeria,2005-06-01,3,0,0,0,0,3
Algeria,2005-06-01,0,0,0,9,0,9
Algeria,2005-06-01,30,0,0,21,3,54
Algeria,2005-06-01,2,0,0,-2,0,0
Algeria,2005-06-01,7,0,0,6,0,13
Algeria,2005-06-01,1,0,0,5,0,6
Algeria,2005-06-01,3,0,0,0,0,3
Algeria,2005-06-01,7,0,0,0,0,7
Algeria,2005-06-01,0,0,0,0,0,0
Algeria,2005-06-01,0,0,0,1,0,1
Algeria,2005-06-01,0,0,0,0,0,0
Algeria,2005-06-01,1,0,1,21,0,23
Algeria,2005-06-01,0,0,0,0,0,0
Algeria,2005-06-01,17,0,0,9,0,26
Algeria,2005-06-01,0,0,0,0,0,0
Algeria,2005-06-01,9,0,0,0,0,9
Algeria,2005-06-01,9,0,0,6,0,15
Algeria,2005-06-01,0,0,0,0,0,0
Algeria,2005-06-01,4,0,0,0,0,4
Algeria,2005-06-01,6,0,0,0,0,6
Algeria,2005-06-01,0,0,0,0,0,0
Algeria,2005-06-01,0,0,0,6,2,8
Algeria,2005-06-01,0,0,0,0,0,0
Algeria,2005-06-01,0,0,0,0,0,0
Algeria,2005-06-01,-1,0,0,15,0,14
Algeria,2005-06-01,0,0,0,0,0,0
Algeria,2005-06-01,7,0,0,6,0,13
Algeria,2005-07-01,0,0,0,0,2,2
Algeria,2005-07-01,3,0,0,3,0,6
Algeria,2005-07-01,3,0,0,0,0,3
Algeria,2005-07-01,3,0,0,-9,0,-6
Algeria,2005-07-01,4,0,0,3,1,8
Algeria,2005-07-01,0,0,0,0,0,0
Algeria,2005-07-01,1,0,0,0,6,7
Algeria,2005-07-01,0,0,0,0,0,0
Algeria,2005-07-01,9,0,0,0,0,9
Algeria,2005-07-01,8,0,0,3,1,12
Algeria,2005-07-01,2,0,0,0,2,4
Algeria,2005-07-01,0,0,0,0,0,0
Algeria,2005-07-01,3,0,0,6,0,9
Algeria,2005-07-01,6,0,0,0,0,6
Algeria,2005-07-01,0,0,0,0,0,0
Algeria,2005-07-01,4,0,0,0,0,4
Algeria,2005-07-01,0,0,0,0,0,0
Algeria,2005-07-01,0,0,0,3,0,3
Algeria,2005-07-01,6,0,0,6,1,13
Algeria,2005-07-01,0,0,0,0,0,0
Algeria,2005-07-01,1,0,0,39,9,49
Algeria,2005-07-01,4,0,0,9,0,13
Algeria,2005-07-01,3,0,0,14,2,19
Algeria,2005-07-01,0,0,0,0,0,0
Algeria,2005-07-01,2,0,0,19,0,21
Algeria,2005-07-01,6,0,-1,14,0,19
Algeria,2005-07-01,37,0,0,44,1,82
Algeria,2005-07-01,15,0,0,6,1,22
Algeria,2005-07-01,18,0,0,3,2,23
Algeria,2005-07-01,3,0,0,6,1,10
Algeria,2005-07-01,6,0,0,18,0,24
Algeria,2005-08-01,1,0,0,3,0,4
Algeria,2005-08-01,0,0,0,3,0,3
Algeria,2005-08-01,31,0,0,33,0,64
Algeria,2005-08-01,0,0,0,6,0,6
Algeria,2005-08-01,0,0,0,5,0,5
Algeria,2005-08-01,4,0,0,0,0,4
Algeria,2005-08-01,0,0,0,1,0,1
Algeria,2005-08-01,0,0,0,0,0,0
Algeria,2005-08-01,9,0,0,0,3,12
Algeria,2005-08-01,-1,0,0,0,0,-1
Algeria,2005-08-01,6,0,0,3,3,12
Algeria,2005-08-01,4,0,0,3,0,7
Algeria,2005-08-01,1,0,0,3,3,7
Algeria,2005-08-01,6,0,0,0,0,6
Algeria,2005-08-01,0,0,0,0,0,0
Algeria,2005-08-01,0,0,0,3,0,3
Algeria,2005-08-01,6,0,0,-1,0,5
Algeria,2005-08-01,1,0,0,-4,0,-3
Algeria,2005-08-01,1,0,0,0,2,3
Algeria,2005-08-01,0,0,0,0,0,0
Algeria,2005-08-01,0,0,0,21,0,21
Algeria,2005-08-01,0,0,0,2,0,2
Algeria,2005-08-01,1,0,0,-2,0,-1
Algeria,2005-08-01,5,0,0,0,2,7
Algeria,2005-08-01,0,0,0,3,0,3
Algeria,2005-08-01,0,0,0,9,0,9
Algeria,2005-08-01,0,0,0,0,0,0
Algeria,2005-08-01,0,0,0,3,0,3
Algeria,2005-08-01,8,0,0,0,0,8
Algeria,2005-08-01,4,0,0,0,0,4
Algeria,2005-09-01,0,0,0,0,1,1
Algeria,2005-09-01,3,0,0,0,0,3
Algeria,2005-09-01,0,0,0,0,0,0
Algeria,2005-09-01,0,0,0,0,0,0
Algeria,2005-09-01,0,0,0,0,2,2
Algeria,2005-09-01,12,0,0,15,0,27
Algeria,2005-09-01,9,0,0,1,1,11
Algeria,2005-09-01,0,0,0,0,0,0
Algeria,2005-09-01,3,0,0,0,0,3
Algeria,2005-09-01,2,2,0,-2,1,3
Algeria,2005-09-01,2,0,0,4,0,6
Algeria,2005-09-01,4,0,0,12,0,16
Algeria,2005-09-01,-3,0,-2,15,2,12
Algeria,2005-09-01,7,0,0,3,2,12
Algeria,2005-09-01,0,0,0,0,0,0
Algeria,2005-09-01,0,0,0,0,0,0
Algeria,2005-09-01,7,0,0,1,0,8
Algeria,2005-09-01,4,0,0,6,0,10
Algeria,2005-09-01,3,0,0,0,0,3
Algeria,2005-09-01,0,0,0,12,0,12
Algeria,2005-09-01,22,0,0,0,0,22
Algeria,2005-09-01,4,0,0,0,0,4
Algeria,2005-09-01,0,0,0,0,0,0
Algeria,2005-09-01,36,0,0,36,0,72
Algeria,2005-09-01,1,0,0,9,2,12
Algeria,2005-09-01,4,0,0,6,0,10
Algeria,2005-09-01,8,0,0,0,2,10
Algeria,2005-09-01,3,0,0,0,2,5
Algeria,2005-10-01,4,0,0,3,0,7
Algeria,2005-10-01,11,0,0,0,2,13
Algeria,2005-10-01,12,0,0,0,0,12
Algeria,2005-10-01,0,0,0,0,0,0
Algeria,2005-10-01,2,0,0,3,0,5
Algeria,2005-10-01,0,0,0,0,2,2
Algeria,2005-10-01,0,0,0,0,0,0
Algeria,2005-10-01,4,0,0,0,0,4
Algeria,2005-10-01,2,0,0,0,1,3
Algeria,2005-10-01,2,0,0,12,0,14
Algeria,2005-10-01,0,0,0,0,0,0
Algeria,2005-10-01,7,0,0,0,0,7
Algeria,2005-10-01,3,0,0,9,0,12
Algeria,2005-10-01,-2,0,0,3,0,1
Algeria,2005-10-01,17,0,0,0,2,19
Algeria,2005-10-01,2,0,0,0,0,2
Algeria,2005-10-01,0,0,0,0,0,0
Algeria,2005-10-01,0,0,0,0,0,0
Algeria,2005-10-01,6,0,0,-4,0,2
Algeria,2005-10-01,5,0,0,0,0,5
Algeria,2005-10-01,0,0,0,-2,0,-2
Algeria,2005-10-01,0,0,0,0,0,0
Algeria,2005-10-01,11,0,0,3,0,14
Algeria,2005-10-01,0,0,0,0,0,0
Algeria,2005-10-01,0,0,0,0,0,0
Algeria,2005-10-01,2,0,0,12,0,14
Algeria,2005-10-01,0,0,0,3,2,5
Algeria,2005-10-01,6,0,0,6,0,12
Algeria,2005-10-01,6,0,0,0,0,6
Algeria,2005-10-01,5,0,0,3,0,8
Algeria,2005-10-01,6,0,0,-3,0,3
Algeria,2005-11-01,12,0,0,0,0,12
Algeria,2005-11-01,2,0,0,3,0,5
Algeria,2005-11-01,6,0,0,0,0,6
Algeria,2005-11-01,4,0,0,12,0,16
Algeria,2005-11-01,2,0,0,9,0,11
Algeria,2005-11-01,0,0,0,0,0,0
Algeria,2005-11-01,6,0,0,3,0,9
Algeria,2005-11-01,5,0,0,18,2,25
Algeria,2005-11-01,18,0,0,3,9,30
Algeria,2005-11-01,3,0,0,0,0,3
Algeria,2005-11-01,18,0,0,3,6,27
Algeria,2005-11-01,2,0,0,3,0,5
Algeria,2005-11-01,0,0,0,0,0,0
Algeria,2005-11-01,-3,0,0,6,0,3
Algeria,2005-11-01,0,0,0,0,0,0
Algeria,2005-11-01,-1,0,0,0,0,-1
Algeria,2005-11-01,40,0,0,18,1,59
Algeria,2005-11-01,2,0,0,15,0,17
Algeria,2005-11-01,0,0,0,0,0,0
Algeria,2005-11-01,0,0,0,0,0,0
Algeria,2005-11-01,0,0,0,0,0,0
Algeria,2005-11-01,0,0,0,0,0,0
Algeria,2005-11-01,0,0,0,0,0,0
Algeria,2005-11-01,8,0,0,31,1,40
Algeria,2005-11-01,0,0,0,0,0,0
Algeria,2005-11-01,0,0,0,0,0,0
Algeria,2005-11-01,3,0,0,0,0,3
Algeria,2005-11-01,10,0,0,0,4,14
Algeria,2005-11-01,10,0,2,3,6,21
Algeria,2005-11-01,0,0,0,15,2,17
Algeria,2005-12-01,3,0,0,9,0,12
Algeria,2005-12-01,12,0,0,0,0,12
Algeria,2005-12-01,3,0,0,0,0,3
Algeria,2005-12-01,0,0,0,0,0,0
Algeria,2005-12-01,0,0,0,3,0,3
Algeria,2005-12-01,0,0,0,0,0,0
Algeria,2005-12-01,0,0,0,6,0,6
Algeria,2005-12-01,-1,0,0,9,0,8
Algeria,2005-12-01,1,0,0,0,0,1
Algeria,2005-12-01,0,0,0,0,0,0
Algeria,2005-12-01,2,0,0,2,0,4
Algeria,2005-12-01,0,0,0,36,3,39
Algeria,2005-12-01,6,0,0,29,0,35
Algeria,2005-12-01,6,0,0,0,0,6
Algeria,2005-12-01,20,0,0,13,0,33
Algeria,2005-12-01,0,0,0,3,0,3
Algeria,2005-12-01,5,0,0,0,0,5
Algeria,2005-12-01,13,0,0,12,0,25
Algeria,2005-12-01,0,0,0,0,0,0
Algeria,2005-12-01,2,2,1,-2,0,3
Algeria,2005-12-01,-1,0,1,12,0,12
Algeria,2005-12-01,4,0,0,0,4,8
Algeria,2005-12-01,0,0,0,0,0,0
Algeria,2005-12-01,0,0,0,-2,0,-2
Algeria,2005-12-01,2,0,0,0,1,3
Algeria,2005-12-01,0,0,0,3,0,3
Algeria,2005-12-01,0,0,0,3,0,3
Algeria,2005-12-01,2,0,0,6,0,8
Algeria,2005-12-01,2,0,0,0,0,2
Bangladesh,2005-01-01,7,0,0,0,0,7
Bangladesh,2005-01-01,6,0,0,0,0,6
Bangladesh,2005-01-01,0,0,0,0,0,0
Bangladesh,2005-01-01,0,0,0,3,0,3
Bangladesh,2005-01-01,12,0,0,0,0,12
Bangladesh,2005-01-01,0,0,0,0,0,0
Bangladesh,2005-01-01,0,0,0,0,0,0
Bangladesh,2005-01-01,-1,0,0,0,0,-1
Bangladesh,2005-01-01,-1,0,0,0,0,-1
Bangladesh,2005-01-01,6,0,0,0,2,8
Bangladesh,2005-01-01,6,0,0,0,0,6
Bangladesh,2005-01-01,0,0,0,0,0,0
Bangladesh,2005-01-01,0,0,0,6,0,6
Bangladesh,2005-01-01,0,0,0,0,0,0
Bangladesh,2005-01-01,3,0,0,0,0,3
Bangladesh,2005-01-01,0,0,0,0,0,0
Bangladesh,2005-01-01,1,0,0,3,0,4
Bangladesh,2005-01-01,0,0,0,0,0,0
Bangladesh,2005-01-01,0,0,0,0,1,1
Bangladesh,2005-01-01,3,0,0,0,2,5
Bangladesh,2005-01-01,2,0,0,3,0,5
Bangladesh,2005-01-01,0,0,0,-2,0,-2
Bangladesh,2005-01-01,4,0,0,6,0,10
Bangladesh,2005-01-01,2,0,0,0,4,6
Bangladesh,2005-01-01,0,0,0,0,0,0
Bangladesh,2005-01-01,0,0,0,0,0,0
Bangladesh,2005-01-01,9,0,1,0,0,10
Bangladesh,2005-02-01,0,0,0,0,0,0
Bangladesh,2005-02-01,-1,0,0,0,0,-1
Bangladesh,2005-02-01,3,0,0,0,0,3
Bangladesh,2005-02-01,3,0,0,0,1,4
Bangladesh,2005-02-01,6,0,0,0,0,6
Bangladesh,2005-02-01,2,0,0,15,0,17
Bangladesh,2005-02-01,0,0,0,6,0,6
Bangladesh,2005-02-01,4,0,0,0,0,4
Bangladesh,2005-02-01,3,0,0,0,0,3
Bangladesh,2005-02-01,2,0,0,3,0,5
Bangladesh,2005-02-01,0,0,0,0,0,0
Bangladesh,2005-02-01,0,0,0,0,0,0
Bangladesh,2005-02-01,2,0,0,0,0,2
Bangladesh,2005-02-01,1,0,0,3,0,4
Bangladesh,2005-02-01,0,0,0,-2,0,-2
Bangladesh,2005-02-01,11,0,0,0,0,11
Bangladesh,2005-02-01,6,0,0,0,0,6
Bangladesh,2005-02-01,0,0,0,3,0,3
Bangladesh,2005-02-01,3,0,0,0,0,3
Bangladesh,2005-02-01,9,0,0,3,0,12
Bangladesh,2005-02-01,0,0,0,-4,0,-4
Bangladesh,2005-02-01,9,0,0,0,0,9
Bangladesh,2005-02-01,0,0,0,0,2,2
Bangladesh,2005-02-01,3,0,0,3,4,10
Bangladesh,2005-02-01,6,0,0,12,6,24
Bangladesh,2005-02-01,15,0,0,0,3,18
Bangladesh,2005-02-01,30,0,0,4,8,42
Bangladesh,2005-03-01,12,0,0,6,0,18
Bangladesh,2005-03-01,26,0,-1,11,6,42
Bangladesh,2005-03-01,22,0,0,0,7,29
Bangladesh,2005-03-01,9,0,0,0,2,11
Bangladesh,2005-03-01,-1,0,0,0,0,-1
Bangladesh,2005-03-01,3,0,0,0,0,3
Bangladesh,2005-03-01,6,0,0,0,6,12
Bangladesh,2005-03-01,0,0,0,0,1,1
Bangladesh,2005-03-01,2,0,0,0,0,2
Bangladesh,2005-03-01,4,0,0,0,0,4
Bangladesh,2005-03-01,6,0,0,3,2,11
Bangladesh,2005-03-01,3,0,0,0,0,3
Bangladesh,2005-03-01,3,0,0,3,1,7
Bangladesh,2005-03-01,5,0,-6,-2,2,-1
Bangladesh,2005-03-01,0,0,0,0,0,0
Bangladesh,2005-03-01,0,0,0,0,0,0
Bangladesh,2005-03-01,3,0,0,24,2,29
Bangladesh,2005-03-01,2,0,0,0,1,3
Bangladesh,2005-03-01,3,0,0,15,0,18
Bangladesh,2005-03-01,10,0,0,9,0,19
Bangladesh,2005-03-01,3,0,0,0,6,9
Bangladesh,2005-03-01,3,0,0,0,0,3
Bangladesh,2005-03-01,1,0,0,0,0,1
Bangladesh,2005-03-01,21,0,0,12,2,35
Bangladesh,2005-03-01,11,0,0,0,2,13
Bangladesh,2005-03-01,6,0,0,0,0,6
Bangladesh,2005-03-01,6,0,0,4,0,10
Bangladesh,2005-03-01,0,0,0,6,0,6
Bangladesh,2005-04-01,3,0,0,0,2,5
Bangladesh,2005-04-01,0,0,0,0,0,0
Bangladesh,2005-04-01,0,0,0,0,0,0
Bangladesh,2005-04-01,0,0,0,0,0,0
Bangladesh,2005-04-01,4,0,0,0,0,4
Bangladesh,2005-04-01,3,0,0,0,0,3
Bangladesh,2005-04-01,1,0,0,0,1,2
Bangladesh,2005-04-01,2,0,0,0,0,2
Bangladesh,2005-04-01,0,0,0,0,0,0
Bangladesh,2005-04-01,27,0,0,15,0,42
Bangladesh,2005-04-01,0,0,0,0,0,0
Bangladesh,2005-04-01,0,0,0,0,0,0
Bangladesh,2005-04-01,3,0,0,1,0,4
Bangladesh,2005-04-01,9,0,0,3,0,12
Bangladesh,2005-04-01,5,0,0,11,0,16
Bangladesh,2005-04-01,0,0,0,0,0,0
Bangladesh,2005-04-01,6,0,0,0,0,6
Bangladesh,2005-04-01,0,0,0,0,0,0
Bangladesh,2005-04-01,7,0,0,3,2,12
Bangladesh,2005-04-01,2,0,0,0,0,2
Bangladesh,2005-04-01,1,0,0,0,4,5
Bangladesh,2005-04-01,3,0,0,0,4,7
Bangladesh,2005-04-01,-3,0,0,3,0,0
Bangladesh,2005-04-01,0,0,0,0,6,6
Bangladesh,2005-04-01,0,0,0,0,1,1
Bangladesh,2005-04-01,1,0,0,3,0,4
Bangladesh,2005-05-01,1,0,0,3,0,4
Bangladesh,2005-05-01,3,0,0,3,0,6
Bangladesh,2005-05-01,5,0,0,0,0,5
Bangladesh,2005-05-01,3,0,0,0,0,3
Bangladesh,2005-05-01,13,0,0,6,0,19
Bangladesh,2005-05-01,6,0,1,0,0,7
Bangladesh,2005-05-01,0,0,0,3,0,3
Bangladesh,2005-05-01,0,0,0,6,0,6
Bangladesh,2005-05-01,0,0,0,0,0,0
Bangladesh,2005-05-01,1,0,0,0,0,1
Bangladesh,2005-05-01,0,0,0,3,0,3
Bangladesh,2005-05-01,6,0,0,3,4,13
Bangladesh,2005-05-01,2,0,0,0,4,6
Bangladesh,2005-05-01,7,0,0,6,0,13
Bangladesh,2005-05-01,8,0,1,3,0,12
Bangladesh,2005-05-01,0,0,0,-2,1,-1
Bangladesh,2005-05-01,0,0,0,3,0,3
Bangladesh,2005-05-01,1,0,0,0,0,1
Bangladesh,2005-05-01,0,0,0,18,0,18
Bangladesh,2005-05-01,0,0,0,0,0,0
Bangladesh,2005-05-01,0,0,0,0,1,1
Bangladesh,2005-05-01,16,0,0,6,2,24
Bangladesh,2005-05-01,1,0,0,6,0,7
Bangladesh,2005-05-01,0,0,0,4,0,4
Bangladesh,2005-05-01,2,0,0,1,1,4
Bangladesh,2005-05-01,0,0,0,0,0,0
Bangladesh,2005-05-01,3,0,0,0,0,3
Bangladesh,2005-05-01,0,0,0,3,0,3
Bangladesh,2005-05-01,6,0,0,3,0,9
Bangladesh,2005-05-01,0,0,0,2,0,2
Bangladesh,2005-06-01,0,0,0,3,0,3
Bangladesh,2005-06-01,1,0,0,0,0,1
Bangladesh,2005-06-01,6,0,0,3,0,9
Bangladesh,2005-06-01,3,0,0,0,0,3
Bangladesh,2005-06-01,-1,0,0,0,0,-1
Bangladesh,2005-06-01,2,0,0,3,0,5
Bangladesh,2005-06-01,0,0,0,0,0,0
Bangladesh,2005-06-01,0,0,0,6,0,6
Bangladesh,2005-06-01,0,0,0,0,0,0
Bangladesh,2005-06-01,11,0,0,3,0,14
Bangladesh,2005-06-01,0,0,0,0,0,0
Bangladesh,2005-06-01,0,0,0,0,1,1
Bangladesh,2005-06-01,3,0,0,0,0,3
Bangladesh,2005-06-01,0,0,0,0,0,0
Bangladesh,2005-06-01,0,0,0,0,0,0
Bangladesh,2005-06-01,1,0,0,0,0,1
Bangladesh,2005-06-01,2,0,0,-4,0,-2
Bangladesh,2005-06-01,0,0,0,0,0,0
Bangladesh,2005-06-01,3,0,0,0,2,5
Bangladesh,2005-06-01,2,0,0,0,0,2
Bangladesh,2005-07-01,3,0,0,3,0,6
Bangladesh,2005-07-01,0,0,0,0,0,0
Bangladesh,2005-07-01,2,0,0,0,0,2
Bangladesh,2005-07-01,0,0,0,-2,0,-2
Bangladesh,2005-07-01,-3,0,0,0,0,-3
Bangladesh,2005-07-01,0,0,0,0,0,0
Bangladesh,2005-07-01,4,0,0,0,0,4
Bangladesh,2005-07-01,3,0,0,0,0,3
Bangladesh,2005-07-01,4,0,0,0,0,4
Bangladesh,2005-07-01,13,0,0,0,0,13
Bangladesh,2005-07-01,3,0,0,0,0,3
Bangladesh,2005-07-01,1,0,0,3,0,4
Bangladesh,2005-07-01,3,0,-1,0,0,2
Bangladesh,2005-07-01,3,0,0,0,0,3
Bangladesh,2005-07-01,0,0,0,0,0,0
Bangladesh,2005-07-01,3,0,0,0,0,3
Bangladesh,2005-07-01,3,0,0,3,0,6
Bangladesh,2005-07-01,5,0,0,0,0,5
Bangladesh,2005-07-01,0,0,0,0,0,0
Bangladesh,2005-07-01,0,0,0,0,0,0
Bangladesh,2005-07-01,0,0,0,0,1,1
Bangladesh,2005-07-01,3,0,0,0,0,3
Bangladesh,2005-07-01,3,0,0,0,0,3
Bangladesh,2005-07-01,0,0,0,0,0,0
Bangladesh,2005-07-01,0,0,0,0,1,1
Bangladesh,2005-07-01,0,0,0,0,0,0
Bangladesh,2005-07-01,0,0,0,0,0,0
Bangladesh,2005-07-01,0,0,0,6,0,6
Bangladesh,2005-08-01,0,0,-1,3,0,2
Bangladesh,2005-08-01,0,0,0,0,0,0
Bangladesh,2005-08-01,3,0,0,0,0,3
Bangladesh,2005-08-01,0,0,0,0,0,0
Bangladesh,2005-08-01,2,0,0,0,0,2
Bangladesh,2005-08-01,0,0,0,0,0,0
Bangladesh,2005-08-01,3,0,0,6,0,9
Bangladesh,2005-08-01,0,0,0,0,0,0
Bangladesh,2005-08-01,0,0,0,0,0,0
Bangladesh,2005-08-01,0,0,0,0,0,0
Bangladesh,2005-08-01,0,0,0,0,0,0
Bangladesh,2005-08-01,10,0,0,9,8,27
Bangladesh,2005-08-01,0,0,0,6,1,7
Bangladesh,2005-08-01,8,0,0,3,0,11
Bangladesh,2005-08-01,0,0,0,0,0,0
Bangladesh,2005-08-01,9,0,0,0,0,9
Bangladesh,2005-08-01,0,0,0,0,0,0
Bangladesh,2005-08-01,1,0,0,6,0,7
Bangladesh,2005-08-01,0,0,0,0,0,0
Bangladesh,2005-08-01,5,0,0,12,0,17
Bangladesh,2005-08-01,0,0,0,6,0,6
Bangladesh,2005-08-01,0,0,0,3,0,3
Bangladesh,2005-08-01,0,0,0,0,0,0
Bangladesh,2005-08-01,3,0,0,0,0,3
Bangladesh,2005-08-01,0,0,0,3,0,3
Bangladesh,2005-09-01,0,0,0,0,0,0
Bangladesh,2005-09-01,0,0,0,0,0,0
Bangladesh,2005-09-01,0,0,0,0,0,0
Bangladesh,2005-09-01,0,0,0,0,0,0
Bangladesh,2005-09-01,2,0,0,0,0,2
Bangladesh,2005-09-01,4,0,0,0,0,4
Bangladesh,2005-09-01,1,0,0,6,0,7
Bangladesh,2005-09-01,0,0,0,0,1,1
Bangladesh,2005-09-01,0,0,0,0,0,0
Bangladesh,2005-09-01,0,0,0,0,0,0
Bangladesh,2005-09-01,2,0,0,9,2,13
Bangladesh,2005-09-01,0,0,0,0,0,0
Bangladesh,2005-09-01,0,0,0,0,0,0
Bangladesh,2005-09-01,0,0,0,0,0,0
Bangladesh,2005-09-01,0,0,0,0,0,0
Bangladesh,2005-09-01,0,0,0,0,0,0
Bangladesh,2005-09-01,1,0,0,3,0,4
Bangladesh,2005-09-01,1,0,0,0,0,1
Bangladesh,2005-09-01,0,0,0,0,0,0
Bangladesh,2005-09-01,0,0,0,0,0,0
Bangladesh,2005-09-01,-2,0,0,3,1,2
Bangladesh,2005-09-01,0,0,0,0,2,2
Bangladesh,2005-09-01,1,0,0,0,4,5
Bangladesh,2005-09-01,0,2,-6,0,6,2
Bangladesh,2005-09-01,3,0,0,3,1,7
Bangladesh,2005-10-01,6,0,0,0,0,6
Bangladesh,2005-10-01,3,0,0,0,0,3
Bangladesh,2005-10-01,0,0,0,3,0,3
Bangladesh,2005-10-01,1,0,0,0,0,1
Bangladesh,2005-10-01,0,0,0,0,0,0
Bangladesh,2005-10-01,0,0,0,0,4,4
Bangladesh,2005-10-01,7,0,0,12,2,21
Bangladesh,2005-10-01,19,2,0,-2,0,19
Bangladesh,2005-10-01,12,2,0,0,0,14
Bangladesh,2005-10-01,0,0,0,0,0,0
Bangladesh,2005-10-01,0,0,0,0,0,0
Bangladesh,2005-10-01,0,0,0,0,0,0
Bangladesh,2005-10-01,2,0,0,0,0,2
Bangladesh,2005-10-01,11,0,0,3,0,14
Bangladesh,2005-10-01,24,0,0,3,11,38
Bangladesh,2005-10-01,5,0,0,0,3,8
Bangladesh,2005-10-01,2,0,0,0,0,2
Bangladesh,2005-10-01,7,0,0,3,0,10
Bangladesh,2005-10-01,2,0,0,0,0,2
Bangladesh,2005-10-01,4,0,0,0,0,4
Bangladesh,2005-10-01,0,0,0,0,0,0
Bangladesh,2005-10-01,9,0,0,9,0,18
Bangladesh,2005-10-01,5,0,0,0,0,5
Bangladesh,2005-10-01,0,0,0,0,0,0
Bangladesh,2005-10-01,4,0,0,5,1,10
Bangladesh,2005-10-01,0,0,0,0,0,0
Bangladesh,2005-10-01,0,0,0,3,0,3
Bangladesh,2005-11-01,0,0,0,3,0,3
Bangladesh,2005-11-01,0,0,0,3,0,3
Bangladesh,2005-11-01,0,0,0,3,0,3
Bangladesh,2005-11-01,0,0,0,0,0,0
Bangladesh,2005-11-01,0,0,0,0,1,1
Bangladesh,2005-11-01,0,0,0,0,0,0
Bangladesh,2005-11-01,0,0,0,0,0,0
Bangladesh,2005-11-01,0,0,-2,0,0,-2
Bangladesh,2005-11-01,2,0,0,0,0,2
Bangladesh,2005-11-01,0,0,0,0,0,0
Bangladesh,2005-11-01,21,0,0,0,12,33
Bangladesh,2005-11-01,0,0,0,0,0,0
Bangladesh,2005-11-01,2,0,0,0,0,2
Bangladesh,2005-11-01,3,0,-2,0,1,2
Bangladesh,2005-11-01,0,0,0,0,0,0
Bangladesh,2005-11-01,3,0,0,0,0,3
Bangladesh,2005-11-01,0,0,0,0,0,0
Bangladesh,2005-11-01,3,0,0,0,0,3
Bangladesh,2005-11-01,0,0,0,0,0,0
Bangladesh,2005-11-01,2,0,0,0,0,2
Bangladesh,2005-11-01,5,0,-1,0,0,4
Bangladesh,2005-11-01,5,0,0,9,0,14
Bangladesh,2005-11-01,0,0,0,0,0,0
Bangladesh,2005-11-01,0,0,0,0,0,0
Bangladesh,2005-11-01,0,0,0,0,0,0
Bangladesh,2005-11-01,3,0,-4,0,3,2
Bangladesh,2005-11-01,6,0,0,0,0,6
Bangladesh,2005-12-01,4,0,0,0,0,4
Bangladesh,2005-12-01,0,0,0,0,0,0
Bangladesh,2005-12-01,0,0,0,0,1,1
Bangladesh,2005-12-01,4,0,0,3,0,7
Bangladesh,2005-12-01,-1,0,-2,0,0,-3
Bangladesh,2005-12-01,0,0,0,9,0,9
Bangladesh,2005-12-01,0,0,0,0,0,0
Bangladesh,2005-12-01,23,0,0,6,3,32
Bangladesh,2005-12-01,0,0,0,9,0,9
Bangladesh,2005-12-01,0,0,0,0,0,0
Bangladesh,2005-12-01,6,0,0,15,0,21
Bangladesh,2005-12-01,5,0,0,15,0,20
Bangladesh,2005-12-01,4,0,0,1,0,5
Bangladesh,2005-12-01,8,0,0,9,0,17
Bangladesh,2005-12-01,2,0,0,0,1,3
Bangladesh,2005-12-01,1,0,0,3,0,4
Bangladesh,2005-12-01,2,0,0,0,0,2
Bangladesh,2005-12-01,4,0,0,9,3,16
Bangladesh,2005-12-01,11,0,0,9,0,20
Bangladesh,2005-12-01,0,0,0,0,0,0
Bangladesh,2005-12-01,6,0,-1,12,0,17
Bangladesh,2005-12-01,0,0,0,0,0,0
Bangladesh,2005-12-01,1,0,0,0,0,1
Bangladesh,2005-12-01,0,0,0,-2,0,-2
Bangladesh,2005-12-01,5,0,0,4,2,11
Bangladesh,2005-12-01,2,0,0,0,3,5
Bangladesh,2005-12-01,4,0,0,0,2,6
Bangladesh,2005-12-01,-1,0,0,-2,0,-3
Bangladesh,2005-12-01,0,0,0,0,0,0
Cameroon,2005-01-01,1,0,0,0,0,1
Cameroon,2005-01-01,0,0,0,0,0,0
Cameroon,2005-01-01,0,0,0,0,0,0
Cameroon,2005-01-01,0,0,0,0,0,0
Cameroon,2005-01-01,0,0,0,0,0,0
Cameroon,2005-01-01,0,0,0,0,0,0
Cameroon,2005-01-01,0,0,0,0,0,0
Cameroon,2005-01-01,0,0,0,0,0,0
Cameroon,2005-01-01,0,0,0,0,0,0
Cameroon,2005-01-01,0,0,0,0,0,0
Cameroon,2005-01-01,0,0,0,0,0,0
Cameroon,2005-01-01,0,0,0,0,0,0
Cameroon,2005-01-01,0,0,0,0,0,0
Cameroon,2005-01-01,0,0,0,0,0,0
Cameroon,2005-01-01,0,0,0,0,0,0
Cameroon,2005-01-01,0,0,0,0,0,0
Cameroon,2005-01-01,0,0,0,0,0,0
Cameroon,2005-01-01,0,0,0,0,0,0
Cameroon,2005-02-01,1,0,0,0,0,1
Cameroon,2005-02-01,0,0,0,0,0,0
Cameroon,2005-02-01,0,0,0,0,0,0
Cameroon,2005-02-01,0,0,0,0,0,0
Cameroon,2005-02-01,5,0,0,0,0,5
Cameroon,2005-02-01,2,0,0,3,0,5
Cameroon,2005-02-01,0,0,0,3,0,3
Cameroon,2005-02-01,0,0,0,0,0,0
Cameroon,2005-02-01,7,0,0,0,0,7
Cameroon,2005-02-01,0,0,0,0,0,0
Cameroon,2005-02-01,0,0,0,0,0,0
Cameroon,2005-02-01,0,0,0,0,0,0
Cameroon,2005-02-01,19,0,0,0,0,19
Cameroon,2005-02-01,1,0,0,15,1,17
Cameroon,2005-02-01,0,0,0,0,0,0
Cameroon,2005-02-01,0,0,0,0,0,0
Cameroon,2005-02-01,2,0,0,0,0,2
Cameroon,2005-02-01,0,0,0,0,0,0
Cameroon,2005-02-01,0,0,0,0,0,0
Cameroon,2005-02-01,-1,0,0,3,0,2
Cameroon,2005-03-01,1,0,0,0,0,1
Cameroon,2005-03-01,4,0,0,3,0,7
Cameroon,2005-03-01,3,0,0,0,0,3
Cameroon,2005-03-01,0,0,0,0,0,0
Cameroon,2005-03-01,0,0,0,0,0,0
Cameroon,2005-03-01,0,0,0,0,0,0
Cameroon,2005-03-01,3,0,0,3,0,6
Cameroon,2005-03-01,4,0,0,0,0,4
Cameroon,2005-03-01,0,0,0,0,0,0
Cameroon,2005-03-01,0,0,0,6,0,6
Cameroon,2005-03-01,9,0,1,4,0,14
Cameroon,2005-03-01,0,0,0,0,0,0
Cameroon,2005-03-01,0,0,0,6,0,6
Cameroon,2005-03-01,0,0,0,0,0,0
Cameroon,2005-03-01,4,0,0,0,0,4
Cameroon,2005-03-01,11,0,0,0,0,11
Cameroon,2005-03-01,0,0,0,0,0,0
Cameroon,2005-03-01,0,0,0,0,0,0
Cameroon,2005-03-01,1,0,0,1,1,3
Cameroon,2005-03-01,3,0,0,0,0,3
Cameroon,2005-03-01,0,0,0,0,0,0
Cameroon,2005-03-01,4,0,0,0,0,4
Cameroon,2005-03-01,2,0,0,0,0,2
Cameroon,2005-04-01,0,0,0,3,0,3
Cameroon,2005-04-01,0,0,0,0,0,0
Cameroon,2005-04-01,0,0,0,0,0,0
Cameroon,2005-04-01,0,0,0,0,0,0
Cameroon,2005-04-01,8,0,0,0,0,8
Cameroon,2005-04-01,0,2,0,0,0,2
Cameroon,2005-04-01,-2,0,0,0,0,-2
Cameroon,2005-04-01,0,0,0,0,0,0
Cameroon,2005-04-01,0,0,0,0,0,0
Cameroon,2005-04-01,1,0,0,0,0,1
Cameroon,2005-04-01,1,0,0,0,0,1
Cameroon,2005-04-01,3,0,0,0,0,3
Cameroon,2005-04-01,2,0,0,0,0,2
Cameroon,2005-04-01,0,0,0,0,0,0
Cameroon,2005-04-01,1,0,0,0,0,1
Cameroon,2005-04-01,0,0,0,0,0,0
Cameroon,2005-04-01,0,0,0,0,0,0
Cameroon,2005-04-01,0,0,0,12,0,12
Cameroon,2005-04-01,9,0,-2,0,0,7
Cameroon,2005-04-01,0,0,0,0,0,0
Cameroon,2005-05-01,0,0,0,0,0,0
Cameroon,2005-05-01,1,0,0,0,0,1
Cameroon,2005-05-01,0,0,0,0,0,0
Cameroon,2005-05-01,3,0,0,0,1,4
Cameroon,2005-05-01,0,0,0,0,0,0
Cameroon,2005-05-01,1,0,0,3,0,4
Cameroon,2005-05-01,-3,0,0,0,0,-3
Cameroon,2005-05-01,0,0,0,3,0,3
Cameroon,2005-05-01,-1,0,0,0,0,-1
Cameroon,2005-05-01,2,0,0,0,0,2
Cameroon,2005-05-01,6,0,0,0,0,6
Cameroon,2005-05-01,0,0,0,3,0,3
Cameroon,2005-05-01,0,0,0,12,0,12
Cameroon,2005-05-01,0,0,0,1,0,1
Cameroon,2005-05-01,0,0,0,0,0,0
Cameroon,2005-05-01,0,0,0,0,0,0
Cameroon,2005-05-01,0,0,0,0,0,0
Cameroon,2005-05-01,2,0,0,0,0,2
Cameroon,2005-05-01,0,0,0,0,0,0
Cameroon,2005-05-01,0,0,0,0,0,0
Cameroon,2005-05-01,3,0,0,0,0,3
Cameroon,2005-06-01,2,0,0,0,0,2
Cameroon,2005-06-01,0,0,0,0,0,0
Cameroon,2005-06-01,6,0,0,3,0,9
Cameroon,2005-06-01,0,0,0,0,0,0
Cameroon,2005-06-01,2,0,0,0,0,2
Cameroon,2005-06-01,0,0,0,0,-1,-1
Cameroon,2005-06-01,2,0,0,2,0,4
Cameroon,2005-06-01,4,0,0,-2,0,2
Cameroon,2005-06-01,1,0,0,-2,0,-1
Cameroon,2005-06-01,0,0,0,0,0,0
Cameroon,2005-06-01,0,0,0,0,1,1
Cameroon,2005-06-01,0,0,0,-2,1,-1
Cameroon,2005-06-01,1,0,0,0,0,1
Cameroon,2005-06-01,0,0,0,0,0,0
Cameroon,2005-06-01,0,0,0,-2,0,-2
Cameroon,2005-06-01,0,0,0,0,0,0
Cameroon,2005-06-01,2,0,0,3,0,5
Cameroon,2005-06-01,8,0,0,0,0,8
Cameroon,2005-06-01,11,0,0,0,2,13
Cameroon,2005-06-01,1,2,0,0,0,3
Cameroon,2005-07-01,0,0,0,3,0,3
Cameroon,2005-07-01,0,0,0,0,0,0
Cameroon,2005-07-01,0,0,0,0,0,0
Cameroon,2005-07-01,0,0,0,0,0,0
Cameroon,2005-07-01,0,0,0,0,0,0
Cameroon,2005-07-01,1,0,0,0,0,1
Cameroon,2005-07-01,8,0,0,0,0,8
Cameroon,2005-07-01,0,0,0,0,0,0
Cameroon,2005-07-01,3,0,0,0,0,3
Cameroon,2005-07-01,0,0,0,0,0,0
Cameroon,2005-07-01,0,0,0,0,0,0
Cameroon,2005-07-01,2,0,0,0,0,2
Cameroon,2005-07-01,5,0,0,0,0,5
Cameroon,2005-07-01,8,0,0,0,0,8
Cameroon,2005-07-01,1,0,0,3,0,4
Cameroon,2005-07-01,0,0,0,0,0,0
Cameroon,2005-07-01,7,0,0,0,0,7
Cameroon,2005-07-01,-3,0,0,0,0,-3
Cameroon,2005-07-01,1,0,0,0,0,1
Cameroon,2005-07-01,4,0,0,3,0,7
Cameroon,2005-08-01,0,0,2,0,0,2
Cameroon,2005-08-01,0,0,0,0,0,0
Cameroon,2005-08-01,1,0,0,0,0,1
Cameroon,2005-08-01,0,0,0,6,0,6
Cameroon,2005-08-01,2,0,0,0,4,6
Cameroon,2005-08-01,0,0,0,0,0,0
Cameroon,2005-08-01,2,0,0,3,2,7
Cameroon,2005-08-01,0,0,0,0,0,0
Cameroon,2005-08-01,2,0,0,0,1,3
Cameroon,2005-08-01,0,0,0,0,0,0
Cameroon,2005-08-01,0,0,0,6,0,6
Cameroon,2005-08-01,1,0,0,0,0,1
Cameroon,2005-08-01,0,0,0,0,0,0
Cameroon,2005-08-01,2,0,0,0,0,2
Cameroon,2005-08-01,1,0,0,0,0,1
Cameroon,2005-08-01,2,0,0,3,0,5
Cameroon,2005-08-01,0,0,0,0,1,1
Cameroon,2005-08-01,0,0,0,0,0,0
Cameroon,2005-08-01,0,0,0,0,0,0
Cameroon,2005-08-01,0,0,0,0,0,0
Cameroon,2005-08-01,-1,0,0,0,0,-1
Cameroon,2005-08-01,0,0,0,0,0,0
Cameroon,2005-09-01,1,0,0,0,0,1
Cameroon,2005-09-01,3,0,0,0,0,3
Cameroon,2005-09-01,2,0,0,0,0,2
Cameroon,2005-09-01,0,0,0,0,0,0
Cameroon,2005-09-01,6,0,0,0,0,6
Cameroon,2005-09-01,4,0,0,0,0,4
Cameroon,2005-09-01,0,0,0,0,0,0
Cameroon,2005-09-01,2,0,0,0,0,2
Cameroon,2005-09-01,0,0,0,0,0,0
Cameroon,2005-09-01,0,0,0,0,0,0
Cameroon,2005-09-01,0,0,0,0,2,2
Cameroon,2005-09-01,3,0,0,0,3,6
Cameroon,2005-09-01,4,0,0,15,0,19
Cameroon,2005-09-01,8,0,0,3,0,11
Cameroon,2005-09-01,0,0,0,0,0,0
Cameroon,2005-09-01,0,0,0,0,0,0
Cameroon,2005-09-01,-1,0,0,0,0,-1
Cameroon,2005-09-01,0,0,0,0,0,0
Cameroon,2005-09-01,16,0,0,0,2,18
Cameroon,2005-09-01,0,0,0,0,0,0
Cameroon,2005-10-01,0,0,0,0,3,3
Cameroon,2005-10-01,0,0,0,0,0,0
Cameroon,2005-10-01,0,0,0,0,0,0
Cameroon,2005-10-01,0,0,0,0,0,0
Cameroon,2005-10-01,4,0,0,0,0,4
Cameroon,2005-10-01,0,0,0,0,0,0
Cameroon,2005-10-01,3,0,0,0,0,3
Cameroon,2005-10-01,0,0,-4,0,0,-4
Cameroon,2005-10-01,0,0,0,0,0,0
Cameroon,2005-10-01,1,0,0,0,0,1
Cameroon,2005-10-01,0,0,0,0,0,0
Cameroon,2005-10-01,0,0,0,0,0,0
Cameroon,2005-10-01,0,0,0,0,0,0
Cameroon,2005-10-01,3,0,0,0,0,3
Cameroon,2005-10-01,3,0,0,0,0,3
Cameroon,2005-10-01,0,0,0,0,0,0
Cameroon,2005-10-01,0,0,0,0,0,0
Cameroon,2005-10-01,3,0,0,0,0,3
Cameroon,2005-10-01,0,0,0,0,0,0
Cameroon,2005-10-01,0,0,0,0,0,0
Cameroon,2005-10-01,-1,0,0,0,0,-1
Cameroon,2005-10-01,0,0,0,0,0,0
Cameroon,2005-11-01,0,0,0,-2,1,-1
Cameroon,2005-11-01,0,0,0,0,0,0
Cameroon,2005-11-01,0,0,0,0,0,0
Cameroon,2005-11-01,0,0,1,3,0,4
Cameroon,2005-11-01,0,0,0,0,0,0
Cameroon,2005-11-01,3,0,0,0,0,3
Cameroon,2005-11-01,0,0,0,-2,0,-2
Cameroon,2005-11-01,1,0,0,0,0,1
Cameroon,2005-11-01,0,0,0,0,0,0
Cameroon,2005-11-01,0,0,0,0,0,0
Cameroon,2005-11-01,0,0,0,0,0,0
Cameroon,2005-11-01,4,0,0,0,0,4
Cameroon,2005-11-01,6,0,0,0,0,6
Cameroon,2005-11-01,0,0,0,0,0,0
Cameroon,2005-11-01,0,0,0,0,0,0
Cameroon,2005-11-01,4,0,-4,0,0,0
Cameroon,2005-11-01,0,0,0,0,0,0
Cameroon,2005-11-01,1,0,0,0,0,1
Cameroon,2005-11-01,2,0,0,0,0,2
Cameroon,2005-11-01,4,0,0,3,2,9
Cameroon,2005-11-01,2,0,0,0,0,2
Cameroon,2005-11-01,1,0,0,0,0,1
Cameroon,2005-12-01,2,0,0,0,0,2
Cameroon,2005-12-01,0,0,0,0,0,0
Cameroon,2005-12-01,0,0,0,0,0,0
Cameroon,2005-12-01,0,0,0,0,0,0
Cameroon,2005-12-01,1,0,0,-2,0,-1
Cameroon,2005-12-01,0,0,0,6,0,6
Cameroon,2005-12-01,0,0,0,0,0,0
Cameroon,2005-12-01,4,0,0,0,0,4
Cameroon,2005-12-01,6,0,0,3,2,11
Cameroon,2005-12-01,-1,0,0,0,0,-1
Cameroon,2005-12-01,1,0,0,0,0,1
Cameroon,2005-12-01,0,0,0,0,1,1
Cameroon,2005-12-01,7,0,-1,3,0,9
Cameroon,2005-12-01,0,0,0,0,0,0
Cameroon,2005-12-01,5,0,0,0,0,5
Cameroon,2005-12-01,15,0,0,0,0,15
Cameroon,2005-12-01,9,0,0,3,0,12
Cameroon,2005-12-01,11,0,0,0,3,14
China,2005-01-01,0,0,0,0,0,0
China,2005-01-01,16,6,0,0,1,23
China,2005-01-01,8,0,0,0,7,15
China,2005-01-01,28,0,0,3,2,33
China,2005-01-01,2,0,0,3,0,5
China,2005-01-01,9,0,0,0,4,13
China,2005-01-01,-1,0,0,3,0,2
China,2005-01-01,-1,0,0,0,0,-1
China,2005-01-01,3,0,0,0,0,3
China,2005-01-01,11,0,0,6,0,17
China,2005-01-01,6,0,0,3,0,9
China,2005-01-01,16,0,0,3,0,19
China,2005-01-01,11,0,0,3,1,15
China,2005-01-01,1,0,0,13,2,16
China,2005-01-01,1,0,0,12,0,13
China,2005-01-01,3,0,0,0,0,3
China,2005-01-01,0,0,0,3,0,3
China,2005-01-01,4,0,0,-3,8,9
China,2005-01-01,15,0,0,9,0,24
China,2005-01-01,3,0,0,-1,3,5
China,2005-01-01,5,0,-1,-1,2,5
China,2005-01-01,5,0,0,-6,0,-1
China,2005-01-01,25,0,0,4,0,29
China,2005-01-01,16,0,-6,17,7,34
China,2005-01-01,18,2,2,15,1,38
China,2005-01-01,8,0,0,10,3,21
China,2005-01-01,13,0,0,21,0,34
China,2005-01-01,2,0,0,4,1,7
China,2005-01-01,0,0,0,0,1,1
China,2005-01-01,2,0,0,0,0,2
China,2005-01-01,21,0,0,6,2,29
China,2005-02-01,18,0,0,3,0,21
China,2005-02-01,9,0,0,2,3,14
China,2005-02-01,8,4,0,0,1,13
China,2005-02-01,3,0,0,21,0,24
China,2005-02-01,0,0,0,12,0,12
China,2005-02-01,5,0,0,0,0,5
China,2005-02-01,4,0,0,8,0,12
China,2005-02-01,14,0,-2,12,1,25
China,2005-02-01,7,0,0,8,2,17
China,2005-02-01,5,0,0,0,2,7
China,2005-02-01,8,2,0,12,0,22
China,2005-02-01,5,0,0,0,0,5
China,2005-02-01,3,0,1,-1,0,3
China,2005-02-01,0,0,0,0,3,3
China,2005-02-01,8,0,0,8,0,16
China,2005-02-01,1,0,0,0,0,1
China,2005-02-01,2,2,0,0,2,6
China,2005-02-01,12,0,0,12,2,26
China,2005-02-01,16,0,0,0,0,16
China,2005-02-01,7,0,0,0,0,7
China,2005-02-01,4,0,0,0,0,4
China,2005-02-01,9,0,0,0,0,9
China,2005-02-01,8,0,0,9,4,21
China,2005-02-01,17,0,-4,0,0,13
China,2005-02-01,6,2,0,7,0,15
China,2005-02-01,2,0,0,3,0,5
China,2005-02-01,6,0,0,6,1,13
China,2005-02-01,17,0,0,13,1,31
China,2005-03-01,6,0,0,6,3,15
China,2005-03-01,10,0,0,6,0,16
China,2005-03-01,19,0,1,2,0,22
China,2005-03-01,18,0,0,0,0,18
China,2005-03-01,2,0,0,-4,0,-2
China,2005-03-01,0,0,0,0,0,0
China,2005-03-01,14,2,0,-2,0,14
China,2005-03-01,19,0,0,7,2,28
China,2005-03-01,17,0,-1,9,1,26
China,2005-03-01,17,0,-7,9,3,22
China,2005-03-01,10,0,2,9,4,25
China,2005-03-01,0,0,-18,3,0,-15
China,2005-03-01,24,0,0,3,0,27
China,2005-03-01,21,0,0,11,1,33
China,2005-03-01,22,2,0,9,5,38
China,2005-03-01,7,0,0,-6,1,2
China,2005-03-01,18,0,-1,12,0,29
China,2005-03-01,34,0,1,6,0,41
China,2005-03-01,3,0,0,6,0,9
China,2005-03-01,11,0,0,0,0,11
China,2005-03-01,3,0,1,3,2,9
China,2005-03-01,28,0,-1,16,0,43
China,2005-03-01,27,0,0,4,1,32
China,2005-03-01,4,0,0,0,2,6
China,2005-03-01,3,0,0,3,0,6
China,2005-03-01,6,0,-1,3,4,12
China,2005-03-01,0,0,0,3,0,3
China,2005-03-01,6,0,0,12,0,18
China,2005-03-01,2,0,0,-3,2,1
China,2005-03-01,12,0,0,-2,0,10
China,2005-03-01,27,0,0,0,0,27
China,2005-04-01,11,0,0,0,5,16
China,2005-04-01,5,0,0,15,2,22
China,2005-04-01,13,0,0,6,2,21
China,2005-04-01,12,0,0,3,5,20
China,2005-04-01,9,0,0,1,8,18
China,2005-04-01,13,0,0,6,5,24
China,2005-04-01,6,0,0,13,0,19
China,2005-04-01,2,0,0,9,5,16
China,2005-04-01,12,0,0,7,0,19
China,2005-04-01,-1,0,0,10,1,10
China,2005-04-01,3,0,0,26,6,35
China,2005-04-01,7,0,0,12,2,21
China,2005-04-01,24,0,0,-7,3,20
China,2005-04-01,2,0,1,15,4,22
China,2005-04-01,1,0,0,12,0,13
China,2005-04-01,4,0,0,7,4,15
China,2005-04-01,2,0,-2,3,10,13
China,2005-04-01,12,0,0,17,1,30
China,2005-04-01,9,0,0,12,2,23
China,2005-04-01,30,0,0,4,4,38
China,2005-04-01,18,0,0,3,3,24
China,2005-04-01,18,0,0,-1,4,21
China,2005-04-01,14,0,0,0,1,15
China,2005-04-01,7,0,0,3,0,10
China,2005-04-01,23,0,0,0,9,32
China,2005-04-01,11,0,0,3,7,21
China,2005-04-01,-2,0,0,9,0,7
China,2005-04-01,19,0,0,-2,0,17
China,2005-04-01,9,0,1,0,0,10
China,2005-04-01,6,0,0,6,0,12
China,2005-05-01,0,0,0,-1,2,1
China,2005-05-01,5,0,0,3,0,8
China,2005-05-01,15,0,1,1,2,19
China,2005-05-01,-1,0,0,4,0,3
China,2005-05-01,0,0,0,3,0,3
China,2005-05-01,3,0,0,0,0,3
China,2005-05-01,-7,0,0,0,0,-7
China,2005-05-01,4,0,0,9,2,15
China,2005-05-01,6,0,-4,12,0,14
China,2005-05-01,11,0,0,0,0,11
China,2005-05-01,7,0,0,0,2,9
China,2005-05-01,6,0,0,6,1,13
China,2005-05-01,12,0,0,-8,2,6
China,2005-05-01,1,0,0,-4,0,-3
China,2005-05-01,16,0,0,0,3,19
China,2005-05-01,19,4,0,0,0,23
China,2005-05-01,13,0,0,0,1,14
China,2005-05-01,13,0,1,3,0,17
China,2005-05-01,19,0,0,0,1,20
China,2005-05-01,12,0,0,21,0,33
China,2005-05-01,5,0,0,16,0,21
China,2005-05-01,6,0,0,-2,0,4
China,2005-05-01,16,0,0,4,0,20
China,2005-05-01,18,0,0,20,1,39
China,2005-05-01,20,0,0,9,0,29
China,2005-05-01,15,0,0,14,7,36
China,2005-05-01,23,0,0,9,6,38
China,2005-05-01,11,0,0,3,2,16
China,2005-05-01,5,0,0,3,2,10
China,2005-05-01,-1,0,0,3,2,4
China,2005-05-01,4,0,0,7,3,14
China,2005-06-01,5,0,0,-2,0,3
China,2005-06-01,11,0,0,6,0,17
China,2005-06-01,2,0,-4,10,8,16
China,2005-06-01,13,0,0,6,0,19
China,2005-06-01,25,0,0,6,0,31
China,2005-06-01,33,2,0,0,0,35
China,2005-06-01,52,0,0,9,0,61
China,2005-06-01,65,0,0,3,1,69
China,2005-06-01,34,0,0,15,4,53
China,2005-06-01,-2,0,0,15,2,15
China,2005-06-01,13,0,0,2,0,15
China,2005-06-01,26,0,0,6,2,34
China,2005-06-01,12,0,0,14,0,26
China,2005-06-01,17,0,0,3,2,22
China,2005-06-01,6,0,0,0,2,8
China,2005-06-01,13,0,0,-6,3,10
China,2005-06-01,16,0,0,9,6,31
China,2005-06-01,9,0,0,9,0,18
China,2005-06-01,14,2,0,3,0,19
China,2005-06-01,21,2,0,12,0,35
China,2005-06-01,8,0,0,1,6,15
China,2005-06-01,15,0,0,0,0,15
China,2005-06-01,13,0,0,6,2,21
China,2005-06-01,4,2,0,3,1,10
China,2005-06-01,-2,0,0,0,0,-2
China,2005-06-01,3,0,1,18,0,22
China,2005-06-01,24,0,0,-2,0,22
China,2005-06-01,12,0,-6,0,0,6
China,2005-06-01,-4,0,0,14,1,11
China,2005-06-01,17,0,0,15,1,33
China,2005-07-01,19,0,0,6,0,25
China,2005-07-01,2,0,0,0,0,2
China,2005-07-01,-4,0,0,15,0,11
China,2005-07-01,30,0,0,3,2,35
China,2005-07-01,2,0,0,3,0,5
China,2005-07-01,0,0,0,3,0,3
China,2005-07-01,1,0,0,0,3,4
China,2005-07-01,10,0,0,12,3,25
China,2005-07-01,3,0,0,-2,0,1
China,2005-07-01,2,0,0,0,0,2
China,2005-07-01,0,0,0,6,1,7
China,2005-07-01,14,0,-6,-4,0,4
China,2005-07-01,4,0,0,6,0,10
China,2005-07-01,8,0,0,9,0,17
China,2005-07-01,32,2,0,7,2,43
China,2005-07-01,21,0,0,0,0,21
China,2005-07-01,1,0,0,-1,3,3
China,2005-07-01,1,0,0,13,0,14
China,2005-07-01,8,0,0,12,2,22
China,2005-07-01,6,0,0,4,1,11
China,2005-07-01,11,0,-1,0,0,10
China,2005-07-01,9,0,0,3,0,12
China,2005-07-01,5,0,0,-4,2,3
China,2005-07-01,30,0,-1,12,0,41
China,2005-07-01,15,8,-1,3,0,25
China,2005-07-01,15,0,0,-1,1,15
China,2005-07-01,10,0,0,0,5,15
China,2005-07-01,17,0,0,4,1,22
China,2005-07-01,6,0,0,0,2,8
China,2005-07-01,5,0,0,1,0,6
China,2005-07-01,11,0,0,-1,0,10
China,2005-08-01,21,0,-3,23,0,41
China,2005-08-01,25,0,0,12,0,37
China,2005-08-01,8,0,0,-1,1,8
China,2005-08-01,18,0,0,-2,2,18
China,2005-08-01,26,0,0,22,0,48
China,2005-08-01,3,0,0,16,0,19
China,2005-08-01,4,0,1,3,0,8
China,2005-08-01,12,0,1,9,0,22
China,2005-08-01,-3,0,0,-4,2,-5
China,2005-08-01,23,0,0,15,0,38
China,2005-08-01,14,0,0,6,5,25
China,2005-08-01,10,0,2,6,2,20
China,2005-08-01,5,0,0,3,0,8
China,2005-08-01,10,0,0,6,0,16
China,2005-08-01,7,0,0,22,0,29
China,2005-08-01,-2,0,0,0,-2,-4
China,2005-08-01,6,0,0,3,2,11
China,2005-08-01,8,0,0,6,0,14
China,2005-08-01,15,0,1,7,2,25
China,2005-08-01,9,0,0,2,8,19
China,2005-08-01,18,0,0,-4,-2,12
China,2005-08-01,18,0,0,0,0,18
China,2005-08-01,31,0,0,9,0,40
China,2005-08-01,16,0,0,15,0,31
China,2005-08-01,15,0,0,0,7,22
China,2005-08-01,2,0,0,6,0,8
China,2005-08-01,4,0,1,0,0,5
China,2005-08-01,7,0,0,3,0,10
China,2005-08-01,1,0,0,15,1,17
China,2005-08-01,2,0,0,15,7,24
China,2005-08-01,5,0,-1,14,4,22
China,2005-09-01,22,0,0,12,0,34
China,2005-09-01,15,0,0,14,0,29
China,2005-09-01,4,0,0,3,0,7
China,2005-09-01,8,0,0,6,0,14
China,2005-09-01,15,2,0,0,2,19
China,2005-09-01,28,2,0,10,0,40
China,2005-09-01,24,0,0,-2,1,23
China,2005-09-01,12,0,0,3,1,16
China,2005-09-01,8,0,0,1,0,9
China,2005-09-01,7,0,0,0,1,8
China,2005-09-01,13,0,1,0,2,16
China,2005-09-01,20,2,0,6,2,30
China,2005-09-01,13,0,0,2,6,21
China,2005-09-01,13,0,0,1,1,15
China,2005-09-01,3,0,0,-5,4,2
China,2005-09-01,7,0,1,1,5,14
China,2005-09-01,1,0,0,4,1,6
China,2005-09-01,-4,0,0,0,0,-4
China,2005-09-01,29,0,0,6,5,40
China,2005-09-01,-1,4,0,-3,0,0
China,2005-09-01,34,0,0,0,0,34
China,2005-09-01,3,0,-1,6,0,8
China,2005-09-01,0,0,0,7,1,8
China,2005-09-01,2,0,0,0,7,9
China,2005-09-01,13,0,0,0,0,13
China,2005-09-01,3,0,0,4,0,7
China,2005-09-01,5,0,0,15,0,20
China,2005-09-01,13,0,0,3,0,16
China,2005-09-01,6,0,1,0,1,8
China,2005-09-01,10,0,0,-4,3,9
China,2005-10-01,11,0,0,0,2,13
China,2005-10-01,9,0,0,1,0,10
China,2005-10-01,5,0,0,3,0,8
China,2005-10-01,4,0,0,12,0,16
China,2005-10-01,25,0,0,2,0,27
China,2005-10-01,13,0,-6,4,0,11
China,2005-10-01,7,0,0,-1,0,6
China,2005-10-01,17,0,0,3,4,24
China,2005-10-01,32,0,-2,0,2,32
China,2005-10-01,17,0,0,0,1,18
China,2005-10-01,7,0,0,3,2,12
China,2005-10-01,5,0,0,12,3,20
China,2005-10-01,2,0,0,4,2,8
China,2005-10-01,-2,0,0,0,0,-2
China,2005-10-01,6,0,0,-1,0,5
China,2005-10-01,8,0,0,0,0,8
China,2005-10-01,8,0,0,-2,2,8
China,2005-10-01,32,0,0,6,4,42
China,2005-10-01,16,0,0,3,5,24
China,2005-10-01,11,0,0,9,1,21
China,2005-10-01,15,0,0,6,0,21
China,2005-10-01,14,0,0,12,0,26
China,2005-10-01,10,2,0,1,0,13
China,2005-10-01,26,2,0,-2,2,28
China,2005-10-01,13,0,0,12,0,25
China,2005-10-01,28,0,0,12,0,40
China,2005-10-01,0,0,0,6,0,6
China,2005-10-01,3,0,-4,0,0,-1
China,2005-10-01,0,0,0,9,0,9
China,2005-10-01,-2,0,0,3,0,1
China,2005-10-01,15,0,0,-2,0,13
China,2005-11-01,1,0,1,3,2,7
China,2005-11-01,9,0,0,9,1,19
China,2005-11-01,9,0,0,-3,0,6
China,2005-11-01,-1,0,0,18,0,17
China,2005-11-01,2,0,0,0,1,3
China,2005-11-01,1,0,0,3,0,4
China,2005-11-01,5,0,0,0,1,6
China,2005-11-01,20,0,0,3,2,25
China,2005-11-01,1,0,0,4,0,5
China,2005-11-01,20,0,0,15,1,36
China,2005-11-01,9,0,0,2,0,11
China,2005-11-01,13,0,0,-2,0,11
China,2005-11-01,-1,0,0,3,2,4
China,2005-11-01,8,0,0,-4,2,6
China,2005-11-01,14,0,0,9,3,26
China,2005-11-01,13,0,-1,3,2,17
China,2005-11-01,16,0,0,2,1,19
China,2005-11-01,39,0,3,-2,1,41
China,2005-11-01,6,0,0,9,0,15
China,2005-11-01,8,0,-5,6,4,13
China,2005-11-01,6,0,2,6,0,14
China,2005-11-01,4,0,0,12,0,16
China,2005-11-01,4,0,0,15,0,19
China,2005-11-01,14,0,0,-2,1,13
China,2005-11-01,-1,0,0,3,3,5
China,2005-11-01,-2,0,0,6,1,5
China,2005-11-01,0,0,0,0,0,0
China,2005-11-01,17,0,0,15,0,32
China,2005-11-01,21,0,0,15,0,36
China,2005-11-01,22,0,0,3,1,26
China,2005-12-01,7,0,0,3,0,10
China,2005-12-01,11,0,0,5,2,18
China,2005-12-01,17,0,0,-2,0,15
China,2005-12-01,9,0,0,3,3,15
China,2005-12-01,1,0,0,12,0,13
China,2005-12-01,5,0,0,15,1,21
China,2005-12-01,6,0,0,3,0,9
China,2005-12-01,-3,0,0,6,2,5
China,2005-12-01,-2,0,0,9,5,12
China,2005-12-01,9,0,0,3,2,14
China,2005-12-01,3,0,0,3,0,6
China,2005-12-01,5,0,0,10,0,15
China,2005-12-01,17,0,0,31,0,48
China,2005-12-01,17,0,0,9,3,29
China,2005-12-01,7,0,0,9,6,22
China,2005-12-01,5,0,0,9,5,19
China,2005-12-01,9,0,0,3,0,12
China,2005-12-01,12,0,0,-2,1,11
China,2005-12-01,24,0,0,1,3,28
China,2005-12-01,7,2,0,3,1,13
China,2005-12-01,10,0,0,2,2,14
China,2005-12-01,20,0,1,16,0,37
China,2005-12-01,1,0,0,3,4,8
China,2005-12-01,8,0,0,3,0,11
China,2005-12-01,8,0,0,0,0,8
China,2005-12-01,-1,0,0,0,2,1
China,2005-12-01,1,0,0,-2,0,-1
China,2005-12-01,5,0,0,-2,1,4
China,2005-12-01,2,0,-4,0,0,-2
China,2005-12-01,1,0,0,3,0,4
China,2005-12-01,0,0,-2,2,2,2
Egypt,2005-01-01,1,0,0,0,2,3
Egypt,2005-01-01,15,0,0,-2,0,13
Egypt,2005-01-01,7,0,0,3,0,10
Egypt,2005-01-01,4,6,0,0,0,10
Egypt,2005-01-01,9,0,0,24,0,33
Egypt,2005-01-01,21,0,0,37,3,61
Egypt,2005-01-01,9,0,0,13,0,22
Egypt,2005-01-01,6,0,0,12,0,18
Egypt,2005-01-01,9,0,0,4,0,13
Egypt,2005-01-01,8,0,0,7,0,15
Egypt,2005-01-01,13,0,-4,17,0,26
Egypt,2005-01-01,-1,0,0,0,0,-1
Egypt,2005-01-01,3,0,0,42,5,50
Egypt,2005-01-01,3,0,0,12,0,15
Egypt,2005-01-01,0,0,0,0,1,1
Egypt,2005-01-01,2,0,0,0,2,4
Egypt,2005-01-01,3,0,1,-6,2,0
Egypt,2005-01-01,6,0,0,0,3,9
Egypt,2005-01-01,1,0,0,0,2,3
Egypt,2005-01-01,15,0,0,4,0,19
Egypt,2005-01-01,25,0,0,0,0,25
Egypt,2005-01-01,3,0,0,0,0,3
Egypt,2005-01-01,0,0,0,0,1,1
Egypt,2005-01-01,4,0,0,0,1,5
Egypt,2005-01-01,0,0,0,10,0,10
Egypt,2005-01-01,32,0,0,12,0,44
Egypt,2005-01-01,6,0,-1,0,0,5
Egypt,2005-01-01,-1,0,0,14,4,17
Egypt,2005-01-01,2,0,1,6,0,9
Egypt,2005-01-01,10,0,0,-2,3,11
Egypt,2005-01-01,28,0,0,8,0,36
Egypt,2005-02-01,28,0,0,-6,2,24
Egypt,2005-02-01,11,0,0,-1,2,12
Egypt,2005-02-01,10,0,1,-6,0,5
Egypt,2005-02-01,4,0,0,-6,4,2
Egypt,2005-02-01,11,0,0,0,0,11
Egypt,2005-02-01,29,0,0,18,2,49
Egypt,2005-02-01,1,0,-2,3,5,7
Egypt,2005-02-01,8,0,0,-6,0,2
Egypt,2005-02-01,12,0,0,9,0,21
Egypt,2005-02-01,4,0,0,14,0,18
Egypt,2005-02-01,16,0,0,0,0,16
Egypt,2005-02-01,0,0,0,0,0,0
Egypt,2005-02-01,9,0,0,2,1,12
Egypt,2005-02-01,6,0,0,15,1,22
Egypt,2005-02-01,5,0,0,9,0,14
Egypt,2005-02-01,20,0,0,0,0,20
Egypt,2005-02-01,2,0,0,3,2,7
Egypt,2005-02-01,-3,0,0,3,3,3
Egypt,2005-02-01,2,0,0,0,4,6
Egypt,2005-02-01,13,0,0,0,3,16
Egypt,2005-02-01,0,0,0,0,0,0
Egypt,2005-02-01,1,0,0,0,0,1
Egypt,2005-02-01,26,0,2,0,0,28
Egypt,2005-02-01,3,0,0,0,0,3
Egypt,2005-02-01,2,0,0,9,3,14
Egypt,2005-02-01,-1,0,0,18,3,20
Egypt,2005-02-01,4,0,-2,0,0,2
Egypt,2005-02-01,-3,0,0,0,0,-3
Egypt,2005-03-01,10,0,0,0,0,10
Egypt,2005-03-01,0,0,0,-2,6,4
Egypt,2005-03-01,-2,0,0,0,0,-2
Egypt,2005-03-01,3,0,0,0,0,3
Egypt,2005-03-01,-1,0,0,0,0,-1
Egypt,2005-03-01,-1,0,0,3,0,2
Egypt,2005-03-01,2,0,0,0,1,3
Egypt,2005-03-01,5,0,0,9,1,15
Egypt,2005-03-01,32,0,1,-3,0,30
Egypt,2005-03-01,1,0,0,-4,3,0
Egypt,2005-03-01,0,0,0,12,0,12
Egypt,2005-03-01,1,0,0,-6,0,-5
Egypt,2005-03-01,6,0,0,3,0,9
Egypt,2005-03-01,0,0,0,6,0,6
Egypt,2005-03-01,10,0,0,-1,4,13
Egypt,2005-03-01,-7,0,0,-2,1,-8
Egypt,2005-03-01,10,0,0,0,2,12
Egypt,2005-03-01,3,0,0,1,0,4
Egypt,2005-03-01,3,0,0,3,0,6
Egypt,2005-03-01,34,0,0,0,6,40
Egypt,2005-03-01,4,0,0,3,0,7
Egypt,2005-03-01,3,0,0,4,4,11
Egypt,2005-03-01,7,0,0,7,0,14
Egypt,2005-03-01,-21,0,0,0,0,-21
Egypt,2005-03-01,5,0,0,0,1,6
Egypt,2005-03-01,-4,0,0,0,0,-4
Egypt,2005-03-01,12,0,0,24,0,36
Egypt,2005-03-01,4,0,0,0,0,4
Egypt,2005-03-01,0,0,0,0,1,1
Egypt,2005-03-01,8,0,0,6,0,14
Egypt,2005-03-01,3,0,0,0,2,5
Egypt,2005-04-01,3,0,0,-2,0,1
Egypt,2005-04-01,4,0,0,0,0,4
Egypt,2005-04-01,7,0,0,0,1,8
Egypt,2005-04-01,8,0,0,15,0,23
Egypt,2005-04-01,25,0,0,0,0,25
Egypt,2005-04-01,0,0,0,0,0,0
Egypt,2005-04-01,8,0,-2,0,0,6
Egypt,2005-04-01,3,0,0,0,0,3
Egypt,2005-04-01,4,0,0,6,0,10
Egypt,2005-04-01,0,0,0,0,0,0
Egypt,2005-04-01,0,0,0,-2,0,-2
Egypt,2005-04-01,2,0,0,0,1,3
Egypt,2005-04-01,4,0,0,3,0,7
Egypt,2005-04-01,20,0,0,9,0,29
Egypt,2005-04-01,22,0,0,3,0,25
Egypt,2005-04-01,3,0,0,0,0,3
Egypt,2005-04-01,-3,2,0,0,0,-1
Egypt,2005-04-01,12,0,0,0,10,22
Egypt,2005-04-01,2,0,0,0,0,2
Egypt,2005-04-01,4,0,0,0,0,4
Egypt,2005-04-01,4,0,0,1,0,5
Egypt,2005-04-01,0,0,0,0,0,0
Egypt,2005-04-01,1,0,0,-2,7,6
Egypt,2005-04-01,4,0,1,1,0,6
Egypt,2005-04-01,-1,0,0,0,0,-1
Egypt,2005-04-01,0,0,-3,0,3,0
Egypt,2005-04-01,-2,0,0,6,0,4
Egypt,2005-04-01,-5,0,0,0,0,-5
Egypt,2005-04-01,1,0,0,3,0,4
Egypt,2005-04-01,4,0,0,0,0,4
Egypt,2005-05-01,4,0,0,1,0,5
Egypt,2005-05-01,2,0,0,3,0,5
Egypt,2005-05-01,17,0,0,0,4,21
Egypt,2005-05-01,1,0,0,-8,0,-7
Egypt,2005-05-01,4,0,0,3,1,8
Egypt,2005-05-01,-1,0,0,9,0,8
Egypt,2005-05-01,0,0,0,3,0,3
Egypt,2005-05-01,1,0,0,0,0,1
Egypt,2005-05-01,-1,0,0,9,0,8
Egypt,2005-05-01,9,0,-2,0,0,7
Egypt,2005-05-01,-1,0,0,6,0,5
Egypt,2005-05-01,18,0,2,3,0,23
Egypt,2005-05-01,1,0,0,0,0,1
Egypt,2005-05-01,2,0,0,1,2,5
Egypt,2005-05-01,2,0,1,3,0,6
Egypt,2005-05-01,5,0,0,0,1,6
Egypt,2005-05-01,-20,0,0,0,1,-19
Egypt,2005-05-01,14,0,-2,12,4,28
Egypt,2005-05-01,3,0,0,26,2,31
Egypt,2005-05-01,11,0,0,18,0,29
Egypt,2005-05-01,7,0,0,3,1,11
Egypt,2005-05-01,7,0,0,3,0,10
Egypt,2005-05-01,12,0,1,6,0,19
Egypt,2005-05-01,4,0,1,7,0,12
Egypt,2005-05-01,0,0,0,0,0,0
Egypt,2005-05-01,13,0,-4,6,4,19
Egypt,2005-05-01,10,0,0,3,0,13
Egypt,2005-05-01,2,0,0,2,2,6
Egypt,2005-05-01,5,0,0,3,0,8
Egypt,2005-05-01,2,0,0,-2,2,2
Egypt,2005-05-01,10,0,0,0,1,11
Egypt,2005-06-01,-2,0,0,0,2,0
Egypt,2005-06-01,-1,0,0,0,0,-1
Egypt,2005-06-01,3,0,0,-3,0,0
Egypt,2005-06-01,5,0,0,0,1,6
Egypt,2005-06-01,3,0,0,0,1,4
Egypt,2005-06-01,9,0,0,0,0,9
Egypt,2005-06-01,42,0,0,0,0,42
Egypt,2005-06-01,1,0,-4,24,1,22
Egypt,2005-06-01,2,0,0,3,1,6
Egypt,2005-06-01,8,0,0,0,0,8
Egypt,2005-06-01,1,0,0,-2,0,-1
Egypt,2005-06-01,8,0,0,-4,2,6
Egypt,2005-06-01,9,0,0,0,0,9
Egypt,2005-06-01,13,0,0,-6,1,8
Egypt,2005-06-01,0,0,1,3,0,4
Egypt,2005-06-01,3,0,0,3,0,6
Egypt,2005-06-01,24,0,0,3,0,27
Egypt,2005-06-01,9,0,-4,1,0,6
Egypt,2005-06-01,9,0,0,3,2,14
Egypt,2005-06-01,0,0,0,3,0,3
Egypt,2005-06-01,24,0,0,9,4,37
Egypt,2005-06-01,8,0,0,10,2,20
Egypt,2005-06-01,0,0,0,6,0,6
Egypt,2005-06-01,4,0,0,-1,2,5
Egypt,2005-06-01,0,0,0,6,2,8
Egypt,2005-06-01,10,0,0,0,0,10
Egypt,2005-06-01,-2,0,0,6,1,5
Egypt,2005-06-01,25,0,0,4,1,30
Egypt,2005-06-01,21,0,0,6,3,30
Egypt,2005-06-01,0,0,0,0,0,0
Egypt,2005-07-01,-1,0,-1,3,0,1
Egypt,2005-07-01,3,0,0,0,1,4
Egypt,2005-07-01,3,0,0,12,2,17
Egypt,2005-07-01,-3,0,0,8,0,5
Egypt,2005-07-01,37,0,0,-1,0,36
Egypt,2005-07-01,2,0,0,14,2,18
Egypt,2005-07-01,32,0,0,17,2,51
Egypt,2005-07-01,49,0,2,28,3,82
Egypt,2005-07-01,10,0,3,6,0,19
Egypt,2005-07-01,8,0,0,0,4,12
Egypt,2005-07-01,10,0,0,3,0,13
Egypt,2005-07-01,5,0,0,15,3,23
Egypt,2005-07-01,13,0,0,3,2,18
Egypt,2005-07-01,28,0,0,39,0,67
Egypt,2005-07-01,13,0,0,34,0,47
Egypt,2005-07-01,5,0,0,0,0,5
Egypt,2005-07-01,3,0,0,0,0,3
Egypt,2005-07-01,13,0,0,19,1,33
Egypt,2005-07-01,31,0,0,9,0,40
Egypt,2005-07-01,8,0,0,12,2,22
Egypt,2005-07-01,3,0,0,30,0,33
Egypt,2005-07-01,8,0,0,9,1,18
Egypt,2005-07-01,47,0,0,12,17,76
Egypt,2005-07-01,41,0,0,3,7,51
Egypt,2005-07-01,11,0,0,18,0,29
Egypt,2005-07-01,17,0,0,3,3,23
Egypt,2005-07-01,23,0,0,33,1,57
Egypt,2005-07-01,25,0,0,12,0,37
Egypt,2005-07-01,27,0,0,18,2,47
Egypt,2005-07-01,4,0,0,15,2,21
Egypt,2005-07-01,1,0,0,0,0,1
Egypt,2005-08-01,9,0,0,11,2,22
Egypt,2005-08-01,0,0,0,0,0,0
Egypt,2005-08-01,0,0,0,9,0,9
Egypt,2005-08-01,5,0,0,6,0,11
Egypt,2005-08-01,-5,0,0,-2,1,-6
Egypt,2005-08-01,1,0,0,0,0,1
Egypt,2005-08-01,7,0,0,-2,0,5
Egypt,2005-08-01,0,0,0,-4,0,-4
Egypt,2005-08-01,16,0,0,-2,1,15
Egypt,2005-08-01,6,0,0,6,1,13
Egypt,2005-08-01,0,0,0,-2,1,-1
Egypt,2005-08-01,-1,0,2,18,2,21
Egypt,2005-08-01,0,0,0,-2,0,-2
Egypt,2005-08-01,14,0,0,9,0,23
Egypt,2005-08-01,1,0,0,3,0,4
Egypt,2005-08-01,-3,0,0,12,0,9
Egypt,2005-08-01,9,0,0,6,3,18
Egypt,2005-08-01,1,0,0,6,8,15
Egypt,2005-08-01,9,0,0,3,0,12
Egypt,2005-08-01,12,0,0,-2,12,22
Egypt,2005-08-01,2,0,0,6,0,8
Egypt,2005-08-01,10,0,0,-1,-1,8
Egypt,2005-08-01,15,0,0,8,0,23
Egypt,2005-08-01,-3,0,0,-2,1,-4
Egypt,2005-08-01,13,0,0,3,0,16
Egypt,2005-08-01,6,0,0,6,0,12
Egypt,2005-08-01,0,0,0,0,1,1
Egypt,2005-08-01,9,0,0,-3,0,6
Egypt,2005-08-01,31,0,1,3,0,35
Egypt,2005-08-01,10,0,0,6,3,19
Egypt,2005-08-01,30,0,0,-5,1,26
Egypt,2005-09-01,17,0,0,1,0,18
Egypt,2005-09-01,-3,0,0,0,0,-3
Egypt,2005-09-01,2,0,3,-6,0,-1
Egypt,2005-09-01,13,0,1,3,0,17
Egypt,2005-09-01,8,0,0,0,0,8
Egypt,2005-09-01,4,0,-2,6,0,8
Egypt,2005-09-01,17,0,0,0,3,20
Egypt,2005-09-01,5,0,0,2,3,10
Egypt,2005-09-01,-5,0,0,-3,3,-5
Egypt,2005-09-01,0,0,0,3,3,6
Egypt,2005-09-01,31,0,0,0,2,33
Egypt,2005-09-01,25,0,0,4,0,29
Egypt,2005-09-01,39,0,-1,0,4,42
Egypt,2005-09-01,38,0,1,9,2,50
Egypt,2005-09-01,47,0,2,10,0,59
Egypt,2005-09-01,6,0,1,6,2,15
Egypt,2005-09-01,26,0,0,11,4,41
Egypt,2005-09-01,29,0,0,0,2,31
Egypt,2005-09-01,1,0,0,3,0,4
Egypt,2005-09-01,14,0,0,6,0,20
Egypt,2005-09-01,-10,0,0,0,0,-10
Egypt,2005-09-01,9,0,0,0,0,9
Egypt,2005-09-01,6,0,0,2,2,10
Egypt,2005-09-01,5,0,0,6,0,11
Egypt,2005-09-01,16,0,0,0,0,16
Egypt,2005-09-01,-16,0,0,12,0,-4
Egypt,2005-09-01,6,0,0,1,0,7
Egypt,2005-09-01,6,0,0,2,0,8
Egypt,2005-09-01,3,12,0,1,0,16
Egypt,2005-09-01,0,0,0,0,0,0
Egypt,2005-10-01,0,0,0,12,0,12
Egypt,2005-10-01,3,0,0,3,0,6
Egypt,2005-10-01,12,0,0,3,0,15
Egypt,2005-10-01,0,0,0,0,0,0
Egypt,2005-10-01,0,0,0,15,0,15
Egypt,2005-10-01,3,0,0,0,0,3
Egypt,2005-10-01,7,0,-2,-3,0,2
Egypt,2005-10-01,9,4,0,1,-2,12
Egypt,2005-10-01,10,0,0,2,0,12
Egypt,2005-10-01,2,0,0,0,-4,-2
Egypt,2005-10-01,3,0,-1,0,1,3
Egypt,2005-10-01,3,0,0,3,0,6
Egypt,2005-10-01,3,0,0,0,0,3
Egypt,2005-10-01,0,0,0,0,0,0
Egypt,2005-10-01,5,0,0,9,0,14
Egypt,2005-10-01,2,0,0,8,0,10
Egypt,2005-10-01,5,0,0,0,1,6
Egypt,2005-10-01,5,0,0,10,0,15
Egypt,2005-10-01,2,0,0,3,1,6
Egypt,2005-10-01,10,2,0,4,0,16
Egypt,2005-10-01,5,0,0,3,0,8
Egypt,2005-10-01,5,0,0,0,0,5
Egypt,2005-10-01,17,0,-2,0,0,15
Egypt,2005-10-01,6,0,0,6,0,12
Egypt,2005-10-01,13,0,0,3,3,19
Egypt,2005-10-01,7,0,0,6,0,13
Egypt,2005-10-01,3,0,-1,3,14,19
Egypt,2005-10-01,8,0,0,0,0,8
Egypt,2005-10-01,17,0,0,0,0,17
Egypt,2005-10-01,8,0,0,3,0,11
Egypt,2005-10-01,-6,0,0,0,2,-4
Egypt,2005-11-01,10,0,-2,1,0,9
Egypt,2005-11-01,3,0,0,0,0,3
Egypt,2005-11-01,6,0,0,0,2,8
Egypt,2005-11-01,0,0,0,0,0,0
Egypt,2005-11-01,-11,0,0,3,0,-8
Egypt,2005-11-01,7,0,0,5,0,12
Egypt,2005-11-01,-5,0,0,3,0,-2
Egypt,2005-11-01,3,0,0,6,0,9
Egypt,2005-11-01,3,0,0,6,0,9
Egypt,2005-11-01,4,0,0,3,0,7
Egypt,2005-11-01,21,0,-2,15,0,34
Egypt,2005-11-01,0,0,0,0,6,6
Egypt,2005-11-01,10,0,1,0,1,12
Egypt,2005-11-01,2,0,0,0,0,2
Egypt,2005-11-01,5,2,0,-2,2,7
Egypt,2005-11-01,0,0,0,3,0,3
Egypt,2005-11-01,3,0,0,0,0,3
Egypt,2005-11-01,3,0,0,3,0,6
Egypt,2005-11-01,0,0,0,3,0,3
Egypt,2005-11-01,3,0,0,0,0,3
Egypt,2005-11-01,10,0,0,0,0,10
Egypt,2005-11-01,8,0,0,3,0,11
Egypt,2005-11-01,2,0,0,0,0,2
Egypt,2005-11-01,0,0,0,3,0,3
Egypt,2005-11-01,-3,0,0,-2,0,-5
Egypt,2005-11-01,3,0,0,-4,3,2
Egypt,2005-11-01,0,0,0,3,0,3
Egypt,2005-11-01,5,0,0,3,4,12
Egypt,2005-11-01,5,0,0,0,2,7
Egypt,2005-11-01,1,0,0,13,0,14
Egypt,2005-12-01,3,0,1,3,0,7
Egypt,2005-12-01,1,0,0,0,0,1
Egypt,2005-12-01,15,0,0,0,0,15
Egypt,2005-12-01,34,0,0,0,1,35
Egypt,2005-12-01,3,0,0,0,0,3
Egypt,2005-12-01,8,0,0,12,2,22
Egypt,2005-12-01,16,0,0,0,0,16
Egypt,2005-12-01,18,0,0,5,0,23
Egypt,2005-12-01,14,0,0,1,0,15
Egypt,2005-12-01,21,0,-1,4,5,29
Egypt,2005-12-01,37,0,0,4,0,41
Egypt,2005-12-01,3,0,0,0,0,3
Egypt,2005-12-01,-2,0,0,3,0,1
Egypt,2005-12-01,16,0,0,6,3,25
Egypt,2005-12-01,5,0,0,3,3,11
Egypt,2005-12-01,3,0,0,-1,0,2
Egypt,2005-12-01,15,0,0,-5,2,12
Egypt,2005-12-01,1,0,0,2,0,3
Egypt,2005-12-01,0,0,0,0,0,0
Egypt,2005-12-01,16,0,0,1,3,20
Egypt,2005-12-01,9,0,0,0,0,9
Egypt,2005-12-01,3,0,0,6,0,9
Egypt,2005-12-01,9,0,0,15,0,24
Egypt,2005-12-01,0,0,0,6,0,6
Egypt,2005-12-01,6,0,0,0,0,6
Egypt,2005-12-01,9,0,0,12,0,21
Egypt,2005-12-01,1,0,0,3,1,5
Egypt,2005-12-01,5,0,1,18,2,26
Egypt,2005-12-01,12,0,0,23,1,36
Egypt,2005-12-01,14,0,0,3,1,18
Egypt,2005-12-01,9,0,0,0,1,10
Eritrea,2005-01-01,11,0,0,6,2,19
Eritrea,2005-01-01,0,0,0,0,1,1
Eritrea,2005-01-01,4,0,0,9,0,13
Eritrea,2005-01-01,3,0,0,0,0,3
Eritrea,2005-01-01,3,0,0,0,0,3
Eritrea,2005-01-01,0,0,0,0,0,0
Eritrea,2005-01-01,0,0,0,0,0,0
Eritrea,2005-01-01,0,0,0,0,0,0
Eritrea,2005-01-01,1,0,0,0,0,1
Eritrea,2005-01-01,0,0,0,0,0,0
Eritrea,2005-01-01,0,0,0,3,0,3
Eritrea,2005-01-01,4,0,0,0,0,4
Eritrea,2005-01-01,1,0,0,0,0,1
Eritrea,2005-01-01,9,0,0,0,0,9
Eritrea,2005-01-01,0,0,0,0,0,0
Eritrea,2005-01-01,0,0,0,0,0,0
Eritrea,2005-01-01,0,0,0,0,0,0
Eritrea,2005-01-01,4,0,0,0,0,4
Eritrea,2005-01-01,0,0,0,0,0,0
Eritrea,2005-01-01,3,0,0,3,0,6
Eritrea,2005-01-01,0,0,0,0,0,0
Eritrea,2005-02-01,0,0,0,0,0,0
Eritrea,2005-02-01,13,0,0,0,0,13
Eritrea,2005-02-01,1,0,0,12,0,13
Eritrea,2005-02-01,0,0,0,0,0,0
Eritrea,2005-02-01,0,0,0,0,0,0
Eritrea,2005-02-01,-3,0,0,0,0,-3
Eritrea,2005-02-01,0,0,0,0,0,0
Eritrea,2005-02-01,0,0,0,0,0,0
Eritrea,2005-02-01,8,0,0,0,0,8
Eritrea,2005-02-01,0,0,0,0,0,0
Eritrea,2005-02-01,8,0,0,0,0,8
Eritrea,2005-02-01,2,0,0,0,0,2
Eritrea,2005-02-01,4,0,0,0,0,4
Eritrea,2005-02-01,6,0,0,0,2,8
Eritrea,2005-02-01,0,0,0,0,0,0
Eritrea,2005-02-01,0,0,0,3,0,3
Eritrea,2005-02-01,6,0,0,1,1,8
Eritrea,2005-02-01,0,0,0,0,0,0
Eritrea,2005-02-01,3,0,0,0,0,3
Eritrea,2005-02-01,0,0,0,3,0,3
Eritrea,2005-02-01,0,0,0,0,0,0
Eritrea,2005-02-01,0,0,0,0,0,0
Eritrea,2005-02-01,4,0,0,0,0,4
Eritrea,2005-02-01,0,0,0,0,0,0
Eritrea,2005-03-01,3,0,0,-2,0,1
Eritrea,2005-03-01,5,0,0,0,0,5
Eritrea,2005-03-01,0,0,0,0,0,0
Eritrea,2005-03-01,4,0,0,0,0,4
Eritrea,2005-03-01,-1,0,0,0,0,-1
Eritrea,2005-03-01,0,0,0,3,0,3
Eritrea,2005-03-01,0,0,0,0,0,0
Eritrea,2005-03-01,6,0,0,0,0,6
Eritrea,2005-03-01,8,0,0,0,0,8
Eritrea,2005-03-01,0,0,0,6,0,6
Eritrea,2005-03-01,6,0,0,10,0,16
Eritrea,2005-03-01,0,0,0,0,0,0
Eritrea,2005-03-01,0,0,0,0,0,0
Eritrea,2005-03-01,0,0,0,0,0,0
Eritrea,2005-03-01,3,0,0,3,0,6
Eritrea,2005-03-01,0,0,0,0,0,0
Eritrea,2005-03-01,-3,0,0,0,0,-3
Eritrea,2005-03-01,0,0,0,0,0,0
Eritrea,2005-03-01,0,0,0,15,0,15
Eritrea,2005-03-01,0,0,0,0,0,0
Eritrea,2005-03-01,0,0,0,0,0,0
Eritrea,2005-03-01,0,0,0,0,0,0
Eritrea,2005-03-01,3,0,0,3,0,6
Eritrea,2005-04-01,0,0,0,0,0,0
Eritrea,2005-04-01,2,0,0,0,0,2
Eritrea,2005-04-01,0,0,0,0,0,0
Eritrea,2005-04-01,0,2,0,0,0,2
Eritrea,2005-04-01,6,0,0,0,0,6
Eritrea,2005-04-01,0,0,0,0,0,0
Eritrea,2005-04-01,0,0,0,0,0,0
Eritrea,2005-04-01,0,0,0,0,0,0
Eritrea,2005-04-01,0,0,0,0,0,0
Eritrea,2005-04-01,2,0,0,0,0,2
Eritrea,2005-04-01,0,0,0,0,0,0
Eritrea,2005-04-01,2,0,0,0,0,2
Eritrea,2005-04-01,0,0,0,0,0,0
Eritrea,2005-04-01,0,0,0,0,0,0
Eritrea,2005-04-01,0,0,0,0,0,0
Eritrea,2005-04-01,0,0,0,0,0,0
Eritrea,2005-04-01,17,0,0,0,0,17
Eritrea,2005-04-01,2,0,0,0,0,2
Eritrea,2005-04-01,2,0,0,-2,0,0
Eritrea,2005-04-01,1,0,0,0,0,1
Eritrea,2005-04-01,0,0,0,0,0,0
Eritrea,2005-04-01,0,0,0,3,0,3
Eritrea,2005-04-01,0,0,0,0,0,0
Eritrea,2005-05-01,0,0,0,0,2,2
Eritrea,2005-05-01,0,0,0,0,0,0
Eritrea,2005-05-01,0,0,0,0,4,4
Eritrea,2005-05-01,3,0,0,0,0,3
Eritrea,2005-05-01,4,0,0,0,0,4
Eritrea,2005-05-01,-2,0,0,1,0,-1
Eritrea,2005-05-01,-2,0,0,0,0,-2
Eritrea,2005-05-01,36,0,0,0,0,36
Eritrea,2005-05-01,0,0,0,0,0,0
Eritrea,2005-05-01,-33,0,0,3,0,-30
Eritrea,2005-05-01,0,0,0,0,0,0
Eritrea,2005-05-01,0,0,0,0,0,0
Eritrea,2005-05-01,2,0,0,-2,0,0
Eritrea,2005-05-01,0,0,0,0,0,0
Eritrea,2005-05-01,0,0,0,6,0,6
Eritrea,2005-05-01,3,0,0,0,0,3
Eritrea,2005-05-01,0,0,0,0,0,0
Eritrea,2005-05-01,0,0,0,0,0,0
Eritrea,2005-05-01,0,0,0,-2,0,-2
Eritrea,2005-05-01,0,0,0,0,0,0
Eritrea,2005-06-01,0,0,0,0,0,0
Eritrea,2005-06-01,1,0,0,0,0,1
Eritrea,2005-06-01,0,0,0,3,0,3
Eritrea,2005-06-01,0,0,0,0,0,0
Eritrea,2005-06-01,2,0,0,-2,0,0
Eritrea,2005-06-01,0,0,0,0,0,0
Eritrea,2005-06-01,0,0,0,0,0,0
Eritrea,2005-06-01,4,0,0,0,0,4
Eritrea,2005-06-01,2,0,0,0,0,2
Eritrea,2005-06-01,-1,0,0,-2,0,-3
Eritrea,2005-06-01,0,0,0,0,0,0
Eritrea,2005-06-01,0,0,0,6,2,8
Eritrea,2005-06-01,2,0,0,0,0,2
Eritrea,2005-06-01,6,0,0,0,0,6
Eritrea,2005-06-01,0,0,0,0,0,0
Eritrea,2005-06-01,2,0,0,0,0,2
Eritrea,2005-06-01,0,0,0,0,0,0
Eritrea,2005-06-01,0,0,0,-4,0,-4
Eritrea,2005-06-01,0,0,0,0,0,0
Eritrea,2005-06-01,0,0,0,0,0,0
Eritrea,2005-06-01,0,0,0,0,0,0
Eritrea,2005-06-01,0,0,0,0,0,0
Eritrea,2005-06-01,2,0,0,0,0,2
Eritrea,2005-06-01,-2,0,0,2,2,2
Eritrea,2005-06-01,0,0,0,0,0,0
Eritrea,2005-07-01,0,0,0,0,0,0
Eritrea,2005-07-01,0,0,0,0,0,0
Eritrea,2005-07-01,4,0,0,6,0,10
Eritrea,2005-07-01,-1,0,0,0,0,-1
Eritrea,2005-07-01,1,0,0,0,0,1
Eritrea,2005-07-01,0,0,0,0,0,0
Eritrea,2005-07-01,0,0,0,0,0,0
Eritrea,2005-07-01,0,0,0,0,0,0
Eritrea,2005-07-01,2,0,0,0,0,2
Eritrea,2005-07-01,-1,0,0,0,0,-1
Eritrea,2005-07-01,2,0,0,0,0,2
Eritrea,2005-07-01,0,0,0,0,0,0
Eritrea,2005-07-01,4,0,0,0,0,4
Eritrea,2005-07-01,0,0,0,3,0,3
Eritrea,2005-07-01,0,0,0,0,0,0
Eritrea,2005-07-01,8,0,0,9,0,17
Eritrea,2005-07-01,0,0,0,3,0,3
Eritrea,2005-07-01,0,0,0,0,0,0
Eritrea,2005-07-01,1,0,0,0,0,1
Eritrea,2005-07-01,0,0,0,3,0,3
Eritrea,2005-07-01,2,0,0,6,0,8
Eritrea,2005-07-01,1,0,0,3,0,4
Eritrea,2005-07-01,1,0,0,0,0,1
Eritrea,2005-08-01,2,0,0,0,2,4
Eritrea,2005-08-01,2,0,0,0,2,4
Eritrea,2005-08-01,0,0,0,0,0,0
Eritrea,2005-08-01,0,0,0,0,0,0
Eritrea,2005-08-01,0,0,0,0,1,1
Eritrea,2005-08-01,1,0,0,0,0,1
Eritrea,2005-08-01,2,0,0,0,0,2
Eritrea,2005-08-01,3,0,0,0,0,3
Eritrea,2005-08-01,0,0,0,0,0,0
Eritrea,2005-08-01,0,0,0,0,0,0
Eritrea,2005-08-01,0,0,0,0,0,0
Eritrea,2005-08-01,0,0,0,0,0,0
Eritrea,2005-08-01,0,0,0,0,0,0
Eritrea,2005-08-01,0,0,0,0,0,0
Eritrea,2005-08-01,0,0,0,0,0,0
Eritrea,2005-08-01,0,0,0,0,0,0
Eritrea,2005-08-01,0,0,0,0,0,0
Eritrea,2005-08-01,0,0,0,0,0,0
Eritrea,2005-08-01,2,0,0,0,0,2
Eritrea,2005-08-01,0,0,0,0,0,0
Eritrea,2005-08-01,6,0,0,0,0,6
Eritrea,2005-08-01,0,0,0,0,0,0
Eritrea,2005-09-01,0,0,1,3,0,4
Eritrea,2005-09-01,2,0,0,0,0,2
Eritrea,2005-09-01,0,0,0,0,0,0
Eritrea,2005-09-01,4,0,0,1,0,5
Eritrea,2005-09-01,2,0,0,3,0,5
Eritrea,2005-09-01,0,0,0,6,0,6
Eritrea,2005-09-01,9,0,0,4,0,13
Eritrea,2005-09-01,0,0,0,3,0,3
Eritrea,2005-09-01,1,0,0,0,0,1
Eritrea,2005-09-01,1,0,0,3,0,4
Eritrea,2005-09-01,0,0,0,0,0,0
Eritrea,2005-09-01,6,0,0,0,0,6
Eritrea,2005-09-01,4,0,0,0,0,4
Eritrea,2005-09-01,0,0,0,0,0,0
Eritrea,2005-10-01,4,0,0,0,0,4
Eritrea,2005-10-01,4,0,0,6,0,10
Eritrea,2005-10-01,0,0,0,9,0,9
Eritrea,2005-10-01,1,0,0,0,0,1
Eritrea,2005-10-01,0,0,0,0,0,0
Eritrea,2005-10-01,-3,0,0,0,0,-3
Eritrea,2005-10-01,0,0,0,0,1,1
Eritrea,2005-10-01,2,0,0,0,0,2
Eritrea,2005-10-01,0,0,0,0,0,0
Eritrea,2005-10-01,2,0,0,0,0,2
Eritrea,2005-10-01,0,0,0,0,0,0
Eritrea,2005-10-01,-6,2,0,3,0,-1
Eritrea,2005-10-01,-11,0,0,8,0,-3
Eritrea,2005-10-01,-3,0,0,3,0,0
Eritrea,2005-10-01,0,0,0,0,0,0
Eritrea,2005-10-01,5,0,0,9,0,14
Eritrea,2005-10-01,3,0,0,0,0,3
Eritrea,2005-10-01,0,0,0,0,0,0
Eritrea,2005-10-01,1,0,0,0,1,2
Eritrea,2005-10-01,4,0,0,18,0,22
Eritrea,2005-10-01,2,0,0,3,0,5
Eritrea,2005-10-01,0,0,0,0,0,0
Eritrea,2005-10-01,0,0,0,3,0,3
Eritrea,2005-10-01,0,0,0,3,0,3
Eritrea,2005-10-01,0,0,0,0,0,0
Eritrea,2005-11-01,4,0,0,3,0,7
Eritrea,2005-11-01,3,0,0,9,0,12
Eritrea,2005-11-01,11,0,0,12,4,27
Eritrea,2005-11-01,8,0,0,6,0,14
Eritrea,2005-11-01,0,0,0,0,0,0
Eritrea,2005-11-01,2,0,0,0,0,2
Eritrea,2005-11-01,5,0,0,0,1,6
Eritrea,2005-11-01,0,0,0,0,0,0
Eritrea,2005-11-01,0,0,0,0,0,0
Eritrea,2005-11-01,0,0,0,0,0,0
Eritrea,2005-11-01,-3,0,0,9,0,6
Eritrea,2005-11-01,6,0,0,0,0,6
Eritrea,2005-11-01,0,0,0,4,0,4
Eritrea,2005-11-01,0,0,0,0,0,0
Eritrea,2005-11-01,0,0,0,0,0,0
Eritrea,2005-11-01,0,0,0,3,0,3
Eritrea,2005-11-01,6,0,0,-26,1,-19
Eritrea,2005-11-01,4,0,0,-6,0,-2
Eritrea,2005-11-01,4,0,0,9,0,13
Eritrea,2005-11-01,-1,0,0,6,0,5
Eritrea,2005-11-01,2,0,0,6,0,8
Eritrea,2005-11-01,0,0,0,9,0,9
Eritrea,2005-11-01,0,0,0,0,0,0
Eritrea,2005-11-01,4,0,0,0,0,4
Eritrea,2005-11-01,6,0,0,0,0,6
Eritrea,2005-11-01,0,0,0,0,0,0
Eritrea,2005-11-01,1,0,0,0,0,1
Eritrea,2005-12-01,0,0,0,0,0,0
Eritrea,2005-12-01,0,0,0,-1,0,-1
Eritrea,2005-12-01,2,0,0,0,0,2
Eritrea,2005-12-01,1,0,0,9,0,10
Eritrea,2005-12-01,1,0,0,-2,0,-1
Eritrea,2005-12-01,4,0,0,6,0,10
Eritrea,2005-12-01,-4,0,0,18,0,14
Eritrea,2005-12-01,-2,0,0,0,4,2
Eritrea,2005-12-01,4,0,0,0,0,4
Eritrea,2005-12-01,3,0,0,6,0,9
Eritrea,2005-12-01,7,0,0,0,0,7
Eritrea,2005-12-01,1,0,0,12,0,13
Eritrea,2005-12-01,1,0,0,60,0,61
Eritrea,2005-12-01,-19,0,0,4,0,-15
Eritrea,2005-12-01,0,0,0,3,0,3
Eritrea,2005-12-01,0,0,0,0,2,2
Eritrea,2005-12-01,3,0,0,0,0,3
Eritrea,2005-12-01,0,0,0,0,1,1
Eritrea,2005-12-01,0,0,0,0,0,0
Eritrea,2005-12-01,2,0,0,0,1,3
Eritrea,2005-12-01,-6,0,0,3,0,-3
Eritrea,2005-12-01,-1,0,0,0,0,-1
Eritrea,2005-12-01,0,0,0,3,0,3
Eritrea,2005-12-01,2,0,0,0,0,2
Eritrea,2005-12-01,0,0,0,3,0,3
Georgia,2005-01-01,0,0,0,0,2,2
Georgia,2005-01-01,0,0,0,0,0,0
Georgia,2005-01-01,3,0,0,0,1,4
Georgia,2005-01-01,5,0,0,-4,0,1
Georgia,2005-01-01,3,0,0,0,0,3
Georgia,2005-01-01,0,0,0,3,0,3
Georgia,2005-01-01,1,0,0,0,0,1
Georgia,2005-01-01,2,0,0,0,0,2
Georgia,2005-01-01,0,0,0,0,0,0
Georgia,2005-01-01,0,0,0,3,2,5
Georgia,2005-01-01,0,0,0,0,0,0
Georgia,2005-01-01,2,0,0,0,0,2
Georgia,2005-01-01,2,0,0,0,0,2
Georgia,2005-01-01,0,0,0,0,0,0
Georgia,2005-01-01,0,0,0,0,0,0
Georgia,2005-01-01,0,0,0,0,0,0
Georgia,2005-01-01,0,0,0,3,0,3
Georgia,2005-01-01,2,0,0,0,0,2
Georgia,2005-01-01,0,0,0,0,0,0
Georgia,2005-01-01,10,0,0,0,0,10
Georgia,2005-01-01,3,0,0,0,0,3
Georgia,2005-01-01,0,0,0,0,0,0
Georgia,2005-01-01,2,0,0,0,0,2
Georgia,2005-01-01,0,0,-1,0,2,1
Georgia,2005-02-01,2,0,0,3,0,5
Georgia,2005-02-01,0,0,0,3,0,3
Georgia,2005-02-01,4,0,0,0,0,4
Georgia,2005-02-01,4,0,0,0,1,5
Georgia,2005-02-01,0,0,0,0,0,0
Georgia,2005-02-01,0,0,0,0,0,0
Georgia,2005-02-01,0,0,0,0,0,0
Georgia,2005-02-01,-1,0,0,0,0,-1
Georgia,2005-02-01,4,0,0,0,0,4
Georgia,2005-02-01,0,0,0,0,0,0
Georgia,2005-02-01,0,0,0,0,0,0
Georgia,2005-02-01,0,0,0,0,0,0
Georgia,2005-02-01,-1,0,0,0,0,-1
Georgia,2005-02-01,0,0,-2,0,0,-2
Georgia,2005-02-01,0,0,0,0,0,0
Georgia,2005-02-01,0,0,-2,6,0,4
Georgia,2005-02-01,2,0,0,0,0,2
Georgia,2005-02-01,0,0,0,0,0,0
Georgia,2005-02-01,0,0,0,0,0,0
Georgia,2005-02-01,0,0,0,0,0,0
Georgia,2005-02-01,0,0,0,0,0,0
Georgia,2005-02-01,0,0,0,0,0,0
Georgia,2005-02-01,3,0,0,0,0,3
Georgia,2005-02-01,3,0,0,0,1,4
Georgia,2005-02-01,0,0,0,3,0,3
Georgia,2005-03-01,0,0,0,0,0,0
Georgia,2005-03-01,0,0,0,-2,0,-2
Georgia,2005-03-01,2,0,-2,1,2,3
Georgia,2005-03-01,4,0,0,0,0,4
Georgia,2005-03-01,0,0,0,0,0,0
Georgia,2005-03-01,0,0,0,0,0,0
Georgia,2005-03-01,2,0,0,0,0,2
Georgia,2005-03-01,0,0,0,0,1,1
Georgia,2005-03-01,0,0,0,-6,0,-6
Georgia,2005-03-01,2,0,0,0,0,2
Georgia,2005-03-01,27,0,0,0,0,27
Georgia,2005-03-01,0,0,0,0,1,1
Georgia,2005-03-01,1,0,0,0,0,1
Georgia,2005-03-01,0,0,0,0,0,0
Georgia,2005-03-01,0,0,0,0,0,0
Georgia,2005-03-01,0,0,0,0,0,0
Georgia,2005-03-01,9,0,-6,0,0,3
Georgia,2005-03-01,3,0,0,0,2,5
Georgia,2005-03-01,0,0,0,0,0,0
Georgia,2005-03-01,1,0,0,0,0,1
Georgia,2005-03-01,3,0,0,6,0,9
Georgia,2005-03-01,8,0,0,0,2,10
Georgia,2005-03-01,9,0,0,0,0,9
Georgia,2005-03-01,2,0,0,0,0,2
Georgia,2005-03-01,0,0,0,0,0,0
Georgia,2005-03-01,0,0,0,3,0,3
Georgia,2005-03-01,0,0,0,6,1,7
Georgia,2005-03-01,4,0,1,0,0,5
Georgia,2005-03-01,11,0,0,3,2,16
Georgia,2005-04-01,3,0,0,0,0,3
Georgia,2005-04-01,0,0,0,0,0,0
Georgia,2005-04-01,2,0,0,0,0,2
Georgia,2005-04-01,0,0,0,0,0,0
Georgia,2005-04-01,0,0,0,0,0,0
Georgia,2005-04-01,3,0,0,0,0,3
Georgia,2005-04-01,3,0,0,0,0,3
Georgia,2005-04-01,0,0,0,0,0,0
Georgia,2005-04-01,3,0,0,0,0,3
Georgia,2005-04-01,0,0,0,0,0,0
Georgia,2005-04-01,0,0,0,0,0,0
Georgia,2005-04-01,4,0,0,0,0,4
Georgia,2005-04-01,0,0,0,0,0,0
Georgia,2005-04-01,0,0,0,0,0,0
Georgia,2005-04-01,0,0,0,0,0,0
Georgia,2005-04-01,9,0,0,0,0,9
Georgia,2005-04-01,4,0,0,6,0,10
Georgia,2005-04-01,0,0,0,6,0,6
Georgia,2005-04-01,0,0,0,0,0,0
Georgia,2005-04-01,-1,0,0,0,0,-1
Georgia,2005-04-01,-5,0,0,0,0,-5
Georgia,2005-04-01,0,0,0,3,0,3
Georgia,2005-04-01,0,0,0,3,0,3
Georgia,2005-04-01,0,0,0,0,0,0
Georgia,2005-04-01,1,0,0,-4,0,-3
Georgia,2005-04-01,1,0,0,0,0,1
Georgia,2005-05-01,2,0,0,-2,0,0
Georgia,2005-05-01,0,2,0,0,2,4
Georgia,2005-05-01,0,0,0,3,0,3
Georgia,2005-05-01,-3,0,0,0,0,-3
Georgia,2005-05-01,3,0,0,6,5,14
Georgia,2005-05-01,4,0,0,0,2,6
Georgia,2005-05-01,0,0,0,0,0,0
Georgia,2005-05-01,2,0,0,0,0,2
Georgia,2005-05-01,3,0,0,0,0,3
Georgia,2005-05-01,0,0,0,0,0,0
Georgia,2005-05-01,0,0,0,0,0,0
Georgia,2005-05-01,-3,0,0,0,2,-1
Georgia,2005-05-01,4,0,0,0,0,4
Georgia,2005-05-01,10,0,1,4,0,15
Georgia,2005-05-01,-1,0,0,0,0,-1
Georgia,2005-05-01,3,0,0,0,1,4
Georgia,2005-05-01,2,0,1,0,0,3
Georgia,2005-05-01,5,0,0,0,2,7
Georgia,2005-05-01,0,0,0,3,0,3
Georgia,2005-05-01,0,0,0,0,2,2
Georgia,2005-05-01,4,0,0,0,0,4
Georgia,2005-05-01,0,0,0,3,0,3
Georgia,2005-05-01,0,0,0,0,0,0
Georgia,2005-05-01,0,0,0,0,0,0
Georgia,2005-05-01,0,0,0,3,0,3
Georgia,2005-05-01,0,0,0,3,0,3
Georgia,2005-05-01,0,0,0,0,2,2
Georgia,2005-05-01,-6,0,0,0,1,-5
Georgia,2005-06-01,3,0,0,0,0,3
Georgia,2005-06-01,0,0,0,0,0,0
Georgia,2005-06-01,-1,0,0,0,0,-1
Georgia,2005-06-01,0,0,0,0,0,0
Georgia,2005-06-01,0,0,0,0,0,0
Georgia,2005-06-01,0,0,0,0,1,1
Georgia,2005-06-01,0,0,0,0,0,0
Georgia,2005-06-01,4,0,0,0,0,4
Georgia,2005-06-01,0,0,0,-2,0,-2
Georgia,2005-06-01,-1,0,0,0,0,-1
Georgia,2005-06-01,0,0,0,0,0,0
Georgia,2005-06-01,0,0,0,0,0,0
Georgia,2005-06-01,3,0,0,3,0,6
Georgia,2005-06-01,0,0,0,0,0,0
Georgia,2005-06-01,3,0,0,0,0,3
Georgia,2005-06-01,0,0,0,0,0,0
Georgia,2005-06-01,0,0,0,0,0,0
Georgia,2005-06-01,2,0,0,0,0,2
Georgia,2005-06-01,0,0,0,0,0,0
Georgia,2005-06-01,0,0,0,3,0,3
Georgia,2005-06-01,0,0,0,0,2,2
Georgia,2005-06-01,0,0,0,0,0,0
Georgia,2005-06-01,0,0,0,0,0,0
Georgia,2005-06-01,8,0,0,0,0,8
Georgia,2005-07-01,2,0,0,0,0,2
Georgia,2005-07-01,2,0,0,0,2,4
Georgia,2005-07-01,6,0,0,0,0,6
Georgia,2005-07-01,2,0,0,2,0,4
Georgia,2005-07-01,0,0,0,3,0,3
Georgia,2005-07-01,0,0,0,0,0,0
Georgia,2005-07-01,3,0,0,0,0,3
Georgia,2005-07-01,2,0,0,0,0,2
Georgia,2005-07-01,0,0,0,0,0,0
Georgia,2005-07-01,0,0,0,0,0,0
Georgia,2005-07-01,0,0,0,1,0,1
Georgia,2005-07-01,3,0,0,6,0,9
Georgia,2005-07-01,4,0,0,6,0,10
Georgia,2005-07-01,2,0,0,3,2,7
Georgia,2005-07-01,0,0,0,0,0,0
Georgia,2005-07-01,0,0,0,0,0,0
Georgia,2005-07-01,2,0,0,3,0,5
Georgia,2005-07-01,2,0,0,0,0,2
Georgia,2005-07-01,3,0,0,0,0,3
Georgia,2005-07-01,1,0,0,3,0,4
Georgia,2005-07-01,0,0,0,1,0,1
Georgia,2005-08-01,0,0,0,0,1,1
Georgia,2005-08-01,0,0,0,0,0,0
Georgia,2005-08-01,15,0,0,0,0,15
Georgia,2005-08-01,0,0,0,3,0,3
Georgia,2005-08-01,6,0,0,0,0,6
Georgia,2005-08-01,0,0,0,0,0,0
Georgia,2005-08-01,0,0,0,0,0,0
Georgia,2005-08-01,3,0,0,0,2,5
Georgia,2005-08-01,3,0,0,0,0,3
Georgia,2005-08-01,17,0,0,0,0,17
Georgia,2005-08-01,3,0,0,0,0,3
Georgia,2005-08-01,5,0,0,0,0,5
Georgia,2005-08-01,6,0,0,3,0,9
Georgia,2005-08-01,3,0,0,0,0,3
Georgia,2005-08-01,3,0,0,0,0,3
Georgia,2005-08-01,0,0,0,0,0,0
Georgia,2005-08-01,2,0,0,4,0,6
Georgia,2005-08-01,1,0,0,3,1,5
Georgia,2005-08-01,5,0,0,3,2,10
Georgia,2005-08-01,0,0,0,0,0,0
Georgia,2005-08-01,0,0,0,0,0,0
Georgia,2005-08-01,0,0,0,9,0,9
Georgia,2005-08-01,0,0,0,0,0,0
Georgia,2005-08-01,2,0,0,0,0,2
Georgia,2005-09-01,0,0,0,3,0,3
Georgia,2005-09-01,3,0,0,0,0,3
Georgia,2005-09-01,0,0,0,0,0,0
Georgia,2005-09-01,3,0,0,0,0,3
Georgia,2005-09-01,0,0,0,0,0,0
Georgia,2005-09-01,0,0,0,0,0,0
Georgia,2005-09-01,-3,0,0,0,0,-3
Georgia,2005-09-01,3,0,0,0,0,3
Georgia,2005-09-01,0,0,0,0,0,0
Georgia,2005-09-01,0,0,0,3,0,3
Georgia,2005-09-01,7,0,0,0,0,7
Georgia,2005-09-01,0,0,0,0,0,0
Georgia,2005-09-01,0,0,0,0,0,0
Georgia,2005-09-01,0,0,0,0,0,0
Georgia,2005-09-01,1,2,0,0,0,3
Georgia,2005-09-01,-1,0,1,0,0,0
Georgia,2005-09-01,0,0,0,3,0,3
Georgia,2005-09-01,0,0,0,0,1,1
Georgia,2005-09-01,0,0,0,6,0,6
Georgia,2005-09-01,0,0,0,0,0,0
Georgia,2005-09-01,0,0,0,0,0,0
Georgia,2005-09-01,0,0,0,0,0,0
Georgia,2005-10-01,2,0,0,0,0,2
Georgia,2005-10-01,0,0,0,0,0,0
Georgia,2005-10-01,7,0,0,0,0,7
Georgia,2005-10-01,0,0,0,0,0,0
Georgia,2005-10-01,3,0,0,3,0,6
Georgia,2005-10-01,0,0,0,0,0,0
Georgia,2005-10-01,0,0,0,0,0,0
Georgia,2005-10-01,0,0,0,3,0,3
Georgia,2005-10-01,0,0,0,0,0,0
Georgia,2005-10-01,-2,0,0,0,0,-2
Georgia,2005-10-01,0,0,0,0,1,1
Georgia,2005-10-01,6,0,0,0,0,6
Georgia,2005-10-01,0,0,0,0,0,0
Georgia,2005-10-01,0,0,0,0,0,0
Georgia,2005-10-01,0,0,0,0,0,0
Georgia,2005-10-01,0,0,0,0,0,0
Georgia,2005-10-01,3,0,0,0,0,3
Georgia,2005-11-01,4,0,0,0,0,4
Georgia,2005-11-01,6,0,0,0,0,6
Georgia,2005-11-01,0,0,0,3,0,3
Georgia,2005-11-01,0,0,0,0,0,0
Georgia,2005-11-01,-1,0,0,0,0,-1
Georgia,2005-11-01,6,2,0,-2,2,8
Georgia,2005-11-01,0,0,0,0,2,2
Georgia,2005-11-01,0,2,0,0,4,6
Georgia,2005-11-01,1,0,0,0,0,1
Georgia,2005-11-01,0,0,0,0,1,1
Georgia,2005-11-01,0,0,0,3,0,3
Georgia,2005-11-01,5,0,0,3,0,8
Georgia,2005-11-01,0,0,0,0,0,0
Georgia,2005-11-01,0,0,0,6,0,6
Georgia,2005-11-01,0,0,0,3,0,3
Georgia,2005-11-01,0,0,0,0,0,0
Georgia,2005-11-01,0,0,0,6,0,6
Georgia,2005-11-01,-3,0,0,0,0,-3
Georgia,2005-11-01,2,0,0,0,0,2
Georgia,2005-11-01,0,0,0,0,0,0
Georgia,2005-11-01,2,0,0,3,0,5
Georgia,2005-12-01,0,0,0,0,0,0
Georgia,2005-12-01,3,0,0,0,0,3
Georgia,2005-12-01,6,0,0,0,0,6
Georgia,2005-12-01,0,0,0,0,0,0
Georgia,2005-12-01,6,0,0,6,2,14
Georgia,2005-12-01,0,0,0,-1,1,0
Georgia,2005-12-01,0,0,0,0,0,0
Georgia,2005-12-01,3,0,0,3,0,6
Georgia,2005-12-01,3,0,0,3,0,6
Georgia,2005-12-01,0,0,0,-2,0,-2
Georgia,2005-12-01,6,0,0,0,0,6
Georgia,2005-12-01,1,0,0,0,0,1
Georgia,2005-12-01,0,0,0,0,0,0
Georgia,2005-12-01,0,0,0,0,0,0
Georgia,2005-12-01,0,0,0,0,0,0
Georgia,2005-12-01,1,0,0,0,0,1
Georgia,2005-12-01,-1,0,0,0,0,-1
Georgia,2005-12-01,0,0,0,0,0,0
Georgia,2005-12-01,2,0,0,0,0,2
Georgia,2005-12-01,2,0,0,-3,0,-1
India,2005-01-01,1,2,0,0,0,3
India,2005-01-01,3,0,0,9,0,12
India,2005-01-01,10,2,0,2,2,16
India,2005-01-01,13,0,0,0,0,13
India,2005-01-01,4,0,0,0,0,4
India,2005-01-01,8,0,0,0,0,8
India,2005-01-01,15,2,-1,3,2,21
India,2005-01-01,-1,0,-1,0,0,-2
India,2005-01-01,2,0,0,-4,0,-2
India,2005-01-01,4,0,0,-2,0,2
India,2005-01-01,1,2,0,-2,0,1
India,2005-01-01,0,0,0,6,0,6
India,2005-01-01,7,0,0,0,1,8
India,2005-01-01,0,0,0,0,0,0
India,2005-01-01,0,0,0,0,0,0
India,2005-01-01,0,0,0,3,2,5
India,2005-01-01,9,0,0,0,0,9
India,2005-01-01,5,0,1,0,0,6
India,2005-01-01,0,0,0,0,0,0
India,2005-01-01,2,0,0,0,0,2
India,2005-01-01,1,0,0,0,0,1
India,2005-01-01,1,0,0,3,0,4
India,2005-01-01,0,0,0,3,2,5
India,2005-01-01,0,0,0,6,1,7
India,2005-01-01,16,0,0,0,0,16
India,2005-01-01,5,0,0,3,1,9
India,2005-01-01,21,0,0,0,2,23
India,2005-01-01,1,0,0,0,0,1
India,2005-01-01,1,0,0,0,0,1
India,2005-01-01,0,2,0,0,3,5
India,2005-01-01,4,0,0,0,3,7
India,2005-02-01,21,0,0,-2,0,19
India,2005-02-01,11,0,0,0,1,12
India,2005-02-01,-1,0,0,0,0,-1
India,2005-02-01,14,0,0,6,0,20
India,2005-02-01,0,0,0,0,0,0
India,2005-02-01,2,0,0,0,0,2
India,2005-02-01,4,0,0,3,1,8
India,2005-02-01,0,0,0,0,0,0
India,2005-02-01,-7,0,0,6,2,1
India,2005-02-01,7,0,0,3,1,11
India,2005-02-01,16,0,0,3,0,19
India,2005-02-01,0,0,0,3,1,4
India,2005-02-01,1,0,0,-2,0,-1
India,2005-02-01,7,0,0,3,1,11
India,2005-02-01,6,0,0,3,3,12
India,2005-02-01,4,2,-1,0,0,5
India,2005-02-01,3,4,0,-2,1,6
India,2005-02-01,8,0,0,-2,1,7
India,2005-02-01,0,0,0,0,0,0
India,2005-02-01,3,0,0,0,0,3
India,2005-02-01,4,0,-1,0,0,3
India,2005-02-01,4,0,0,0,4,8
India,2005-02-01,12,0,0,3,1,16
India,2005-02-01,1,0,-1,9,1,10
India,2005-02-01,0,0,0,3,2,5
India,2005-02-01,15,0,0,0,0,15
India,2005-02-01,3,0,0,3,0,6
India,2005-02-01,11,0,0,0,0,11
India,2005-03-01,13,2,0,0,0,15
India,2005-03-01,3,0,0,-2,0,1
India,2005-03-01,5,0,0,0,0,5
India,2005-03-01,7,0,0,0,0,7
India,2005-03-01,-1,0,-2,3,1,1
India,2005-03-01,1,2,0,0,1,4
India,2005-03-01,14,0,0,3,3,20
India,2005-03-01,13,0,0,-4,0,9
India,2005-03-01,2,0,0,1,0,3
India,2005-03-01,4,2,0,0,0,6
India,2005-03-01,2,0,0,3,1,6
India,2005-03-01,0,4,0,0,0,4
India,2005-03-01,3,0,0,6,0,9
India,2005-03-01,19,0,0,0,2,21
India,2005-03-01,2,0,-1,-1,3,3
India,2005-03-01,0,0,0,0,1,1
India,2005-03-01,3,0,0,9,0,12
India,2005-03-01,10,0,0,0,6,16
India,2005-03-01,2,0,0,0,1,3
India,2005-03-01,2,0,0,0,0,2
India,2005-03-01,-1,0,0,-2,0,-3
India,2005-03-01,0,0,1,6,0,7
India,2005-03-01,0,0,0,3,0,3
India,2005-03-01,6,0,0,0,0,6
India,2005-03-01,0,0,0,0,0,0
India,2005-03-01,0,0,0,0,0,0
India,2005-03-01,3,0,0,0,0,3
India,2005-03-01,2,0,0,0,0,2
India,2005-03-01,1,0,0,0,0,1
India,2005-03-01,6,0,0,0,0,6
India,2005-03-01,2,0,-2,1,2,3
India,2005-04-01,10,0,0,0,1,11
India,2005-04-01,7,0,0,6,8,21
India,2005-04-01,2,0,0,0,0,2
India,2005-04-01,0,0,0,0,0,0
India,2005-04-01,0,0,0,0,0,0
India,2005-04-01,2,0,0,0,0,2
India,2005-04-01,3,0,0,0,0,3
India,2005-04-01,-1,0,0,6,0,5
India,2005-04-01,7,0,0,0,1,8
India,2005-04-01,3,0,0,-1,2,4
India,2005-04-01,6,0,0,6,0,12
India,2005-04-01,6,0,0,1,0,7
India,2005-04-01,8,0,0,3,1,12
India,2005-04-01,6,0,0,3,1,10
India,2005-04-01,4,0,0,-2,0,2
India,2005-04-01,2,0,0,0,0,2
India,2005-04-01,7,0,0,2,0,9
India,2005-04-01,8,0,0,-4,0,4
India,2005-04-01,1,0,0,0,0,1
India,2005-04-01,3,0,0,-6,0,-3
India,2005-04-01,12,0,0,0,1,13
India,2005-04-01,14,0,0,0,0,14
India,2005-04-01,7,0,0,0,0,7
India,2005-04-01,3,0,0,4,0,7
India,2005-04-01,4,0,0,2,2,8
India,2005-04-01,-1,0,-1,0,0,-2
India,2005-04-01,10,0,0,6,1,17
India,2005-04-01,8,0,0,3,0,11
India,2005-04-01,0,0,0,0,0,0
India,2005-04-01,5,0,0,-1,0,4
India,2005-05-01,4,0,0,3,0,7
India,2005-05-01,0,0,0,6,3,9
India,2005-05-01,1,0,1,6,3,11
India,2005-05-01,1,0,0,0,0,1
India,2005-05-01,5,0,0,6,0,11
India,2005-05-01,20,2,0,0,2,24
India,2005-05-01,6,0,0,18,3,27
India,2005-05-01,0,0,0,0,2,2
India,2005-05-01,-3,0,0,0,0,-3
India,2005-05-01,4,0,0,0,0,4
India,2005-05-01,4,0,0,-2,0,2
India,2005-05-01,13,0,0,0,2,15
India,2005-05-01,12,0,0,-2,3,13
India,2005-05-01,-1,0,0,0,0,-1
India,2005-05-01,-1,0,-1,3,0,1
India,2005-05-01,3,0,0,6,0,9
India,2005-05-01,3,2,0,3,0,8
India,2005-05-01,6,0,0,3,0,9
India,2005-05-01,0,0,0,3,0,3
India,2005-05-01,-1,0,0,3,0,2
India,2005-05-01,6,0,0,0,0,6
India,2005-05-01,1,0,0,0,0,1
India,2005-05-01,5,0,0,0,3,8
India,2005-05-01,-1,0,0,0,0,-1
India,2005-05-01,14,0,-3,0,3,14
India,2005-05-01,9,0,0,0,0,9
India,2005-05-01,-1,0,0,6,1,6
India,2005-05-01,0,0,0,3,0,3
India,2005-05-01,2,0,0,0,1,3
India,2005-05-01,9,0,0,0,2,11
India,2005-05-01,4,0,0,0,8,12
India,2005-06-01,1,0,0,3,0,4
India,2005-06-01,15,0,0,12,0,27
India,2005-06-01,0,2,0,0,2,4
India,2005-06-01,0,0,0,0,0,0
India,2005-06-01,8,0,0,0,0,8
India,2005-06-01,2,2,0,0,0,4
India,2005-06-01,-1,0,0,3,0,2
India,2005-06-01,7,0,0,0,0,7
India,2005-06-01,3,0,0,3,1,7
India,2005-06-01,7,0,0,2,1,10
India,2005-06-01,4,0,0,0,0,4
India,2005-06-01,-4,0,0,0,2,-2
India,2005-06-01,2,0,0,6,0,8
India,2005-06-01,3,0,0,0,0,3
India,2005-06-01,16,0,0,3,0,19
India,2005-06-01,1,0,0,6,0,7
India,2005-06-01,0,0,0,0,0,0
India,2005-06-01,1,0,0,0,3,4
India,2005-06-01,1,0,0,0,0,1
India,2005-06-01,0,0,0,3,0,3
India,2005-06-01,1,0,0,0,0,1
India,2005-06-01,5,0,0,0,0,5
India,2005-06-01,2,0,0,0,0,2
India,2005-06-01,5,0,0,3,0,8
India,2005-06-01,0,0,0,0,0,0
India,2005-06-01,2,0,0,0,0,2
India,2005-06-01,0,0,0,0,0,0
India,2005-06-01,0,0,0,0,0,0
India,2005-06-01,8,0,0,-4,7,11
India,2005-06-01,-3,0,0,0,3,0
India,2005-07-01,2,0,0,0,0,2
India,2005-07-01,0,0,0,0,0,0
India,2005-07-01,-1,0,-2,0,0,-3
India,2005-07-01,9,0,0,-2,0,7
India,2005-07-01,0,0,0,3,0,3
India,2005-07-01,12,0,0,0,0,12
India,2005-07-01,2,0,-1,0,0,1
India,2005-07-01,1,0,0,3,0,4
India,2005-07-01,0,0,0,0,0,0
India,2005-07-01,11,0,-1,0,2,12
India,2005-07-01,0,0,0,-2,1,-1
India,2005-07-01,7,0,0,0,1,8
India,2005-07-01,1,0,0,0,0,1
India,2005-07-01,2,0,0,0,0,2
India,2005-07-01,2,2,0,3,0,7
India,2005-07-01,0,0,0,3,0,3
India,2005-07-01,3,0,0,3,0,6
India,2005-07-01,6,0,0,0,0,6
India,2005-07-01,3,0,0,1,1,5
India,2005-07-01,7,0,0,-2,3,8
India,2005-07-01,11,0,0,-2,0,9
India,2005-07-01,4,0,0,0,0,4
India,2005-07-01,-2,0,0,-2,1,-3
India,2005-07-01,14,0,0,0,1,15
India,2005-07-01,3,0,0,3,0,6
India,2005-07-01,1,0,0,0,0,1
India,2005-07-01,21,0,-1,12,0,32
India,2005-07-01,3,0,0,0,0,3
India,2005-07-01,15,0,0,9,4,28
India,2005-07-01,0,0,0,0,0,0
India,2005-07-01,22,0,0,0,1,23
India,2005-08-01,2,0,0,0,0,2
India,2005-08-01,2,2,0,0,1,5
India,2005-08-01,0,0,0,0,0,0
India,2005-08-01,6,0,0,0,0,6
India,2005-08-01,7,0,0,0,1,8
India,2005-08-01,0,0,0,0,0,0
India,2005-08-01,1,0,0,0,1,2
India,2005-08-01,7,0,0,0,0,7
India,2005-08-01,3,0,0,0,0,3
India,2005-08-01,3,0,0,0,1,4
India,2005-08-01,4,0,0,6,0,10
India,2005-08-01,0,0,0,0,0,0
India,2005-08-01,3,0,0,3,0,6
India,2005-08-01,3,0,0,0,0,3
India,2005-08-01,3,0,0,9,0,12
India,2005-08-01,10,0,0,0,0,10
India,2005-08-01,3,0,0,0,4,7
India,2005-08-01,0,0,0,0,0,0
India,2005-08-01,4,0,0,0,1,5
India,2005-08-01,0,0,0,0,0,0
India,2005-08-01,1,0,0,0,0,1
India,2005-08-01,0,0,0,0,0,0
India,2005-08-01,1,0,0,3,0,4
India,2005-08-01,13,0,0,-6,0,7
India,2005-08-01,3,0,0,3,1,7
India,2005-08-01,4,0,0,0,0,4
India,2005-08-01,6,0,0,3,0,9
India,2005-08-01,11,0,0,0,0,11
India,2005-08-01,1,0,0,0,2,3
India,2005-08-01,12,0,0,0,1,13
India,2005-08-01,3,0,0,0,1,4
India,2005-09-01,7,0,0,3,0,10
India,2005-09-01,13,2,0,0,0,15
India,2005-09-01,-1,0,0,0,0,-1
India,2005-09-01,0,0,0,1,0,1
India,2005-09-01,3,0,0,0,0,3
India,2005-09-01,1,0,0,0,1,2
India,2005-09-01,12,0,0,3,3,18
India,2005-09-01,2,0,0,0,0,2
India,2005-09-01,12,0,0,-1,1,12
India,2005-09-01,0,0,0,0,1,1
India,2005-09-01,2,0,0,0,0,2
India,2005-09-01,4,0,0,-6,0,-2
India,2005-09-01,14,0,0,0,0,14
India,2005-09-01,-2,0,-1,0,0,-3
India,2005-09-01,-4,0,0,6,0,2
India,2005-09-01,5,0,0,-1,0,4
India,2005-09-01,0,0,0,0,0,0
India,2005-09-01,2,0,0,0,0,2
India,2005-09-01,2,2,1,3,0,8
India,2005-09-01,2,0,0,0,0,2
India,2005-09-01,4,0,0,0,0,4
India,2005-09-01,3,0,0,0,0,3
India,2005-09-01,0,0,0,0,0,0
India,2005-09-01,1,0,0,0,0,1
India,2005-09-01,6,0,0,0,0,6
India,2005-09-01,-1,0,-1,0,1,-1
India,2005-09-01,2,0,-1,0,0,1
India,2005-09-01,5,0,1,0,0,6
India,2005-09-01,14,0,0,0,0,14
India,2005-09-01,5,0,0,9,0,14
India,2005-10-01,0,0,0,0,0,0
India,2005-10-01,0,0,0,0,1,1
India,2005-10-01,0,0,0,0,0,0
India,2005-10-01,3,0,0,0,0,3
India,2005-10-01,16,0,0,-4,4,16
India,2005-10-01,3,0,0,3,0,6
India,2005-10-01,3,0,0,0,0,3
India,2005-10-01,5,0,0,-2,0,3
India,2005-10-01,4,2,0,3,0,9
India,2005-10-01,2,0,0,-2,4,4
India,2005-10-01,2,0,0,3,4,9
India,2005-10-01,1,0,0,3,0,4
India,2005-10-01,7,0,0,0,0,7
India,2005-10-01,6,0,0,0,0,6
India,2005-10-01,2,0,0,0,0,2
India,2005-10-01,4,0,0,0,0,4
India,2005-10-01,7,0,0,0,0,7
India,2005-10-01,14,0,0,3,0,17
India,2005-10-01,7,0,0,6,0,13
India,2005-10-01,26,0,0,0,0,26
India,2005-10-01,0,0,0,3,0,3
India,2005-10-01,7,2,0,3,0,12
India,2005-10-01,0,0,0,3,0,3
India,2005-10-01,5,0,0,0,0,5
India,2005-10-01,2,0,0,0,2,4
India,2005-10-01,0,0,0,9,0,9
India,2005-10-01,0,0,0,0,1,1
India,2005-10-01,3,0,0,3,0,6
India,2005-10-01,7,0,-1,3,0,9
India,2005-10-01,0,0,0,0,0,0
India,2005-10-01,-3,0,0,6,0,3
India,2005-11-01,5,0,0,0,4,9
India,2005-11-01,4,0,0,0,3,7
India,2005-11-01,3,0,-2,0,1,2
India,2005-11-01,3,0,0,0,0,3
India,2005-11-01,1,0,0,0,0,1
India,2005-11-01,6,0,0,0,0,6
India,2005-11-01,3,0,-2,0,2,3
India,2005-11-01,9,2,0,-2,0,9
India,2005-11-01,1,0,0,-4,0,-3
India,2005-11-01,15,0,-4,-2,0,9
India,2005-11-01,5,2,0,0,0,7
India,2005-11-01,0,0,0,3,0,3
India,2005-11-01,0,0,1,0,0,1
India,2005-11-01,15,0,-1,0,0,14
India,2005-11-01,2,0,0,0,0,2
India,2005-11-01,6,0,0,0,0,6
India,2005-11-01,0,0,0,0,0,0
India,2005-11-01,0,0,0,0,1,1
India,2005-11-01,3,0,0,0,0,3
India,2005-11-01,0,0,0,3,0,3
India,2005-11-01,12,0,0,0,1,13
India,2005-11-01,4,0,0,0,1,5
India,2005-11-01,3,0,0,0,0,3
India,2005-11-01,3,0,0,0,1,4
India,2005-11-01,2,0,0,0,0,2
India,2005-11-01,0,2,0,0,0,2
India,2005-11-01,0,0,0,0,0,0
India,2005-11-01,15,0,0,-6,0,9
India,2005-11-01,-4,0,0,0,0,-4
India,2005-12-01,-1,0,0,0,2,1
India,2005-12-01,0,0,0,0,0,0
India,2005-12-01,0,0,0,0,0,0
India,2005-12-01,5,0,0,12,3,20
India,2005-12-01,4,0,0,0,2,6
India,2005-12-01,3,0,0,-6,0,-3
India,2005-12-01,4,0,0,0,2,6
India,2005-12-01,8,0,0,6,0,14
India,2005-12-01,7,0,0,0,1,8
India,2005-12-01,2,0,0,0,0,2
India,2005-12-01,0,0,0,3,0,3
India,2005-12-01,0,0,0,3,0,3
India,2005-12-01,3,0,0,0,0,3
India,2005-12-01,6,0,0,10,1,17
India,2005-12-01,3,0,0,0,0,3
India,2005-12-01,6,0,0,0,0,6
India,2005-12-01,12,0,0,3,0,15
India,2005-12-01,0,0,0,0,6,6
India,2005-12-01,0,0,0,0,0,0
India,2005-12-01,0,0,0,3,0,3
India,2005-12-01,0,0,0,0,0,0
India,2005-12-01,0,0,-1,-3,0,-4
India,2005-12-01,7,0,-2,6,0,11
India,2005-12-01,5,0,-1,0,0,4
India,2005-12-01,0,0,0,0,1,1
India,2005-12-01,4,0,0,0,0,4
India,2005-12-01,-3,0,0,0,1,-2
India,2005-12-01,3,0,0,0,0,3
India,2005-12-01,8,0,0,3,0,11
India,2005-12-01,5,0,0,3,0,8
India,2005-12-01,6,0,0,0,1,7
Iran,2005-01-01,0,0,0,9,0,9
Iran,2005-01-01,4,0,0,0,0,4
Iran,2005-01-01,-7,0,0,6,0,-1
Iran,2005-01-01,4,0,0,0,2,6
Iran,2005-01-01,5,0,0,0,0,5
Iran,2005-01-01,13,0,2,13,0,28
Iran,2005-01-01,15,0,0,3,5,23
Iran,2005-01-01,16,0,0,9,0,25
Iran,2005-01-01,6,0,0,3,6,15
Iran,2005-01-01,4,0,0,9,0,13
Iran,2005-01-01,5,2,-1,6,2,14
Iran,2005-01-01,12,0,0,10,2,24
Iran,2005-01-01,13,0,0,6,1,20
Iran,2005-01-01,-1,0,0,0,0,-1
Iran,2005-01-01,17,0,0,-1,0,16
Iran,2005-01-01,12,0,0,9,0,21
Iran,2005-01-01,10,0,0,11,0,21
Iran,2005-01-01,22,0,0,9,0,31
Iran,2005-01-01,5,2,0,9,0,16
Iran,2005-01-01,19,0,0,5,0,24
Iran,2005-01-01,20,0,0,-4,0,16
Iran,2005-01-01,3,0,0,6,0,9
Iran,2005-01-01,31,0,0,26,0,57
Iran,2005-01-01,6,0,0,15,1,22
Iran,2005-01-01,2,0,0,15,1,18
Iran,2005-01-01,9,0,0,0,2,11
Iran,2005-01-01,30,0,0,0,0,30
Iran,2005-01-01,2,0,0,1,9,12
Iran,2005-01-01,25,0,0,0,9,34
Iran,2005-01-01,2,0,0,6,1,9
Iran,2005-01-01,9,0,-2,3,2,12
Iran,2005-02-01,8,0,-2,3,1,10
Iran,2005-02-01,6,0,0,-2,0,4
Iran,2005-02-01,-1,0,0,3,2,4
Iran,2005-02-01,9,0,0,0,0,9
Iran,2005-02-01,14,0,0,0,0,14
Iran,2005-02-01,19,0,2,-2,1,20
Iran,2005-02-01,6,0,0,-7,3,2
Iran,2005-02-01,7,0,0,6,0,13
Iran,2005-02-01,21,0,0,12,0,33
Iran,2005-02-01,11,0,4,14,5,34
Iran,2005-02-01,2,0,0,6,0,8
Iran,2005-02-01,-3,0,0,3,0,0
Iran,2005-02-01,31,2,0,0,0,33
Iran,2005-02-01,12,0,0,-2,2,12
Iran,2005-02-01,8,0,0,1,0,9
Iran,2005-02-01,19,2,2,7,0,30
Iran,2005-02-01,9,0,0,2,0,11
Iran,2005-02-01,3,0,0,0,0,3
Iran,2005-02-01,6,0,0,1,0,7
Iran,2005-02-01,4,0,0,0,1,5
Iran,2005-02-01,-1,0,0,8,2,9
Iran,2005-02-01,11,0,0,6,11,28
Iran,2005-02-01,4,0,0,-2,4,6
Iran,2005-02-01,12,0,2,-2,2,14
Iran,2005-02-01,1,0,0,15,2,18
Iran,2005-02-01,2,0,0,0,4,6
Iran,2005-02-01,3,0,0,0,0,3
Iran,2005-02-01,6,0,0,3,0,9
Iran,2005-03-01,7,0,0,8,4,19
Iran,2005-03-01,6,0,-2,0,1,5
Iran,2005-03-01,9,0,0,-7,2,4
Iran,2005-03-01,5,0,0,-3,1,3
Iran,2005-03-01,4,0,0,0,0,4
Iran,2005-03-01,2,0,0,-4,0,-2
Iran,2005-03-01,13,0,0,20,1,34
Iran,2005-03-01,22,0,1,22,2,47
Iran,2005-03-01,22,0,0,12,1,35
Iran,2005-03-01,3,0,0,0,16,19
Iran,2005-03-01,-4,0,0,9,3,8
Iran,2005-03-01,3,0,0,-6,0,-3
Iran,2005-03-01,3,0,0,0,0,3
Iran,2005-03-01,3,0,-2,3,0,4
Iran,2005-03-01,7,0,0,-4,0,3
Iran,2005-03-01,13,0,0,6,0,19
Iran,2005-03-01,10,2,1,-1,0,12
Iran,2005-03-01,1,0,-1,11,0,11
Iran,2005-03-01,2,0,0,0,0,2
Iran,2005-03-01,12,0,0,0,3,15
Iran,2005-03-01,3,0,0,0,0,3
Iran,2005-03-01,2,0,0,4,0,6
Iran,2005-03-01,8,0,0,-3,0,5
Iran,2005-03-01,5,0,-3,0,0,2
Iran,2005-03-01,8,0,0,-6,0,2
Iran,2005-03-01,2,0,0,21,4,27
Iran,2005-03-01,20,0,0,54,0,74
Iran,2005-03-01,7,0,0,0,0,7
Iran,2005-03-01,-1,0,0,9,0,8
Iran,2005-03-01,-4,0,0,0,0,-4
Iran,2005-03-01,4,0,0,0,0,4
Iran,2005-04-01,8,0,0,3,5,16
Iran,2005-04-01,5,0,1,1,2,9
Iran,2005-04-01,3,0,0,-2,4,5
Iran,2005-04-01,8,0,0,0,4,12
Iran,2005-04-01,13,0,0,2,1,16
Iran,2005-04-01,19,0,0,6,1,26
Iran,2005-04-01,18,0,0,4,0,22
Iran,2005-04-01,3,0,0,0,1,4
Iran,2005-04-01,4,0,0,6,0,10
Iran,2005-04-01,18,0,1,3,0,22
Iran,2005-04-01,5,0,0,0,1,6
Iran,2005-04-01,12,0,0,3,6,21
Iran,2005-04-01,-2,0,0,0,0,-2
Iran,2005-04-01,12,0,0,3,1,16
Iran,2005-04-01,8,0,0,0,0,8
Iran,2005-04-01,10,0,0,3,0,13
Iran,2005-04-01,4,0,1,1,3,9
Iran,2005-04-01,4,0,0,3,0,7
Iran,2005-04-01,11,0,0,0,0,11
Iran,2005-04-01,12,0,0,0,3,15
Iran,2005-04-01,5,0,0,0,0,5
Iran,2005-04-01,1,0,0,0,0,1
Iran,2005-04-01,4,0,0,0,0,4
Iran,2005-04-01,4,0,-2,-6,0,-4
Iran,2005-04-01,16,0,0,7,0,23
Iran,2005-04-01,6,0,0,6,0,12
Iran,2005-04-01,9,0,0,0,0,9
Iran,2005-04-01,1,0,0,6,0,7
Iran,2005-04-01,9,0,0,3,2,14
Iran,2005-04-01,23,0,0,6,0,29
Iran,2005-05-01,3,0,0,0,3,6
Iran,2005-05-01,0,0,0,3,0,3
Iran,2005-05-01,13,0,0,12,0,25
Iran,2005-05-01,15,0,0,4,1,20
Iran,2005-05-01,2,0,2,7,2,13
Iran,2005-05-01,3,0,0,6,0,9
Iran,2005-05-01,2,0,0,6,0,8
Iran,2005-05-01,11,0,0,-4,0,7
Iran,2005-05-01,3,0,0,3,0,6
Iran,2005-05-01,8,0,0,0,1,9
Iran,2005-05-01,5,0,1,0,4,10
Iran,2005-05-01,8,0,0,-3,2,7
Iran,2005-05-01,3,0,0,5,1,9
Iran,2005-05-01,6,0,0,16,8,30
Iran,2005-05-01,4,0,0,5,0,9
Iran,2005-05-01,0,0,2,15,-6,11
Iran,2005-05-01,6,0,0,-4,2,4
Iran,2005-05-01,18,0,0,7,3,28
Iran,2005-05-01,30,0,0,18,1,49
Iran,2005-05-01,12,0,0,3,1,16
Iran,2005-05-01,6,0,0,0,0,6
Iran,2005-05-01,-1,0,0,4,2,5
Iran,2005-05-01,9,0,-5,-2,0,2
Iran,2005-05-01,1,0,1,20,1,23
Iran,2005-05-01,0,0,0,3,0,3
Iran,2005-05-01,-2,0,0,0,0,-2
Iran,2005-05-01,1,0,0,1,3,5
Iran,2005-05-01,4,0,0,1,2,7
Iran,2005-05-01,25,0,2,6,3,36
Iran,2005-05-01,17,0,0,15,0,32
Iran,2005-05-01,21,0,0,3,2,26
Iran,2005-06-01,2,0,0,4,1,7
Iran,2005-06-01,13,0,0,-4,3,12
Iran,2005-06-01,2,0,0,3,5,10
Iran,2005-06-01,0,0,0,0,0,0
Iran,2005-06-01,7,0,0,0,0,7
Iran,2005-06-01,6,0,0,2,0,8
Iran,2005-06-01,2,0,1,3,0,6
Iran,2005-06-01,8,0,0,1,3,12
Iran,2005-06-01,5,0,-4,3,0,4
Iran,2005-06-01,29,0,0,12,0,41
Iran,2005-06-01,4,0,0,0,0,4
Iran,2005-06-01,8,0,0,6,0,14
Iran,2005-06-01,12,0,0,4,1,17
Iran,2005-06-01,20,0,0,-4,1,17
Iran,2005-06-01,0,0,0,-1,0,-1
Iran,2005-06-01,2,0,0,6,4,12
Iran,2005-06-01,4,0,2,23,14,43
Iran,2005-06-01,14,0,0,0,1,15
Iran,2005-06-01,-3,0,0,3,8,8
Iran,2005-06-01,0,0,0,0,3,3
Iran,2005-06-01,3,0,0,3,0,6
Iran,2005-06-01,8,0,0,-1,1,8
Iran,2005-06-01,9,0,0,6,1,16
Iran,2005-06-01,4,0,0,3,5,12
Iran,2005-06-01,7,0,0,-2,0,5
Iran,2005-06-01,-1,0,0,-4,0,-5
Iran,2005-06-01,13,0,0,-2,1,12
Iran,2005-06-01,6,0,-1,9,0,14
Iran,2005-06-01,24,0,0,3,0,27
Iran,2005-06-01,6,0,0,2,1,9
Iran,2005-07-01,7,0,0,0,6,13
Iran,2005-07-01,3,0,0,0,0,3
Iran,2005-07-01,14,0,0,-14,2,2
Iran,2005-07-01,30,0,0,-4,0,26
Iran,2005-07-01,19,0,-2,2,2,21
Iran,2005-07-01,22,0,0,-1,0,21
Iran,2005-07-01,0,0,0,7,0,7
Iran,2005-07-01,0,0,0,0,0,0
Iran,2005-07-01,0,4,0,0,0,4
Iran,2005-07-01,3,0,0,-4,0,-1
Iran,2005-07-01,0,0,0,0,0,0
Iran,2005-07-01,6,0,0,0,0,6
Iran,2005-07-01,17,0,0,6,11,34
Iran,2005-07-01,18,0,0,3,1,22
Iran,2005-07-01,1,0,0,7,0,8
Iran,2005-07-01,1,0,0,2,0,3
Iran,2005-07-01,4,0,0,6,3,13
Iran,2005-07-01,9,0,0,0,0,9
Iran,2005-07-01,4,0,0,9,0,13
Iran,2005-07-01,12,0,0,4,5,21
Iran,2005-07-01,2,0,-1,3,0,4
Iran,2005-07-01,5,0,0,0,1,6
Iran,2005-07-01,16,0,0,0,0,16
Iran,2005-07-01,12,0,0,0,0,12
Iran,2005-07-01,5,0,0,0,0,5
Iran,2005-07-01,3,0,0,3,0,6
Iran,2005-07-01,7,0,0,-4,0,3
Iran,2005-07-01,1,0,0,-4,0,-3
Iran,2005-07-01,0,0,0,0,0,0
Iran,2005-07-01,2,0,0,2,4,8
Iran,2005-07-01,1,0,0,0,0,1
Iran,2005-08-01,6,0,0,0,0,6
Iran,2005-08-01,4,0,0,9,3,16
Iran,2005-08-01,8,0,0,0,1,9
Iran,2005-08-01,6,0,0,3,5,14
Iran,2005-08-01,14,0,-1,6,2,21
Iran,2005-08-01,12,0,0,-2,1,11
Iran,2005-08-01,2,0,-6,0,0,-4
Iran,2005-08-01,6,0,0,6,0,12
Iran,2005-08-01,20,0,1,1,5,27
Iran,2005-08-01,19,0,1,0,2,22
Iran,2005-08-01,12,0,0,6,4,22
Iran,2005-08-01,11,0,0,3,1,15
Iran,2005-08-01,0,0,0,3,0,3
Iran,2005-08-01,9,0,0,9,0,18
Iran,2005-08-01,9,0,0,-4,1,6
Iran,2005-08-01,-1,0,0,0,0,-1
Iran,2005-08-01,1,0,0,0,0,1
Iran,2005-08-01,3,0,0,3,0,6
Iran,2005-08-01,6,0,0,-7,1,0
Iran,2005-08-01,3,0,0,0,0,3
Iran,2005-08-01,17,0,0,9,0,26
Iran,2005-08-01,4,0,0,1,0,5
Iran,2005-08-01,20,0,0,9,5,34
Iran,2005-08-01,9,0,0,7,4,20
Iran,2005-08-01,15,0,0,-5,2,12
Iran,2005-08-01,8,0,0,0,1,9
Iran,2005-08-01,5,0,0,-1,0,4
Iran,2005-08-01,29,0,0,0,0,29
Iran,2005-08-01,10,0,0,4,0,14
Iran,2005-08-01,0,0,0,0,3,3
Iran,2005-08-01,37,0,0,0,7,44
Iran,2005-09-01,3,0,0,-5,0,-2
Iran,2005-09-01,4,0,-2,0,0,2
Iran,2005-09-01,0,0,0,0,0,0
Iran,2005-09-01,2,0,0,-1,0,1
Iran,2005-09-01,10,0,0,6,0,16
Iran,2005-09-01,0,0,0,1,0,1
Iran,2005-09-01,10,2,-2,7,0,17
Iran,2005-09-01,4,0,0,0,0,4
Iran,2005-09-01,1,0,0,0,0,1
Iran,2005-09-01,5,0,0,7,0,12
Iran,2005-09-01,2,0,0,3,0,5
Iran,2005-09-01,6,0,0,9,0,15
Iran,2005-09-01,0,0,0,0,0,0
Iran,2005-09-01,18,0,0,7,5,30
Iran,2005-09-01,35,0,0,0,1,36
Iran,2005-09-01,7,0,0,6,1,14
Iran,2005-09-01,18,0,0,6,0,24
Iran,2005-09-01,13,0,0,9,0,22
Iran,2005-09-01,2,0,0,1,1,4
Iran,2005-09-01,16,0,0,0,0,16
Iran,2005-09-01,15,0,1,-6,4,14
Iran,2005-09-01,23,0,0,7,6,36
Iran,2005-09-01,6,0,0,22,1,29
Iran,2005-09-01,17,0,1,0,0,18
Iran,2005-09-01,5,0,0,6,0,11
Iran,2005-09-01,7,0,0,7,0,14
Iran,2005-09-01,4,0,0,3,0,7
Iran,2005-09-01,14,0,0,9,2,25
Iran,2005-09-01,-2,0,0,7,9,14
Iran,2005-09-01,0,0,0,0,0,0
Iran,2005-10-01,16,0,0,3,0,19
Iran,2005-10-01,8,0,0,9,2,19
Iran,2005-10-01,4,0,0,1,0,5
Iran,2005-10-01,24,0,0,0,0,24
Iran,2005-10-01,5,0,0,-2,0,3
Iran,2005-10-01,12,0,0,0,1,13
Iran,2005-10-01,-2,0,1,2,0,1
Iran,2005-10-01,1,0,0,0,0,1
Iran,2005-10-01,6,0,0,-4,1,3
Iran,2005-10-01,6,0,0,0,0,6
Iran,2005-10-01,1,0,0,3,0,4
Iran,2005-10-01,12,0,0,12,0,24
Iran,2005-10-01,14,0,0,0,0,14
Iran,2005-10-01,18,0,0,0,0,18
Iran,2005-10-01,19,0,0,15,12,46
Iran,2005-10-01,12,0,-1,0,1,12
Iran,2005-10-01,26,4,0,1,1,32
Iran,2005-10-01,22,0,0,18,0,40
Iran,2005-10-01,20,0,0,7,2,29
Iran,2005-10-01,6,0,0,3,1,10
Iran,2005-10-01,0,0,0,0,2,2
Iran,2005-10-01,0,0,-2,15,2,15
Iran,2005-10-01,5,0,0,6,2,13
Iran,2005-10-01,9,0,0,3,0,12
Iran,2005-10-01,3,0,0,15,0,18
Iran,2005-10-01,20,0,0,-2,3,21
Iran,2005-10-01,15,0,-3,15,3,30
Iran,2005-10-01,33,0,0,9,6,48
Iran,2005-10-01,6,0,0,3,1,10
Iran,2005-10-01,2,0,0,9,3,14
Iran,2005-10-01,9,0,0,11,0,20
Iran,2005-11-01,12,4,0,0,1,17
Iran,2005-11-01,14,0,0,1,3,18
Iran,2005-11-01,10,0,0,-7,1,4
Iran,2005-11-01,10,0,1,1,1,13
Iran,2005-11-01,23,0,0,3,0,26
Iran,2005-11-01,13,0,0,3,0,16
Iran,2005-11-01,14,0,0,0,0,14
Iran,2005-11-01,16,0,0,4,1,21
Iran,2005-11-01,22,0,0,-8,0,14
Iran,2005-11-01,24,0,0,0,3,27
Iran,2005-11-01,13,0,0,-2,2,13
Iran,2005-11-01,-1,0,0,0,0,-1
Iran,2005-11-01,9,0,0,0,1,10
Iran,2005-11-01,9,0,0,0,0,9
Iran,2005-11-01,16,0,0,-4,4,16
Iran,2005-11-01,14,0,1,9,0,24
Iran,2005-11-01,6,2,0,4,0,12
Iran,2005-11-01,16,0,0,3,9,28
Iran,2005-11-01,12,0,0,3,7,22
Iran,2005-11-01,5,0,0,0,0,5
Iran,2005-11-01,9,0,0,6,0,15
Iran,2005-11-01,4,0,0,9,0,13
Iran,2005-11-01,24,0,0,3,0,27
Iran,2005-11-01,10,0,0,2,5,17
Iran,2005-11-01,11,0,0,0,0,11
Iran,2005-11-01,12,0,0,13,2,27
Iran,2005-11-01,0,0,0,9,14,23
Iran,2005-11-01,6,0,0,3,1,10
Iran,2005-11-01,-4,0,0,11,1,8
Iran,2005-11-01,-2,0,0,-12,2,-12
Iran,2005-12-01,37,0,0,17,0,54
Iran,2005-12-01,5,0,0,-2,0,3
Iran,2005-12-01,5,0,0,0,0,5
Iran,2005-12-01,10,0,0,6,0,16
Iran,2005-12-01,31,0,0,6,0,37
Iran,2005-12-01,-1,0,0,-2,3,0
Iran,2005-12-01,7,0,2,0,0,9
Iran,2005-12-01,21,0,0,0,0,21
Iran,2005-12-01,15,0,0,0,0,15
Iran,2005-12-01,21,0,0,0,0,21
Iran,2005-12-01,21,0,0,18,1,40
Iran,2005-12-01,29,0,0,12,0,41
Iran,2005-12-01,6,0,0,1,0,7
Iran,2005-12-01,4,0,0,7,2,13
Iran,2005-12-01,23,0,0,1,2,26
Iran,2005-12-01,12,0,0,12,4,28
Iran,2005-12-01,31,0,0,1,0,32
Iran,2005-12-01,10,0,0,1,0,11
Iran,2005-12-01,13,0,0,3,2,18
Iran,2005-12-01,9,0,0,0,2,11
Iran,2005-12-01,34,0,0,11,4,49
Iran,2005-12-01,3,0,0,1,0,4
Iran,2005-12-01,5,0,0,12,2,19
Iran,2005-12-01,7,0,0,11,0,18
Iran,2005-12-01,6,0,0,9,2,17
Iran,2005-12-01,3,0,0,0,0,3
Iran,2005-12-01,11,0,0,18,1,30
Iran,2005-12-01,9,0,0,5,0,14
Iran,2005-12-01,3,0,0,-2,9,10
Iran,2005-12-01,2,0,0,0,0,2
Iran,2005-12-01,8,0,0,3,2,13
Iraq,2005-01-01,17,0,1,46,3,67
Iraq,2005-01-01,77,0,-3,7,9,90
Iraq,2005-01-01,29,0,0,10,8,47
Iraq,2005-01-01,26,6,0,13,9,54
Iraq,2005-01-01,68,6,3,27,12,116
Iraq,2005-01-01,22,2,2,42,22,90
Iraq,2005-01-01,21,0,0,9,11,41
Iraq,2005-01-01,36,0,3,45,10,94
Iraq,2005-01-01,33,0,1,22,1,57
Iraq,2005-01-01,26,0,1,21,4,52
Iraq,2005-01-01,75,0,0,2,13,90
Iraq,2005-01-01,93,4,0,31,6,134
Iraq,2005-01-01,58,0,0,30,11,99
Iraq,2005-01-01,20,0,0,6,7,33
Iraq,2005-01-01,54,0,0,16,3,73
Iraq,2005-01-01,28,0,0,16,13,57
Iraq,2005-01-01,70,0,0,28,16,114
Iraq,2005-01-01,96,2,-1,15,11,123
Iraq,2005-01-01,70,0,-1,32,8,109
Iraq,2005-01-01,113,0,2,10,19,144
Iraq,2005-01-01,32,0,-2,44,5,79
Iraq,2005-01-01,20,0,-1,11,4,34
Iraq,2005-01-01,60,2,-2,40,9,109
Iraq,2005-01-01,89,0,0,70,6,165
Iraq,2005-01-01,70,2,0,10,11,93
Iraq,2005-01-01,103,0,-1,30,9,141
Iraq,2005-01-01,88,0,-6,23,17,122
Iraq,2005-01-01,91,0,-4,14,89,190
Iraq,2005-01-01,59,0,0,16,26,101
Iraq,2005-01-01,123,0,3,15,47,188
Iraq,2005-01-01,148,8,1,-5,22,174
Iraq,2005-02-01,87,2,3,20,14,126
Iraq,2005-02-01,36,0,0,25,9,70
Iraq,2005-02-01,99,2,0,16,12,129
Iraq,2005-02-01,24,0,-2,20,2,44
Iraq,2005-02-01,52,10,-1,43,11,115
Iraq,2005-02-01,33,2,0,-9,3,29
Iraq,2005-02-01,58,2,-2,5,16,79
Iraq,2005-02-01,37,0,-1,7,6,49
Iraq,2005-02-01,72,2,2,14,8,98
Iraq,2005-02-01,24,0,-1,18,5,46
Iraq,2005-02-01,32,0,1,1,9,43
Iraq,2005-02-01,24,0,0,1,3,28
Iraq,2005-02-01,80,0,-1,35,11,125
Iraq,2005-02-01,47,0,3,11,16,77
Iraq,2005-02-01,38,2,-2,7,10,55
Iraq,2005-02-01,55,2,2,9,6,74
Iraq,2005-02-01,23,0,-2,20,12,53
Iraq,2005-02-01,58,0,0,22,0,80
Iraq,2005-02-01,52,0,1,6,7,66
Iraq,2005-02-01,22,0,-2,14,1,35
Iraq,2005-02-01,43,2,1,25,4,75
Iraq,2005-02-01,50,0,3,16,8,77
Iraq,2005-02-01,99,0,-2,45,10,152
Iraq,2005-02-01,44,0,0,35,7,86
Iraq,2005-02-01,53,0,1,57,3,114
Iraq,2005-02-01,37,0,0,1,11,49
Iraq,2005-02-01,23,0,-2,27,3,51
Iraq,2005-02-01,54,0,3,-3,8,62
Iraq,2005-03-01,19,4,4,12,10,49
Iraq,2005-03-01,48,0,0,-10,11,49
Iraq,2005-03-01,62,2,-1,-2,3,64
Iraq,2005-03-01,13,0,1,10,2,26
Iraq,2005-03-01,12,0,0,13,1,26
Iraq,2005-03-01,13,0,0,9,0,22
Iraq,2005-03-01,35,6,1,17,-2,57
Iraq,2005-03-01,87,0,1,0,5,93
Iraq,2005-03-01,59,0,0,20,0,79
Iraq,2005-03-01,58,0,0,14,9,81
Iraq,2005-03-01,40,0,2,11,0,53
Iraq,2005-03-01,2,0,0,11,6,19
Iraq,2005-03-01,81,0,0,12,6,99
Iraq,2005-03-01,48,0,1,30,0,79
Iraq,2005-03-01,32,0,0,9,3,44
Iraq,2005-03-01,49,2,2,22,10,85
Iraq,2005-03-01,56,0,0,22,14,92
Iraq,2005-03-01,30,0,0,32,4,66
Iraq,2005-03-01,23,0,0,-4,12,31
Iraq,2005-03-01,58,2,0,27,31,118
Iraq,2005-03-01,50,0,0,25,7,82
Iraq,2005-03-01,14,0,3,18,2,37
Iraq,2005-03-01,39,0,0,10,6,55
Iraq,2005-03-01,42,0,0,1,8,51
Iraq,2005-03-01,14,0,2,-2,3,17
Iraq,2005-03-01,24,0,0,-4,5,25
Iraq,2005-03-01,15,0,0,23,5,43
Iraq,2005-03-01,44,0,0,28,1,73
Iraq,2005-03-01,56,0,1,29,7,93
Iraq,2005-03-01,25,0,0,36,2,63
Iraq,2005-03-01,19,0,-8,25,4,40
Iraq,2005-04-01,23,0,-6,25,4,46
Iraq,2005-04-01,18,0,0,-2,4,20
Iraq,2005-04-01,23,0,0,0,0,23
Iraq,2005-04-01,47,0,0,23,5,75
Iraq,2005-04-01,21,0,-3,16,3,37
Iraq,2005-04-01,57,0,1,5,3,66
Iraq,2005-04-01,10,0,0,9,4,23
Iraq,2005-04-01,5,0,-1,6,8,18
Iraq,2005-04-01,6,0,0,3,0,9
Iraq,2005-04-01,9,0,-8,2,1,4
Iraq,2005-04-01,25,0,0,23,1,49
Iraq,2005-04-01,26,0,0,63,12,101
Iraq,2005-04-01,55,0,2,23,2,82
Iraq,2005-04-01,34,0,0,9,1,44
Iraq,2005-04-01,30,0,0,-2,1,29
Iraq,2005-04-01,6,0,0,0,2,8
Iraq,2005-04-01,-2,0,0,0,0,-2
Iraq,2005-04-01,18,0,0,8,6,32
Iraq,2005-04-01,39,2,0,4,5,50
Iraq,2005-04-01,22,0,1,12,5,40
Iraq,2005-04-01,67,0,-4,28,2,93
Iraq,2005-04-01,51,0,0,3,4,58
Iraq,2005-04-01,23,0,2,8,10,43
Iraq,2005-04-01,11,0,0,6,1,18
Iraq,2005-04-01,35,0,0,17,0,52
Iraq,2005-04-01,48,0,0,-2,7,53
Iraq,2005-04-01,19,0,0,51,10,80
Iraq,2005-04-01,49,0,-1,60,3,111
Iraq,2005-04-01,79,2,2,8,3,94
Iraq,2005-04-01,62,0,1,6,2,71
Iraq,2005-05-01,19,0,3,34,1,57
Iraq,2005-05-01,59,0,0,38,5,102
Iraq,2005-05-01,65,0,0,5,1,71
Iraq,2005-05-01,49,0,-4,35,0,80
Iraq,2005-05-01,39,0,-3,30,15,81
Iraq,2005-05-01,40,0,-2,25,20,83
Iraq,2005-05-01,9,0,-1,-1,11,18
Iraq,2005-05-01,49,0,-4,30,4,79
Iraq,2005-05-01,26,0,1,18,4,49
Iraq,2005-05-01,44,6,0,21,9,80
Iraq,2005-05-01,43,0,-2,24,3,68
Iraq,2005-05-01,37,0,-4,26,2,61
Iraq,2005-05-01,25,0,0,19,4,48
Iraq,2005-05-01,53,0,0,10,9,72
Iraq,2005-05-01,20,2,0,3,6,31
Iraq,2005-05-01,40,0,1,23,6,70
Iraq,2005-05-01,31,0,0,34,4,69
Iraq,2005-05-01,45,2,0,52,2,101
Iraq,2005-05-01,32,0,1,27,8,68
Iraq,2005-05-01,76,2,0,33,8,119
Iraq,2005-05-01,4,0,0,26,4,34
Iraq,2005-05-01,22,0,0,22,4,48
Iraq,2005-05-01,30,0,0,19,10,59
Iraq,2005-05-01,34,2,0,20,2,58
Iraq,2005-05-01,47,0,1,21,5,74
Iraq,2005-05-01,36,2,0,3,0,41
Iraq,2005-05-01,22,0,0,15,6,43
Iraq,2005-05-01,48,0,0,9,27,84
Iraq,2005-05-01,36,0,0,21,8,65
Iraq,2005-05-01,16,0,0,28,0,44
Iraq,2005-05-01,52,0,0,16,3,71
Iraq,2005-06-01,50,0,0,28,16,94
Iraq,2005-06-01,28,0,0,3,11,42
Iraq,2005-06-01,11,0,0,11,0,22
Iraq,2005-06-01,20,0,0,9,8,37
Iraq,2005-06-01,14,0,0,24,0,38
Iraq,2005-06-01,34,0,-4,13,1,44
Iraq,2005-06-01,33,0,0,27,4,64
Iraq,2005-06-01,59,0,0,15,2,76
Iraq,2005-06-01,25,0,0,12,4,41
Iraq,2005-06-01,26,0,0,19,8,53
Iraq,2005-06-01,25,0,0,19,2,46
Iraq,2005-06-01,27,0,0,10,3,40
Iraq,2005-06-01,44,0,0,-6,0,38
Iraq,2005-06-01,19,4,0,10,2,35
Iraq,2005-06-01,72,0,0,-6,5,71
Iraq,2005-06-01,68,0,0,36,8,112
Iraq,2005-06-01,27,0,0,16,5,48
Iraq,2005-06-01,44,0,-2,6,2,50
Iraq,2005-06-01,25,0,0,8,1,34
Iraq,2005-06-01,30,4,-4,-10,5,25
Iraq,2005-06-01,60,2,0,6,6,74
Iraq,2005-06-01,34,2,0,22,4,62
Iraq,2005-06-01,65,2,0,11,13,91
Iraq,2005-06-01,37,0,0,-4,10,43
Iraq,2005-06-01,23,0,1,3,3,30
Iraq,2005-06-01,21,0,0,2,11,34
Iraq,2005-06-01,26,0,0,0,7,33
Iraq,2005-06-01,47,0,0,11,6,64
Iraq,2005-06-01,72,2,0,16,9,99
Iraq,2005-06-01,28,0,0,7,5,40
Iraq,2005-07-01,40,0,1,8,0,49
Iraq,2005-07-01,18,0,2,-2,0,18
Iraq,2005-07-01,30,0,0,-3,14,41
Iraq,2005-07-01,43,0,0,27,11,81
Iraq,2005-07-01,41,0,2,16,1,60
Iraq,2005-07-01,59,0,2,40,11,112
Iraq,2005-07-01,85,2,-3,20,3,107
Iraq,2005-07-01,55,0,1,-2,2,56
Iraq,2005-07-01,16,0,1,15,5,37
Iraq,2005-07-01,30,0,0,0,9,39
Iraq,2005-07-01,74,0,0,6,4,84
Iraq,2005-07-01,37,0,1,40,5,83
Iraq,2005-07-01,42,0,-4,37,3,78
Iraq,2005-07-01,52,2,1,0,13,68
Iraq,2005-07-01,20,2,0,3,5,30
Iraq,2005-07-01,11,0,2,0,1,14
Iraq,2005-07-01,44,0,0,6,2,52
Iraq,2005-07-01,96,2,0,12,2,112
Iraq,2005-07-01,95,0,0,13,12,120
Iraq,2005-07-01,35,0,0,-7,3,31
Iraq,2005-07-01,15,0,0,8,6,29
Iraq,2005-07-01,37,0,1,3,6,47
Iraq,2005-07-01,19,0,-2,9,5,31
Iraq,2005-07-01,11,0,0,0,6,17
Iraq,2005-07-01,66,0,0,24,5,95
Iraq,2005-07-01,44,0,0,30,6,80
Iraq,2005-07-01,22,0,1,20,12,55
Iraq,2005-07-01,15,0,0,2,16,33
Iraq,2005-07-01,39,0,0,58,9,106
Iraq,2005-07-01,50,0,0,19,5,74
Iraq,2005-07-01,29,0,0,24,1,54
Iraq,2005-08-01,14,0,-1,24,12,49
Iraq,2005-08-01,19,0,2,17,4,42
Iraq,2005-08-01,53,0,0,35,6,94
Iraq,2005-08-01,43,0,0,9,21,73
Iraq,2005-08-01,31,0,0,10,5,46
Iraq,2005-08-01,15,0,-4,1,13,25
Iraq,2005-08-01,55,0,0,21,12,88
Iraq,2005-08-01,10,2,-2,16,2,28
Iraq,2005-08-01,17,0,0,3,0,20
Iraq,2005-08-01,43,0,0,19,1,63
Iraq,2005-08-01,31,0,0,3,7,41
Iraq,2005-08-01,22,0,-2,18,5,43
Iraq,2005-08-01,40,0,-3,3,8,48
Iraq,2005-08-01,39,0,0,-1,6,44
Iraq,2005-08-01,37,0,0,7,7,51
Iraq,2005-08-01,17,0,0,10,4,31
Iraq,2005-08-01,5,0,0,6,7,18
Iraq,2005-08-01,12,0,0,9,3,24
Iraq,2005-08-01,54,0,0,9,1,64
Iraq,2005-08-01,40,0,0,7,2,49
Iraq,2005-08-01,24,0,0,5,5,34
Iraq,2005-08-01,23,0,-1,7,11,40
Iraq,2005-08-01,79,0,-5,9,11,94
Iraq,2005-08-01,113,0,0,5,5,123
Iraq,2005-08-01,30,0,0,3,8,41
Iraq,2005-08-01,39,0,-3,4,18,58
Iraq,2005-08-01,17,2,0,-5,0,14
Iraq,2005-08-01,67,0,-1,3,15,84
Iraq,2005-08-01,46,0,0,6,3,55
Iraq,2005-08-01,83,0,0,13,11,107
Iraq,2005-08-01,42,0,1,14,2,59
Iraq,2005-09-01,27,0,0,6,4,37
Iraq,2005-09-01,42,0,0,5,20,67
Iraq,2005-09-01,35,4,0,2,6,47
Iraq,2005-09-01,33,0,0,0,2,35
Iraq,2005-09-01,50,0,0,32,4,86
Iraq,2005-09-01,42,0,0,24,6,72
Iraq,2005-09-01,35,4,2,29,8,78
Iraq,2005-09-01,29,0,0,17,2,48
Iraq,2005-09-01,23,0,-1,3,0,25
Iraq,2005-09-01,4,0,-4,6,17,23
Iraq,2005-09-01,29,0,0,21,8,58
Iraq,2005-09-01,46,0,-3,3,3,49
Iraq,2005-09-01,10,0,0,18,5,33
Iraq,2005-09-01,45,0,1,13,2,61
Iraq,2005-09-01,44,4,0,7,22,77
Iraq,2005-09-01,13,0,2,28,6,49
Iraq,2005-09-01,30,0,0,0,0,30
Iraq,2005-09-01,16,0,-2,1,9,24
Iraq,2005-09-01,46,2,0,27,10,85
Iraq,2005-09-01,19,0,0,9,19,47
Iraq,2005-09-01,65,0,-6,26,18,103
Iraq,2005-09-01,33,0,4,60,9,106
Iraq,2005-09-01,36,0,-1,26,2,63
Iraq,2005-09-01,9,0,0,5,9,23
Iraq,2005-09-01,39,0,0,0,4,43
Iraq,2005-09-01,15,0,0,-7,3,11
Iraq,2005-09-01,16,0,0,12,7,35
Iraq,2005-09-01,38,0,-4,27,14,75
Iraq,2005-09-01,46,0,-7,2,4,45
Iraq,2005-09-01,27,0,2,13,3,45
Iraq,2005-10-01,17,0,0,1,7,25
Iraq,2005-10-01,50,0,-1,-2,9,56
Iraq,2005-10-01,23,0,-2,18,7,46
Iraq,2005-10-01,59,0,0,-1,1,59
Iraq,2005-10-01,91,0,-6,6,8,99
Iraq,2005-10-01,29,0,-1,24,7,59
Iraq,2005-10-01,38,0,0,-4,4,38
Iraq,2005-10-01,38,0,0,18,1,57
Iraq,2005-10-01,50,0,0,6,5,61
Iraq,2005-10-01,47,0,0,0,3,50
Iraq,2005-10-01,34,0,-2,69,4,105
Iraq,2005-10-01,46,0,-1,2,13,60
Iraq,2005-10-01,70,0,-4,12,2,80
Iraq,2005-10-01,35,0,0,-4,2,33
Iraq,2005-10-01,54,0,1,9,10,74
Iraq,2005-10-01,76,0,-1,22,12,109
Iraq,2005-10-01,65,0,-2,34,8,105
Iraq,2005-10-01,43,2,0,12,2,59
Iraq,2005-10-01,32,0,0,24,3,59
Iraq,2005-10-01,45,0,0,29,5,79
Iraq,2005-10-01,8,0,-2,-4,5,7
Iraq,2005-10-01,18,0,0,10,1,29
Iraq,2005-10-01,35,0,1,6,5,47
Iraq,2005-10-01,30,0,0,13,8,51
Iraq,2005-10-01,47,0,0,4,6,57
Iraq,2005-10-01,23,0,0,20,15,58
Iraq,2005-10-01,37,2,-2,34,19,90
Iraq,2005-10-01,47,0,-10,59,11,107
Iraq,2005-10-01,28,0,-10,36,3,57
Iraq,2005-10-01,50,0,0,-3,8,55
Iraq,2005-10-01,29,0,0,14,6,49
Iraq,2005-11-01,39,2,1,9,4,55
Iraq,2005-11-01,45,0,-6,11,4,54
Iraq,2005-11-01,28,2,5,54,2,91
Iraq,2005-11-01,15,0,-1,26,3,43
Iraq,2005-11-01,18,2,-4,9,8,33
Iraq,2005-11-01,48,0,-6,16,4,62
Iraq,2005-11-01,-2,0,-5,4,10,7
Iraq,2005-11-01,14,0,0,36,2,52
Iraq,2005-11-01,39,0,0,33,29,101
Iraq,2005-11-01,101,0,-2,15,13,127
Iraq,2005-11-01,94,2,-2,33,29,156
Iraq,2005-11-01,58,0,2,19,4,83
Iraq,2005-11-01,40,2,2,27,8,79
Iraq,2005-11-01,28,2,0,0,9,39
Iraq,2005-11-01,61,0,-2,38,19,116
Iraq,2005-11-01,100,0,5,15,12,132
Iraq,2005-11-01,77,2,-2,21,13,111
Iraq,2005-11-01,48,0,-9,32,24,95
Iraq,2005-11-01,51,0,-4,10,7,64
Iraq,2005-11-01,64,0,0,17,13,94
Iraq,2005-11-01,49,0,0,21,4,74
Iraq,2005-11-01,53,0,1,31,6,91
Iraq,2005-11-01,48,0,-2,4,12,62
Iraq,2005-11-01,6,0,-3,9,1,13
Iraq,2005-11-01,19,0,-2,0,0,17
Iraq,2005-11-01,10,0,0,10,-1,19
Iraq,2005-11-01,26,2,0,43,9,80
Iraq,2005-11-01,38,6,-1,12,3,58
Iraq,2005-11-01,60,0,0,23,0,83
Iraq,2005-11-01,88,0,-6,17,1,100
Iraq,2005-12-01,35,0,0,17,3,55
Iraq,2005-12-01,50,0,0,16,0,66
Iraq,2005-12-01,13,0,0,-2,0,11
Iraq,2005-12-01,42,4,0,-4,10,52
Iraq,2005-12-01,49,4,-4,2,11,62
Iraq,2005-12-01,52,2,-17,20,6,63
Iraq,2005-12-01,44,0,-7,30,3,70
Iraq,2005-12-01,53,0,0,35,2,90
Iraq,2005-12-01,26,0,0,19,2,47
Iraq,2005-12-01,8,2,-1,10,4,23
Iraq,2005-12-01,40,0,0,5,4,49
Iraq,2005-12-01,27,0,0,13,25,65
Iraq,2005-12-01,32,0,0,24,23,79
Iraq,2005-12-01,30,0,0,11,18,59
Iraq,2005-12-01,28,0,1,19,12,60
Iraq,2005-12-01,40,0,0,9,16,65
Iraq,2005-12-01,8,0,0,21,6,35
Iraq,2005-12-01,47,0,0,17,4,68
Iraq,2005-12-01,76,2,-3,44,3,122
Iraq,2005-12-01,21,4,3,15,2,45
Iraq,2005-12-01,17,0,0,4,0,21
Iraq,2005-12-01,29,0,0,1,1,31
Iraq,2005-12-01,9,0,0,-1,3,11
Iraq,2005-12-01,21,0,-6,17,1,33
Iraq,2005-12-01,0,0,0,6,4,10
Iraq,2005-12-01,9,0,0,7,0,16
Iraq,2005-12-01,1,2,1,-1,0,3
Iraq,2005-12-01,47,0,3,18,6,74
Iraq,2005-12-01,21,0,0,9,6,36
Iraq,2005-12-01,4,0,0,9,6,19
Iraq,2005-12-01,19,0,-2,-1,2,18
Morocco,2005-01-01,3,0,0,12,0,15
Morocco,2005-01-01,0,0,0,0,0,0
Morocco,2005-01-01,4,0,0,0,0,4
Morocco,2005-01-01,0,0,0,6,0,6
Morocco,2005-01-01,0,0,0,3,0,3
Morocco,2005-01-01,6,0,0,0,0,6
Morocco,2005-01-01,1,0,0,-2,0,-1
Morocco,2005-01-01,0,0,0,24,0,24
Morocco,2005-01-01,0,0,0,3,0,3
Morocco,2005-01-01,0,0,0,3,0,3
Morocco,2005-01-01,0,0,0,0,0,0
Morocco,2005-01-01,4,0,1,-2,0,3
Morocco,2005-01-01,0,0,0,15,0,15
Morocco,2005-01-01,1,0,0,0,0,1
Morocco,2005-01-01,0,0,0,0,0,0
Morocco,2005-01-01,2,0,0,0,0,2
Morocco,2005-01-01,0,0,0,0,0,0
Morocco,2005-01-01,0,0,0,0,0,0
Morocco,2005-01-01,1,4,0,0,0,5
Morocco,2005-01-01,4,0,0,-4,0,0
Morocco,2005-01-01,2,0,0,0,0,2
Morocco,2005-01-01,-1,0,0,6,0,5
Morocco,2005-01-01,0,0,0,6,0,6
Morocco,2005-01-01,0,0,0,0,0,0
Morocco,2005-01-01,-1,0,0,0,0,-1
Morocco,2005-01-01,-3,0,0,3,0,0
Morocco,2005-01-01,0,0,0,0,0,0
Morocco,2005-01-01,0,4,0,-4,0,0
Morocco,2005-02-01,0,0,0,6,0,6
Morocco,2005-02-01,2,0,0,14,0,16
Morocco,2005-02-01,0,0,0,0,0,0
Morocco,2005-02-01,4,0,0,16,0,20
Morocco,2005-02-01,0,0,0,3,0,3
Morocco,2005-02-01,-1,0,0,0,0,-1
Morocco,2005-02-01,0,0,0,0,0,0
Morocco,2005-02-01,6,0,0,0,0,6
Morocco,2005-02-01,-1,0,0,6,0,5
Morocco,2005-02-01,0,0,0,0,0,0
Morocco,2005-02-01,0,0,0,0,0,0
Morocco,2005-02-01,3,0,0,0,0,3
Morocco,2005-02-01,9,0,0,3,0,12
Morocco,2005-02-01,1,0,0,7,0,8
Morocco,2005-02-01,1,0,0,3,0,4
Morocco,2005-02-01,3,0,0,0,0,3
Morocco,2005-02-01,6,0,0,0,0,6
Morocco,2005-02-01,0,0,0,0,0,0
Morocco,2005-02-01,0,0,0,0,0,0
Morocco,2005-02-01,0,0,0,12,0,12
Morocco,2005-02-01,0,0,0,0,0,0
Morocco,2005-02-01,2,0,0,0,0,2
Morocco,2005-02-01,4,0,0,3,4,11
Morocco,2005-02-01,0,0,0,-2,0,-2
Morocco,2005-02-01,2,0,0,6,0,8
Morocco,2005-03-01,0,0,0,0,0,0
Morocco,2005-03-01,0,0,0,0,0,0
Morocco,2005-03-01,3,0,0,0,0,3
Morocco,2005-03-01,3,0,0,3,0,6
Morocco,2005-03-01,0,0,0,6,3,9
Morocco,2005-03-01,0,0,0,0,0,0
Morocco,2005-03-01,0,0,0,6,0,6
Morocco,2005-03-01,1,0,0,0,0,1
Morocco,2005-03-01,0,0,-2,0,0,-2
Morocco,2005-03-01,15,0,0,15,0,30
Morocco,2005-03-01,0,0,0,0,0,0
Morocco,2005-03-01,-2,0,0,0,0,-2
Morocco,2005-03-01,0,0,0,0,0,0
Morocco,2005-03-01,0,0,0,6,0,6
Morocco,2005-03-01,16,0,0,0,0,16
Morocco,2005-03-01,0,0,0,0,0,0
Morocco,2005-03-01,1,0,0,4,0,5
Morocco,2005-03-01,1,0,0,6,0,7
Morocco,2005-03-01,0,0,0,6,2,8
Morocco,2005-03-01,9,0,0,0,0,9
Morocco,2005-03-01,2,0,0,9,0,11
Morocco,2005-03-01,1,0,0,12,0,13
Morocco,2005-03-01,3,0,0,0,0,3
Morocco,2005-03-01,-3,0,0,0,0,-3
Morocco,2005-03-01,0,0,0,0,0,0
Morocco,2005-03-01,0,0,0,1,0,1
Morocco,2005-03-01,0,0,0,0,0,0
Morocco,2005-03-01,-1,0,0,3,0,2
Morocco,2005-03-01,2,0,0,9,0,11
Morocco,2005-04-01,5,0,0,11,0,16
Morocco,2005-04-01,-2,0,0,0,1,-1
Morocco,2005-04-01,0,0,0,0,0,0
Morocco,2005-04-01,5,0,0,1,1,7
Morocco,2005-04-01,11,0,0,3,0,14
Morocco,2005-04-01,26,0,0,12,0,38
Morocco,2005-04-01,14,0,0,0,0,14
Morocco,2005-04-01,6,0,0,0,0,6
Morocco,2005-04-01,1,0,0,-4,0,-3
Morocco,2005-04-01,0,0,0,0,0,0
Morocco,2005-04-01,0,0,0,0,0,0
Morocco,2005-04-01,0,0,0,12,0,12
Morocco,2005-04-01,6,0,0,6,0,12
Morocco,2005-04-01,-1,0,0,25,0,24
Morocco,2005-04-01,-2,0,0,13,0,11
Morocco,2005-04-01,1,0,0,4,2,7
Morocco,2005-04-01,0,0,0,0,0,0
Morocco,2005-04-01,0,0,0,0,0,0
Morocco,2005-04-01,0,0,0,0,0,0
Morocco,2005-04-01,-3,0,0,4,0,1
Morocco,2005-04-01,0,0,0,3,0,3
Morocco,2005-04-01,0,0,0,0,0,0
Morocco,2005-04-01,2,0,0,6,0,8
Morocco,2005-04-01,0,0,0,0,0,0
Morocco,2005-04-01,1,0,0,9,0,10
Morocco,2005-04-01,9,0,0,0,2,11
Morocco,2005-04-01,-3,0,0,0,1,-2
Morocco,2005-04-01,0,0,0,0,0,0
Morocco,2005-05-01,-3,0,0,0,0,-3
Morocco,2005-05-01,0,0,0,0,1,1
Morocco,2005-05-01,0,0,0,0,0,0
Morocco,2005-05-01,4,0,0,3,0,7
Morocco,2005-05-01,0,0,0,0,0,0
Morocco,2005-05-01,0,0,0,0,0,0
Morocco,2005-05-01,2,0,0,0,0,2
Morocco,2005-05-01,0,0,0,0,0,0
Morocco,2005-05-01,-1,0,0,12,0,11
Morocco,2005-05-01,9,0,0,9,0,18
Morocco,2005-05-01,0,0,0,0,0,0
Morocco,2005-05-01,2,0,0,0,0,2
Morocco,2005-05-01,2,0,0,-2,0,0
Morocco,2005-05-01,2,0,0,0,0,2
Morocco,2005-05-01,6,0,0,0,0,6
Morocco,2005-05-01,-4,0,0,0,0,-4
Morocco,2005-05-01,0,0,0,0,0,0
Morocco,2005-05-01,4,0,0,7,0,11
Morocco,2005-05-01,16,0,0,8,0,24
Morocco,2005-05-01,1,0,0,0,0,1
Morocco,2005-05-01,15,0,0,10,6,31
Morocco,2005-05-01,0,0,0,0,0,0
Morocco,2005-05-01,0,0,0,0,0,0
Morocco,2005-05-01,-5,0,0,3,0,-2
Morocco,2005-05-01,3,0,0,3,1,7
Morocco,2005-05-01,6,0,0,3,0,9
Morocco,2005-06-01,19,0,0,5,1,25
Morocco,2005-06-01,1,0,0,0,0,1
Morocco,2005-06-01,8,0,0,0,0,8
Morocco,2005-06-01,0,0,0,3,0,3
Morocco,2005-06-01,0,0,0,0,0,0
Morocco,2005-06-01,0,0,1,0,0,1
Morocco,2005-06-01,26,0,1,26,0,53
Morocco,2005-06-01,0,0,0,6,0,6
Morocco,2005-06-01,0,0,0,6,0,6
Morocco,2005-06-01,5,0,0,3,0,8
Morocco,2005-06-01,0,0,0,9,0,9
Morocco,2005-06-01,2,0,0,2,0,4
Morocco,2005-06-01,6,0,0,3,0,9
Morocco,2005-06-01,6,0,0,3,0,9
Morocco,2005-06-01,15,0,0,9,0,24
Morocco,2005-06-01,0,0,0,0,2,2
Morocco,2005-06-01,0,0,0,0,0,0
Morocco,2005-06-01,9,0,1,12,0,22
Morocco,2005-06-01,-2,0,0,6,0,4
Morocco,2005-06-01,0,0,0,0,0,0
Morocco,2005-06-01,-2,0,0,9,0,7
Morocco,2005-06-01,0,0,0,-4,0,-4
Morocco,2005-06-01,0,0,0,9,0,9
Morocco,2005-06-01,8,0,0,18,0,26
Morocco,2005-06-01,4,0,1,15,0,20
Morocco,2005-06-01,0,0,0,0,0,0
Morocco,2005-06-01,1,0,0,12,0,13
Morocco,2005-07-01,7,0,-1,0,0,6
Morocco,2005-07-01,-1,0,0,0,0,-1
Morocco,2005-07-01,10,0,0,9,2,21
Morocco,2005-07-01,6,0,0,0,0,6
Morocco,2005-07-01,0,0,0,6,0,6
Morocco,2005-07-01,-3,0,0,0,0,-3
Morocco,2005-07-01,3,0,0,0,0,3
Morocco,2005-07-01,3,0,0,3,0,6
Morocco,2005-07-01,0,0,0,0,0,0
Morocco,2005-07-01,1,0,0,0,0,1
Morocco,2005-07-01,1,0,0,0,0,1
Morocco,2005-07-01,9,0,0,9,0,18
Morocco,2005-07-01,3,0,0,0,0,3
Morocco,2005-07-01,0,0,0,0,0,0
Morocco,2005-07-01,4,0,0,-6,0,-2
Morocco,2005-07-01,0,0,0,3,0,3
Morocco,2005-07-01,0,0,0,0,0,0
Morocco,2005-07-01,1,0,0,8,0,9
Morocco,2005-07-01,2,0,0,1,0,3
Morocco,2005-07-01,1,0,0,6,1,8
Morocco,2005-07-01,2,0,0,3,0,5
Morocco,2005-07-01,-3,0,0,3,0,0
Morocco,2005-07-01,0,0,0,3,0,3
Morocco,2005-07-01,6,0,0,0,0,6
Morocco,2005-07-01,15,0,0,0,1,16
Morocco,2005-07-01,3,0,0,-2,0,1
Morocco,2005-07-01,14,0,0,0,0,14
Morocco,2005-07-01,20,0,0,-2,0,18
Morocco,2005-07-01,0,0,0,-4,0,-4
Morocco,2005-07-01,4,0,0,0,0,4
Morocco,2005-07-01,0,0,0,0,0,0
Morocco,2005-08-01,0,0,0,0,0,0
Morocco,2005-08-01,0,0,0,24,1,25
Morocco,2005-08-01,2,0,0,0,2,4
Morocco,2005-08-01,0,0,0,0,0,0
Morocco,2005-08-01,0,0,0,0,0,0
Morocco,2005-08-01,0,0,0,0,0,0
Morocco,2005-08-01,-2,0,0,3,0,1
Morocco,2005-08-01,1,0,0,6,3,10
Morocco,2005-08-01,9,0,-1,0,5,13
Morocco,2005-08-01,3,0,0,0,0,3
Morocco,2005-08-01,-1,0,0,3,3,5
Morocco,2005-08-01,0,0,0,0,0,0
Morocco,2005-08-01,0,0,0,0,0,0
Morocco,2005-08-01,3,0,0,25,0,28
Morocco,2005-08-01,26,0,0,3,0,29
Morocco,2005-08-01,21,0,0,44,0,65
Morocco,2005-08-01,9,0,0,9,0,18
Morocco,2005-08-01,0,0,0,0,2,2
Morocco,2005-08-01,-13,0,0,0,0,-13
Morocco,2005-08-01,13,0,0,3,0,16
Morocco,2005-08-01,0,0,0,0,0,0
Morocco,2005-08-01,0,0,0,15,0,15
Morocco,2005-08-01,1,2,-2,1,2,4
Morocco,2005-08-01,1,0,0,7,2,10
Morocco,2005-08-01,3,0,0,6,0,9
Morocco,2005-08-01,4,0,0,12,0,16
Morocco,2005-08-01,0,0,0,0,0,0
Morocco,2005-08-01,1,0,0,6,0,7
Morocco,2005-09-01,2,0,0,0,0,2
Morocco,2005-09-01,3,0,0,3,0,6
Morocco,2005-09-01,2,0,0,0,0,2
Morocco,2005-09-01,1,0,0,0,0,1
Morocco,2005-09-01,0,0,0,0,0,0
Morocco,2005-09-01,4,0,0,3,2,9
Morocco,2005-09-01,0,0,0,3,0,3
Morocco,2005-09-01,2,0,0,15,1,18
Morocco,2005-09-01,1,0,2,-6,2,-1
Morocco,2005-09-01,0,0,0,0,0,0
Morocco,2005-09-01,0,0,0,19,1,20
Morocco,2005-09-01,2,0,0,0,0,2
Morocco,2005-09-01,4,0,0,0,0,4
Morocco,2005-09-01,0,0,0,0,0,0
Morocco,2005-09-01,6,0,0,0,0,6
Morocco,2005-09-01,8,0,0,4,0,12
Morocco,2005-09-01,0,0,0,0,1,1
Morocco,2005-09-01,2,0,0,0,0,2
Morocco,2005-09-01,0,0,0,0,0,0
Morocco,2005-09-01,2,0,0,6,0,8
Morocco,2005-09-01,19,0,0,3,0,22
Morocco,2005-09-01,0,0,0,0,0,0
Morocco,2005-09-01,0,0,0,1,0,1
Morocco,2005-09-01,15,0,0,12,0,27
Morocco,2005-09-01,2,0,0,9,0,11
Morocco,2005-09-01,12,0,2,0,0,14
Morocco,2005-09-01,14,0,0,0,2,16
Morocco,2005-09-01,19,0,0,0,2,21
Morocco,2005-10-01,0,0,0,0,0,0
Morocco,2005-10-01,0,0,0,0,1,1
Morocco,2005-10-01,3,0,0,6,0,9
Morocco,2005-10-01,0,0,0,-2,6,4
Morocco,2005-10-01,5,0,0,15,2,22
Morocco,2005-10-01,-1,0,0,6,4,9
Morocco,2005-10-01,10,0,0,21,0,31
Morocco,2005-10-01,0,0,0,3,0,3
Morocco,2005-10-01,7,0,0,0,0,7
Morocco,2005-10-01,6,0,0,3,0,9
Morocco,2005-10-01,1,0,0,15,0,16
Morocco,2005-10-01,5,0,0,9,0,14
Morocco,2005-10-01,3,0,0,12,0,15
Morocco,2005-10-01,10,0,0,0,0,10
Morocco,2005-10-01,0,0,0,0,3,3
Morocco,2005-10-01,0,0,0,0,0,0
Morocco,2005-10-01,0,0,0,3,0,3
Morocco,2005-10-01,4,0,0,12,0,16
Morocco,2005-10-01,0,0,0,0,0,0
Morocco,2005-10-01,1,0,0,3,1,5
Morocco,2005-10-01,0,0,0,9,0,9
Morocco,2005-10-01,2,0,0,0,0,2
Morocco,2005-10-01,4,0,0,0,0,4
Morocco,2005-10-01,26,0,0,12,0,38
Morocco,2005-10-01,18,0,0,12,0,30
Morocco,2005-10-01,7,0,0,-1,0,6
Morocco,2005-10-01,4,0,0,9,0,13
Morocco,2005-10-01,4,0,0,0,0,4
Morocco,2005-10-01,6,0,0,-1,0,5
Morocco,2005-11-01,5,0,0,7,1,13
Morocco,2005-11-01,9,0,0,4,0,13
Morocco,2005-11-01,3,0,0,11,2,16
Morocco,2005-11-01,1,0,0,9,2,12
Morocco,2005-11-01,2,0,0,8,4,14
Morocco,2005-11-01,4,0,0,2,0,6
Morocco,2005-11-01,14,0,0,3,1,18
Morocco,2005-11-01,0,0,0,0,0,0
Morocco,2005-11-01,18,0,0,0,0,18
Morocco,2005-11-01,0,0,0,0,0,0
Morocco,2005-11-01,5,0,0,6,0,11
Morocco,2005-11-01,7,0,0,15,6,28
Morocco,2005-11-01,0,0,0,0,0,0
Morocco,2005-11-01,-1,0,0,0,2,1
Morocco,2005-11-01,0,0,0,3,0,3
Morocco,2005-11-01,-1,0,1,-3,1,-2
Morocco,2005-11-01,5,0,0,7,0,12
Morocco,2005-11-01,0,0,0,0,0,0
Morocco,2005-11-01,4,0,0,3,0,7
Morocco,2005-11-01,0,0,0,0,0,0
Morocco,2005-11-01,-7,0,0,3,0,-4
Morocco,2005-11-01,0,0,0,12,0,12
Morocco,2005-11-01,6,0,0,3,0,9
Morocco,2005-11-01,0,0,0,0,0,0
Morocco,2005-11-01,4,0,0,6,0,10
Morocco,2005-11-01,3,0,0,0,0,3
Morocco,2005-11-01,4,0,0,0,0,4
Morocco,2005-11-01,6,0,0,6,2,14
Morocco,2005-11-01,1,0,0,7,2,10
Morocco,2005-11-01,14,0,0,9,0,23
Morocco,2005-12-01,18,0,0,3,0,21
Morocco,2005-12-01,0,0,0,0,0,0
Morocco,2005-12-01,0,0,0,0,2,2
Morocco,2005-12-01,0,0,0,0,0,0
Morocco,2005-12-01,12,0,0,3,0,15
Morocco,2005-12-01,1,0,0,0,0,1
Morocco,2005-12-01,15,0,0,9,0,24
Morocco,2005-12-01,3,0,0,0,0,3
Morocco,2005-12-01,0,0,0,3,0,3
Morocco,2005-12-01,0,0,0,0,0,0
Morocco,2005-12-01,-2,0,0,0,0,-2
Morocco,2005-12-01,0,0,0,6,0,6
Morocco,2005-12-01,5,0,0,6,0,11
Morocco,2005-12-01,4,0,0,6,0,10
Morocco,2005-12-01,13,0,0,-2,0,11
Morocco,2005-12-01,1,0,0,9,0,10
Morocco,2005-12-01,0,0,0,0,0,0
Morocco,2005-12-01,6,0,0,2,0,8
Morocco,2005-12-01,0,0,0,10,0,10
Morocco,2005-12-01,0,0,0,0,0,0
Morocco,2005-12-01,0,0,0,0,0,0
Morocco,2005-12-01,0,0,0,3,0,3
Morocco,2005-12-01,0,0,0,0,0,0
Morocco,2005-12-01,0,0,0,4,0,4
Morocco,2005-12-01,0,0,0,0,0,0
Morocco,2005-12-01,0,0,0,3,0,3
Morocco,2005-12-01,3,0,0,0,0,3
Morocco,2005-12-01,9,0,0,0,0,9
Nigeria,2005-01-01,5,0,0,0,0,5
Nigeria,2005-01-01,8,0,1,-2,4,11
Nigeria,2005-01-01,11,2,-1,3,0,15
Nigeria,2005-01-01,14,0,0,0,3,17
Nigeria,2005-01-01,1,0,0,0,0,1
Nigeria,2005-01-01,17,0,0,5,1,23
Nigeria,2005-01-01,0,0,0,0,2,2
Nigeria,2005-01-01,0,0,-1,9,0,8
Nigeria,2005-01-01,9,0,0,0,0,9
Nigeria,2005-01-01,22,0,0,3,10,35
Nigeria,2005-01-01,3,0,0,-3,1,1
Nigeria,2005-01-01,19,0,0,9,0,28
Nigeria,2005-01-01,36,0,0,0,5,41
Nigeria,2005-01-01,7,0,0,6,0,13
Nigeria,2005-01-01,8,0,0,0,0,8
Nigeria,2005-01-01,11,0,-1,0,0,10
Nigeria,2005-01-01,23,0,0,3,3,29
Nigeria,2005-01-01,18,0,0,-2,2,18
Nigeria,2005-01-01,18,0,0,13,0,31
Nigeria,2005-01-01,6,0,0,0,0,6
Nigeria,2005-01-01,5,0,0,8,1,14
Nigeria,2005-01-01,5,0,0,3,1,9
Nigeria,2005-01-01,12,0,1,0,2,15
Nigeria,2005-01-01,12,0,0,4,2,18
Nigeria,2005-01-01,17,0,0,0,1,18
Nigeria,2005-01-01,15,0,0,3,0,18
Nigeria,2005-01-01,14,0,0,8,1,23
Nigeria,2005-01-01,15,0,0,0,1,16
Nigeria,2005-01-01,4,0,0,0,0,4
Nigeria,2005-01-01,13,0,0,9,3,25
Nigeria,2005-01-01,18,0,0,-2,4,20
Nigeria,2005-02-01,6,0,0,0,2,8
Nigeria,2005-02-01,6,0,1,-2,0,5
Nigeria,2005-02-01,7,0,-2,2,2,9
Nigeria,2005-02-01,11,0,0,0,2,13
Nigeria,2005-02-01,6,0,0,0,2,8
Nigeria,2005-02-01,22,0,2,-2,0,22
Nigeria,2005-02-01,21,0,1,4,1,27
Nigeria,2005-02-01,12,0,0,-2,0,10
Nigeria,2005-02-01,6,0,0,-4,0,2
Nigeria,2005-02-01,0,0,0,3,3,6
Nigeria,2005-02-01,9,0,-4,-6,3,2
Nigeria,2005-02-01,8,0,0,6,0,14
Nigeria,2005-02-01,4,0,0,3,0,7
Nigeria,2005-02-01,10,0,0,7,2,19
Nigeria,2005-02-01,4,0,-2,-2,1,1
Nigeria,2005-02-01,18,0,-4,0,27,41
Nigeria,2005-02-01,19,0,0,9,1,29
Nigeria,2005-02-01,8,0,0,0,0,8
Nigeria,2005-02-01,4,0,1,3,1,9
Nigeria,2005-02-01,9,0,0,3,1,13
Nigeria,2005-02-01,17,0,-2,0,0,15
Nigeria,2005-02-01,22,0,0,3,6,31
Nigeria,2005-02-01,13,0,0,9,1,23
Nigeria,2005-02-01,11,2,0,9,2,24
Nigeria,2005-02-01,1,0,0,6,0,7
Nigeria,2005-02-01,5,0,-2,6,0,9
Nigeria,2005-02-01,7,0,-2,0,0,5
Nigeria,2005-02-01,4,0,0,4,0,8
Nigeria,2005-03-01,11,0,-6,13,2,20
Nigeria,2005-03-01,7,0,0,9,2,18
Nigeria,2005-03-01,8,0,0,0,3,11
Nigeria,2005-03-01,12,0,0,0,0,12
Nigeria,2005-03-01,0,0,0,3,1,4
Nigeria,2005-03-01,11,0,2,6,0,19
Nigeria,2005-03-01,22,0,0,3,6,31
Nigeria,2005-03-01,11,0,-2,10,2,21
Nigeria,2005-03-01,15,0,0,0,3,18
Nigeria,2005-03-01,4,0,0,0,0,4
Nigeria,2005-03-01,6,0,0,3,0,9
Nigeria,2005-03-01,-1,0,0,3,0,2
Nigeria,2005-03-01,9,0,-4,-2,0,3
Nigeria,2005-03-01,6,0,0,0,0,6
Nigeria,2005-03-01,8,0,0,3,1,12
Nigeria,2005-03-01,8,0,0,4,1,13
Nigeria,2005-03-01,9,0,0,9,1,19
Nigeria,2005-03-01,0,0,-1,0,0,-1
Nigeria,2005-03-01,5,0,0,0,0,5
Nigeria,2005-03-01,0,0,0,9,0,9
Nigeria,2005-03-01,15,0,0,9,4,28
Nigeria,2005-03-01,10,0,0,9,5,24
Nigeria,2005-03-01,24,0,-4,18,2,40
Nigeria,2005-03-01,14,0,0,14,3,31
Nigeria,2005-03-01,1,0,0,6,0,7
Nigeria,2005-03-01,2,0,0,3,0,5
Nigeria,2005-03-01,7,0,0,3,0,10
Nigeria,2005-03-01,13,0,-3,15,1,26
Nigeria,2005-03-01,22,0,0,6,1,29
Nigeria,2005-03-01,4,0,-2,1,1,4
Nigeria,2005-03-01,13,0,0,2,3,18
Nigeria,2005-04-01,3,0,0,15,1,19
Nigeria,2005-04-01,8,0,0,4,0,12
Nigeria,2005-04-01,2,0,0,0,0,2
Nigeria,2005-04-01,30,0,1,3,1,35
Nigeria,2005-04-01,9,0,1,0,2,12
Nigeria,2005-04-01,1,0,0,4,7,12
Nigeria,2005-04-01,26,0,0,1,2,29
Nigeria,2005-04-01,1,2,0,18,1,22
Nigeria,2005-04-01,10,0,0,0,1,11
Nigeria,2005-04-01,6,0,0,3,0,9
Nigeria,2005-04-01,15,0,0,9,3,27
Nigeria,2005-04-01,15,6,0,-2,3,22
Nigeria,2005-04-01,1,0,0,6,1,8
Nigeria,2005-04-01,26,0,0,1,3,30
Nigeria,2005-04-01,17,0,0,12,4,33
Nigeria,2005-04-01,0,0,0,3,0,3
Nigeria,2005-04-01,-1,0,0,3,0,2
Nigeria,2005-04-01,17,0,0,6,0,23
Nigeria,2005-04-01,15,4,-2,7,0,24
Nigeria,2005-04-01,3,0,0,6,0,9
Nigeria,2005-04-01,17,0,0,12,0,29
Nigeria,2005-04-01,3,0,-2,3,1,5
Nigeria,2005-04-01,3,0,0,9,0,12
Nigeria,2005-04-01,2,0,0,1,1,4
Nigeria,2005-04-01,9,2,0,1,2,14
Nigeria,2005-04-01,18,0,0,0,0,18
Nigeria,2005-04-01,7,0,0,-2,1,6
Nigeria,2005-04-01,13,0,-6,4,0,11
Nigeria,2005-04-01,19,0,0,0,2,21
Nigeria,2005-04-01,0,0,0,0,0,0
Nigeria,2005-05-01,0,0,0,0,0,0
Nigeria,2005-05-01,3,0,0,6,2,11
Nigeria,2005-05-01,10,0,0,-2,0,8
Nigeria,2005-05-01,1,0,0,9,0,10
Nigeria,2005-05-01,3,0,-4,-11,2,-10
Nigeria,2005-05-01,2,0,0,13,3,18
Nigeria,2005-05-01,2,0,0,0,0,2
Nigeria,2005-05-01,9,2,-4,1,1,9
Nigeria,2005-05-01,20,0,0,3,0,23
Nigeria,2005-05-01,0,0,3,-2,1,2
Nigeria,2005-05-01,-7,0,0,6,0,-1
Nigeria,2005-05-01,-5,0,2,0,4,1
Nigeria,2005-05-01,5,0,0,0,1,6
Nigeria,2005-05-01,15,0,0,-2,0,13
Nigeria,2005-05-01,27,0,-1,0,0,26
Nigeria,2005-05-01,16,0,1,6,2,25
Nigeria,2005-05-01,-7,0,3,4,2,2
Nigeria,2005-05-01,4,0,-1,-4,4,3
Nigeria,2005-05-01,26,0,0,6,0,32
Nigeria,2005-05-01,15,0,0,6,0,21
Nigeria,2005-05-01,1,0,0,0,1,2
Nigeria,2005-05-01,9,0,-1,0,1,9
Nigeria,2005-05-01,1,0,0,3,0,4
Nigeria,2005-05-01,13,0,0,9,0,22
Nigeria,2005-05-01,12,0,1,11,3,27
Nigeria,2005-05-01,7,0,-4,-2,1,2
Nigeria,2005-05-01,5,0,0,3,1,9
Nigeria,2005-05-01,6,0,0,6,0,12
Nigeria,2005-05-01,4,0,0,0,0,4
Nigeria,2005-05-01,11,0,0,0,14,25
Nigeria,2005-05-01,21,0,0,9,2,32
Nigeria,2005-06-01,2,0,0,3,2,7
Nigeria,2005-06-01,-8,0,0,9,0,1
Nigeria,2005-06-01,4,0,0,12,1,17
Nigeria,2005-06-01,4,0,3,0,3,10
Nigeria,2005-06-01,3,0,0,9,4,16
Nigeria,2005-06-01,12,0,2,9,6,29
Nigeria,2005-06-01,19,0,1,6,6,32
Nigeria,2005-06-01,19,0,0,9,0,28
Nigeria,2005-06-01,14,0,0,0,0,14
Nigeria,2005-06-01,7,0,0,-4,0,3
Nigeria,2005-06-01,9,0,0,1,3,13
Nigeria,2005-06-01,5,0,0,0,1,6
Nigeria,2005-06-01,6,0,0,0,0,6
Nigeria,2005-06-01,12,0,0,-2,1,11
Nigeria,2005-06-01,8,0,0,6,0,14
Nigeria,2005-06-01,14,2,0,3,2,21
Nigeria,2005-06-01,10,0,0,-3,1,8
Nigeria,2005-06-01,12,0,0,-5,0,7
Nigeria,2005-06-01,5,0,0,0,2,7
Nigeria,2005-06-01,34,0,-2,1,5,38
Nigeria,2005-06-01,8,0,0,18,0,26
Nigeria,2005-06-01,20,0,0,0,2,22
Nigeria,2005-06-01,14,0,0,6,0,20
Nigeria,2005-06-01,13,0,1,0,1,15
Nigeria,2005-06-01,8,0,0,-4,2,6
Nigeria,2005-06-01,2,0,0,0,0,2
Nigeria,2005-06-01,5,0,0,6,1,12
Nigeria,2005-06-01,10,0,0,12,6,28
Nigeria,2005-06-01,15,0,0,3,1,19
Nigeria,2005-06-01,19,0,0,0,1,20
Nigeria,2005-07-01,6,0,2,3,2,13
Nigeria,2005-07-01,11,0,0,3,0,14
Nigeria,2005-07-01,5,0,0,-4,2,3
Nigeria,2005-07-01,1,0,0,0,0,1
Nigeria,2005-07-01,7,0,0,-4,2,5
Nigeria,2005-07-01,-4,0,0,0,1,-3
Nigeria,2005-07-01,14,0,0,9,2,25
Nigeria,2005-07-01,5,0,0,6,1,12
Nigeria,2005-07-01,-6,0,0,0,0,-6
Nigeria,2005-07-01,-3,0,0,0,5,2
Nigeria,2005-07-01,14,0,0,0,0,14
Nigeria,2005-07-01,12,2,0,-6,2,10
Nigeria,2005-07-01,27,0,1,4,0,32
Nigeria,2005-07-01,12,0,-2,0,2,12
Nigeria,2005-07-01,7,0,0,15,0,22
Nigeria,2005-07-01,-1,0,0,1,0,0
Nigeria,2005-07-01,3,0,0,0,0,3
Nigeria,2005-07-01,9,0,0,3,1,13
Nigeria,2005-07-01,26,0,0,0,2,28
Nigeria,2005-07-01,8,0,-8,0,2,2
Nigeria,2005-07-01,9,2,0,3,1,15
Nigeria,2005-07-01,20,0,0,3,1,24
Nigeria,2005-07-01,0,0,0,0,0,0
Nigeria,2005-07-01,4,0,0,6,1,11
Nigeria,2005-07-01,5,0,-1,0,1,5
Nigeria,2005-07-01,14,0,0,-1,1,14
Nigeria,2005-07-01,17,0,0,0,2,19
Nigeria,2005-07-01,19,0,0,12,4,35
Nigeria,2005-07-01,2,0,0,0,2,4
Nigeria,2005-07-01,3,0,0,3,0,6
Nigeria,2005-07-01,0,0,-2,-1,2,-1
Nigeria,2005-08-01,9,4,-8,1,2,8
Nigeria,2005-08-01,15,2,0,-2,0,15
Nigeria,2005-08-01,9,0,0,6,3,18
Nigeria,2005-08-01,8,0,0,15,3,26
Nigeria,2005-08-01,5,0,1,-1,0,5
Nigeria,2005-08-01,2,2,0,0,0,4
Nigeria,2005-08-01,-2,0,0,0,1,-1
Nigeria,2005-08-01,26,0,0,3,1,30
Nigeria,2005-08-01,1,0,0,0,1,2
Nigeria,2005-08-01,8,0,0,3,0,11
Nigeria,2005-08-01,10,0,0,6,1,17
Nigeria,2005-08-01,5,0,0,3,0,8
Nigeria,2005-08-01,8,0,0,0,1,9
Nigeria,2005-08-01,4,0,0,0,6,10
Nigeria,2005-08-01,17,0,0,-1,2,18
Nigeria,2005-08-01,8,0,-1,-1,2,8
Nigeria,2005-08-01,8,0,1,24,0,33
Nigeria,2005-08-01,8,0,0,9,0,17
Nigeria,2005-08-01,18,0,-2,0,0,16
Nigeria,2005-08-01,2,0,0,-4,0,-2
Nigeria,2005-08-01,12,0,0,15,0,27
Nigeria,2005-08-01,13,0,0,3,4,20
Nigeria,2005-08-01,10,0,0,3,0,13
Nigeria,2005-08-01,8,0,0,3,0,11
Nigeria,2005-08-01,3,0,0,-1,2,4
Nigeria,2005-08-01,12,0,0,6,1,19
Nigeria,2005-08-01,8,0,2,9,0,19
Nigeria,2005-08-01,14,0,0,-2,0,12
Nigeria,2005-08-01,0,0,0,3,0,3
Nigeria,2005-08-01,4,0,0,-2,0,2
Nigeria,2005-08-01,7,0,1,-3,4,9
Nigeria,2005-09-01,19,0,0,3,0,22
Nigeria,2005-09-01,-8,0,0,6,3,1
Nigeria,2005-09-01,11,0,0,0,0,11
Nigeria,2005-09-01,0,0,0,0,0,0
Nigeria,2005-09-01,4,0,0,0,0,4
Nigeria,2005-09-01,8,0,-2,-2,0,4
Nigeria,2005-09-01,11,4,1,-2,1,15
Nigeria,2005-09-01,7,2,2,3,0,14
Nigeria,2005-09-01,3,2,-2,-1,18,20
Nigeria,2005-09-01,8,0,-2,9,0,15
Nigeria,2005-09-01,10,0,1,3,1,15
Nigeria,2005-09-01,7,0,0,0,0,7
Nigeria,2005-09-01,7,0,0,-2,2,7
Nigeria,2005-09-01,9,0,0,-2,7,14
Nigeria,2005-09-01,7,0,0,11,2,20
Nigeria,2005-09-01,9,0,0,6,0,15
Nigeria,2005-09-01,0,0,0,11,0,11
Nigeria,2005-09-01,1,0,0,0,0,1
Nigeria,2005-09-01,16,0,0,-3,0,13
Nigeria,2005-09-01,4,0,2,0,0,6
Nigeria,2005-09-01,12,0,0,3,2,17
Nigeria,2005-09-01,4,0,-1,3,1,7
Nigeria,2005-09-01,-1,0,0,0,0,-1
Nigeria,2005-09-01,-3,0,0,9,0,6
Nigeria,2005-09-01,0,0,0,12,0,12
Nigeria,2005-09-01,0,0,0,0,5,5
Nigeria,2005-09-01,12,0,0,15,3,30
Nigeria,2005-09-01,20,0,-2,6,0,24
Nigeria,2005-09-01,10,0,0,6,1,17
Nigeria,2005-09-01,10,0,1,2,6,19
Nigeria,2005-10-01,0,0,0,0,0,0
Nigeria,2005-10-01,2,0,0,0,0,2
Nigeria,2005-10-01,8,0,0,-1,2,9
Nigeria,2005-10-01,32,0,0,0,1,33
Nigeria,2005-10-01,13,0,0,-1,1,13
Nigeria,2005-10-01,8,0,0,3,7,18
Nigeria,2005-10-01,2,0,1,-2,0,1
Nigeria,2005-10-01,5,0,0,0,2,7
Nigeria,2005-10-01,7,0,1,0,2,10
Nigeria,2005-10-01,5,0,-2,3,0,6
Nigeria,2005-10-01,-2,0,0,0,1,-1
Nigeria,2005-10-01,9,0,0,4,2,15
Nigeria,2005-10-01,5,0,0,6,3,14
Nigeria,2005-10-01,11,0,0,0,0,11
Nigeria,2005-10-01,0,0,0,0,1,1
Nigeria,2005-10-01,5,0,0,1,0,6
Nigeria,2005-10-01,0,0,0,-11,0,-11
Nigeria,2005-10-01,10,0,0,1,5,16
Nigeria,2005-10-01,14,0,0,12,3,29
Nigeria,2005-10-01,0,0,0,3,0,3
Nigeria,2005-10-01,9,0,0,-2,0,7
Nigeria,2005-10-01,0,0,0,3,0,3
Nigeria,2005-10-01,9,0,0,6,0,15
Nigeria,2005-10-01,11,0,-1,0,0,10
Nigeria,2005-10-01,-1,0,0,1,5,5
Nigeria,2005-10-01,7,0,0,12,6,25
Nigeria,2005-10-01,12,0,0,9,2,23
Nigeria,2005-10-01,2,0,0,6,0,8
Nigeria,2005-10-01,6,0,0,3,0,9
Nigeria,2005-10-01,3,0,0,0,0,3
Nigeria,2005-10-01,-1,0,4,30,2,35
Nigeria,2005-11-01,12,0,-2,-9,1,2
Nigeria,2005-11-01,16,0,0,-5,26,37
Nigeria,2005-11-01,1,0,-1,3,0,3
Nigeria,2005-11-01,17,0,0,1,0,18
Nigeria,2005-11-01,8,0,0,0,0,8
Nigeria,2005-11-01,2,0,0,0,0,2
Nigeria,2005-11-01,8,0,0,6,1,15
Nigeria,2005-11-01,13,0,0,0,2,15
Nigeria,2005-11-01,9,0,0,6,1,16
Nigeria,2005-11-01,3,0,0,0,0,3
Nigeria,2005-11-01,2,0,0,1,0,3
Nigeria,2005-11-01,0,0,0,3,0,3
Nigeria,2005-11-01,6,0,1,0,0,7
Nigeria,2005-11-01,7,0,0,9,6,22
Nigeria,2005-11-01,10,0,0,4,2,16
Nigeria,2005-11-01,8,6,0,0,1,15
Nigeria,2005-11-01,4,0,0,3,0,7
Nigeria,2005-11-01,11,0,0,6,0,17
Nigeria,2005-11-01,2,0,0,3,0,5
Nigeria,2005-11-01,2,0,-2,0,0,0
Nigeria,2005-11-01,10,0,0,0,2,12
Nigeria,2005-11-01,17,0,0,0,2,19
Nigeria,2005-11-01,6,0,0,0,0,6
Nigeria,2005-11-01,0,0,0,9,0,9
Nigeria,2005-11-01,11,0,-1,14,2,26
Nigeria,2005-11-01,-1,0,0,6,0,5
Nigeria,2005-11-01,7,0,0,0,0,7
Nigeria,2005-11-01,7,0,0,3,0,10
Nigeria,2005-11-01,9,0,0,7,1,17
Nigeria,2005-11-01,16,0,-4,15,3,30
Nigeria,2005-12-01,13,0,0,6,0,19
Nigeria,2005-12-01,0,0,0,4,1,5
Nigeria,2005-12-01,2,0,0,6,2,10
Nigeria,2005-12-01,-2,0,0,4,0,2
Nigeria,2005-12-01,9,0,0,7,1,17
Nigeria,2005-12-01,11,0,0,-2,0,9
Nigeria,2005-12-01,15,0,0,0,0,15
Nigeria,2005-12-01,13,0,0,0,0,13
Nigeria,2005-12-01,6,0,0,6,0,12
Nigeria,2005-12-01,2,0,0,3,0,5
Nigeria,2005-12-01,14,0,-1,0,0,13
Nigeria,2005-12-01,6,0,0,0,0,6
Nigeria,2005-12-01,6,0,-4,7,2,11
Nigeria,2005-12-01,6,0,0,-6,6,6
Nigeria,2005-12-01,4,0,0,3,0,7
Nigeria,2005-12-01,8,0,-1,-2,0,5
Nigeria,2005-12-01,-1,0,-2,0,0,-3
Nigeria,2005-12-01,6,0,0,7,0,13
Nigeria,2005-12-01,1,0,0,0,1,2
Nigeria,2005-12-01,14,0,0,9,1,24
Nigeria,2005-12-01,2,0,3,3,0,8
Nigeria,2005-12-01,0,0,0,0,0,0
Nigeria,2005-12-01,0,0,0,-4,0,-4
Nigeria,2005-12-01,9,0,0,0,0,9
Nigeria,2005-12-01,6,0,0,0,0,6
Nigeria,2005-12-01,5,0,0,-2,0,3
Nigeria,2005-12-01,3,0,1,0,0,4
Nigeria,2005-12-01,12,0,0,-2,0,10
Nigeria,2005-12-01,0,0,0,0,0,0
Nigeria,2005-12-01,11,0,0,0,0,11
Nigeria,2005-12-01,4,0,0,3,0,7
Pakistan,2005-01-01,4,0,-2,6,1,9
Pakistan,2005-01-01,10,0,0,3,0,13
Pakistan,2005-01-01,2,0,0,0,0,2
Pakistan,2005-01-01,6,0,0,3,0,9
Pakistan,2005-01-01,10,0,0,6,0,16
Pakistan,2005-01-01,17,0,0,2,1,20
Pakistan,2005-01-01,14,0,0,-2,0,12
Pakistan,2005-01-01,31,0,0,3,2,36
Pakistan,2005-01-01,25,0,0,0,0,25
Pakistan,2005-01-01,4,0,0,19,0,23
Pakistan,2005-01-01,-2,0,0,-4,0,-6
Pakistan,2005-01-01,14,0,0,3,0,17
Pakistan,2005-01-01,8,0,0,6,0,14
Pakistan,2005-01-01,1,0,0,15,0,16
Pakistan,2005-01-01,0,0,0,6,0,6
Pakistan,2005-01-01,3,0,0,-9,4,-2
Pakistan,2005-01-01,10,0,0,0,0,10
Pakistan,2005-01-01,19,0,0,18,0,37
Pakistan,2005-01-01,2,0,0,0,0,2
Pakistan,2005-01-01,5,0,0,0,0,5
Pakistan,2005-01-01,3,0,0,12,0,15
Pakistan,2005-01-01,-1,0,0,0,0,-1
Pakistan,2005-01-01,9,0,0,9,0,18
Pakistan,2005-01-01,3,2,0,13,0,18
Pakistan,2005-01-01,3,0,0,15,1,19
Pakistan,2005-01-01,0,0,0,4,0,4
Pakistan,2005-01-01,1,0,0,-1,0,0
Pakistan,2005-01-01,1,0,0,-6,0,-5
Pakistan,2005-01-01,8,0,0,6,0,14
Pakistan,2005-01-01,2,0,0,1,0,3
Pakistan,2005-01-01,5,0,0,15,3,23
Pakistan,2005-02-01,5,0,-2,6,3,12
Pakistan,2005-02-01,9,0,0,6,2,17
Pakistan,2005-02-01,0,0,0,0,0,0
Pakistan,2005-02-01,3,2,0,1,0,6
Pakistan,2005-02-01,7,0,0,3,0,10
Pakistan,2005-02-01,11,0,0,12,1,24
Pakistan,2005-02-01,11,0,0,3,2,16
Pakistan,2005-02-01,4,0,0,9,0,13
Pakistan,2005-02-01,14,0,0,-1,0,13
Pakistan,2005-02-01,0,0,0,0,1,1
Pakistan,2005-02-01,19,0,-2,1,0,18
Pakistan,2005-02-01,4,0,0,7,0,11
Pakistan,2005-02-01,3,2,0,6,0,11
Pakistan,2005-02-01,9,0,0,21,0,30
Pakistan,2005-02-01,15,0,0,15,2,32
Pakistan,2005-02-01,15,2,0,4,0,21
Pakistan,2005-02-01,-1,2,0,3,0,4
Pakistan,2005-02-01,2,0,0,6,3,11
Pakistan,2005-02-01,2,0,0,0,0,2
Pakistan,2005-02-01,-1,0,0,0,0,-1
Pakistan,2005-02-01,7,0,0,6,0,13
Pakistan,2005-02-01,0,0,0,0,7,7
Pakistan,2005-02-01,11,0,0,0,0,11
Pakistan,2005-02-01,10,0,0,3,6,19
Pakistan,2005-02-01,4,0,0,3,8,15
Pakistan,2005-02-01,12,0,0,0,0,12
Pakistan,2005-02-01,0,0,-2,0,0,-2
Pakistan,2005-02-01,14,0,-1,6,1,20
Pakistan,2005-03-01,18,2,0,0,0,20
Pakistan,2005-03-01,40,0,0,3,10,53
Pakistan,2005-03-01,15,0,0,6,4,25
Pakistan,2005-03-01,0,0,0,0,1,1
Pakistan,2005-03-01,0,0,0,0,0,0
Pakistan,2005-03-01,3,0,0,-13,1,-9
Pakistan,2005-03-01,23,0,0,8,0,31
Pakistan,2005-03-01,3,0,0,3,1,7
Pakistan,2005-03-01,1,0,-2,27,0,26
Pakistan,2005-03-01,5,0,0,6,0,11
Pakistan,2005-03-01,3,2,0,-5,0,0
Pakistan,2005-03-01,2,0,0,0,2,4
Pakistan,2005-03-01,7,0,0,18,4,29
Pakistan,2005-03-01,8,0,0,10,0,18
Pakistan,2005-03-01,4,0,0,3,0,7
Pakistan,2005-03-01,11,0,0,5,1,17
Pakistan,2005-03-01,9,0,0,3,0,12
Pakistan,2005-03-01,11,0,0,3,0,14
Pakistan,2005-03-01,1,0,0,1,3,5
Pakistan,2005-03-01,8,0,0,6,0,14
Pakistan,2005-03-01,0,0,0,0,0,0
Pakistan,2005-03-01,-3,0,0,23,0,20
Pakistan,2005-03-01,24,0,0,8,1,33
Pakistan,2005-03-01,18,0,0,1,0,19
Pakistan,2005-03-01,17,0,0,2,0,19
Pakistan,2005-03-01,5,0,0,0,1,6
Pakistan,2005-03-01,5,0,0,0,2,7
Pakistan,2005-03-01,49,0,0,0,1,50
Pakistan,2005-03-01,-1,0,0,0,0,-1
Pakistan,2005-03-01,0,0,0,-4,0,-4
Pakistan,2005-03-01,12,0,0,0,0,12
Pakistan,2005-04-01,5,0,0,6,0,11
Pakistan,2005-04-01,20,0,0,0,4,24
Pakistan,2005-04-01,19,0,0,-1,0,18
Pakistan,2005-04-01,3,0,0,0,0,3
Pakistan,2005-04-01,0,0,0,6,0,6
Pakistan,2005-04-01,25,0,0,3,6,34
Pakistan,2005-04-01,2,0,0,0,0,2
Pakistan,2005-04-01,4,0,0,0,0,4
Pakistan,2005-04-01,5,0,0,12,0,17
Pakistan,2005-04-01,8,0,0,3,0,11
Pakistan,2005-04-01,0,0,0,0,0,0
Pakistan,2005-04-01,10,0,0,9,0,19
Pakistan,2005-04-01,11,0,0,26,2,39
Pakistan,2005-04-01,0,0,0,8,0,8
Pakistan,2005-04-01,8,0,0,0,0,8
Pakistan,2005-04-01,8,0,0,0,0,8
Pakistan,2005-04-01,4,0,0,9,2,15
Pakistan,2005-04-01,4,0,0,9,0,13
Pakistan,2005-04-01,-4,0,0,8,0,4
Pakistan,2005-04-01,10,0,0,0,0,10
Pakistan,2005-04-01,5,0,0,-3,3,5
Pakistan,2005-04-01,-4,0,0,7,0,3
Pakistan,2005-04-01,2,0,0,6,0,8
Pakistan,2005-04-01,0,0,0,-1,0,-1
Pakistan,2005-04-01,5,0,-1,10,3,17
Pakistan,2005-04-01,20,0,0,12,0,32
Pakistan,2005-04-01,5,0,0,3,2,10
Pakistan,2005-04-01,3,0,0,0,0,3
Pakistan,2005-04-01,0,0,0,0,0,0
Pakistan,2005-04-01,4,0,0,0,0,4
Pakistan,2005-05-01,2,0,0,3,1,6
Pakistan,2005-05-01,5,0,0,0,0,5
Pakistan,2005-05-01,4,0,0,-1,0,3
Pakistan,2005-05-01,1,0,0,9,0,10
Pakistan,2005-05-01,14,0,0,19,12,45
Pakistan,2005-05-01,8,0,0,3,0,11
Pakistan,2005-05-01,-1,0,0,-2,1,-2
Pakistan,2005-05-01,2,0,0,15,2,19
Pakistan,2005-05-01,-5,0,0,-6,1,-10
Pakistan,2005-05-01,19,0,0,0,2,21
Pakistan,2005-05-01,12,0,0,0,3,15
Pakistan,2005-05-01,15,0,0,-1,7,21
Pakistan,2005-05-01,4,0,-2,3,3,8
Pakistan,2005-05-01,7,0,0,3,0,10
Pakistan,2005-05-01,3,0,0,3,14,20
Pakistan,2005-05-01,2,0,0,3,15,20
Pakistan,2005-05-01,2,0,0,6,0,8
Pakistan,2005-05-01,13,0,0,8,5,26
Pakistan,2005-05-01,0,0,0,6,1,7
Pakistan,2005-05-01,3,0,0,4,0,7
Pakistan,2005-05-01,6,0,0,6,0,12
Pakistan,2005-05-01,1,0,0,0,2,3
Pakistan,2005-05-01,4,0,0,9,2,15
Pakistan,2005-05-01,0,0,0,9,0,9
Pakistan,2005-05-01,1,0,0,9,6,16
Pakistan,2005-05-01,8,0,-1,12,2,21
Pakistan,2005-05-01,4,0,0,-1,0,3
Pakistan,2005-05-01,3,0,0,0,1,4
Pakistan,2005-05-01,7,0,0,0,0,7
Pakistan,2005-05-01,0,0,0,8,0,8
Pakistan,2005-05-01,7,0,0,21,0,28
Pakistan,2005-06-01,7,0,0,12,0,19
Pakistan,2005-06-01,8,0,0,0,0,8
Pakistan,2005-06-01,8,0,0,0,0,8
Pakistan,2005-06-01,5,0,0,0,-2,3
Pakistan,2005-06-01,13,0,0,1,2,16
Pakistan,2005-06-01,3,0,0,16,0,19
Pakistan,2005-06-01,4,0,0,-2,0,2
Pakistan,2005-06-01,48,0,0,9,0,57
Pakistan,2005-06-01,19,0,0,15,1,35
Pakistan,2005-06-01,14,0,0,3,0,17
Pakistan,2005-06-01,13,0,0,19,2,34
Pakistan,2005-06-01,8,0,0,2,0,10
Pakistan,2005-06-01,24,0,2,11,6,43
Pakistan,2005-06-01,6,0,0,0,2,8
Pakistan,2005-06-01,33,0,0,37,6,76
Pakistan,2005-06-01,26,0,0,13,5,44
Pakistan,2005-06-01,27,0,0,7,0,34
Pakistan,2005-06-01,2,0,0,0,0,2
Pakistan,2005-06-01,1,0,0,0,0,1
Pakistan,2005-06-01,18,0,0,0,0,18
Pakistan,2005-06-01,14,0,-1,6,3,22
Pakistan,2005-06-01,23,0,1,17,10,51
Pakistan,2005-06-01,15,0,0,9,0,24
Pakistan,2005-06-01,5,0,0,0,0,5
Pakistan,2005-06-01,12,0,0,3,0,15
Pakistan,2005-06-01,7,0,0,0,0,7
Pakistan,2005-06-01,13,0,0,0,0,13
Pakistan,2005-06-01,15,0,0,9,3,27
Pakistan,2005-06-01,22,0,0,7,0,29
Pakistan,2005-06-01,19,0,0,0,0,19
Pakistan,2005-07-01,12,0,0,0,0,12
Pakistan,2005-07-01,6,0,0,0,0,6
Pakistan,2005-07-01,9,0,0,7,2,18
Pakistan,2005-07-01,11,0,2,1,0,14
Pakistan,2005-07-01,41,0,0,10,0,51
Pakistan,2005-07-01,31,0,0,10,2,43
Pakistan,2005-07-01,36,0,0,12,0,48
Pakistan,2005-07-01,24,0,0,6,6,36
Pakistan,2005-07-01,3,0,0,6,2,11
Pakistan,2005-07-01,14,0,0,21,2,37
Pakistan,2005-07-01,19,0,-1,3,4,25
Pakistan,2005-07-01,17,2,1,18,6,44
Pakistan,2005-07-01,55,0,0,9,5,69
Pakistan,2005-07-01,13,0,0,6,0,19
Pakistan,2005-07-01,42,0,0,1,0,43
Pakistan,2005-07-01,13,0,0,9,2,24
Pakistan,2005-07-01,25,0,0,3,0,28
Pakistan,2005-07-01,7,0,0,0,6,13
Pakistan,2005-07-01,26,2,0,6,7,41
Pakistan,2005-07-01,3,0,0,12,3,18
Pakistan,2005-07-01,35,0,0,17,2,54
Pakistan,2005-07-01,21,0,0,24,0,45
Pakistan,2005-07-01,19,0,0,3,2,24
Pakistan,2005-07-01,7,0,0,13,0,20
Pakistan,2005-07-01,23,0,0,12,0,35
Pakistan,2005-07-01,15,0,0,6,0,21
Pakistan,2005-07-01,12,0,0,15,3,30
Pakistan,2005-07-01,16,0,0,6,1,23
Pakistan,2005-07-01,10,0,0,12,0,22
Pakistan,2005-07-01,5,0,0,9,4,18
Pakistan,2005-07-01,8,0,0,3,0,11
Pakistan,2005-08-01,12,0,0,4,0,16
Pakistan,2005-08-01,16,0,0,6,3,25
Pakistan,2005-08-01,16,2,0,6,6,30
Pakistan,2005-08-01,12,0,0,18,1,31
Pakistan,2005-08-01,4,0,0,3,3,10
Pakistan,2005-08-01,9,0,0,-4,0,5
Pakistan,2005-08-01,6,0,0,6,0,12
Pakistan,2005-08-01,11,0,0,0,0,11
Pakistan,2005-08-01,17,0,0,9,3,29
Pakistan,2005-08-01,9,0,0,12,0,21
Pakistan,2005-08-01,17,0,0,0,0,17
Pakistan,2005-08-01,6,0,0,0,0,6
Pakistan,2005-08-01,4,0,0,0,0,4
Pakistan,2005-08-01,11,0,0,-2,0,9
Pakistan,2005-08-01,7,0,0,18,0,25
Pakistan,2005-08-01,7,0,0,3,0,10
Pakistan,2005-08-01,7,0,0,-2,0,5
Pakistan,2005-08-01,9,0,0,6,0,15
Pakistan,2005-08-01,-6,0,0,0,0,-6
Pakistan,2005-08-01,0,0,0,3,0,3
Pakistan,2005-08-01,2,0,0,0,0,2
Pakistan,2005-08-01,9,0,0,3,1,13
Pakistan,2005-08-01,4,0,0,2,8,14
Pakistan,2005-08-01,7,0,0,6,0,13
Pakistan,2005-08-01,0,0,0,4,0,4
Pakistan,2005-08-01,3,0,0,-2,0,1
Pakistan,2005-08-01,21,0,-2,0,0,19
Pakistan,2005-08-01,3,0,0,3,0,6
Pakistan,2005-08-01,3,0,0,12,0,15
Pakistan,2005-08-01,3,0,0,-4,0,-1
Pakistan,2005-08-01,2,0,0,12,0,14
Pakistan,2005-09-01,71,0,6,18,16,111
Pakistan,2005-09-01,21,0,2,6,5,34
Pakistan,2005-09-01,5,0,0,3,3,11
Pakistan,2005-09-01,0,0,0,0,0,0
Pakistan,2005-09-01,12,0,0,3,0,15
Pakistan,2005-09-01,3,0,0,0,0,3
Pakistan,2005-09-01,7,0,0,0,0,7
Pakistan,2005-09-01,0,0,0,0,0,0
Pakistan,2005-09-01,7,0,0,-12,2,-3
Pakistan,2005-09-01,14,0,0,18,18,50
Pakistan,2005-09-01,10,0,0,6,0,16
Pakistan,2005-09-01,15,0,1,7,1,24
Pakistan,2005-09-01,23,0,0,-5,0,18
Pakistan,2005-09-01,21,0,1,0,8,30
Pakistan,2005-09-01,19,0,0,9,4,32
Pakistan,2005-09-01,15,0,0,-2,0,13
Pakistan,2005-09-01,21,0,0,12,0,33
Pakistan,2005-09-01,15,0,0,9,3,27
Pakistan,2005-09-01,22,0,-2,8,1,29
Pakistan,2005-09-01,18,0,0,15,0,33
Pakistan,2005-09-01,2,0,0,3,0,5
Pakistan,2005-09-01,5,0,3,9,0,17
Pakistan,2005-09-01,1,0,0,27,0,28
Pakistan,2005-09-01,0,0,0,3,0,3
Pakistan,2005-09-01,0,0,0,-4,1,-3
Pakistan,2005-09-01,0,0,0,0,0,0
Pakistan,2005-09-01,9,0,0,6,0,15
Pakistan,2005-09-01,2,0,0,6,0,8
Pakistan,2005-09-01,13,0,0,16,0,29
Pakistan,2005-09-01,8,0,0,4,0,12
Pakistan,2005-10-01,3,0,0,0,0,3
Pakistan,2005-10-01,19,0,0,0,0,19
Pakistan,2005-10-01,9,0,0,0,0,9
Pakistan,2005-10-01,7,0,0,18,3,28
Pakistan,2005-10-01,6,0,0,18,6,30
Pakistan,2005-10-01,0,0,0,3,0,3
Pakistan,2005-10-01,7,0,0,12,0,19
Pakistan,2005-10-01,10,0,0,9,0,19
Pakistan,2005-10-01,13,6,0,19,3,41
Pakistan,2005-10-01,13,2,0,2,0,17
Pakistan,2005-10-01,7,4,0,8,8,27
Pakistan,2005-10-01,13,0,-1,2,0,14
Pakistan,2005-10-01,21,0,0,0,0,21
Pakistan,2005-10-01,10,0,0,6,1,17
Pakistan,2005-10-01,5,0,0,9,0,14
Pakistan,2005-10-01,19,2,0,0,0,21
Pakistan,2005-10-01,12,0,0,-6,0,6
Pakistan,2005-10-01,9,4,0,-5,0,8
Pakistan,2005-10-01,5,0,0,15,1,21
Pakistan,2005-10-01,18,2,0,3,3,26
Pakistan,2005-10-01,6,2,0,0,1,9
Pakistan,2005-10-01,8,0,0,9,1,18
Pakistan,2005-10-01,4,2,0,0,0,6
Pakistan,2005-10-01,11,0,0,5,3,19
Pakistan,2005-10-01,14,0,0,-6,4,12
Pakistan,2005-10-01,9,14,0,13,6,42
Pakistan,2005-10-01,16,6,0,18,2,42
Pakistan,2005-10-01,5,0,0,15,0,20
Pakistan,2005-10-01,23,0,-2,5,0,26
Pakistan,2005-10-01,13,0,0,0,0,13
Pakistan,2005-10-01,6,0,0,0,0,6
Pakistan,2005-11-01,9,2,0,33,0,44
Pakistan,2005-11-01,22,0,0,-6,4,20
Pakistan,2005-11-01,0,0,0,29,0,29
Pakistan,2005-11-01,4,0,0,17,0,21
Pakistan,2005-11-01,4,0,0,1,1,6
Pakistan,2005-11-01,4,0,1,30,2,37
Pakistan,2005-11-01,12,2,0,13,6,33
Pakistan,2005-11-01,19,0,-2,-2,2,17
Pakistan,2005-11-01,14,0,0,7,0,21
Pakistan,2005-11-01,3,0,0,10,0,13
Pakistan,2005-11-01,11,0,0,-4,0,7
Pakistan,2005-11-01,9,0,3,0,0,12
Pakistan,2005-11-01,13,2,0,9,0,24
Pakistan,2005-11-01,17,0,0,12,0,29
Pakistan,2005-11-01,1,0,0,9,0,10
Pakistan,2005-11-01,17,0,-1,6,8,30
Pakistan,2005-11-01,9,8,0,3,5,25
Pakistan,2005-11-01,10,0,0,0,0,10
Pakistan,2005-11-01,28,2,-1,0,0,29
Pakistan,2005-11-01,-4,0,0,0,0,-4
Pakistan,2005-11-01,10,0,0,0,0,10
Pakistan,2005-11-01,5,0,0,18,0,23
Pakistan,2005-11-01,0,0,0,3,0,3
Pakistan,2005-11-01,10,0,0,3,1,14
Pakistan,2005-11-01,2,2,0,0,0,4
Pakistan,2005-11-01,6,2,0,3,0,11
Pakistan,2005-11-01,3,0,0,3,0,6
Pakistan,2005-11-01,31,0,0,6,0,37
Pakistan,2005-11-01,7,0,0,3,0,10
Pakistan,2005-11-01,19,0,0,-6,0,13
Pakistan,2005-12-01,17,0,0,0,0,17
Pakistan,2005-12-01,13,0,0,-2,0,11
Pakistan,2005-12-01,12,0,0,6,0,18
Pakistan,2005-12-01,41,0,1,15,2,59
Pakistan,2005-12-01,11,0,0,3,1,15
Pakistan,2005-12-01,6,0,0,0,1,7
Pakistan,2005-12-01,14,0,0,0,0,14
Pakistan,2005-12-01,7,0,0,1,0,8
Pakistan,2005-12-01,18,0,0,0,0,18
Pakistan,2005-12-01,0,0,0,0,0,0
Pakistan,2005-12-01,2,0,0,15,0,17
Pakistan,2005-12-01,16,0,0,1,0,17
Pakistan,2005-12-01,4,0,0,-2,6,8
Pakistan,2005-12-01,0,0,0,3,9,12
Pakistan,2005-12-01,12,0,-4,0,0,8
Pakistan,2005-12-01,32,0,0,37,1,70
Pakistan,2005-12-01,7,0,0,-2,0,5
Pakistan,2005-12-01,37,0,0,18,0,55
Pakistan,2005-12-01,19,0,0,11,6,36
Pakistan,2005-12-01,4,0,0,0,0,4
Pakistan,2005-12-01,8,0,0,12,0,20
Pakistan,2005-12-01,8,0,0,-1,3,10
Pakistan,2005-12-01,6,0,0,12,0,18
Pakistan,2005-12-01,0,0,0,0,0,0
Pakistan,2005-12-01,0,0,0,-3,0,-3
Pakistan,2005-12-01,5,0,0,4,0,9
Pakistan,2005-12-01,-9,0,0,3,6,0
Pakistan,2005-12-01,21,0,0,12,0,33
Pakistan,2005-12-01,8,0,0,9,0,17
Pakistan,2005-12-01,0,0,0,6,0,6
Pakistan,2005-12-01,-5,0,0,9,2,6
Sierra Leone,2005-01-01,2,0,0,3,1,6
Sierra Leone,2005-01-01,6,0,0,-4,0,2
Sierra Leone,2005-01-01,-6,0,0,0,0,-6
Sierra Leone,2005-01-01,4,0,0,0,1,5
Sierra Leone,2005-01-01,0,0,0,0,2,2
Sierra Leone,2005-01-01,1,2,0,0,0,3
Sierra Leone,2005-01-01,0,2,0,1,0,3
Sierra Leone,2005-01-01,0,0,0,0,0,0
Sierra Leone,2005-01-01,0,0,0,0,0,0
Sierra Leone,2005-01-01,-1,0,0,3,2,4
Sierra Leone,2005-01-01,6,0,0,0,1,7
Sierra Leone,2005-01-01,3,0,0,3,0,6
Sierra Leone,2005-01-01,0,0,0,0,0,0
Sierra Leone,2005-01-01,3,0,0,1,0,4
Sierra Leone,2005-01-01,0,0,0,0,0,0
Sierra Leone,2005-01-01,0,0,0,0,0,0
Sierra Leone,2005-01-01,2,0,0,0,2,4
Sierra Leone,2005-01-01,-1,0,0,3,0,2
Sierra Leone,2005-01-01,0,0,0,3,0,3
Sierra Leone,2005-01-01,0,0,0,-2,0,-2
Sierra Leone,2005-01-01,0,0,0,0,0,0
Sierra Leone,2005-01-01,0,0,0,0,0,0
Sierra Leone,2005-01-01,0,0,0,3,0,3
Sierra Leone,2005-02-01,0,0,0,0,0,0
Sierra Leone,2005-02-01,7,0,0,-4,0,3
Sierra Leone,2005-02-01,0,0,0,-4,2,-2
Sierra Leone,2005-02-01,2,0,0,0,0,2
Sierra Leone,2005-02-01,8,0,0,6,1,15
Sierra Leone,2005-02-01,0,0,1,3,0,4
Sierra Leone,2005-02-01,1,0,0,1,0,2
Sierra Leone,2005-02-01,3,0,0,0,1,4
Sierra Leone,2005-02-01,2,0,0,0,2,4
Sierra Leone,2005-02-01,0,0,0,0,1,1
Sierra Leone,2005-02-01,3,0,0,0,0,3
Sierra Leone,2005-02-01,1,0,0,3,0,4
Sierra Leone,2005-02-01,2,0,0,12,0,14
Sierra Leone,2005-02-01,2,0,0,1,0,3
Sierra Leone,2005-02-01,3,0,0,0,1,4
Sierra Leone,2005-02-01,2,0,0,-2,0,0
Sierra Leone,2005-02-01,1,0,0,0,0,1
Sierra Leone,2005-02-01,0,0,0,0,0,0
Sierra Leone,2005-02-01,8,0,0,-2,1,7
Sierra Leone,2005-02-01,2,0,0,0,0,2
Sierra Leone,2005-02-01,7,0,1,-6,0,2
Sierra Leone,2005-02-01,0,0,0,-2,0,-2
Sierra Leone,2005-02-01,3,0,0,0,1,4
Sierra Leone,2005-02-01,1,0,0,0,1,2
Sierra Leone,2005-03-01,0,0,0,-22,1,-21
Sierra Leone,2005-03-01,2,0,0,1,0,3
Sierra Leone,2005-03-01,14,0,0,1,0,15
Sierra Leone,2005-03-01,2,0,0,0,0,2
Sierra Leone,2005-03-01,0,0,0,0,0,0
Sierra Leone,2005-03-01,0,0,0,0,0,0
Sierra Leone,2005-03-01,0,0,0,6,0,6
Sierra Leone,2005-03-01,0,0,0,3,0,3
Sierra Leone,2005-03-01,0,0,0,3,1,4
Sierra Leone,2005-03-01,9,0,0,5,0,14
Sierra Leone,2005-03-01,0,0,0,0,0,0
Sierra Leone,2005-03-01,0,0,0,0,0,0
Sierra Leone,2005-03-01,11,0,0,3,0,14
Sierra Leone,2005-03-01,-1,0,0,0,0,-1
Sierra Leone,2005-03-01,1,0,0,3,0,4
Sierra Leone,2005-03-01,0,0,0,0,0,0
Sierra Leone,2005-03-01,0,0,0,0,0,0
Sierra Leone,2005-03-01,2,0,0,3,2,7
Sierra Leone,2005-03-01,0,0,0,0,0,0
Sierra Leone,2005-03-01,8,0,0,6,0,14
Sierra Leone,2005-03-01,0,0,0,0,0,0
Sierra Leone,2005-03-01,0,0,0,0,0,0
Sierra Leone,2005-03-01,0,0,0,0,0,0
Sierra Leone,2005-03-01,6,0,0,0,0,6
Sierra Leone,2005-03-01,0,0,0,3,0,3
Sierra Leone,2005-03-01,0,0,0,0,0,0
Sierra Leone,2005-03-01,0,0,0,6,0,6
Sierra Leone,2005-04-01,1,0,0,0,0,1
Sierra Leone,2005-04-01,1,0,0,6,0,7
Sierra Leone,2005-04-01,0,0,0,-6,0,-6
Sierra Leone,2005-04-01,-3,0,0,3,0,0
Sierra Leone,2005-04-01,-2,0,0,0,0,-2
Sierra Leone,2005-04-01,4,0,0,0,0,4
Sierra Leone,2005-04-01,2,0,0,0,0,2
Sierra Leone,2005-04-01,2,0,0,3,0,5
Sierra Leone,2005-04-01,2,0,0,0,0,2
Sierra Leone,2005-04-01,2,0,0,3,0,5
Sierra Leone,2005-04-01,2,0,0,0,0,2
Sierra Leone,2005-04-01,0,0,0,0,0,0
Sierra Leone,2005-04-01,0,0,0,0,0,0
Sierra Leone,2005-04-01,0,0,0,0,0,0
Sierra Leone,2005-04-01,-1,0,0,6,1,6
Sierra Leone,2005-04-01,1,0,0,-4,0,-3
Sierra Leone,2005-04-01,0,0,0,0,0,0
Sierra Leone,2005-04-01,0,0,0,0,0,0
Sierra Leone,2005-04-01,0,0,0,0,0,0
Sierra Leone,2005-04-01,2,0,0,0,2,4
Sierra Leone,2005-04-01,0,0,0,0,0,0
Sierra Leone,2005-04-01,2,0,0,0,0,2
Sierra Leone,2005-04-01,1,0,0,6,0,7
Sierra Leone,2005-04-01,1,0,0,0,0,1
Sierra Leone,2005-05-01,0,0,0,0,0,0
Sierra Leone,2005-05-01,7,0,0,4,0,11
Sierra Leone,2005-05-01,0,0,0,3,0,3
Sierra Leone,2005-05-01,7,0,0,3,0,10
Sierra Leone,2005-05-01,3,0,0,-2,0,1
Sierra Leone,2005-05-01,0,0,0,0,0,0
Sierra Leone,2005-05-01,0,0,0,0,0,0
Sierra Leone,2005-05-01,1,0,0,0,0,1
Sierra Leone,2005-05-01,0,0,0,0,0,0
Sierra Leone,2005-05-01,1,0,0,0,1,2
Sierra Leone,2005-05-01,0,0,0,-4,0,-4
Sierra Leone,2005-05-01,2,0,0,9,2,13
Sierra Leone,2005-05-01,12,0,0,0,0,12
Sierra Leone,2005-05-01,0,0,-2,0,0,-2
Sierra Leone,2005-05-01,1,0,0,0,0,1
Sierra Leone,2005-05-01,-1,0,0,3,0,2
Sierra Leone,2005-05-01,0,0,0,0,0,0
Sierra Leone,2005-05-01,5,0,0,0,0,5
Sierra Leone,2005-05-01,0,0,0,4,0,4
Sierra Leone,2005-05-01,0,0,0,3,1,4
Sierra Leone,2005-05-01,0,0,0,3,0,3
Sierra Leone,2005-05-01,3,0,0,-2,0,1
Sierra Leone,2005-05-01,0,0,0,0,0,0
Sierra Leone,2005-05-01,3,0,0,3,0,6
Sierra Leone,2005-05-01,0,0,0,-2,0,-2
Sierra Leone,2005-06-01,0,0,0,0,0,0
Sierra Leone,2005-06-01,0,0,0,3,0,3
Sierra Leone,2005-06-01,11,0,0,3,0,14
Sierra Leone,2005-06-01,0,0,0,0,0,0
Sierra Leone,2005-06-01,0,0,0,0,0,0
Sierra Leone,2005-06-01,2,0,0,0,0,2
Sierra Leone,2005-06-01,0,0,0,0,0,0
Sierra Leone,2005-06-01,2,0,0,3,0,5
Sierra Leone,2005-06-01,-3,0,0,0,0,-3
Sierra Leone,2005-06-01,0,0,0,0,0,0
Sierra Leone,2005-06-01,-3,0,0,6,0,3
Sierra Leone,2005-06-01,1,0,0,0,0,1
Sierra Leone,2005-06-01,0,0,0,0,1,1
Sierra Leone,2005-06-01,0,0,0,0,0,0
Sierra Leone,2005-06-01,2,0,0,-3,0,-1
Sierra Leone,2005-06-01,2,0,0,0,0,2
Sierra Leone,2005-06-01,0,0,0,0,0,0
Sierra Leone,2005-06-01,3,0,0,0,0,3
Sierra Leone,2005-06-01,0,0,0,0,0,0
Sierra Leone,2005-06-01,6,0,0,0,1,7
Sierra Leone,2005-06-01,3,0,0,0,0,3
Sierra Leone,2005-06-01,3,0,0,-2,0,1
Sierra Leone,2005-06-01,0,0,0,0,0,0
Sierra Leone,2005-06-01,0,0,0,0,0,0
Sierra Leone,2005-06-01,0,0,0,6,0,6
Sierra Leone,2005-06-01,2,0,0,-2,0,0
Sierra Leone,2005-06-01,4,0,0,0,0,4
Sierra Leone,2005-06-01,0,0,0,0,0,0
Sierra Leone,2005-07-01,1,0,0,6,0,7
Sierra Leone,2005-07-01,0,0,0,0,0,0
Sierra Leone,2005-07-01,0,0,0,3,0,3
Sierra Leone,2005-07-01,8,0,0,0,0,8
Sierra Leone,2005-07-01,1,0,0,0,2,3
Sierra Leone,2005-07-01,3,0,0,0,0,3
Sierra Leone,2005-07-01,0,0,0,0,0,0
Sierra Leone,2005-07-01,4,0,0,0,0,4
Sierra Leone,2005-07-01,0,0,0,0,2,2
Sierra Leone,2005-07-01,1,0,0,-3,1,-1
Sierra Leone,2005-07-01,2,0,0,12,6,20
Sierra Leone,2005-07-01,1,0,0,0,0,1
Sierra Leone,2005-07-01,0,0,0,6,0,6
Sierra Leone,2005-07-01,-1,0,-1,0,0,-2
Sierra Leone,2005-07-01,4,0,0,0,0,4
Sierra Leone,2005-07-01,5,0,0,0,1,6
Sierra Leone,2005-07-01,1,0,0,3,0,4
Sierra Leone,2005-07-01,0,0,0,3,0,3
Sierra Leone,2005-07-01,20,0,0,3,0,23
Sierra Leone,2005-07-01,0,0,0,0,0,0
Sierra Leone,2005-07-01,6,0,0,0,1,7
Sierra Leone,2005-07-01,11,0,3,-3,0,11
Sierra Leone,2005-07-01,0,0,0,0,0,0
Sierra Leone,2005-07-01,8,0,0,0,0,8
Sierra Leone,2005-07-01,0,0,0,0,0,0
Sierra Leone,2005-07-01,0,0,0,0,0,0
Sierra Leone,2005-08-01,2,2,0,0,0,4
Sierra Leone,2005-08-01,0,0,0,0,0,0
Sierra Leone,2005-08-01,6,2,0,0,0,8
Sierra Leone,2005-08-01,3,0,0,18,0,21
Sierra Leone,2005-08-01,6,0,0,15,2,23
Sierra Leone,2005-08-01,0,0,0,0,0,0
Sierra Leone,2005-08-01,0,0,0,3,0,3
Sierra Leone,2005-08-01,0,0,0,0,0,0
Sierra Leone,2005-08-01,-2,0,0,0,0,-2
Sierra Leone,2005-08-01,0,0,0,3,0,3
Sierra Leone,2005-08-01,3,0,0,0,0,3
Sierra Leone,2005-08-01,4,0,0,0,0,4
Sierra Leone,2005-08-01,0,0,0,0,4,4
Sierra Leone,2005-08-01,0,0,0,6,2,8
Sierra Leone,2005-08-01,0,0,0,0,0,0
Sierra Leone,2005-08-01,0,0,0,-2,0,-2
Sierra Leone,2005-08-01,-3,0,0,0,5,2
Sierra Leone,2005-08-01,1,0,0,0,0,1
Sierra Leone,2005-08-01,6,0,0,0,0,6
Sierra Leone,2005-08-01,0,0,0,0,0,0
Sierra Leone,2005-08-01,0,0,0,0,0,0
Sierra Leone,2005-08-01,3,0,0,3,0,6
Sierra Leone,2005-08-01,1,0,0,0,0,1
Sierra Leone,2005-08-01,5,0,0,7,2,14
Sierra Leone,2005-09-01,4,0,0,0,0,4
Sierra Leone,2005-09-01,1,0,0,0,0,1
Sierra Leone,2005-09-01,1,0,0,0,0,1
Sierra Leone,2005-09-01,0,0,0,0,0,0
Sierra Leone,2005-09-01,0,0,0,0,0,0
Sierra Leone,2005-09-01,0,0,0,0,0,0
Sierra Leone,2005-09-01,8,0,0,3,1,12
Sierra Leone,2005-09-01,2,0,0,0,0,2
Sierra Leone,2005-09-01,0,0,0,3,0,3
Sierra Leone,2005-09-01,3,0,0,12,2,17
Sierra Leone,2005-09-01,1,0,0,0,0,1
Sierra Leone,2005-09-01,0,0,0,0,0,0
Sierra Leone,2005-09-01,0,0,0,0,0,0
Sierra Leone,2005-09-01,0,0,0,3,0,3
Sierra Leone,2005-09-01,0,0,0,3,0,3
Sierra Leone,2005-09-01,5,0,0,0,2,7
Sierra Leone,2005-09-01,0,0,0,0,5,5
Sierra Leone,2005-09-01,0,0,0,0,0,0
Sierra Leone,2005-09-01,7,0,0,0,0,7
Sierra Leone,2005-09-01,0,0,0,0,0,0
Sierra Leone,2005-09-01,5,0,0,6,0,11
Sierra Leone,2005-10-01,2,0,0,0,0,2
Sierra Leone,2005-10-01,0,0,0,0,3,3
Sierra Leone,2005-10-01,0,0,0,3,0,3
Sierra Leone,2005-10-01,0,4,0,0,0,4
Sierra Leone,2005-10-01,0,0,0,3,0,3
Sierra Leone,2005-10-01,-7,0,0,-2,0,-9
Sierra Leone,2005-10-01,1,0,0,0,0,1
Sierra Leone,2005-10-01,3,0,0,0,0,3
Sierra Leone,2005-10-01,-1,0,0,0,0,-1
Sierra Leone,2005-10-01,0,0,0,0,0,0
Sierra Leone,2005-10-01,2,0,0,6,0,8
Sierra Leone,2005-10-01,1,2,0,6,0,9
Sierra Leone,2005-10-01,1,2,0,0,4,7
Sierra Leone,2005-10-01,1,2,0,4,0,7
Sierra Leone,2005-10-01,1,0,0,0,0,1
Sierra Leone,2005-10-01,0,0,0,0,0,0
Sierra Leone,2005-10-01,0,0,0,0,0,0
Sierra Leone,2005-10-01,0,0,0,0,0,0
Sierra Leone,2005-10-01,0,0,0,0,1,1
Sierra Leone,2005-10-01,0,0,0,-2,0,-2
Sierra Leone,2005-10-01,0,0,0,0,0,0
Sierra Leone,2005-10-01,6,0,0,0,0,6
Sierra Leone,2005-11-01,4,0,0,-1,1,4
Sierra Leone,2005-11-01,1,0,0,1,1,3
Sierra Leone,2005-11-01,0,0,0,0,0,0
Sierra Leone,2005-11-01,0,0,0,0,0,0
Sierra Leone,2005-11-01,0,0,0,0,0,0
Sierra Leone,2005-11-01,6,0,-1,6,0,11
Sierra Leone,2005-11-01,6,0,0,0,0,6
Sierra Leone,2005-11-01,0,0,0,0,0,0
Sierra Leone,2005-11-01,5,0,0,0,0,5
Sierra Leone,2005-11-01,1,0,0,0,0,1
Sierra Leone,2005-11-01,0,0,-2,5,0,3
Sierra Leone,2005-11-01,0,0,0,0,2,2
Sierra Leone,2005-11-01,0,0,0,6,0,6
Sierra Leone,2005-11-01,-1,0,0,0,0,-1
Sierra Leone,2005-11-01,0,0,0,9,0,9
Sierra Leone,2005-11-01,0,0,0,0,0,0
Sierra Leone,2005-11-01,5,0,0,10,0,15
Sierra Leone,2005-11-01,0,0,0,3,0,3
Sierra Leone,2005-11-01,2,0,0,3,1,6
Sierra Leone,2005-11-01,0,0,0,0,0,0
Sierra Leone,2005-11-01,0,0,0,9,0,9
Sierra Leone,2005-11-01,-1,0,0,0,0,-1
Sierra Leone,2005-11-01,-3,0,0,-2,0,-5
Sierra Leone,2005-11-01,11,0,0,-2,0,9
Sierra Leone,2005-12-01,2,0,0,0,0,2
Sierra Leone,2005-12-01,1,0,0,0,0,1
Sierra Leone,2005-12-01,0,0,0,3,0,3
Sierra Leone,2005-12-01,0,0,0,0,0,0
Sierra Leone,2005-12-01,8,0,0,4,0,12
Sierra Leone,2005-12-01,2,0,0,0,0,2
Sierra Leone,2005-12-01,2,0,0,0,0,2
Sierra Leone,2005-12-01,0,0,0,0,0,0
Sierra Leone,2005-12-01,0,0,0,3,0,3
Sierra Leone,2005-12-01,0,0,0,-2,0,-2
Sierra Leone,2005-12-01,2,0,0,0,0,2
Sierra Leone,2005-12-01,2,0,0,-2,0,0
Sierra Leone,2005-12-01,4,0,0,9,0,13
Sierra Leone,2005-12-01,-1,0,0,0,0,-1
Sierra Leone,2005-12-01,0,0,0,0,0,0
Sierra Leone,2005-12-01,2,0,0,0,0,2
Sierra Leone,2005-12-01,0,0,0,-10,0,-10
Sierra Leone,2005-12-01,-1,0,0,3,0,2
Sierra Leone,2005-12-01,-3,0,0,6,0,3
Sierra Leone,2005-12-01,0,0,0,0,0,0
Sierra Leone,2005-12-01,0,0,0,0,0,0
Sierra Leone,2005-12-01,0,0,0,0,0,0
Sierra Leone,2005-12-01,0,0,0,0,0,0
Sierra Leone,2005-12-01,0,0,0,3,0,3
Somalia,2005-01-01,8,0,0,0,0,8
Somalia,2005-01-01,4,0,0,0,0,4
Somalia,2005-01-01,32,0,0,0,0,32
Somalia,2005-01-01,2,2,0,0,0,4
Somalia,2005-01-01,2,0,0,0,0,2
Somalia,2005-01-01,8,4,0,-2,0,10
Somalia,2005-01-01,9,0,0,0,0,9
Somalia,2005-01-01,2,0,0,0,0,2
Somalia,2005-01-01,0,0,0,0,0,0
Somalia,2005-01-01,21,2,0,5,0,28
Somalia,2005-01-01,-1,0,1,3,2,5
Somalia,2005-01-01,15,0,0,0,0,15
Somalia,2005-01-01,4,0,0,3,0,7
Somalia,2005-01-01,0,0,0,0,0,0
Somalia,2005-01-01,0,0,0,0,2,2
Somalia,2005-01-01,3,0,0,0,0,3
Somalia,2005-01-01,4,0,0,0,0,4
Somalia,2005-01-01,2,0,0,3,0,5
Somalia,2005-01-01,0,0,0,0,0,0
Somalia,2005-01-01,0,0,0,0,0,0
Somalia,2005-01-01,5,0,0,0,0,5
Somalia,2005-01-01,3,0,0,0,3,6
Somalia,2005-01-01,0,0,0,0,1,1
Somalia,2005-01-01,0,0,0,0,0,0
Somalia,2005-01-01,2,0,0,0,0,2
Somalia,2005-01-01,2,0,0,3,0,5
Somalia,2005-01-01,1,0,0,0,0,1
Somalia,2005-01-01,-3,0,0,0,0,-3
Somalia,2005-01-01,0,0,0,9,0,9
Somalia,2005-01-01,0,0,0,-2,0,-2
Somalia,2005-01-01,4,0,0,0,0,4
Somalia,2005-02-01,0,0,0,0,0,0
Somalia,2005-02-01,3,0,0,0,0,3
Somalia,2005-02-01,2,0,0,-4,0,-2
Somalia,2005-02-01,2,0,0,0,0,2
Somalia,2005-02-01,6,0,0,0,0,6
Somalia,2005-02-01,0,0,0,0,0,0
Somalia,2005-02-01,0,0,0,0,0,0
Somalia,2005-02-01,4,0,0,1,0,5
Somalia,2005-02-01,-1,0,0,0,4,3
Somalia,2005-02-01,2,0,0,0,0,2
Somalia,2005-02-01,0,0,0,0,0,0
Somalia,2005-02-01,0,0,0,-2,0,-2
Somalia,2005-02-01,0,0,0,0,0,0
Somalia,2005-02-01,2,0,0,0,0,2
Somalia,2005-02-01,2,0,0,0,0,2
Somalia,2005-02-01,-1,0,0,0,0,-1
Somalia,2005-02-01,3,0,0,0,0,3
Somalia,2005-02-01,6,0,0,0,0,6
Somalia,2005-02-01,2,0,0,0,4,6
Somalia,2005-02-01,1,0,0,4,0,5
Somalia,2005-02-01,12,0,0,3,0,15
Somalia,2005-02-01,0,0,0,0,0,0
Somalia,2005-02-01,7,0,0,0,1,8
Somalia,2005-02-01,6,0,0,0,0,6
Somalia,2005-02-01,6,0,0,0,0,6
Somalia,2005-02-01,2,0,0,0,0,2
Somalia,2005-03-01,8,0,0,0,0,8
Somalia,2005-03-01,5,0,0,0,0,5
Somalia,2005-03-01,4,0,0,0,0,4
Somalia,2005-03-01,3,0,0,3,0,6
Somalia,2005-03-01,1,0,0,0,0,1
Somalia,2005-03-01,0,0,0,0,0,0
Somalia,2005-03-01,1,0,0,0,0,1
Somalia,2005-03-01,16,0,0,0,0,16
Somalia,2005-03-01,8,0,0,0,2,10
Somalia,2005-03-01,1,0,0,0,0,1
Somalia,2005-03-01,0,0,0,-4,0,-4
Somalia,2005-03-01,1,0,0,0,0,1
Somalia,2005-03-01,2,0,0,0,0,2
Somalia,2005-03-01,2,0,0,-4,0,-2
Somalia,2005-03-01,32,0,0,0,0,32
Somalia,2005-03-01,23,0,0,3,5,31
Somalia,2005-03-01,9,0,0,1,0,10
Somalia,2005-03-01,4,4,0,3,2,13
Somalia,2005-03-01,3,0,0,17,2,22
Somalia,2005-03-01,4,0,0,-4,2,2
Somalia,2005-03-01,1,0,0,3,1,5
Somalia,2005-03-01,6,0,0,6,2,14
Somalia,2005-03-01,3,0,0,0,0,3
Somalia,2005-03-01,15,0,0,0,0,15
Somalia,2005-03-01,3,0,0,0,0,3
Somalia,2005-03-01,0,0,0,0,0,0
Somalia,2005-03-01,10,0,0,0,3,13
Somalia,2005-03-01,3,0,0,0,0,3
Somalia,2005-03-01,0,0,0,0,0,0
Somalia,2005-03-01,15,0,0,0,0,15
Somalia,2005-03-01,-1,0,0,0,0,-1
Somalia,2005-04-01,0,0,0,6,0,6
Somalia,2005-04-01,0,0,0,0,0,0
Somalia,2005-04-01,0,0,0,0,0,0
Somalia,2005-04-01,6,0,0,0,0,6
Somalia,2005-04-01,0,0,0,0,2,2
Somalia,2005-04-01,7,0,0,3,0,10
Somalia,2005-04-01,2,0,0,0,0,2
Somalia,2005-04-01,11,0,0,3,0,14
Somalia,2005-04-01,3,0,1,-2,0,2
Somalia,2005-04-01,0,0,0,0,0,0
Somalia,2005-04-01,3,0,0,0,2,5
Somalia,2005-04-01,0,0,0,0,0,0
Somalia,2005-04-01,0,0,0,0,0,0
Somalia,2005-04-01,0,0,0,0,0,0
Somalia,2005-04-01,-7,0,0,0,0,-7
Somalia,2005-04-01,1,0,0,3,0,4
Somalia,2005-04-01,0,0,0,0,0,0
Somalia,2005-04-01,0,0,0,1,0,1
Somalia,2005-04-01,1,0,0,3,0,4
Somalia,2005-04-01,3,0,0,-2,0,1
Somalia,2005-04-01,3,0,0,0,0,3
Somalia,2005-04-01,0,0,0,0,0,0
Somalia,2005-04-01,0,0,1,0,0,1
Somalia,2005-04-01,9,0,0,0,0,9
Somalia,2005-04-01,0,0,0,0,0,0
Somalia,2005-04-01,2,0,0,0,0,2
Somalia,2005-05-01,3,0,0,0,0,3
Somalia,2005-05-01,4,0,0,0,0,4
Somalia,2005-05-01,0,0,0,0,0,0
Somalia,2005-05-01,0,0,0,0,0,0
Somalia,2005-05-01,3,0,0,0,0,3
Somalia,2005-05-01,-1,0,0,0,0,-1
Somalia,2005-05-01,0,0,0,0,0,0
Somalia,2005-05-01,0,0,0,0,0,0
Somalia,2005-05-01,-1,0,0,0,0,-1
Somalia,2005-05-01,0,0,0,0,0,0
Somalia,2005-05-01,0,0,0,0,0,0
Somalia,2005-05-01,0,0,0,0,0,0
Somalia,2005-05-01,1,0,0,0,1,2
Somalia,2005-05-01,2,0,0,0,2,4
Somalia,2005-05-01,1,0,0,0,0,1
Somalia,2005-05-01,0,0,0,0,1,1
Somalia,2005-05-01,0,0,0,0,2,2
Somalia,2005-05-01,-4,0,0,0,0,-4
Somalia,2005-05-01,0,0,0,0,0,0
Somalia,2005-05-01,0,0,0,0,0,0
Somalia,2005-05-01,3,0,0,9,0,12
Somalia,2005-05-01,2,0,0,0,0,2
Somalia,2005-05-01,0,0,0,0,0,0
Somalia,2005-05-01,4,0,0,0,0,4
Somalia,2005-05-01,2,0,0,0,0,2
Somalia,2005-05-01,0,0,0,0,0,0
Somalia,2005-05-01,0,0,0,1,0,1
Somalia,2005-05-01,0,0,0,0,0,0
Somalia,2005-06-01,1,0,0,0,0,1
Somalia,2005-06-01,0,4,0,0,0,4
Somalia,2005-06-01,0,0,0,0,0,0
Somalia,2005-06-01,9,0,0,0,0,9
Somalia,2005-06-01,0,0,0,3,0,3
Somalia,2005-06-01,-2,2,0,-6,0,-6
Somalia,2005-06-01,0,0,0,3,0,3
Somalia,2005-06-01,0,0,0,0,0,0
Somalia,2005-06-01,-1,0,0,0,0,-1
Somalia,2005-06-01,-2,0,0,0,0,-2
Somalia,2005-06-01,0,0,0,0,0,0
Somalia,2005-06-01,-1,0,0,3,0,2
Somalia,2005-06-01,0,0,0,-2,0,-2
Somalia,2005-06-01,1,0,0,0,0,1
Somalia,2005-06-01,1,0,0,0,0,1
Somalia,2005-06-01,3,0,0,6,0,9
Somalia,2005-06-01,0,0,0,0,0,0
Somalia,2005-06-01,0,0,0,0,0,0
Somalia,2005-06-01,3,0,0,0,0,3
Somalia,2005-06-01,0,0,0,1,0,1
Somalia,2005-06-01,0,0,0,4,0,4
Somalia,2005-06-01,0,0,0,0,0,0
Somalia,2005-06-01,-1,0,0,0,0,-1
Somalia,2005-06-01,0,0,0,0,0,0
Somalia,2005-06-01,14,0,0,0,2,16
Somalia,2005-06-01,0,0,0,0,0,0
Somalia,2005-06-01,0,0,0,3,2,5
Somalia,2005-07-01,3,0,0,6,0,9
Somalia,2005-07-01,0,0,0,1,0,1
Somalia,2005-07-01,0,0,0,0,0,0
Somalia,2005-07-01,0,0,0,3,2,5
Somalia,2005-07-01,1,0,0,0,0,1
Somalia,2005-07-01,6,0,0,6,0,12
Somalia,2005-07-01,0,0,0,2,0,2
Somalia,2005-07-01,7,0,0,0,0,7
Somalia,2005-07-01,0,0,0,0,0,0
Somalia,2005-07-01,9,0,0,0,0,9
Somalia,2005-07-01,3,0,0,0,0,3
Somalia,2005-07-01,8,0,0,0,0,8
Somalia,2005-07-01,0,0,0,3,0,3
Somalia,2005-07-01,0,0,0,0,0,0
Somalia,2005-07-01,3,0,0,-2,0,1
Somalia,2005-07-01,0,0,0,1,0,1
Somalia,2005-07-01,0,0,0,3,0,3
Somalia,2005-07-01,0,0,0,0,0,0
Somalia,2005-07-01,0,0,0,-2,0,-2
Somalia,2005-07-01,3,0,0,1,6,10
Somalia,2005-07-01,0,0,0,0,0,0
Somalia,2005-07-01,0,0,0,3,0,3
Somalia,2005-07-01,1,0,0,3,0,4
Somalia,2005-07-01,23,0,0,9,2,34
Somalia,2005-07-01,11,0,0,3,0,14
Somalia,2005-07-01,12,0,0,12,0,24
Somalia,2005-07-01,12,0,0,16,1,29
Somalia,2005-07-01,15,0,0,18,6,39
Somalia,2005-07-01,0,0,0,21,0,21
Somalia,2005-07-01,1,0,0,0,0,1
Somalia,2005-08-01,0,0,1,0,0,1
Somalia,2005-08-01,0,0,0,0,0,0
Somalia,2005-08-01,6,0,0,0,0,6
Somalia,2005-08-01,1,0,0,0,1,2
Somalia,2005-08-01,-3,0,0,0,0,-3
Somalia,2005-08-01,-2,0,0,3,0,1
Somalia,2005-08-01,1,0,-2,0,0,-1
Somalia,2005-08-01,0,0,0,0,0,0
Somalia,2005-08-01,6,0,0,3,4,13
Somalia,2005-08-01,6,0,0,0,0,6
Somalia,2005-08-01,2,0,0,0,4,6
Somalia,2005-08-01,0,0,0,0,0,0
Somalia,2005-08-01,0,0,0,0,0,0
Somalia,2005-08-01,5,0,0,0,0,5
Somalia,2005-08-01,4,0,0,6,2,12
Somalia,2005-08-01,1,0,0,-8,2,-5
Somalia,2005-08-01,11,0,0,0,2,13
Somalia,2005-08-01,0,0,0,0,0,0
Somalia,2005-08-01,4,0,0,5,0,9
Somalia,2005-08-01,6,0,0,0,0,6
Somalia,2005-08-01,0,0,0,0,0,0
Somalia,2005-08-01,1,0,0,-2,0,-1
Somalia,2005-08-01,1,0,0,0,0,1
Somalia,2005-08-01,21,0,0,0,0,21
Somalia,2005-08-01,1,0,0,0,0,1
Somalia,2005-08-01,0,0,0,3,1,4
Somalia,2005-08-01,3,0,0,0,0,3
Somalia,2005-08-01,6,2,-2,9,0,15
Somalia,2005-08-01,6,0,0,7,0,13
Somalia,2005-09-01,7,0,0,-9,0,-2
Somalia,2005-09-01,1,0,0,-6,0,-5
Somalia,2005-09-01,0,0,0,0,0,0
Somalia,2005-09-01,4,0,0,0,0,4
Somalia,2005-09-01,4,0,0,9,0,13
Somalia,2005-09-01,-2,0,0,8,0,6
Somalia,2005-09-01,0,0,0,0,2,2
Somalia,2005-09-01,-2,0,0,0,0,-2
Somalia,2005-09-01,0,0,0,0,0,0
Somalia,2005-09-01,15,0,0,0,0,15
Somalia,2005-09-01,3,0,0,3,0,6
Somalia,2005-09-01,2,0,0,3,0,5
Somalia,2005-09-01,0,0,0,3,0,3
Somalia,2005-09-01,2,0,0,0,0,2
Somalia,2005-09-01,0,0,0,0,0,0
Somalia,2005-09-01,0,0,0,0,0,0
Somalia,2005-09-01,0,0,0,0,0,0
Somalia,2005-09-01,-1,0,0,1,0,0
Somalia,2005-09-01,0,0,0,6,0,6
Somalia,2005-09-01,5,2,0,2,0,9
Somalia,2005-09-01,0,0,0,0,0,0
Somalia,2005-09-01,0,0,0,0,0,0
Somalia,2005-09-01,0,0,1,13,0,14
Somalia,2005-09-01,2,0,0,0,0,2
Somalia,2005-09-01,0,0,0,0,0,0
Somalia,2005-09-01,0,0,0,0,0,0
Somalia,2005-10-01,-1,0,0,3,0,2
Somalia,2005-10-01,3,0,0,0,0,3
Somalia,2005-10-01,0,0,0,0,0,0
Somalia,2005-10-01,0,0,0,0,0,0
Somalia,2005-10-01,0,0,0,-4,0,-4
Somalia,2005-10-01,0,0,0,0,0,0
Somalia,2005-10-01,2,0,0,0,0,2
Somalia,2005-10-01,0,0,0,3,0,3
Somalia,2005-10-01,0,0,0,9,0,9
Somalia,2005-10-01,0,4,1,0,0,5
Somalia,2005-10-01,0,0,0,10,0,10
Somalia,2005-10-01,0,4,0,12,0,16
Somalia,2005-10-01,2,0,0,3,0,5
Somalia,2005-10-01,0,0,0,-6,0,-6
Somalia,2005-10-01,0,0,0,0,0,0
Somalia,2005-10-01,0,0,0,3,0,3
Somalia,2005-10-01,4,0,0,-1,0,3
Somalia,2005-10-01,3,0,0,0,0,3
Somalia,2005-10-01,6,0,0,-4,0,2
Somalia,2005-10-01,3,0,0,0,0,3
Somalia,2005-10-01,3,2,0,6,0,11
Somalia,2005-10-01,0,0,0,0,0,0
Somalia,2005-10-01,2,0,0,4,0,6
Somalia,2005-10-01,7,0,0,12,0,19
Somalia,2005-10-01,7,0,0,0,0,7
Somalia,2005-10-01,0,0,0,-4,0,-4
Somalia,2005-10-01,9,0,0,-5,0,4
Somalia,2005-10-01,2,0,0,0,0,2
Somalia,2005-10-01,1,0,0,0,0,1
Somalia,2005-10-01,3,0,0,3,0,6
Somalia,2005-11-01,0,0,0,0,0,0
Somalia,2005-11-01,3,0,0,-2,0,1
Somalia,2005-11-01,12,0,0,0,0,12
Somalia,2005-11-01,5,0,0,0,0,5
Somalia,2005-11-01,3,0,0,0,0,3
Somalia,2005-11-01,5,0,0,0,2,7
Somalia,2005-11-01,3,0,0,0,0,3
Somalia,2005-11-01,5,2,0,-1,0,6
Somalia,2005-11-01,-6,0,0,3,0,-3
Somalia,2005-11-01,0,0,0,0,0,0
Somalia,2005-11-01,1,0,0,0,0,1
Somalia,2005-11-01,0,0,0,3,0,3
Somalia,2005-11-01,3,0,0,0,0,3
Somalia,2005-11-01,14,0,0,0,0,14
Somalia,2005-11-01,3,0,0,0,0,3
Somalia,2005-11-01,0,0,0,-4,1,-3
Somalia,2005-11-01,0,0,0,-4,0,-4
Somalia,2005-11-01,0,0,0,0,0,0
Somalia,2005-11-01,0,0,0,0,0,0
Somalia,2005-11-01,0,0,0,0,0,0
Somalia,2005-11-01,-1,0,0,0,0,-1
Somalia,2005-11-01,26,0,0,0,2,28
Somalia,2005-11-01,1,0,0,0,0,1
Somalia,2005-11-01,4,0,0,-9,1,-4
Somalia,2005-11-01,2,0,0,2,0,4
Somalia,2005-11-01,0,0,0,3,0,3
Somalia,2005-11-01,0,0,0,3,0,3
Somalia,2005-12-01,0,0,0,-8,0,-8
Somalia,2005-12-01,0,0,0,6,0,6
Somalia,2005-12-01,3,0,0,0,1,4
Somalia,2005-12-01,0,0,0,0,0,0
Somalia,2005-12-01,3,0,0,-6,0,-3
Somalia,2005-12-01,0,0,0,-4,0,-4
Somalia,2005-12-01,0,0,0,3,0,3
Somalia,2005-12-01,2,2,0,0,0,4
Somalia,2005-12-01,-1,0,-6,14,0,7
Somalia,2005-12-01,0,0,0,0,0,0
Somalia,2005-12-01,0,0,0,0,0,0
Somalia,2005-12-01,2,0,0,0,0,2
Somalia,2005-12-01,0,2,0,0,0,2
Somalia,2005-12-01,1,0,0,0,0,1
Somalia,2005-12-01,-3,0,0,0,0,-3
Somalia,2005-12-01,33,0,0,6,2,41
Somalia,2005-12-01,0,0,0,0,0,0
Somalia,2005-12-01,0,0,0,0,0,0
Somalia,2005-12-01,0,0,0,0,0,0
Somalia,2005-12-01,2,0,0,0,0,2
Somalia,2005-12-01,0,0,0,0,0,0
Somalia,2005-12-01,0,0,0,-3,0,-3
Somalia,2005-12-01,3,0,0,0,0,3
Somalia,2005-12-01,6,0,0,-4,0,2
Somalia,2005-12-01,27,0,0,0,0,27
Somalia,2005-12-01,0,0,-2,0,0,-2
Syria,2005-01-01,4,0,0,0,0,4
Syria,2005-01-01,3,0,-8,0,0,-5
Syria,2005-01-01,6,0,0,0,0,6
Syria,2005-01-01,2,0,0,-3,0,-1
Syria,2005-01-01,12,0,0,0,0,12
Syria,2005-01-01,4,0,-1,6,0,9
Syria,2005-01-01,8,0,0,0,1,9
Syria,2005-01-01,-8,0,0,0,-4,-12
Syria,2005-01-01,12,0,0,0,0,12
Syria,2005-01-01,13,0,0,0,0,13
Syria,2005-01-01,13,0,0,7,2,22
Syria,2005-01-01,-1,0,0,24,0,23
Syria,2005-01-01,7,0,0,0,0,7
Syria,2005-01-01,22,0,0,0,2,24
Syria,2005-01-01,15,0,0,0,0,15
Syria,2005-01-01,7,0,0,6,1,14
Syria,2005-01-01,11,0,0,9,1,21
Syria,2005-01-01,2,0,0,-4,0,-2
Syria,2005-01-01,0,0,0,2,0,2
Syria,2005-01-01,7,0,0,0,0,7
Syria,2005-01-01,2,0,0,0,0,2
Syria,2005-01-01,6,0,0,6,0,12
Syria,2005-01-01,1,0,0,0,1,2
Syria,2005-01-01,7,0,0,0,2,9
Syria,2005-01-01,0,0,0,0,1,1
Syria,2005-01-01,2,0,0,9,0,11
Syria,2005-01-01,4,0,0,-2,0,2
Syria,2005-01-01,4,0,0,0,0,4
Syria,2005-01-01,8,0,0,0,0,8
Syria,2005-01-01,13,0,0,6,10,29
Syria,2005-01-01,5,0,0,3,1,9
Syria,2005-02-01,7,0,0,12,0,19
Syria,2005-02-01,7,0,0,0,0,7
Syria,2005-02-01,-4,0,0,0,0,-4
Syria,2005-02-01,-3,0,0,0,0,-3
Syria,2005-02-01,-6,0,0,6,0,0
Syria,2005-02-01,4,0,3,2,0,9
Syria,2005-02-01,2,0,0,0,0,2
Syria,2005-02-01,4,0,0,6,0,10
Syria,2005-02-01,8,0,0,0,1,9
Syria,2005-02-01,0,0,0,3,0,3
Syria,2005-02-01,1,0,0,0,0,1
Syria,2005-02-01,-3,0,0,0,0,-3
Syria,2005-02-01,6,0,0,6,3,15
Syria,2005-02-01,24,0,0,1,6,31
Syria,2005-02-01,18,0,-1,0,0,17
Syria,2005-02-01,10,0,0,0,2,12
Syria,2005-02-01,11,0,0,12,5,28
Syria,2005-02-01,27,0,-6,15,0,36
Syria,2005-02-01,2,0,2,21,4,29
Syria,2005-02-01,-4,0,3,0,0,-1
Syria,2005-02-01,-15,0,0,2,2,-11
Syria,2005-02-01,2,0,0,0,3,5
Syria,2005-02-01,14,0,0,0,2,16
Syria,2005-02-01,-7,0,0,0,1,-6
Syria,2005-02-01,-13,0,0,9,0,-4
Syria,2005-02-01,-1,0,0,0,5,4
Syria,2005-02-01,11,0,0,1,1,13
Syria,2005-02-01,-8,0,-9,12,5,0
Syria,2005-03-01,25,0,2,20,6,53
Syria,2005-03-01,-19,0,-2,5,0,-16
Syria,2005-03-01,-18,0,-8,3,0,-23
Syria,2005-03-01,0,0,0,3,0,3
Syria,2005-03-01,-26,0,0,3,2,-21
Syria,2005-03-01,-5,0,0,4,3,2
Syria,2005-03-01,-5,0,0,4,2,1
Syria,2005-03-01,6,0,2,3,0,11
Syria,2005-03-01,0,0,0,0,1,1
Syria,2005-03-01,5,0,-10,-2,0,-7
Syria,2005-03-01,-5,0,-3,0,5,-3
Syria,2005-03-01,-16,0,-4,18,4,2
Syria,2005-03-01,1,0,0,6,8,15
Syria,2005-03-01,-3,0,-2,3,13,11
Syria,2005-03-01,-4,0,0,0,8,4
Syria,2005-03-01,-29,0,0,9,7,-13
Syria,2005-03-01,-41,0,-3,0,8,-36
Syria,2005-03-01,-2,0,0,-2,0,-4
Syria,2005-03-01,-16,0,-2,12,0,-6
Syria,2005-03-01,-8,0,0,0,0,-8
Syria,2005-03-01,13,0,0,3,0,16
Syria,2005-03-01,13,0,-6,3,0,10
Syria,2005-03-01,12,0,1,6,0,19
Syria,2005-03-01,-26,0,0,0,0,-26
Syria,2005-03-01,-7,0,0,0,0,-7
Syria,2005-03-01,-3,0,1,0,0,-2
Syria,2005-03-01,24,0,0,3,0,27
Syria,2005-03-01,4,0,0,-2,0,2
Syria,2005-03-01,-9,0,-2,6,1,-4
Syria,2005-03-01,20,0,0,-4,0,16
Syria,2005-03-01,2,0,3,9,4,18
Syria,2005-04-01,12,0,-1,-2,0,9
Syria,2005-04-01,0,0,0,0,0,0
Syria,2005-04-01,3,0,0,-2,1,2
Syria,2005-04-01,-4,0,0,6,2,4
Syria,2005-04-01,-5,0,0,-6,0,-11
Syria,2005-04-01,5,0,1,4,0,10
Syria,2005-04-01,-9,0,0,0,2,-7
Syria,2005-04-01,4,0,0,0,0,4
Syria,2005-04-01,1,0,0,0,0,1
Syria,2005-04-01,-5,0,0,12,0,7
Syria,2005-04-01,6,0,0,7,5,18
Syria,2005-04-01,55,0,1,12,6,74
Syria,2005-04-01,15,0,0,6,0,21
Syria,2005-04-01,16,0,2,21,0,39
Syria,2005-04-01,-5,0,-2,0,0,-7
Syria,2005-04-01,6,0,0,0,2,8
Syria,2005-04-01,-6,0,0,0,1,-5
Syria,2005-04-01,-6,0,0,-3,0,-9
Syria,2005-04-01,-33,0,0,0,1,-32
Syria,2005-04-01,-4,0,0,0,1,-3
Syria,2005-04-01,12,0,0,3,4,19
Syria,2005-04-01,23,0,-1,9,0,31
Syria,2005-04-01,-3,0,0,0,0,-3
Syria,2005-04-01,-5,0,0,-2,0,-7
Syria,2005-04-01,-22,0,1,3,0,-18
Syria,2005-04-01,-18,0,0,5,2,-11
Syria,2005-04-01,-4,0,0,6,0,2
Syria,2005-04-01,4,0,0,7,1,12
Syria,2005-04-01,-11,0,-1,3,0,-9
Syria,2005-04-01,2,2,0,-5,0,-1
Syria,2005-05-01,15,0,0,0,0,15
Syria,2005-05-01,13,0,0,4,0,17
Syria,2005-05-01,23,2,0,-6,1,20
Syria,2005-05-01,12,0,0,8,0,20
Syria,2005-05-01,8,2,0,0,0,10
Syria,2005-05-01,9,0,0,7,1,17
Syria,2005-05-01,-12,0,-2,0,0,-14
Syria,2005-05-01,9,0,0,3,0,12
Syria,2005-05-01,16,0,0,1,2,19
Syria,2005-05-01,18,4,0,15,1,38
Syria,2005-05-01,16,0,0,0,0,16
Syria,2005-05-01,24,0,0,15,2,41
Syria,2005-05-01,19,0,0,0,3,22
Syria,2005-05-01,33,0,0,3,0,36
Syria,2005-05-01,9,0,0,-1,0,8
Syria,2005-05-01,19,0,0,0,0,19
Syria,2005-05-01,8,0,0,0,0,8
Syria,2005-05-01,-10,0,0,1,0,-9
Syria,2005-05-01,7,0,0,9,2,18
Syria,2005-05-01,14,0,0,0,0,14
Syria,2005-05-01,0,0,0,1,0,1
Syria,2005-05-01,5,0,0,9,0,14
Syria,2005-05-01,5,0,0,0,0,5
Syria,2005-05-01,3,0,0,17,0,20
Syria,2005-05-01,31,0,1,2,1,35
Syria,2005-05-01,25,0,0,1,0,26
Syria,2005-05-01,5,0,0,11,0,16
Syria,2005-05-01,-7,0,-4,4,2,-5
Syria,2005-05-01,0,0,1,8,2,11
Syria,2005-05-01,6,0,0,19,0,25
Syria,2005-05-01,8,0,0,0,0,8
Syria,2005-06-01,15,0,0,13,3,31
Syria,2005-06-01,8,0,1,0,0,9
Syria,2005-06-01,-1,4,0,3,14,20
Syria,2005-06-01,3,0,0,4,0,7
Syria,2005-06-01,13,0,0,3,0,16
Syria,2005-06-01,6,0,-4,27,2,31
Syria,2005-06-01,-7,0,-2,-1,1,-9
Syria,2005-06-01,3,0,-3,21,0,21
Syria,2005-06-01,32,0,1,3,2,38
Syria,2005-06-01,16,0,0,0,0,16
Syria,2005-06-01,14,0,0,0,0,14
Syria,2005-06-01,3,0,0,0,5,8
Syria,2005-06-01,12,0,0,9,0,21
Syria,2005-06-01,2,0,0,8,0,10
Syria,2005-06-01,0,0,0,2,0,2
Syria,2005-06-01,2,0,0,0,10,12
Syria,2005-06-01,19,0,0,6,0,25
Syria,2005-06-01,5,0,-4,6,3,10
Syria,2005-06-01,27,0,0,18,4,49
Syria,2005-06-01,5,0,1,3,6,15
Syria,2005-06-01,55,0,-2,-1,19,71
Syria,2005-06-01,5,0,0,0,2,7
Syria,2005-06-01,33,0,1,0,0,34
Syria,2005-06-01,20,0,1,3,0,24
Syria,2005-06-01,10,0,0,0,0,10
Syria,2005-06-01,-1,0,0,5,0,4
Syria,2005-06-01,8,0,0,-1,0,7
Syria,2005-06-01,-4,0,0,0,1,-3
Syria,2005-06-01,15,0,4,0,0,19
Syria,2005-06-01,7,0,0,-4,0,3
Syria,2005-07-01,5,0,-2,3,6,12
Syria,2005-07-01,9,0,0,2,0,11
Syria,2005-07-01,5,0,0,6,0,11
Syria,2005-07-01,8,0,0,15,0,23
Syria,2005-07-01,28,0,0,9,0,37
Syria,2005-07-01,-4,0,0,3,0,-1
Syria,2005-07-01,18,0,0,3,0,21
Syria,2005-07-01,-4,0,0,7,0,3
Syria,2005-07-01,11,0,0,-4,0,7
Syria,2005-07-01,5,0,0,6,18,29
Syria,2005-07-01,13,0,0,0,27,40
Syria,2005-07-01,16,0,0,15,4,35
Syria,2005-07-01,13,0,0,9,3,25
Syria,2005-07-01,4,0,0,12,2,18
Syria,2005-07-01,2,0,0,6,0,8
Syria,2005-07-01,9,0,0,0,0,9
Syria,2005-07-01,3,0,0,0,0,3
Syria,2005-07-01,0,0,1,3,0,4
Syria,2005-07-01,16,0,1,6,1,24
Syria,2005-07-01,12,0,0,-1,0,11
Syria,2005-07-01,2,0,0,3,4,9
Syria,2005-07-01,0,0,0,-2,0,-2
Syria,2005-07-01,1,0,0,0,0,1
Syria,2005-07-01,0,0,0,3,0,3
Syria,2005-07-01,7,0,0,0,0,7
Syria,2005-07-01,17,0,0,3,0,20
Syria,2005-07-01,0,0,0,3,0,3
Syria,2005-07-01,9,0,0,3,1,13
Syria,2005-07-01,24,0,0,3,0,27
Syria,2005-07-01,9,0,0,3,0,12
Syria,2005-07-01,10,0,0,0,0,10
Syria,2005-08-01,0,0,0,0,0,0
Syria,2005-08-01,5,0,0,0,0,5
Syria,2005-08-01,13,0,0,3,4,20
Syria,2005-08-01,3,0,0,0,0,3
Syria,2005-08-01,39,0,0,9,1,49
Syria,2005-08-01,-2,0,0,0,0,-2
Syria,2005-08-01,0,0,0,0,2,2
Syria,2005-08-01,6,0,-1,21,2,28
Syria,2005-08-01,14,0,0,3,0,17
Syria,2005-08-01,33,0,0,6,3,42
Syria,2005-08-01,11,0,0,23,0,34
Syria,2005-08-01,9,0,0,2,0,11
Syria,2005-08-01,5,0,0,0,0,5
Syria,2005-08-01,-3,0,0,0,0,-3
Syria,2005-08-01,0,0,0,6,0,6
Syria,2005-08-01,-1,0,0,0,0,-1
Syria,2005-08-01,-2,0,0,1,0,-1
Syria,2005-08-01,0,0,0,0,2,2
Syria,2005-08-01,0,0,0,0,0,0
Syria,2005-08-01,9,0,0,0,0,9
Syria,2005-08-01,0,0,0,0,0,0
Syria,2005-08-01,5,0,0,0,2,7
Syria,2005-08-01,20,0,0,2,0,22
Syria,2005-08-01,3,0,0,0,0,3
Syria,2005-08-01,10,0,0,6,0,16
Syria,2005-08-01,6,0,0,3,0,9
Syria,2005-08-01,6,0,0,4,0,10
Syria,2005-08-01,0,0,0,6,0,6
Syria,2005-08-01,1,0,0,1,0,2
Syria,2005-08-01,33,0,2,18,1,54
Syria,2005-08-01,18,0,0,3,0,21
Syria,2005-09-01,25,0,0,3,0,28
Syria,2005-09-01,-1,0,0,0,0,-1
Syria,2005-09-01,-1,0,0,0,0,-1
Syria,2005-09-01,0,0,0,3,0,3
Syria,2005-09-01,-3,0,0,0,0,-3
Syria,2005-09-01,5,0,0,2,2,9
Syria,2005-09-01,4,0,0,0,0,4
Syria,2005-09-01,30,0,0,27,3,60
Syria,2005-09-01,6,0,-2,3,3,10
Syria,2005-09-01,9,0,0,12,0,21
Syria,2005-09-01,12,0,0,12,0,24
Syria,2005-09-01,9,0,0,3,0,12
Syria,2005-09-01,5,0,0,-4,0,1
Syria,2005-09-01,3,0,0,0,2,5
Syria,2005-09-01,10,0,0,0,0,10
Syria,2005-09-01,7,0,0,12,0,19
Syria,2005-09-01,12,0,0,4,0,16
Syria,2005-09-01,0,0,0,0,0,0
Syria,2005-09-01,7,0,0,12,0,19
Syria,2005-09-01,13,0,0,7,0,20
Syria,2005-09-01,9,0,0,0,0,9
Syria,2005-09-01,0,0,0,6,0,6
Syria,2005-09-01,-3,0,0,15,0,12
Syria,2005-09-01,6,0,0,0,0,6
Syria,2005-09-01,-2,0,0,0,0,-2
Syria,2005-09-01,-3,0,0,22,0,19
Syria,2005-09-01,-4,0,0,3,0,-1
Syria,2005-09-01,20,0,0,3,0,23
Syria,2005-09-01,21,0,0,6,0,27
Syria,2005-09-01,5,0,0,0,0,5
Syria,2005-10-01,4,0,0,3,6,13
Syria,2005-10-01,12,0,0,3,0,15
Syria,2005-10-01,16,0,0,-14,0,2
Syria,2005-10-01,16,0,0,3,0,19
Syria,2005-10-01,4,0,-2,6,0,8
Syria,2005-10-01,1,0,0,6,0,7
Syria,2005-10-01,18,0,0,3,0,21
Syria,2005-10-01,-4,0,0,3,0,-1
Syria,2005-10-01,10,0,0,4,1,15
Syria,2005-10-01,6,0,0,9,0,15
Syria,2005-10-01,10,0,0,6,15,31
Syria,2005-10-01,33,0,0,3,12,48
Syria,2005-10-01,21,0,0,3,0,24
Syria,2005-10-01,-1,0,0,0,0,-1
Syria,2005-10-01,2,0,0,0,6,8
Syria,2005-10-01,2,0,0,9,0,11
Syria,2005-10-01,-4,0,0,0,0,-4
Syria,2005-10-01,-2,0,1,12,0,11
Syria,2005-10-01,3,0,0,9,0,12
Syria,2005-10-01,41,0,0,18,0,59
Syria,2005-10-01,23,0,1,6,7,37
Syria,2005-10-01,30,0,1,2,1,34
Syria,2005-10-01,10,0,0,9,0,19
Syria,2005-10-01,11,0,2,15,0,28
Syria,2005-10-01,29,0,-6,9,5,37
Syria,2005-10-01,42,0,0,21,3,66
Syria,2005-10-01,6,0,0,0,0,6
Syria,2005-10-01,2,0,0,5,0,7
Syria,2005-10-01,25,0,0,12,1,38
Syria,2005-10-01,16,0,-4,9,4,25
Syria,2005-10-01,16,0,0,0,7,23
Syria,2005-11-01,33,0,0,18,1,52
Syria,2005-11-01,11,2,0,2,4,19
Syria,2005-11-01,4,0,0,12,5,21
Syria,2005-11-01,0,0,0,0,0,0
Syria,2005-11-01,4,0,-6,18,2,18
Syria,2005-11-01,20,0,0,0,2,22
Syria,2005-11-01,27,0,0,0,0,27
Syria,2005-11-01,26,0,0,0,0,26
Syria,2005-11-01,5,0,0,6,0,11
Syria,2005-11-01,42,0,1,3,6,52
Syria,2005-11-01,3,0,0,0,1,4
Syria,2005-11-01,20,0,0,3,0,23
Syria,2005-11-01,6,0,1,6,0,13
Syria,2005-11-01,17,0,0,3,0,20
Syria,2005-11-01,13,0,0,0,6,19
Syria,2005-11-01,28,0,0,0,0,28
Syria,2005-11-01,6,0,0,12,0,18
Syria,2005-11-01,8,0,0,0,0,8
Syria,2005-11-01,6,0,1,1,0,8
Syria,2005-11-01,3,0,0,0,0,3
Syria,2005-11-01,15,0,0,0,0,15
Syria,2005-11-01,22,0,-2,6,0,26
Syria,2005-11-01,7,0,0,3,0,10
Syria,2005-11-01,12,0,0,6,0,18
Syria,2005-11-01,16,0,0,0,0,16
Syria,2005-11-01,17,0,-1,9,0,25
Syria,2005-11-01,22,0,0,0,0,22
Syria,2005-11-01,9,0,0,0,0,9
Syria,2005-11-01,2,0,0,3,0,5
Syria,2005-11-01,7,0,0,15,4,26
Syria,2005-12-01,0,0,0,-2,0,-2
Syria,2005-12-01,9,0,-4,3,0,8
Syria,2005-12-01,21,0,0,3,0,24
Syria,2005-12-01,21,0,0,0,0,21
Syria,2005-12-01,5,0,0,1,2,8
Syria,2005-12-01,17,4,0,12,1,34
Syria,2005-12-01,8,0,0,7,0,15
Syria,2005-12-01,31,0,0,0,6,37
Syria,2005-12-01,8,0,0,3,3,14
Syria,2005-12-01,1,0,0,0,0,1
Syria,2005-12-01,6,0,0,3,0,9
Syria,2005-12-01,44,0,2,4,14,64
Syria,2005-12-01,17,0,0,0,7,24
Syria,2005-12-01,5,0,0,9,21,35
Syria,2005-12-01,28,0,0,3,1,32
Syria,2005-12-01,8,0,0,6,0,14
Syria,2005-12-01,15,0,-6,0,6,15
Syria,2005-12-01,8,0,0,-2,0,6
Syria,2005-12-01,3,0,0,0,1,4
Syria,2005-12-01,39,0,-2,9,0,46
Syria,2005-12-01,-2,0,-2,0,4,0
Syria,2005-12-01,15,0,0,3,0,18
Syria,2005-12-01,0,0,0,0,0,0
Syria,2005-12-01,0,0,0,0,0,0
Syria,2005-12-01,2,0,0,0,0,2
Syria,2005-12-01,2,0,0,0,0,2
Syria,2005-12-01,38,0,0,12,2,52
Syria,2005-12-01,38,0,0,3,1,42
Syria,2005-12-01,-7,0,-3,3,0,-7
Syria,2005-12-01,25,0,0,21,3,49
Yemen,2005-01-01,6,0,0,0,0,6
Yemen,2005-01-01,1,0,0,3,0,4
Yemen,2005-01-01,6,0,0,0,0,6
Yemen,2005-01-01,0,0,0,3,0,3
Yemen,2005-01-01,6,0,0,3,0,9
Yemen,2005-01-01,10,0,0,0,0,10
Yemen,2005-01-01,0,0,0,4,1,5
Yemen,2005-01-01,3,0,0,0,0,3
Yemen,2005-01-01,0,0,0,0,0,0
Yemen,2005-01-01,6,0,0,12,0,18
Yemen,2005-01-01,0,0,0,0,0,0
Yemen,2005-01-01,9,0,1,0,1,11
Yemen,2005-01-01,18,0,0,3,0,21
Yemen,2005-01-01,0,0,0,0,0,0
Yemen,2005-01-01,0,0,0,3,0,3
Yemen,2005-01-01,0,0,0,0,0,0
Yemen,2005-01-01,5,0,0,0,0,5
Yemen,2005-01-01,0,0,0,3,0,3
Yemen,2005-01-01,0,0,1,6,0,7
Yemen,2005-01-01,8,0,0,0,0,8
Yemen,2005-01-01,0,0,0,0,0,0
Yemen,2005-01-01,6,0,0,0,0,6
Yemen,2005-01-01,5,0,0,0,2,7
Yemen,2005-01-01,2,0,0,5,2,9
Yemen,2005-02-01,0,0,0,0,0,0
Yemen,2005-02-01,0,0,0,0,0,0
Yemen,2005-02-01,0,0,0,3,0,3
Yemen,2005-02-01,0,0,0,0,0,0
Yemen,2005-02-01,12,0,1,6,0,19
Yemen,2005-02-01,3,0,0,0,0,3
Yemen,2005-02-01,0,0,0,0,0,0
Yemen,2005-02-01,3,0,0,0,0,3
Yemen,2005-02-01,-1,0,0,0,0,-1
Yemen,2005-02-01,2,0,0,0,0,2
Yemen,2005-02-01,0,0,0,0,0,0
Yemen,2005-02-01,2,0,0,0,0,2
Yemen,2005-02-01,0,0,0,0,0,0
Yemen,2005-02-01,4,0,0,0,0,4
Yemen,2005-02-01,-2,0,0,21,1,20
Yemen,2005-02-01,0,0,0,0,0,0
Yemen,2005-02-01,0,0,0,3,3,6
Yemen,2005-02-01,9,0,0,0,0,9
Yemen,2005-02-01,0,0,0,0,0,0
Yemen,2005-02-01,9,0,0,0,0,9
Yemen,2005-02-01,0,0,0,3,0,3
Yemen,2005-02-01,8,0,7,6,9,30
Yemen,2005-02-01,0,0,0,3,0,3
Yemen,2005-02-01,4,0,0,12,0,16
Yemen,2005-03-01,4,0,0,0,0,4
Yemen,2005-03-01,0,0,0,0,0,0
Yemen,2005-03-01,7,0,0,12,0,19
Yemen,2005-03-01,3,0,0,0,0,3
Yemen,2005-03-01,0,0,0,0,0,0
Yemen,2005-03-01,0,0,0,3,0,3
Yemen,2005-03-01,9,0,0,0,0,9
Yemen,2005-03-01,0,0,0,3,0,3
Yemen,2005-03-01,0,0,0,3,0,3
Yemen,2005-03-01,3,0,0,4,3,10
Yemen,2005-03-01,0,0,0,0,0,0
Yemen,2005-03-01,0,0,0,0,0,0
Yemen,2005-03-01,3,0,0,0,0,3
Yemen,2005-03-01,-4,0,0,0,0,-4
Yemen,2005-03-01,2,0,0,0,0,2
Yemen,2005-03-01,18,0,0,9,0,27
Yemen,2005-03-01,15,0,0,39,0,54
Yemen,2005-03-01,7,0,0,6,0,13
Yemen,2005-03-01,7,0,0,3,0,10
Yemen,2005-03-01,13,0,0,0,0,13
Yemen,2005-03-01,9,0,0,2,0,11
Yemen,2005-03-01,0,0,0,32,0,32
Yemen,2005-04-01,9,0,0,0,2,11
Yemen,2005-04-01,10,0,0,0,0,10
Yemen,2005-04-01,12,0,0,0,14,26
Yemen,2005-04-01,3,0,0,0,0,3
Yemen,2005-04-01,0,0,0,0,0,0
Yemen,2005-04-01,-2,0,0,0,0,-2
Yemen,2005-04-01,2,0,0,3,0,5
Yemen,2005-04-01,9,0,0,3,0,12
Yemen,2005-04-01,2,0,0,0,3,5
Yemen,2005-04-01,1,0,0,0,0,1
Yemen,2005-04-01,2,0,0,0,2,4
Yemen,2005-04-01,0,0,0,0,3,3
Yemen,2005-04-01,6,0,0,0,4,10
Yemen,2005-04-01,2,0,0,-3,0,-1
Yemen,2005-04-01,2,0,0,-3,0,-1
Yemen,2005-04-01,11,0,0,6,0,17
Yemen,2005-04-01,1,0,0,0,0,1
Yemen,2005-04-01,0,0,0,6,0,6
Yemen,2005-04-01,0,0,0,0,0,0
Yemen,2005-04-01,14,0,0,3,0,17
Yemen,2005-04-01,0,0,0,0,0,0
Yemen,2005-04-01,0,0,0,0,0,0
Yemen,2005-04-01,2,0,0,0,0,2
Yemen,2005-04-01,1,0,0,3,0,4
Yemen,2005-04-01,0,0,0,0,0,0
Yemen,2005-04-01,10,0,0,3,3,16
Yemen,2005-04-01,0,0,0,3,3,6
Yemen,2005-05-01,0,0,0,3,0,3
Yemen,2005-05-01,2,0,0,3,0,5
Yemen,2005-05-01,1,0,0,0,0,1
Yemen,2005-05-01,13,0,0,0,0,13
Yemen,2005-05-01,-1,0,0,0,0,-1
Yemen,2005-05-01,0,0,0,0,0,0
Yemen,2005-05-01,0,0,0,0,0,0
Yemen,2005-05-01,3,0,0,0,3,6
Yemen,2005-05-01,0,0,0,0,0,0
Yemen,2005-05-01,8,0,0,0,0,8
Yemen,2005-05-01,8,0,0,6,2,16
Yemen,2005-05-01,28,0,-13,12,0,27
Yemen,2005-05-01,5,0,0,0,0,5
Yemen,2005-05-01,3,0,0,2,1,6
Yemen,2005-05-01,15,0,-1,0,0,14
Yemen,2005-05-01,0,0,0,0,0,0
Yemen,2005-05-01,0,0,0,0,0,0
Yemen,2005-05-01,3,0,0,0,0,3
Yemen,2005-05-01,0,0,0,0,0,0
Yemen,2005-05-01,0,0,0,6,0,6
Yemen,2005-05-01,0,0,0,0,0,0
Yemen,2005-05-01,0,0,0,0,0,0
Yemen,2005-05-01,0,0,0,-2,0,-2
Yemen,2005-05-01,0,0,0,18,0,18
Yemen,2005-05-01,0,0,0,0,0,0
Yemen,2005-05-01,0,0,0,0,6,6
Yemen,2005-06-01,9,0,0,0,0,9
Yemen,2005-06-01,3,0,0,0,0,3
Yemen,2005-06-01,1,0,0,0,0,1
Yemen,2005-06-01,0,0,0,0,0,0
Yemen,2005-06-01,13,0,-2,9,2,22
Yemen,2005-06-01,2,0,0,0,0,2
Yemen,2005-06-01,2,0,-1,0,0,1
Yemen,2005-06-01,6,0,0,3,2,11
Yemen,2005-06-01,1,0,0,9,0,10
Yemen,2005-06-01,0,0,0,0,0,0
Yemen,2005-06-01,0,0,0,0,0,0
Yemen,2005-06-01,2,0,0,3,2,7
Yemen,2005-06-01,0,0,0,0,0,0
Yemen,2005-06-01,0,0,0,0,0,0
Yemen,2005-06-01,4,0,0,0,0,4
Yemen,2005-06-01,0,0,0,0,0,0
Yemen,2005-06-01,12,0,0,0,0,12
Yemen,2005-06-01,0,0,0,0,0,0
Yemen,2005-06-01,2,0,0,0,0,2
Yemen,2005-06-01,0,0,0,3,0,3
Yemen,2005-06-01,14,0,0,3,0,17
Yemen,2005-06-01,0,0,0,0,0,0
Yemen,2005-06-01,-1,0,0,0,0,-1
Yemen,2005-06-01,15,0,0,0,0,15
Yemen,2005-06-01,6,0,0,0,0,6
Yemen,2005-07-01,0,0,0,0,0,0
Yemen,2005-07-01,0,0,0,3,0,3
Yemen,2005-07-01,0,0,0,3,0,3
Yemen,2005-07-01,0,0,0,0,0,0
Yemen,2005-07-01,3,0,0,6,0,9
Yemen,2005-07-01,0,0,0,0,0,0
Yemen,2005-07-01,0,0,0,3,0,3
Yemen,2005-07-01,0,0,0,3,0,3
Yemen,2005-07-01,15,0,0,0,0,15
Yemen,2005-07-01,0,0,0,3,0,3
Yemen,2005-07-01,0,0,0,6,1,7
Yemen,2005-07-01,0,0,0,0,1,1
Yemen,2005-07-01,14,0,-4,3,3,16
Yemen,2005-07-01,0,0,0,6,0,6
Yemen,2005-07-01,0,0,-2,-2,0,-4
Yemen,2005-07-01,2,0,0,0,4,6
Yemen,2005-07-01,4,0,0,0,0,4
Yemen,2005-07-01,9,0,0,0,0,9
Yemen,2005-07-01,3,0,0,0,0,3
Yemen,2005-07-01,3,0,0,0,0,3
Yemen,2005-07-01,0,0,0,3,0,3
Yemen,2005-07-01,6,0,0,0,1,7
Yemen,2005-07-01,2,0,0,0,0,2
Yemen,2005-07-01,0,0,0,15,5,20
Yemen,2005-07-01,0,0,0,0,0,0
Yemen,2005-07-01,-1,0,0,0,0,-1
Yemen,2005-08-01,8,0,0,3,0,11
Yemen,2005-08-01,0,0,2,0,0,2
Yemen,2005-08-01,4,0,0,0,0,4
Yemen,2005-08-01,0,0,0,-2,0,-2
Yemen,2005-08-01,-1,0,0,0,0,-1
Yemen,2005-08-01,2,0,0,0,0,2
Yemen,2005-08-01,1,0,0,0,8,9
Yemen,2005-08-01,8,0,0,9,2,19
Yemen,2005-08-01,1,0,0,0,0,1
Yemen,2005-08-01,0,0,0,3,0,3
Yemen,2005-08-01,0,0,0,0,0,0
Yemen,2005-08-01,-1,0,0,0,0,-1
Yemen,2005-08-01,7,0,0,0,0,7
Yemen,2005-08-01,3,0,0,0,6,9
Yemen,2005-08-01,0,0,0,-1,0,-1
Yemen,2005-08-01,22,0,0,0,0,22
Yemen,2005-08-01,0,0,0,3,0,3
Yemen,2005-08-01,0,0,0,0,3,3
Yemen,2005-08-01,0,0,0,0,0,0
Yemen,2005-08-01,8,0,0,0,0,8
Yemen,2005-08-01,0,0,0,0,0,0
Yemen,2005-08-01,0,0,0,0,0,0
Yemen,2005-08-01,0,0,0,0,0,0
Yemen,2005-08-01,4,0,0,0,0,4
Yemen,2005-08-01,0,0,0,0,0,0
Yemen,2005-09-01,0,2,0,3,3,8
Yemen,2005-09-01,0,0,0,15,0,15
Yemen,2005-09-01,0,0,0,0,0,0
Yemen,2005-09-01,0,0,0,0,0,0
Yemen,2005-09-01,0,0,0,0,0,0
Yemen,2005-09-01,2,0,0,0,0,2
Yemen,2005-09-01,2,0,0,6,0,8
Yemen,2005-09-01,1,0,0,-2,0,-1
Yemen,2005-09-01,3,0,0,0,0,3
Yemen,2005-09-01,0,0,0,0,0,0
Yemen,2005-09-01,1,0,0,0,0,1
Yemen,2005-09-01,0,0,0,0,0,0
Yemen,2005-09-01,27,0,0,0,2,29
Yemen,2005-09-01,0,0,0,0,0,0
Yemen,2005-09-01,4,0,0,3,0,7
Yemen,2005-09-01,0,0,0,36,3,39
Yemen,2005-09-01,0,0,0,0,0,0
Yemen,2005-09-01,2,0,0,-6,0,-4
Yemen,2005-09-01,0,0,0,0,0,0
Yemen,2005-09-01,0,0,0,0,0,0
Yemen,2005-10-01,0,0,0,0,0,0
Yemen,2005-10-01,0,0,0,3,2,5
Yemen,2005-10-01,0,4,0,-6,0,-2
Yemen,2005-10-01,0,0,0,0,0,0
Yemen,2005-10-01,17,0,0,-3,2,16
Yemen,2005-10-01,0,0,-1,0,0,-1
Yemen,2005-10-01,1,0,0,3,1,5
Yemen,2005-10-01,1,0,0,0,0,1
Yemen,2005-10-01,0,0,0,0,0,0
Yemen,2005-10-01,1,0,0,0,0,1
Yemen,2005-10-01,0,0,0,3,0,3
Yemen,2005-10-01,0,0,0,0,0,0
Yemen,2005-10-01,0,0,0,0,0,0
Yemen,2005-10-01,1,0,0,0,0,1
Yemen,2005-10-01,0,0,0,0,0,0
Yemen,2005-11-01,0,0,0,0,0,0
Yemen,2005-11-01,-1,0,0,0,0,-1
Yemen,2005-11-01,0,0,0,3,0,3
Yemen,2005-11-01,1,0,0,0,0,1
Yemen,2005-11-01,27,0,0,0,0,27
Yemen,2005-11-01,5,0,0,12,1,18
Yemen,2005-11-01,10,0,0,6,0,16
Yemen,2005-11-01,6,0,0,6,0,12
Yemen,2005-11-01,2,0,1,9,0,12
Yemen,2005-11-01,0,0,0,3,0,3
Yemen,2005-11-01,0,0,0,3,0,3
Yemen,2005-11-01,0,0,0,3,1,4
Yemen,2005-11-01,0,0,0,6,0,6
Yemen,2005-11-01,0,0,0,6,0,6
Yemen,2005-11-01,1,0,0,-1,0,0
Yemen,2005-11-01,0,0,0,1,0,1
Yemen,2005-11-01,0,0,0,0,0,0
Yemen,2005-11-01,19,0,-2,27,0,44
Yemen,2005-11-01,4,0,0,15,1,20
Yemen,2005-11-01,6,0,0,12,0,18
Yemen,2005-11-01,22,0,0,18,0,40
Yemen,2005-12-01,3,0,0,0,0,3
Yemen,2005-12-01,6,0,0,3,0,9
Yemen,2005-12-01,0,0,0,6,0,6
Yemen,2005-12-01,8,0,0,0,2,10
Yemen,2005-12-01,0,0,0,3,2,5
Yemen,2005-12-01,0,0,0,3,0,3
Yemen,2005-12-01,1,0,0,-2,0,-1
Yemen,2005-12-01,0,0,0,0,0,0
Yemen,2005-12-01,0,0,0,3,2,5
Yemen,2005-12-01,2,0,0,9,0,11
Yemen,2005-12-01,0,0,0,0,0,0
Yemen,2005-12-01,0,0,0,0,0,0
Yemen,2005-12-01,0,0,0,0,0,0
Yemen,2005-12-01,0,0,0,0,0,0
Yemen,2005-12-01,1,0,0,0,0,1
Yemen,2005-12-01,18,0,0,-4,0,14
Yemen,2005-12-01,1,0,0,0,0,1
Yemen,2005-12-01,2,0,0,0,0,2
Yemen,2005-12-01,0,0,0,-2,0,-2
Yemen,2005-12-01,0,0,0,-1,0,-1
Yemen,2005-12-01,1,0,0,0,1,2
Yemen,2005-12-01,0,0,0,9,1,10
Yemen,2005-12-01,1,0,0,3,0,4
Yemen,2005-12-01,-4,0,0,-7,0,-11
Afghanistan,2004-01-01,14,0,0,-4,2,12
Afghanistan,2004-01-01,13,0,0,6,3,22
Afghanistan,2004-01-01,8,0,-1,19,2,28
Afghanistan,2004-01-01,16,0,0,1,0,17
Afghanistan,2004-01-01,10,0,2,8,-1,19
Afghanistan,2004-01-01,46,2,0,2,13,63
Afghanistan,2004-01-01,27,0,1,7,5,40
Afghanistan,2004-01-01,39,0,0,34,3,76
Afghanistan,2004-01-01,38,0,-1,22,6,65
Afghanistan,2004-01-01,29,0,0,9,0,38
Afghanistan,2004-01-01,34,0,0,25,0,59
Afghanistan,2004-01-01,7,0,0,16,7,30
Afghanistan,2004-01-01,24,0,0,9,1,34
Afghanistan,2004-01-01,6,0,0,22,4,32
Afghanistan,2004-01-01,12,0,0,20,16,48
Afghanistan,2004-01-01,2,0,0,14,21,37
Afghanistan,2004-01-01,32,0,0,1,2,35
Afghanistan,2004-01-01,22,0,0,4,0,26
Afghanistan,2004-01-01,40,0,-2,29,3,70
Afghanistan,2004-01-01,17,0,0,12,0,29
Afghanistan,2004-01-01,40,0,0,27,1,68
Afghanistan,2004-01-01,40,0,1,23,6,70
Afghanistan,2004-01-01,20,0,0,1,0,21
Afghanistan,2004-01-01,10,0,0,18,1,29
Afghanistan,2004-01-01,39,0,0,13,0,52
Afghanistan,2004-01-01,35,0,0,6,2,43
Afghanistan,2004-01-01,-4,0,-2,13,8,15
Afghanistan,2004-01-01,12,0,0,18,0,30
Afghanistan,2004-01-01,9,0,0,4,0,13
Afghanistan,2004-01-01,26,0,0,19,0,45
Afghanistan,2004-01-01,8,0,0,7,0,15
Afghanistan,2004-02-01,7,0,0,11,0,18
Afghanistan,2004-02-01,17,2,-1,28,0,46
Afghanistan,2004-02-01,13,0,0,9,2,24
Afghanistan,2004-02-01,16,0,0,6,0,22
Afghanistan,2004-02-01,31,0,0,11,0,42
Afghanistan,2004-02-01,16,0,0,8,6,30
Afghanistan,2004-02-01,19,0,-1,-2,1,17
Afghanistan,2004-02-01,28,2,0,3,4,37
Afghanistan,2004-02-01,9,0,0,3,1,13
Afghanistan,2004-02-01,8,0,0,0,0,8
Afghanistan,2004-02-01,37,0,0,22,0,59
Afghanistan,2004-02-01,27,0,1,48,1,77
Afghanistan,2004-02-01,16,0,0,6,2,24
Afghanistan,2004-02-01,12,0,0,36,0,48
Afghanistan,2004-02-01,8,0,0,3,1,12
Afghanistan,2004-02-01,37,0,0,9,1,47
Afghanistan,2004-02-01,19,0,-2,18,0,35
Afghanistan,2004-02-01,13,2,0,3,0,18
Afghanistan,2004-02-01,18,2,0,41,2,63
Afghanistan,2004-02-01,43,0,0,12,1,56
Afghanistan,2004-02-01,41,0,1,27,2,71
Afghanistan,2004-02-01,25,0,0,0,0,25
Afghanistan,2004-02-01,50,0,0,11,1,62
Afghanistan,2004-02-01,51,0,0,20,0,71
Afghanistan,2004-02-01,29,0,0,15,5,49
Afghanistan,2004-02-01,1,0,0,15,3,19
Afghanistan,2004-02-01,26,0,5,13,-1,43
Afghanistan,2004-02-01,12,6,1,12,2,33
Afghanistan,2004-02-01,28,0,0,8,3,39
Afghanistan,2004-03-01,23,0,0,30,4,57
Afghanistan,2004-03-01,26,0,0,20,0,46
Afghanistan,2004-03-01,27,2,0,15,0,44
Afghanistan,2004-03-01,35,0,0,15,0,50
Afghanistan,2004-03-01,22,0,0,8,2,32
Afghanistan,2004-03-01,22,0,0,-2,6,26
Afghanistan,2004-03-01,28,0,0,6,0,34
Afghanistan,2004-03-01,14,0,-1,42,4,59
Afghanistan,2004-03-01,42,0,0,39,1,82
Afghanistan,2004-03-01,25,0,0,26,6,57
Afghanistan,2004-03-01,50,0,0,6,2,58
Afghanistan,2004-03-01,38,2,0,16,0,56
Afghanistan,2004-03-01,24,0,0,20,3,47
Afghanistan,2004-03-01,42,0,1,-2,3,44
Afghanistan,2004-03-01,37,0,0,-1,3,39
Afghanistan,2004-03-01,29,0,0,17,0,46
Afghanistan,2004-03-01,35,0,0,1,12,48
Afghanistan,2004-03-01,67,0,1,1,19,88
Afghanistan,2004-03-01,86,2,0,48,4,140
Afghanistan,2004-03-01,37,0,0,19,3,59
Afghanistan,2004-03-01,48,0,0,6,0,54
Afghanistan,2004-03-01,88,0,0,11,6,105
Afghanistan,2004-03-01,36,0,0,14,2,52
Afghanistan,2004-03-01,28,0,0,19,13,60
Afghanistan,2004-03-01,62,0,2,6,0,70
Afghanistan,2004-03-01,26,0,-1,9,3,37
Afghanistan,2004-03-01,46,0,0,21,5,72
Afghanistan,2004-03-01,16,0,0,8,2,26
Afghanistan,2004-03-01,96,0,0,6,5,107
Afghanistan,2004-03-01,28,6,0,7,0,41
Afghanistan,2004-03-01,48,4,0,16,12,80
Afghanistan,2004-04-01,37,0,0,23,8,68
Afghanistan,2004-04-01,62,0,-1,39,4,104
Afghanistan,2004-04-01,27,0,0,14,0,41
Afghanistan,2004-04-01,32,0,1,4,0,37
Afghanistan,2004-04-01,31,8,0,4,0,43
Afghanistan,2004-04-01,28,0,0,-12,3,19
Afghanistan,2004-04-01,13,0,1,23,7,44
Afghanistan,2004-04-01,53,0,0,34,2,89
Afghanistan,2004-04-01,35,0,0,15,0,50
Afghanistan,2004-04-01,24,0,0,6,3,33
Afghanistan,2004-04-01,19,0,1,-3,4,21
Afghanistan,2004-04-01,14,0,-5,-2,0,7
Afghanistan,2004-04-01,-2,0,0,0,0,-2
Afghanistan,2004-04-01,40,0,0,15,0,55
Afghanistan,2004-04-01,12,0,0,0,5,17
Afghanistan,2004-04-01,9,4,0,36,0,49
Afghanistan,2004-04-01,12,0,0,9,0,21
Afghanistan,2004-04-01,22,0,0,6,0,28
Afghanistan,2004-04-01,-4,0,0,7,6,9
Afghanistan,2004-04-01,15,0,-1,3,8,25
Afghanistan,2004-04-01,27,0,0,5,0,32
Afghanistan,2004-04-01,32,0,-2,7,0,37
Afghanistan,2004-04-01,15,0,0,10,0,25
Afghanistan,2004-04-01,18,0,0,15,0,33
Afghanistan,2004-04-01,18,0,0,9,0,27
Afghanistan,2004-04-01,20,0,0,25,0,45
Afghanistan,2004-04-01,24,0,0,1,0,25
Afghanistan,2004-04-01,48,0,0,25,2,75
Afghanistan,2004-04-01,21,0,0,14,2,37
Afghanistan,2004-04-01,27,0,0,-1,6,32
Afghanistan,2004-05-01,18,0,0,1,5,24
Afghanistan,2004-05-01,14,0,0,14,0,28
Afghanistan,2004-05-01,17,0,0,-2,4,19
Afghanistan,2004-05-01,16,0,0,24,4,44
Afghanistan,2004-05-01,40,0,0,5,1,46
Afghanistan,2004-05-01,39,0,0,5,2,46
Afghanistan,2004-05-01,16,0,0,6,9,31
Afghanistan,2004-05-01,9,6,0,0,4,19
Afghanistan,2004-05-01,23,0,0,12,0,35
Afghanistan,2004-05-01,12,6,0,4,0,22
Afghanistan,2004-05-01,47,0,0,15,5,67
Afghanistan,2004-05-01,6,0,0,22,1,29
Afghanistan,2004-05-01,28,0,0,28,8,64
Afghanistan,2004-05-01,23,0,0,4,2,29
Afghanistan,2004-05-01,8,0,0,26,15,49
Afghanistan,2004-05-01,22,0,0,3,6,31
Afghanistan,2004-05-01,41,0,0,-2,5,44
Afghanistan,2004-05-01,42,2,0,12,1,57
Afghanistan,2004-05-01,17,0,0,60,5,82
Afghanistan,2004-05-01,14,0,0,32,0,46
Afghanistan,2004-05-01,34,0,2,32,6,74
Afghanistan,2004-05-01,40,0,0,15,1,56
Afghanistan,2004-05-01,27,0,0,18,0,45
Afghanistan,2004-05-01,45,0,0,21,1,67
Afghanistan,2004-05-01,18,0,-1,3,1,21
Afghanistan,2004-05-01,9,0,0,24,2,35
Afghanistan,2004-05-01,17,0,0,19,4,40
Afghanistan,2004-05-01,26,0,0,10,1,37
Afghanistan,2004-05-01,0,0,0,18,0,18
Afghanistan,2004-05-01,38,0,0,9,3,50
Afghanistan,2004-05-01,31,0,0,6,-2,35
Afghanistan,2004-06-01,25,0,0,0,7,32
Afghanistan,2004-06-01,49,0,-8,26,0,67
Afghanistan,2004-06-01,56,0,0,7,6,69
Afghanistan,2004-06-01,17,0,0,21,0,38
Afghanistan,2004-06-01,14,0,0,15,7,36
Afghanistan,2004-06-01,63,0,0,-1,14,76
Afghanistan,2004-06-01,4,0,0,19,5,28
Afghanistan,2004-06-01,33,0,2,10,4,49
Afghanistan,2004-06-01,69,0,1,18,5,93
Afghanistan,2004-06-01,61,0,0,21,6,88
Afghanistan,2004-06-01,49,0,0,15,9,73
Afghanistan,2004-06-01,44,0,0,16,0,60
Afghanistan,2004-06-01,53,0,0,-3,2,52
Afghanistan,2004-06-01,71,0,0,21,0,92
Afghanistan,2004-06-01,35,0,0,24,0,59
Afghanistan,2004-06-01,37,0,0,4,4,45
Afghanistan,2004-06-01,21,2,-6,-5,1,13
Afghanistan,2004-06-01,49,0,0,3,14,66
Afghanistan,2004-06-01,25,0,0,-12,1,14
Afghanistan,2004-06-01,6,0,0,-3,2,5
Afghanistan,2004-06-01,28,0,0,7,5,40
Afghanistan,2004-06-01,15,0,0,5,4,24
Afghanistan,2004-06-01,26,0,0,20,3,49
Afghanistan,2004-06-01,38,0,-4,28,0,62
Afghanistan,2004-06-01,31,0,0,34,0,65
Afghanistan,2004-06-01,27,0,0,16,0,43
Afghanistan,2004-06-01,11,0,0,-4,2,9
Afghanistan,2004-06-01,12,0,0,6,3,21
Afghanistan,2004-06-01,82,2,-2,48,7,137
Afghanistan,2004-06-01,27,0,-2,27,6,58
Afghanistan,2004-07-01,31,0,0,-1,2,32
Afghanistan,2004-07-01,16,0,0,18,0,34
Afghanistan,2004-07-01,12,0,0,12,0,24
Afghanistan,2004-07-01,13,0,0,11,0,24
Afghanistan,2004-07-01,1,2,0,6,0,9
Afghanistan,2004-07-01,12,0,0,6,2,20
Afghanistan,2004-07-01,25,2,0,22,3,52
Afghanistan,2004-07-01,11,0,1,11,0,23
Afghanistan,2004-07-01,7,0,0,16,0,23
Afghanistan,2004-07-01,6,0,1,12,0,19
Afghanistan,2004-07-01,26,0,2,3,2,33
Afghanistan,2004-07-01,3,0,0,21,0,24
Afghanistan,2004-07-01,21,0,0,18,2,41
Afghanistan,2004-07-01,17,0,0,-2,0,15
Afghanistan,2004-07-01,8,0,0,21,1,30
Afghanistan,2004-07-01,18,0,0,-6,0,12
Afghanistan,2004-07-01,25,0,0,12,0,37
Afghanistan,2004-07-01,14,0,0,-4,2,12
Afghanistan,2004-07-01,18,0,0,6,0,24
Afghanistan,2004-07-01,8,0,0,12,0,20
Afghanistan,2004-07-01,19,0,0,13,0,32
Afghanistan,2004-07-01,14,0,0,1,2,17
Afghanistan,2004-07-01,35,0,-1,-5,0,29
Afghanistan,2004-07-01,6,0,0,6,0,12
Afghanistan,2004-07-01,12,0,0,-14,0,-2
Afghanistan,2004-07-01,6,0,0,3,0,9
Afghanistan,2004-07-01,23,0,0,14,0,37
Afghanistan,2004-07-01,45,0,0,-3,12,54
Afghanistan,2004-07-01,29,0,0,3,0,32
Afghanistan,2004-07-01,14,0,0,22,0,36
Afghanistan,2004-07-01,14,0,-6,10,0,18
Afghanistan,2004-08-01,17,0,0,6,0,23
Afghanistan,2004-08-01,8,0,0,6,6,20
Afghanistan,2004-08-01,16,8,0,16,0,40
Afghanistan,2004-08-01,40,0,1,35,4,80
Afghanistan,2004-08-01,20,0,0,28,0,48
Afghanistan,2004-08-01,38,0,0,34,4,76
Afghanistan,2004-08-01,37,0,0,7,4,48
Afghanistan,2004-08-01,47,2,0,31,0,80
Afghanistan,2004-08-01,27,0,0,6,0,33
Afghanistan,2004-08-01,43,0,0,6,5,54
Afghanistan,2004-08-01,30,0,0,4,0,34
Afghanistan,2004-08-01,27,0,-2,24,3,52
Afghanistan,2004-08-01,30,0,0,-4,5,31
Afghanistan,2004-08-01,10,0,0,6,0,16
Afghanistan,2004-08-01,51,0,0,6,2,59
Afghanistan,2004-08-01,16,0,0,0,2,18
Afghanistan,2004-08-01,13,0,-1,2,1,15
Afghanistan,2004-08-01,5,0,-3,12,5,19
Afghanistan,2004-08-01,34,0,0,-1,2,35
Afghanistan,2004-08-01,28,0,0,5,5,38
Afghanistan,2004-08-01,33,0,-2,-3,4,32
Afghanistan,2004-08-01,6,0,0,15,1,22
Afghanistan,2004-08-01,52,6,0,21,3,82
Afghanistan,2004-08-01,49,0,-4,7,1,53
Afghanistan,2004-08-01,30,0,0,34,2,66
Afghanistan,2004-08-01,29,0,1,21,0,51
Afghanistan,2004-08-01,22,0,0,9,0,31
Afghanistan,2004-08-01,8,0,-2,7,0,13
Afghanistan,2004-08-01,16,0,0,6,0,22
Afghanistan,2004-08-01,30,0,0,8,0,38
Afghanistan,2004-08-01,25,0,-2,27,5,55
Afghanistan,2004-09-01,20,0,0,12,5,37
Afghanistan,2004-09-01,21,2,0,-8,0,15
Afghanistan,2004-09-01,15,0,0,-1,3,17
Afghanistan,2004-09-01,18,0,0,9,2,29
Afghanistan,2004-09-01,9,0,0,0,2,11
Afghanistan,2004-09-01,19,0,0,15,2,36
Afghanistan,2004-09-01,25,0,0,15,1,41
Afghanistan,2004-09-01,9,0,-2,3,0,10
Afghanistan,2004-09-01,47,0,1,6,3,57
Afghanistan,2004-09-01,49,0,0,-1,0,48
Afghanistan,2004-09-01,12,0,0,3,0,15
Afghanistan,2004-09-01,46,0,0,0,5,51
Afghanistan,2004-09-01,23,0,1,21,3,48
Afghanistan,2004-09-01,43,0,0,13,0,56
Afghanistan,2004-09-01,5,0,0,9,0,14
Afghanistan,2004-09-01,15,0,-2,9,1,23
Afghanistan,2004-09-01,10,0,-2,30,4,42
Afghanistan,2004-09-01,27,0,3,-2,3,31
Afghanistan,2004-09-01,25,0,0,3,3,31
Afghanistan,2004-09-01,7,0,0,0,0,7
Afghanistan,2004-09-01,23,0,3,3,9,38
Afghanistan,2004-09-01,27,0,4,2,6,39
Afghanistan,2004-09-01,20,0,0,3,3,26
Afghanistan,2004-09-01,13,0,0,22,4,39
Afghanistan,2004-09-01,10,0,0,6,7,23
Afghanistan,2004-09-01,45,0,-5,7,9,56
Afghanistan,2004-09-01,46,0,0,11,4,61
Afghanistan,2004-09-01,16,0,0,15,4,35
Afghanistan,2004-09-01,31,0,0,-2,0,29
Afghanistan,2004-09-01,38,2,0,10,7,57
Afghanistan,2004-10-01,43,0,0,19,2,64
Afghanistan,2004-10-01,6,0,0,3,0,9
Afghanistan,2004-10-01,11,0,0,0,18,29
Afghanistan,2004-10-01,28,0,0,8,4,40
Afghanistan,2004-10-01,20,0,1,3,0,24
Afghanistan,2004-10-01,31,0,0,6,0,37
Afghanistan,2004-10-01,27,0,0,18,1,46
Afghanistan,2004-10-01,18,0,0,13,5,36
Afghanistan,2004-10-01,18,0,3,9,13,43
Afghanistan,2004-10-01,41,0,3,10,16,70
Afghanistan,2004-10-01,35,0,5,12,7,59
Afghanistan,2004-10-01,31,0,0,17,4,52
Afghanistan,2004-10-01,22,0,2,18,3,45
Afghanistan,2004-10-01,12,2,2,17,2,35
Afghanistan,2004-10-01,4,0,0,13,1,18
Afghanistan,2004-10-01,3,0,0,2,8,13
Afghanistan,2004-10-01,8,0,-2,-3,0,3
Afghanistan,2004-10-01,22,0,0,9,1,32
Afghanistan,2004-10-01,38,0,0,19,3,60
Afghanistan,2004-10-01,8,0,-2,3,0,9
Afghanistan,2004-10-01,3,0,-2,12,2,15
Afghanistan,2004-10-01,13,0,0,17,1,31
Afghanistan,2004-10-01,20,0,0,1,1,22
Afghanistan,2004-10-01,3,0,0,-2,2,3
Afghanistan,2004-10-01,31,0,0,9,6,46
Afghanistan,2004-10-01,17,0,0,6,4,27
Afghanistan,2004-10-01,62,0,0,17,0,79
Afghanistan,2004-10-01,15,0,0,9,4,28
Afghanistan,2004-10-01,0,0,0,4,2,6
Afghanistan,2004-10-01,59,0,0,0,1,60
Afghanistan,2004-10-01,9,0,0,2,0,11
Afghanistan,2004-11-01,20,0,0,6,0,26
Afghanistan,2004-11-01,18,0,2,25,3,48
Afghanistan,2004-11-01,14,0,-2,23,0,35
Afghanistan,2004-11-01,19,0,0,13,2,34
Afghanistan,2004-11-01,16,2,0,9,0,27
Afghanistan,2004-11-01,7,0,0,3,2,12
Afghanistan,2004-11-01,3,0,0,-2,0,1
Afghanistan,2004-11-01,16,0,0,39,7,62
Afghanistan,2004-11-01,24,0,0,17,3,44
Afghanistan,2004-11-01,26,0,0,4,2,32
Afghanistan,2004-11-01,13,0,0,12,2,27
Afghanistan,2004-11-01,19,0,0,1,1,21
Afghanistan,2004-11-01,29,0,0,1,0,30
Afghanistan,2004-11-01,8,0,0,4,1,13
Afghanistan,2004-11-01,5,0,-4,9,0,10
Afghanistan,2004-11-01,12,0,0,3,0,15
Afghanistan,2004-11-01,17,0,0,13,0,30
Afghanistan,2004-11-01,3,0,0,3,0,6
Afghanistan,2004-11-01,11,0,0,3,2,16
Afghanistan,2004-11-01,10,0,0,2,0,12
Afghanistan,2004-11-01,21,0,0,0,1,22
Afghanistan,2004-11-01,30,2,0,12,0,44
Afghanistan,2004-11-01,7,0,0,2,1,10
Afghanistan,2004-11-01,13,0,0,-8,0,5
Afghanistan,2004-11-01,11,2,0,4,2,19
Afghanistan,2004-11-01,8,0,0,12,0,20
Afghanistan,2004-11-01,-2,0,0,4,0,2
Afghanistan,2004-11-01,19,0,0,2,1,22
Afghanistan,2004-11-01,10,0,0,12,2,24
Afghanistan,2004-11-01,17,0,0,-1,0,16
Afghanistan,2004-12-01,22,0,0,12,0,34
Afghanistan,2004-12-01,1,0,0,-6,2,-3
Afghanistan,2004-12-01,14,0,0,0,2,16
Afghanistan,2004-12-01,4,0,0,-2,0,2
Afghanistan,2004-12-01,14,0,0,8,1,23
Afghanistan,2004-12-01,22,0,1,7,4,34
Afghanistan,2004-12-01,18,0,0,6,1,25
Afghanistan,2004-12-01,19,0,0,13,0,32
Afghanistan,2004-12-01,17,0,0,6,0,23
Afghanistan,2004-12-01,23,0,0,9,2,34
Afghanistan,2004-12-01,10,0,1,3,0,14
Afghanistan,2004-12-01,-1,0,0,18,0,17
Afghanistan,2004-12-01,9,0,-4,16,2,23
Afghanistan,2004-12-01,36,0,-4,-2,6,36
Afghanistan,2004-12-01,38,0,0,20,1,59
Afghanistan,2004-12-01,24,0,-2,3,3,28
Afghanistan,2004-12-01,13,0,0,21,0,34
Afghanistan,2004-12-01,18,0,0,14,2,34
Afghanistan,2004-12-01,4,0,0,3,0,7
Afghanistan,2004-12-01,5,0,0,-1,2,6
Afghanistan,2004-12-01,17,0,0,6,0,23
Afghanistan,2004-12-01,15,2,0,3,0,20
Afghanistan,2004-12-01,5,0,0,0,0,5
Afghanistan,2004-12-01,7,0,0,3,4,14
Afghanistan,2004-12-01,19,0,0,4,2,25
Afghanistan,2004-12-01,12,0,0,3,2,17
Afghanistan,2004-12-01,15,0,0,4,2,21
Afghanistan,2004-12-01,21,0,-1,3,0,23
Afghanistan,2004-12-01,1,0,-9,6,3,1
Afghanistan,2004-12-01,22,0,-2,-2,2,20
Afghanistan,2004-12-01,0,0,0,0,1,1
Albania,2004-01-01,0,0,0,0,0,0
Albania,2004-01-01,4,0,0,0,0,4
Albania,2004-01-01,4,0,0,9,1,14
Albania,2004-01-01,3,0,0,0,2,5
Albania,2004-01-01,3,0,0,3,1,7
Albania,2004-01-01,17,0,0,4,0,21
Albania,2004-01-01,3,0,0,3,0,6
Albania,2004-01-01,24,0,0,0,0,24
Albania,2004-01-01,12,0,0,0,0,12
Albania,2004-01-01,6,0,0,2,0,8
Albania,2004-01-01,9,0,0,0,2,11
Albania,2004-01-01,5,0,0,0,1,6
Albania,2004-01-01,3,0,-2,-10,4,-5
Albania,2004-01-01,6,0,0,0,0,6
Albania,2004-01-01,11,0,0,0,0,11
Albania,2004-01-01,-2,0,0,0,1,-1
Albania,2004-01-01,1,0,1,-2,2,2
Albania,2004-01-01,12,0,0,0,0,12
Albania,2004-01-01,14,0,0,12,0,26
Albania,2004-01-01,5,0,0,0,0,5
Albania,2004-01-01,-1,0,0,0,0,-1
Albania,2004-01-01,0,0,0,0,0,0
Albania,2004-01-01,12,0,0,6,0,18
Albania,2004-01-01,1,0,0,0,4,5
Albania,2004-01-01,-10,0,0,0,3,-7
Albania,2004-01-01,5,0,0,13,1,19
Albania,2004-01-01,6,0,0,0,0,6
Albania,2004-01-01,2,0,1,0,1,4
Albania,2004-02-01,2,0,0,0,0,2
Albania,2004-02-01,3,0,0,1,6,10
Albania,2004-02-01,0,0,0,0,0,0
Albania,2004-02-01,1,0,0,9,0,10
Albania,2004-02-01,8,0,0,6,0,14
Albania,2004-02-01,2,4,0,3,0,9
Albania,2004-02-01,4,0,0,3,5,12
Albania,2004-02-01,4,0,0,3,1,8
Albania,2004-02-01,30,0,0,1,4,35
Albania,2004-02-01,2,0,0,9,0,11
Albania,2004-02-01,8,0,-2,2,2,10
Albania,2004-02-01,10,0,0,9,2,21
Albania,2004-02-01,-1,0,0,4,0,3
Albania,2004-02-01,1,0,0,0,4,5
Albania,2004-02-01,0,0,0,9,1,10
Albania,2004-02-01,31,0,0,21,1,53
Albania,2004-02-01,1,0,0,0,0,1
Albania,2004-02-01,-2,0,0,0,2,0
Albania,2004-02-01,14,0,0,1,0,15
Albania,2004-02-01,25,0,0,3,6,34
Albania,2004-02-01,3,0,0,-4,4,3
Albania,2004-02-01,6,0,0,0,0,6
Albania,2004-02-01,10,0,0,10,0,20
Albania,2004-02-01,-5,0,0,0,0,-5
Albania,2004-02-01,24,0,0,11,2,37
Albania,2004-02-01,27,0,0,0,0,27
Albania,2004-02-01,0,0,0,3,0,3
Albania,2004-02-01,7,0,0,0,0,7
Albania,2004-02-01,10,0,0,8,1,19
Albania,2004-03-01,15,0,0,0,1,16
Albania,2004-03-01,7,0,1,0,0,8
Albania,2004-03-01,11,0,0,4,3,18
Albania,2004-03-01,15,0,-1,3,0,17
Albania,2004-03-01,11,0,-6,6,2,13
Albania,2004-03-01,-7,0,0,0,0,-7
Albania,2004-03-01,-2,0,0,0,0,-2
Albania,2004-03-01,30,0,0,-2,2,30
Albania,2004-03-01,8,0,0,9,2,19
Albania,2004-03-01,0,0,0,3,0,3
Albania,2004-03-01,5,0,0,0,0,5
Albania,2004-03-01,1,0,0,0,1,2
Albania,2004-03-01,-2,0,0,0,1,-1
Albania,2004-03-01,6,0,0,0,2,8
Albania,2004-03-01,26,0,0,6,2,34
Albania,2004-03-01,62,0,0,2,2,66
Albania,2004-03-01,259,0,-3,30,52,338
Albania,2004-03-01,174,0,-1,52,85,310
Albania,2004-03-01,124,0,-1,10,32,165
Albania,2004-03-01,109,0,-1,4,13,125
Albania,2004-03-01,50,0,0,9,5,64
Albania,2004-03-01,70,0,0,6,31,107
Albania,2004-03-01,42,0,-2,3,0,43
Albania,2004-03-01,38,0,0,5,1,44
Albania,2004-03-01,34,0,-3,0,7,38
Albania,2004-03-01,67,0,-3,0,2,66
Albania,2004-03-01,2,0,0,-2,3,3
Albania,2004-03-01,9,0,0,3,13,25
Albania,2004-03-01,15,0,0,12,3,30
Albania,2004-03-01,26,0,-1,3,3,31
Albania,2004-03-01,-4,0,-1,3,6,4
Albania,2004-04-01,34,0,0,5,4,43
Albania,2004-04-01,17,0,-2,1,2,18
Albania,2004-04-01,5,0,-2,0,1,4
Albania,2004-04-01,1,0,0,0,0,1
Albania,2004-04-01,17,0,0,0,4,21
Albania,2004-04-01,10,0,0,-4,1,7
Albania,2004-04-01,8,0,0,0,2,10
Albania,2004-04-01,8,0,0,3,1,12
Albania,2004-04-01,1,0,0,0,2,3
Albania,2004-04-01,34,0,0,12,0,46
Albania,2004-04-01,5,0,0,2,0,7
Albania,2004-04-01,28,0,0,7,11,46
Albania,2004-04-01,18,0,0,0,1,19
Albania,2004-04-01,27,0,0,-1,7,33
Albania,2004-04-01,8,0,-2,0,4,10
Albania,2004-04-01,9,0,0,-3,3,9
Albania,2004-04-01,50,0,0,12,2,64
Albania,2004-04-01,18,0,0,13,1,32
Albania,2004-04-01,24,0,0,3,1,28
Albania,2004-04-01,34,0,0,7,0,41
Albania,2004-04-01,11,0,0,9,0,20
Albania,2004-04-01,26,0,0,6,0,32
Albania,2004-04-01,17,0,0,1,-1,17
Albania,2004-04-01,13,0,0,0,0,13
Albania,2004-04-01,10,0,0,0,0,10
Albania,2004-04-01,6,0,0,0,2,8
Albania,2004-04-01,18,0,0,7,2,27
Albania,2004-04-01,47,0,-8,51,12,102
Albania,2004-04-01,17,2,0,5,5,29
Albania,2004-04-01,6,0,0,0,0,6
Albania,2004-05-01,29,0,-1,-6,4,26
Albania,2004-05-01,9,0,-2,13,6,26
Albania,2004-05-01,13,0,-2,0,2,13
Albania,2004-05-01,3,0,0,9,0,12
Albania,2004-05-01,-1,0,0,1,0,0
Albania,2004-05-01,6,0,0,0,0,6
Albania,2004-05-01,0,0,0,-5,8,3
Albania,2004-05-01,23,0,0,6,0,29
Albania,2004-05-01,0,0,0,3,0,3
Albania,2004-05-01,11,0,0,0,1,12
Albania,2004-05-01,20,0,0,0,0,20
Albania,2004-05-01,7,0,0,-2,0,5
Albania,2004-05-01,8,0,0,0,0,8
Albania,2004-05-01,5,0,2,6,0,13
Albania,2004-05-01,2,0,0,9,0,11
Albania,2004-05-01,0,0,0,6,0,6
Albania,2004-05-01,9,0,-4,12,2,19
Albania,2004-05-01,12,0,0,20,0,32
Albania,2004-05-01,1,0,0,0,2,3
Albania,2004-05-01,5,0,0,3,0,8
Albania,2004-05-01,11,0,0,1,1,13
Albania,2004-05-01,0,0,0,-2,0,-2
Albania,2004-05-01,11,0,0,0,1,12
Albania,2004-05-01,22,2,0,3,1,28
Albania,2004-05-01,14,0,-8,9,1,16
Albania,2004-05-01,15,0,0,0,1,16
Albania,2004-05-01,10,0,0,6,0,16
Albania,2004-05-01,5,0,0,6,0,11
Albania,2004-05-01,12,0,0,-6,0,6
Albania,2004-05-01,1,0,0,0,0,1
Albania,2004-05-01,5,0,0,0,8,13
Albania,2004-06-01,0,0,0,0,0,0
Albania,2004-06-01,3,0,0,6,0,9
Albania,2004-06-01,15,0,0,6,0,21
Albania,2004-06-01,2,0,0,8,1,11
Albania,2004-06-01,16,0,0,3,0,19
Albania,2004-06-01,7,0,3,7,1,18
Albania,2004-06-01,22,0,0,3,2,27
Albania,2004-06-01,17,0,0,0,0,17
Albania,2004-06-01,14,0,0,6,0,20
Albania,2004-06-01,17,0,-2,3,0,18
Albania,2004-06-01,0,0,0,7,1,8
Albania,2004-06-01,2,0,0,-2,0,0
Albania,2004-06-01,0,0,0,0,9,9
Albania,2004-06-01,8,0,0,-3,0,5
Albania,2004-06-01,3,0,0,6,1,10
Albania,2004-06-01,4,0,0,3,1,8
Albania,2004-06-01,0,0,0,21,1,22
Albania,2004-06-01,9,0,0,0,1,10
Albania,2004-06-01,13,0,0,0,0,13
Albania,2004-06-01,0,0,0,14,0,14
Albania,2004-06-01,1,0,0,0,0,1
Albania,2004-06-01,1,0,0,0,0,1
Albania,2004-06-01,10,0,0,12,2,24
Albania,2004-06-01,17,0,0,9,1,27
Albania,2004-06-01,6,0,-2,18,1,23
Albania,2004-06-01,-2,0,3,0,1,2
Albania,2004-06-01,3,0,0,-6,1,-2
Albania,2004-06-01,10,0,0,0,1,11
Albania,2004-06-01,0,0,0,-1,0,-1
Albania,2004-06-01,6,0,0,3,0,9
Albania,2004-07-01,8,0,0,3,2,13
Albania,2004-07-01,4,0,0,1,0,5
Albania,2004-07-01,0,0,-4,0,2,-2
Albania,2004-07-01,1,0,0,-6,2,-3
Albania,2004-07-01,-3,0,0,0,0,-3
Albania,2004-07-01,0,0,0,0,0,0
Albania,2004-07-01,1,0,0,0,1,2
Albania,2004-07-01,19,0,-2,0,1,18
Albania,2004-07-01,4,0,0,6,3,13
Albania,2004-07-01,5,0,0,3,0,8
Albania,2004-07-01,16,0,0,-1,0,15
Albania,2004-07-01,1,0,0,0,0,1
Albania,2004-07-01,11,0,0,0,2,13
Albania,2004-07-01,3,0,0,-7,3,-1
Albania,2004-07-01,0,0,0,0,0,0
Albania,2004-07-01,10,0,0,0,1,11
Albania,2004-07-01,0,0,1,0,0,1
Albania,2004-07-01,0,0,0,0,5,5
Albania,2004-07-01,8,0,0,-1,0,7
Albania,2004-07-01,19,0,0,12,0,31
Albania,2004-07-01,9,0,0,0,0,9
Albania,2004-07-01,11,0,0,6,2,19
Albania,2004-07-01,8,0,0,-2,1,7
Albania,2004-07-01,0,0,-2,0,0,-2
Albania,2004-07-01,11,0,0,3,8,22
Albania,2004-07-01,8,0,0,1,0,9
Albania,2004-07-01,2,0,-1,4,9,14
Albania,2004-07-01,3,0,0,3,3,9
Albania,2004-07-01,3,0,1,-2,0,2
Albania,2004-07-01,-6,0,0,0,0,-6
Albania,2004-08-01,0,0,0,3,0,3
Albania,2004-08-01,2,0,0,0,1,3
Albania,2004-08-01,8,0,0,0,0,8
Albania,2004-08-01,13,0,1,3,2,19
Albania,2004-08-01,4,0,0,0,0,4
Albania,2004-08-01,1,0,0,0,0,1
Albania,2004-08-01,2,0,0,0,8,10
Albania,2004-08-01,0,0,0,0,2,2
Albania,2004-08-01,15,0,0,0,2,17
Albania,2004-08-01,6,0,1,7,14,28
Albania,2004-08-01,1,0,0,0,12,13
Albania,2004-08-01,6,0,0,0,1,7
Albania,2004-08-01,3,0,-1,0,0,2
Albania,2004-08-01,12,0,-6,3,3,12
Albania,2004-08-01,6,0,0,0,1,7
Albania,2004-08-01,1,0,0,0,0,1
Albania,2004-08-01,1,0,0,-2,0,-1
Albania,2004-08-01,8,0,0,3,0,11
Albania,2004-08-01,0,0,0,0,2,2
Albania,2004-08-01,3,0,0,0,1,4
Albania,2004-08-01,15,0,0,-4,3,14
Albania,2004-08-01,8,0,1,-4,0,5
Albania,2004-08-01,6,0,0,3,0,9
Albania,2004-08-01,21,0,0,3,0,24
Albania,2004-08-01,2,0,0,3,0,5
Albania,2004-08-01,0,0,0,0,0,0
Albania,2004-08-01,0,0,0,0,0,0
Albania,2004-08-01,16,0,0,6,1,23
Albania,2004-08-01,5,4,0,0,0,9
Albania,2004-09-01,16,0,1,0,0,17
Albania,2004-09-01,4,0,0,3,0,7
Albania,2004-09-01,0,0,0,4,0,4
Albania,2004-09-01,0,0,0,0,0,0
Albania,2004-09-01,6,0,0,0,0,6
Albania,2004-09-01,12,0,0,-3,0,9
Albania,2004-09-01,0,0,0,3,2,5
Albania,2004-09-01,4,0,0,0,0,4
Albania,2004-09-01,9,0,0,0,4,13
Albania,2004-09-01,1,0,0,0,0,1
Albania,2004-09-01,6,0,0,0,0,6
Albania,2004-09-01,0,0,0,0,0,0
Albania,2004-09-01,9,0,3,3,0,15
Albania,2004-09-01,19,0,1,9,4,33
Albania,2004-09-01,15,0,0,6,1,22
Albania,2004-09-01,0,0,0,0,0,0
Albania,2004-09-01,0,0,0,0,0,0
Albania,2004-09-01,0,0,0,0,0,0
Albania,2004-09-01,0,0,0,0,0,0
Albania,2004-09-01,2,0,0,3,0,5
Albania,2004-09-01,11,0,0,9,1,21
Albania,2004-09-01,18,0,0,6,0,24
Albania,2004-09-01,4,0,-4,0,0,0
Albania,2004-09-01,0,0,0,0,0,0
Albania,2004-09-01,0,0,0,0,0,0
Albania,2004-09-01,-3,0,0,-2,0,-5
Albania,2004-09-01,7,0,0,14,2,23
Albania,2004-09-01,6,0,0,21,2,29
Albania,2004-09-01,2,0,0,3,0,5
Albania,2004-10-01,7,0,0,0,0,7
Albania,2004-10-01,0,0,0,0,2,2
Albania,2004-10-01,6,0,-2,0,2,6
Albania,2004-10-01,3,0,0,0,2,5
Albania,2004-10-01,2,0,-2,6,0,6
Albania,2004-10-01,4,0,0,3,2,9
Albania,2004-10-01,0,0,0,0,0,0
Albania,2004-10-01,12,0,-4,2,7,17
Albania,2004-10-01,7,0,0,6,0,13
Albania,2004-10-01,-2,0,0,3,0,1
Albania,2004-10-01,0,0,0,3,0,3
Albania,2004-10-01,25,0,0,6,0,31
Albania,2004-10-01,5,0,0,6,1,12
Albania,2004-10-01,9,0,0,-2,0,7
Albania,2004-10-01,9,0,0,0,0,9
Albania,2004-10-01,-1,0,0,0,0,-1
Albania,2004-10-01,0,0,0,0,0,0
Albania,2004-10-01,6,0,0,0,0,6
Albania,2004-10-01,20,0,0,3,1,24
Albania,2004-10-01,1,0,0,3,1,5
Albania,2004-10-01,5,0,0,0,0,5
Albania,2004-10-01,0,0,0,3,2,5
Albania,2004-10-01,4,0,0,9,8,21
Albania,2004-10-01,21,0,-1,0,10,30
Albania,2004-10-01,-2,0,0,0,2,0
Albania,2004-10-01,16,0,0,3,5,24
Albania,2004-10-01,0,0,0,3,0,3
Albania,2004-10-01,-2,0,0,0,0,-2
Albania,2004-10-01,12,4,0,-2,1,15
Albania,2004-10-01,9,0,0,15,0,24
Albania,2004-10-01,0,0,-2,0,0,-2
Albania,2004-11-01,0,0,0,3,0,3
Albania,2004-11-01,4,0,0,3,1,8
Albania,2004-11-01,25,0,-1,9,2,35
Albania,2004-11-01,11,0,1,9,0,21
Albania,2004-11-01,21,2,0,6,2,31
Albania,2004-11-01,-1,0,0,0,0,-1
Albania,2004-11-01,5,0,0,0,9,14
Albania,2004-11-01,4,0,0,12,1,17
Albania,2004-11-01,5,0,0,3,1,9
Albania,2004-11-01,4,0,0,0,0,4
Albania,2004-11-01,2,0,0,0,2,4
Albania,2004-11-01,4,0,0,0,3,7
Albania,2004-11-01,10,0,0,8,0,18
Albania,2004-11-01,1,0,0,3,0,4
Albania,2004-11-01,14,0,-9,27,6,38
Albania,2004-11-01,3,0,0,3,3,9
Albania,2004-11-01,4,0,0,0,0,4
Albania,2004-11-01,-2,0,0,0,0,-2
Albania,2004-11-01,1,0,0,0,0,1
Albania,2004-11-01,5,0,-6,0,0,-1
Albania,2004-11-01,3,0,0,6,3,12
Albania,2004-11-01,24,0,1,0,4,29
Albania,2004-11-01,4,0,0,-2,0,2
Albania,2004-11-01,-1,0,0,9,1,9
Albania,2004-11-01,0,0,0,6,0,6
Albania,2004-11-01,8,0,-2,2,0,8
Albania,2004-11-01,2,0,0,0,0,2
Albania,2004-11-01,10,0,0,0,1,11
Albania,2004-11-01,14,0,0,3,1,18
Albania,2004-11-01,8,0,0,2,0,10
Albania,2004-12-01,18,0,0,12,0,30
Albania,2004-12-01,0,0,0,3,2,5
Albania,2004-12-01,11,0,1,22,1,35
Albania,2004-12-01,6,0,3,1,0,10
Albania,2004-12-01,3,0,0,-4,0,-1
Albania,2004-12-01,7,0,0,0,0,7
Albania,2004-12-01,4,0,0,0,0,4
Albania,2004-12-01,-1,0,0,0,0,-1
Albania,2004-12-01,6,0,1,15,2,24
Albania,2004-12-01,2,0,0,3,0,5
Albania,2004-12-01,0,0,0,0,0,0
Albania,2004-12-01,2,0,1,3,0,6
Albania,2004-12-01,4,0,0,0,0,4
Albania,2004-12-01,14,0,-2,3,1,16
Albania,2004-12-01,24,0,0,13,2,39
Albania,2004-12-01,2,0,0,0,1,3
Albania,2004-12-01,7,0,0,-2,0,5
Albania,2004-12-01,0,0,0,0,4,4
Albania,2004-12-01,0,0,0,0,0,0
Albania,2004-12-01,11,0,0,31,3,45
Albania,2004-12-01,4,0,0,9,0,13
Albania,2004-12-01,34,0,0,9,2,45
Albania,2004-12-01,8,0,0,0,0,8
Albania,2004-12-01,3,0,0,0,2,5
Albania,2004-12-01,2,0,1,6,0,9
Albania,2004-12-01,12,0,0,12,0,24
Albania,2004-12-01,4,0,0,12,0,16
Albania,2004-12-01,4,0,0,3,0,7
Albania,2004-12-01,1,0,0,7,0,8
Albania,2004-12-01,2,0,0,0,1,3
Albania,2004-12-01,0,0,0,0,0,0
Algeria,2004-01-01,0,0,0,0,0,0
Algeria,2004-01-01,6,0,0,0,0,6
Algeria,2004-01-01,2,0,0,0,0,2
Algeria,2004-01-01,12,0,0,0,1,13
Algeria,2004-01-01,0,0,0,-4,0,-4
Algeria,2004-01-01,0,0,0,0,0,0
Algeria,2004-01-01,7,0,0,-4,0,3
Algeria,2004-01-01,-1,0,0,-4,0,-5
Algeria,2004-01-01,6,0,0,3,0,9
Algeria,2004-01-01,7,0,0,1,2,10
Algeria,2004-01-01,4,0,0,6,0,10
Algeria,2004-01-01,2,0,0,0,0,2
Algeria,2004-01-01,0,0,0,0,0,0
Algeria,2004-01-01,-1,0,0,6,0,5
Algeria,2004-01-01,5,0,0,9,0,14
Algeria,2004-01-01,2,0,0,4,1,7
Algeria,2004-01-01,10,0,-2,2,0,10
Algeria,2004-01-01,1,0,1,-2,2,2
Algeria,2004-01-01,0,0,0,0,0,0
Algeria,2004-01-01,8,0,0,6,0,14
Algeria,2004-01-01,1,0,0,0,0,1
Algeria,2004-01-01,6,0,0,9,2,17
Algeria,2004-01-01,4,0,2,0,0,6
Algeria,2004-01-01,2,0,1,0,0,3
Algeria,2004-01-01,5,0,0,0,0,5
Algeria,2004-01-01,5,0,0,6,0,11
Algeria,2004-01-01,2,0,0,12,0,14
Algeria,2004-01-01,2,0,0,0,0,2
Algeria,2004-01-01,1,0,0,0,3,4
Algeria,2004-01-01,-3,0,0,0,0,-3
Algeria,2004-01-01,-2,0,0,0,0,-2
Algeria,2004-02-01,3,0,0,0,0,3
Algeria,2004-02-01,0,0,0,21,1,22
Algeria,2004-02-01,-2,0,0,0,0,-2
Algeria,2004-02-01,14,0,0,0,1,15
Algeria,2004-02-01,1,0,0,3,0,4
Algeria,2004-02-01,3,0,0,3,0,6
Algeria,2004-02-01,5,0,0,0,0,5
Algeria,2004-02-01,3,0,0,0,0,3
Algeria,2004-02-01,0,0,-4,0,0,-4
Algeria,2004-02-01,-1,0,0,3,0,2
Algeria,2004-02-01,0,0,-1,3,0,2
Algeria,2004-02-01,3,0,0,9,0,12
Algeria,2004-02-01,10,0,0,9,1,20
Algeria,2004-02-01,4,0,-1,6,0,9
Algeria,2004-02-01,0,0,0,18,0,18
Algeria,2004-02-01,3,0,0,0,0,3
Algeria,2004-02-01,0,0,0,3,0,3
Algeria,2004-02-01,2,0,0,0,0,2
Algeria,2004-02-01,-8,0,0,2,0,-6
Algeria,2004-02-01,1,0,0,0,2,3
Algeria,2004-02-01,-1,0,0,0,0,-1
Algeria,2004-02-01,2,0,0,-4,1,-1
Algeria,2004-02-01,0,0,0,12,1,13
Algeria,2004-02-01,4,0,0,0,0,4
Algeria,2004-02-01,0,0,0,-7,0,-7
Algeria,2004-02-01,16,0,0,-8,1,9
Algeria,2004-02-01,3,0,0,0,0,3
Algeria,2004-02-01,6,0,0,0,0,6
Algeria,2004-02-01,1,0,0,0,1,2
Algeria,2004-03-01,2,0,0,0,0,2
Algeria,2004-03-01,3,0,0,1,0,4
Algeria,2004-03-01,10,0,0,3,0,13
Algeria,2004-03-01,4,0,0,0,3,7
Algeria,2004-03-01,4,0,1,-3,0,2
Algeria,2004-03-01,9,0,0,12,0,21
Algeria,2004-03-01,2,0,2,-3,0,1
Algeria,2004-03-01,42,0,0,0,0,42
Algeria,2004-03-01,8,0,0,15,0,23
Algeria,2004-03-01,-2,0,0,3,0,1
Algeria,2004-03-01,36,0,0,0,2,38
Algeria,2004-03-01,2,0,0,6,1,9
Algeria,2004-03-01,3,0,0,0,0,3
Algeria,2004-03-01,17,0,0,1,0,18
Algeria,2004-03-01,0,0,0,4,0,4
Algeria,2004-03-01,4,0,0,3,0,7
Algeria,2004-03-01,4,0,0,6,1,11
Algeria,2004-03-01,8,0,4,0,0,12
Algeria,2004-03-01,0,0,0,-2,0,-2
Algeria,2004-03-01,0,0,0,0,0,0
Algeria,2004-03-01,12,0,0,0,0,12
Algeria,2004-03-01,6,0,0,12,0,18
Algeria,2004-03-01,6,1,0,3,0,10
Algeria,2004-03-01,1,0,-2,24,0,23
Algeria,2004-03-01,8,0,0,0,1,9
Algeria,2004-03-01,4,0,0,0,0,4
Algeria,2004-03-01,6,0,0,0,0,6
Algeria,2004-03-01,-2,0,0,0,0,-2
Algeria,2004-03-01,5,0,0,12,2,19
Algeria,2004-03-01,0,0,0,9,0,9
Algeria,2004-04-01,0,0,0,0,0,0
Algeria,2004-04-01,0,0,0,3,0,3
Algeria,2004-04-01,0,0,0,3,0,3
Algeria,2004-04-01,0,0,0,3,0,3
Algeria,2004-04-01,1,0,0,0,2,3
Algeria,2004-04-01,0,0,0,0,0,0
Algeria,2004-04-01,1,0,0,0,1,2
Algeria,2004-04-01,8,0,-2,9,0,15
Algeria,2004-04-01,7,0,1,0,-1,7
Algeria,2004-04-01,1,0,0,10,0,11
Algeria,2004-04-01,0,0,0,0,0,0
Algeria,2004-04-01,2,0,-6,12,0,8
Algeria,2004-04-01,5,0,0,9,0,14
Algeria,2004-04-01,10,0,0,6,0,16
Algeria,2004-04-01,2,0,0,0,0,2
Algeria,2004-04-01,3,0,0,0,0,3
Algeria,2004-04-01,6,0,0,0,0,6
Algeria,2004-04-01,3,0,0,0,0,3
Algeria,2004-04-01,3,0,0,0,0,3
Algeria,2004-04-01,10,0,0,16,0,26
Algeria,2004-04-01,1,0,0,6,0,7
Algeria,2004-04-01,2,0,0,0,1,3
Algeria,2004-04-01,4,0,0,1,0,5
Algeria,2004-04-01,1,0,0,0,0,1
Algeria,2004-04-01,-1,0,0,0,0,-1
Algeria,2004-04-01,3,0,-2,0,0,1
Algeria,2004-04-01,6,0,0,0,0,6
Algeria,2004-04-01,-2,0,0,3,0,1
Algeria,2004-04-01,4,0,0,3,0,7
Algeria,2004-05-01,1,0,0,0,0,1
Algeria,2004-05-01,-1,0,0,0,0,-1
Algeria,2004-05-01,0,0,0,15,1,16
Algeria,2004-05-01,5,0,0,-1,0,4
Algeria,2004-05-01,0,0,0,3,0,3
Algeria,2004-05-01,4,0,0,9,0,13
Algeria,2004-05-01,33,0,0,0,1,34
Algeria,2004-05-01,1,0,0,6,0,7
Algeria,2004-05-01,4,0,0,3,0,7
Algeria,2004-05-01,1,0,0,1,0,2
Algeria,2004-05-01,0,0,0,15,2,17
Algeria,2004-05-01,4,0,0,0,0,4
Algeria,2004-05-01,5,0,0,4,0,9
Algeria,2004-05-01,12,0,0,1,0,13
Algeria,2004-05-01,5,0,0,6,0,11
Algeria,2004-05-01,3,0,0,3,0,6
Algeria,2004-05-01,1,0,0,0,0,1
Algeria,2004-05-01,10,0,0,27,0,37
Algeria,2004-05-01,2,0,0,3,0,5
Algeria,2004-05-01,5,0,0,1,1,7
Algeria,2004-05-01,0,0,0,-4,0,-4
Algeria,2004-05-01,11,0,0,0,0,11
Algeria,2004-05-01,0,0,0,0,0,0
Algeria,2004-05-01,3,0,0,0,-2,1
Algeria,2004-05-01,-1,0,0,3,0,2
Algeria,2004-05-01,0,0,0,21,0,21
Algeria,2004-05-01,0,0,0,-2,0,-2
Algeria,2004-05-01,2,0,0,0,0,2
Algeria,2004-05-01,0,0,0,0,0,0
Algeria,2004-05-01,2,0,0,0,0,2
Algeria,2004-05-01,13,0,0,0,0,13
Algeria,2004-06-01,0,0,0,6,0,6
Algeria,2004-06-01,-2,0,0,0,0,-2
Algeria,2004-06-01,8,0,0,0,0,8
Algeria,2004-06-01,0,0,0,0,0,0
Algeria,2004-06-01,0,0,0,7,1,8
Algeria,2004-06-01,1,0,0,0,0,1
Algeria,2004-06-01,1,0,0,17,0,18
Algeria,2004-06-01,0,0,0,0,0,0
Algeria,2004-06-01,2,0,0,18,0,20
Algeria,2004-06-01,2,0,0,9,0,11
Algeria,2004-06-01,8,0,-2,0,0,6
Algeria,2004-06-01,4,0,-2,0,0,2
Algeria,2004-06-01,3,0,0,0,0,3
Algeria,2004-06-01,47,0,0,0,0,47
Algeria,2004-06-01,1,0,0,0,0,1
Algeria,2004-06-01,2,0,0,3,0,5
Algeria,2004-06-01,2,0,0,3,2,7
Algeria,2004-06-01,6,0,0,-2,1,5
Algeria,2004-06-01,15,0,0,-2,1,14
Algeria,2004-06-01,3,0,0,24,0,27
Algeria,2004-06-01,19,0,0,18,0,37
Algeria,2004-06-01,4,0,0,10,1,15
Algeria,2004-06-01,7,0,0,0,0,7
Algeria,2004-06-01,2,0,0,24,0,26
Algeria,2004-06-01,-4,0,0,-2,0,-6
Algeria,2004-06-01,0,0,0,0,0,0
Algeria,2004-06-01,3,0,0,0,0,3
Algeria,2004-06-01,8,0,0,-2,0,6
Algeria,2004-06-01,3,0,0,0,0,3
Algeria,2004-06-01,1,0,0,0,0,1
Algeria,2004-07-01,0,0,0,0,0,0
Algeria,2004-07-01,6,0,0,0,0,6
Algeria,2004-07-01,3,0,0,9,0,12
Algeria,2004-07-01,0,0,0,0,0,0
Algeria,2004-07-01,4,0,0,4,0,8
Algeria,2004-07-01,2,2,0,0,0,4
Algeria,2004-07-01,0,0,0,0,0,0
Algeria,2004-07-01,3,0,0,8,0,11
Algeria,2004-07-01,0,0,0,0,0,0
Algeria,2004-07-01,2,0,0,0,0,2
Algeria,2004-07-01,2,0,0,0,0,2
Algeria,2004-07-01,3,0,0,0,0,3
Algeria,2004-07-01,3,0,0,9,0,12
Algeria,2004-07-01,0,0,0,0,0,0
Algeria,2004-07-01,-1,0,0,0,0,-1
Algeria,2004-07-01,0,0,-1,0,0,-1
Algeria,2004-07-01,0,0,0,0,0,0
Algeria,2004-07-01,0,0,-4,0,0,-4
Algeria,2004-07-01,0,0,0,6,0,6
Algeria,2004-07-01,5,0,0,9,0,14
Algeria,2004-07-01,0,0,0,0,0,0
Algeria,2004-07-01,0,0,0,0,0,0
Algeria,2004-07-01,6,0,0,3,0,9
Algeria,2004-07-01,-1,0,0,0,0,-1
Algeria,2004-07-01,-2,0,0,0,0,-2
Algeria,2004-07-01,12,0,0,5,0,17
Algeria,2004-07-01,0,0,0,6,0,6
Algeria,2004-07-01,6,0,0,0,0,6
Algeria,2004-07-01,5,0,0,3,0,8
Algeria,2004-07-01,0,0,0,0,0,0
Algeria,2004-07-01,0,0,0,0,0,0
Algeria,2004-08-01,0,0,0,0,0,0
Algeria,2004-08-01,0,0,0,0,0,0
Algeria,2004-08-01,4,0,0,10,0,14
Algeria,2004-08-01,0,0,0,0,0,0
Algeria,2004-08-01,3,0,0,-3,0,0
Algeria,2004-08-01,4,0,0,0,0,4
Algeria,2004-08-01,0,0,0,0,0,0
Algeria,2004-08-01,3,0,0,3,0,6
Algeria,2004-08-01,0,0,0,3,0,3
Algeria,2004-08-01,0,0,0,0,2,2
Algeria,2004-08-01,0,0,0,-2,0,-2
Algeria,2004-08-01,-1,0,0,0,0,-1
Algeria,2004-08-01,0,0,0,0,0,0
Algeria,2004-08-01,3,0,0,0,0,3
Algeria,2004-08-01,0,0,0,0,0,0
Algeria,2004-08-01,0,0,0,4,0,4
Algeria,2004-08-01,7,0,0,6,2,15
Algeria,2004-08-01,6,0,0,6,0,12
Algeria,2004-08-01,0,0,0,6,0,6
Algeria,2004-08-01,2,0,0,0,0,2
Algeria,2004-08-01,0,0,0,-6,0,-6
Algeria,2004-08-01,7,0,0,0,0,7
Algeria,2004-08-01,0,0,0,0,0,0
Algeria,2004-08-01,8,0,0,-2,0,6
Algeria,2004-08-01,3,0,0,0,0,3
Algeria,2004-08-01,0,0,0,0,0,0
Algeria,2004-08-01,2,0,0,0,0,2
Algeria,2004-08-01,0,0,0,0,0,0
Algeria,2004-09-01,3,0,0,0,0,3
Algeria,2004-09-01,0,0,0,3,0,3
Algeria,2004-09-01,0,0,0,0,2,2
Algeria,2004-09-01,0,0,0,-2,0,-2
Algeria,2004-09-01,0,0,0,6,0,6
Algeria,2004-09-01,3,0,0,0,0,3
Algeria,2004-09-01,8,0,0,0,0,8
Algeria,2004-09-01,3,0,0,0,0,3
Algeria,2004-09-01,0,0,0,0,0,0
Algeria,2004-09-01,9,0,0,7,0,16
Algeria,2004-09-01,0,0,0,2,0,2
Algeria,2004-09-01,0,0,0,-2,0,-2
Algeria,2004-09-01,4,0,0,3,0,7
Algeria,2004-09-01,11,2,0,21,0,34
Algeria,2004-09-01,6,0,-2,9,0,13
Algeria,2004-09-01,2,0,0,15,1,18
Algeria,2004-09-01,0,0,0,6,0,6
Algeria,2004-09-01,0,0,0,0,0,0
Algeria,2004-09-01,7,0,0,6,0,13
Algeria,2004-09-01,2,0,0,0,0,2
Algeria,2004-09-01,0,0,0,3,0,3
Algeria,2004-09-01,-1,0,0,0,0,-1
Algeria,2004-09-01,0,0,0,0,0,0
Algeria,2004-09-01,0,0,0,0,0,0
Algeria,2004-09-01,0,0,0,0,0,0
Algeria,2004-09-01,3,0,0,0,0,3
Algeria,2004-09-01,13,0,0,0,0,13
Algeria,2004-09-01,11,0,0,0,0,11
Algeria,2004-10-01,0,0,0,0,1,1
Algeria,2004-10-01,0,0,0,0,0,0
Algeria,2004-10-01,0,0,0,0,0,0
Algeria,2004-10-01,6,0,0,16,0,22
Algeria,2004-10-01,7,0,0,21,6,34
Algeria,2004-10-01,4,0,0,3,0,7
Algeria,2004-10-01,6,0,0,12,0,18
Algeria,2004-10-01,10,0,0,0,0,10
Algeria,2004-10-01,8,0,0,0,1,9
Algeria,2004-10-01,9,0,0,0,0,9
Algeria,2004-10-01,2,0,0,0,0,2
Algeria,2004-10-01,-1,0,0,0,0,-1
Algeria,2004-10-01,7,0,0,0,0,7
Algeria,2004-10-01,3,0,-4,0,0,-1
Algeria,2004-10-01,1,0,0,18,0,19
Algeria,2004-10-01,5,0,0,0,0,5
Algeria,2004-10-01,0,0,0,3,0,3
Algeria,2004-10-01,2,0,0,0,1,3
Algeria,2004-10-01,2,0,0,6,0,8
Algeria,2004-10-01,5,0,1,15,1,22
Algeria,2004-10-01,-2,0,3,-3,3,1
Algeria,2004-10-01,0,0,-1,0,-4,-5
Algeria,2004-10-01,0,0,0,-1,0,-1
Algeria,2004-10-01,3,0,0,3,1,7
Algeria,2004-10-01,6,0,0,0,1,7
Algeria,2004-10-01,0,0,0,3,1,4
Algeria,2004-10-01,2,0,0,6,0,8
Algeria,2004-10-01,0,0,0,2,0,2
Algeria,2004-10-01,8,0,0,9,0,17
Algeria,2004-10-01,-3,0,0,0,0,-3
Algeria,2004-10-01,0,0,0,0,0,0
Algeria,2004-11-01,0,0,0,3,0,3
Algeria,2004-11-01,0,0,0,3,0,3
Algeria,2004-11-01,7,0,0,0,0,7
Algeria,2004-11-01,0,0,0,0,0,0
Algeria,2004-11-01,0,0,0,0,0,0
Algeria,2004-11-01,0,0,0,0,1,1
Algeria,2004-11-01,0,0,0,0,0,0
Algeria,2004-11-01,4,0,0,0,0,4
Algeria,2004-11-01,2,0,0,6,0,8
Algeria,2004-11-01,0,0,0,9,0,9
Algeria,2004-11-01,1,0,0,6,4,11
Algeria,2004-11-01,0,0,0,0,0,0
Algeria,2004-11-01,1,0,0,0,0,1
Algeria,2004-11-01,0,0,0,0,0,0
Algeria,2004-11-01,0,0,0,0,0,0
Algeria,2004-11-01,0,0,0,0,0,0
Algeria,2004-11-01,0,0,0,9,0,9
Algeria,2004-11-01,0,0,0,0,0,0
Algeria,2004-11-01,0,0,0,0,0,0
Algeria,2004-11-01,0,0,0,3,0,3
Algeria,2004-11-01,0,0,0,1,3,4
Algeria,2004-11-01,0,0,0,0,0,0
Algeria,2004-11-01,0,0,0,0,0,0
Algeria,2004-11-01,2,0,0,0,0,2
Algeria,2004-11-01,3,0,0,5,3,11
Algeria,2004-11-01,0,0,0,0,0,0
Algeria,2004-11-01,0,0,0,0,0,0
Algeria,2004-11-01,0,0,0,0,0,0
Algeria,2004-11-01,-1,0,0,0,0,-1
Algeria,2004-11-01,-3,0,0,0,0,-3
Algeria,2004-12-01,3,0,0,0,0,3
Algeria,2004-12-01,6,0,0,0,4,10
Algeria,2004-12-01,4,0,0,0,4,8
Algeria,2004-12-01,0,0,0,0,0,0
Algeria,2004-12-01,2,0,0,0,0,2
Algeria,2004-12-01,3,0,0,3,0,6
Algeria,2004-12-01,9,0,0,15,0,24
Algeria,2004-12-01,0,0,0,0,0,0
Algeria,2004-12-01,4,0,0,-1,0,3
Algeria,2004-12-01,6,0,0,6,3,15
Algeria,2004-12-01,0,0,0,9,0,9
Algeria,2004-12-01,3,0,0,0,0,3
Algeria,2004-12-01,0,0,0,3,0,3
Algeria,2004-12-01,9,0,0,21,0,30
Algeria,2004-12-01,0,0,0,9,0,9
Algeria,2004-12-01,-1,0,0,3,0,2
Algeria,2004-12-01,0,0,0,0,0,0
Algeria,2004-12-01,0,0,0,0,0,0
Algeria,2004-12-01,4,0,0,3,0,7
Algeria,2004-12-01,-1,0,0,0,0,-1
Algeria,2004-12-01,0,0,0,0,0,0
Algeria,2004-12-01,3,0,0,0,0,3
Algeria,2004-12-01,0,0,0,0,0,0
Algeria,2004-12-01,6,0,0,-2,0,4
Algeria,2004-12-01,0,0,0,0,0,0
Algeria,2004-12-01,0,0,0,0,0,0
Algeria,2004-12-01,2,0,0,0,0,2
Algeria,2004-12-01,3,0,0,0,0,3
Algeria,2004-12-01,0,0,0,0,0,0
Bangladesh,2004-01-01,3,0,0,1,0,4
Bangladesh,2004-01-01,5,0,0,0,0,5
Bangladesh,2004-01-01,1,0,0,3,0,4
Bangladesh,2004-01-01,14,0,0,0,0,14
Bangladesh,2004-01-01,2,0,0,0,0,2
Bangladesh,2004-01-01,-1,0,0,0,0,-1
Bangladesh,2004-01-01,0,0,0,0,0,0
Bangladesh,2004-01-01,0,0,0,0,0,0
Bangladesh,2004-01-01,-9,0,0,0,0,-9
Bangladesh,2004-01-01,3,0,0,0,0,3
Bangladesh,2004-01-01,0,0,0,0,0,0
Bangladesh,2004-01-01,0,0,0,0,0,0
Bangladesh,2004-01-01,5,0,0,6,3,14
Bangladesh,2004-01-01,0,0,0,0,0,0
Bangladesh,2004-01-01,2,0,0,0,0,2
Bangladesh,2004-01-01,2,0,0,12,1,15
Bangladesh,2004-01-01,9,0,0,3,3,15
Bangladesh,2004-01-01,0,0,0,0,0,0
Bangladesh,2004-01-01,0,0,0,0,0,0
Bangladesh,2004-01-01,-1,0,0,0,0,-1
Bangladesh,2004-01-01,-3,0,0,0,2,-1
Bangladesh,2004-01-01,0,0,0,0,0,0
Bangladesh,2004-01-01,5,0,0,10,3,18
Bangladesh,2004-01-01,0,0,0,6,0,6
Bangladesh,2004-01-01,-1,0,0,-2,0,-3
Bangladesh,2004-02-01,0,0,0,6,0,6
Bangladesh,2004-02-01,0,0,0,3,0,3
Bangladesh,2004-02-01,0,0,0,0,0,0
Bangladesh,2004-02-01,4,0,0,0,0,4
Bangladesh,2004-02-01,4,0,0,0,0,4
Bangladesh,2004-02-01,-10,0,0,0,0,-10
Bangladesh,2004-02-01,1,0,0,0,0,1
Bangladesh,2004-02-01,0,0,0,0,0,0
Bangladesh,2004-02-01,-2,0,0,0,0,-2
Bangladesh,2004-02-01,1,0,0,0,1,2
Bangladesh,2004-02-01,0,0,0,0,0,0
Bangladesh,2004-02-01,0,0,0,3,0,3
Bangladesh,2004-02-01,-10,0,0,0,0,-10
Bangladesh,2004-02-01,4,0,0,3,1,8
Bangladesh,2004-02-01,0,0,0,0,1,1
Bangladesh,2004-02-01,1,0,0,3,0,4
Bangladesh,2004-02-01,3,0,0,0,0,3
Bangladesh,2004-02-01,3,0,0,3,0,6
Bangladesh,2004-02-01,3,0,0,6,0,9
Bangladesh,2004-02-01,0,0,0,0,0,0
Bangladesh,2004-02-01,4,0,-2,0,0,2
Bangladesh,2004-02-01,2,0,0,0,2,4
Bangladesh,2004-02-01,0,0,0,0,0,0
Bangladesh,2004-02-01,5,0,0,9,0,14
Bangladesh,2004-02-01,0,0,0,15,0,15
Bangladesh,2004-02-01,0,0,0,3,0,3
Bangladesh,2004-03-01,1,0,0,0,0,1
Bangladesh,2004-03-01,0,0,0,6,0,6
Bangladesh,2004-03-01,1,0,0,0,0,1
Bangladesh,2004-03-01,-2,0,0,0,0,-2
Bangladesh,2004-03-01,0,0,0,0,0,0
Bangladesh,2004-03-01,0,0,0,0,0,0
Bangladesh,2004-03-01,0,0,0,0,0,0
Bangladesh,2004-03-01,0,0,0,0,0,0
Bangladesh,2004-03-01,0,0,0,0,2,2
Bangladesh,2004-03-01,4,0,0,0,3,7
Bangladesh,2004-03-01,4,0,0,0,0,4
Bangladesh,2004-03-01,0,0,0,3,3,6
Bangladesh,2004-03-01,2,0,0,0,0,2
Bangladesh,2004-03-01,0,0,0,0,0,0
Bangladesh,2004-03-01,0,0,0,-2,0,-2
Bangladesh,2004-03-01,0,0,0,-2,0,-2
Bangladesh,2004-03-01,2,0,0,0,0,2
Bangladesh,2004-03-01,-1,0,0,3,0,2
Bangladesh,2004-03-01,1,0,2,0,6,9
Bangladesh,2004-03-01,9,0,0,18,0,27
Bangladesh,2004-03-01,2,0,0,0,0,2
Bangladesh,2004-03-01,-20,0,-2,0,0,-22
Bangladesh,2004-03-01,17,0,0,4,0,21
Bangladesh,2004-03-01,0,0,0,0,0,0
Bangladesh,2004-03-01,-3,0,0,0,0,-3
Bangladesh,2004-03-01,3,0,0,0,0,3
Bangladesh,2004-03-01,12,0,0,6,0,18
Bangladesh,2004-03-01,0,0,0,6,0,6
Bangladesh,2004-04-01,5,0,0,-2,0,3
Bangladesh,2004-04-01,0,0,0,3,0,3
Bangladesh,2004-04-01,0,0,0,0,0,0
Bangladesh,2004-04-01,3,0,0,3,0,6
Bangladesh,2004-04-01,0,0,0,0,0,0
Bangladesh,2004-04-01,1,0,0,0,2,3
Bangladesh,2004-04-01,10,0,0,9,0,19
Bangladesh,2004-04-01,3,0,0,6,0,9
Bangladesh,2004-04-01,0,0,0,0,0,0
Bangladesh,2004-04-01,2,0,0,0,0,2
Bangladesh,2004-04-01,0,0,0,0,1,1
Bangladesh,2004-04-01,0,0,0,0,0,0
Bangladesh,2004-04-01,0,0,0,0,0,0
Bangladesh,2004-04-01,0,0,0,6,0,6
Bangladesh,2004-04-01,6,0,0,6,0,12
Bangladesh,2004-04-01,0,0,0,0,0,0
Bangladesh,2004-04-01,0,0,0,3,0,3
Bangladesh,2004-04-01,4,0,1,0,0,5
Bangladesh,2004-04-01,1,0,0,0,1,2
Bangladesh,2004-04-01,0,0,0,4,0,4
Bangladesh,2004-04-01,0,0,0,0,0,0
Bangladesh,2004-04-01,0,0,-2,0,1,-1
Bangladesh,2004-04-01,3,0,0,3,1,7
Bangladesh,2004-04-01,0,0,0,0,0,0
Bangladesh,2004-04-01,0,0,0,0,0,0
Bangladesh,2004-05-01,2,0,0,0,2,4
Bangladesh,2004-05-01,-1,0,0,0,0,-1
Bangladesh,2004-05-01,3,0,0,0,0,3
Bangladesh,2004-05-01,0,0,0,-2,0,-2
Bangladesh,2004-05-01,2,0,0,0,0,2
Bangladesh,2004-05-01,0,0,0,0,0,0
Bangladesh,2004-05-01,-4,0,0,0,0,-4
Bangladesh,2004-05-01,15,0,0,0,0,15
Bangladesh,2004-05-01,2,0,0,-2,0,0
Bangladesh,2004-05-01,0,0,0,0,0,0
Bangladesh,2004-05-01,7,0,-4,6,2,11
Bangladesh,2004-05-01,0,0,0,0,0,0
Bangladesh,2004-05-01,2,0,0,0,0,2
Bangladesh,2004-05-01,8,0,0,0,3,11
Bangladesh,2004-05-01,0,0,0,0,0,0
Bangladesh,2004-05-01,4,0,0,0,0,4
Bangladesh,2004-05-01,4,0,0,0,0,4
Bangladesh,2004-05-01,12,0,0,0,3,15
Bangladesh,2004-05-01,12,0,0,0,5,17
Bangladesh,2004-05-01,0,0,0,3,0,3
Bangladesh,2004-05-01,3,0,0,6,2,11
Bangladesh,2004-05-01,16,0,0,24,2,42
Bangladesh,2004-05-01,0,0,0,12,0,12
Bangladesh,2004-05-01,6,0,0,12,2,20
Bangladesh,2004-05-01,0,2,0,3,0,5
Bangladesh,2004-05-01,0,0,0,0,0,0
Bangladesh,2004-05-01,5,0,0,0,0,5
Bangladesh,2004-06-01,3,0,0,0,0,3
Bangladesh,2004-06-01,2,0,0,0,0,2
Bangladesh,2004-06-01,2,0,0,9,1,12
Bangladesh,2004-06-01,3,0,0,0,0,3
Bangladesh,2004-06-01,0,0,0,0,2,2
Bangladesh,2004-06-01,0,0,0,0,0,0
Bangladesh,2004-06-01,2,0,0,0,0,2
Bangladesh,2004-06-01,0,0,0,0,0,0
Bangladesh,2004-06-01,1,0,0,0,0,1
Bangladesh,2004-06-01,1,0,0,0,0,1
Bangladesh,2004-06-01,1,0,0,0,0,1
Bangladesh,2004-06-01,3,0,0,-1,0,2
Bangladesh,2004-06-01,0,0,0,3,0,3
Bangladesh,2004-06-01,0,0,0,0,0,0
Bangladesh,2004-06-01,0,0,0,0,0,0
Bangladesh,2004-06-01,5,0,0,3,0,8
Bangladesh,2004-06-01,1,0,0,6,0,7
Bangladesh,2004-06-01,2,0,0,6,0,8
Bangladesh,2004-06-01,4,0,0,0,0,4
Bangladesh,2004-06-01,1,0,-2,0,0,-1
Bangladesh,2004-06-01,5,0,0,0,2,7
Bangladesh,2004-06-01,1,0,0,0,0,1
Bangladesh,2004-06-01,0,0,0,0,0,0
Bangladesh,2004-06-01,0,0,0,0,0,0
Bangladesh,2004-06-01,1,0,0,1,0,2
Bangladesh,2004-06-01,0,0,0,0,0,0
Bangladesh,2004-06-01,4,0,0,6,0,10
Bangladesh,2004-06-01,6,0,0,0,0,6
Bangladesh,2004-06-01,1,0,0,3,0,4
Bangladesh,2004-07-01,0,0,0,-2,0,-2
Bangladesh,2004-07-01,0,0,0,-2,0,-2
Bangladesh,2004-07-01,0,0,0,0,0,0
Bangladesh,2004-07-01,0,0,0,0,0,0
Bangladesh,2004-07-01,0,0,0,0,0,0
Bangladesh,2004-07-01,0,0,0,0,0,0
Bangladesh,2004-07-01,0,0,0,0,0,0
Bangladesh,2004-07-01,9,0,0,6,4,19
Bangladesh,2004-07-01,3,0,0,0,0,3
Bangladesh,2004-07-01,2,0,0,0,0,2
Bangladesh,2004-07-01,-1,0,0,3,0,2
Bangladesh,2004-07-01,0,0,0,0,0,0
Bangladesh,2004-07-01,2,0,0,0,2,4
Bangladesh,2004-07-01,0,0,0,0,0,0
Bangladesh,2004-07-01,0,0,0,9,0,9
Bangladesh,2004-07-01,3,0,0,9,0,12
Bangladesh,2004-07-01,0,0,0,0,2,2
Bangladesh,2004-07-01,6,0,0,0,0,6
Bangladesh,2004-07-01,3,0,0,-2,0,1
Bangladesh,2004-07-01,-2,0,0,0,0,-2
Bangladesh,2004-07-01,1,0,0,0,0,1
Bangladesh,2004-07-01,7,0,0,0,0,7
Bangladesh,2004-07-01,26,0,0,12,0,38
Bangladesh,2004-07-01,2,0,0,0,0,2
Bangladesh,2004-07-01,0,0,0,0,0,0
Bangladesh,2004-07-01,5,0,0,0,0,5
Bangladesh,2004-08-01,10,0,0,0,0,10
Bangladesh,2004-08-01,0,0,0,0,0,0
Bangladesh,2004-08-01,11,0,0,0,0,11
Bangladesh,2004-08-01,2,0,0,0,0,2
Bangladesh,2004-08-01,0,0,0,0,0,0
Bangladesh,2004-08-01,2,0,0,0,0,2
Bangladesh,2004-08-01,0,0,0,0,0,0
Bangladesh,2004-08-01,4,0,0,0,0,4
Bangladesh,2004-08-01,1,0,0,0,0,1
Bangladesh,2004-08-01,1,0,0,0,0,1
Bangladesh,2004-08-01,-1,0,0,0,0,-1
Bangladesh,2004-08-01,0,0,0,0,0,0
Bangladesh,2004-08-01,0,0,0,-1,0,-1
Bangladesh,2004-08-01,0,0,0,-1,0,-1
Bangladesh,2004-08-01,4,0,0,0,0,4
Bangladesh,2004-08-01,0,0,0,3,0,3
Bangladesh,2004-08-01,0,0,0,0,0,0
Bangladesh,2004-08-01,0,0,0,6,4,10
Bangladesh,2004-08-01,0,0,0,6,0,6
Bangladesh,2004-08-01,11,0,0,0,0,11
Bangladesh,2004-08-01,3,0,0,0,2,5
Bangladesh,2004-08-01,5,0,0,0,0,5
Bangladesh,2004-08-01,-2,0,0,0,0,-2
Bangladesh,2004-08-01,7,2,0,-4,1,6
Bangladesh,2004-08-01,0,6,0,0,1,7
Bangladesh,2004-09-01,3,0,0,0,0,3
Bangladesh,2004-09-01,8,0,0,0,0,8
Bangladesh,2004-09-01,-1,0,0,0,0,-1
Bangladesh,2004-09-01,0,0,0,3,0,3
Bangladesh,2004-09-01,9,2,0,-3,2,10
Bangladesh,2004-09-01,4,0,0,0,0,4
Bangladesh,2004-09-01,0,0,0,3,0,3
Bangladesh,2004-09-01,0,0,0,3,0,3
Bangladesh,2004-09-01,-2,0,0,3,6,7
Bangladesh,2004-09-01,0,0,0,0,0,0
Bangladesh,2004-09-01,0,0,0,2,1,3
Bangladesh,2004-09-01,0,0,0,-2,0,-2
Bangladesh,2004-09-01,2,0,0,0,0,2
Bangladesh,2004-09-01,0,0,0,0,3,3
Bangladesh,2004-09-01,1,0,0,-6,0,-5
Bangladesh,2004-09-01,4,0,0,6,0,10
Bangladesh,2004-09-01,1,0,0,0,1,2
Bangladesh,2004-09-01,0,0,0,0,0,0
Bangladesh,2004-09-01,0,0,0,9,0,9
Bangladesh,2004-09-01,1,0,0,0,0,1
Bangladesh,2004-09-01,4,0,0,6,0,10
Bangladesh,2004-09-01,4,0,0,3,0,7
Bangladesh,2004-09-01,4,0,0,0,0,4
Bangladesh,2004-09-01,0,0,0,0,0,0
Bangladesh,2004-09-01,14,0,0,15,2,31
Bangladesh,2004-10-01,0,0,0,0,0,0
Bangladesh,2004-10-01,6,0,0,0,0,6
Bangladesh,2004-10-01,33,0,0,0,6,39
Bangladesh,2004-10-01,33,0,0,0,6,39
Bangladesh,2004-10-01,3,0,0,4,0,7
Bangladesh,2004-10-01,6,0,0,-4,0,2
Bangladesh,2004-10-01,1,0,0,0,0,1
Bangladesh,2004-10-01,9,0,0,0,2,11
Bangladesh,2004-10-01,2,0,0,0,0,2
Bangladesh,2004-10-01,0,0,0,0,0,0
Bangladesh,2004-10-01,5,0,0,0,0,5
Bangladesh,2004-10-01,7,0,0,3,0,10
Bangladesh,2004-10-01,0,0,0,13,0,13
Bangladesh,2004-10-01,0,0,0,0,0,0
Bangladesh,2004-10-01,0,4,0,0,0,4
Bangladesh,2004-10-01,0,0,0,-4,0,-4
Bangladesh,2004-10-01,0,0,0,0,0,0
Bangladesh,2004-10-01,0,0,0,0,1,1
Bangladesh,2004-10-01,1,0,0,0,1,2
Bangladesh,2004-10-01,6,0,0,6,2,14
Bangladesh,2004-10-01,6,0,0,0,0,6
Bangladesh,2004-10-01,0,0,0,0,0,0
Bangladesh,2004-10-01,0,0,0,0,0,0
Bangladesh,2004-10-01,9,0,0,3,4,16
Bangladesh,2004-10-01,0,0,0,0,0,0
Bangladesh,2004-10-01,3,0,0,18,1,22
Bangladesh,2004-10-01,0,0,0,4,0,4
Bangladesh,2004-11-01,2,0,0,3,0,5
Bangladesh,2004-11-01,4,0,0,0,0,4
Bangladesh,2004-11-01,0,0,0,2,1,3
Bangladesh,2004-11-01,-1,0,0,-2,0,-3
Bangladesh,2004-11-01,3,0,0,3,0,6
Bangladesh,2004-11-01,3,0,0,-2,1,2
Bangladesh,2004-11-01,3,0,1,0,0,4
Bangladesh,2004-11-01,9,0,0,0,0,9
Bangladesh,2004-11-01,0,0,0,0,0,0
Bangladesh,2004-11-01,1,0,0,1,0,2
Bangladesh,2004-11-01,0,0,0,3,0,3
Bangladesh,2004-11-01,0,0,0,3,0,3
Bangladesh,2004-11-01,0,0,0,0,0,0
Bangladesh,2004-11-01,5,0,0,0,0,5
Bangladesh,2004-11-01,11,0,0,0,0,11
Bangladesh,2004-11-01,0,0,0,0,0,0
Bangladesh,2004-11-01,0,0,0,0,0,0
Bangladesh,2004-11-01,0,0,0,0,0,0
Bangladesh,2004-11-01,3,0,0,0,1,4
Bangladesh,2004-11-01,2,0,0,0,0,2
Bangladesh,2004-11-01,0,0,0,0,0,0
Bangladesh,2004-11-01,2,0,0,0,0,2
Bangladesh,2004-11-01,0,0,0,4,0,4
Bangladesh,2004-11-01,5,0,-4,0,0,1
Bangladesh,2004-11-01,2,0,0,0,0,2
Bangladesh,2004-11-01,1,0,0,0,0,1
Bangladesh,2004-12-01,0,0,0,0,0,0
Bangladesh,2004-12-01,0,0,0,3,0,3
Bangladesh,2004-12-01,12,0,0,0,0,12
Bangladesh,2004-12-01,0,0,1,0,0,1
Bangladesh,2004-12-01,1,0,0,6,0,7
Bangladesh,2004-12-01,0,0,0,6,0,6
Bangladesh,2004-12-01,0,0,0,9,0,9
Bangladesh,2004-12-01,4,0,0,-5,2,1
Bangladesh,2004-12-01,0,0,0,0,0,0
Bangladesh,2004-12-01,-3,0,0,4,0,1
Bangladesh,2004-12-01,2,0,0,0,0,2
Bangladesh,2004-12-01,0,0,0,9,0,9
Bangladesh,2004-12-01,3,0,0,0,0,3
Bangladesh,2004-12-01,4,0,0,0,0,4
Bangladesh,2004-12-01,0,0,0,3,0,3
Bangladesh,2004-12-01,0,0,0,7,0,7
Bangladesh,2004-12-01,0,0,0,3,0,3
Bangladesh,2004-12-01,2,0,0,6,0,8
Bangladesh,2004-12-01,5,0,0,0,0,5
Bangladesh,2004-12-01,9,0,-1,2,0,10
Bangladesh,2004-12-01,10,0,-1,0,0,9
Bangladesh,2004-12-01,4,0,0,0,0,4
Bangladesh,2004-12-01,30,0,0,0,0,30
Bangladesh,2004-12-01,26,0,0,1,0,27
Bangladesh,2004-12-01,23,0,0,0,1,24
Cameroon,2004-01-01,0,0,0,-2,0,-2
Cameroon,2004-01-01,0,0,0,0,0,0
Cameroon,2004-01-01,0,0,0,0,0,0
Cameroon,2004-01-01,2,0,0,0,0,2
Cameroon,2004-01-01,3,0,0,0,0,3
Cameroon,2004-01-01,0,0,0,-2,0,-2
Cameroon,2004-01-01,1,0,0,0,0,1
Cameroon,2004-01-01,0,0,0,0,0,0
Cameroon,2004-01-01,0,0,0,0,0,0
Cameroon,2004-01-01,0,0,0,3,0,3
Cameroon,2004-01-01,2,0,0,0,0,2
Cameroon,2004-01-01,1,0,0,0,0,1
Cameroon,2004-01-01,0,0,0,0,0,0
Cameroon,2004-01-01,3,0,0,0,0,3
Cameroon,2004-01-01,0,0,0,0,0,0
Cameroon,2004-01-01,0,0,0,0,0,0
Cameroon,2004-02-01,0,0,0,0,0,0
Cameroon,2004-02-01,0,0,0,0,0,0
Cameroon,2004-02-01,0,0,0,0,0,0
Cameroon,2004-02-01,0,0,0,0,0,0
Cameroon,2004-02-01,0,0,0,0,0,0
Cameroon,2004-02-01,0,0,0,3,0,3
Cameroon,2004-02-01,0,0,0,0,0,0
Cameroon,2004-02-01,2,0,0,0,0,2
Cameroon,2004-02-01,6,0,0,0,0,6
Cameroon,2004-02-01,0,0,0,0,0,0
Cameroon,2004-02-01,0,0,0,0,0,0
Cameroon,2004-02-01,0,0,0,0,0,0
Cameroon,2004-02-01,2,0,0,9,0,11
Cameroon,2004-02-01,1,0,0,0,0,1
Cameroon,2004-02-01,6,0,0,6,0,12
Cameroon,2004-02-01,-3,0,0,0,0,-3
Cameroon,2004-02-01,0,0,0,0,0,0
Cameroon,2004-02-01,0,0,0,0,0,0
Cameroon,2004-03-01,5,0,0,9,0,14
Cameroon,2004-03-01,1,0,0,0,0,1
Cameroon,2004-03-01,5,0,0,3,0,8
Cameroon,2004-03-01,0,0,0,0,0,0
Cameroon,2004-03-01,0,0,0,0,0,0
Cameroon,2004-03-01,2,0,0,0,0,2
Cameroon,2004-03-01,2,0,0,0,0,2
Cameroon,2004-03-01,8,0,0,0,0,8
Cameroon,2004-03-01,0,0,0,8,0,8
Cameroon,2004-03-01,0,0,0,-6,1,-5
Cameroon,2004-03-01,2,0,0,0,0,2
Cameroon,2004-03-01,2,0,0,0,2,4
Cameroon,2004-03-01,1,0,0,0,0,1
Cameroon,2004-03-01,1,0,0,0,0,1
Cameroon,2004-03-01,0,0,0,0,0,0
Cameroon,2004-03-01,1,0,0,0,0,1
Cameroon,2004-03-01,1,0,0,12,0,13
Cameroon,2004-03-01,2,0,0,0,0,2
Cameroon,2004-03-01,2,0,0,0,0,2
Cameroon,2004-03-01,1,0,0,0,0,1
Cameroon,2004-03-01,3,0,0,0,-2,1
Cameroon,2004-03-01,0,0,0,0,0,0
Cameroon,2004-03-01,0,0,0,0,0,0
Cameroon,2004-03-01,8,0,0,3,0,11
Cameroon,2004-03-01,4,0,0,0,0,4
Cameroon,2004-04-01,7,0,0,0,0,7
Cameroon,2004-04-01,0,0,0,0,0,0
Cameroon,2004-04-01,0,0,0,0,0,0
Cameroon,2004-04-01,6,0,0,0,0,6
Cameroon,2004-04-01,0,0,0,0,0,0
Cameroon,2004-04-01,0,0,0,0,0,0
Cameroon,2004-04-01,0,0,0,0,0,0
Cameroon,2004-04-01,0,0,0,6,1,7
Cameroon,2004-04-01,1,0,1,6,1,9
Cameroon,2004-04-01,0,0,0,0,0,0
Cameroon,2004-04-01,0,0,0,0,0,0
Cameroon,2004-04-01,0,0,0,0,0,0
Cameroon,2004-04-01,0,0,0,0,0,0
Cameroon,2004-04-01,8,0,0,0,0,8
Cameroon,2004-04-01,2,0,0,0,0,2
Cameroon,2004-04-01,0,0,0,0,0,0
Cameroon,2004-04-01,0,0,0,0,0,0
Cameroon,2004-04-01,0,0,0,0,0,0
Cameroon,2004-04-01,3,0,0,0,0,3
Cameroon,2004-05-01,3,0,0,0,0,3
Cameroon,2004-05-01,0,0,0,0,0,0
Cameroon,2004-05-01,0,0,0,2,0,2
Cameroon,2004-05-01,0,0,0,0,0,0
Cameroon,2004-05-01,0,0,0,3,0,3
Cameroon,2004-05-01,2,0,0,0,0,2
Cameroon,2004-05-01,0,0,0,0,0,0
Cameroon,2004-05-01,0,0,0,0,0,0
Cameroon,2004-05-01,0,0,0,0,0,0
Cameroon,2004-05-01,6,0,0,0,0,6
Cameroon,2004-05-01,0,0,0,0,0,0
Cameroon,2004-05-01,0,4,0,0,0,4
Cameroon,2004-05-01,3,0,0,0,0,3
Cameroon,2004-05-01,0,0,0,0,0,0
Cameroon,2004-05-01,0,2,0,0,0,2
Cameroon,2004-06-01,0,0,0,0,0,0
Cameroon,2004-06-01,0,0,0,3,0,3
Cameroon,2004-06-01,0,0,0,0,0,0
Cameroon,2004-06-01,6,0,0,0,0,6
Cameroon,2004-06-01,0,0,0,0,0,0
Cameroon,2004-06-01,2,0,0,0,0,2
Cameroon,2004-06-01,0,0,0,0,0,0
Cameroon,2004-06-01,0,0,0,3,0,3
Cameroon,2004-06-01,0,0,0,0,0,0
Cameroon,2004-06-01,0,0,0,0,0,0
Cameroon,2004-06-01,0,0,0,0,0,0
Cameroon,2004-06-01,0,0,0,0,0,0
Cameroon,2004-06-01,0,0,0,0,0,0
Cameroon,2004-06-01,5,0,0,0,0,5
Cameroon,2004-06-01,0,0,0,0,0,0
Cameroon,2004-06-01,0,0,0,0,0,0
Cameroon,2004-06-01,0,0,0,0,0,0
Cameroon,2004-06-01,0,0,0,0,0,0
Cameroon,2004-06-01,0,0,0,0,0,0
Cameroon,2004-06-01,1,0,0,0,0,1
Cameroon,2004-06-01,0,0,-3,0,0,-3
Cameroon,2004-07-01,0,0,0,6,0,6
Cameroon,2004-07-01,-1,0,0,0,0,-1
Cameroon,2004-07-01,0,0,0,0,0,0
Cameroon,2004-07-01,0,0,0,-2,0,-2
Cameroon,2004-07-01,0,0,0,0,0,0
Cameroon,2004-07-01,0,0,0,0,0,0
Cameroon,2004-07-01,3,0,0,0,0,3
Cameroon,2004-07-01,0,0,0,0,0,0
Cameroon,2004-07-01,0,0,0,0,0,0
Cameroon,2004-07-01,0,0,0,0,0,0
Cameroon,2004-08-01,0,0,0,0,0,0
Cameroon,2004-08-01,3,0,0,3,1,7
Cameroon,2004-08-01,2,0,0,0,0,2
Cameroon,2004-08-01,0,0,0,0,0,0
Cameroon,2004-08-01,0,0,0,0,0,0
Cameroon,2004-08-01,0,0,0,0,0,0
Cameroon,2004-08-01,0,0,0,0,0,0
Cameroon,2004-08-01,0,0,0,0,0,0
Cameroon,2004-08-01,0,0,0,0,0,0
Cameroon,2004-08-01,3,0,0,0,0,3
Cameroon,2004-08-01,3,0,0,0,0,3
Cameroon,2004-08-01,2,0,0,0,0,2
Cameroon,2004-08-01,0,0,0,3,0,3
Cameroon,2004-08-01,0,0,0,0,0,0
Cameroon,2004-08-01,2,0,0,3,0,5
Cameroon,2004-09-01,0,0,0,0,0,0
Cameroon,2004-09-01,0,0,0,0,0,0
Cameroon,2004-09-01,0,0,0,0,0,0
Cameroon,2004-09-01,2,0,0,0,0,2
Cameroon,2004-09-01,9,0,0,0,0,9
Cameroon,2004-09-01,1,0,0,0,0,1
Cameroon,2004-09-01,7,0,0,0,0,7
Cameroon,2004-09-01,2,0,1,0,0,3
Cameroon,2004-09-01,5,0,0,0,0,5
Cameroon,2004-09-01,-2,0,0,0,0,-2
Cameroon,2004-09-01,3,0,0,0,1,4
Cameroon,2004-09-01,2,0,0,0,0,2
Cameroon,2004-09-01,0,0,0,0,0,0
Cameroon,2004-09-01,0,0,0,9,0,9
Cameroon,2004-09-01,0,0,0,0,0,0
Cameroon,2004-09-01,0,0,0,3,0,3
Cameroon,2004-09-01,0,0,0,0,0,0
Cameroon,2004-09-01,2,0,0,0,0,2
Cameroon,2004-09-01,6,0,0,9,0,15
Cameroon,2004-09-01,-1,0,0,4,0,3
Cameroon,2004-09-01,24,0,0,15,4,43
Cameroon,2004-09-01,0,0,-6,0,0,-6
Cameroon,2004-09-01,2,0,0,3,0,5
Cameroon,2004-09-01,0,0,0,6,0,6
Cameroon,2004-09-01,4,0,0,9,0,13
Cameroon,2004-09-01,0,0,0,0,2,2
Cameroon,2004-10-01,0,0,0,0,0,0
Cameroon,2004-10-01,2,0,0,0,0,2
Cameroon,2004-10-01,0,0,0,0,0,0
Cameroon,2004-10-01,0,0,0,0,4,4
Cameroon,2004-10-01,0,0,0,0,0,0
Cameroon,2004-10-01,0,0,0,0,0,0
Cameroon,2004-10-01,-3,0,-1,3,0,-1
Cameroon,2004-10-01,0,0,-2,0,0,-2
Cameroon,2004-10-01,0,0,0,3,0,3
Cameroon,2004-10-01,2,0,0,3,1,6
Cameroon,2004-10-01,0,0,-1,0,0,-1
Cameroon,2004-10-01,0,0,0,0,1,1
Cameroon,2004-10-01,1,0,0,0,0,1
Cameroon,2004-10-01,1,0,0,0,0,1
Cameroon,2004-10-01,2,0,0,-2,0,0
Cameroon,2004-10-01,0,0,0,0,0,0
Cameroon,2004-10-01,1,0,0,0,0,1
Cameroon,2004-10-01,2,0,0,3,0,5
Cameroon,2004-10-01,0,0,0,0,0,0
Cameroon,2004-10-01,4,0,0,0,1,5
Cameroon,2004-10-01,0,0,0,0,0,0
Cameroon,2004-10-01,0,0,0,0,0,0
Cameroon,2004-10-01,1,0,0,0,0,1
Cameroon,2004-10-01,3,0,2,0,0,5
Cameroon,2004-11-01,0,0,0,0,0,0
Cameroon,2004-11-01,0,0,0,0,0,0
Cameroon,2004-11-01,1,0,0,0,0,1
Cameroon,2004-11-01,0,0,0,6,0,6
Cameroon,2004-11-01,0,0,0,0,0,0
Cameroon,2004-11-01,0,0,0,0,0,0
Cameroon,2004-11-01,3,0,0,0,0,3
Cameroon,2004-11-01,1,0,0,0,0,1
Cameroon,2004-11-01,0,0,0,0,0,0
Cameroon,2004-11-01,4,0,0,0,0,4
Cameroon,2004-11-01,0,0,0,0,0,0
Cameroon,2004-11-01,0,0,0,0,0,0
Cameroon,2004-11-01,2,0,0,0,0,2
Cameroon,2004-11-01,4,0,0,0,0,4
Cameroon,2004-12-01,5,0,0,3,0,8
Cameroon,2004-12-01,3,0,0,0,0,3
Cameroon,2004-12-01,0,0,0,0,0,0
Cameroon,2004-12-01,0,0,0,0,2,2
Cameroon,2004-12-01,0,0,0,0,0,0
Cameroon,2004-12-01,0,0,0,0,0,0
Cameroon,2004-12-01,0,0,0,0,0,0
Cameroon,2004-12-01,2,0,0,0,0,2
Cameroon,2004-12-01,7,0,0,0,0,7
Cameroon,2004-12-01,-1,0,0,0,0,-1
Cameroon,2004-12-01,0,0,0,3,2,5
Cameroon,2004-12-01,0,0,0,0,0,0
Cameroon,2004-12-01,0,0,0,0,0,0
Cameroon,2004-12-01,1,0,0,0,0,1
Cameroon,2004-12-01,2,0,0,0,0,2
Cameroon,2004-12-01,2,0,0,0,0,2
Cameroon,2004-12-01,2,0,0,0,0,2
China,2004-01-01,2,0,0,0,3,5
China,2004-01-01,13,0,0,3,3,19
China,2004-01-01,6,0,0,0,0,6
China,2004-01-01,5,0,0,0,1,6
China,2004-01-01,14,0,0,4,0,18
China,2004-01-01,15,0,0,4,0,19
China,2004-01-01,21,0,0,8,2,31
China,2004-01-01,26,0,0,13,6,45
China,2004-01-01,19,0,1,6,1,27
China,2004-01-01,11,0,0,6,2,19
China,2004-01-01,8,0,0,-4,0,4
China,2004-01-01,9,0,0,10,0,19
China,2004-01-01,18,0,0,1,0,19
China,2004-01-01,27,0,0,-4,3,26
China,2004-01-01,18,0,4,15,1,38
China,2004-01-01,14,2,0,6,1,23
China,2004-01-01,4,0,0,0,2,6
China,2004-01-01,-1,0,-3,3,0,-1
China,2004-01-01,6,0,0,8,6,20
China,2004-01-01,20,0,0,-1,5,24
China,2004-01-01,2,0,0,15,0,17
China,2004-01-01,4,0,0,15,2,21
China,2004-01-01,7,0,-1,-10,2,-2
China,2004-01-01,5,0,0,19,0,24
China,2004-01-01,11,0,1,0,0,12
China,2004-01-01,7,0,0,25,2,34
China,2004-01-01,32,0,0,9,1,42
China,2004-01-01,21,0,0,4,3,28
China,2004-01-01,2,0,0,3,2,7
China,2004-01-01,45,0,0,0,1,46
China,2004-01-01,2,0,0,0,0,2
China,2004-02-01,1,0,0,4,1,6
China,2004-02-01,17,0,0,9,2,28
China,2004-02-01,12,0,0,3,2,17
China,2004-02-01,6,0,0,3,2,11
China,2004-02-01,11,0,0,3,0,14
China,2004-02-01,25,0,0,13,3,41
China,2004-02-01,22,0,1,9,0,32
China,2004-02-01,4,0,0,-2,0,2
China,2004-02-01,12,0,0,16,0,28
China,2004-02-01,59,0,0,-3,1,57
China,2004-02-01,5,0,0,10,0,15
China,2004-02-01,33,0,-1,10,10,52
China,2004-02-01,14,0,0,3,1,18
China,2004-02-01,0,0,0,9,0,9
China,2004-02-01,5,0,2,0,0,7
China,2004-02-01,12,0,0,6,0,18
China,2004-02-01,9,0,0,4,0,13
China,2004-02-01,3,0,0,18,1,22
China,2004-02-01,0,0,0,0,0,0
China,2004-02-01,12,0,0,-2,2,12
China,2004-02-01,2,0,-1,3,0,4
China,2004-02-01,12,2,0,0,0,14
China,2004-02-01,2,0,0,3,3,8
China,2004-02-01,4,0,0,6,1,11
China,2004-02-01,1,0,0,3,0,4
China,2004-02-01,4,0,1,18,0,23
China,2004-02-01,6,0,0,9,0,15
China,2004-02-01,5,0,0,0,0,5
China,2004-02-01,3,0,0,3,2,8
China,2004-03-01,25,0,0,6,1,32
China,2004-03-01,20,0,1,21,0,42
China,2004-03-01,29,0,1,13,2,45
China,2004-03-01,7,0,0,20,2,29
China,2004-03-01,25,0,0,0,3,28
China,2004-03-01,3,0,1,0,0,4
China,2004-03-01,17,0,0,0,0,17
China,2004-03-01,7,0,0,0,2,9
China,2004-03-01,8,0,-1,21,2,30
China,2004-03-01,26,0,0,3,2,31
China,2004-03-01,3,0,0,6,8,17
China,2004-03-01,12,0,0,3,1,16
China,2004-03-01,4,0,0,3,1,8
China,2004-03-01,12,0,0,5,1,18
China,2004-03-01,38,0,-3,16,2,53
China,2004-03-01,18,0,0,8,9,35
China,2004-03-01,13,0,0,3,1,17
China,2004-03-01,13,0,0,11,2,26
China,2004-03-01,11,0,-3,7,0,15
China,2004-03-01,28,0,0,16,10,54
China,2004-03-01,14,0,0,9,8,31
China,2004-03-01,13,0,0,16,0,29
China,2004-03-01,4,0,0,22,4,30
China,2004-03-01,32,0,1,12,0,45
China,2004-03-01,16,0,-1,37,4,56
China,2004-03-01,15,0,-1,25,0,39
China,2004-03-01,11,0,0,6,0,17
China,2004-03-01,21,0,0,13,0,34
China,2004-03-01,6,0,1,6,0,13
China,2004-03-01,-1,0,0,8,0,7
China,2004-03-01,19,0,0,0,2,21
China,2004-04-01,44,0,1,9,6,60
China,2004-04-01,6,0,0,-1,8,13
China,2004-04-01,5,0,0,4,1,10
China,2004-04-01,8,0,0,12,5,25
China,2004-04-01,9,0,0,9,4,22
China,2004-04-01,19,0,1,-1,2,21
China,2004-04-01,31,0,0,4,3,38
China,2004-04-01,6,0,-12,12,2,8
China,2004-04-01,3,0,-2,24,0,25
China,2004-04-01,10,0,0,3,1,14
China,2004-04-01,5,0,2,9,0,16
China,2004-04-01,10,0,2,7,3,22
China,2004-04-01,20,4,0,-3,3,24
China,2004-04-01,11,0,0,3,1,15
China,2004-04-01,0,0,0,4,0,4
China,2004-04-01,7,0,0,1,1,9
China,2004-04-01,9,0,0,0,1,10
China,2004-04-01,12,0,0,3,2,17
China,2004-04-01,12,0,0,1,1,14
China,2004-04-01,25,0,0,3,0,28
China,2004-04-01,24,0,0,6,-2,28
China,2004-04-01,22,0,0,3,0,25
China,2004-04-01,35,0,-1,3,11,48
China,2004-04-01,27,0,1,12,10,50
China,2004-04-01,5,0,1,0,0,6
China,2004-04-01,20,0,1,4,4,29
China,2004-04-01,9,2,0,-6,9,14
China,2004-04-01,16,2,0,3,1,22
China,2004-04-01,6,0,0,0,0,6
China,2004-04-01,14,0,0,8,3,25
China,2004-05-01,5,0,0,0,2,7
China,2004-05-01,2,0,-2,0,0,0
China,2004-05-01,26,0,0,12,5,43
China,2004-05-01,2,0,0,13,12,27
China,2004-05-01,23,0,0,27,5,55
China,2004-05-01,3,4,0,16,1,24
China,2004-05-01,9,0,0,0,8,17
China,2004-05-01,10,0,-4,0,0,6
China,2004-05-01,8,0,0,15,2,25
China,2004-05-01,15,0,1,20,3,39
China,2004-05-01,21,0,0,9,0,30
China,2004-05-01,27,0,1,2,0,30
China,2004-05-01,23,0,-2,2,2,25
China,2004-05-01,8,0,-2,7,0,13
China,2004-05-01,8,0,0,0,1,9
China,2004-05-01,2,2,0,0,1,5
China,2004-05-01,7,0,0,-2,2,7
China,2004-05-01,21,0,0,1,1,23
China,2004-05-01,25,0,-6,3,4,26
China,2004-05-01,27,0,-1,20,10,56
China,2004-05-01,13,0,0,9,2,24
China,2004-05-01,8,0,0,-2,1,7
China,2004-05-01,8,0,0,6,5,19
China,2004-05-01,8,0,2,6,3,19
China,2004-05-01,10,0,0,6,2,18
China,2004-05-01,16,0,-5,-2,3,12
China,2004-05-01,23,0,0,7,2,32
China,2004-05-01,6,0,-2,6,0,10
China,2004-05-01,4,2,-1,2,0,7
China,2004-05-01,12,0,0,-2,0,10
China,2004-05-01,7,2,0,-2,2,9
China,2004-06-01,8,2,0,3,2,15
China,2004-06-01,15,0,0,5,1,21
China,2004-06-01,30,0,0,6,6,42
China,2004-06-01,14,0,1,15,0,30
China,2004-06-01,19,0,0,6,0,25
China,2004-06-01,13,0,0,4,1,18
China,2004-06-01,-1,0,3,7,2,11
China,2004-06-01,18,0,1,42,6,67
China,2004-06-01,26,0,0,24,1,51
China,2004-06-01,99,0,-1,18,5,121
China,2004-06-01,94,0,1,28,2,125
China,2004-06-01,56,0,0,7,6,69
China,2004-06-01,15,0,0,15,2,32
China,2004-06-01,29,0,0,4,4,37
China,2004-06-01,4,0,0,6,0,10
China,2004-06-01,66,0,-5,0,6,67
China,2004-06-01,14,0,0,6,4,24
China,2004-06-01,16,2,0,3,2,23
China,2004-06-01,26,0,0,6,4,36
China,2004-06-01,28,0,-2,3,4,33
China,2004-06-01,14,0,-4,-1,1,10
China,2004-06-01,55,0,-4,-20,8,39
China,2004-06-01,49,4,0,6,0,59
China,2004-06-01,38,0,0,6,8,52
China,2004-06-01,40,0,1,13,0,54
China,2004-06-01,11,0,0,0,0,11
China,2004-06-01,5,0,0,6,0,11
China,2004-06-01,7,0,0,-1,0,6
China,2004-06-01,12,0,0,-4,1,9
China,2004-06-01,20,0,0,2,2,24
China,2004-07-01,0,0,0,3,5,8
China,2004-07-01,19,0,0,3,2,24
China,2004-07-01,1,0,0,3,0,4
China,2004-07-01,0,0,0,3,0,3
China,2004-07-01,15,0,0,0,2,17
China,2004-07-01,4,0,0,3,3,10
China,2004-07-01,4,0,0,6,0,10
China,2004-07-01,8,0,0,9,5,22
China,2004-07-01,2,0,2,-4,2,2
China,2004-07-01,15,0,0,0,0,15
China,2004-07-01,2,0,0,0,0,2
China,2004-07-01,4,0,0,0,0,4
China,2004-07-01,10,6,0,6,0,22
China,2004-07-01,-5,0,0,3,0,-2
China,2004-07-01,4,0,0,10,0,14
China,2004-07-01,4,0,-5,-1,0,-2
China,2004-07-01,7,0,0,3,0,10
China,2004-07-01,5,0,0,12,4,21
China,2004-07-01,0,0,0,0,0,0
China,2004-07-01,3,0,0,-10,0,-7
China,2004-07-01,5,0,0,0,0,5
China,2004-07-01,-1,0,0,1,0,0
China,2004-07-01,-3,0,0,3,2,2
China,2004-07-01,0,0,0,6,0,6
China,2004-07-01,3,0,0,0,2,5
China,2004-07-01,24,0,0,0,0,24
China,2004-07-01,17,0,0,3,2,22
China,2004-07-01,18,0,0,3,0,21
China,2004-07-01,14,0,0,4,1,19
China,2004-07-01,6,0,0,-2,0,4
China,2004-07-01,4,0,0,2,12,18
China,2004-08-01,14,0,0,0,3,17
China,2004-08-01,1,0,0,0,0,1
China,2004-08-01,5,4,0,15,0,24
China,2004-08-01,10,0,0,-4,0,6
China,2004-08-01,3,0,0,2,1,6
China,2004-08-01,44,0,0,0,2,46
China,2004-08-01,-1,0,2,6,5,12
China,2004-08-01,0,0,0,8,6,14
China,2004-08-01,3,0,0,9,0,12
China,2004-08-01,25,0,0,3,0,28
China,2004-08-01,7,0,0,9,0,16
China,2004-08-01,4,0,-1,3,0,6
China,2004-08-01,4,0,0,-6,3,1
China,2004-08-01,8,0,0,0,2,10
China,2004-08-01,3,0,0,6,1,10
China,2004-08-01,36,0,0,6,2,44
China,2004-08-01,18,0,0,0,0,18
China,2004-08-01,23,0,0,3,0,26
China,2004-08-01,14,0,0,3,0,17
China,2004-08-01,28,0,0,3,2,33
China,2004-08-01,13,0,0,3,0,16
China,2004-08-01,12,0,0,9,0,21
China,2004-08-01,9,0,0,6,0,15
China,2004-08-01,19,0,0,6,4,29
China,2004-08-01,-1,0,0,9,2,10
China,2004-08-01,13,0,0,0,0,13
China,2004-08-01,4,0,0,6,12,22
China,2004-08-01,27,0,0,0,12,39
China,2004-08-01,6,0,0,6,0,12
China,2004-08-01,8,0,0,0,0,8
China,2004-08-01,7,0,0,3,0,10
China,2004-09-01,2,0,1,-2,3,4
China,2004-09-01,3,0,0,12,2,17
China,2004-09-01,7,0,0,1,0,8
China,2004-09-01,4,0,0,-2,0,2
China,2004-09-01,4,0,0,2,0,6
China,2004-09-01,2,0,0,6,0,8
China,2004-09-01,-3,0,0,3,0,0
China,2004-09-01,4,0,0,3,2,9
China,2004-09-01,35,0,0,6,6,47
China,2004-09-01,20,0,0,9,0,29
China,2004-09-01,20,0,0,0,0,20
China,2004-09-01,0,0,0,6,0,6
China,2004-09-01,17,0,1,0,15,33
China,2004-09-01,6,0,0,8,1,15
China,2004-09-01,60,0,0,3,0,63
China,2004-09-01,4,0,1,3,0,8
China,2004-09-01,7,0,-4,6,0,9
China,2004-09-01,7,0,0,6,3,16
China,2004-09-01,3,0,0,0,0,3
China,2004-09-01,6,0,2,3,0,11
China,2004-09-01,5,0,0,-3,0,2
China,2004-09-01,9,0,0,4,0,13
China,2004-09-01,10,0,3,-5,4,12
China,2004-09-01,4,0,2,12,1,19
China,2004-09-01,2,0,0,0,0,2
China,2004-09-01,8,0,0,0,2,10
China,2004-09-01,3,0,-1,0,2,4
China,2004-09-01,7,0,0,12,1,20
China,2004-09-01,3,0,0,1,0,4
China,2004-09-01,9,0,0,3,1,13
China,2004-10-01,13,0,0,-11,0,2
China,2004-10-01,6,0,0,-2,0,4
China,2004-10-01,10,0,0,0,0,10
China,2004-10-01,10,0,0,3,0,13
China,2004-10-01,17,2,0,0,1,20
China,2004-10-01,-1,0,0,6,1,6
China,2004-10-01,9,0,0,0,0,9
China,2004-10-01,14,0,0,0,1,15
China,2004-10-01,21,0,0,9,2,32
China,2004-10-01,5,0,0,9,3,17
China,2004-10-01,22,0,0,18,1,41
China,2004-10-01,12,0,0,-1,0,11
China,2004-10-01,24,0,1,-1,0,24
China,2004-10-01,42,0,0,20,3,65
China,2004-10-01,6,0,0,3,0,9
China,2004-10-01,10,0,0,6,9,25
China,2004-10-01,3,0,0,-2,0,1
China,2004-10-01,40,0,0,1,0,41
China,2004-10-01,6,0,0,15,0,21
China,2004-10-01,19,2,0,-1,7,27
China,2004-10-01,24,0,0,10,2,36
China,2004-10-01,20,0,-2,-6,0,12
China,2004-10-01,23,0,0,6,0,29
China,2004-10-01,12,0,0,5,2,19
China,2004-10-01,4,0,0,0,0,4
China,2004-10-01,14,0,0,0,1,15
China,2004-10-01,11,0,0,3,4,18
China,2004-10-01,6,0,0,8,1,15
China,2004-10-01,11,0,0,4,0,15
China,2004-10-01,6,0,0,6,0,12
China,2004-10-01,10,0,0,0,0,10
China,2004-11-01,4,0,0,6,0,10
China,2004-11-01,10,0,0,0,1,11
China,2004-11-01,5,0,0,-4,0,1
China,2004-11-01,9,0,0,3,2,14
China,2004-11-01,12,0,0,21,2,35
China,2004-11-01,7,0,1,6,0,14
China,2004-11-01,12,6,-1,1,0,18
China,2004-11-01,21,0,0,0,0,21
China,2004-11-01,22,0,0,15,7,44
China,2004-11-01,11,0,0,9,2,22
China,2004-11-01,4,0,0,7,1,12
China,2004-11-01,38,0,0,1,3,42
China,2004-11-01,22,0,0,3,0,25
China,2004-11-01,3,0,0,6,3,12
China,2004-11-01,10,0,-4,-1,0,5
China,2004-11-01,1,0,0,3,4,8
China,2004-11-01,23,0,0,1,4,28
China,2004-11-01,5,0,0,21,0,26
China,2004-11-01,30,0,0,42,5,77
China,2004-11-01,12,0,0,3,2,17
China,2004-11-01,15,0,0,7,0,22
China,2004-11-01,2,0,0,25,0,27
China,2004-11-01,36,0,0,7,4,47
China,2004-11-01,2,0,0,39,0,41
China,2004-11-01,5,0,0,3,0,8
China,2004-11-01,16,0,0,0,1,17
China,2004-11-01,5,0,0,-6,2,1
China,2004-11-01,10,0,0,0,0,10
China,2004-11-01,-4,0,0,0,6,2
China,2004-11-01,23,0,0,6,2,31
China,2004-12-01,11,0,0,8,4,23
China,2004-12-01,8,0,1,1,2,12
China,2004-12-01,5,0,0,12,0,17
China,2004-12-01,4,0,1,12,0,17
China,2004-12-01,11,0,1,0,0,12
China,2004-12-01,4,0,0,3,0,7
China,2004-12-01,12,2,0,9,0,23
China,2004-12-01,13,0,0,15,1,29
China,2004-12-01,25,0,-2,18,0,41
China,2004-12-01,1,0,0,3,5,9
China,2004-12-01,11,0,-1,4,4,18
China,2004-12-01,4,0,0,0,1,5
China,2004-12-01,0,0,0,7,0,7
China,2004-12-01,2,0,1,-2,0,1
China,2004-12-01,8,0,0,0,0,8
China,2004-12-01,10,0,0,1,5,16
China,2004-12-01,6,0,0,32,0,38
China,2004-12-01,9,0,0,1,0,10
China,2004-12-01,6,0,0,-1,4,9
China,2004-12-01,12,0,-4,0,3,11
China,2004-12-01,9,0,0,-2,2,9
China,2004-12-01,-7,0,0,0,2,-5
China,2004-12-01,2,0,0,0,0,2
China,2004-12-01,10,0,0,6,0,16
China,2004-12-01,3,0,0,0,1,4
China,2004-12-01,9,0,1,0,0,10
China,2004-12-01,15,0,0,3,0,18
China,2004-12-01,9,0,0,18,0,27
China,2004-12-01,10,0,0,9,0,19
China,2004-12-01,22,2,0,9,0,33
China,2004-12-01,10,0,0,4,0,14
Egypt,2004-01-01,-3,0,-1,7,0,3
Egypt,2004-01-01,3,0,0,0,4,7
Egypt,2004-01-01,10,0,0,0,0,10
Egypt,2004-01-01,14,0,0,3,0,17
Egypt,2004-01-01,1,0,0,3,0,4
Egypt,2004-01-01,16,0,0,-2,0,14
Egypt,2004-01-01,6,0,0,6,0,12
Egypt,2004-01-01,12,0,0,2,0,14
Egypt,2004-01-01,0,0,0,7,0,7
Egypt,2004-01-01,3,0,0,1,1,5
Egypt,2004-01-01,12,0,0,-2,0,10
Egypt,2004-01-01,-8,0,0,0,0,-8
Egypt,2004-01-01,18,0,0,16,0,34
Egypt,2004-01-01,3,0,0,9,0,12
Egypt,2004-01-01,6,0,0,7,0,13
Egypt,2004-01-01,0,0,0,9,0,9
Egypt,2004-01-01,7,0,0,0,0,7
Egypt,2004-01-01,6,0,0,3,0,9
Egypt,2004-01-01,0,0,0,3,0,3
Egypt,2004-01-01,3,0,0,0,0,3
Egypt,2004-01-01,58,0,0,9,2,69
Egypt,2004-01-01,16,0,0,4,0,20
Egypt,2004-01-01,1,0,0,0,0,1
Egypt,2004-01-01,20,0,0,3,2,25
Egypt,2004-01-01,8,0,0,0,0,8
Egypt,2004-01-01,4,0,0,6,4,14
Egypt,2004-01-01,13,0,0,12,0,25
Egypt,2004-01-01,29,0,0,1,1,31
Egypt,2004-01-01,-3,0,0,3,0,0
Egypt,2004-01-01,9,0,0,6,0,15
Egypt,2004-01-01,15,0,0,2,0,17
Egypt,2004-02-01,9,0,0,6,3,18
Egypt,2004-02-01,9,0,0,3,0,12
Egypt,2004-02-01,-1,0,0,0,0,-1
Egypt,2004-02-01,2,0,0,0,2,4
Egypt,2004-02-01,7,0,0,1,1,9
Egypt,2004-02-01,26,0,0,3,0,29
Egypt,2004-02-01,14,0,0,0,0,14
Egypt,2004-02-01,5,0,0,0,0,5
Egypt,2004-02-01,8,0,0,18,0,26
Egypt,2004-02-01,13,0,0,0,0,13
Egypt,2004-02-01,45,0,-1,0,4,48
Egypt,2004-02-01,28,0,0,6,3,37
Egypt,2004-02-01,3,0,0,-1,0,2
Egypt,2004-02-01,10,0,0,3,4,17
Egypt,2004-02-01,5,0,0,0,0,5
Egypt,2004-02-01,-1,0,0,0,0,-1
Egypt,2004-02-01,3,0,-1,0,0,2
Egypt,2004-02-01,16,0,0,0,0,16
Egypt,2004-02-01,0,0,0,-2,0,-2
Egypt,2004-02-01,12,0,0,9,2,23
Egypt,2004-02-01,-2,0,0,0,0,-2
Egypt,2004-02-01,7,0,0,9,1,17
Egypt,2004-02-01,0,0,0,9,1,10
Egypt,2004-02-01,4,0,0,4,1,9
Egypt,2004-02-01,7,0,0,3,0,10
Egypt,2004-02-01,5,0,0,36,2,43
Egypt,2004-02-01,14,0,-1,3,0,16
Egypt,2004-02-01,2,0,0,3,0,5
Egypt,2004-02-01,8,0,0,1,0,9
Egypt,2004-03-01,12,0,0,21,0,33
Egypt,2004-03-01,6,0,0,0,0,6
Egypt,2004-03-01,1,0,0,0,3,4
Egypt,2004-03-01,22,0,0,18,2,42
Egypt,2004-03-01,14,0,0,9,0,23
Egypt,2004-03-01,0,0,0,6,0,6
Egypt,2004-03-01,12,0,0,0,3,15
Egypt,2004-03-01,7,0,0,0,0,7
Egypt,2004-03-01,1,0,-1,-2,0,-2
Egypt,2004-03-01,13,0,0,3,0,16
Egypt,2004-03-01,6,2,0,6,2,16
Egypt,2004-03-01,5,0,0,12,2,19
Egypt,2004-03-01,-3,0,-1,-2,1,-5
Egypt,2004-03-01,6,0,0,6,0,12
Egypt,2004-03-01,14,0,0,6,0,20
Egypt,2004-03-01,5,0,-2,12,0,15
Egypt,2004-03-01,51,0,0,15,3,69
Egypt,2004-03-01,33,0,0,3,4,40
Egypt,2004-03-01,16,0,0,0,0,16
Egypt,2004-03-01,1,0,0,3,0,4
Egypt,2004-03-01,1,0,0,3,0,4
Egypt,2004-03-01,-23,0,0,9,0,-14
Egypt,2004-03-01,-13,0,0,6,3,-4
Egypt,2004-03-01,22,0,0,12,1,35
Egypt,2004-03-01,-2,0,0,13,0,11
Egypt,2004-03-01,3,0,0,0,0,3
Egypt,2004-03-01,0,0,0,-2,0,-2
Egypt,2004-03-01,3,0,0,12,0,15
Egypt,2004-03-01,2,0,0,9,0,11
Egypt,2004-03-01,13,0,0,6,7,26
Egypt,2004-03-01,1,0,0,1,0,2
Egypt,2004-04-01,13,0,0,6,0,19
Egypt,2004-04-01,7,0,0,-2,0,5
Egypt,2004-04-01,2,0,0,3,0,5
Egypt,2004-04-01,11,0,0,0,0,11
Egypt,2004-04-01,9,0,0,-1,0,8
Egypt,2004-04-01,0,0,0,0,2,2
Egypt,2004-04-01,7,0,0,6,0,13
Egypt,2004-04-01,-1,0,0,0,3,2
Egypt,2004-04-01,9,0,0,0,0,9
Egypt,2004-04-01,2,0,0,0,0,2
Egypt,2004-04-01,3,0,0,0,0,3
Egypt,2004-04-01,-11,0,0,3,0,-8
Egypt,2004-04-01,10,0,0,3,0,13
Egypt,2004-04-01,-1,0,0,3,0,2
Egypt,2004-04-01,15,0,0,6,1,22
Egypt,2004-04-01,18,0,0,-6,0,12
Egypt,2004-04-01,6,0,-2,9,0,13
Egypt,2004-04-01,-6,0,0,0,1,-5
Egypt,2004-04-01,-21,0,0,4,0,-17
Egypt,2004-04-01,42,0,0,0,0,42
Egypt,2004-04-01,11,0,0,9,2,22
Egypt,2004-04-01,16,0,0,6,0,22
Egypt,2004-04-01,4,0,0,3,2,9
Egypt,2004-04-01,0,0,0,0,0,0
Egypt,2004-04-01,3,0,0,0,0,3
Egypt,2004-04-01,2,0,0,-2,0,0
Egypt,2004-04-01,22,0,0,0,0,22
Egypt,2004-04-01,12,0,0,-2,0,10
Egypt,2004-04-01,2,0,1,0,0,3
Egypt,2004-04-01,4,0,0,0,0,4
Egypt,2004-05-01,2,0,0,-3,3,2
Egypt,2004-05-01,2,0,0,0,0,2
Egypt,2004-05-01,3,0,0,0,0,3
Egypt,2004-05-01,21,0,0,12,3,36
Egypt,2004-05-01,21,0,0,10,1,32
Egypt,2004-05-01,6,0,2,-4,1,5
Egypt,2004-05-01,0,0,0,3,2,5
Egypt,2004-05-01,8,0,0,4,1,13
Egypt,2004-05-01,23,0,0,3,0,26
Egypt,2004-05-01,9,0,0,0,0,9
Egypt,2004-05-01,3,0,0,9,0,12
Egypt,2004-05-01,10,0,0,-8,2,4
Egypt,2004-05-01,24,0,0,-6,8,26
Egypt,2004-05-01,26,0,0,-2,2,26
Egypt,2004-05-01,-5,0,0,0,2,-3
Egypt,2004-05-01,24,0,-1,3,3,29
Egypt,2004-05-01,39,0,4,2,4,49
Egypt,2004-05-01,34,0,-2,6,8,46
Egypt,2004-05-01,27,0,1,10,6,44
Egypt,2004-05-01,13,0,2,10,3,28
Egypt,2004-05-01,-1,0,0,9,5,13
Egypt,2004-05-01,0,0,1,0,0,1
Egypt,2004-05-01,11,0,0,0,4,15
Egypt,2004-05-01,11,0,0,0,9,20
Egypt,2004-05-01,9,0,0,3,2,14
Egypt,2004-05-01,7,0,0,-2,1,6
Egypt,2004-05-01,3,0,0,18,1,22
Egypt,2004-05-01,25,0,0,6,0,31
Egypt,2004-05-01,16,0,0,6,0,22
Egypt,2004-05-01,20,0,0,6,0,26
Egypt,2004-05-01,-1,0,0,17,5,21
Egypt,2004-06-01,19,0,0,1,3,23
Egypt,2004-06-01,19,0,0,4,3,26
Egypt,2004-06-01,17,0,0,23,4,44
Egypt,2004-06-01,6,0,0,0,2,8
Egypt,2004-06-01,-4,0,0,0,1,-3
Egypt,2004-06-01,34,0,2,18,4,58
Egypt,2004-06-01,-1,0,0,3,0,2
Egypt,2004-06-01,33,0,0,33,2,68
Egypt,2004-06-01,27,0,0,45,0,72
Egypt,2004-06-01,-4,0,0,31,0,27
Egypt,2004-06-01,15,0,0,29,2,46
Egypt,2004-06-01,5,0,0,18,6,29
Egypt,2004-06-01,7,2,-2,-1,0,6
Egypt,2004-06-01,37,0,2,19,0,58
Egypt,2004-06-01,15,0,0,15,3,33
Egypt,2004-06-01,17,0,0,6,2,25
Egypt,2004-06-01,34,0,1,30,0,65
Egypt,2004-06-01,12,0,0,13,2,27
Egypt,2004-06-01,1,0,0,-6,0,-5
Egypt,2004-06-01,2,0,0,4,0,6
Egypt,2004-06-01,27,0,0,0,2,29
Egypt,2004-06-01,19,0,0,6,5,30
Egypt,2004-06-01,-19,2,1,0,0,-16
Egypt,2004-06-01,-5,0,0,3,2,0
Egypt,2004-06-01,19,0,0,0,3,22
Egypt,2004-06-01,3,0,0,12,-2,13
Egypt,2004-06-01,10,0,0,0,0,10
Egypt,2004-06-01,4,0,2,1,0,7
Egypt,2004-06-01,13,0,0,-1,0,12
Egypt,2004-06-01,9,0,0,0,1,10
Egypt,2004-07-01,3,0,0,0,3,6
Egypt,2004-07-01,-1,0,1,9,2,11
Egypt,2004-07-01,13,0,0,0,0,13
Egypt,2004-07-01,27,0,0,0,0,27
Egypt,2004-07-01,8,2,0,3,1,14
Egypt,2004-07-01,6,0,-1,-4,0,1
Egypt,2004-07-01,11,0,0,30,0,41
Egypt,2004-07-01,17,0,0,9,0,26
Egypt,2004-07-01,9,0,-2,15,1,23
Egypt,2004-07-01,18,0,-4,7,0,21
Egypt,2004-07-01,-1,0,0,0,0,-1
Egypt,2004-07-01,3,0,0,12,1,16
Egypt,2004-07-01,-4,2,-1,-6,1,-8
Egypt,2004-07-01,0,0,0,12,0,12
Egypt,2004-07-01,21,0,0,6,0,27
Egypt,2004-07-01,9,0,0,8,1,18
Egypt,2004-07-01,2,0,0,4,2,8
Egypt,2004-07-01,8,0,2,6,16,32
Egypt,2004-07-01,24,0,1,17,5,47
Egypt,2004-07-01,24,0,0,-4,2,22
Egypt,2004-07-01,3,0,0,-2,0,1
Egypt,2004-07-01,-2,0,0,-6,0,-8
Egypt,2004-07-01,12,0,0,42,2,56
Egypt,2004-07-01,3,0,0,16,6,25
Egypt,2004-07-01,13,0,0,17,3,33
Egypt,2004-07-01,4,0,0,10,13,27
Egypt,2004-07-01,5,0,0,3,6,14
Egypt,2004-07-01,8,0,-4,3,3,10
Egypt,2004-07-01,5,2,0,7,0,14
Egypt,2004-07-01,7,0,0,6,0,13
Egypt,2004-07-01,15,0,0,-3,3,15
Egypt,2004-08-01,11,0,0,4,8,23
Egypt,2004-08-01,3,0,0,2,1,6
Egypt,2004-08-01,19,0,0,6,0,25
Egypt,2004-08-01,13,0,1,0,0,14
Egypt,2004-08-01,1,0,0,12,1,14
Egypt,2004-08-01,17,0,0,3,2,22
Egypt,2004-08-01,7,0,0,-2,0,5
Egypt,2004-08-01,2,0,0,33,0,35
Egypt,2004-08-01,-17,0,0,12,0,-5
Egypt,2004-08-01,7,0,0,0,2,9
Egypt,2004-08-01,7,0,0,6,2,15
Egypt,2004-08-01,7,0,0,0,2,9
Egypt,2004-08-01,16,0,0,-4,1,13
Egypt,2004-08-01,14,0,0,3,0,17
Egypt,2004-08-01,2,0,0,0,0,2
Egypt,2004-08-01,10,0,0,9,0,19
Egypt,2004-08-01,3,0,0,0,0,3
Egypt,2004-08-01,-4,0,0,0,0,-4
Egypt,2004-08-01,14,0,0,6,0,20
Egypt,2004-08-01,11,0,0,3,1,15
Egypt,2004-08-01,3,0,0,3,0,6
Egypt,2004-08-01,3,0,0,15,0,18
Egypt,2004-08-01,11,0,0,-10,1,2
Egypt,2004-08-01,0,0,0,3,0,3
Egypt,2004-08-01,7,0,0,3,3,13
Egypt,2004-08-01,10,0,0,24,1,35
Egypt,2004-08-01,2,0,0,6,2,10
Egypt,2004-08-01,2,0,0,3,0,5
Egypt,2004-08-01,0,0,0,1,1,2
Egypt,2004-08-01,15,0,0,3,0,18
Egypt,2004-08-01,27,0,0,0,6,33
Egypt,2004-09-01,48,6,0,11,13,78
Egypt,2004-09-01,9,0,0,6,0,15
Egypt,2004-09-01,12,0,0,8,0,20
Egypt,2004-09-01,9,0,0,0,0,9
Egypt,2004-09-01,39,0,0,15,2,56
Egypt,2004-09-01,6,0,-2,4,0,8
Egypt,2004-09-01,23,0,0,0,2,25
Egypt,2004-09-01,13,0,-2,6,0,17
Egypt,2004-09-01,18,2,2,12,0,34
Egypt,2004-09-01,5,0,0,0,0,5
Egypt,2004-09-01,24,0,0,2,0,26
Egypt,2004-09-01,-4,0,0,3,0,-1
Egypt,2004-09-01,15,0,0,2,0,17
Egypt,2004-09-01,-1,0,0,6,0,5
Egypt,2004-09-01,26,0,0,-10,2,18
Egypt,2004-09-01,9,0,0,27,0,36
Egypt,2004-09-01,6,0,0,9,0,15
Egypt,2004-09-01,6,0,0,0,0,6
Egypt,2004-09-01,7,0,0,17,0,24
Egypt,2004-09-01,5,0,0,3,0,8
Egypt,2004-09-01,-1,0,0,-4,0,-5
Egypt,2004-09-01,0,0,-2,3,1,2
Egypt,2004-09-01,8,0,0,0,0,8
Egypt,2004-09-01,9,0,0,26,9,44
Egypt,2004-09-01,5,0,0,18,1,24
Egypt,2004-09-01,9,0,0,47,2,58
Egypt,2004-09-01,0,0,0,-7,2,-5
Egypt,2004-09-01,3,0,0,-24,3,-18
Egypt,2004-09-01,4,0,0,-1,0,3
Egypt,2004-09-01,40,0,0,4,10,54
Egypt,2004-10-01,-1,0,0,3,0,2
Egypt,2004-10-01,5,6,0,1,2,14
Egypt,2004-10-01,18,0,0,3,0,21
Egypt,2004-10-01,17,0,0,3,10,30
Egypt,2004-10-01,20,0,0,12,0,32
Egypt,2004-10-01,6,0,0,6,0,12
Egypt,2004-10-01,53,0,0,18,13,84
Egypt,2004-10-01,136,0,0,0,18,154
Egypt,2004-10-01,35,0,0,6,10,51
Egypt,2004-10-01,30,0,0,-2,2,30
Egypt,2004-10-01,7,0,0,-1,6,12
Egypt,2004-10-01,18,0,0,0,0,18
Egypt,2004-10-01,8,0,0,4,0,12
Egypt,2004-10-01,9,0,0,0,0,9
Egypt,2004-10-01,5,0,0,3,0,8
Egypt,2004-10-01,8,0,0,0,2,10
Egypt,2004-10-01,-1,0,0,0,0,-1
Egypt,2004-10-01,33,0,0,30,4,67
Egypt,2004-10-01,3,0,0,2,2,7
Egypt,2004-10-01,17,0,0,-8,3,12
Egypt,2004-10-01,28,0,0,0,0,28
Egypt,2004-10-01,7,0,0,0,0,7
Egypt,2004-10-01,0,0,0,0,0,0
Egypt,2004-10-01,-1,0,-2,3,1,1
Egypt,2004-10-01,13,0,0,3,3,19
Egypt,2004-10-01,10,0,1,-1,0,10
Egypt,2004-10-01,-3,0,0,4,0,1
Egypt,2004-10-01,9,0,-4,6,3,14
Egypt,2004-10-01,8,0,0,3,0,11
Egypt,2004-10-01,0,0,0,0,0,0
Egypt,2004-10-01,3,0,0,12,1,16
Egypt,2004-11-01,8,0,0,0,0,8
Egypt,2004-11-01,2,0,0,0,1,3
Egypt,2004-11-01,16,0,6,3,2,27
Egypt,2004-11-01,10,0,2,3,0,15
Egypt,2004-11-01,0,0,1,0,0,1
Egypt,2004-11-01,0,0,0,0,0,0
Egypt,2004-11-01,2,0,0,-2,0,0
Egypt,2004-11-01,2,0,0,3,0,5
Egypt,2004-11-01,3,0,0,9,0,12
Egypt,2004-11-01,1,0,0,12,0,13
Egypt,2004-11-01,-2,0,0,12,0,10
Egypt,2004-11-01,3,0,0,0,1,4
Egypt,2004-11-01,3,0,0,0,0,3
Egypt,2004-11-01,5,0,0,2,0,7
Egypt,2004-11-01,7,0,0,10,1,18
Egypt,2004-11-01,-1,0,0,0,0,-1
Egypt,2004-11-01,5,0,0,0,0,5
Egypt,2004-11-01,59,0,0,-2,5,62
Egypt,2004-11-01,14,0,0,3,2,19
Egypt,2004-11-01,13,0,0,4,0,17
Egypt,2004-11-01,3,0,0,3,0,6
Egypt,2004-11-01,30,0,0,17,0,47
Egypt,2004-11-01,-2,0,1,0,2,1
Egypt,2004-11-01,4,0,0,0,0,4
Egypt,2004-11-01,6,0,0,6,3,15
Egypt,2004-11-01,3,0,1,0,0,4
Egypt,2004-11-01,5,0,1,0,0,6
Egypt,2004-11-01,6,0,-2,0,0,4
Egypt,2004-11-01,17,0,-4,0,2,15
Egypt,2004-11-01,19,0,1,0,11,31
Egypt,2004-12-01,26,0,-2,0,1,25
Egypt,2004-12-01,10,0,0,-1,0,9
Egypt,2004-12-01,-3,0,0,-2,0,-5
Egypt,2004-12-01,3,0,3,0,0,6
Egypt,2004-12-01,5,0,0,2,4,11
Egypt,2004-12-01,14,0,0,4,0,18
Egypt,2004-12-01,13,0,0,6,0,19
Egypt,2004-12-01,7,0,0,0,1,8
Egypt,2004-12-01,15,0,0,58,3,76
Egypt,2004-12-01,12,0,0,3,1,16
Egypt,2004-12-01,2,0,0,-1,0,1
Egypt,2004-12-01,35,0,0,-13,13,35
Egypt,2004-12-01,52,0,0,1,0,53
Egypt,2004-12-01,29,0,0,0,2,31
Egypt,2004-12-01,6,0,0,2,0,8
Egypt,2004-12-01,16,0,0,0,1,17
Egypt,2004-12-01,20,0,0,15,0,35
Egypt,2004-12-01,21,0,0,0,6,27
Egypt,2004-12-01,8,0,0,6,1,15
Egypt,2004-12-01,6,0,0,2,0,8
Egypt,2004-12-01,0,0,0,3,0,3
Egypt,2004-12-01,9,0,0,0,0,9
Egypt,2004-12-01,6,0,0,3,0,9
Egypt,2004-12-01,2,0,0,0,0,2
Egypt,2004-12-01,0,0,0,0,0,0
Egypt,2004-12-01,16,0,0,0,0,16
Egypt,2004-12-01,7,0,0,-18,0,-11
Egypt,2004-12-01,-3,0,0,3,0,0
Egypt,2004-12-01,5,0,0,24,0,29
Egypt,2004-12-01,6,0,0,0,0,6
Egypt,2004-12-01,14,0,0,10,0,24
Eritrea,2004-01-01,0,0,0,0,0,0
Eritrea,2004-01-01,0,0,0,0,0,0
Eritrea,2004-01-01,2,0,0,0,0,2
Eritrea,2004-01-01,0,0,0,3,0,3
Eritrea,2004-01-01,4,0,0,0,0,4
Eritrea,2004-01-01,3,0,0,0,0,3
Eritrea,2004-01-01,2,0,0,9,0,11
Eritrea,2004-01-01,6,0,0,0,1,7
Eritrea,2004-01-01,-1,0,0,0,0,-1
Eritrea,2004-01-01,0,0,0,0,0,0
Eritrea,2004-01-01,0,0,0,3,0,3
Eritrea,2004-01-01,0,0,0,3,0,3
Eritrea,2004-01-01,5,0,0,0,0,5
Eritrea,2004-01-01,0,0,0,0,2,2
Eritrea,2004-01-01,2,0,0,0,0,2
Eritrea,2004-01-01,16,0,0,3,1,20
Eritrea,2004-01-01,2,0,0,0,0,2
Eritrea,2004-01-01,-6,0,0,0,0,-6
Eritrea,2004-01-01,1,0,0,0,0,1
Eritrea,2004-01-01,0,0,1,0,0,1
Eritrea,2004-01-01,0,0,0,0,0,0
Eritrea,2004-01-01,0,0,0,0,0,0
Eritrea,2004-01-01,6,0,0,3,0,9
Eritrea,2004-02-01,9,0,0,0,0,9
Eritrea,2004-02-01,2,0,0,0,0,2
Eritrea,2004-02-01,0,0,0,0,0,0
Eritrea,2004-02-01,2,0,0,0,0,2
Eritrea,2004-02-01,0,0,0,0,0,0
Eritrea,2004-02-01,2,0,0,0,0,2
Eritrea,2004-02-01,0,0,0,0,0,0
Eritrea,2004-02-01,-2,0,0,0,0,-2
Eritrea,2004-02-01,2,4,0,0,0,6
Eritrea,2004-02-01,2,0,0,0,0,2
Eritrea,2004-02-01,-5,0,0,0,0,-5
Eritrea,2004-02-01,3,0,0,0,0,3
Eritrea,2004-02-01,4,0,0,0,0,4
Eritrea,2004-02-01,0,0,0,0,0,0
Eritrea,2004-02-01,2,0,0,0,0,2
Eritrea,2004-02-01,0,0,0,0,0,0
Eritrea,2004-02-01,2,0,0,0,0,2
Eritrea,2004-02-01,0,0,0,0,0,0
Eritrea,2004-02-01,1,2,0,0,0,3
Eritrea,2004-02-01,0,0,0,0,0,0
Eritrea,2004-02-01,0,0,0,0,0,0
Eritrea,2004-02-01,0,0,0,0,0,0
Eritrea,2004-02-01,-2,0,0,0,0,-2
Eritrea,2004-02-01,0,0,0,-8,0,-8
Eritrea,2004-03-01,6,0,0,-4,0,2
Eritrea,2004-03-01,5,2,0,0,0,7
Eritrea,2004-03-01,0,0,0,0,0,0
Eritrea,2004-03-01,-1,4,0,0,0,3
Eritrea,2004-03-01,0,0,0,0,0,0
Eritrea,2004-03-01,0,0,0,0,0,0
Eritrea,2004-03-01,0,0,0,0,0,0
Eritrea,2004-03-01,0,0,0,0,0,0
Eritrea,2004-03-01,3,0,0,0,0,3
Eritrea,2004-03-01,2,0,0,0,0,2
Eritrea,2004-03-01,3,0,0,-4,0,-1
Eritrea,2004-03-01,0,0,0,0,0,0
Eritrea,2004-03-01,0,0,0,0,0,0
Eritrea,2004-03-01,0,0,0,0,0,0
Eritrea,2004-03-01,-1,0,0,0,0,-1
Eritrea,2004-03-01,0,0,0,0,0,0
Eritrea,2004-03-01,0,0,0,0,0,0
Eritrea,2004-03-01,0,0,0,0,0,0
Eritrea,2004-03-01,4,0,0,0,0,4
Eritrea,2004-03-01,0,0,0,0,0,0
Eritrea,2004-03-01,0,0,0,0,0,0
Eritrea,2004-03-01,0,0,0,0,0,0
Eritrea,2004-03-01,2,0,0,0,0,2
Eritrea,2004-03-01,0,0,0,0,0,0
Eritrea,2004-03-01,3,0,0,0,0,3
Eritrea,2004-04-01,0,0,0,3,0,3
Eritrea,2004-04-01,0,0,0,12,0,12
Eritrea,2004-04-01,0,0,0,0,0,0
Eritrea,2004-04-01,0,0,0,0,0,0
Eritrea,2004-04-01,0,0,0,0,1,1
Eritrea,2004-04-01,1,0,0,0,0,1
Eritrea,2004-04-01,0,0,0,0,0,0
Eritrea,2004-04-01,15,0,0,0,0,15
Eritrea,2004-04-01,0,0,0,0,0,0
Eritrea,2004-04-01,2,0,0,3,0,5
Eritrea,2004-04-01,0,0,0,0,0,0
Eritrea,2004-04-01,-2,0,0,0,0,-2
Eritrea,2004-04-01,2,0,0,0,0,2
Eritrea,2004-04-01,4,0,0,0,0,4
Eritrea,2004-04-01,0,0,0,0,0,0
Eritrea,2004-04-01,0,0,0,-2,0,-2
Eritrea,2004-04-01,0,0,0,0,0,0
Eritrea,2004-04-01,2,0,0,0,0,2
Eritrea,2004-04-01,4,0,0,0,0,4
Eritrea,2004-05-01,0,0,0,3,0,3
Eritrea,2004-05-01,0,0,0,0,0,0
Eritrea,2004-05-01,0,0,0,0,0,0
Eritrea,2004-05-01,2,0,0,3,2,7
Eritrea,2004-05-01,2,0,0,3,0,5
Eritrea,2004-05-01,4,0,0,0,0,4
Eritrea,2004-05-01,6,0,0,0,0,6
Eritrea,2004-05-01,4,0,0,0,2,6
Eritrea,2004-05-01,7,0,0,0,7,14
Eritrea,2004-05-01,0,0,0,0,0,0
Eritrea,2004-05-01,6,0,0,0,0,6
Eritrea,2004-05-01,6,0,0,0,2,8
Eritrea,2004-05-01,-2,0,0,0,0,-2
Eritrea,2004-05-01,0,0,0,0,0,0
Eritrea,2004-05-01,0,0,0,6,0,6
Eritrea,2004-05-01,-1,0,0,9,1,9
Eritrea,2004-05-01,2,0,0,3,0,5
Eritrea,2004-05-01,0,0,0,3,0,3
Eritrea,2004-05-01,0,0,0,0,0,0
Eritrea,2004-05-01,2,0,0,0,0,2
Eritrea,2004-05-01,6,0,0,0,0,6
Eritrea,2004-05-01,0,0,0,0,0,0
Eritrea,2004-05-01,2,0,0,6,0,8
Eritrea,2004-05-01,0,0,0,3,0,3
Eritrea,2004-05-01,0,0,0,0,0,0
Eritrea,2004-06-01,0,0,0,0,0,0
Eritrea,2004-06-01,0,0,0,0,0,0
Eritrea,2004-06-01,1,0,0,0,0,1
Eritrea,2004-06-01,-1,0,0,0,0,-1
Eritrea,2004-06-01,0,0,0,0,0,0
Eritrea,2004-06-01,-3,0,0,0,0,-3
Eritrea,2004-06-01,0,0,0,0,0,0
Eritrea,2004-06-01,0,2,0,0,0,2
Eritrea,2004-06-01,0,0,0,0,0,0
Eritrea,2004-06-01,0,0,0,0,0,0
Eritrea,2004-06-01,0,0,0,3,0,3
Eritrea,2004-06-01,0,0,0,0,0,0
Eritrea,2004-06-01,1,0,0,0,0,1
Eritrea,2004-06-01,-1,0,0,0,0,-1
Eritrea,2004-06-01,2,0,0,3,0,5
Eritrea,2004-06-01,0,0,0,0,0,0
Eritrea,2004-06-01,0,0,0,0,0,0
Eritrea,2004-06-01,0,0,0,0,0,0
Eritrea,2004-06-01,0,0,0,0,0,0
Eritrea,2004-06-01,0,0,0,0,0,0
Eritrea,2004-07-01,0,0,0,0,0,0
Eritrea,2004-07-01,-3,0,0,0,0,-3
Eritrea,2004-07-01,4,0,0,0,0,4
Eritrea,2004-07-01,0,0,0,0,0,0
Eritrea,2004-07-01,0,0,0,0,0,0
Eritrea,2004-07-01,2,0,0,0,0,2
Eritrea,2004-07-01,-2,0,0,0,0,-2
Eritrea,2004-07-01,-3,0,0,0,0,-3
Eritrea,2004-07-01,2,0,0,0,0,2
Eritrea,2004-07-01,0,0,0,0,1,1
Eritrea,2004-07-01,0,0,0,0,0,0
Eritrea,2004-07-01,0,0,0,0,0,0
Eritrea,2004-07-01,0,0,0,0,0,0
Eritrea,2004-07-01,0,0,0,0,0,0
Eritrea,2004-07-01,0,0,0,6,0,6
Eritrea,2004-07-01,1,0,0,0,0,1
Eritrea,2004-07-01,2,0,0,6,0,8
Eritrea,2004-07-01,0,0,0,6,0,6
Eritrea,2004-07-01,0,0,0,6,0,6
Eritrea,2004-07-01,0,0,0,0,0,0
Eritrea,2004-07-01,9,0,0,0,0,9
Eritrea,2004-07-01,0,0,0,0,0,0
Eritrea,2004-07-01,0,0,0,0,0,0
Eritrea,2004-08-01,0,0,0,0,0,0
Eritrea,2004-08-01,9,0,0,-4,0,5
Eritrea,2004-08-01,3,4,0,0,0,7
Eritrea,2004-08-01,14,0,0,0,0,14
Eritrea,2004-08-01,6,0,0,0,0,6
Eritrea,2004-08-01,0,0,0,0,0,0
Eritrea,2004-08-01,0,0,0,0,0,0
Eritrea,2004-08-01,0,0,0,0,0,0
Eritrea,2004-08-01,3,0,0,0,0,3
Eritrea,2004-08-01,0,0,0,0,0,0
Eritrea,2004-08-01,0,0,0,0,0,0
Eritrea,2004-08-01,1,0,0,0,0,1
Eritrea,2004-08-01,36,0,0,0,0,36
Eritrea,2004-08-01,0,0,0,0,0,0
Eritrea,2004-08-01,0,0,0,0,2,2
Eritrea,2004-08-01,0,0,0,0,0,0
Eritrea,2004-08-01,0,0,0,0,0,0
Eritrea,2004-08-01,6,0,0,6,0,12
Eritrea,2004-08-01,0,0,0,0,0,0
Eritrea,2004-08-01,-2,0,0,0,0,-2
Eritrea,2004-08-01,0,0,0,0,0,0
Eritrea,2004-08-01,2,0,0,9,0,11
Eritrea,2004-08-01,3,0,0,6,0,9
Eritrea,2004-08-01,0,0,0,3,0,3
Eritrea,2004-08-01,3,0,0,0,0,3
Eritrea,2004-08-01,1,0,0,0,0,1
Eritrea,2004-09-01,0,0,0,6,0,6
Eritrea,2004-09-01,0,0,0,0,0,0
Eritrea,2004-09-01,3,0,0,3,0,6
Eritrea,2004-09-01,2,0,0,3,0,5
Eritrea,2004-09-01,2,0,0,0,0,2
Eritrea,2004-09-01,0,0,0,-4,0,-4
Eritrea,2004-09-01,4,0,0,6,0,10
Eritrea,2004-09-01,14,0,0,0,0,14
Eritrea,2004-09-01,4,0,0,9,0,13
Eritrea,2004-09-01,1,0,0,0,0,1
Eritrea,2004-09-01,-18,0,0,0,0,-18
Eritrea,2004-09-01,0,0,0,0,0,0
Eritrea,2004-09-01,1,0,0,0,0,1
Eritrea,2004-09-01,0,0,0,-2,1,-1
Eritrea,2004-09-01,0,0,0,12,0,12
Eritrea,2004-09-01,3,0,0,0,0,3
Eritrea,2004-09-01,0,0,0,1,0,1
Eritrea,2004-09-01,0,0,0,18,0,18
Eritrea,2004-09-01,10,0,0,11,0,21
Eritrea,2004-09-01,4,0,0,9,0,13
Eritrea,2004-09-01,2,0,0,0,0,2
Eritrea,2004-09-01,2,0,0,6,0,8
Eritrea,2004-09-01,0,0,0,0,0,0
Eritrea,2004-09-01,0,0,0,0,0,0
Eritrea,2004-09-01,0,0,0,0,2,2
Eritrea,2004-09-01,1,0,0,0,3,4
Eritrea,2004-09-01,0,0,0,0,0,0
Eritrea,2004-10-01,0,0,0,0,0,0
Eritrea,2004-10-01,2,0,0,0,0,2
Eritrea,2004-10-01,0,0,0,0,0,0
Eritrea,2004-10-01,4,0,0,-10,0,-6
Eritrea,2004-10-01,6,0,0,0,0,6
Eritrea,2004-10-01,1,0,0,9,0,10
Eritrea,2004-10-01,0,0,0,6,0,6
Eritrea,2004-10-01,-2,0,0,0,2,0
Eritrea,2004-10-01,0,0,0,6,0,6
Eritrea,2004-10-01,0,0,0,0,0,0
Eritrea,2004-10-01,3,0,0,0,0,3
Eritrea,2004-10-01,0,0,0,0,0,0
Eritrea,2004-10-01,1,0,0,-4,0,-3
Eritrea,2004-10-01,0,0,0,0,0,0
Eritrea,2004-10-01,0,0,0,0,0,0
Eritrea,2004-10-01,-3,0,0,0,0,-3
Eritrea,2004-10-01,0,0,0,0,0,0
Eritrea,2004-10-01,10,0,0,0,0,10
Eritrea,2004-10-01,0,0,0,0,0,0
Eritrea,2004-10-01,0,0,0,0,0,0
Eritrea,2004-10-01,0,0,0,0,0,0
Eritrea,2004-10-01,0,0,0,0,0,0
Eritrea,2004-10-01,0,0,0,0,2,2
Eritrea,2004-10-01,0,0,0,3,0,3
Eritrea,2004-10-01,0,0,0,0,0,0
Eritrea,2004-10-01,0,0,0,0,0,0
Eritrea,2004-11-01,-1,0,0,0,0,-1
Eritrea,2004-11-01,0,0,0,0,0,0
Eritrea,2004-11-01,0,0,0,0,0,0
Eritrea,2004-11-01,20,0,0,12,1,33
Eritrea,2004-11-01,-1,0,0,0,0,-1
Eritrea,2004-11-01,3,0,0,3,0,6
Eritrea,2004-11-01,0,0,0,0,0,0
Eritrea,2004-11-01,3,0,0,0,0,3
Eritrea,2004-11-01,0,0,0,0,0,0
Eritrea,2004-11-01,0,0,0,3,0,3
Eritrea,2004-11-01,2,0,0,0,0,2
Eritrea,2004-11-01,0,0,0,0,0,0
Eritrea,2004-11-01,3,0,0,0,0,3
Eritrea,2004-11-01,0,0,0,0,0,0
Eritrea,2004-11-01,0,0,0,0,0,0
Eritrea,2004-11-01,3,0,0,0,0,3
Eritrea,2004-11-01,2,0,0,-2,0,0
Eritrea,2004-11-01,0,0,0,0,0,0
Eritrea,2004-11-01,0,0,0,3,1,4
Eritrea,2004-11-01,19,0,0,0,0,19
Eritrea,2004-11-01,4,0,0,0,0,4
Eritrea,2004-11-01,8,0,0,0,0,8
Eritrea,2004-11-01,3,0,0,0,0,3
Eritrea,2004-11-01,11,0,0,3,0,14
Eritrea,2004-12-01,0,0,0,0,0,0
Eritrea,2004-12-01,9,0,0,0,0,9
Eritrea,2004-12-01,3,0,0,0,1,4
Eritrea,2004-12-01,0,0,0,0,0,0
Eritrea,2004-12-01,0,0,0,0,0,0
Eritrea,2004-12-01,1,0,0,0,0,1
Eritrea,2004-12-01,16,0,0,9,1,26
Eritrea,2004-12-01,0,0,0,0,0,0
Eritrea,2004-12-01,2,0,0,0,0,2
Eritrea,2004-12-01,2,0,0,12,0,14
Eritrea,2004-12-01,0,0,0,0,0,0
Eritrea,2004-12-01,4,0,0,0,0,4
Eritrea,2004-12-01,-1,0,0,0,0,-1
Eritrea,2004-12-01,1,0,0,0,0,1
Eritrea,2004-12-01,1,0,0,0,3,4
Eritrea,2004-12-01,6,0,0,0,0,6
Eritrea,2004-12-01,0,0,0,0,0,0
Eritrea,2004-12-01,6,0,0,0,0,6
Eritrea,2004-12-01,2,0,0,0,0,2
Eritrea,2004-12-01,0,0,1,0,0,1
Eritrea,2004-12-01,-1,0,1,0,0,0
Eritrea,2004-12-01,0,2,0,-2,0,0
Eritrea,2004-12-01,0,0,0,0,0,0
Eritrea,2004-12-01,0,0,0,-2,0,-2
Eritrea,2004-12-01,0,0,0,0,1,1
Eritrea,2004-12-01,6,0,0,0,0,6
Eritrea,2004-12-01,8,0,0,0,0,8
Eritrea,2004-12-01,0,0,0,0,0,0
Eritrea,2004-12-01,8,0,0,-2,0,6
Georgia,2004-01-01,0,0,0,0,3,3
Georgia,2004-01-01,3,0,0,0,0,3
Georgia,2004-01-01,2,0,0,0,1,3
Georgia,2004-01-01,2,0,-4,0,0,-2
Georgia,2004-01-01,8,0,0,0,0,8
Georgia,2004-01-01,0,0,0,2,0,2
Georgia,2004-01-01,1,0,1,0,4,6
Georgia,2004-01-01,12,0,-2,3,1,14
Georgia,2004-01-01,2,0,0,0,0,2
Georgia,2004-01-01,4,0,0,0,0,4
Georgia,2004-01-01,3,0,-1,0,0,2
Georgia,2004-01-01,1,0,0,0,0,1
Georgia,2004-01-01,2,0,0,0,0,2
Georgia,2004-01-01,0,0,0,0,0,0
Georgia,2004-01-01,0,0,0,0,0,0
Georgia,2004-01-01,2,0,0,0,0,2
Georgia,2004-01-01,-4,0,0,0,0,-4
Georgia,2004-01-01,-3,0,0,0,0,-3
Georgia,2004-01-01,2,0,-2,0,0,0
Georgia,2004-01-01,0,0,0,3,0,3
Georgia,2004-01-01,-2,0,0,0,0,-2
Georgia,2004-01-01,3,0,0,0,0,3
Georgia,2004-01-01,-3,0,2,3,0,2
Georgia,2004-01-01,0,0,0,3,0,3
Georgia,2004-01-01,5,0,0,0,0,5
Georgia,2004-01-01,2,0,0,0,0,2
Georgia,2004-01-01,-1,0,0,0,0,-1
Georgia,2004-01-01,4,0,0,0,0,4
Georgia,2004-02-01,1,0,0,0,0,1
Georgia,2004-02-01,3,0,0,3,0,6
Georgia,2004-02-01,4,0,0,0,0,4
Georgia,2004-02-01,-1,0,0,0,0,-1
Georgia,2004-02-01,0,0,0,0,0,0
Georgia,2004-02-01,3,0,0,1,0,4
Georgia,2004-02-01,2,0,-2,0,1,1
Georgia,2004-02-01,-1,0,-6,0,0,-7
Georgia,2004-02-01,1,0,0,0,0,1
Georgia,2004-02-01,2,0,0,0,0,2
Georgia,2004-02-01,-1,0,0,3,0,2
Georgia,2004-02-01,0,0,0,0,1,1
Georgia,2004-02-01,0,0,0,0,0,0
Georgia,2004-02-01,0,0,0,0,0,0
Georgia,2004-02-01,0,0,0,0,0,0
Georgia,2004-02-01,5,0,0,0,1,6
Georgia,2004-02-01,0,0,-2,12,0,10
Georgia,2004-02-01,3,0,-2,0,2,3
Georgia,2004-02-01,2,0,0,1,0,3
Georgia,2004-02-01,3,0,0,0,1,4
Georgia,2004-02-01,0,0,0,0,0,0
Georgia,2004-02-01,0,0,0,0,0,0
Georgia,2004-02-01,-1,0,0,0,0,-1
Georgia,2004-02-01,-1,0,0,0,0,-1
Georgia,2004-02-01,7,0,0,0,0,7
Georgia,2004-02-01,6,0,0,0,0,6
Georgia,2004-02-01,1,0,0,3,0,4
Georgia,2004-03-01,1,0,0,0,0,1
Georgia,2004-03-01,6,0,0,0,1,7
Georgia,2004-03-01,8,0,0,0,0,8
Georgia,2004-03-01,7,0,0,0,0,7
Georgia,2004-03-01,2,0,0,0,0,2
Georgia,2004-03-01,2,0,0,0,0,2
Georgia,2004-03-01,0,0,0,0,0,0
Georgia,2004-03-01,-1,0,0,0,0,-1
Georgia,2004-03-01,3,0,0,0,2,5
Georgia,2004-03-01,0,0,1,0,0,1
Georgia,2004-03-01,2,0,0,0,0,2
Georgia,2004-03-01,2,0,0,3,1,6
Georgia,2004-03-01,2,0,0,0,0,2
Georgia,2004-03-01,-1,0,0,0,0,-1
Georgia,2004-03-01,9,0,0,0,1,10
Georgia,2004-03-01,3,0,0,3,0,6
Georgia,2004-03-01,1,0,0,0,0,1
Georgia,2004-03-01,2,0,0,-2,0,0
Georgia,2004-03-01,4,0,1,0,0,5
Georgia,2004-03-01,0,0,-2,0,0,-2
Georgia,2004-03-01,0,0,0,0,0,0
Georgia,2004-03-01,3,0,0,0,0,3
Georgia,2004-03-01,0,0,0,0,0,0
Georgia,2004-03-01,0,0,0,0,0,0
Georgia,2004-03-01,2,0,0,1,1,4
Georgia,2004-03-01,8,0,0,0,0,8
Georgia,2004-03-01,0,0,0,3,0,3
Georgia,2004-03-01,3,0,0,0,1,4
Georgia,2004-03-01,5,0,0,0,3,8
Georgia,2004-03-01,-1,0,0,0,0,-1
Georgia,2004-03-01,4,0,0,6,1,11
Georgia,2004-04-01,4,0,0,3,0,7
Georgia,2004-04-01,1,0,0,0,1,2
Georgia,2004-04-01,2,0,0,0,0,2
Georgia,2004-04-01,0,0,0,0,0,0
Georgia,2004-04-01,2,2,1,6,0,11
Georgia,2004-04-01,14,0,0,0,0,14
Georgia,2004-04-01,0,0,0,3,0,3
Georgia,2004-04-01,2,0,2,-2,2,4
Georgia,2004-04-01,4,0,0,0,0,4
Georgia,2004-04-01,4,0,2,0,0,6
Georgia,2004-04-01,2,0,0,0,1,3
Georgia,2004-04-01,6,0,0,0,0,6
Georgia,2004-04-01,0,0,1,3,0,4
Georgia,2004-04-01,0,0,0,0,0,0
Georgia,2004-04-01,0,0,0,0,0,0
Georgia,2004-04-01,2,0,0,0,1,3
Georgia,2004-04-01,0,0,0,0,0,0
Georgia,2004-04-01,3,0,0,5,0,8
Georgia,2004-04-01,3,0,1,3,0,7
Georgia,2004-04-01,5,0,0,0,3,8
Georgia,2004-04-01,7,0,0,0,0,7
Georgia,2004-04-01,2,0,-4,0,0,-2
Georgia,2004-04-01,14,0,0,3,0,17
Georgia,2004-04-01,0,0,0,0,0,0
Georgia,2004-04-01,2,0,0,0,0,2
Georgia,2004-04-01,0,0,0,3,0,3
Georgia,2004-04-01,1,0,0,0,0,1
Georgia,2004-04-01,1,0,0,0,0,1
Georgia,2004-04-01,0,0,0,0,0,0
Georgia,2004-05-01,0,0,0,0,0,0
Georgia,2004-05-01,5,0,0,0,0,5
Georgia,2004-05-01,0,0,0,0,0,0
Georgia,2004-05-01,9,0,-2,6,6,19
Georgia,2004-05-01,6,0,-6,0,2,2
Georgia,2004-05-01,11,0,0,0,0,11
Georgia,2004-05-01,1,0,0,0,0,1
Georgia,2004-05-01,0,0,0,0,1,1
Georgia,2004-05-01,0,0,0,0,0,0
Georgia,2004-05-01,6,0,0,0,0,6
Georgia,2004-05-01,1,0,0,9,0,10
Georgia,2004-05-01,8,0,1,3,0,12
Georgia,2004-05-01,3,0,0,0,0,3
Georgia,2004-05-01,3,0,0,0,0,3
Georgia,2004-05-01,2,0,0,0,0,2
Georgia,2004-05-01,0,0,0,0,0,0
Georgia,2004-05-01,3,0,0,3,0,6
Georgia,2004-05-01,2,0,0,0,0,2
Georgia,2004-05-01,0,0,0,0,0,0
Georgia,2004-05-01,0,0,0,0,0,0
Georgia,2004-05-01,-2,0,0,0,0,-2
Georgia,2004-05-01,0,0,0,0,0,0
Georgia,2004-05-01,1,0,0,9,2,12
Georgia,2004-05-01,2,0,0,0,1,3
Georgia,2004-05-01,3,0,0,0,0,3
Georgia,2004-05-01,0,0,0,0,0,0
Georgia,2004-05-01,0,0,0,0,0,0
Georgia,2004-05-01,0,0,0,0,0,0
Georgia,2004-05-01,6,0,0,0,1,7
Georgia,2004-05-01,0,0,0,0,0,0
Georgia,2004-06-01,0,0,0,0,0,0
Georgia,2004-06-01,2,0,0,0,0,2
Georgia,2004-06-01,0,0,0,0,0,0
Georgia,2004-06-01,4,0,0,0,0,4
Georgia,2004-06-01,0,0,0,0,0,0
Georgia,2004-06-01,0,0,0,0,0,0
Georgia,2004-06-01,6,0,0,0,0,6
Georgia,2004-06-01,6,0,0,0,0,6
Georgia,2004-06-01,7,0,0,6,0,13
Georgia,2004-06-01,17,0,0,0,0,17
Georgia,2004-06-01,0,0,0,0,0,0
Georgia,2004-06-01,0,0,0,0,1,1
Georgia,2004-06-01,2,0,0,0,1,3
Georgia,2004-06-01,3,0,0,0,0,3
Georgia,2004-06-01,0,0,0,0,0,0
Georgia,2004-06-01,6,0,0,9,0,15
Georgia,2004-06-01,0,0,0,0,0,0
Georgia,2004-06-01,0,0,0,0,0,0
Georgia,2004-06-01,2,0,0,0,0,2
Georgia,2004-06-01,-2,0,0,0,0,-2
Georgia,2004-06-01,0,0,0,0,0,0
Georgia,2004-06-01,9,0,0,0,0,9
Georgia,2004-06-01,0,0,0,0,0,0
Georgia,2004-06-01,6,0,0,0,0,6
Georgia,2004-06-01,0,0,0,0,0,0
Georgia,2004-06-01,0,0,0,0,0,0
Georgia,2004-06-01,0,0,0,0,1,1
Georgia,2004-07-01,2,0,0,0,0,2
Georgia,2004-07-01,2,0,0,0,0,2
Georgia,2004-07-01,0,0,0,0,0,0
Georgia,2004-07-01,1,0,0,0,0,1
Georgia,2004-07-01,0,0,0,-2,0,-2
Georgia,2004-07-01,2,0,0,0,0,2
Georgia,2004-07-01,0,0,0,0,0,0
Georgia,2004-07-01,0,0,0,0,0,0
Georgia,2004-07-01,3,0,0,0,0,3
Georgia,2004-07-01,2,0,0,0,0,2
Georgia,2004-07-01,-1,0,0,0,0,-1
Georgia,2004-07-01,0,0,0,0,0,0
Georgia,2004-07-01,-3,0,0,0,1,-2
Georgia,2004-07-01,-2,0,0,0,0,-2
Georgia,2004-07-01,0,0,0,0,0,0
Georgia,2004-07-01,-2,0,0,0,0,-2
Georgia,2004-07-01,2,0,0,3,0,5
Georgia,2004-07-01,1,0,0,-2,1,0
Georgia,2004-07-01,1,0,0,0,0,1
Georgia,2004-07-01,0,0,0,0,0,0
Georgia,2004-07-01,4,0,0,0,0,4
Georgia,2004-07-01,4,0,0,0,0,4
Georgia,2004-07-01,0,0,0,-4,0,-4
Georgia,2004-07-01,0,0,0,0,0,0
Georgia,2004-08-01,0,0,0,0,0,0
Georgia,2004-08-01,0,0,0,0,0,0
Georgia,2004-08-01,0,0,0,3,0,3
Georgia,2004-08-01,0,0,0,3,0,3
Georgia,2004-08-01,0,0,0,0,0,0
Georgia,2004-08-01,0,2,0,0,0,2
Georgia,2004-08-01,0,0,0,0,0,0
Georgia,2004-08-01,0,0,0,0,0,0
Georgia,2004-08-01,-2,0,0,0,0,-2
Georgia,2004-08-01,0,0,0,0,0,0
Georgia,2004-08-01,0,0,0,0,0,0
Georgia,2004-08-01,0,0,0,0,0,0
Georgia,2004-08-01,4,0,0,0,0,4
Georgia,2004-08-01,0,0,0,1,0,1
Georgia,2004-08-01,2,0,0,0,0,2
Georgia,2004-08-01,1,0,0,0,0,1
Georgia,2004-08-01,0,0,0,0,0,0
Georgia,2004-08-01,3,0,0,0,0,3
Georgia,2004-08-01,1,0,0,0,0,1
Georgia,2004-08-01,0,0,0,0,0,0
Georgia,2004-08-01,0,0,0,0,0,0
Georgia,2004-08-01,4,0,0,0,0,4
Georgia,2004-08-01,2,0,0,0,0,2
Georgia,2004-08-01,2,0,0,0,4,6
Georgia,2004-08-01,4,0,0,0,0,4
Georgia,2004-08-01,0,0,0,0,0,0
Georgia,2004-08-01,0,0,0,3,2,5
Georgia,2004-09-01,2,0,-2,0,0,0
Georgia,2004-09-01,2,0,0,0,0,2
Georgia,2004-09-01,1,0,0,0,0,1
Georgia,2004-09-01,0,0,0,-1,0,-1
Georgia,2004-09-01,4,0,0,1,0,5
Georgia,2004-09-01,0,0,0,0,0,0
Georgia,2004-09-01,0,0,1,-2,0,-1
Georgia,2004-09-01,0,0,0,0,0,0
Georgia,2004-09-01,0,0,0,0,0,0
Georgia,2004-09-01,0,0,0,0,0,0
Georgia,2004-09-01,0,0,0,0,0,0
Georgia,2004-09-01,0,0,0,6,0,6
Georgia,2004-09-01,0,0,0,0,0,0
Georgia,2004-09-01,0,0,0,-2,0,-2
Georgia,2004-09-01,-1,0,0,0,0,-1
Georgia,2004-09-01,0,0,0,0,0,0
Georgia,2004-09-01,0,0,0,0,0,0
Georgia,2004-09-01,6,0,0,0,0,6
Georgia,2004-09-01,4,0,0,0,0,4
Georgia,2004-09-01,0,0,0,0,0,0
Georgia,2004-09-01,0,0,0,0,0,0
Georgia,2004-09-01,0,0,0,0,0,0
Georgia,2004-09-01,0,0,0,0,0,0
Georgia,2004-09-01,0,0,0,0,0,0
Georgia,2004-09-01,1,0,0,0,0,1
Georgia,2004-09-01,2,0,0,0,0,2
Georgia,2004-09-01,0,0,0,-2,0,-2
Georgia,2004-09-01,0,0,0,0,0,0
Georgia,2004-10-01,0,0,0,0,0,0
Georgia,2004-10-01,0,0,0,0,0,0
Georgia,2004-10-01,2,0,0,0,0,2
Georgia,2004-10-01,3,0,0,0,0,3
Georgia,2004-10-01,0,0,0,0,0,0
Georgia,2004-10-01,-1,0,0,0,0,-1
Georgia,2004-10-01,2,0,0,0,0,2
Georgia,2004-10-01,0,0,-1,0,0,-1
Georgia,2004-10-01,0,0,0,0,0,0
Georgia,2004-10-01,4,0,0,0,0,4
Georgia,2004-10-01,0,0,0,6,3,9
Georgia,2004-10-01,0,0,-2,0,0,-2
Georgia,2004-10-01,2,0,0,0,0,2
Georgia,2004-10-01,2,0,0,3,0,5
Georgia,2004-10-01,6,0,0,-2,0,4
Georgia,2004-10-01,0,0,0,3,0,3
Georgia,2004-10-01,0,0,0,0,0,0
Georgia,2004-10-01,0,0,0,0,0,0
Georgia,2004-10-01,0,0,0,0,0,0
Georgia,2004-10-01,3,0,0,3,0,6
Georgia,2004-10-01,0,0,0,18,0,18
Georgia,2004-10-01,0,0,0,0,0,0
Georgia,2004-10-01,0,2,0,0,0,2
Georgia,2004-10-01,5,0,0,6,1,12
Georgia,2004-10-01,3,0,0,0,1,4
Georgia,2004-10-01,0,0,0,0,0,0
Georgia,2004-11-01,3,0,0,0,0,3
Georgia,2004-11-01,2,0,0,0,0,2
Georgia,2004-11-01,2,0,0,3,0,5
Georgia,2004-11-01,8,0,-2,0,0,6
Georgia,2004-11-01,1,0,0,0,0,1
Georgia,2004-11-01,3,0,0,0,0,3
Georgia,2004-11-01,8,0,0,0,0,8
Georgia,2004-11-01,2,0,0,12,2,16
Georgia,2004-11-01,6,0,0,0,0,6
Georgia,2004-11-01,3,0,0,3,0,6
Georgia,2004-11-01,0,0,0,0,0,0
Georgia,2004-11-01,6,0,0,0,0,6
Georgia,2004-11-01,0,0,0,0,0,0
Georgia,2004-11-01,3,0,0,0,0,3
Georgia,2004-11-01,2,0,0,0,0,2
Georgia,2004-11-01,0,0,0,-2,0,-2
Georgia,2004-11-01,0,0,0,0,0,0
Georgia,2004-11-01,4,0,0,0,1,5
Georgia,2004-11-01,0,0,0,-2,0,-2
Georgia,2004-11-01,1,0,0,0,0,1
Georgia,2004-11-01,0,0,0,3,0,3
Georgia,2004-11-01,0,0,0,0,0,0
Georgia,2004-12-01,0,0,0,0,0,0
Georgia,2004-12-01,2,0,0,0,0,2
Georgia,2004-12-01,0,0,0,0,0,0
Georgia,2004-12-01,2,0,0,0,0,2
Georgia,2004-12-01,0,0,0,0,1,1
Georgia,2004-12-01,0,0,0,0,0,0
Georgia,2004-12-01,3,0,0,0,3,6
Georgia,2004-12-01,0,0,0,0,0,0
Georgia,2004-12-01,0,0,0,0,0,0
Georgia,2004-12-01,0,0,0,0,0,0
Georgia,2004-12-01,0,0,0,0,0,0
Georgia,2004-12-01,0,0,-1,-2,0,-3
Georgia,2004-12-01,0,0,0,0,0,0
Georgia,2004-12-01,0,0,0,0,0,0
Georgia,2004-12-01,0,0,0,0,0,0
Georgia,2004-12-01,0,0,0,3,0,3
Georgia,2004-12-01,0,0,0,0,0,0
Georgia,2004-12-01,1,0,0,3,0,4
Georgia,2004-12-01,0,0,0,0,0,0
Georgia,2004-12-01,0,0,0,0,0,0
Georgia,2004-12-01,2,0,-2,0,0,0
Georgia,2004-12-01,0,0,0,0,0,0
Georgia,2004-12-01,0,0,0,0,0,0
India,2004-01-01,4,0,0,0,0,4
India,2004-01-01,2,0,0,0,0,2
India,2004-01-01,0,0,0,-2,4,2
India,2004-01-01,9,0,0,3,0,12
India,2004-01-01,1,0,0,6,0,7
India,2004-01-01,1,0,0,0,0,1
India,2004-01-01,8,0,0,-2,0,6
India,2004-01-01,13,0,0,0,0,13
India,2004-01-01,8,0,0,3,2,13
India,2004-01-01,2,0,0,0,0,2
India,2004-01-01,11,0,0,0,0,11
India,2004-01-01,2,0,0,9,2,13
India,2004-01-01,1,0,1,0,0,2
India,2004-01-01,3,0,2,0,0,5
India,2004-01-01,18,0,0,3,6,27
India,2004-01-01,11,0,0,0,0,11
India,2004-01-01,2,0,1,0,0,3
India,2004-01-01,4,0,0,0,0,4
India,2004-01-01,-3,0,0,6,0,3
India,2004-01-01,0,0,0,1,0,1
India,2004-01-01,-1,0,0,4,1,4
India,2004-01-01,4,0,0,0,0,4
India,2004-01-01,-2,0,0,0,0,-2
India,2004-01-01,1,0,0,3,0,4
India,2004-01-01,6,0,0,3,1,10
India,2004-01-01,4,0,0,3,0,7
India,2004-01-01,0,0,0,0,0,0
India,2004-01-01,3,0,0,0,1,4
India,2004-01-01,11,0,0,0,0,11
India,2004-01-01,2,0,0,1,0,3
India,2004-01-01,4,0,0,7,0,11
India,2004-02-01,0,0,0,0,0,0
India,2004-02-01,4,0,0,3,1,8
India,2004-02-01,5,0,0,-2,1,4
India,2004-02-01,8,0,0,4,0,12
India,2004-02-01,0,0,0,0,0,0
India,2004-02-01,5,0,0,6,0,11
India,2004-02-01,5,0,0,3,0,8
India,2004-02-01,-3,0,0,0,1,-2
India,2004-02-01,15,0,0,0,1,16
India,2004-02-01,0,0,0,-2,0,-2
India,2004-02-01,4,0,0,3,0,7
India,2004-02-01,10,0,0,3,0,13
India,2004-02-01,3,0,0,0,0,3
India,2004-02-01,3,0,0,0,0,3
India,2004-02-01,3,0,0,0,0,3
India,2004-02-01,2,0,0,0,0,2
India,2004-02-01,5,0,1,0,2,8
India,2004-02-01,6,0,0,0,0,6
India,2004-02-01,12,0,0,0,4,16
India,2004-02-01,2,0,0,0,0,2
India,2004-02-01,1,0,0,0,0,1
India,2004-02-01,0,0,0,0,1,1
India,2004-02-01,0,0,0,0,0,0
India,2004-02-01,3,0,0,0,0,3
India,2004-02-01,1,0,0,0,0,1
India,2004-02-01,6,0,0,0,0,6
India,2004-02-01,4,0,0,1,0,5
India,2004-02-01,0,0,0,0,0,0
India,2004-02-01,2,0,0,-4,1,-1
India,2004-03-01,10,0,0,-10,0,0
India,2004-03-01,5,4,0,3,1,13
India,2004-03-01,29,0,1,-4,6,32
India,2004-03-01,0,0,0,3,0,3
India,2004-03-01,9,4,0,0,10,23
India,2004-03-01,1,0,0,9,1,11
India,2004-03-01,1,0,0,0,0,1
India,2004-03-01,-2,0,0,0,0,-2
India,2004-03-01,25,0,0,0,4,29
India,2004-03-01,6,0,0,0,0,6
India,2004-03-01,7,0,0,0,0,7
India,2004-03-01,0,0,0,-2,0,-2
India,2004-03-01,0,0,0,0,0,0
India,2004-03-01,0,0,0,0,0,0
India,2004-03-01,4,0,0,0,0,4
India,2004-03-01,3,0,0,0,0,3
India,2004-03-01,2,0,0,0,0,2
India,2004-03-01,6,0,0,0,0,6
India,2004-03-01,5,0,1,-2,0,4
India,2004-03-01,-2,0,0,0,2,0
India,2004-03-01,3,0,0,1,0,4
India,2004-03-01,0,0,0,0,2,2
India,2004-03-01,19,0,0,0,0,19
India,2004-03-01,13,0,0,3,0,16
India,2004-03-01,2,0,0,0,0,2
India,2004-03-01,8,0,0,3,0,11
India,2004-03-01,0,0,0,0,0,0
India,2004-03-01,2,0,1,3,0,6
India,2004-03-01,2,0,0,-2,0,0
India,2004-03-01,3,0,0,3,0,6
India,2004-04-01,4,0,-2,0,0,2
India,2004-04-01,1,0,0,0,0,1
India,2004-04-01,2,0,0,0,1,3
India,2004-04-01,12,0,0,6,6,24
India,2004-04-01,1,0,0,0,3,4
India,2004-04-01,1,0,0,0,0,1
India,2004-04-01,9,0,0,0,0,9
India,2004-04-01,13,0,0,7,4,24
India,2004-04-01,0,0,0,3,0,3
India,2004-04-01,0,0,0,0,2,2
India,2004-04-01,16,0,0,6,0,22
India,2004-04-01,4,0,0,3,1,8
India,2004-04-01,7,0,0,0,0,7
India,2004-04-01,0,0,0,0,3,3
India,2004-04-01,8,0,0,-4,0,4
India,2004-04-01,2,0,0,6,4,12
India,2004-04-01,4,0,0,0,0,4
India,2004-04-01,20,0,0,0,0,20
India,2004-04-01,3,0,0,-6,0,-3
India,2004-04-01,11,0,0,3,1,15
India,2004-04-01,2,0,0,0,0,2
India,2004-04-01,4,0,0,0,0,4
India,2004-04-01,9,0,0,0,2,11
India,2004-04-01,4,0,0,0,0,4
India,2004-04-01,0,0,0,0,2,2
India,2004-04-01,3,0,0,0,1,4
India,2004-04-01,17,0,0,6,0,23
India,2004-04-01,-1,0,-2,0,0,-3
India,2004-04-01,16,0,0,1,5,22
India,2004-04-01,0,0,0,1,0,1
India,2004-05-01,0,0,0,0,0,0
India,2004-05-01,2,0,0,0,1,3
India,2004-05-01,1,0,0,3,1,5
India,2004-05-01,10,0,0,0,0,10
India,2004-05-01,2,0,0,4,6,12
India,2004-05-01,9,2,0,0,0,11
India,2004-05-01,1,0,0,3,0,4
India,2004-05-01,-1,0,0,0,0,-1
India,2004-05-01,0,0,0,0,0,0
India,2004-05-01,-1,0,0,0,5,4
India,2004-05-01,9,0,0,11,1,21
India,2004-05-01,7,0,0,-2,1,6
India,2004-05-01,11,0,-2,3,0,12
India,2004-05-01,3,0,-6,-2,0,-5
India,2004-05-01,9,0,0,-2,0,7
India,2004-05-01,4,0,-2,0,0,2
India,2004-05-01,8,2,0,0,0,10
India,2004-05-01,10,0,0,0,0,10
India,2004-05-01,18,0,-4,3,1,18
India,2004-05-01,6,0,-1,3,3,11
India,2004-05-01,9,0,-2,3,0,10
India,2004-05-01,5,0,0,0,0,5
India,2004-05-01,5,0,-1,0,0,4
India,2004-05-01,4,0,-2,0,0,2
India,2004-05-01,0,0,0,0,0,0
India,2004-05-01,3,0,0,-6,0,-3
India,2004-05-01,6,0,0,-4,0,2
India,2004-05-01,1,0,0,0,0,1
India,2004-05-01,17,0,0,0,0,17
India,2004-05-01,3,0,0,-2,0,1
India,2004-05-01,3,0,0,2,0,5
India,2004-06-01,7,0,0,-2,0,5
India,2004-06-01,9,0,0,0,0,9
India,2004-06-01,3,0,0,0,0,3
India,2004-06-01,4,8,0,1,0,13
India,2004-06-01,1,0,0,0,1,2
India,2004-06-01,2,0,0,1,0,3
India,2004-06-01,1,0,0,2,0,3
India,2004-06-01,5,0,0,0,1,6
India,2004-06-01,6,0,0,-2,0,4
India,2004-06-01,37,0,0,-4,0,33
India,2004-06-01,0,0,0,0,0,0
India,2004-06-01,4,0,0,12,0,16
India,2004-06-01,7,0,0,6,0,13
India,2004-06-01,10,0,0,0,0,10
India,2004-06-01,7,0,0,0,1,8
India,2004-06-01,8,0,0,7,2,17
India,2004-06-01,6,0,0,3,1,10
India,2004-06-01,-1,0,0,0,0,-1
India,2004-06-01,1,0,0,4,0,5
India,2004-06-01,3,0,0,0,0,3
India,2004-06-01,-1,0,0,6,0,5
India,2004-06-01,7,0,0,3,-2,8
India,2004-06-01,12,0,0,0,0,12
India,2004-06-01,20,0,0,0,1,21
India,2004-06-01,2,0,0,0,2,4
India,2004-06-01,17,0,-8,0,0,9
India,2004-06-01,9,0,0,0,0,9
India,2004-06-01,2,0,0,0,1,3
India,2004-06-01,7,0,0,-2,4,9
India,2004-06-01,5,0,0,1,0,6
India,2004-07-01,-1,0,0,0,0,-1
India,2004-07-01,-1,0,0,0,3,2
India,2004-07-01,0,0,0,0,0,0
India,2004-07-01,-3,0,0,0,0,-3
India,2004-07-01,10,0,0,0,0,10
India,2004-07-01,5,0,0,0,0,5
India,2004-07-01,0,0,0,0,6,6
India,2004-07-01,0,0,0,0,2,2
India,2004-07-01,2,0,0,0,0,2
India,2004-07-01,5,0,0,0,0,5
India,2004-07-01,0,0,0,0,2,2
India,2004-07-01,4,0,0,-4,0,0
India,2004-07-01,6,0,0,0,0,6
India,2004-07-01,2,0,0,0,0,2
India,2004-07-01,0,0,0,0,1,1
India,2004-07-01,9,0,0,0,3,12
India,2004-07-01,3,0,0,1,0,4
India,2004-07-01,0,0,0,0,0,0
India,2004-07-01,5,0,0,3,0,8
India,2004-07-01,12,0,0,0,0,12
India,2004-07-01,5,4,0,0,0,9
India,2004-07-01,3,0,0,1,0,4
India,2004-07-01,-5,0,0,2,0,-3
India,2004-07-01,0,0,0,6,1,7
India,2004-07-01,4,0,0,0,0,4
India,2004-07-01,1,0,0,8,0,9
India,2004-07-01,0,0,0,0,0,0
India,2004-07-01,7,0,0,4,2,13
India,2004-07-01,0,0,0,-1,0,-1
India,2004-07-01,1,0,0,1,1,3
India,2004-07-01,0,0,0,-1,0,-1
India,2004-08-01,1,0,0,2,0,3
India,2004-08-01,2,0,0,0,0,2
India,2004-08-01,2,0,0,0,0,2
India,2004-08-01,1,0,0,3,0,4
India,2004-08-01,6,0,0,0,0,6
India,2004-08-01,2,0,0,0,2,4
India,2004-08-01,0,0,0,0,0,0
India,2004-08-01,1,0,0,31,0,32
India,2004-08-01,2,0,0,0,0,2
India,2004-08-01,1,0,0,0,0,1
India,2004-08-01,0,0,0,9,0,9
India,2004-08-01,3,0,-2,-2,0,-1
India,2004-08-01,7,0,0,-1,0,6
India,2004-08-01,0,0,0,0,0,0
India,2004-08-01,0,0,0,-2,0,-2
India,2004-08-01,0,0,0,-2,1,-1
India,2004-08-01,6,0,0,0,2,8
India,2004-08-01,4,0,0,0,0,4
India,2004-08-01,4,0,0,0,0,4
India,2004-08-01,0,0,0,0,0,0
India,2004-08-01,6,0,0,0,0,6
India,2004-08-01,-2,0,0,0,2,0
India,2004-08-01,10,0,0,0,0,10
India,2004-08-01,2,0,0,0,0,2
India,2004-08-01,-2,0,0,0,0,-2
India,2004-08-01,4,0,0,1,0,5
India,2004-08-01,-2,0,0,0,3,1
India,2004-08-01,0,0,0,0,0,0
India,2004-08-01,8,0,0,3,0,11
India,2004-08-01,2,0,0,-1,2,3
India,2004-09-01,3,0,0,-3,0,0
India,2004-09-01,5,0,0,-4,2,3
India,2004-09-01,4,0,2,-2,0,4
India,2004-09-01,0,0,0,-2,0,-2
India,2004-09-01,4,0,0,-2,0,2
India,2004-09-01,1,0,0,3,0,4
India,2004-09-01,5,0,0,0,0,5
India,2004-09-01,1,0,0,0,0,1
India,2004-09-01,11,0,0,0,0,11
India,2004-09-01,4,2,1,0,3,10
India,2004-09-01,0,0,0,0,0,0
India,2004-09-01,14,0,0,0,1,15
India,2004-09-01,12,0,0,0,2,14
India,2004-09-01,4,0,0,-2,0,2
India,2004-09-01,-2,0,0,3,0,1
India,2004-09-01,10,0,0,0,0,10
India,2004-09-01,1,0,0,0,0,1
India,2004-09-01,3,0,0,6,0,9
India,2004-09-01,4,0,-1,0,0,3
India,2004-09-01,8,0,0,0,0,8
India,2004-09-01,0,0,-2,0,0,-2
India,2004-09-01,0,0,0,4,0,4
India,2004-09-01,-3,0,0,-1,0,-4
India,2004-09-01,0,0,-2,1,0,-1
India,2004-09-01,2,0,0,15,1,18
India,2004-09-01,1,0,0,0,0,1
India,2004-09-01,8,0,0,0,0,8
India,2004-09-01,3,0,0,0,0,3
India,2004-09-01,-1,0,0,0,0,-1
India,2004-09-01,7,0,0,3,0,10
India,2004-10-01,0,0,0,0,4,4
India,2004-10-01,0,0,0,0,0,0
India,2004-10-01,1,0,0,0,0,1
India,2004-10-01,8,0,0,0,0,8
India,2004-10-01,0,0,0,0,0,0
India,2004-10-01,2,0,0,6,0,8
India,2004-10-01,7,0,0,0,0,7
India,2004-10-01,2,0,0,0,0,2
India,2004-10-01,2,0,0,1,0,3
India,2004-10-01,1,0,0,-2,0,-1
India,2004-10-01,5,0,0,0,0,5
India,2004-10-01,1,0,0,0,0,1
India,2004-10-01,2,0,0,0,0,2
India,2004-10-01,5,0,0,3,0,8
India,2004-10-01,0,0,0,0,0,0
India,2004-10-01,0,0,0,0,2,2
India,2004-10-01,0,2,0,0,0,2
India,2004-10-01,0,0,0,0,0,0
India,2004-10-01,7,0,-4,-1,0,2
India,2004-10-01,10,0,0,0,0,10
India,2004-10-01,6,0,0,3,2,11
India,2004-10-01,12,0,0,0,0,12
India,2004-10-01,-1,0,0,0,0,-1
India,2004-10-01,24,0,0,-2,0,22
India,2004-10-01,7,0,0,0,0,7
India,2004-10-01,7,0,0,0,0,7
India,2004-10-01,2,0,0,0,0,2
India,2004-10-01,9,0,0,5,0,14
India,2004-10-01,0,0,0,9,0,9
India,2004-10-01,2,0,0,6,0,8
India,2004-10-01,4,0,0,0,0,4
India,2004-11-01,3,0,0,6,1,10
India,2004-11-01,9,0,0,-4,1,6
India,2004-11-01,2,0,0,0,0,2
India,2004-11-01,18,0,0,4,0,22
India,2004-11-01,2,0,0,-2,1,1
India,2004-11-01,0,0,0,3,0,3
India,2004-11-01,8,0,0,0,4,12
India,2004-11-01,4,0,0,6,3,13
India,2004-11-01,5,0,0,3,4,12
India,2004-11-01,-2,0,0,0,1,-1
India,2004-11-01,11,0,-1,0,6,16
India,2004-11-01,8,0,0,-1,0,7
India,2004-11-01,1,0,0,0,0,1
India,2004-11-01,0,0,0,0,0,0
India,2004-11-01,8,0,-8,0,0,0
India,2004-11-01,7,0,0,0,0,7
India,2004-11-01,7,2,0,0,0,9
India,2004-11-01,8,0,0,0,0,8
India,2004-11-01,2,0,0,6,0,8
India,2004-11-01,3,0,0,0,0,3
India,2004-11-01,18,0,0,3,0,21
India,2004-11-01,3,0,0,6,0,9
India,2004-11-01,0,0,0,0,0,0
India,2004-11-01,0,0,0,0,0,0
India,2004-11-01,16,0,0,0,1,17
India,2004-11-01,2,0,0,-2,3,3
India,2004-11-01,10,0,0,-4,0,6
India,2004-11-01,14,0,1,0,1,16
India,2004-11-01,14,0,0,-3,3,14
India,2004-11-01,21,0,0,3,0,24
India,2004-12-01,3,0,0,6,0,9
India,2004-12-01,1,0,0,0,1,2
India,2004-12-01,1,0,0,6,0,7
India,2004-12-01,7,0,0,-2,0,5
India,2004-12-01,1,0,-1,0,0,0
India,2004-12-01,5,0,0,0,0,5
India,2004-12-01,12,0,0,1,1,14
India,2004-12-01,10,0,0,0,0,10
India,2004-12-01,15,0,0,0,0,15
India,2004-12-01,17,0,0,3,2,22
India,2004-12-01,8,0,0,0,1,9
India,2004-12-01,0,0,0,0,0,0
India,2004-12-01,1,2,0,0,0,3
India,2004-12-01,9,0,0,0,0,9
India,2004-12-01,4,0,1,3,2,10
India,2004-12-01,9,0,0,7,0,16
India,2004-12-01,4,0,0,3,0,7
India,2004-12-01,0,0,0,0,-2,-2
India,2004-12-01,1,0,0,0,1,2
India,2004-12-01,6,0,0,3,0,9
India,2004-12-01,4,2,-4,0,0,2
India,2004-12-01,0,0,0,0,0,0
India,2004-12-01,5,0,0,0,0,5
India,2004-12-01,-3,0,0,0,0,-3
India,2004-12-01,8,0,0,0,0,8
India,2004-12-01,7,0,0,3,0,10
India,2004-12-01,3,2,0,0,0,5
India,2004-12-01,19,4,0,0,3,26
India,2004-12-01,4,0,0,-2,1,3
India,2004-12-01,1,0,0,1,0,2
India,2004-12-01,32,0,0,0,3,35
Iran,2004-01-01,3,0,0,0,0,3
Iran,2004-01-01,6,0,0,7,0,13
Iran,2004-01-01,21,0,0,13,0,34
Iran,2004-01-01,4,0,0,1,0,5
Iran,2004-01-01,20,2,-1,30,5,56
Iran,2004-01-01,10,4,0,-4,5,15
Iran,2004-01-01,19,0,0,25,5,49
Iran,2004-01-01,7,6,-2,0,0,11
Iran,2004-01-01,17,0,1,15,1,34
Iran,2004-01-01,19,0,0,6,0,25
Iran,2004-01-01,17,0,1,-1,1,18
Iran,2004-01-01,11,0,0,0,1,12
Iran,2004-01-01,28,4,2,-5,2,31
Iran,2004-01-01,16,2,-2,21,4,41
Iran,2004-01-01,27,0,0,15,5,47
Iran,2004-01-01,4,0,0,3,0,7
Iran,2004-01-01,11,0,-4,13,3,23
Iran,2004-01-01,13,0,0,3,0,16
Iran,2004-01-01,6,0,0,13,2,21
Iran,2004-01-01,15,0,0,28,5,48
Iran,2004-01-01,51,0,-1,3,2,55
Iran,2004-01-01,42,0,1,12,2,57
Iran,2004-01-01,16,4,1,13,7,41
Iran,2004-01-01,5,0,-3,3,3,8
Iran,2004-01-01,11,0,0,11,0,22
Iran,2004-01-01,12,0,0,26,4,42
Iran,2004-01-01,65,0,0,-2,20,83
Iran,2004-01-01,20,0,-2,16,4,38
Iran,2004-01-01,22,0,1,4,3,30
Iran,2004-01-01,5,0,0,-1,0,4
Iran,2004-01-01,20,0,-3,9,5,31
Iran,2004-02-01,52,0,-2,3,3,56
Iran,2004-02-01,8,0,0,9,2,19
Iran,2004-02-01,21,2,0,24,2,49
Iran,2004-02-01,22,0,-4,9,1,28
Iran,2004-02-01,13,0,0,25,0,38
Iran,2004-02-01,2,0,0,3,4,9
Iran,2004-02-01,15,0,0,2,1,18
Iran,2004-02-01,27,0,-2,1,0,26
Iran,2004-02-01,3,0,0,1,3,7
Iran,2004-02-01,13,0,0,0,0,13
Iran,2004-02-01,8,2,0,7,0,17
Iran,2004-02-01,13,0,-1,2,0,14
Iran,2004-02-01,27,0,2,-2,2,29
Iran,2004-02-01,21,0,3,15,4,43
Iran,2004-02-01,27,0,0,2,0,29
Iran,2004-02-01,15,0,3,10,0,28
Iran,2004-02-01,23,0,-4,-1,1,19
Iran,2004-02-01,13,0,0,15,0,28
Iran,2004-02-01,23,0,-1,4,4,30
Iran,2004-02-01,2,0,0,6,2,10
Iran,2004-02-01,8,0,0,0,2,10
Iran,2004-02-01,3,0,-3,3,10,13
Iran,2004-02-01,19,2,-1,1,5,26
Iran,2004-02-01,18,0,0,-1,1,18
Iran,2004-02-01,30,0,0,-4,1,27
Iran,2004-02-01,14,0,0,1,8,23
Iran,2004-02-01,-1,0,-4,24,0,19
Iran,2004-02-01,12,0,0,12,0,24
Iran,2004-02-01,0,0,1,-1,1,1
Iran,2004-03-01,10,0,0,0,0,10
Iran,2004-03-01,65,0,0,13,24,102
Iran,2004-03-01,59,0,0,12,7,78
Iran,2004-03-01,14,0,0,12,3,29
Iran,2004-03-01,4,0,0,0,0,4
Iran,2004-03-01,6,0,0,0,2,8
Iran,2004-03-01,17,0,0,9,3,29
Iran,2004-03-01,22,0,0,4,1,27
Iran,2004-03-01,1,0,-1,6,1,7
Iran,2004-03-01,28,0,-9,1,0,20
Iran,2004-03-01,25,0,0,8,0,33
Iran,2004-03-01,-1,0,0,-1,4,2
Iran,2004-03-01,17,0,-2,0,0,15
Iran,2004-03-01,7,0,0,4,1,12
Iran,2004-03-01,10,2,0,4,0,16
Iran,2004-03-01,13,0,0,3,0,16
Iran,2004-03-01,11,0,0,3,3,17
Iran,2004-03-01,17,0,0,1,0,18
Iran,2004-03-01,7,0,0,0,2,9
Iran,2004-03-01,-1,0,0,4,1,4
Iran,2004-03-01,9,0,0,6,1,16
Iran,2004-03-01,15,0,0,-8,3,10
Iran,2004-03-01,8,0,0,-1,0,7
Iran,2004-03-01,6,0,0,0,8,14
Iran,2004-03-01,12,0,0,0,0,12
Iran,2004-03-01,-2,0,0,-4,2,-4
Iran,2004-03-01,15,0,0,0,0,15
Iran,2004-03-01,-3,0,0,0,0,-3
Iran,2004-03-01,-1,0,0,0,4,3
Iran,2004-03-01,6,0,0,0,0,6
Iran,2004-03-01,3,0,0,0,0,3
Iran,2004-04-01,13,0,-1,12,1,25
Iran,2004-04-01,0,0,0,6,0,6
Iran,2004-04-01,10,0,0,8,1,19
Iran,2004-04-01,4,0,0,9,2,15
Iran,2004-04-01,16,0,0,-4,0,12
Iran,2004-04-01,12,0,0,18,0,30
Iran,2004-04-01,59,0,-2,13,0,70
Iran,2004-04-01,12,0,-6,-2,0,4
Iran,2004-04-01,38,0,0,6,4,48
Iran,2004-04-01,17,0,-2,18,1,34
Iran,2004-04-01,-4,0,0,-3,0,-7
Iran,2004-04-01,11,0,-4,1,0,8
Iran,2004-04-01,0,0,0,3,0,3
Iran,2004-04-01,4,0,0,-5,1,0
Iran,2004-04-01,45,2,-4,3,0,46
Iran,2004-04-01,17,0,0,6,0,23
Iran,2004-04-01,10,0,0,-2,0,8
Iran,2004-04-01,16,0,-2,2,0,16
Iran,2004-04-01,15,0,-4,0,0,11
Iran,2004-04-01,6,0,0,18,2,26
Iran,2004-04-01,3,2,0,0,3,8
Iran,2004-04-01,44,0,0,14,0,58
Iran,2004-04-01,5,0,0,-4,2,3
Iran,2004-04-01,6,0,0,9,2,17
Iran,2004-04-01,15,0,1,-2,1,15
Iran,2004-04-01,14,0,0,3,0,17
Iran,2004-04-01,33,0,0,4,2,39
Iran,2004-04-01,13,0,0,7,2,22
Iran,2004-04-01,16,0,0,0,0,16
Iran,2004-04-01,8,0,0,1,3,12
Iran,2004-05-01,0,0,0,0,0,0
Iran,2004-05-01,11,0,0,-2,0,9
Iran,2004-05-01,11,0,0,0,2,13
Iran,2004-05-01,6,0,0,6,2,14
Iran,2004-05-01,31,0,0,6,0,37
Iran,2004-05-01,19,0,0,13,2,34
Iran,2004-05-01,3,0,0,-1,0,2
Iran,2004-05-01,13,0,0,-16,1,-2
Iran,2004-05-01,5,0,0,-2,0,3
Iran,2004-05-01,10,0,1,6,0,17
Iran,2004-05-01,14,0,0,0,0,14
Iran,2004-05-01,26,0,0,-1,7,32
Iran,2004-05-01,4,0,3,10,0,17
Iran,2004-05-01,30,0,0,0,4,34
Iran,2004-05-01,3,0,1,0,3,7
Iran,2004-05-01,9,2,0,3,0,14
Iran,2004-05-01,8,0,0,1,2,11
Iran,2004-05-01,12,0,2,15,0,29
Iran,2004-05-01,6,0,0,6,0,12
Iran,2004-05-01,5,0,1,10,0,16
Iran,2004-05-01,30,0,0,6,8,44
Iran,2004-05-01,14,0,0,-2,9,21
Iran,2004-05-01,4,0,0,0,2,6
Iran,2004-05-01,3,0,0,0,0,3
Iran,2004-05-01,11,0,1,-8,0,4
Iran,2004-05-01,12,0,0,0,0,12
Iran,2004-05-01,31,0,1,1,2,35
Iran,2004-05-01,9,0,0,12,1,22
Iran,2004-05-01,16,0,0,0,0,16
Iran,2004-05-01,12,0,0,13,0,25
Iran,2004-05-01,17,0,0,0,4,21
Iran,2004-06-01,16,0,0,3,0,19
Iran,2004-06-01,14,0,0,0,4,18
Iran,2004-06-01,3,0,0,1,1,5
Iran,2004-06-01,-2,0,0,-2,0,-4
Iran,2004-06-01,0,0,0,0,0,0
Iran,2004-06-01,6,0,0,3,1,10
Iran,2004-06-01,6,0,0,15,2,23
Iran,2004-06-01,6,0,0,-4,2,4
Iran,2004-06-01,4,0,0,-2,0,2
Iran,2004-06-01,6,0,2,3,0,11
Iran,2004-06-01,5,0,0,0,0,5
Iran,2004-06-01,8,0,0,0,0,8
Iran,2004-06-01,11,0,0,3,0,14
Iran,2004-06-01,18,0,0,-10,0,8
Iran,2004-06-01,19,0,1,-5,0,15
Iran,2004-06-01,20,0,0,5,7,32
Iran,2004-06-01,7,0,0,4,3,14
Iran,2004-06-01,6,0,0,0,4,10
Iran,2004-06-01,8,0,0,18,4,30
Iran,2004-06-01,12,0,-4,3,3,14
Iran,2004-06-01,10,0,0,3,0,13
Iran,2004-06-01,9,0,0,28,0,37
Iran,2004-06-01,14,0,1,6,4,25
Iran,2004-06-01,19,0,0,-2,0,17
Iran,2004-06-01,8,2,0,0,0,10
Iran,2004-06-01,8,0,0,6,0,14
Iran,2004-06-01,20,0,0,6,2,28
Iran,2004-06-01,29,0,0,12,0,41
Iran,2004-06-01,13,0,0,-3,0,10
Iran,2004-06-01,6,0,1,1,2,10
Iran,2004-07-01,14,0,0,6,1,21
Iran,2004-07-01,15,0,0,3,0,18
Iran,2004-07-01,9,0,0,2,0,11
Iran,2004-07-01,5,0,0,0,0,5
Iran,2004-07-01,14,0,0,15,5,34
Iran,2004-07-01,8,0,0,3,1,12
Iran,2004-07-01,6,0,0,1,3,10
Iran,2004-07-01,15,0,0,7,0,22
Iran,2004-07-01,12,0,0,12,0,24
Iran,2004-07-01,1,0,0,3,0,4
Iran,2004-07-01,5,0,1,3,2,11
Iran,2004-07-01,7,0,0,0,4,11
Iran,2004-07-01,2,0,0,0,2,4
Iran,2004-07-01,25,0,0,0,0,25
Iran,2004-07-01,0,0,0,15,0,15
Iran,2004-07-01,2,0,0,0,0,2
Iran,2004-07-01,19,0,0,3,4,26
Iran,2004-07-01,8,0,0,5,1,14
Iran,2004-07-01,17,0,0,12,2,31
Iran,2004-07-01,17,0,0,3,2,22
Iran,2004-07-01,13,0,0,12,0,25
Iran,2004-07-01,14,0,0,5,0,19
Iran,2004-07-01,8,0,0,1,0,9
Iran,2004-07-01,4,0,0,9,0,13
Iran,2004-07-01,12,0,0,0,0,12
Iran,2004-07-01,18,0,0,-2,0,16
Iran,2004-07-01,3,0,3,6,0,12
Iran,2004-07-01,18,0,0,4,0,22
Iran,2004-07-01,14,0,0,9,4,27
Iran,2004-07-01,0,0,0,3,0,3
Iran,2004-07-01,6,0,0,0,1,7
Iran,2004-08-01,-3,0,0,0,2,-1
Iran,2004-08-01,0,0,0,0,0,0
Iran,2004-08-01,9,0,0,0,0,9
Iran,2004-08-01,9,0,0,12,0,21
Iran,2004-08-01,-3,0,0,3,0,0
Iran,2004-08-01,18,0,0,0,4,22
Iran,2004-08-01,8,0,0,6,6,20
Iran,2004-08-01,4,0,0,15,0,19
Iran,2004-08-01,17,0,0,-4,0,13
Iran,2004-08-01,14,0,0,3,2,19
Iran,2004-08-01,6,0,0,15,0,21
Iran,2004-08-01,14,0,0,0,0,14
Iran,2004-08-01,1,0,0,0,1,2
Iran,2004-08-01,4,0,0,3,0,7
Iran,2004-08-01,12,0,0,-4,0,8
Iran,2004-08-01,5,0,0,1,4,10
Iran,2004-08-01,10,0,0,6,0,16
Iran,2004-08-01,4,0,0,3,1,8
Iran,2004-08-01,18,0,0,3,0,21
Iran,2004-08-01,27,0,0,-6,0,21
Iran,2004-08-01,13,0,0,9,0,22
Iran,2004-08-01,0,0,0,0,0,0
Iran,2004-08-01,2,0,0,0,0,2
Iran,2004-08-01,10,0,0,9,0,19
Iran,2004-08-01,5,0,0,0,0,5
Iran,2004-08-01,9,0,0,6,0,15
Iran,2004-08-01,4,0,0,0,0,4
Iran,2004-08-01,10,0,0,0,1,11
Iran,2004-08-01,2,0,0,17,0,19
Iran,2004-08-01,4,0,0,3,0,7
Iran,2004-08-01,23,0,0,27,0,50
Iran,2004-09-01,9,0,0,24,3,36
Iran,2004-09-01,0,0,0,-6,0,-6
Iran,2004-09-01,19,0,0,6,0,25
Iran,2004-09-01,12,0,0,12,1,25
Iran,2004-09-01,10,0,0,12,0,22
Iran,2004-09-01,0,0,0,0,0,0
Iran,2004-09-01,7,0,0,7,0,14
Iran,2004-09-01,10,0,0,7,0,17
Iran,2004-09-01,6,0,0,0,0,6
Iran,2004-09-01,26,0,0,0,5,31
Iran,2004-09-01,5,0,0,0,3,8
Iran,2004-09-01,6,0,0,0,0,6
Iran,2004-09-01,-1,0,0,1,0,0
Iran,2004-09-01,29,0,0,8,8,45
Iran,2004-09-01,12,0,0,4,0,16
Iran,2004-09-01,7,0,0,8,0,15
Iran,2004-09-01,28,0,0,1,0,29
Iran,2004-09-01,19,0,0,6,0,25
Iran,2004-09-01,3,0,0,9,0,12
Iran,2004-09-01,9,0,0,-1,1,9
Iran,2004-09-01,10,0,1,4,0,15
Iran,2004-09-01,15,0,2,10,5,32
Iran,2004-09-01,5,0,0,12,3,20
Iran,2004-09-01,5,0,-2,8,0,11
Iran,2004-09-01,4,0,1,5,1,11
Iran,2004-09-01,6,0,0,-10,0,-4
Iran,2004-09-01,7,0,2,-15,0,-6
Iran,2004-09-01,-6,0,0,-18,2,-22
Iran,2004-09-01,3,0,0,7,0,10
Iran,2004-09-01,6,0,0,6,0,12
Iran,2004-10-01,9,0,0,4,1,14
Iran,2004-10-01,4,0,0,0,0,4
Iran,2004-10-01,11,0,0,7,3,21
Iran,2004-10-01,21,0,-10,-1,1,11
Iran,2004-10-01,16,0,-1,6,2,23
Iran,2004-10-01,1,0,0,0,3,4
Iran,2004-10-01,16,0,0,-6,1,11
Iran,2004-10-01,3,2,0,0,1,6
Iran,2004-10-01,19,0,2,6,2,29
Iran,2004-10-01,7,0,1,4,0,12
Iran,2004-10-01,9,0,0,12,0,21
Iran,2004-10-01,12,0,-2,15,0,25
Iran,2004-10-01,13,0,0,30,0,43
Iran,2004-10-01,6,0,1,0,0,7
Iran,2004-10-01,-2,0,0,9,0,7
Iran,2004-10-01,12,0,0,9,3,24
Iran,2004-10-01,1,0,0,1,0,2
Iran,2004-10-01,23,0,0,9,2,34
Iran,2004-10-01,16,0,0,18,2,36
Iran,2004-10-01,-1,0,1,10,0,10
Iran,2004-10-01,13,0,0,0,6,19
Iran,2004-10-01,-2,0,0,1,1,0
Iran,2004-10-01,0,0,0,0,2,2
Iran,2004-10-01,20,0,0,0,1,21
Iran,2004-10-01,4,0,0,8,0,12
Iran,2004-10-01,5,0,0,6,0,11
Iran,2004-10-01,-2,0,1,4,1,4
Iran,2004-10-01,6,0,0,8,1,15
Iran,2004-10-01,-1,0,0,0,0,-1
Iran,2004-10-01,15,0,0,5,4,24
Iran,2004-10-01,18,0,0,7,0,25
Iran,2004-11-01,11,0,0,13,1,25
Iran,2004-11-01,18,0,0,0,2,20
Iran,2004-11-01,7,0,1,0,0,8
Iran,2004-11-01,9,0,0,6,0,15
Iran,2004-11-01,10,0,0,0,0,10
Iran,2004-11-01,3,0,-4,0,0,-1
Iran,2004-11-01,1,0,0,0,0,1
Iran,2004-11-01,1,0,1,6,0,8
Iran,2004-11-01,14,0,0,9,0,23
Iran,2004-11-01,11,0,0,23,2,36
Iran,2004-11-01,3,0,0,0,0,3
Iran,2004-11-01,1,0,0,11,0,12
Iran,2004-11-01,0,0,0,0,0,0
Iran,2004-11-01,5,0,0,18,0,23
Iran,2004-11-01,9,0,7,36,1,53
Iran,2004-11-01,2,0,0,4,0,6
Iran,2004-11-01,7,0,0,13,0,20
Iran,2004-11-01,15,0,0,0,1,16
Iran,2004-11-01,0,2,0,3,2,7
Iran,2004-11-01,3,0,0,9,0,12
Iran,2004-11-01,9,0,-2,3,2,12
Iran,2004-11-01,14,0,-2,1,0,13
Iran,2004-11-01,-7,0,0,2,0,-5
Iran,2004-11-01,11,0,0,0,2,13
Iran,2004-11-01,7,0,0,3,5,15
Iran,2004-11-01,-2,0,0,-10,0,-12
Iran,2004-11-01,8,0,0,5,0,13
Iran,2004-11-01,4,0,0,0,2,6
Iran,2004-11-01,18,0,0,0,0,18
Iran,2004-11-01,-1,0,0,9,1,9
Iran,2004-12-01,17,0,0,15,0,32
Iran,2004-12-01,-1,0,0,3,1,3
Iran,2004-12-01,13,0,0,9,0,22
Iran,2004-12-01,6,0,0,0,0,6
Iran,2004-12-01,12,0,0,11,0,23
Iran,2004-12-01,-2,0,0,0,0,-2
Iran,2004-12-01,12,0,0,36,4,52
Iran,2004-12-01,5,0,0,3,0,8
Iran,2004-12-01,4,0,-2,3,0,5
Iran,2004-12-01,9,0,0,-10,0,-1
Iran,2004-12-01,12,0,0,7,3,22
Iran,2004-12-01,25,0,0,6,3,34
Iran,2004-12-01,8,0,0,6,2,16
Iran,2004-12-01,7,0,0,1,0,8
Iran,2004-12-01,16,0,-2,13,0,27
Iran,2004-12-01,18,0,0,0,1,19
Iran,2004-12-01,1,0,1,0,0,2
Iran,2004-12-01,3,0,0,0,0,3
Iran,2004-12-01,21,0,0,3,0,24
Iran,2004-12-01,35,0,0,3,1,39
Iran,2004-12-01,0,0,0,3,2,5
Iran,2004-12-01,7,0,2,9,0,18
Iran,2004-12-01,23,0,1,9,5,38
Iran,2004-12-01,-2,0,0,0,0,-2
Iran,2004-12-01,21,0,0,18,2,41
Iran,2004-12-01,4,0,0,0,0,4
Iran,2004-12-01,29,0,0,3,6,38
Iran,2004-12-01,1,0,1,0,3,5
Iran,2004-12-01,-1,0,-2,3,0,0
Iran,2004-12-01,4,0,0,6,0,10
Iran,2004-12-01,2,0,0,12,2,16
Iraq,2004-01-01,41,0,1,12,1,55
Iraq,2004-01-01,39,0,2,16,1,58
Iraq,2004-01-01,28,0,0,-4,3,27
Iraq,2004-01-01,67,0,1,31,7,106
Iraq,2004-01-01,60,0,2,26,8,96
Iraq,2004-01-01,86,0,-10,-8,10,78
Iraq,2004-01-01,56,2,-1,25,10,92
Iraq,2004-01-01,53,6,0,17,3,79
Iraq,2004-01-01,38,0,-2,25,7,68
Iraq,2004-01-01,36,0,0,13,10,59
Iraq,2004-01-01,62,0,5,6,6,79
Iraq,2004-01-01,99,2,0,4,1,106
Iraq,2004-01-01,71,2,-2,8,9,88
Iraq,2004-01-01,38,0,-1,26,5,68
Iraq,2004-01-01,75,2,-1,6,3,85
Iraq,2004-01-01,50,0,0,3,7,60
Iraq,2004-01-01,35,0,0,-1,9,43
Iraq,2004-01-01,32,0,1,3,4,40
Iraq,2004-01-01,84,0,3,12,2,101
Iraq,2004-01-01,46,2,-6,19,5,66
Iraq,2004-01-01,101,0,-9,5,4,101
Iraq,2004-01-01,72,0,2,17,19,110
Iraq,2004-01-01,56,4,-3,16,12,85
Iraq,2004-01-01,41,0,-1,18,4,62
Iraq,2004-01-01,53,0,-7,24,5,75
Iraq,2004-01-01,78,0,-4,33,7,114
Iraq,2004-01-01,92,0,-8,32,9,125
Iraq,2004-01-01,61,0,0,12,14,87
Iraq,2004-01-01,118,6,-7,9,17,143
Iraq,2004-01-01,126,0,-6,39,6,165
Iraq,2004-01-01,60,0,-4,10,13,79
Iraq,2004-02-01,107,0,0,-1,9,115
Iraq,2004-02-01,71,0,-2,17,6,92
Iraq,2004-02-01,134,0,-1,18,16,167
Iraq,2004-02-01,175,2,1,15,18,211
Iraq,2004-02-01,102,0,-9,10,16,119
Iraq,2004-02-01,78,0,-4,32,11,117
Iraq,2004-02-01,43,6,-8,1,5,47
Iraq,2004-02-01,47,0,-3,2,10,56
Iraq,2004-02-01,56,0,1,20,33,110
Iraq,2004-02-01,89,0,0,5,7,101
Iraq,2004-02-01,37,0,1,8,4,50
Iraq,2004-02-01,47,2,0,-1,6,54
Iraq,2004-02-01,87,0,0,3,5,95
Iraq,2004-02-01,88,0,1,18,10,117
Iraq,2004-02-01,64,2,3,25,11,105
Iraq,2004-02-01,61,0,-5,-9,6,53
Iraq,2004-02-01,81,2,-3,1,4,85
Iraq,2004-02-01,63,2,1,2,13,81
Iraq,2004-02-01,67,2,4,5,9,87
Iraq,2004-02-01,52,0,2,5,5,64
Iraq,2004-02-01,41,0,1,27,3,72
Iraq,2004-02-01,60,0,-2,3,6,67
Iraq,2004-02-01,49,4,1,-2,10,62
Iraq,2004-02-01,82,0,3,27,9,121
Iraq,2004-02-01,63,0,1,25,11,100
Iraq,2004-02-01,31,0,1,12,0,44
Iraq,2004-02-01,59,2,0,12,9,82
Iraq,2004-02-01,34,2,1,0,4,41
Iraq,2004-02-01,97,0,-3,4,2,100
Iraq,2004-03-01,58,0,-3,4,3,62
Iraq,2004-03-01,101,0,0,17,39,157
Iraq,2004-03-01,79,0,0,17,9,105
Iraq,2004-03-01,84,0,-9,26,26,127
Iraq,2004-03-01,47,0,-4,43,4,90
Iraq,2004-03-01,40,2,0,10,6,58
Iraq,2004-03-01,34,0,2,-4,15,47
Iraq,2004-03-01,59,0,0,-15,13,57
Iraq,2004-03-01,51,0,-1,23,10,83
Iraq,2004-03-01,57,0,3,5,4,69
Iraq,2004-03-01,70,0,-4,0,6,72
Iraq,2004-03-01,70,0,-2,22,4,94
Iraq,2004-03-01,26,0,0,12,8,46
Iraq,2004-03-01,54,0,-2,22,10,84
Iraq,2004-03-01,139,0,-2,7,20,164
Iraq,2004-03-01,97,2,5,0,8,112
Iraq,2004-03-01,121,2,0,-1,15,137
Iraq,2004-03-01,65,0,-3,24,32,118
Iraq,2004-03-01,79,0,1,4,32,116
Iraq,2004-03-01,115,0,-1,19,43,176
Iraq,2004-03-01,53,0,0,28,21,102
Iraq,2004-03-01,91,4,-2,2,18,113
Iraq,2004-03-01,86,0,0,-5,6,87
Iraq,2004-03-01,64,0,2,-1,11,76
Iraq,2004-03-01,56,0,-4,14,15,81
Iraq,2004-03-01,45,0,-4,-4,17,54
Iraq,2004-03-01,65,2,1,-3,5,70
Iraq,2004-03-01,109,0,-2,2,10,119
Iraq,2004-03-01,32,0,-2,-1,3,32
Iraq,2004-03-01,43,0,-2,6,2,49
Iraq,2004-03-01,40,4,-2,0,11,53
Iraq,2004-04-01,117,0,1,35,12,165
Iraq,2004-04-01,84,4,-2,-3,10,93
Iraq,2004-04-01,32,0,-1,-6,6,31
Iraq,2004-04-01,57,0,0,20,10,87
Iraq,2004-04-01,116,0,0,-3,12,125
Iraq,2004-04-01,142,4,0,31,10,187
Iraq,2004-04-01,205,0,1,53,2,261
Iraq,2004-04-01,207,0,-18,76,26,291
Iraq,2004-04-01,186,6,10,54,29,285
Iraq,2004-04-01,84,6,-4,21,20,127
Iraq,2004-04-01,96,2,1,6,5,110
Iraq,2004-04-01,117,0,-1,31,11,158
Iraq,2004-04-01,162,0,2,45,13,222
Iraq,2004-04-01,170,8,-7,59,24,254
Iraq,2004-04-01,130,0,-10,71,13,204
Iraq,2004-04-01,109,0,1,53,12,175
Iraq,2004-04-01,119,4,-2,16,8,145
Iraq,2004-04-01,107,6,-2,77,11,199
Iraq,2004-04-01,143,0,8,41,8,200
Iraq,2004-04-01,45,0,-1,24,8,76
Iraq,2004-04-01,189,2,-7,22,16,222
Iraq,2004-04-01,99,0,5,31,12,147
Iraq,2004-04-01,194,0,-5,2,13,204
Iraq,2004-04-01,91,2,-2,13,10,114
Iraq,2004-04-01,156,2,-2,3,4,163
Iraq,2004-04-01,110,4,-3,42,6,159
Iraq,2004-04-01,85,0,0,34,11,130
Iraq,2004-04-01,143,4,-2,24,12,181
Iraq,2004-04-01,197,0,-14,13,16,212
Iraq,2004-04-01,139,1,0,10,3,153
Iraq,2004-05-01,88,2,0,19,11,120
Iraq,2004-05-01,88,0,-4,36,17,137
Iraq,2004-05-01,96,0,0,47,26,169
Iraq,2004-05-01,66,0,-2,68,32,164
Iraq,2004-05-01,86,2,0,67,50,205
Iraq,2004-05-01,97,0,-8,46,18,153
Iraq,2004-05-01,105,2,-9,97,32,227
Iraq,2004-05-01,78,4,-5,53,21,151
Iraq,2004-05-01,71,0,0,47,37,155
Iraq,2004-05-01,148,2,-6,65,48,257
Iraq,2004-05-01,143,0,-5,89,42,269
Iraq,2004-05-01,159,2,-3,145,49,352
Iraq,2004-05-01,111,0,4,155,43,313
Iraq,2004-05-01,116,0,-11,98,24,227
Iraq,2004-05-01,93,0,-5,52,15,155
Iraq,2004-05-01,112,0,-1,20,30,161
Iraq,2004-05-01,142,0,-8,21,23,178
Iraq,2004-05-01,143,0,-4,50,27,216
Iraq,2004-05-01,120,0,-2,57,41,216
Iraq,2004-05-01,134,0,1,53,32,220
Iraq,2004-05-01,146,0,1,34,35,216
Iraq,2004-05-01,51,0,1,41,19,112
Iraq,2004-05-01,133,0,0,47,2,182
Iraq,2004-05-01,118,0,-1,45,20,182
Iraq,2004-05-01,81,16,-8,29,38,156
Iraq,2004-05-01,73,6,3,20,12,114
Iraq,2004-05-01,105,2,-1,46,19,171
Iraq,2004-05-01,101,0,-2,56,5,160
Iraq,2004-05-01,49,0,0,19,10,78
Iraq,2004-05-01,93,0,-2,19,6,116
Iraq,2004-05-01,77,0,-6,7,17,95
Iraq,2004-06-01,107,8,3,37,17,172
Iraq,2004-06-01,58,8,2,8,17,93
Iraq,2004-06-01,141,0,-15,59,20,205
Iraq,2004-06-01,100,0,-2,28,28,154
Iraq,2004-06-01,67,0,-1,22,21,109
Iraq,2004-06-01,81,0,-5,8,6,90
Iraq,2004-06-01,83,0,-11,12,13,97
Iraq,2004-06-01,74,0,0,19,22,115
Iraq,2004-06-01,126,2,-2,7,22,155
Iraq,2004-06-01,72,2,-9,9,18,92
Iraq,2004-06-01,90,0,-1,5,14,108
Iraq,2004-06-01,37,0,-2,17,5,57
Iraq,2004-06-01,61,0,-1,12,7,79
Iraq,2004-06-01,68,0,-6,4,9,75
Iraq,2004-06-01,69,0,-6,14,14,91
Iraq,2004-06-01,52,0,1,38,8,99
Iraq,2004-06-01,101,0,1,55,16,173
Iraq,2004-06-01,42,0,-5,14,7,58
Iraq,2004-06-01,54,2,-1,20,3,78
Iraq,2004-06-01,66,0,0,15,17,98
Iraq,2004-06-01,104,2,1,79,6,192
Iraq,2004-06-01,83,0,6,38,6,133
Iraq,2004-06-01,132,2,-4,32,15,177
Iraq,2004-06-01,87,0,-3,35,13,132
Iraq,2004-06-01,164,14,1,57,26,262
Iraq,2004-06-01,103,2,1,28,15,149
Iraq,2004-06-01,93,4,0,52,13,162
Iraq,2004-06-01,129,2,-20,25,41,177
Iraq,2004-06-01,122,4,-4,105,18,245
Iraq,2004-06-01,133,2,-10,34,6,165
Iraq,2004-07-01,48,0,-6,11,19,72
Iraq,2004-07-01,118,0,-3,41,5,161
Iraq,2004-07-01,14,0,1,11,2,28
Iraq,2004-07-01,24,0,1,38,2,65
Iraq,2004-07-01,28,2,-1,15,7,51
Iraq,2004-07-01,85,0,-1,27,6,117
Iraq,2004-07-01,56,4,2,54,9,125
Iraq,2004-07-01,31,0,-6,44,6,75
Iraq,2004-07-01,42,0,-4,13,5,56
Iraq,2004-07-01,113,0,-2,32,11,154
Iraq,2004-07-01,44,0,-1,43,10,96
Iraq,2004-07-01,39,0,1,15,5,60
Iraq,2004-07-01,19,2,2,34,0,57
Iraq,2004-07-01,53,0,-2,38,17,106
Iraq,2004-07-01,57,0,-2,28,15,98
Iraq,2004-07-01,18,0,3,6,8,35
Iraq,2004-07-01,-4,0,-2,8,5,7
Iraq,2004-07-01,4,0,0,13,8,25
Iraq,2004-07-01,29,0,-1,36,7,71
Iraq,2004-07-01,52,0,0,45,11,108
Iraq,2004-07-01,32,2,2,14,1,51
Iraq,2004-07-01,69,4,-2,10,7,88
Iraq,2004-07-01,41,0,-2,53,6,98
Iraq,2004-07-01,32,0,-2,53,4,87
Iraq,2004-07-01,28,0,2,23,8,61
Iraq,2004-07-01,37,4,1,55,7,104
Iraq,2004-07-01,57,0,1,29,6,93
Iraq,2004-07-01,98,0,1,25,16,140
Iraq,2004-07-01,164,6,-2,46,8,222
Iraq,2004-07-01,62,0,1,48,9,120
Iraq,2004-07-01,65,0,0,-16,16,65
Iraq,2004-08-01,66,0,-8,-4,12,66
Iraq,2004-08-01,140,0,-1,5,3,147
Iraq,2004-08-01,43,4,0,14,5,66
Iraq,2004-08-01,62,2,-2,16,11,89
Iraq,2004-08-01,92,2,-2,20,1,113
Iraq,2004-08-01,73,0,0,31,1,105
Iraq,2004-08-01,42,0,-1,27,6,74
Iraq,2004-08-01,26,0,0,12,6,44
Iraq,2004-08-01,114,0,2,27,7,150
Iraq,2004-08-01,75,0,-3,43,6,121
Iraq,2004-08-01,67,0,-1,47,13,126
Iraq,2004-08-01,48,0,0,29,14,91
Iraq,2004-08-01,63,2,-8,31,5,93
Iraq,2004-08-01,49,4,0,38,3,94
Iraq,2004-08-01,78,0,0,43,8,129
Iraq,2004-08-01,86,0,3,22,19,130
Iraq,2004-08-01,106,0,1,40,5,152
Iraq,2004-08-01,160,0,0,13,10,183
Iraq,2004-08-01,101,0,0,43,16,160
Iraq,2004-08-01,53,0,1,10,17,81
Iraq,2004-08-01,33,0,1,28,10,72
Iraq,2004-08-01,58,0,1,17,8,84
Iraq,2004-08-01,91,0,0,59,12,162
Iraq,2004-08-01,83,0,0,30,8,121
Iraq,2004-08-01,79,4,-1,107,15,204
Iraq,2004-08-01,32,0,0,46,13,91
Iraq,2004-08-01,48,4,0,34,11,97
Iraq,2004-08-01,64,0,-1,16,1,80
Iraq,2004-08-01,32,0,1,46,2,81
Iraq,2004-08-01,82,2,1,84,8,177
Iraq,2004-08-01,142,0,0,74,14,230
Iraq,2004-09-01,109,2,0,164,23,298
Iraq,2004-09-01,68,0,2,69,9,148
Iraq,2004-09-01,70,0,1,41,9,121
Iraq,2004-09-01,70,0,0,33,10,113
Iraq,2004-09-01,61,0,0,53,9,123
Iraq,2004-09-01,67,0,2,94,23,186
Iraq,2004-09-01,62,0,0,36,5,103
Iraq,2004-09-01,64,0,-4,45,6,111
Iraq,2004-09-01,53,0,-4,31,18,98
Iraq,2004-09-01,55,0,0,28,4,87
Iraq,2004-09-01,46,0,-5,32,3,76
Iraq,2004-09-01,100,0,-2,9,15,122
Iraq,2004-09-01,80,0,-4,35,9,120
Iraq,2004-09-01,70,4,-3,18,3,92
Iraq,2004-09-01,52,0,4,19,9,84
Iraq,2004-09-01,91,0,0,49,11,151
Iraq,2004-09-01,155,0,3,9,20,187
Iraq,2004-09-01,76,0,4,30,11,121
Iraq,2004-09-01,42,0,0,33,6,81
Iraq,2004-09-01,81,4,2,5,2,94
Iraq,2004-09-01,48,2,-1,36,11,96
Iraq,2004-09-01,77,2,0,6,8,93
Iraq,2004-09-01,102,6,-3,13,5,123
Iraq,2004-09-01,28,2,8,20,13,71
Iraq,2004-09-01,57,2,0,49,5,113
Iraq,2004-09-01,67,0,5,28,4,104
Iraq,2004-09-01,52,0,-1,44,16,111
Iraq,2004-09-01,68,2,1,-24,14,61
Iraq,2004-09-01,44,0,4,40,9,97
Iraq,2004-09-01,107,10,2,49,11,179
Iraq,2004-10-01,149,0,1,62,9,221
Iraq,2004-10-01,40,0,0,73,13,126
Iraq,2004-10-01,37,0,0,21,0,58
Iraq,2004-10-01,41,4,0,46,15,106
Iraq,2004-10-01,79,0,0,48,4,131
Iraq,2004-10-01,78,0,5,38,5,126
Iraq,2004-10-01,68,0,-4,39,4,107
Iraq,2004-10-01,154,0,0,89,12,255
Iraq,2004-10-01,78,2,0,23,11,114
Iraq,2004-10-01,46,0,1,2,5,54
Iraq,2004-10-01,62,0,-1,15,16,92
Iraq,2004-10-01,130,0,3,43,7,183
Iraq,2004-10-01,65,8,-1,22,8,102
Iraq,2004-10-01,83,0,0,16,5,104
Iraq,2004-10-01,27,0,1,57,6,91
Iraq,2004-10-01,47,2,0,17,1,67
Iraq,2004-10-01,83,2,1,32,13,131
Iraq,2004-10-01,107,0,2,46,12,167
Iraq,2004-10-01,59,0,0,13,9,81
Iraq,2004-10-01,81,0,-1,31,11,122
Iraq,2004-10-01,84,0,1,22,7,114
Iraq,2004-10-01,115,0,1,10,16,142
Iraq,2004-10-01,36,0,0,31,-2,65
Iraq,2004-10-01,88,0,0,23,8,119
Iraq,2004-10-01,114,0,0,12,16,142
Iraq,2004-10-01,67,6,0,73,14,160
Iraq,2004-10-01,47,0,0,40,5,92
Iraq,2004-10-01,32,2,0,77,4,115
Iraq,2004-10-01,69,2,0,63,7,141
Iraq,2004-10-01,43,0,1,92,9,145
Iraq,2004-10-01,61,8,4,92,13,178
Iraq,2004-11-01,110,0,0,58,19,187
Iraq,2004-11-01,75,0,-1,36,16,126
Iraq,2004-11-01,87,2,-2,42,12,141
Iraq,2004-11-01,23,0,2,37,16,78
Iraq,2004-11-01,41,2,1,14,3,61
Iraq,2004-11-01,49,0,2,-7,7,51
Iraq,2004-11-01,42,0,0,8,13,63
Iraq,2004-11-01,88,0,-4,29,22,135
Iraq,2004-11-01,177,0,-3,-7,28,195
Iraq,2004-11-01,116,0,0,24,19,159
Iraq,2004-11-01,85,0,2,25,12,124
Iraq,2004-11-01,105,0,0,12,7,124
Iraq,2004-11-01,68,0,0,46,21,135
Iraq,2004-11-01,40,0,-4,31,12,79
Iraq,2004-11-01,97,0,0,19,12,128
Iraq,2004-11-01,179,2,-22,32,6,197
Iraq,2004-11-01,108,0,2,8,4,122
Iraq,2004-11-01,95,4,1,85,8,193
Iraq,2004-11-01,41,0,-4,0,12,49
Iraq,2004-11-01,27,0,0,5,7,39
Iraq,2004-11-01,64,2,0,11,19,96
Iraq,2004-11-01,49,0,3,20,19,91
Iraq,2004-11-01,55,0,-7,31,14,93
Iraq,2004-11-01,80,4,-2,26,24,132
Iraq,2004-11-01,49,0,-3,28,2,76
Iraq,2004-11-01,44,0,6,9,9,68
Iraq,2004-11-01,22,0,4,-3,4,27
Iraq,2004-11-01,38,0,-3,2,10,47
Iraq,2004-11-01,83,6,-4,17,11,113
Iraq,2004-11-01,54,0,-7,18,1,66
Iraq,2004-12-01,51,0,-3,13,7,68
Iraq,2004-12-01,40,4,-11,-4,11,40
Iraq,2004-12-01,41,2,-3,42,16,98
Iraq,2004-12-01,42,0,2,12,3,59
Iraq,2004-12-01,24,0,2,6,0,32
Iraq,2004-12-01,26,4,-3,18,13,58
Iraq,2004-12-01,84,0,2,33,8,127
Iraq,2004-12-01,76,2,-1,7,2,86
Iraq,2004-12-01,70,6,1,18,5,100
Iraq,2004-12-01,27,0,2,16,3,48
Iraq,2004-12-01,57,0,-1,13,0,69
Iraq,2004-12-01,65,0,0,29,9,103
Iraq,2004-12-01,59,0,-2,10,5,72
Iraq,2004-12-01,62,6,0,30,6,104
Iraq,2004-12-01,72,0,0,34,2,108
Iraq,2004-12-01,88,2,-1,11,6,106
Iraq,2004-12-01,38,0,-3,22,4,61
Iraq,2004-12-01,21,0,1,8,11,41
Iraq,2004-12-01,55,0,0,23,19,97
Iraq,2004-12-01,36,0,1,10,6,53
Iraq,2004-12-01,77,4,0,12,7,100
Iraq,2004-12-01,95,0,1,46,10,152
Iraq,2004-12-01,79,2,-2,4,10,93
Iraq,2004-12-01,50,0,2,5,5,62
Iraq,2004-12-01,76,0,0,20,3,99
Iraq,2004-12-01,32,0,0,-2,5,35
Iraq,2004-12-01,42,0,1,45,17,105
Iraq,2004-12-01,50,4,1,2,4,61
Iraq,2004-12-01,74,2,-6,2,21,93
Iraq,2004-12-01,18,0,-1,0,1,18
Iraq,2004-12-01,44,2,-2,32,12,88
Morocco,2004-01-01,0,0,0,0,0,0
Morocco,2004-01-01,3,0,0,6,0,9
Morocco,2004-01-01,0,0,0,3,0,3
Morocco,2004-01-01,0,0,0,18,0,18
Morocco,2004-01-01,4,0,0,12,2,18
Morocco,2004-01-01,1,0,0,0,0,1
Morocco,2004-01-01,3,0,0,-1,0,2
Morocco,2004-01-01,6,0,0,0,0,6
Morocco,2004-01-01,0,0,0,0,0,0
Morocco,2004-01-01,6,0,0,9,0,15
Morocco,2004-01-01,6,0,0,0,0,6
Morocco,2004-01-01,0,0,0,-2,0,-2
Morocco,2004-01-01,3,0,0,-2,0,1
Morocco,2004-01-01,6,0,0,15,0,21
Morocco,2004-01-01,0,0,0,0,0,0
Morocco,2004-01-01,0,0,0,9,0,9
Morocco,2004-01-01,3,0,0,6,0,9
Morocco,2004-01-01,0,0,0,3,0,3
Morocco,2004-01-01,10,0,0,10,2,22
Morocco,2004-01-01,0,0,-1,18,0,17
Morocco,2004-01-01,4,0,0,12,3,19
Morocco,2004-01-01,0,0,0,0,0,0
Morocco,2004-01-01,0,0,0,0,0,0
Morocco,2004-01-01,0,0,0,0,0,0
Morocco,2004-01-01,2,0,0,12,1,15
Morocco,2004-01-01,0,0,-1,2,0,1
Morocco,2004-01-01,6,0,0,4,1,11
Morocco,2004-01-01,4,0,0,10,0,14
Morocco,2004-01-01,4,0,-1,3,0,6
Morocco,2004-01-01,0,0,0,0,0,0
Morocco,2004-02-01,0,0,0,1,4,5
Morocco,2004-02-01,3,0,0,3,0,6
Morocco,2004-02-01,2,0,0,12,0,14
Morocco,2004-02-01,0,0,0,0,0,0
Morocco,2004-02-01,13,0,0,24,0,37
Morocco,2004-02-01,8,0,0,3,0,11
Morocco,2004-02-01,2,0,0,1,0,3
Morocco,2004-02-01,-1,0,0,0,0,-1
Morocco,2004-02-01,-1,0,0,-2,0,-3
Morocco,2004-02-01,0,0,0,0,0,0
Morocco,2004-02-01,0,0,0,3,1,4
Morocco,2004-02-01,8,0,0,3,0,11
Morocco,2004-02-01,-8,0,-2,-6,0,-16
Morocco,2004-02-01,1,0,0,0,0,1
Morocco,2004-02-01,0,0,0,0,0,0
Morocco,2004-02-01,3,0,2,0,0,5
Morocco,2004-02-01,0,0,0,0,0,0
Morocco,2004-02-01,0,0,0,0,0,0
Morocco,2004-02-01,2,0,0,0,0,2
Morocco,2004-02-01,0,0,0,3,0,3
Morocco,2004-02-01,0,0,0,0,2,2
Morocco,2004-02-01,9,0,0,-4,0,5
Morocco,2004-02-01,-1,0,0,5,1,5
Morocco,2004-02-01,11,0,-2,9,1,19
Morocco,2004-02-01,4,0,0,3,0,7
Morocco,2004-02-01,13,0,0,3,0,16
Morocco,2004-02-01,2,0,0,3,0,5
Morocco,2004-02-01,4,0,0,0,0,4
Morocco,2004-03-01,33,0,0,0,0,33
Morocco,2004-03-01,8,0,0,3,0,11
Morocco,2004-03-01,4,0,0,4,0,8
Morocco,2004-03-01,4,0,0,10,0,14
Morocco,2004-03-01,7,0,0,1,0,8
Morocco,2004-03-01,0,0,0,0,0,0
Morocco,2004-03-01,0,0,0,6,3,9
Morocco,2004-03-01,2,0,0,6,0,8
Morocco,2004-03-01,3,0,0,10,0,13
Morocco,2004-03-01,3,0,0,-4,3,2
Morocco,2004-03-01,13,0,0,12,0,25
Morocco,2004-03-01,7,0,0,12,0,19
Morocco,2004-03-01,21,0,0,12,1,34
Morocco,2004-03-01,21,0,0,16,0,37
Morocco,2004-03-01,0,0,0,4,1,5
Morocco,2004-03-01,0,0,0,6,1,7
Morocco,2004-03-01,7,0,0,17,0,24
Morocco,2004-03-01,15,0,0,21,3,39
Morocco,2004-03-01,17,0,0,6,0,23
Morocco,2004-03-01,13,0,0,3,0,16
Morocco,2004-03-01,-1,0,0,9,4,12
Morocco,2004-03-01,4,0,0,28,0,32
Morocco,2004-03-01,8,0,0,3,2,13
Morocco,2004-03-01,5,0,0,42,0,47
Morocco,2004-03-01,16,0,0,39,2,57
Morocco,2004-03-01,2,0,0,0,0,2
Morocco,2004-03-01,3,0,0,21,0,24
Morocco,2004-03-01,9,0,0,6,0,15
Morocco,2004-03-01,2,0,0,9,0,11
Morocco,2004-03-01,2,0,0,0,0,2
Morocco,2004-04-01,5,0,0,-2,0,3
Morocco,2004-04-01,12,0,0,9,2,23
Morocco,2004-04-01,13,0,0,6,0,19
Morocco,2004-04-01,2,0,0,0,0,2
Morocco,2004-04-01,10,0,0,17,0,27
Morocco,2004-04-01,16,0,0,0,0,16
Morocco,2004-04-01,14,0,0,40,0,54
Morocco,2004-04-01,0,0,0,13,1,14
Morocco,2004-04-01,7,0,0,18,0,25
Morocco,2004-04-01,5,0,0,0,0,5
Morocco,2004-04-01,0,0,0,0,0,0
Morocco,2004-04-01,3,0,0,1,0,4
Morocco,2004-04-01,0,0,0,3,0,3
Morocco,2004-04-01,4,0,-1,1,0,4
Morocco,2004-04-01,8,0,-2,0,0,6
Morocco,2004-04-01,5,0,0,12,0,17
Morocco,2004-04-01,9,2,0,6,0,17
Morocco,2004-04-01,0,0,0,0,0,0
Morocco,2004-04-01,2,0,0,0,0,2
Morocco,2004-04-01,0,0,0,-2,1,-1
Morocco,2004-04-01,8,0,0,2,0,10
Morocco,2004-04-01,4,0,0,0,0,4
Morocco,2004-04-01,5,0,0,1,0,6
Morocco,2004-04-01,2,0,0,6,2,10
Morocco,2004-04-01,0,0,0,-6,0,-6
Morocco,2004-04-01,4,0,0,18,0,22
Morocco,2004-04-01,3,0,0,8,0,11
Morocco,2004-04-01,12,0,0,21,0,33
Morocco,2004-04-01,-3,0,-2,13,0,8
Morocco,2004-04-01,0,0,0,4,2,6
Morocco,2004-05-01,6,0,0,2,0,8
Morocco,2004-05-01,-2,0,0,0,0,-2
Morocco,2004-05-01,0,0,0,0,0,0
Morocco,2004-05-01,-3,0,0,0,0,-3
Morocco,2004-05-01,5,0,0,0,1,6
Morocco,2004-05-01,0,0,0,-2,0,-2
Morocco,2004-05-01,7,0,0,9,2,18
Morocco,2004-05-01,3,0,0,9,0,12
Morocco,2004-05-01,6,0,0,4,0,10
Morocco,2004-05-01,0,0,0,-4,0,-4
Morocco,2004-05-01,0,0,0,0,0,0
Morocco,2004-05-01,0,0,0,3,0,3
Morocco,2004-05-01,3,0,0,0,0,3
Morocco,2004-05-01,0,0,0,6,0,6
Morocco,2004-05-01,0,0,0,3,0,3
Morocco,2004-05-01,-1,0,0,0,0,-1
Morocco,2004-05-01,1,0,0,0,0,1
Morocco,2004-05-01,0,0,0,0,0,0
Morocco,2004-05-01,0,0,0,0,0,0
Morocco,2004-05-01,0,0,0,0,0,0
Morocco,2004-05-01,1,0,0,6,5,12
Morocco,2004-05-01,4,0,0,0,0,4
Morocco,2004-05-01,0,0,0,0,0,0
Morocco,2004-05-01,0,0,0,0,0,0
Morocco,2004-05-01,0,0,0,0,0,0
Morocco,2004-05-01,7,0,0,21,0,28
Morocco,2004-05-01,0,0,0,0,0,0
Morocco,2004-05-01,0,0,0,9,0,9
Morocco,2004-05-01,2,0,0,0,0,2
Morocco,2004-05-01,2,0,0,3,0,5
Morocco,2004-05-01,0,0,0,0,0,0
Morocco,2004-06-01,0,0,0,3,0,3
Morocco,2004-06-01,6,0,0,0,0,6
Morocco,2004-06-01,0,0,0,0,0,0
Morocco,2004-06-01,0,0,0,0,0,0
Morocco,2004-06-01,0,0,0,0,0,0
Morocco,2004-06-01,3,0,0,0,1,4
Morocco,2004-06-01,15,0,0,6,0,21
Morocco,2004-06-01,12,0,0,15,0,27
Morocco,2004-06-01,8,0,0,4,1,13
Morocco,2004-06-01,0,0,0,0,0,0
Morocco,2004-06-01,-1,0,-2,0,0,-3
Morocco,2004-06-01,-7,0,-2,3,0,-6
Morocco,2004-06-01,70,0,-3,0,0,67
Morocco,2004-06-01,4,0,0,9,0,13
Morocco,2004-06-01,-2,0,0,0,0,-2
Morocco,2004-06-01,1,0,-2,5,0,4
Morocco,2004-06-01,0,0,0,7,0,7
Morocco,2004-06-01,0,0,0,0,0,0
Morocco,2004-06-01,0,0,0,0,0,0
Morocco,2004-06-01,-3,0,-1,-9,0,-13
Morocco,2004-06-01,1,0,0,-4,0,-3
Morocco,2004-06-01,-8,0,0,3,0,-5
Morocco,2004-06-01,0,0,0,0,0,0
Morocco,2004-06-01,0,0,0,6,0,6
Morocco,2004-06-01,0,0,0,0,0,0
Morocco,2004-06-01,0,0,0,1,0,1
Morocco,2004-06-01,8,0,0,9,0,17
Morocco,2004-06-01,1,0,0,0,0,1
Morocco,2004-07-01,0,0,0,0,0,0
Morocco,2004-07-01,9,0,0,0,3,12
Morocco,2004-07-01,7,0,0,0,0,7
Morocco,2004-07-01,0,0,0,0,0,0
Morocco,2004-07-01,0,0,0,3,0,3
Morocco,2004-07-01,3,0,0,6,0,9
Morocco,2004-07-01,5,0,0,9,1,15
Morocco,2004-07-01,0,0,0,1,0,1
Morocco,2004-07-01,6,0,0,0,0,6
Morocco,2004-07-01,2,0,0,0,0,2
Morocco,2004-07-01,2,0,0,0,1,3
Morocco,2004-07-01,6,0,0,6,0,12
Morocco,2004-07-01,4,0,0,6,1,11
Morocco,2004-07-01,16,0,0,-2,3,17
Morocco,2004-07-01,9,0,0,3,0,12
Morocco,2004-07-01,15,0,0,12,0,27
Morocco,2004-07-01,0,0,0,0,0,0
Morocco,2004-07-01,5,0,0,3,0,8
Morocco,2004-07-01,0,0,0,3,0,3
Morocco,2004-07-01,7,0,0,0,0,7
Morocco,2004-07-01,3,0,0,0,1,4
Morocco,2004-07-01,0,0,0,0,0,0
Morocco,2004-07-01,0,0,0,0,0,0
Morocco,2004-07-01,0,0,0,3,0,3
Morocco,2004-07-01,-2,0,0,0,2,0
Morocco,2004-07-01,0,0,0,0,0,0
Morocco,2004-07-01,1,0,0,-2,0,-1
Morocco,2004-07-01,0,0,0,6,0,6
Morocco,2004-07-01,0,0,0,3,0,3
Morocco,2004-08-01,0,0,0,9,0,9
Morocco,2004-08-01,0,0,0,0,0,0
Morocco,2004-08-01,11,0,0,13,0,24
Morocco,2004-08-01,0,0,0,-6,0,-6
Morocco,2004-08-01,0,0,0,0,0,0
Morocco,2004-08-01,2,0,0,0,0,2
Morocco,2004-08-01,0,0,0,0,0,0
Morocco,2004-08-01,7,0,0,0,0,7
Morocco,2004-08-01,1,0,0,0,0,1
Morocco,2004-08-01,23,0,0,0,1,24
Morocco,2004-08-01,13,0,0,18,0,31
Morocco,2004-08-01,3,0,0,0,0,3
Morocco,2004-08-01,6,0,0,0,1,7
Morocco,2004-08-01,0,0,0,0,0,0
Morocco,2004-08-01,0,0,0,0,0,0
Morocco,2004-08-01,2,0,0,-4,0,-2
Morocco,2004-08-01,10,0,0,0,0,10
Morocco,2004-08-01,2,0,0,0,0,2
Morocco,2004-08-01,0,0,0,3,1,4
Morocco,2004-08-01,0,0,0,3,0,3
Morocco,2004-08-01,0,0,0,0,0,0
Morocco,2004-08-01,0,0,0,0,0,0
Morocco,2004-08-01,0,0,0,0,0,0
Morocco,2004-08-01,4,0,0,1,0,5
Morocco,2004-08-01,6,0,0,0,0,6
Morocco,2004-08-01,1,0,0,0,0,1
Morocco,2004-08-01,0,0,0,0,1,1
Morocco,2004-08-01,3,0,0,-4,0,-1
Morocco,2004-08-01,0,0,0,0,0,0
Morocco,2004-09-01,0,0,0,3,0,3
Morocco,2004-09-01,-1,0,0,17,0,16
Morocco,2004-09-01,-2,0,0,18,2,18
Morocco,2004-09-01,1,0,0,7,0,8
Morocco,2004-09-01,0,0,0,15,0,15
Morocco,2004-09-01,3,0,0,0,0,3
Morocco,2004-09-01,0,0,0,6,0,6
Morocco,2004-09-01,0,0,0,0,0,0
Morocco,2004-09-01,4,0,0,0,0,4
Morocco,2004-09-01,0,0,0,9,0,9
Morocco,2004-09-01,7,0,0,6,0,13
Morocco,2004-09-01,0,0,0,0,0,0
Morocco,2004-09-01,0,0,0,3,0,3
Morocco,2004-09-01,3,0,0,6,0,9
Morocco,2004-09-01,6,0,0,-4,0,2
Morocco,2004-09-01,0,0,0,6,0,6
Morocco,2004-09-01,0,0,0,0,0,0
Morocco,2004-09-01,-1,0,0,0,0,-1
Morocco,2004-09-01,0,0,0,0,0,0
Morocco,2004-09-01,3,0,0,-2,0,1
Morocco,2004-09-01,0,0,0,3,0,3
Morocco,2004-09-01,7,0,0,-1,0,6
Morocco,2004-09-01,8,0,0,0,0,8
Morocco,2004-09-01,0,0,0,0,0,0
Morocco,2004-09-01,1,0,0,6,0,7
Morocco,2004-09-01,0,0,0,3,0,3
Morocco,2004-09-01,0,0,0,6,0,6
Morocco,2004-09-01,4,0,0,0,0,4
Morocco,2004-10-01,2,0,0,0,0,2
Morocco,2004-10-01,-1,0,0,0,0,-1
Morocco,2004-10-01,5,0,0,0,0,5
Morocco,2004-10-01,0,0,0,0,0,0
Morocco,2004-10-01,0,0,0,0,0,0
Morocco,2004-10-01,2,0,0,0,0,2
Morocco,2004-10-01,1,0,0,6,0,7
Morocco,2004-10-01,0,0,0,3,2,5
Morocco,2004-10-01,0,0,0,0,0,0
Morocco,2004-10-01,4,0,0,0,0,4
Morocco,2004-10-01,6,0,0,3,0,9
Morocco,2004-10-01,6,0,1,0,0,7
Morocco,2004-10-01,2,0,0,0,0,2
Morocco,2004-10-01,2,0,0,8,1,11
Morocco,2004-10-01,3,0,0,0,1,4
Morocco,2004-10-01,-6,0,0,6,0,0
Morocco,2004-10-01,0,0,0,0,1,1
Morocco,2004-10-01,-3,0,0,0,0,-3
Morocco,2004-10-01,-7,0,-1,2,0,-6
Morocco,2004-10-01,0,0,0,6,0,6
Morocco,2004-10-01,0,0,0,6,0,6
Morocco,2004-10-01,0,0,0,0,0,0
Morocco,2004-10-01,0,0,0,0,0,0
Morocco,2004-10-01,-6,0,-2,0,1,-7
Morocco,2004-10-01,4,0,0,9,0,13
Morocco,2004-10-01,0,0,-2,0,0,-2
Morocco,2004-10-01,-8,0,0,6,0,-2
Morocco,2004-11-01,1,0,0,0,0,1
Morocco,2004-11-01,19,0,0,0,0,19
Morocco,2004-11-01,6,0,0,0,0,6
Morocco,2004-11-01,12,0,0,9,0,21
Morocco,2004-11-01,0,0,0,6,0,6
Morocco,2004-11-01,12,0,0,7,6,25
Morocco,2004-11-01,0,0,0,0,2,2
Morocco,2004-11-01,20,0,0,0,0,20
Morocco,2004-11-01,10,0,0,9,0,19
Morocco,2004-11-01,19,0,1,2,0,22
Morocco,2004-11-01,1,0,0,9,0,10
Morocco,2004-11-01,0,0,0,-2,2,0
Morocco,2004-11-01,1,0,0,0,2,3
Morocco,2004-11-01,0,0,0,0,0,0
Morocco,2004-11-01,0,0,0,0,0,0
Morocco,2004-11-01,18,0,0,15,0,33
Morocco,2004-11-01,3,0,0,6,0,9
Morocco,2004-11-01,5,0,0,0,0,5
Morocco,2004-11-01,3,0,0,6,0,9
Morocco,2004-11-01,0,0,0,0,0,0
Morocco,2004-11-01,0,0,0,0,0,0
Morocco,2004-11-01,0,0,0,0,0,0
Morocco,2004-11-01,0,0,0,3,0,3
Morocco,2004-11-01,0,0,0,0,0,0
Morocco,2004-11-01,6,0,0,3,1,10
Morocco,2004-11-01,3,0,0,3,0,6
Morocco,2004-11-01,-1,0,0,0,0,-1
Morocco,2004-11-01,8,0,0,3,0,11
Morocco,2004-11-01,7,0,-4,3,0,6
Morocco,2004-11-01,6,0,0,9,0,15
Morocco,2004-12-01,0,0,0,1,0,1
Morocco,2004-12-01,0,0,0,0,0,0
Morocco,2004-12-01,-1,0,0,0,0,-1
Morocco,2004-12-01,0,0,0,0,0,0
Morocco,2004-12-01,-3,0,0,0,0,-3
Morocco,2004-12-01,-3,0,0,3,0,0
Morocco,2004-12-01,0,0,0,0,0,0
Morocco,2004-12-01,0,0,0,0,0,0
Morocco,2004-12-01,6,0,0,0,0,6
Morocco,2004-12-01,4,0,0,0,0,4
Morocco,2004-12-01,0,0,0,0,0,0
Morocco,2004-12-01,0,0,0,0,0,0
Morocco,2004-12-01,6,0,0,0,0,6
Morocco,2004-12-01,0,0,0,9,0,9
Morocco,2004-12-01,5,0,0,7,0,12
Morocco,2004-12-01,-1,0,0,15,0,14
Morocco,2004-12-01,0,0,0,0,0,0
Morocco,2004-12-01,0,0,0,0,1,1
Morocco,2004-12-01,-2,0,0,3,0,1
Morocco,2004-12-01,0,0,0,-4,0,-4
Morocco,2004-12-01,4,0,0,0,0,4
Morocco,2004-12-01,0,0,0,-4,2,-2
Morocco,2004-12-01,1,0,0,12,0,13
Morocco,2004-12-01,0,0,-1,6,0,5
Morocco,2004-12-01,0,0,0,-4,0,-4
Morocco,2004-12-01,0,0,0,0,1,1
Morocco,2004-12-01,0,0,0,6,0,6
Morocco,2004-12-01,5,0,0,0,0,5
Nigeria,2004-01-01,6,0,0,0,1,7
Nigeria,2004-01-01,8,0,0,8,4,20
Nigeria,2004-01-01,1,0,2,5,1,9
Nigeria,2004-01-01,1,0,0,3,0,4
Nigeria,2004-01-01,6,0,1,1,0,8
Nigeria,2004-01-01,9,0,0,6,1,16
Nigeria,2004-01-01,4,0,0,15,2,21
Nigeria,2004-01-01,6,0,0,3,2,11
Nigeria,2004-01-01,5,0,0,1,0,6
Nigeria,2004-01-01,5,0,0,-2,2,5
Nigeria,2004-01-01,2,0,0,0,0,2
Nigeria,2004-01-01,11,2,0,13,2,28
Nigeria,2004-01-01,23,0,0,3,1,27
Nigeria,2004-01-01,22,0,0,13,7,42
Nigeria,2004-01-01,17,0,-4,12,3,28
Nigeria,2004-01-01,16,0,0,1,2,19
Nigeria,2004-01-01,0,0,-2,0,0,-2
Nigeria,2004-01-01,9,0,0,4,1,14
Nigeria,2004-01-01,25,0,0,6,3,34
Nigeria,2004-01-01,21,0,0,4,0,25
Nigeria,2004-01-01,5,0,0,0,0,5
Nigeria,2004-01-01,7,0,0,15,1,23
Nigeria,2004-01-01,6,0,0,3,2,11
Nigeria,2004-01-01,0,0,0,0,1,1
Nigeria,2004-01-01,0,0,0,0,0,0
Nigeria,2004-01-01,20,0,0,5,0,25
Nigeria,2004-01-01,11,0,0,-2,0,9
Nigeria,2004-01-01,17,0,-1,12,4,32
Nigeria,2004-01-01,17,0,0,0,0,17
Nigeria,2004-01-01,7,2,2,14,0,25
Nigeria,2004-01-01,1,0,0,4,1,6
Nigeria,2004-02-01,-1,0,0,0,0,-1
Nigeria,2004-02-01,7,0,0,9,4,20
Nigeria,2004-02-01,2,0,0,0,2,4
Nigeria,2004-02-01,12,0,0,0,2,14
Nigeria,2004-02-01,18,0,0,4,1,23
Nigeria,2004-02-01,11,0,0,9,0,20
Nigeria,2004-02-01,1,0,0,9,0,10
Nigeria,2004-02-01,5,0,0,9,0,14
Nigeria,2004-02-01,12,0,0,0,5,17
Nigeria,2004-02-01,22,4,1,5,0,32
Nigeria,2004-02-01,11,4,0,2,12,29
Nigeria,2004-02-01,4,0,0,6,8,18
Nigeria,2004-02-01,40,0,0,3,10,53
Nigeria,2004-02-01,-1,0,0,0,5,4
Nigeria,2004-02-01,0,0,0,0,0,0
Nigeria,2004-02-01,5,0,1,0,3,9
Nigeria,2004-02-01,2,0,0,0,6,8
Nigeria,2004-02-01,13,0,0,9,6,28
Nigeria,2004-02-01,12,0,0,5,2,19
Nigeria,2004-02-01,15,0,0,4,0,19
Nigeria,2004-02-01,4,0,-1,0,1,4
Nigeria,2004-02-01,8,0,1,2,1,12
Nigeria,2004-02-01,13,0,0,21,1,35
Nigeria,2004-02-01,9,0,0,-1,3,11
Nigeria,2004-02-01,20,0,0,6,2,28
Nigeria,2004-02-01,11,0,0,-1,2,12
Nigeria,2004-02-01,12,0,0,1,2,15
Nigeria,2004-02-01,2,0,0,1,0,3
Nigeria,2004-02-01,1,0,0,0,1,2
Nigeria,2004-03-01,5,0,0,0,3,8
Nigeria,2004-03-01,38,0,0,21,1,60
Nigeria,2004-03-01,8,0,-6,6,6,14
Nigeria,2004-03-01,17,0,0,4,2,23
Nigeria,2004-03-01,9,0,4,3,3,19
Nigeria,2004-03-01,7,0,0,12,0,19
Nigeria,2004-03-01,14,0,0,0,0,14
Nigeria,2004-03-01,56,0,0,-1,3,58
Nigeria,2004-03-01,5,0,1,5,0,11
Nigeria,2004-03-01,19,0,0,12,1,32
Nigeria,2004-03-01,13,0,0,6,7,26
Nigeria,2004-03-01,8,0,-4,12,1,17
Nigeria,2004-03-01,6,0,0,0,0,6
Nigeria,2004-03-01,0,0,0,3,0,3
Nigeria,2004-03-01,10,0,1,6,3,20
Nigeria,2004-03-01,18,0,2,6,2,28
Nigeria,2004-03-01,13,0,-2,1,1,13
Nigeria,2004-03-01,7,2,0,-1,0,8
Nigeria,2004-03-01,11,0,0,9,0,20
Nigeria,2004-03-01,0,0,0,-2,2,0
Nigeria,2004-03-01,4,0,0,0,0,4
Nigeria,2004-03-01,7,0,0,21,3,31
Nigeria,2004-03-01,7,0,0,0,0,7
Nigeria,2004-03-01,12,0,0,-1,1,12
Nigeria,2004-03-01,6,0,0,-4,0,2
Nigeria,2004-03-01,17,0,0,0,6,23
Nigeria,2004-03-01,0,0,0,0,0,0
Nigeria,2004-03-01,0,0,0,0,0,0
Nigeria,2004-03-01,16,0,0,0,0,16
Nigeria,2004-03-01,0,0,1,-3,0,-2
Nigeria,2004-03-01,8,0,0,3,6,17
Nigeria,2004-04-01,7,0,-3,3,0,7
Nigeria,2004-04-01,7,0,0,16,2,25
Nigeria,2004-04-01,17,0,0,0,0,17
Nigeria,2004-04-01,14,0,0,-2,0,12
Nigeria,2004-04-01,-1,0,0,7,1,7
Nigeria,2004-04-01,0,0,0,12,2,14
Nigeria,2004-04-01,3,0,0,0,0,3
Nigeria,2004-04-01,6,0,0,3,1,10
Nigeria,2004-04-01,2,0,0,12,0,14
Nigeria,2004-04-01,2,0,0,0,0,2
Nigeria,2004-04-01,4,0,0,0,0,4
Nigeria,2004-04-01,23,0,0,3,2,28
Nigeria,2004-04-01,2,0,1,0,0,3
Nigeria,2004-04-01,1,0,3,18,4,26
Nigeria,2004-04-01,14,0,1,0,1,16
Nigeria,2004-04-01,11,0,0,0,0,11
Nigeria,2004-04-01,0,0,0,-2,0,-2
Nigeria,2004-04-01,-1,0,0,0,0,-1
Nigeria,2004-04-01,6,0,0,4,0,10
Nigeria,2004-04-01,2,2,0,0,3,7
Nigeria,2004-04-01,12,0,0,3,0,15
Nigeria,2004-04-01,8,0,0,-2,0,6
Nigeria,2004-04-01,6,0,0,4,0,10
Nigeria,2004-04-01,4,0,0,8,0,12
Nigeria,2004-04-01,2,0,2,3,4,11
Nigeria,2004-04-01,6,0,0,1,1,8
Nigeria,2004-04-01,9,0,0,3,0,12
Nigeria,2004-04-01,20,2,0,-4,0,18
Nigeria,2004-04-01,3,0,0,1,1,5
Nigeria,2004-04-01,2,0,0,3,0,5
Nigeria,2004-05-01,-1,0,0,0,2,1
Nigeria,2004-05-01,20,0,0,0,2,22
Nigeria,2004-05-01,32,0,0,-2,1,31
Nigeria,2004-05-01,27,0,0,0,3,30
Nigeria,2004-05-01,7,0,0,9,0,16
Nigeria,2004-05-01,4,0,0,-5,7,6
Nigeria,2004-05-01,2,0,-3,-4,1,-4
Nigeria,2004-05-01,14,0,0,0,0,14
Nigeria,2004-05-01,0,0,0,3,1,4
Nigeria,2004-05-01,20,0,0,5,4,29
Nigeria,2004-05-01,7,0,0,6,2,15
Nigeria,2004-05-01,2,0,0,9,0,11
Nigeria,2004-05-01,10,0,1,2,3,16
Nigeria,2004-05-01,7,0,0,0,1,8
Nigeria,2004-05-01,1,0,0,0,0,1
Nigeria,2004-05-01,2,0,0,0,0,2
Nigeria,2004-05-01,-3,4,0,0,2,3
Nigeria,2004-05-01,7,0,0,3,0,10
Nigeria,2004-05-01,1,0,0,1,0,2
Nigeria,2004-05-01,18,0,0,-2,-4,12
Nigeria,2004-05-01,7,4,0,-8,0,3
Nigeria,2004-05-01,0,0,0,-2,0,-2
Nigeria,2004-05-01,14,0,0,0,0,14
Nigeria,2004-05-01,0,0,0,0,0,0
Nigeria,2004-05-01,2,0,0,-2,0,0
Nigeria,2004-05-01,2,0,0,0,1,3
Nigeria,2004-05-01,16,0,0,-2,5,19
Nigeria,2004-05-01,16,2,3,3,3,27
Nigeria,2004-05-01,0,0,0,0,0,0
Nigeria,2004-05-01,2,0,1,0,0,3
Nigeria,2004-05-01,-3,0,-2,11,0,6
Nigeria,2004-06-01,7,0,4,9,2,22
Nigeria,2004-06-01,21,4,1,5,2,33
Nigeria,2004-06-01,3,0,0,9,0,12
Nigeria,2004-06-01,5,0,0,9,0,14
Nigeria,2004-06-01,3,0,0,0,0,3
Nigeria,2004-06-01,7,0,0,0,0,7
Nigeria,2004-06-01,8,0,2,0,3,13
Nigeria,2004-06-01,7,0,0,8,1,16
Nigeria,2004-06-01,2,0,0,15,3,20
Nigeria,2004-06-01,2,0,-6,12,1,9
Nigeria,2004-06-01,9,0,0,0,0,9
Nigeria,2004-06-01,0,0,0,9,0,9
Nigeria,2004-06-01,2,0,0,0,0,2
Nigeria,2004-06-01,3,0,0,-1,0,2
Nigeria,2004-06-01,3,0,0,0,1,4
Nigeria,2004-06-01,19,0,3,6,1,29
Nigeria,2004-06-01,14,0,0,7,1,22
Nigeria,2004-06-01,0,0,0,0,1,1
Nigeria,2004-06-01,8,0,0,0,0,8
Nigeria,2004-06-01,17,0,0,0,0,17
Nigeria,2004-06-01,24,0,0,0,1,25
Nigeria,2004-06-01,8,0,0,0,0,8
Nigeria,2004-06-01,17,0,0,2,0,19
Nigeria,2004-06-01,14,0,1,3,1,19
Nigeria,2004-06-01,21,0,0,7,2,30
Nigeria,2004-06-01,4,0,0,3,4,11
Nigeria,2004-06-01,0,0,0,0,0,0
Nigeria,2004-06-01,-1,0,0,2,0,1
Nigeria,2004-06-01,12,0,2,8,1,23
Nigeria,2004-06-01,12,0,0,-1,2,13
Nigeria,2004-07-01,8,0,0,0,3,11
Nigeria,2004-07-01,3,0,0,0,0,3
Nigeria,2004-07-01,3,0,0,0,0,3
Nigeria,2004-07-01,2,0,0,0,0,2
Nigeria,2004-07-01,10,0,1,4,1,16
Nigeria,2004-07-01,14,2,-2,1,0,15
Nigeria,2004-07-01,16,0,-2,-1,2,15
Nigeria,2004-07-01,11,0,0,17,0,28
Nigeria,2004-07-01,6,0,0,-2,2,6
Nigeria,2004-07-01,7,0,0,0,0,7
Nigeria,2004-07-01,0,0,0,0,0,0
Nigeria,2004-07-01,1,0,0,4,0,5
Nigeria,2004-07-01,10,0,0,18,0,28
Nigeria,2004-07-01,-3,0,0,7,2,6
Nigeria,2004-07-01,17,0,-2,1,2,18
Nigeria,2004-07-01,16,0,0,-2,0,14
Nigeria,2004-07-01,4,0,0,-4,1,1
Nigeria,2004-07-01,1,0,0,0,0,1
Nigeria,2004-07-01,15,0,0,6,1,22
Nigeria,2004-07-01,13,0,0,6,0,19
Nigeria,2004-07-01,11,2,1,18,1,33
Nigeria,2004-07-01,18,0,0,6,2,26
Nigeria,2004-07-01,5,0,2,0,2,9
Nigeria,2004-07-01,9,0,0,-2,0,7
Nigeria,2004-07-01,7,0,0,0,0,7
Nigeria,2004-07-01,11,0,-2,-2,3,10
Nigeria,2004-07-01,12,0,-1,6,4,21
Nigeria,2004-07-01,9,0,0,0,5,14
Nigeria,2004-07-01,-4,0,0,0,2,-2
Nigeria,2004-07-01,11,0,0,3,1,15
Nigeria,2004-07-01,2,0,0,0,0,2
Nigeria,2004-08-01,0,0,0,0,0,0
Nigeria,2004-08-01,3,0,0,0,0,3
Nigeria,2004-08-01,31,2,0,3,1,37
Nigeria,2004-08-01,17,0,-2,11,4,30
Nigeria,2004-08-01,26,0,-3,7,4,34
Nigeria,2004-08-01,27,2,0,-3,2,28
Nigeria,2004-08-01,9,0,0,6,0,15
Nigeria,2004-08-01,7,0,0,0,0,7
Nigeria,2004-08-01,10,0,-4,3,1,10
Nigeria,2004-08-01,12,0,1,7,1,21
Nigeria,2004-08-01,16,4,0,-6,3,17
Nigeria,2004-08-01,8,0,0,6,0,14
Nigeria,2004-08-01,24,0,0,6,1,31
Nigeria,2004-08-01,-3,0,1,0,0,-2
Nigeria,2004-08-01,8,0,0,0,8,16
Nigeria,2004-08-01,14,0,0,6,0,20
Nigeria,2004-08-01,15,0,0,-2,2,15
Nigeria,2004-08-01,26,2,0,6,5,39
Nigeria,2004-08-01,19,0,0,10,1,30
Nigeria,2004-08-01,31,2,0,7,0,40
Nigeria,2004-08-01,24,0,0,3,5,32
Nigeria,2004-08-01,12,0,0,3,3,18
Nigeria,2004-08-01,7,0,0,6,4,17
Nigeria,2004-08-01,11,0,1,0,0,12
Nigeria,2004-08-01,9,0,0,3,3,15
Nigeria,2004-08-01,18,0,0,7,0,25
Nigeria,2004-08-01,12,0,1,6,3,22
Nigeria,2004-08-01,9,0,0,6,2,17
Nigeria,2004-08-01,13,0,-1,-2,0,10
Nigeria,2004-08-01,28,0,0,3,4,35
Nigeria,2004-08-01,13,0,0,7,3,23
Nigeria,2004-09-01,20,0,-1,13,2,34
Nigeria,2004-09-01,6,0,0,10,0,16
Nigeria,2004-09-01,6,0,0,3,1,10
Nigeria,2004-09-01,3,0,0,2,2,7
Nigeria,2004-09-01,4,0,0,4,1,9
Nigeria,2004-09-01,8,0,0,9,8,25
Nigeria,2004-09-01,8,0,0,6,0,14
Nigeria,2004-09-01,6,0,0,6,0,12
Nigeria,2004-09-01,6,0,0,12,1,19
Nigeria,2004-09-01,13,0,0,1,2,16
Nigeria,2004-09-01,1,0,-4,6,0,3
Nigeria,2004-09-01,3,0,-1,3,0,5
Nigeria,2004-09-01,23,2,1,9,2,37
Nigeria,2004-09-01,19,0,0,4,0,23
Nigeria,2004-09-01,33,0,0,0,0,33
Nigeria,2004-09-01,8,0,0,1,0,9
Nigeria,2004-09-01,10,0,0,7,4,21
Nigeria,2004-09-01,8,0,0,0,0,8
Nigeria,2004-09-01,2,0,0,3,0,5
Nigeria,2004-09-01,16,4,0,12,0,32
Nigeria,2004-09-01,22,0,0,8,3,33
Nigeria,2004-09-01,10,0,0,-1,1,10
Nigeria,2004-09-01,17,2,0,12,1,32
Nigeria,2004-09-01,8,2,0,3,3,16
Nigeria,2004-09-01,13,4,-2,-4,0,11
Nigeria,2004-09-01,9,0,0,9,1,19
Nigeria,2004-09-01,16,0,0,-4,2,14
Nigeria,2004-09-01,18,4,1,8,1,32
Nigeria,2004-09-01,19,6,0,3,6,34
Nigeria,2004-09-01,24,0,0,6,2,32
Nigeria,2004-10-01,24,0,0,-2,0,22
Nigeria,2004-10-01,3,0,0,3,0,6
Nigeria,2004-10-01,0,0,0,0,0,0
Nigeria,2004-10-01,4,0,-2,2,0,4
Nigeria,2004-10-01,25,0,0,0,1,26
Nigeria,2004-10-01,4,0,0,0,0,4
Nigeria,2004-10-01,16,0,0,4,3,23
Nigeria,2004-10-01,28,0,0,-2,3,29
Nigeria,2004-10-01,3,0,0,9,0,12
Nigeria,2004-10-01,0,0,0,0,0,0
Nigeria,2004-10-01,15,0,0,1,1,17
Nigeria,2004-10-01,6,0,0,1,0,7
Nigeria,2004-10-01,11,0,0,3,0,14
Nigeria,2004-10-01,4,0,0,0,0,4
Nigeria,2004-10-01,11,0,0,0,3,14
Nigeria,2004-10-01,3,0,0,0,2,5
Nigeria,2004-10-01,2,0,0,0,0,2
Nigeria,2004-10-01,25,0,0,0,1,26
Nigeria,2004-10-01,14,0,0,9,1,24
Nigeria,2004-10-01,22,0,0,6,12,40
Nigeria,2004-10-01,9,0,0,6,5,20
Nigeria,2004-10-01,17,0,0,3,1,21
Nigeria,2004-10-01,10,0,0,0,0,10
Nigeria,2004-10-01,10,0,0,0,2,12
Nigeria,2004-10-01,18,0,0,4,4,26
Nigeria,2004-10-01,18,0,0,3,1,22
Nigeria,2004-10-01,21,0,0,-2,3,22
Nigeria,2004-10-01,10,0,0,-4,0,6
Nigeria,2004-10-01,38,0,0,15,2,55
Nigeria,2004-10-01,4,0,0,-2,0,2
Nigeria,2004-10-01,3,0,-2,1,5,7
Nigeria,2004-11-01,13,4,-4,0,3,16
Nigeria,2004-11-01,7,2,0,-3,1,7
Nigeria,2004-11-01,14,0,0,3,0,17
Nigeria,2004-11-01,12,0,0,15,10,37
Nigeria,2004-11-01,4,0,0,1,0,5
Nigeria,2004-11-01,8,0,0,0,2,10
Nigeria,2004-11-01,9,0,0,0,3,12
Nigeria,2004-11-01,9,0,0,15,0,24
Nigeria,2004-11-01,7,0,0,0,3,10
Nigeria,2004-11-01,1,2,0,2,7,12
Nigeria,2004-11-01,12,0,0,3,0,15
Nigeria,2004-11-01,9,0,0,0,0,9
Nigeria,2004-11-01,1,0,0,0,1,2
Nigeria,2004-11-01,8,0,0,3,1,12
Nigeria,2004-11-01,5,2,0,0,2,9
Nigeria,2004-11-01,8,0,0,0,2,10
Nigeria,2004-11-01,3,0,0,3,0,6
Nigeria,2004-11-01,15,0,-1,1,0,15
Nigeria,2004-11-01,7,0,2,-3,2,8
Nigeria,2004-11-01,3,0,0,0,1,4
Nigeria,2004-11-01,9,2,0,0,0,11
Nigeria,2004-11-01,17,0,0,-2,2,17
Nigeria,2004-11-01,12,0,-2,0,3,13
Nigeria,2004-11-01,30,0,0,0,0,30
Nigeria,2004-11-01,1,0,1,12,1,15
Nigeria,2004-11-01,0,0,0,0,0,0
Nigeria,2004-11-01,5,0,0,1,1,7
Nigeria,2004-11-01,9,0,-2,6,1,14
Nigeria,2004-11-01,7,0,0,7,0,14
Nigeria,2004-11-01,6,0,0,6,1,13
Nigeria,2004-12-01,5,2,0,3,2,12
Nigeria,2004-12-01,1,0,0,6,0,7
Nigeria,2004-12-01,14,0,0,15,1,30
Nigeria,2004-12-01,9,0,0,0,0,9
Nigeria,2004-12-01,4,0,-1,4,0,7
Nigeria,2004-12-01,7,0,0,9,2,18
Nigeria,2004-12-01,15,0,0,12,8,35
Nigeria,2004-12-01,9,2,-1,1,0,11
Nigeria,2004-12-01,9,0,0,8,5,22
Nigeria,2004-12-01,5,0,0,0,0,5
Nigeria,2004-12-01,14,0,0,12,2,28
Nigeria,2004-12-01,19,0,1,1,1,22
Nigeria,2004-12-01,2,0,-1,0,0,1
Nigeria,2004-12-01,4,0,0,-2,2,4
Nigeria,2004-12-01,-3,0,1,1,0,-1
Nigeria,2004-12-01,12,2,0,0,1,15
Nigeria,2004-12-01,2,0,0,-6,1,-3
Nigeria,2004-12-01,-1,0,0,0,2,1
Nigeria,2004-12-01,7,0,0,9,1,17
Nigeria,2004-12-01,4,0,0,1,1,6
Nigeria,2004-12-01,8,0,0,-2,0,6
Nigeria,2004-12-01,4,6,0,1,3,14
Nigeria,2004-12-01,13,0,0,4,2,19
Nigeria,2004-12-01,12,0,0,0,0,12
Nigeria,2004-12-01,1,2,0,0,0,3
Nigeria,2004-12-01,0,0,0,-2,0,-2
Nigeria,2004-12-01,5,0,0,3,0,8
Nigeria,2004-12-01,11,0,0,0,4,15
Nigeria,2004-12-01,11,0,0,7,1,19
Nigeria,2004-12-01,16,0,0,15,5,36
Nigeria,2004-12-01,6,0,0,0,2,8
Pakistan,2004-01-01,44,0,0,0,0,44
Pakistan,2004-01-01,0,0,0,0,0,0
Pakistan,2004-01-01,2,0,0,0,0,2
Pakistan,2004-01-01,6,0,0,0,0,6
Pakistan,2004-01-01,11,0,0,12,0,23
Pakistan,2004-01-01,3,0,0,0,0,3
Pakistan,2004-01-01,4,0,0,-2,1,3
Pakistan,2004-01-01,10,0,0,30,0,40
Pakistan,2004-01-01,6,0,0,0,0,6
Pakistan,2004-01-01,9,0,0,3,0,12
Pakistan,2004-01-01,15,0,0,-6,1,10
Pakistan,2004-01-01,34,0,1,-6,5,34
Pakistan,2004-01-01,9,0,0,7,1,17
Pakistan,2004-01-01,2,0,0,8,0,10
Pakistan,2004-01-01,21,0,0,-24,6,3
Pakistan,2004-01-01,58,0,0,0,1,59
Pakistan,2004-01-01,15,0,0,6,7,28
Pakistan,2004-01-01,12,0,0,1,0,13
Pakistan,2004-01-01,6,0,0,-11,2,-3
Pakistan,2004-01-01,33,0,3,12,8,56
Pakistan,2004-01-01,2,0,0,22,0,24
Pakistan,2004-01-01,9,0,1,28,0,38
Pakistan,2004-01-01,13,0,0,15,0,28
Pakistan,2004-01-01,19,0,0,26,0,45
Pakistan,2004-01-01,5,0,0,3,0,8
Pakistan,2004-01-01,20,0,0,1,0,21
Pakistan,2004-01-01,38,0,0,15,2,55
Pakistan,2004-01-01,15,0,1,3,3,22
Pakistan,2004-01-01,47,0,0,19,0,66
Pakistan,2004-01-01,23,0,0,1,0,24
Pakistan,2004-01-01,25,0,0,10,1,36
Pakistan,2004-02-01,0,0,0,3,0,3
Pakistan,2004-02-01,48,0,0,-12,1,37
Pakistan,2004-02-01,62,0,1,9,2,74
Pakistan,2004-02-01,65,0,0,23,0,88
Pakistan,2004-02-01,54,0,0,26,2,82
Pakistan,2004-02-01,47,0,1,37,5,90
Pakistan,2004-02-01,37,0,0,1,1,39
Pakistan,2004-02-01,29,0,0,3,4,36
Pakistan,2004-02-01,46,0,0,18,1,65
Pakistan,2004-02-01,71,0,0,0,2,73
Pakistan,2004-02-01,25,0,0,15,0,40
Pakistan,2004-02-01,11,0,0,7,1,19
Pakistan,2004-02-01,31,4,0,0,4,39
Pakistan,2004-02-01,12,0,0,3,2,17
Pakistan,2004-02-01,17,0,0,6,0,23
Pakistan,2004-02-01,19,0,3,12,4,38
Pakistan,2004-02-01,13,0,0,6,2,21
Pakistan,2004-02-01,15,0,0,3,0,18
Pakistan,2004-02-01,1,0,0,6,0,7
Pakistan,2004-02-01,12,0,0,13,4,29
Pakistan,2004-02-01,10,0,0,25,2,37
Pakistan,2004-02-01,7,0,0,6,1,14
Pakistan,2004-02-01,20,0,0,1,2,23
Pakistan,2004-02-01,53,0,1,6,7,67
Pakistan,2004-02-01,13,0,0,6,0,19
Pakistan,2004-02-01,13,0,-2,20,0,31
Pakistan,2004-02-01,17,0,0,1,-2,16
Pakistan,2004-02-01,16,0,0,30,0,46
Pakistan,2004-02-01,22,0,0,9,4,35
Pakistan,2004-03-01,16,0,-1,12,2,29
Pakistan,2004-03-01,96,0,0,36,10,142
Pakistan,2004-03-01,42,0,0,14,10,66
Pakistan,2004-03-01,31,0,0,33,2,66
Pakistan,2004-03-01,3,0,1,21,7,32
Pakistan,2004-03-01,9,0,0,0,0,9
Pakistan,2004-03-01,18,0,0,0,0,18
Pakistan,2004-03-01,17,0,0,8,2,27
Pakistan,2004-03-01,16,0,-1,-2,2,15
Pakistan,2004-03-01,11,0,0,-2,0,9
Pakistan,2004-03-01,12,0,1,12,3,28
Pakistan,2004-03-01,25,0,1,15,2,43
Pakistan,2004-03-01,11,0,0,12,2,25
Pakistan,2004-03-01,17,0,0,15,0,32
Pakistan,2004-03-01,17,0,0,1,0,18
Pakistan,2004-03-01,14,0,-1,12,0,25
Pakistan,2004-03-01,37,0,0,5,1,43
Pakistan,2004-03-01,10,0,1,7,5,23
Pakistan,2004-03-01,61,0,0,0,0,61
Pakistan,2004-03-01,12,0,0,12,3,27
Pakistan,2004-03-01,26,0,0,15,4,45
Pakistan,2004-03-01,9,0,0,37,8,54
Pakistan,2004-03-01,19,0,0,8,6,33
Pakistan,2004-03-01,50,0,0,0,0,50
Pakistan,2004-03-01,13,0,0,9,2,24
Pakistan,2004-03-01,17,0,0,12,0,29
Pakistan,2004-03-01,6,0,0,6,4,16
Pakistan,2004-03-01,24,0,0,3,0,27
Pakistan,2004-03-01,26,0,0,0,1,27
Pakistan,2004-03-01,24,0,0,4,0,28
Pakistan,2004-03-01,-3,0,0,12,11,20
Pakistan,2004-04-01,4,0,-1,12,0,15
Pakistan,2004-04-01,12,0,0,15,0,27
Pakistan,2004-04-01,0,0,0,12,0,12
Pakistan,2004-04-01,30,0,0,1,0,31
Pakistan,2004-04-01,2,0,0,4,0,6
Pakistan,2004-04-01,18,0,0,6,0,24
Pakistan,2004-04-01,27,0,0,12,1,40
Pakistan,2004-04-01,34,0,0,24,3,61
Pakistan,2004-04-01,16,0,-2,13,4,31
Pakistan,2004-04-01,0,0,0,10,0,10
Pakistan,2004-04-01,3,0,0,0,0,3
Pakistan,2004-04-01,11,6,0,-8,0,9
Pakistan,2004-04-01,32,0,0,3,0,35
Pakistan,2004-04-01,6,0,0,27,9,42
Pakistan,2004-04-01,13,0,0,3,2,18
Pakistan,2004-04-01,6,0,0,3,2,11
Pakistan,2004-04-01,19,0,-1,3,2,23
Pakistan,2004-04-01,9,4,0,6,1,20
Pakistan,2004-04-01,15,0,0,8,5,28
Pakistan,2004-04-01,0,0,0,41,2,43
Pakistan,2004-04-01,27,0,0,4,8,39
Pakistan,2004-04-01,13,0,0,9,4,26
Pakistan,2004-04-01,12,0,0,-2,0,10
Pakistan,2004-04-01,4,0,0,6,1,11
Pakistan,2004-04-01,14,0,-2,6,0,18
Pakistan,2004-04-01,9,0,0,-1,5,13
Pakistan,2004-04-01,14,0,0,3,2,19
Pakistan,2004-04-01,10,0,0,3,0,13
Pakistan,2004-04-01,8,0,0,-2,0,6
Pakistan,2004-04-01,36,0,0,5,8,49
Pakistan,2004-05-01,21,0,0,3,10,34
Pakistan,2004-05-01,12,0,0,9,1,22
Pakistan,2004-05-01,19,0,0,14,0,33
Pakistan,2004-05-01,51,0,0,7,0,58
Pakistan,2004-05-01,19,0,0,-6,8,21
Pakistan,2004-05-01,12,0,0,15,0,27
Pakistan,2004-05-01,4,0,0,21,0,25
Pakistan,2004-05-01,18,0,0,9,0,27
Pakistan,2004-05-01,8,0,0,-8,0,0
Pakistan,2004-05-01,8,0,0,6,3,17
Pakistan,2004-05-01,24,0,-1,6,5,34
Pakistan,2004-05-01,32,0,0,15,10,57
Pakistan,2004-05-01,22,0,-3,13,0,32
Pakistan,2004-05-01,6,0,0,0,3,9
Pakistan,2004-05-01,11,0,0,-3,0,8
Pakistan,2004-05-01,0,0,0,3,0,3
Pakistan,2004-05-01,5,4,0,-4,0,5
Pakistan,2004-05-01,15,0,-1,1,1,16
Pakistan,2004-05-01,46,0,0,6,7,59
Pakistan,2004-05-01,50,0,0,2,3,55
Pakistan,2004-05-01,11,0,0,6,-2,15
Pakistan,2004-05-01,14,0,2,6,1,23
Pakistan,2004-05-01,2,0,0,0,1,3
Pakistan,2004-05-01,12,0,0,10,0,22
Pakistan,2004-05-01,5,0,0,9,0,14
Pakistan,2004-05-01,18,0,0,18,0,36
Pakistan,2004-05-01,31,0,0,6,2,39
Pakistan,2004-05-01,0,0,0,30,1,31
Pakistan,2004-05-01,34,0,0,24,3,61
Pakistan,2004-05-01,3,0,0,0,0,3
Pakistan,2004-05-01,22,0,0,3,4,29
Pakistan,2004-06-01,15,0,0,6,0,21
Pakistan,2004-06-01,8,0,0,4,1,13
Pakistan,2004-06-01,43,0,-3,6,1,47
Pakistan,2004-06-01,3,0,0,21,0,24
Pakistan,2004-06-01,28,0,0,-2,0,26
Pakistan,2004-06-01,32,0,0,3,0,35
Pakistan,2004-06-01,30,0,-1,6,2,37
Pakistan,2004-06-01,14,0,0,3,0,17
Pakistan,2004-06-01,18,0,0,3,0,21
Pakistan,2004-06-01,52,0,0,0,3,55
Pakistan,2004-06-01,46,0,0,12,0,58
Pakistan,2004-06-01,68,0,0,5,4,77
Pakistan,2004-06-01,9,0,0,27,0,36
Pakistan,2004-06-01,22,0,-4,39,0,57
Pakistan,2004-06-01,37,0,0,18,3,58
Pakistan,2004-06-01,13,0,0,10,0,23
Pakistan,2004-06-01,15,0,2,20,0,37
Pakistan,2004-06-01,33,0,0,3,0,36
Pakistan,2004-06-01,26,0,0,12,2,40
Pakistan,2004-06-01,19,0,0,6,0,25
Pakistan,2004-06-01,9,0,0,3,0,12
Pakistan,2004-06-01,11,2,0,6,-1,18
Pakistan,2004-06-01,24,0,0,6,1,31
Pakistan,2004-06-01,6,0,0,0,0,6
Pakistan,2004-06-01,8,8,1,-2,0,15
Pakistan,2004-06-01,15,0,-6,0,4,13
Pakistan,2004-06-01,2,0,1,0,3,6
Pakistan,2004-06-01,35,0,0,17,4,56
Pakistan,2004-06-01,6,0,-2,22,0,26
Pakistan,2004-06-01,12,0,0,5,3,20
Pakistan,2004-07-01,22,0,0,12,11,45
Pakistan,2004-07-01,19,0,0,1,0,20
Pakistan,2004-07-01,18,0,0,1,0,19
Pakistan,2004-07-01,0,0,0,6,0,6
Pakistan,2004-07-01,6,0,0,4,1,11
Pakistan,2004-07-01,15,0,0,19,0,34
Pakistan,2004-07-01,12,0,-3,23,0,32
Pakistan,2004-07-01,11,0,-8,33,1,37
Pakistan,2004-07-01,-1,0,0,30,1,30
Pakistan,2004-07-01,16,0,0,3,1,20
Pakistan,2004-07-01,11,0,0,-1,0,10
Pakistan,2004-07-01,25,0,0,1,0,26
Pakistan,2004-07-01,16,0,0,21,0,37
Pakistan,2004-07-01,7,0,0,33,0,40
Pakistan,2004-07-01,0,0,1,23,0,24
Pakistan,2004-07-01,1,0,1,13,0,15
Pakistan,2004-07-01,2,0,0,-4,0,-2
Pakistan,2004-07-01,6,0,0,9,2,17
Pakistan,2004-07-01,12,0,0,4,0,16
Pakistan,2004-07-01,4,0,0,-4,1,1
Pakistan,2004-07-01,0,0,0,-1,6,5
Pakistan,2004-07-01,2,0,0,3,0,5
Pakistan,2004-07-01,1,0,0,0,2,3
Pakistan,2004-07-01,23,0,0,3,0,26
Pakistan,2004-07-01,8,0,0,1,2,11
Pakistan,2004-07-01,18,0,0,16,4,38
Pakistan,2004-07-01,37,0,1,9,1,48
Pakistan,2004-07-01,35,0,0,-4,1,32
Pakistan,2004-07-01,14,0,0,13,6,33
Pakistan,2004-07-01,13,0,0,9,24,46
Pakistan,2004-07-01,3,0,0,7,1,11
Pakistan,2004-08-01,18,0,0,6,1,25
Pakistan,2004-08-01,22,0,0,30,1,53
Pakistan,2004-08-01,41,0,0,15,1,57
Pakistan,2004-08-01,19,4,0,21,3,47
Pakistan,2004-08-01,16,0,0,31,2,49
Pakistan,2004-08-01,57,0,0,37,6,100
Pakistan,2004-08-01,37,0,0,25,0,62
Pakistan,2004-08-01,17,2,0,36,0,55
Pakistan,2004-08-01,24,0,0,16,0,40
Pakistan,2004-08-01,21,0,0,10,6,37
Pakistan,2004-08-01,17,0,0,5,0,22
Pakistan,2004-08-01,11,0,0,15,0,26
Pakistan,2004-08-01,12,4,0,2,0,18
Pakistan,2004-08-01,0,0,0,18,0,18
Pakistan,2004-08-01,29,0,0,-2,0,27
Pakistan,2004-08-01,5,0,0,5,0,10
Pakistan,2004-08-01,5,0,0,30,0,35
Pakistan,2004-08-01,8,0,0,3,0,11
Pakistan,2004-08-01,-2,0,-1,3,0,0
Pakistan,2004-08-01,12,0,0,6,0,18
Pakistan,2004-08-01,17,0,0,12,0,29
Pakistan,2004-08-01,6,0,0,4,0,10
Pakistan,2004-08-01,11,0,0,0,0,11
Pakistan,2004-08-01,11,0,0,16,1,28
Pakistan,2004-08-01,17,0,-2,1,0,16
Pakistan,2004-08-01,4,0,-6,9,0,7
Pakistan,2004-08-01,5,0,0,6,3,14
Pakistan,2004-08-01,6,0,0,9,0,15
Pakistan,2004-08-01,1,0,0,12,1,14
Pakistan,2004-08-01,21,0,0,21,0,42
Pakistan,2004-08-01,13,0,0,0,0,13
Pakistan,2004-09-01,8,0,0,8,0,16
Pakistan,2004-09-01,37,0,-2,12,0,47
Pakistan,2004-09-01,5,0,0,8,0,13
Pakistan,2004-09-01,15,0,1,6,0,22
Pakistan,2004-09-01,13,0,0,3,4,20
Pakistan,2004-09-01,5,0,0,3,0,8
Pakistan,2004-09-01,6,0,0,6,0,12
Pakistan,2004-09-01,1,0,0,2,0,3
Pakistan,2004-09-01,18,0,0,6,6,30
Pakistan,2004-09-01,28,0,0,2,2,32
Pakistan,2004-09-01,21,0,1,6,0,28
Pakistan,2004-09-01,18,0,0,-20,0,-2
Pakistan,2004-09-01,-3,0,1,-1,2,-1
Pakistan,2004-09-01,7,0,-1,10,2,18
Pakistan,2004-09-01,24,0,-4,27,1,48
Pakistan,2004-09-01,11,0,-3,2,-1,9
Pakistan,2004-09-01,14,0,0,0,4,18
Pakistan,2004-09-01,26,0,0,-6,0,20
Pakistan,2004-09-01,2,0,0,-6,0,-4
Pakistan,2004-09-01,5,0,-2,-6,1,-2
Pakistan,2004-09-01,8,0,0,10,0,18
Pakistan,2004-09-01,20,0,1,-12,3,12
Pakistan,2004-09-01,27,0,-2,12,0,37
Pakistan,2004-09-01,23,0,-2,3,-4,20
Pakistan,2004-09-01,26,0,0,9,4,39
Pakistan,2004-09-01,2,0,0,4,0,6
Pakistan,2004-09-01,2,0,0,-2,1,1
Pakistan,2004-09-01,13,0,0,0,3,16
Pakistan,2004-09-01,9,0,0,1,0,10
Pakistan,2004-09-01,23,0,3,-2,1,25
Pakistan,2004-10-01,4,0,0,12,0,16
Pakistan,2004-10-01,9,0,0,0,1,10
Pakistan,2004-10-01,0,0,0,0,0,0
Pakistan,2004-10-01,24,0,0,-4,0,20
Pakistan,2004-10-01,12,0,0,10,0,22
Pakistan,2004-10-01,6,2,0,12,0,20
Pakistan,2004-10-01,23,0,0,17,5,45
Pakistan,2004-10-01,55,0,0,6,1,62
Pakistan,2004-10-01,10,0,0,6,4,20
Pakistan,2004-10-01,1,0,0,10,1,12
Pakistan,2004-10-01,25,0,0,15,2,42
Pakistan,2004-10-01,2,0,-4,2,0,0
Pakistan,2004-10-01,14,0,1,-2,1,14
Pakistan,2004-10-01,10,0,0,1,0,11
Pakistan,2004-10-01,8,0,0,4,1,13
Pakistan,2004-10-01,0,0,0,9,0,9
Pakistan,2004-10-01,0,0,0,0,0,0
Pakistan,2004-10-01,17,0,0,3,1,21
Pakistan,2004-10-01,20,0,0,30,6,56
Pakistan,2004-10-01,12,0,0,2,0,14
Pakistan,2004-10-01,0,0,-2,5,2,5
Pakistan,2004-10-01,12,0,0,9,1,22
Pakistan,2004-10-01,15,0,0,-14,0,1
Pakistan,2004-10-01,0,0,0,-1,0,-1
Pakistan,2004-10-01,12,0,0,-5,1,8
Pakistan,2004-10-01,20,0,0,0,1,21
Pakistan,2004-10-01,32,0,0,6,5,43
Pakistan,2004-10-01,4,0,0,9,0,13
Pakistan,2004-10-01,5,0,0,29,2,36
Pakistan,2004-10-01,11,0,0,3,2,16
Pakistan,2004-10-01,2,0,0,-2,0,0
Pakistan,2004-11-01,7,0,0,6,2,15
Pakistan,2004-11-01,4,0,0,3,1,8
Pakistan,2004-11-01,7,0,0,6,0,13
Pakistan,2004-11-01,17,0,0,0,0,17
Pakistan,2004-11-01,0,0,0,6,1,7
Pakistan,2004-11-01,46,0,0,9,0,55
Pakistan,2004-11-01,12,0,0,18,0,30
Pakistan,2004-11-01,21,0,0,0,3,24
Pakistan,2004-11-01,3,0,0,0,0,3
Pakistan,2004-11-01,6,0,0,15,0,21
Pakistan,2004-11-01,10,0,0,12,0,22
Pakistan,2004-11-01,20,0,0,0,0,20
Pakistan,2004-11-01,9,0,0,7,4,20
Pakistan,2004-11-01,1,0,0,0,0,1
Pakistan,2004-11-01,22,0,0,7,0,29
Pakistan,2004-11-01,28,0,-1,2,0,29
Pakistan,2004-11-01,-1,0,0,4,0,3
Pakistan,2004-11-01,2,0,0,4,0,6
Pakistan,2004-11-01,10,0,-6,3,0,7
Pakistan,2004-11-01,11,0,0,-1,0,10
Pakistan,2004-11-01,5,0,0,3,2,10
Pakistan,2004-11-01,2,0,0,6,0,8
Pakistan,2004-11-01,4,0,0,4,0,8
Pakistan,2004-11-01,1,0,0,9,3,13
Pakistan,2004-11-01,12,0,0,6,2,20
Pakistan,2004-11-01,3,0,0,3,0,6
Pakistan,2004-11-01,3,0,0,5,1,9
Pakistan,2004-11-01,14,0,0,3,3,20
Pakistan,2004-11-01,15,0,0,3,0,18
Pakistan,2004-11-01,15,0,0,-10,0,5
Pakistan,2004-12-01,26,0,0,7,0,33
Pakistan,2004-12-01,4,0,0,1,0,5
Pakistan,2004-12-01,13,0,0,6,3,22
Pakistan,2004-12-01,17,0,0,3,0,20
Pakistan,2004-12-01,24,0,0,3,0,27
Pakistan,2004-12-01,0,0,-2,-2,0,-4
Pakistan,2004-12-01,28,0,0,0,3,31
Pakistan,2004-12-01,18,0,1,4,1,24
Pakistan,2004-12-01,18,0,0,3,0,21
Pakistan,2004-12-01,12,0,0,0,0,12
Pakistan,2004-12-01,1,0,0,7,0,8
Pakistan,2004-12-01,16,0,0,9,0,25
Pakistan,2004-12-01,8,0,1,9,0,18
Pakistan,2004-12-01,15,0,0,9,2,26
Pakistan,2004-12-01,19,0,0,1,0,20
Pakistan,2004-12-01,10,0,0,12,4,26
Pakistan,2004-12-01,14,0,0,4,0,18
Pakistan,2004-12-01,12,0,0,12,2,26
Pakistan,2004-12-01,6,0,0,0,0,6
Pakistan,2004-12-01,5,0,-2,-2,0,1
Pakistan,2004-12-01,29,0,0,4,1,34
Pakistan,2004-12-01,11,0,1,9,3,24
Pakistan,2004-12-01,-2,0,0,0,0,-2
Pakistan,2004-12-01,6,0,0,3,0,9
Pakistan,2004-12-01,1,0,0,6,0,7
Pakistan,2004-12-01,11,0,0,4,0,15
Pakistan,2004-12-01,8,0,0,9,3,20
Pakistan,2004-12-01,17,0,2,15,0,34
Pakistan,2004-12-01,7,0,0,0,0,7
Pakistan,2004-12-01,9,0,0,-2,0,7
Pakistan,2004-12-01,-7,0,0,18,0,11
Sierra Leone,2004-01-01,2,0,0,0,0,2
Sierra Leone,2004-01-01,2,0,0,0,2,4
Sierra Leone,2004-01-01,2,0,0,0,0,2
Sierra Leone,2004-01-01,6,0,0,0,0,6
Sierra Leone,2004-01-01,0,0,0,0,0,0
Sierra Leone,2004-01-01,2,0,0,0,0,2
Sierra Leone,2004-01-01,0,0,0,0,0,0
Sierra Leone,2004-01-01,0,0,0,0,0,0
Sierra Leone,2004-01-01,0,0,0,-4,0,-4
Sierra Leone,2004-01-01,2,0,0,0,0,2
Sierra Leone,2004-01-01,0,0,0,0,4,4
Sierra Leone,2004-01-01,-1,0,0,6,0,5
Sierra Leone,2004-01-01,0,0,0,0,1,1
Sierra Leone,2004-01-01,0,0,0,0,0,0
Sierra Leone,2004-01-01,0,0,0,0,1,1
Sierra Leone,2004-01-01,-1,0,0,0,0,-1
Sierra Leone,2004-01-01,2,0,0,3,0,5
Sierra Leone,2004-01-01,0,0,0,0,0,0
Sierra Leone,2004-01-01,1,0,0,0,0,1
Sierra Leone,2004-01-01,0,0,0,0,0,0
Sierra Leone,2004-01-01,2,0,0,0,0,2
Sierra Leone,2004-01-01,2,0,0,-4,0,-2
Sierra Leone,2004-01-01,0,0,0,0,0,0
Sierra Leone,2004-01-01,0,6,0,0,0,6
Sierra Leone,2004-01-01,0,0,0,0,0,0
Sierra Leone,2004-02-01,0,0,0,3,0,3
Sierra Leone,2004-02-01,0,0,0,0,0,0
Sierra Leone,2004-02-01,4,0,0,0,0,4
Sierra Leone,2004-02-01,0,0,0,9,1,10
Sierra Leone,2004-02-01,2,0,0,3,0,5
Sierra Leone,2004-02-01,0,4,0,0,0,4
Sierra Leone,2004-02-01,1,0,0,0,0,1
Sierra Leone,2004-02-01,0,0,0,0,0,0
Sierra Leone,2004-02-01,0,0,0,0,1,1
Sierra Leone,2004-02-01,0,0,0,0,0,0
Sierra Leone,2004-02-01,3,0,0,6,0,9
Sierra Leone,2004-02-01,0,0,0,3,1,4
Sierra Leone,2004-02-01,3,0,0,0,0,3
Sierra Leone,2004-02-01,1,0,0,0,0,1
Sierra Leone,2004-02-01,1,0,0,3,-4,0
Sierra Leone,2004-02-01,2,0,0,6,0,8
Sierra Leone,2004-02-01,2,0,0,0,0,2
Sierra Leone,2004-02-01,6,0,0,-4,2,4
Sierra Leone,2004-02-01,7,0,0,0,0,7
Sierra Leone,2004-02-01,2,0,0,3,0,5
Sierra Leone,2004-02-01,3,0,0,6,0,9
Sierra Leone,2004-02-01,-3,0,0,7,0,4
Sierra Leone,2004-02-01,0,0,0,0,0,0
Sierra Leone,2004-02-01,2,0,0,0,0,2
Sierra Leone,2004-02-01,0,0,0,0,0,0
Sierra Leone,2004-03-01,0,0,0,-5,0,-5
Sierra Leone,2004-03-01,6,0,0,-2,0,4
Sierra Leone,2004-03-01,0,0,0,0,0,0
Sierra Leone,2004-03-01,0,0,0,0,0,0
Sierra Leone,2004-03-01,0,0,0,0,0,0
Sierra Leone,2004-03-01,1,0,0,0,0,1
Sierra Leone,2004-03-01,12,0,0,6,0,18
Sierra Leone,2004-03-01,0,0,0,0,0,0
Sierra Leone,2004-03-01,3,0,0,6,1,10
Sierra Leone,2004-03-01,4,0,0,0,1,5
Sierra Leone,2004-03-01,2,0,0,6,2,10
Sierra Leone,2004-03-01,0,0,0,9,0,9
Sierra Leone,2004-03-01,-1,0,0,3,0,2
Sierra Leone,2004-03-01,2,0,0,0,0,2
Sierra Leone,2004-03-01,8,0,0,6,0,14
Sierra Leone,2004-03-01,-2,0,0,12,0,10
Sierra Leone,2004-03-01,0,0,0,-16,0,-16
Sierra Leone,2004-03-01,-8,0,0,3,0,-5
Sierra Leone,2004-03-01,8,0,-1,3,1,11
Sierra Leone,2004-03-01,-17,0,0,0,0,-17
Sierra Leone,2004-03-01,4,0,0,3,2,9
Sierra Leone,2004-03-01,2,0,0,0,0,2
Sierra Leone,2004-03-01,10,0,0,0,0,10
Sierra Leone,2004-03-01,3,0,0,0,0,3
Sierra Leone,2004-03-01,2,0,0,0,2,4
Sierra Leone,2004-03-01,2,0,0,0,0,2
Sierra Leone,2004-03-01,1,0,0,0,0,1
Sierra Leone,2004-04-01,6,0,0,0,0,6
Sierra Leone,2004-04-01,0,0,0,-2,0,-2
Sierra Leone,2004-04-01,0,0,0,0,0,0
Sierra Leone,2004-04-01,4,0,0,-4,0,0
Sierra Leone,2004-04-01,1,0,0,0,2,3
Sierra Leone,2004-04-01,-1,0,0,6,0,5
Sierra Leone,2004-04-01,0,0,0,0,0,0
Sierra Leone,2004-04-01,0,0,0,0,0,0
Sierra Leone,2004-04-01,-3,0,0,6,0,3
Sierra Leone,2004-04-01,2,0,0,3,0,5
Sierra Leone,2004-04-01,0,0,0,3,0,3
Sierra Leone,2004-04-01,2,0,0,0,0,2
Sierra Leone,2004-04-01,0,0,0,0,0,0
Sierra Leone,2004-04-01,5,0,2,0,1,8
Sierra Leone,2004-04-01,4,0,0,3,0,7
Sierra Leone,2004-04-01,1,0,0,0,0,1
Sierra Leone,2004-04-01,1,0,0,0,1,2
Sierra Leone,2004-04-01,0,0,0,0,0,0
Sierra Leone,2004-04-01,0,0,0,0,0,0
Sierra Leone,2004-04-01,9,0,0,0,0,9
Sierra Leone,2004-04-01,0,0,0,0,0,0
Sierra Leone,2004-04-01,1,0,0,9,0,10
Sierra Leone,2004-04-01,-4,0,0,-8,0,-12
Sierra Leone,2004-04-01,0,0,0,0,0,0
Sierra Leone,2004-05-01,0,0,0,0,0,0
Sierra Leone,2004-05-01,0,0,0,3,0,3
Sierra Leone,2004-05-01,4,0,0,3,0,7
Sierra Leone,2004-05-01,0,0,0,-2,1,-1
Sierra Leone,2004-05-01,1,0,0,0,0,1
Sierra Leone,2004-05-01,2,0,0,0,1,3
Sierra Leone,2004-05-01,-1,0,0,0,0,-1
Sierra Leone,2004-05-01,0,0,0,0,0,0
Sierra Leone,2004-05-01,0,0,0,3,0,3
Sierra Leone,2004-05-01,0,2,0,0,0,2
Sierra Leone,2004-05-01,0,0,0,0,0,0
Sierra Leone,2004-05-01,2,0,0,0,0,2
Sierra Leone,2004-05-01,0,0,0,0,0,0
Sierra Leone,2004-05-01,-1,0,0,0,1,0
Sierra Leone,2004-05-01,9,0,0,0,0,9
Sierra Leone,2004-05-01,2,2,0,1,0,5
Sierra Leone,2004-05-01,4,0,0,0,0,4
Sierra Leone,2004-05-01,0,0,0,0,0,0
Sierra Leone,2004-05-01,0,0,0,0,0,0
Sierra Leone,2004-05-01,0,2,0,0,0,2
Sierra Leone,2004-05-01,0,0,0,0,0,0
Sierra Leone,2004-05-01,-6,0,0,0,0,-6
Sierra Leone,2004-05-01,0,0,0,0,0,0
Sierra Leone,2004-06-01,5,0,0,3,0,8
Sierra Leone,2004-06-01,0,0,0,0,0,0
Sierra Leone,2004-06-01,2,0,0,0,0,2
Sierra Leone,2004-06-01,1,0,0,6,0,7
Sierra Leone,2004-06-01,4,0,0,0,0,4
Sierra Leone,2004-06-01,0,0,0,3,0,3
Sierra Leone,2004-06-01,1,0,0,0,0,1
Sierra Leone,2004-06-01,6,0,0,0,0,6
Sierra Leone,2004-06-01,0,0,0,0,0,0
Sierra Leone,2004-06-01,3,0,0,3,0,6
Sierra Leone,2004-06-01,0,0,0,6,1,7
Sierra Leone,2004-06-01,0,0,0,0,0,0
Sierra Leone,2004-06-01,3,0,0,0,0,3
Sierra Leone,2004-06-01,7,0,0,6,0,13
Sierra Leone,2004-06-01,9,0,0,6,0,15
Sierra Leone,2004-06-01,1,0,0,0,0,1
Sierra Leone,2004-06-01,0,0,0,0,0,0
Sierra Leone,2004-06-01,2,0,0,0,5,7
Sierra Leone,2004-06-01,0,0,0,0,5,5
Sierra Leone,2004-06-01,10,0,0,0,1,11
Sierra Leone,2004-06-01,1,0,0,0,2,3
Sierra Leone,2004-06-01,2,0,0,0,0,2
Sierra Leone,2004-06-01,0,0,0,0,0,0
Sierra Leone,2004-06-01,3,0,0,0,0,3
Sierra Leone,2004-06-01,6,0,0,0,0,6
Sierra Leone,2004-06-01,2,0,0,-4,0,-2
Sierra Leone,2004-07-01,8,0,0,9,0,17
Sierra Leone,2004-07-01,2,0,0,6,0,8
Sierra Leone,2004-07-01,0,0,0,6,0,6
Sierra Leone,2004-07-01,16,0,0,0,0,16
Sierra Leone,2004-07-01,0,0,0,3,0,3
Sierra Leone,2004-07-01,6,0,0,0,0,6
Sierra Leone,2004-07-01,0,0,0,0,0,0
Sierra Leone,2004-07-01,1,2,0,0,0,3
Sierra Leone,2004-07-01,0,0,0,6,0,6
Sierra Leone,2004-07-01,0,0,0,0,0,0
Sierra Leone,2004-07-01,4,0,0,0,0,4
Sierra Leone,2004-07-01,3,0,0,21,2,26
Sierra Leone,2004-07-01,0,0,0,-2,0,-2
Sierra Leone,2004-07-01,5,0,0,6,0,11
Sierra Leone,2004-07-01,8,0,0,-2,0,6
Sierra Leone,2004-07-01,0,0,0,0,1,1
Sierra Leone,2004-07-01,3,0,0,0,1,4
Sierra Leone,2004-07-01,10,0,0,-2,1,9
Sierra Leone,2004-07-01,2,0,0,6,0,8
Sierra Leone,2004-07-01,14,0,-2,0,0,12
Sierra Leone,2004-07-01,9,0,0,-4,0,5
Sierra Leone,2004-07-01,1,0,0,6,0,7
Sierra Leone,2004-07-01,2,0,0,0,0,2
Sierra Leone,2004-07-01,4,0,0,3,0,7
Sierra Leone,2004-07-01,7,0,0,6,0,13
Sierra Leone,2004-07-01,3,0,0,4,0,7
Sierra Leone,2004-07-01,0,0,0,0,0,0
Sierra Leone,2004-08-01,0,0,0,0,0,0
Sierra Leone,2004-08-01,3,0,0,0,0,3
Sierra Leone,2004-08-01,1,0,0,0,0,1
Sierra Leone,2004-08-01,2,0,0,-1,0,1
Sierra Leone,2004-08-01,0,0,0,12,0,12
Sierra Leone,2004-08-01,0,0,0,0,2,2
Sierra Leone,2004-08-01,0,0,0,3,0,3
Sierra Leone,2004-08-01,0,0,0,3,0,3
Sierra Leone,2004-08-01,0,0,0,6,0,6
Sierra Leone,2004-08-01,-1,0,0,0,1,0
Sierra Leone,2004-08-01,0,0,0,0,1,1
Sierra Leone,2004-08-01,1,0,0,0,0,1
Sierra Leone,2004-08-01,1,0,0,0,2,3
Sierra Leone,2004-08-01,6,0,0,0,1,7
Sierra Leone,2004-08-01,0,0,0,-2,0,-2
Sierra Leone,2004-08-01,0,0,0,12,0,12
Sierra Leone,2004-08-01,6,0,0,3,2,11
Sierra Leone,2004-08-01,0,0,0,0,0,0
Sierra Leone,2004-08-01,0,0,0,0,0,0
Sierra Leone,2004-08-01,0,0,0,0,0,0
Sierra Leone,2004-08-01,3,0,0,0,0,3
Sierra Leone,2004-08-01,2,0,0,0,0,2
Sierra Leone,2004-08-01,-1,0,-2,0,0,-3
Sierra Leone,2004-08-01,0,0,0,0,0,0
Sierra Leone,2004-08-01,1,0,0,0,0,1
Sierra Leone,2004-08-01,0,0,0,6,0,6
Sierra Leone,2004-08-01,0,0,0,-2,0,-2
Sierra Leone,2004-08-01,0,0,0,9,0,9
Sierra Leone,2004-09-01,4,0,0,0,0,4
Sierra Leone,2004-09-01,0,0,0,-6,0,-6
Sierra Leone,2004-09-01,9,0,-2,0,0,7
Sierra Leone,2004-09-01,4,0,0,0,0,4
Sierra Leone,2004-09-01,2,0,0,0,0,2
Sierra Leone,2004-09-01,0,0,0,-4,1,-3
Sierra Leone,2004-09-01,0,0,0,0,1,1
Sierra Leone,2004-09-01,2,0,0,3,0,5
Sierra Leone,2004-09-01,0,0,0,0,0,0
Sierra Leone,2004-09-01,0,0,0,0,0,0
Sierra Leone,2004-09-01,0,0,0,0,0,0
Sierra Leone,2004-09-01,7,0,0,-6,0,1
Sierra Leone,2004-09-01,3,0,0,6,0,9
Sierra Leone,2004-09-01,6,0,0,0,0,6
Sierra Leone,2004-09-01,0,0,0,1,0,1
Sierra Leone,2004-09-01,-1,0,0,6,0,5
Sierra Leone,2004-09-01,0,0,1,3,0,4
Sierra Leone,2004-09-01,-8,0,0,3,0,-5
Sierra Leone,2004-09-01,2,0,0,1,3,6
Sierra Leone,2004-09-01,7,0,0,1,0,8
Sierra Leone,2004-09-01,3,0,0,9,0,12
Sierra Leone,2004-10-01,-4,0,0,0,2,-2
Sierra Leone,2004-10-01,1,0,0,-2,0,-1
Sierra Leone,2004-10-01,9,0,0,0,0,9
Sierra Leone,2004-10-01,8,0,0,3,0,11
Sierra Leone,2004-10-01,2,0,-1,0,1,2
Sierra Leone,2004-10-01,0,0,0,0,0,0
Sierra Leone,2004-10-01,0,0,0,0,0,0
Sierra Leone,2004-10-01,2,0,0,6,0,8
Sierra Leone,2004-10-01,1,0,0,0,1,2
Sierra Leone,2004-10-01,3,0,0,9,0,12
Sierra Leone,2004-10-01,-1,0,0,0,0,-1
Sierra Leone,2004-10-01,0,0,0,0,0,0
Sierra Leone,2004-10-01,0,0,0,0,0,0
Sierra Leone,2004-10-01,4,0,0,-6,0,-2
Sierra Leone,2004-10-01,0,0,0,0,0,0
Sierra Leone,2004-10-01,1,0,0,0,0,1
Sierra Leone,2004-10-01,6,0,0,-1,0,5
Sierra Leone,2004-10-01,3,0,0,3,1,7
Sierra Leone,2004-10-01,0,0,0,0,0,0
Sierra Leone,2004-10-01,0,0,0,0,0,0
Sierra Leone,2004-10-01,10,0,0,-2,0,8
Sierra Leone,2004-10-01,1,0,0,6,0,7
Sierra Leone,2004-10-01,6,0,0,3,0,9
Sierra Leone,2004-10-01,4,0,0,12,0,16
Sierra Leone,2004-10-01,0,0,0,0,0,0
Sierra Leone,2004-10-01,2,0,0,0,0,2
Sierra Leone,2004-10-01,2,0,0,0,0,2
Sierra Leone,2004-11-01,0,0,0,0,0,0
Sierra Leone,2004-11-01,0,0,0,0,0,0
Sierra Leone,2004-11-01,4,0,0,-2,0,2
Sierra Leone,2004-11-01,3,0,0,1,0,4
Sierra Leone,2004-11-01,2,0,0,0,0,2
Sierra Leone,2004-11-01,0,0,0,0,0,0
Sierra Leone,2004-11-01,0,0,0,0,0,0
Sierra Leone,2004-11-01,0,0,0,0,0,0
Sierra Leone,2004-11-01,4,0,0,0,0,4
Sierra Leone,2004-11-01,7,0,0,0,0,7
Sierra Leone,2004-11-01,0,0,0,0,0,0
Sierra Leone,2004-11-01,-1,2,0,0,0,1
Sierra Leone,2004-11-01,2,0,0,3,0,5
Sierra Leone,2004-11-01,10,0,0,9,0,19
Sierra Leone,2004-11-01,2,0,0,0,0,2
Sierra Leone,2004-11-01,1,0,0,0,0,1
Sierra Leone,2004-11-01,0,0,0,3,0,3
Sierra Leone,2004-11-01,4,0,-1,-2,0,1
Sierra Leone,2004-11-01,2,0,0,0,0,2
Sierra Leone,2004-11-01,4,0,0,0,0,4
Sierra Leone,2004-11-01,0,0,0,0,0,0
Sierra Leone,2004-11-01,0,0,0,0,0,0
Sierra Leone,2004-11-01,0,0,0,0,0,0
Sierra Leone,2004-12-01,2,0,0,0,2,4
Sierra Leone,2004-12-01,0,0,0,0,1,1
Sierra Leone,2004-12-01,2,0,1,0,2,5
Sierra Leone,2004-12-01,-1,0,0,0,0,-1
Sierra Leone,2004-12-01,3,0,0,-2,0,1
Sierra Leone,2004-12-01,4,0,0,0,0,4
Sierra Leone,2004-12-01,0,0,0,-1,3,2
Sierra Leone,2004-12-01,0,0,0,0,1,1
Sierra Leone,2004-12-01,0,0,0,0,0,0
Sierra Leone,2004-12-01,1,0,0,0,0,1
Sierra Leone,2004-12-01,0,0,-2,0,0,-2
Sierra Leone,2004-12-01,0,0,0,0,0,0
Sierra Leone,2004-12-01,3,0,0,0,0,3
Sierra Leone,2004-12-01,0,0,0,0,0,0
Sierra Leone,2004-12-01,-2,0,0,12,0,10
Sierra Leone,2004-12-01,-1,0,0,0,0,-1
Sierra Leone,2004-12-01,0,0,0,0,7,7
Sierra Leone,2004-12-01,0,0,0,0,0,0
Sierra Leone,2004-12-01,2,0,0,3,0,5
Sierra Leone,2004-12-01,0,0,0,0,0,0
Somalia,2004-01-01,0,0,0,0,1,1
Somalia,2004-01-01,1,0,0,3,0,4
Somalia,2004-01-01,0,0,0,0,0,0
Somalia,2004-01-01,3,0,0,0,0,3
Somalia,2004-01-01,0,0,0,0,0,0
Somalia,2004-01-01,1,0,0,6,0,7
Somalia,2004-01-01,4,0,0,-2,0,2
Somalia,2004-01-01,-1,0,1,0,0,0
Somalia,2004-01-01,5,0,0,0,0,5
Somalia,2004-01-01,0,0,0,3,0,3
Somalia,2004-01-01,7,0,0,0,0,7
Somalia,2004-01-01,2,0,0,0,0,2
Somalia,2004-01-01,0,0,0,0,1,1
Somalia,2004-01-01,0,0,0,0,1,1
Somalia,2004-01-01,2,0,0,0,0,2
Somalia,2004-01-01,0,0,0,0,0,0
Somalia,2004-01-01,2,0,0,-2,1,1
Somalia,2004-01-01,12,0,0,0,0,12
Somalia,2004-01-01,2,0,0,0,0,2
Somalia,2004-01-01,4,0,0,0,0,4
Somalia,2004-01-01,4,0,0,0,0,4
Somalia,2004-01-01,1,0,0,0,2,3
Somalia,2004-01-01,-8,0,0,0,0,-8
Somalia,2004-01-01,9,0,-3,6,0,12
Somalia,2004-01-01,16,0,0,3,0,19
Somalia,2004-01-01,0,0,0,0,0,0
Somalia,2004-01-01,6,0,0,0,2,8
Somalia,2004-01-01,3,0,0,0,0,3
Somalia,2004-02-01,0,0,0,0,0,0
Somalia,2004-02-01,0,0,0,0,0,0
Somalia,2004-02-01,0,0,0,0,0,0
Somalia,2004-02-01,10,0,0,0,0,10
Somalia,2004-02-01,4,0,0,6,0,10
Somalia,2004-02-01,19,0,0,3,0,22
Somalia,2004-02-01,-1,0,0,0,0,-1
Somalia,2004-02-01,0,0,0,0,0,0
Somalia,2004-02-01,0,0,0,0,0,0
Somalia,2004-02-01,3,0,0,0,0,3
Somalia,2004-02-01,0,0,0,0,0,0
Somalia,2004-02-01,0,0,0,0,0,0
Somalia,2004-02-01,7,0,0,0,0,7
Somalia,2004-02-01,4,0,0,0,0,4
Somalia,2004-02-01,0,0,0,0,0,0
Somalia,2004-02-01,3,0,0,3,0,6
Somalia,2004-02-01,-2,0,0,0,0,-2
Somalia,2004-02-01,1,0,0,0,0,1
Somalia,2004-02-01,5,0,0,0,0,5
Somalia,2004-02-01,0,0,0,0,0,0
Somalia,2004-02-01,-1,0,0,0,0,-1
Somalia,2004-02-01,2,0,0,3,0,5
Somalia,2004-02-01,2,0,1,0,0,3
Somalia,2004-02-01,-2,0,0,0,0,-2
Somalia,2004-02-01,0,0,0,0,0,0
Somalia,2004-02-01,0,2,0,0,0,2
Somalia,2004-02-01,2,0,0,0,1,3
Somalia,2004-02-01,0,0,0,0,0,0
Somalia,2004-03-01,0,0,0,0,0,0
Somalia,2004-03-01,1,0,0,3,0,4
Somalia,2004-03-01,4,0,0,1,1,6
Somalia,2004-03-01,0,0,0,0,0,0
Somalia,2004-03-01,2,0,0,0,0,2
Somalia,2004-03-01,6,0,-1,0,0,5
Somalia,2004-03-01,7,0,0,1,0,8
Somalia,2004-03-01,10,0,0,6,0,16
Somalia,2004-03-01,3,0,0,0,0,3
Somalia,2004-03-01,2,0,0,0,0,2
Somalia,2004-03-01,2,0,0,3,0,5
Somalia,2004-03-01,2,0,0,0,0,2
Somalia,2004-03-01,5,0,0,0,0,5
Somalia,2004-03-01,2,0,0,0,0,2
Somalia,2004-03-01,7,0,0,0,0,7
Somalia,2004-03-01,0,0,0,6,0,6
Somalia,2004-03-01,0,0,0,0,0,0
Somalia,2004-03-01,0,0,0,0,0,0
Somalia,2004-03-01,-1,0,0,-2,0,-3
Somalia,2004-03-01,6,0,1,3,1,11
Somalia,2004-03-01,1,0,0,0,0,1
Somalia,2004-03-01,0,0,0,0,0,0
Somalia,2004-03-01,0,0,0,0,0,0
Somalia,2004-03-01,2,0,0,0,0,2
Somalia,2004-03-01,11,0,0,0,0,11
Somalia,2004-03-01,0,0,0,0,0,0
Somalia,2004-03-01,1,0,0,0,0,1
Somalia,2004-03-01,0,0,0,0,0,0
Somalia,2004-03-01,0,0,0,0,0,0
Somalia,2004-04-01,5,0,0,0,0,5
Somalia,2004-04-01,6,0,0,0,0,6
Somalia,2004-04-01,0,0,0,0,0,0
Somalia,2004-04-01,0,0,0,3,0,3
Somalia,2004-04-01,9,0,0,0,0,9
Somalia,2004-04-01,-3,0,0,0,1,-2
Somalia,2004-04-01,2,0,0,0,0,2
Somalia,2004-04-01,0,0,0,0,0,0
Somalia,2004-04-01,-3,0,0,3,0,0
Somalia,2004-04-01,0,0,0,0,0,0
Somalia,2004-04-01,0,0,0,0,0,0
Somalia,2004-04-01,0,0,0,3,0,3
Somalia,2004-04-01,0,0,0,3,0,3
Somalia,2004-04-01,0,0,0,0,0,0
Somalia,2004-04-01,-3,0,0,0,0,-3
Somalia,2004-04-01,2,0,0,0,0,2
Somalia,2004-04-01,0,0,0,0,0,0
Somalia,2004-04-01,4,0,0,0,0,4
Somalia,2004-04-01,3,0,0,0,0,3
Somalia,2004-04-01,1,0,0,0,0,1
Somalia,2004-04-01,4,0,0,3,0,7
Somalia,2004-04-01,11,0,0,3,0,14
Somalia,2004-05-01,13,0,0,3,0,16
Somalia,2004-05-01,0,0,0,0,0,0
Somalia,2004-05-01,3,0,0,0,0,3
Somalia,2004-05-01,0,0,0,3,0,3
Somalia,2004-05-01,0,0,0,3,0,3
Somalia,2004-05-01,3,0,0,0,0,3
Somalia,2004-05-01,0,0,0,6,0,6
Somalia,2004-05-01,0,0,0,6,0,6
Somalia,2004-05-01,0,0,0,6,1,7
Somalia,2004-05-01,3,0,0,9,1,13
Somalia,2004-05-01,5,0,0,18,0,23
Somalia,2004-05-01,-1,0,0,6,2,7
Somalia,2004-05-01,0,0,0,3,0,3
Somalia,2004-05-01,0,0,0,0,0,0
Somalia,2004-05-01,0,0,0,6,0,6
Somalia,2004-05-01,0,0,0,3,3,6
Somalia,2004-05-01,6,0,0,9,0,15
Somalia,2004-05-01,8,0,0,15,0,23
Somalia,2004-05-01,1,0,0,3,0,4
Somalia,2004-05-01,0,0,1,3,0,4
Somalia,2004-05-01,-2,0,0,0,0,-2
Somalia,2004-05-01,6,0,0,0,0,6
Somalia,2004-05-01,21,0,0,0,2,23
Somalia,2004-05-01,2,0,0,7,0,9
Somalia,2004-05-01,0,0,0,0,0,0
Somalia,2004-05-01,0,0,0,3,0,3
Somalia,2004-05-01,1,0,0,-2,0,-1
Somalia,2004-05-01,1,0,0,-2,0,-1
Somalia,2004-05-01,4,0,0,6,0,10
Somalia,2004-05-01,8,0,0,9,0,17
Somalia,2004-06-01,6,0,0,3,0,9
Somalia,2004-06-01,16,0,0,0,0,16
Somalia,2004-06-01,15,0,0,0,0,15
Somalia,2004-06-01,5,0,0,6,0,11
Somalia,2004-06-01,5,0,0,3,0,8
Somalia,2004-06-01,1,0,0,12,0,13
Somalia,2004-06-01,2,2,0,0,1,5
Somalia,2004-06-01,2,0,0,3,0,5
Somalia,2004-06-01,0,0,0,1,0,1
Somalia,2004-06-01,0,0,0,3,0,3
Somalia,2004-06-01,0,0,0,0,0,0
Somalia,2004-06-01,10,0,0,3,0,13
Somalia,2004-06-01,7,0,0,-1,0,6
Somalia,2004-06-01,2,0,0,6,0,8
Somalia,2004-06-01,2,0,0,15,0,17
Somalia,2004-06-01,2,0,0,3,1,6
Somalia,2004-06-01,2,0,0,-1,1,2
Somalia,2004-06-01,3,0,0,0,0,3
Somalia,2004-06-01,0,0,0,0,0,0
Somalia,2004-06-01,0,0,0,9,0,9
Somalia,2004-06-01,1,0,0,15,0,16
Somalia,2004-06-01,3,0,0,0,0,3
Somalia,2004-06-01,1,0,0,0,0,1
Somalia,2004-06-01,3,0,0,-1,0,2
Somalia,2004-06-01,2,0,0,0,3,5
Somalia,2004-06-01,0,0,0,0,0,0
Somalia,2004-06-01,0,0,0,-4,0,-4
Somalia,2004-07-01,3,0,0,0,0,3
Somalia,2004-07-01,0,0,0,6,0,6
Somalia,2004-07-01,2,0,0,6,1,9
Somalia,2004-07-01,1,0,0,-2,0,-1
Somalia,2004-07-01,0,0,0,0,0,0
Somalia,2004-07-01,1,0,0,0,0,1
Somalia,2004-07-01,3,0,0,0,0,3
Somalia,2004-07-01,1,0,0,0,0,1
Somalia,2004-07-01,10,0,0,0,0,10
Somalia,2004-07-01,0,0,0,0,0,0
Somalia,2004-07-01,2,0,0,0,0,2
Somalia,2004-07-01,-3,0,0,0,0,-3
Somalia,2004-07-01,1,0,0,0,0,1
Somalia,2004-07-01,1,0,0,0,0,1
Somalia,2004-07-01,1,0,0,0,0,1
Somalia,2004-07-01,0,0,0,0,0,0
Somalia,2004-07-01,1,0,0,6,0,7
Somalia,2004-07-01,2,0,0,0,0,2
Somalia,2004-07-01,1,0,0,0,0,1
Somalia,2004-07-01,0,0,0,0,0,0
Somalia,2004-07-01,0,0,0,0,0,0
Somalia,2004-07-01,0,0,0,0,0,0
Somalia,2004-07-01,4,0,0,0,0,4
Somalia,2004-07-01,5,0,0,3,6,14
Somalia,2004-07-01,12,0,0,2,0,14
Somalia,2004-07-01,7,0,0,7,0,14
Somalia,2004-07-01,4,0,0,10,0,14
Somalia,2004-08-01,-1,0,0,0,0,-1
Somalia,2004-08-01,10,0,0,0,0,10
Somalia,2004-08-01,0,0,0,0,0,0
Somalia,2004-08-01,2,0,0,0,0,2
Somalia,2004-08-01,0,0,0,0,0,0
Somalia,2004-08-01,0,0,0,0,0,0
Somalia,2004-08-01,0,0,-4,-2,0,-6
Somalia,2004-08-01,3,0,0,0,0,3
Somalia,2004-08-01,0,0,0,0,0,0
Somalia,2004-08-01,1,0,0,0,1,2
Somalia,2004-08-01,9,0,0,0,0,9
Somalia,2004-08-01,0,0,0,0,0,0
Somalia,2004-08-01,0,0,0,3,0,3
Somalia,2004-08-01,1,0,0,0,1,2
Somalia,2004-08-01,0,0,0,0,0,0
Somalia,2004-08-01,9,0,0,-2,0,7
Somalia,2004-08-01,1,0,0,0,0,1
Somalia,2004-08-01,7,0,0,0,0,7
Somalia,2004-08-01,0,0,0,3,0,3
Somalia,2004-08-01,1,0,0,0,0,1
Somalia,2004-08-01,-2,0,0,2,0,0
Somalia,2004-08-01,1,0,0,0,0,1
Somalia,2004-08-01,4,0,0,0,0,4
Somalia,2004-08-01,1,0,0,0,1,2
Somalia,2004-09-01,2,0,0,0,0,2
Somalia,2004-09-01,5,0,0,0,-4,1
Somalia,2004-09-01,12,2,1,0,0,15
Somalia,2004-09-01,3,0,0,3,0,6
Somalia,2004-09-01,6,0,0,0,0,6
Somalia,2004-09-01,1,0,0,0,0,1
Somalia,2004-09-01,2,0,0,0,0,2
Somalia,2004-09-01,6,2,0,6,0,14
Somalia,2004-09-01,4,0,0,6,0,10
Somalia,2004-09-01,0,0,0,0,0,0
Somalia,2004-09-01,5,0,0,0,0,5
Somalia,2004-09-01,7,0,0,6,0,13
Somalia,2004-09-01,3,0,0,0,0,3
Somalia,2004-09-01,1,0,0,0,0,1
Somalia,2004-09-01,3,0,0,0,0,3
Somalia,2004-09-01,0,0,0,0,1,1
Somalia,2004-09-01,-1,0,0,0,0,-1
Somalia,2004-09-01,-6,0,0,0,0,-6
Somalia,2004-09-01,0,0,0,3,2,5
Somalia,2004-09-01,2,0,5,6,2,15
Somalia,2004-09-01,0,2,0,0,0,2
Somalia,2004-09-01,0,0,0,0,0,0
Somalia,2004-09-01,0,0,0,0,0,0
Somalia,2004-09-01,0,0,0,0,0,0
Somalia,2004-09-01,8,0,0,0,0,8
Somalia,2004-09-01,3,0,0,0,0,3
Somalia,2004-09-01,4,0,0,15,0,19
Somalia,2004-09-01,0,0,0,9,0,9
Somalia,2004-10-01,2,0,0,0,0,2
Somalia,2004-10-01,-2,0,0,3,0,1
Somalia,2004-10-01,0,0,2,0,0,2
Somalia,2004-10-01,0,0,0,-6,0,-6
Somalia,2004-10-01,0,0,0,12,0,12
Somalia,2004-10-01,12,0,0,1,0,13
Somalia,2004-10-01,2,0,0,3,0,5
Somalia,2004-10-01,11,0,0,0,0,11
Somalia,2004-10-01,1,0,0,0,0,1
Somalia,2004-10-01,3,0,0,0,3,6
Somalia,2004-10-01,5,0,0,24,0,29
Somalia,2004-10-01,6,0,0,3,0,9
Somalia,2004-10-01,3,0,0,-6,0,-3
Somalia,2004-10-01,11,0,0,0,0,11
Somalia,2004-10-01,10,0,0,0,0,10
Somalia,2004-10-01,11,0,0,0,0,11
Somalia,2004-10-01,0,0,0,0,0,0
Somalia,2004-10-01,3,0,0,0,2,5
Somalia,2004-10-01,8,2,0,3,0,13
Somalia,2004-10-01,5,0,0,3,0,8
Somalia,2004-10-01,0,2,0,0,0,2
Somalia,2004-10-01,0,0,0,0,0,0
Somalia,2004-10-01,8,2,0,0,0,10
Somalia,2004-10-01,0,0,0,0,0,0
Somalia,2004-10-01,10,0,0,0,0,10
Somalia,2004-10-01,6,0,0,6,0,12
Somalia,2004-10-01,0,0,0,3,0,3
Somalia,2004-10-01,0,0,0,0,0,0
Somalia,2004-10-01,15,0,0,9,1,25
Somalia,2004-10-01,33,0,0,0,1,34
Somalia,2004-10-01,0,0,0,0,0,0
Somalia,2004-11-01,18,0,0,0,1,19
Somalia,2004-11-01,0,0,0,0,1,1
Somalia,2004-11-01,1,0,0,0,0,1
Somalia,2004-11-01,5,6,0,9,0,20
Somalia,2004-11-01,3,0,0,0,0,3
Somalia,2004-11-01,7,0,0,6,2,15
Somalia,2004-11-01,10,0,0,0,4,14
Somalia,2004-11-01,8,0,-2,-2,0,4
Somalia,2004-11-01,0,0,0,0,3,3
Somalia,2004-11-01,-1,0,0,0,0,-1
Somalia,2004-11-01,0,2,0,0,0,2
Somalia,2004-11-01,0,0,0,0,0,0
Somalia,2004-11-01,6,0,0,3,0,9
Somalia,2004-11-01,0,0,0,0,0,0
Somalia,2004-11-01,0,0,0,3,0,3
Somalia,2004-11-01,3,0,0,0,0,3
Somalia,2004-11-01,28,0,0,1,0,29
Somalia,2004-11-01,1,0,0,1,0,2
Somalia,2004-11-01,4,0,0,0,1,5
Somalia,2004-11-01,0,0,0,6,0,6
Somalia,2004-11-01,0,0,0,0,4,4
Somalia,2004-11-01,0,0,0,0,0,0
Somalia,2004-11-01,2,0,0,-2,0,0
Somalia,2004-11-01,0,0,0,0,0,0
Somalia,2004-11-01,0,0,0,0,0,0
Somalia,2004-11-01,0,2,0,0,0,2
Somalia,2004-11-01,0,0,0,0,0,0
Somalia,2004-11-01,0,0,0,0,0,0
Somalia,2004-11-01,5,0,0,0,0,5
Somalia,2004-11-01,11,0,0,0,0,11
Somalia,2004-12-01,0,0,0,0,0,0
Somalia,2004-12-01,11,0,0,0,0,11
Somalia,2004-12-01,0,0,0,0,1,1
Somalia,2004-12-01,1,0,0,6,0,7
Somalia,2004-12-01,2,4,0,0,0,6
Somalia,2004-12-01,3,0,-2,0,0,1
Somalia,2004-12-01,3,0,0,0,0,3
Somalia,2004-12-01,5,0,0,0,0,5
Somalia,2004-12-01,0,0,0,0,0,0
Somalia,2004-12-01,4,0,0,0,0,4
Somalia,2004-12-01,0,0,0,6,0,6
Somalia,2004-12-01,5,0,0,6,0,11
Somalia,2004-12-01,1,0,0,0,0,1
Somalia,2004-12-01,0,0,0,6,0,6
Somalia,2004-12-01,1,0,0,9,0,10
Somalia,2004-12-01,-2,0,0,0,0,-2
Somalia,2004-12-01,0,0,0,0,0,0
Somalia,2004-12-01,3,0,0,0,0,3
Somalia,2004-12-01,5,0,0,0,0,5
Somalia,2004-12-01,2,0,0,0,0,2
Somalia,2004-12-01,0,0,0,0,0,0
Somalia,2004-12-01,2,0,0,0,0,2
Somalia,2004-12-01,66,2,0,-4,0,64
Somalia,2004-12-01,11,4,0,0,2,17
Somalia,2004-12-01,25,0,0,0,0,25
Somalia,2004-12-01,27,0,0,0,0,27
Somalia,2004-12-01,14,0,0,0,0,14
Syria,2004-01-01,-1,0,0,0,0,-1
Syria,2004-01-01,12,0,0,0,0,12
Syria,2004-01-01,0,0,0,9,0,9
Syria,2004-01-01,-1,0,0,4,0,3
Syria,2004-01-01,9,0,0,15,0,24
Syria,2004-01-01,0,0,0,2,1,3
Syria,2004-01-01,6,0,0,0,0,6
Syria,2004-01-01,5,0,-4,7,0,8
Syria,2004-01-01,8,0,0,0,0,8
Syria,2004-01-01,2,0,0,0,8,10
Syria,2004-01-01,14,2,-1,0,1,16
Syria,2004-01-01,-2,0,1,6,0,5
Syria,2004-01-01,11,0,0,-2,0,9
Syria,2004-01-01,7,0,0,0,0,7
Syria,2004-01-01,6,0,0,0,1,7
Syria,2004-01-01,2,0,0,3,0,5
Syria,2004-01-01,11,0,0,3,0,14
Syria,2004-01-01,4,0,-2,1,0,3
Syria,2004-01-01,8,0,0,3,0,11
Syria,2004-01-01,30,0,0,3,1,34
Syria,2004-01-01,11,0,0,9,1,21
Syria,2004-01-01,15,0,1,10,0,26
Syria,2004-01-01,6,0,1,9,0,16
Syria,2004-01-01,9,0,0,-11,0,-2
Syria,2004-01-01,-4,0,0,1,0,-3
Syria,2004-01-01,-1,0,0,-1,0,-2
Syria,2004-01-01,3,0,0,3,0,6
Syria,2004-01-01,1,0,0,-2,0,-1
Syria,2004-01-01,8,0,0,15,0,23
Syria,2004-01-01,0,0,0,0,0,0
Syria,2004-01-01,0,0,1,0,0,1
Syria,2004-02-01,9,0,0,3,1,13
Syria,2004-02-01,12,0,0,6,0,18
Syria,2004-02-01,4,0,-2,-4,0,-2
Syria,2004-02-01,0,0,0,-6,0,-6
Syria,2004-02-01,0,0,0,3,0,3
Syria,2004-02-01,5,0,0,-1,0,4
Syria,2004-02-01,2,0,0,-4,0,-2
Syria,2004-02-01,0,0,0,0,0,0
Syria,2004-02-01,6,0,0,3,0,9
Syria,2004-02-01,11,0,0,0,0,11
Syria,2004-02-01,-1,0,0,0,0,-1
Syria,2004-02-01,-3,0,0,5,1,3
Syria,2004-02-01,3,0,0,0,6,9
Syria,2004-02-01,2,0,0,3,0,5
Syria,2004-02-01,50,0,0,1,0,51
Syria,2004-02-01,20,0,0,6,0,26
Syria,2004-02-01,8,0,0,6,0,14
Syria,2004-02-01,0,0,0,0,0,0
Syria,2004-02-01,5,0,0,0,0,5
Syria,2004-02-01,0,0,0,-4,0,-4
Syria,2004-02-01,0,0,0,0,0,0
Syria,2004-02-01,0,0,0,-6,1,-5
Syria,2004-02-01,3,0,0,0,0,3
Syria,2004-02-01,3,0,0,3,0,6
Syria,2004-02-01,12,0,0,-1,2,13
Syria,2004-02-01,0,0,0,17,0,17
Syria,2004-02-01,8,0,0,3,0,11
Syria,2004-02-01,0,0,0,0,0,0
Syria,2004-02-01,9,0,0,0,0,9
Syria,2004-03-01,8,0,0,6,0,14
Syria,2004-03-01,8,0,0,18,6,32
Syria,2004-03-01,0,0,0,3,3,6
Syria,2004-03-01,3,0,0,3,0,6
Syria,2004-03-01,10,0,0,-2,1,9
Syria,2004-03-01,0,0,0,0,0,0
Syria,2004-03-01,2,0,0,0,0,2
Syria,2004-03-01,0,0,0,6,1,7
Syria,2004-03-01,11,0,0,-2,0,9
Syria,2004-03-01,14,0,0,17,3,34
Syria,2004-03-01,4,0,0,2,0,6
Syria,2004-03-01,6,0,0,7,2,15
Syria,2004-03-01,13,0,0,0,0,13
Syria,2004-03-01,1,0,0,3,0,4
Syria,2004-03-01,-3,0,0,-2,0,-5
Syria,2004-03-01,6,0,0,0,4,10
Syria,2004-03-01,9,0,0,0,2,11
Syria,2004-03-01,4,0,0,0,9,13
Syria,2004-03-01,8,0,0,0,0,8
Syria,2004-03-01,2,0,0,-1,0,1
Syria,2004-03-01,0,0,0,3,0,3
Syria,2004-03-01,2,0,0,0,1,3
Syria,2004-03-01,16,0,0,14,3,33
Syria,2004-03-01,2,0,0,0,0,2
Syria,2004-03-01,8,2,0,6,0,16
Syria,2004-03-01,6,0,1,0,2,9
Syria,2004-03-01,8,0,-2,0,0,6
Syria,2004-03-01,9,0,0,0,3,12
Syria,2004-03-01,17,0,0,4,0,21
Syria,2004-03-01,20,0,0,24,0,44
Syria,2004-03-01,5,0,0,10,0,15
Syria,2004-04-01,19,0,0,18,0,37
Syria,2004-04-01,5,0,0,-8,0,-3
Syria,2004-04-01,0,0,0,0,0,0
Syria,2004-04-01,12,0,0,0,0,12
Syria,2004-04-01,0,0,0,0,0,0
Syria,2004-04-01,6,0,0,2,0,8
Syria,2004-04-01,14,0,0,1,0,15
Syria,2004-04-01,9,0,-2,3,0,10
Syria,2004-04-01,4,0,0,3,0,7
Syria,2004-04-01,0,0,0,7,7,14
Syria,2004-04-01,-3,0,0,18,1,16
Syria,2004-04-01,8,0,0,6,0,14
Syria,2004-04-01,3,0,0,12,0,15
Syria,2004-04-01,8,0,0,10,3,21
Syria,2004-04-01,3,0,0,3,1,7
Syria,2004-04-01,4,0,0,4,0,8
Syria,2004-04-01,1,0,0,-4,0,-3
Syria,2004-04-01,29,0,0,-2,4,31
Syria,2004-04-01,15,0,0,0,8,23
Syria,2004-04-01,24,0,0,2,1,27
Syria,2004-04-01,37,0,0,15,0,52
Syria,2004-04-01,17,0,0,20,0,37
Syria,2004-04-01,-3,0,0,6,0,3
Syria,2004-04-01,1,0,0,3,1,5
Syria,2004-04-01,0,0,0,0,0,0
Syria,2004-04-01,17,0,0,0,0,17
Syria,2004-04-01,1,0,-6,6,0,1
Syria,2004-04-01,0,0,-6,3,0,-3
Syria,2004-04-01,3,0,0,0,2,5
Syria,2004-04-01,4,0,0,6,0,10
Syria,2004-05-01,11,0,0,-6,0,5
Syria,2004-05-01,3,0,0,9,0,12
Syria,2004-05-01,0,0,0,0,0,0
Syria,2004-05-01,2,0,0,0,0,2
Syria,2004-05-01,6,0,0,0,0,6
Syria,2004-05-01,22,0,0,9,0,31
Syria,2004-05-01,18,0,0,0,0,18
Syria,2004-05-01,3,0,0,0,2,5
Syria,2004-05-01,7,0,0,0,0,7
Syria,2004-05-01,-1,0,0,0,0,-1
Syria,2004-05-01,2,0,1,6,0,9
Syria,2004-05-01,6,0,0,9,3,18
Syria,2004-05-01,11,0,0,0,0,11
Syria,2004-05-01,-3,0,0,-3,0,-6
Syria,2004-05-01,3,0,0,3,0,6
Syria,2004-05-01,2,0,0,0,0,2
Syria,2004-05-01,3,0,0,3,0,6
Syria,2004-05-01,4,0,0,0,0,4
Syria,2004-05-01,14,0,0,-4,6,16
Syria,2004-05-01,16,0,0,0,0,16
Syria,2004-05-01,9,0,0,0,0,9
Syria,2004-05-01,0,0,0,0,2,2
Syria,2004-05-01,1,0,0,3,2,6
Syria,2004-05-01,22,0,0,0,1,23
Syria,2004-05-01,17,0,0,6,1,24
Syria,2004-05-01,9,0,0,2,0,11
Syria,2004-05-01,5,0,0,8,3,16
Syria,2004-05-01,3,0,0,0,2,5
Syria,2004-05-01,-1,0,0,3,0,2
Syria,2004-05-01,0,0,0,0,0,0
Syria,2004-05-01,6,0,0,6,0,12
Syria,2004-06-01,1,0,0,6,2,9
Syria,2004-06-01,-7,0,0,0,0,-7
Syria,2004-06-01,1,0,0,3,0,4
Syria,2004-06-01,2,0,0,0,0,2
Syria,2004-06-01,3,0,0,0,0,3
Syria,2004-06-01,12,0,0,6,1,19
Syria,2004-06-01,1,0,0,0,0,1
Syria,2004-06-01,7,0,0,0,0,7
Syria,2004-06-01,0,0,0,0,0,0
Syria,2004-06-01,3,0,0,12,0,15
Syria,2004-06-01,15,0,0,0,2,17
Syria,2004-06-01,12,0,0,0,2,14
Syria,2004-06-01,25,0,0,0,3,28
Syria,2004-06-01,5,0,0,0,0,5
Syria,2004-06-01,10,0,0,8,1,19
Syria,2004-06-01,0,0,0,3,6,9
Syria,2004-06-01,6,0,1,18,0,25
Syria,2004-06-01,0,0,0,-4,0,-4
Syria,2004-06-01,4,0,0,6,0,10
Syria,2004-06-01,0,0,0,0,0,0
Syria,2004-06-01,3,0,0,2,2,7
Syria,2004-06-01,0,0,0,0,0,0
Syria,2004-06-01,6,0,0,3,0,9
Syria,2004-06-01,0,0,1,7,0,8
Syria,2004-06-01,14,2,0,0,0,16
Syria,2004-06-01,12,0,0,6,0,18
Syria,2004-06-01,0,0,0,0,0,0
Syria,2004-06-01,3,0,0,3,0,6
Syria,2004-06-01,11,0,0,6,0,17
Syria,2004-06-01,0,0,0,0,0,0
Syria,2004-07-01,1,0,0,0,0,1
Syria,2004-07-01,0,0,0,0,0,0
Syria,2004-07-01,-3,0,0,6,0,3
Syria,2004-07-01,7,0,0,0,3,10
Syria,2004-07-01,2,0,0,0,0,2
Syria,2004-07-01,6,0,0,0,0,6
Syria,2004-07-01,4,0,0,3,0,7
Syria,2004-07-01,0,0,0,0,0,0
Syria,2004-07-01,0,0,0,0,0,0
Syria,2004-07-01,1,0,0,0,0,1
Syria,2004-07-01,0,0,0,0,0,0
Syria,2004-07-01,12,2,0,0,0,14
Syria,2004-07-01,-1,0,0,-2,0,-3
Syria,2004-07-01,0,0,0,12,0,12
Syria,2004-07-01,-3,0,0,0,0,-3
Syria,2004-07-01,2,0,0,-4,6,4
Syria,2004-07-01,0,0,0,0,0,0
Syria,2004-07-01,0,0,0,3,0,3
Syria,2004-07-01,1,0,0,0,0,1
Syria,2004-07-01,12,0,0,1,0,13
Syria,2004-07-01,23,0,0,3,0,26
Syria,2004-07-01,7,0,0,3,0,10
Syria,2004-07-01,0,0,0,0,0,0
Syria,2004-07-01,0,0,0,-4,0,-4
Syria,2004-07-01,0,0,0,-4,1,-3
Syria,2004-07-01,0,0,0,9,0,9
Syria,2004-07-01,-3,0,3,2,0,2
Syria,2004-07-01,0,0,0,0,0,0
Syria,2004-07-01,3,0,0,0,0,3
Syria,2004-07-01,0,0,0,9,0,9
Syria,2004-07-01,2,0,0,15,0,17
Syria,2004-08-01,21,0,0,0,0,21
Syria,2004-08-01,15,0,0,0,3,18
Syria,2004-08-01,9,0,0,18,0,27
Syria,2004-08-01,0,0,0,4,0,4
Syria,2004-08-01,2,0,2,0,0,4
Syria,2004-08-01,9,0,1,10,0,20
Syria,2004-08-01,0,0,0,0,0,0
Syria,2004-08-01,3,0,0,-2,0,1
Syria,2004-08-01,2,0,0,0,0,2
Syria,2004-08-01,0,0,0,0,0,0
Syria,2004-08-01,0,0,0,0,1,1
Syria,2004-08-01,1,0,0,19,3,23
Syria,2004-08-01,4,0,0,0,1,5
Syria,2004-08-01,2,0,0,9,2,13
Syria,2004-08-01,0,0,0,9,0,9
Syria,2004-08-01,7,0,0,-2,0,5
Syria,2004-08-01,8,0,0,15,0,23
Syria,2004-08-01,4,0,0,0,0,4
Syria,2004-08-01,2,0,0,0,0,2
Syria,2004-08-01,0,0,0,6,0,6
Syria,2004-08-01,3,0,0,3,0,6
Syria,2004-08-01,0,0,0,0,0,0
Syria,2004-08-01,0,0,0,-2,0,-2
Syria,2004-08-01,0,0,0,-4,0,-4
Syria,2004-08-01,0,0,0,9,0,9
Syria,2004-08-01,3,0,0,7,0,10
Syria,2004-08-01,0,0,0,-1,0,-1
Syria,2004-08-01,3,0,-2,0,0,1
Syria,2004-08-01,0,0,0,0,0,0
Syria,2004-08-01,5,0,0,0,0,5
Syria,2004-08-01,11,0,0,-6,0,5
Syria,2004-09-01,0,0,-2,0,2,0
Syria,2004-09-01,6,0,0,-1,0,5
Syria,2004-09-01,15,0,0,-1,0,14
Syria,2004-09-01,4,0,0,3,0,7
Syria,2004-09-01,11,0,0,0,0,11
Syria,2004-09-01,10,0,0,0,0,10
Syria,2004-09-01,4,0,0,0,3,7
Syria,2004-09-01,3,0,0,0,0,3
Syria,2004-09-01,21,4,-2,30,8,61
Syria,2004-09-01,6,0,0,3,2,11
Syria,2004-09-01,6,0,0,0,0,6
Syria,2004-09-01,0,0,0,9,0,9
Syria,2004-09-01,11,0,-4,0,8,15
Syria,2004-09-01,3,0,0,15,1,19
Syria,2004-09-01,-3,0,0,0,0,-3
Syria,2004-09-01,0,0,0,7,0,7
Syria,2004-09-01,6,0,0,4,2,12
Syria,2004-09-01,1,0,0,-3,0,-2
Syria,2004-09-01,2,0,0,6,0,8
Syria,2004-09-01,1,0,0,9,1,11
Syria,2004-09-01,0,0,0,0,0,0
Syria,2004-09-01,-4,0,0,18,0,14
Syria,2004-09-01,-4,0,0,0,1,-3
Syria,2004-09-01,0,0,0,-2,0,-2
Syria,2004-09-01,5,2,0,0,0,7
Syria,2004-09-01,6,0,0,6,1,13
Syria,2004-09-01,2,6,0,12,0,20
Syria,2004-09-01,12,0,0,12,2,26
Syria,2004-09-01,-2,0,0,12,0,10
Syria,2004-09-01,0,0,0,9,1,10
Syria,2004-10-01,-3,0,2,9,6,14
Syria,2004-10-01,0,0,0,15,0,15
Syria,2004-10-01,-7,0,0,0,3,-4
Syria,2004-10-01,4,0,0,6,0,10
Syria,2004-10-01,0,0,0,6,0,6
Syria,2004-10-01,6,0,0,9,1,16
Syria,2004-10-01,2,0,0,-2,0,0
Syria,2004-10-01,0,0,0,3,0,3
Syria,2004-10-01,6,0,2,0,0,8
Syria,2004-10-01,6,0,0,9,2,17
Syria,2004-10-01,0,0,0,5,0,5
Syria,2004-10-01,4,0,0,0,0,4
Syria,2004-10-01,11,0,0,6,0,17
Syria,2004-10-01,50,0,0,6,0,56
Syria,2004-10-01,11,0,0,6,6,23
Syria,2004-10-01,3,0,0,0,6,9
Syria,2004-10-01,1,0,0,12,0,13
Syria,2004-10-01,2,0,-4,3,0,1
Syria,2004-10-01,7,0,0,3,0,10
Syria,2004-10-01,9,0,-8,-8,1,-6
Syria,2004-10-01,-2,0,-2,0,0,-4
Syria,2004-10-01,3,0,0,0,0,3
Syria,2004-10-01,3,0,0,3,0,6
Syria,2004-10-01,3,0,0,6,0,9
Syria,2004-10-01,6,0,0,0,0,6
Syria,2004-10-01,7,0,-8,6,0,5
Syria,2004-10-01,19,0,0,0,0,19
Syria,2004-10-01,2,0,0,3,-4,1
Syria,2004-10-01,0,0,0,0,0,0
Syria,2004-10-01,0,0,0,0,0,0
Syria,2004-10-01,-1,0,0,-1,0,-2
Syria,2004-11-01,3,0,0,0,0,3
Syria,2004-11-01,4,0,0,-2,0,2
Syria,2004-11-01,2,0,0,3,0,5
Syria,2004-11-01,4,0,0,0,0,4
Syria,2004-11-01,3,0,0,12,0,15
Syria,2004-11-01,0,0,0,0,0,0
Syria,2004-11-01,14,0,0,2,0,16
Syria,2004-11-01,14,2,0,9,0,25
Syria,2004-11-01,11,0,0,2,6,19
Syria,2004-11-01,11,0,0,0,0,11
Syria,2004-11-01,26,0,0,3,2,31
Syria,2004-11-01,17,0,0,-2,0,15
Syria,2004-11-01,7,0,0,6,0,13
Syria,2004-11-01,4,0,0,3,0,7
Syria,2004-11-01,6,0,0,0,0,6
Syria,2004-11-01,3,0,-2,0,0,1
Syria,2004-11-01,1,0,0,0,0,1
Syria,2004-11-01,8,0,0,0,1,9
Syria,2004-11-01,14,0,0,1,1,16
Syria,2004-11-01,0,0,0,0,0,0
Syria,2004-11-01,19,2,0,-2,0,19
Syria,2004-11-01,2,0,0,3,0,5
Syria,2004-11-01,4,0,0,9,1,14
Syria,2004-11-01,2,0,0,6,2,10
Syria,2004-11-01,0,0,0,0,0,0
Syria,2004-11-01,15,0,0,18,0,33
Syria,2004-11-01,-3,0,0,0,0,-3
Syria,2004-11-01,7,0,0,3,0,10
Syria,2004-11-01,-1,0,0,-3,0,-4
Syria,2004-11-01,11,0,0,0,0,11
Syria,2004-12-01,5,0,0,0,0,5
Syria,2004-12-01,7,0,0,0,0,7
Syria,2004-12-01,18,0,0,3,0,21
Syria,2004-12-01,-3,0,0,12,1,10
Syria,2004-12-01,0,0,0,6,0,6
Syria,2004-12-01,-1,0,0,0,0,-1
Syria,2004-12-01,9,0,0,1,4,14
Syria,2004-12-01,3,0,0,6,0,9
Syria,2004-12-01,1,0,0,-1,0,0
Syria,2004-12-01,1,0,0,10,2,13
Syria,2004-12-01,15,0,0,0,0,15
Syria,2004-12-01,0,0,0,0,2,2
Syria,2004-12-01,0,0,0,0,0,0
Syria,2004-12-01,0,0,0,0,0,0
Syria,2004-12-01,6,0,0,19,0,25
Syria,2004-12-01,-1,0,0,0,0,-1
Syria,2004-12-01,1,0,0,0,2,3
Syria,2004-12-01,-6,0,0,0,0,-6
Syria,2004-12-01,3,0,0,6,0,9
Syria,2004-12-01,1,0,0,0,0,1
Syria,2004-12-01,13,0,0,30,0,43
Syria,2004-12-01,7,0,0,2,0,9
Syria,2004-12-01,3,0,0,3,0,6
Syria,2004-12-01,0,0,0,6,0,6
Syria,2004-12-01,9,0,0,0,0,9
Syria,2004-12-01,10,0,0,6,0,16
Syria,2004-12-01,21,0,0,3,1,25
Syria,2004-12-01,0,0,0,3,1,4
Syria,2004-12-01,0,0,0,0,0,0
Syria,2004-12-01,7,0,0,3,1,11
Syria,2004-12-01,0,0,0,3,0,3
Yemen,2004-01-01,0,0,0,0,1,1
Yemen,2004-01-01,2,0,0,0,0,2
Yemen,2004-01-01,0,0,0,0,0,0
Yemen,2004-01-01,4,0,0,6,0,10
Yemen,2004-01-01,0,0,0,0,0,0
Yemen,2004-01-01,0,0,0,6,0,6
Yemen,2004-01-01,0,0,0,0,0,0
Yemen,2004-01-01,2,0,0,0,0,2
Yemen,2004-01-01,2,0,0,0,0,2
Yemen,2004-01-01,0,0,0,0,0,0
Yemen,2004-01-01,-1,0,0,0,0,-1
Yemen,2004-01-01,0,0,0,-6,0,-6
Yemen,2004-01-01,0,0,0,0,0,0
Yemen,2004-01-01,0,0,0,0,2,2
Yemen,2004-01-01,3,0,0,0,0,3
Yemen,2004-01-01,3,0,0,0,0,3
Yemen,2004-01-01,0,0,0,0,0,0
Yemen,2004-01-01,3,0,0,0,0,3
Yemen,2004-01-01,8,0,0,3,0,11
Yemen,2004-01-01,0,0,0,0,0,0
Yemen,2004-01-01,-1,0,0,3,4,6
Yemen,2004-01-01,2,0,0,0,0,2
Yemen,2004-01-01,0,0,0,3,0,3
Yemen,2004-01-01,0,0,0,0,0,0
Yemen,2004-01-01,15,0,0,3,0,18
Yemen,2004-01-01,0,0,0,0,0,0
Yemen,2004-02-01,0,0,0,0,0,0
Yemen,2004-02-01,0,0,0,0,0,0
Yemen,2004-02-01,5,0,0,15,0,20
Yemen,2004-02-01,5,0,0,9,0,14
Yemen,2004-02-01,1,0,0,0,0,1
Yemen,2004-02-01,3,0,0,6,0,9
Yemen,2004-02-01,0,0,0,0,0,0
Yemen,2004-02-01,8,0,0,3,0,11
Yemen,2004-02-01,2,0,0,0,0,2
Yemen,2004-02-01,10,0,0,36,0,46
Yemen,2004-02-01,0,2,0,6,1,9
Yemen,2004-02-01,2,0,0,0,0,2
Yemen,2004-02-01,0,0,0,0,0,0
Yemen,2004-02-01,13,0,0,0,0,13
Yemen,2004-02-01,6,0,0,3,0,9
Yemen,2004-02-01,2,0,0,0,0,2
Yemen,2004-02-01,7,0,0,0,0,7
Yemen,2004-02-01,1,0,0,0,1,2
Yemen,2004-02-01,0,0,0,0,0,0
Yemen,2004-02-01,0,0,0,3,0,3
Yemen,2004-02-01,2,0,0,6,1,9
Yemen,2004-02-01,0,0,0,0,0,0
Yemen,2004-02-01,1,0,0,12,0,13
Yemen,2004-02-01,0,0,0,0,0,0
Yemen,2004-02-01,4,0,0,0,0,4
Yemen,2004-03-01,0,0,0,0,0,0
Yemen,2004-03-01,0,0,0,0,0,0
Yemen,2004-03-01,2,0,0,9,0,11
Yemen,2004-03-01,9,0,0,3,0,12
Yemen,2004-03-01,1,0,0,6,0,7
Yemen,2004-03-01,9,0,2,38,0,49
Yemen,2004-03-01,8,0,0,8,6,22
Yemen,2004-03-01,2,0,0,25,1,28
Yemen,2004-03-01,4,0,0,0,0,4
Yemen,2004-03-01,-1,0,0,-2,0,-3
Yemen,2004-03-01,1,0,0,0,0,1
Yemen,2004-03-01,4,0,0,0,0,4
Yemen,2004-03-01,-2,0,0,6,0,4
Yemen,2004-03-01,0,0,0,0,0,0
Yemen,2004-03-01,10,0,0,3,0,13
Yemen,2004-03-01,13,0,0,2,0,15
Yemen,2004-03-01,0,0,0,3,0,3
Yemen,2004-03-01,8,0,0,6,0,14
Yemen,2004-03-01,12,0,0,12,1,25
Yemen,2004-03-01,0,0,0,3,1,4
Yemen,2004-03-01,0,0,0,15,0,15
Yemen,2004-03-01,1,0,0,3,0,4
Yemen,2004-03-01,4,0,1,3,2,10
Yemen,2004-03-01,3,0,0,0,0,3
Yemen,2004-03-01,5,0,0,0,0,5
Yemen,2004-03-01,1,0,0,0,0,1
Yemen,2004-03-01,3,0,0,0,0,3
Yemen,2004-03-01,0,0,0,-4,0,-4
Yemen,2004-03-01,8,0,0,0,0,8
Yemen,2004-03-01,0,0,0,-6,0,-6
Yemen,2004-03-01,29,0,0,2,0,31
Yemen,2004-04-01,-1,0,0,6,0,5
Yemen,2004-04-01,13,0,0,3,0,16
Yemen,2004-04-01,0,0,0,0,0,0
Yemen,2004-04-01,8,0,0,0,0,8
Yemen,2004-04-01,7,0,0,0,0,7
Yemen,2004-04-01,2,0,0,13,0,15
Yemen,2004-04-01,12,0,0,0,0,12
Yemen,2004-04-01,4,0,0,9,0,13
Yemen,2004-04-01,0,0,0,0,0,0
Yemen,2004-04-01,3,0,0,0,0,3
Yemen,2004-04-01,3,0,0,3,0,6
Yemen,2004-04-01,2,0,0,0,0,2
Yemen,2004-04-01,0,0,0,0,0,0
Yemen,2004-04-01,0,0,0,0,0,0
Yemen,2004-04-01,0,0,0,0,0,0
Yemen,2004-04-01,9,0,0,0,10,19
Yemen,2004-04-01,3,0,0,0,1,4
Yemen,2004-04-01,0,0,0,0,0,0
Yemen,2004-04-01,0,0,0,0,0,0
Yemen,2004-04-01,12,0,0,0,0,12
Yemen,2004-04-01,0,0,0,0,0,0
Yemen,2004-04-01,9,0,0,0,0,9
Yemen,2004-04-01,3,0,0,0,0,3
Yemen,2004-04-01,4,0,0,0,0,4
Yemen,2004-04-01,7,0,0,6,0,13
Yemen,2004-04-01,8,0,0,3,0,11
Yemen,2004-04-01,5,0,0,6,0,11
Yemen,2004-04-01,6,0,0,6,6,18
Yemen,2004-05-01,3,0,0,0,0,3
Yemen,2004-05-01,0,0,0,0,0,0
Yemen,2004-05-01,0,0,0,1,0,1
Yemen,2004-05-01,5,0,0,0,0,5
Yemen,2004-05-01,9,4,0,3,0,16
Yemen,2004-05-01,8,0,0,0,0,8
Yemen,2004-05-01,-2,0,0,-1,0,-3
Yemen,2004-05-01,0,0,0,-2,0,-2
Yemen,2004-05-01,0,0,0,0,0,0
Yemen,2004-05-01,0,0,0,0,0,0
Yemen,2004-05-01,5,0,0,0,0,5
Yemen,2004-05-01,4,0,0,3,0,7
Yemen,2004-05-01,3,0,0,0,0,3
Yemen,2004-05-01,3,0,0,0,0,3
Yemen,2004-05-01,0,0,0,0,0,0
Yemen,2004-05-01,0,0,0,0,0,0
Yemen,2004-05-01,9,0,0,0,0,9
Yemen,2004-05-01,0,0,0,0,0,0
Yemen,2004-05-01,0,0,0,0,0,0
Yemen,2004-05-01,-6,0,0,0,0,-6
Yemen,2004-05-01,-1,0,0,0,0,-1
Yemen,2004-05-01,9,0,0,0,0,9
Yemen,2004-05-01,3,0,0,0,3,6
Yemen,2004-05-01,5,0,0,9,0,14
Yemen,2004-05-01,2,0,0,3,0,5
Yemen,2004-05-01,19,0,0,0,0,19
Yemen,2004-05-01,21,0,0,23,0,44
Yemen,2004-05-01,16,0,0,1,1,18
Yemen,2004-05-01,5,0,0,3,0,8
Yemen,2004-05-01,10,0,0,0,0,10
Yemen,2004-05-01,2,0,0,3,0,5
Yemen,2004-06-01,0,0,0,9,0,9
Yemen,2004-06-01,0,0,0,0,0,0
Yemen,2004-06-01,5,0,0,12,0,17
Yemen,2004-06-01,0,0,0,0,0,0
Yemen,2004-06-01,0,0,0,0,1,1
Yemen,2004-06-01,2,0,0,3,0,5
Yemen,2004-06-01,4,0,0,3,0,7
Yemen,2004-06-01,3,0,0,3,1,7
Yemen,2004-06-01,0,0,0,0,0,0
Yemen,2004-06-01,12,0,0,0,0,12
Yemen,2004-06-01,0,0,0,0,0,0
Yemen,2004-06-01,0,0,0,6,0,6
Yemen,2004-06-01,0,0,0,0,0,0
Yemen,2004-06-01,0,0,0,0,0,0
Yemen,2004-06-01,21,0,0,6,0,27
Yemen,2004-06-01,30,0,0,10,0,40
Yemen,2004-06-01,12,0,0,0,0,12
Yemen,2004-06-01,28,0,0,0,1,29
Yemen,2004-06-01,3,0,0,0,0,3
Yemen,2004-06-01,0,0,0,0,0,0
Yemen,2004-06-01,0,0,-1,0,0,-1
Yemen,2004-06-01,0,0,0,3,0,3
Yemen,2004-06-01,0,0,0,0,0,0
Yemen,2004-06-01,2,0,0,0,6,8
Yemen,2004-06-01,6,0,0,3,6,15
Yemen,2004-06-01,30,0,0,0,0,30
Yemen,2004-06-01,15,0,0,0,3,18
Yemen,2004-07-01,17,0,0,3,0,20
Yemen,2004-07-01,7,0,0,0,2,9
Yemen,2004-07-01,0,0,0,0,0,0
Yemen,2004-07-01,3,0,0,0,0,3
Yemen,2004-07-01,3,0,0,0,0,3
Yemen,2004-07-01,23,0,0,9,0,32
Yemen,2004-07-01,2,0,0,0,6,8
Yemen,2004-07-01,1,0,0,3,0,4
Yemen,2004-07-01,8,0,0,0,0,8
Yemen,2004-07-01,0,0,0,0,0,0
Yemen,2004-07-01,0,0,0,0,0,0
Yemen,2004-07-01,4,0,0,0,0,4
Yemen,2004-07-01,1,0,0,12,0,13
Yemen,2004-07-01,2,0,0,0,0,2
Yemen,2004-07-01,0,0,0,0,0,0
Yemen,2004-07-01,3,0,0,0,0,3
Yemen,2004-07-01,0,0,0,0,0,0
Yemen,2004-07-01,0,0,0,0,0,0
Yemen,2004-07-01,0,0,0,9,0,9
Yemen,2004-07-01,0,0,0,3,0,3
Yemen,2004-07-01,22,0,0,6,0,28
Yemen,2004-07-01,1,0,0,0,0,1
Yemen,2004-07-01,0,0,0,0,0,0
Yemen,2004-07-01,2,0,0,2,0,4
Yemen,2004-07-01,5,0,0,0,0,5
Yemen,2004-07-01,15,0,0,0,0,15
Yemen,2004-07-01,0,0,0,6,0,6
Yemen,2004-08-01,0,0,0,0,0,0
Yemen,2004-08-01,5,0,0,12,-6,11
Yemen,2004-08-01,15,0,0,0,0,15
Yemen,2004-08-01,5,0,0,3,2,10
Yemen,2004-08-01,0,0,0,3,0,3
Yemen,2004-08-01,6,0,0,0,0,6
Yemen,2004-08-01,0,0,0,0,4,4
Yemen,2004-08-01,2,0,0,0,0,2
Yemen,2004-08-01,1,0,0,0,0,1
Yemen,2004-08-01,3,0,0,0,0,3
Yemen,2004-08-01,3,0,0,6,3,12
Yemen,2004-08-01,3,0,0,6,3,12
Yemen,2004-08-01,7,0,0,0,0,7
Yemen,2004-08-01,10,0,0,6,0,16
Yemen,2004-08-01,9,0,0,0,6,15
Yemen,2004-08-01,2,0,0,0,4,6
Yemen,2004-08-01,19,0,0,0,0,19
Yemen,2004-08-01,16,0,0,3,0,19
Yemen,2004-08-01,25,0,0,6,0,31
Yemen,2004-08-01,25,0,0,9,2,36
Yemen,2004-08-01,33,0,0,21,0,54
Yemen,2004-08-01,17,0,0,10,3,30
Yemen,2004-08-01,17,0,-2,9,3,27
Yemen,2004-08-01,8,0,0,3,0,11
Yemen,2004-08-01,6,0,0,36,12,54
Yemen,2004-08-01,6,0,0,6,12,24
Yemen,2004-08-01,1,0,0,0,0,1
Yemen,2004-08-01,0,0,0,9,0,9
Yemen,2004-09-01,7,0,0,6,0,13
Yemen,2004-09-01,2,0,0,-2,0,0
Yemen,2004-09-01,8,0,0,3,0,11
Yemen,2004-09-01,0,0,0,2,0,2
Yemen,2004-09-01,3,0,0,9,0,12
Yemen,2004-09-01,2,0,0,0,0,2
Yemen,2004-09-01,9,0,0,0,0,9
Yemen,2004-09-01,6,0,0,0,0,6
Yemen,2004-09-01,9,4,0,0,0,13
Yemen,2004-09-01,58,0,0,3,0,61
Yemen,2004-09-01,4,2,0,0,0,6
Yemen,2004-09-01,0,0,0,0,0,0
Yemen,2004-09-01,2,0,0,0,0,2
Yemen,2004-09-01,7,0,0,0,6,13
Yemen,2004-09-01,4,0,0,3,0,7
Yemen,2004-09-01,9,0,0,5,1,15
Yemen,2004-09-01,3,0,0,0,0,3
Yemen,2004-09-01,0,0,0,0,0,0
Yemen,2004-09-01,7,0,0,9,0,16
Yemen,2004-09-01,0,0,0,12,0,12
Yemen,2004-09-01,0,0,0,0,0,0
Yemen,2004-09-01,0,0,0,-1,0,-1
Yemen,2004-09-01,2,0,0,0,0,2
Yemen,2004-09-01,0,0,0,3,0,3
Yemen,2004-09-01,0,0,0,-6,2,-4
Yemen,2004-09-01,3,0,0,0,0,3
Yemen,2004-09-01,25,0,0,48,0,73
Yemen,2004-09-01,8,0,0,3,0,11
Yemen,2004-10-01,0,0,0,12,0,12
Yemen,2004-10-01,0,0,0,0,0,0
Yemen,2004-10-01,2,0,0,3,0,5
Yemen,2004-10-01,2,0,0,0,0,2
Yemen,2004-10-01,2,0,0,0,0,2
Yemen,2004-10-01,0,0,0,0,0,0
Yemen,2004-10-01,3,0,0,9,0,12
Yemen,2004-10-01,0,0,0,3,0,3
Yemen,2004-10-01,9,0,0,0,0,9
Yemen,2004-10-01,4,0,0,6,0,10
Yemen,2004-10-01,2,0,0,0,0,2
Yemen,2004-10-01,0,0,0,9,0,9
Yemen,2004-10-01,6,0,0,18,0,24
Yemen,2004-10-01,0,0,0,0,0,0
Yemen,2004-10-01,0,0,0,0,0,0
Yemen,2004-10-01,0,0,0,0,0,0
Yemen,2004-10-01,0,0,0,-5,0,-5
Yemen,2004-10-01,-1,0,0,3,0,2
Yemen,2004-10-01,-2,0,0,15,0,13
Yemen,2004-10-01,-3,0,0,0,0,-3
Yemen,2004-10-01,12,0,0,0,0,12
Yemen,2004-10-01,6,0,0,2,0,8
Yemen,2004-11-01,0,0,0,0,0,0
Yemen,2004-11-01,0,0,0,0,0,0
Yemen,2004-11-01,0,0,0,9,0,9
Yemen,2004-11-01,0,0,0,0,0,0
Yemen,2004-11-01,0,0,0,0,0,0
Yemen,2004-11-01,4,0,0,6,0,10
Yemen,2004-11-01,5,0,0,21,2,28
Yemen,2004-11-01,11,0,0,9,2,22
Yemen,2004-11-01,0,0,0,0,0,0
Yemen,2004-11-01,3,0,0,0,0,3
Yemen,2004-11-01,-1,0,0,0,0,-1
Yemen,2004-11-01,3,0,0,3,0,6
Yemen,2004-11-01,0,0,0,0,1,1
Yemen,2004-11-01,5,0,1,3,9,18
Yemen,2004-11-01,2,0,0,0,0,2
Yemen,2004-11-01,6,0,0,0,1,7
Yemen,2004-11-01,3,0,0,3,0,6
Yemen,2004-11-01,7,0,0,0,0,7
Yemen,2004-11-01,2,0,0,0,0,2
Yemen,2004-11-01,9,0,0,7,0,16
Yemen,2004-11-01,3,0,0,-2,0,1
Yemen,2004-11-01,-1,0,0,3,0,2
Yemen,2004-11-01,6,0,0,0,0,6
Yemen,2004-11-01,12,0,0,0,2,14
Yemen,2004-12-01,0,0,0,0,0,0
Yemen,2004-12-01,0,0,0,0,0,0
Yemen,2004-12-01,0,0,0,0,0,0
Yemen,2004-12-01,7,0,0,0,0,7
Yemen,2004-12-01,6,0,0,6,0,12
Yemen,2004-12-01,54,0,-2,0,2,54
Yemen,2004-12-01,6,0,0,15,0,21
Yemen,2004-12-01,8,0,0,0,0,8
Yemen,2004-12-01,5,0,0,0,0,5
Yemen,2004-12-01,0,0,0,0,0,0
Yemen,2004-12-01,0,0,0,6,0,6
Yemen,2004-12-01,2,0,0,3,0,5
Yemen,2004-12-01,2,4,0,0,0,6
Yemen,2004-12-01,1,0,0,6,0,7
Yemen,2004-12-01,0,0,0,0,0,0
Yemen,2004-12-01,0,0,0,0,0,0
Yemen,2004-12-01,0,0,0,0,0,0
Yemen,2004-12-01,0,0,0,0,0,0
Yemen,2004-12-01,0,0,0,0,0,0
Yemen,2004-12-01,11,0,0,0,0,11
Yemen,2004-12-01,1,0,0,0,0,1
Yemen,2004-12-01,12,0,0,0,0,12
Yemen,2004-12-01,17,0,0,0,6,23
Yemen,2004-12-01,6,0,0,-2,0,4
Afghanistan,2006-03-01,83,0,0,41,5,129
Afghanistan,2006-03-01,63,0,0,11,10,84
Afghanistan,2006-03-01,49,0,0,23,7,79
Afghanistan,2006-03-01,98,0,0,13,2,113
Afghanistan,2006-03-01,72,0,0,1,6,79
Afghanistan,2006-03-01,78,0,0,21,10,109
Afghanistan,2006-03-01,18,0,0,15,8,41
Afghanistan,2006-03-01,41,0,0,16,7,64
Afghanistan,2006-03-01,26,0,0,12,0,38
Afghanistan,2006-03-01,48,0,0,19,0,67
Afghanistan,2006-03-01,12,0,0,12,3,27
Afghanistan,2006-03-01,15,0,0,0,6,21
Afghanistan,2006-03-01,27,0,0,6,0,33
Afghanistan,2006-03-01,21,0,0,6,4,31
Afghanistan,2006-03-01,42,0,0,7,0,49
Afghanistan,2006-03-01,60,0,0,34,0,94
Afghanistan,2006-03-01,45,0,0,11,0,56
Afghanistan,2006-03-01,29,0,0,6,11,46
Afghanistan,2006-03-01,32,0,0,27,0,59
Afghanistan,2006-03-01,52,0,1,37,10,100
Afghanistan,2006-03-01,70,0,0,6,7,83
Afghanistan,2006-03-01,34,0,0,34,0,68
Afghanistan,2006-03-01,23,0,0,37,0,60
Afghanistan,2006-03-01,5,0,0,0,1,6
Afghanistan,2006-03-01,61,0,0,6,2,69
Afghanistan,2006-03-01,10,0,1,12,5,28
Afghanistan,2006-03-01,31,0,0,14,5,50
Afghanistan,2006-03-01,46,0,0,29,9,84
Afghanistan,2006-03-01,113,2,0,16,8,139
Afghanistan,2006-03-01,51,0,0,4,20,75
Afghanistan,2006-03-01,12,0,0,12,6,30
Albania,2006-03-01,21,0,-6,24,0,39
Albania,2006-03-01,39,0,-4,18,2,55
Albania,2006-03-01,2,0,-3,6,0,5
Albania,2006-03-01,1,0,0,0,0,1
Albania,2006-03-01,0,0,0,0,0,0
Albania,2006-03-01,0,0,0,-4,0,-4
Albania,2006-03-01,0,0,0,0,1,1
Albania,2006-03-01,5,0,0,0,0,5
Albania,2006-03-01,9,0,0,13,1,23
Albania,2006-03-01,28,0,0,20,20,68
Albania,2006-03-01,6,0,-4,21,10,33
Albania,2006-03-01,20,0,0,41,12,73
Albania,2006-03-01,2,0,0,7,3,12
Albania,2006-03-01,2,0,0,-2,1,1
Albania,2006-03-01,9,0,0,3,0,12
Albania,2006-03-01,17,0,-6,6,17,34
Albania,2006-03-01,9,0,0,3,0,12
Albania,2006-03-01,7,0,0,0,2,9
Albania,2006-03-01,2,0,0,0,2,4
Albania,2006-03-01,9,0,0,-2,0,7
Albania,2006-03-01,0,0,-1,-2,1,-2
Albania,2006-03-01,2,0,0,0,0,2
Albania,2006-03-01,2,0,0,0,0,2
Albania,2006-03-01,5,0,0,0,0,5
Albania,2006-03-01,2,0,0,12,0,14
Albania,2006-03-01,4,0,0,0,0,4
Albania,2006-03-01,7,0,0,3,2,12
Albania,2006-03-01,10,0,1,-2,1,10
Albania,2006-03-01,3,0,-1,6,1,9
Albania,2006-03-01,4,0,0,0,0,4
Algeria,2006-03-01,-1,0,0,3,1,3
Algeria,2006-03-01,12,0,0,21,0,33
Algeria,2006-03-01,4,0,0,3,0,7
Algeria,2006-03-01,0,0,0,0,0,0
Algeria,2006-03-01,1,0,0,0,0,1
Algeria,2006-03-01,4,0,0,-2,0,2
Algeria,2006-03-01,2,0,0,0,0,2
Algeria,2006-03-01,0,0,0,-3,2,-1
Algeria,2006-03-01,0,0,0,3,2,5
Algeria,2006-03-01,-3,0,0,0,0,-3
Algeria,2006-03-01,0,0,0,-2,0,-2
Algeria,2006-03-01,2,0,0,20,0,22
Algeria,2006-03-01,2,0,0,0,0,2
Algeria,2006-03-01,2,0,0,3,0,5
Algeria,2006-03-01,-2,0,0,-2,0,-4
Algeria,2006-03-01,3,0,0,3,0,6
Algeria,2006-03-01,1,0,0,12,0,13
Algeria,2006-03-01,2,0,0,18,0,20
Algeria,2006-03-01,11,0,0,21,3,35
Algeria,2006-03-01,-1,0,0,6,0,5
Algeria,2006-03-01,5,0,0,0,6,11
Algeria,2006-03-01,9,0,0,0,0,9
Algeria,2006-03-01,1,0,0,0,0,1
Algeria,2006-03-01,5,0,0,0,8,13
Algeria,2006-03-01,14,0,0,1,0,15
Algeria,2006-03-01,1,0,0,0,0,1
Algeria,2006-03-01,5,0,0,0,0,5
Algeria,2006-03-01,8,0,0,33,0,41
Algeria,2006-03-01,1,0,-1,0,0,0
Algeria,2006-03-01,0,0,0,0,0,0
Bangladesh,2006-03-01,0,0,0,3,0,3
Bangladesh,2006-03-01,0,0,0,0,0,0
Bangladesh,2006-03-01,0,0,0,0,0,0
Bangladesh,2006-03-01,0,0,0,-2,1,-1
Bangladesh,2006-03-01,0,0,0,0,2,2
Bangladesh,2006-03-01,0,0,0,3,0,3
Bangladesh,2006-03-01,0,0,0,0,0,0
Bangladesh,2006-03-01,0,0,0,0,0,0
Bangladesh,2006-03-01,0,0,0,9,0,9
Bangladesh,2006-03-01,2,0,0,0,3,5
Bangladesh,2006-03-01,9,0,0,0,1,10
Bangladesh,2006-03-01,0,0,0,0,0,0
Bangladesh,2006-03-01,-1,0,0,6,0,5
Bangladesh,2006-03-01,0,0,0,0,0,0
Bangladesh,2006-03-01,0,0,0,18,2,20
Bangladesh,2006-03-01,0,0,0,0,0,0
Bangladesh,2006-03-01,4,0,0,3,1,8
Bangladesh,2006-03-01,3,0,0,6,1,10
Bangladesh,2006-03-01,14,0,-2,15,0,27
Bangladesh,2006-03-01,2,0,0,0,0,2
Bangladesh,2006-03-01,0,0,0,0,2,2
Bangladesh,2006-03-01,21,0,0,0,0,21
Bangladesh,2006-03-01,2,0,0,0,0,2
Bangladesh,2006-03-01,9,0,0,0,4,13
Bangladesh,2006-03-01,8,0,0,0,0,8
Bangladesh,2006-03-01,12,0,0,0,4,16
Bangladesh,2006-03-01,15,0,0,-4,1,12
Bangladesh,2006-03-01,2,0,0,0,1,3
Cameroon,2006-03-01,0,0,0,0,0,0
Cameroon,2006-03-01,0,0,0,0,0,0
Cameroon,2006-03-01,2,0,0,0,0,2
Cameroon,2006-03-01,-1,0,0,0,0,-1
Cameroon,2006-03-01,0,0,0,0,0,0
Cameroon,2006-03-01,0,0,0,0,0,0
Cameroon,2006-03-01,0,0,0,0,0,0
Cameroon,2006-03-01,3,0,0,0,0,3
Cameroon,2006-03-01,12,0,0,9,0,21
Cameroon,2006-03-01,1,0,0,0,0,1
Cameroon,2006-03-01,1,0,1,6,0,8
Cameroon,2006-03-01,1,0,0,0,2,3
Cameroon,2006-03-01,2,0,-2,3,0,3
Cameroon,2006-03-01,-2,0,1,3,0,2
Cameroon,2006-03-01,0,0,0,9,0,9
Cameroon,2006-03-01,0,0,0,0,0,0
Cameroon,2006-03-01,0,0,1,0,0,1
Cameroon,2006-03-01,0,0,0,0,0,0
Cameroon,2006-03-01,1,0,0,0,0,1
Cameroon,2006-03-01,0,0,0,24,0,24
Cameroon,2006-03-01,2,0,0,0,1,3
Cameroon,2006-03-01,28,0,0,45,0,73
Cameroon,2006-03-01,13,0,0,27,0,40
Cameroon,2006-03-01,0,0,-2,7,1,6
China,2006-03-01,33,0,0,-7,0,26
China,2006-03-01,26,0,-6,4,5,29
China,2006-03-01,14,0,0,3,0,17
China,2006-03-01,19,0,0,6,1,26
China,2006-03-01,12,0,0,1,1,14
China,2006-03-01,28,2,0,6,1,37
China,2006-03-01,35,4,0,5,3,47
China,2006-03-01,14,4,0,7,3,28
China,2006-03-01,27,0,0,1,4,32
China,2006-03-01,26,0,0,-17,1,10
China,2006-03-01,-2,0,0,10,1,9
China,2006-03-01,29,0,0,24,2,55
China,2006-03-01,37,0,0,2,2,41
China,2006-03-01,41,0,1,29,5,76
China,2006-03-01,46,0,1,5,1,53
China,2006-03-01,35,0,0,24,3,62
China,2006-03-01,36,0,0,16,3,55
China,2006-03-01,25,2,0,-2,2,27
China,2006-03-01,25,0,-1,0,3,27
China,2006-03-01,60,0,0,30,10,100
China,2006-03-01,60,0,1,11,13,85
China,2006-03-01,46,0,-9,7,0,44
China,2006-03-01,18,0,-1,12,0,29
China,2006-03-01,13,0,0,5,0,18
China,2006-03-01,11,0,0,-2,0,9
China,2006-03-01,27,0,0,21,7,55
China,2006-03-01,8,0,0,4,5,17
China,2006-03-01,28,0,1,46,11,86
China,2006-03-01,22,0,2,16,1,41
China,2006-03-01,45,0,-1,28,3,75
China,2006-03-01,21,0,-2,12,3,34
Egypt,2006-03-01,5,0,0,-4,1,2
Egypt,2006-03-01,2,0,0,3,1,6
Egypt,2006-03-01,11,0,0,37,0,48
Egypt,2006-03-01,0,0,0,-2,6,4
Egypt,2006-03-01,2,0,0,3,0,5
Egypt,2006-03-01,8,0,0,3,0,11
Egypt,2006-03-01,5,0,0,3,0,8
Egypt,2006-03-01,0,0,0,0,0,0
Egypt,2006-03-01,7,0,0,0,0,7
Egypt,2006-03-01,8,0,0,0,0,8
Egypt,2006-03-01,0,0,0,0,0,0
Egypt,2006-03-01,1,0,-2,3,2,4
Egypt,2006-03-01,3,0,0,3,0,6
Egypt,2006-03-01,15,0,0,0,0,15
Egypt,2006-03-01,0,0,0,0,0,0
Egypt,2006-03-01,10,0,0,12,2,24
Egypt,2006-03-01,0,0,0,0,1,1
Egypt,2006-03-01,10,0,0,0,0,10
Egypt,2006-03-01,6,0,0,0,1,7
Egypt,2006-03-01,28,0,0,13,9,50
Egypt,2006-03-01,13,0,0,3,1,17
Egypt,2006-03-01,10,0,0,0,3,13
Egypt,2006-03-01,11,0,0,0,0,11
Egypt,2006-03-01,1,0,0,0,0,1
Egypt,2006-03-01,11,0,0,0,0,11
Egypt,2006-03-01,10,0,0,9,0,19
Egypt,2006-03-01,0,0,0,3,0,3
Egypt,2006-03-01,1,0,0,26,2,29
Egypt,2006-03-01,13,0,0,-8,0,5
Egypt,2006-03-01,12,0,0,9,0,21
Egypt,2006-03-01,6,0,0,-2,0,4
Eritrea,2006-03-01,0,0,0,0,0,0
Eritrea,2006-03-01,0,0,0,0,0,0
Eritrea,2006-03-01,3,0,0,7,0,10
Eritrea,2006-03-01,0,0,0,6,0,6
Eritrea,2006-03-01,0,0,0,0,0,0
Eritrea,2006-03-01,0,0,0,0,0,0
Eritrea,2006-03-01,-2,0,0,3,0,1
Eritrea,2006-03-01,0,0,0,0,0,0
Eritrea,2006-03-01,0,0,0,0,0,0
Eritrea,2006-03-01,-2,0,0,3,0,1
Eritrea,2006-03-01,3,0,0,0,1,4
Eritrea,2006-03-01,9,0,0,0,0,9
Eritrea,2006-03-01,0,0,0,0,0,0
Eritrea,2006-03-01,0,0,0,0,0,0
Eritrea,2006-03-01,1,0,0,0,0,1
Eritrea,2006-03-01,15,2,0,6,0,23
Eritrea,2006-03-01,5,2,0,3,0,10
Eritrea,2006-03-01,3,0,0,0,0,3
Eritrea,2006-03-01,7,0,0,0,0,7
Eritrea,2006-03-01,0,0,0,0,1,1
Eritrea,2006-03-01,0,0,0,3,0,3
Eritrea,2006-03-01,6,0,0,0,0,6
Eritrea,2006-03-01,5,0,0,0,0,5
Eritrea,2006-03-01,1,0,0,0,0,1
Eritrea,2006-03-01,0,0,0,0,0,0
Eritrea,2006-03-01,0,0,0,0,0,0
Georgia,2006-03-01,0,0,0,0,1,1
Georgia,2006-03-01,10,0,0,3,0,13
Georgia,2006-03-01,2,0,0,0,0,2
Georgia,2006-03-01,0,0,0,0,1,1
Georgia,2006-03-01,2,0,0,0,0,2
Georgia,2006-03-01,3,0,0,3,0,6
Georgia,2006-03-01,6,0,0,0,2,8
Georgia,2006-03-01,3,0,0,3,0,6
Georgia,2006-03-01,7,0,0,12,0,19
Georgia,2006-03-01,4,0,0,9,0,13
Georgia,2006-03-01,16,0,0,6,0,22
Georgia,2006-03-01,3,0,0,0,0,3
Georgia,2006-03-01,6,0,0,3,0,9
Georgia,2006-03-01,4,0,-2,0,0,2
Georgia,2006-03-01,0,0,0,8,1,9
Georgia,2006-03-01,0,0,0,6,3,9
Georgia,2006-03-01,0,0,0,-2,2,0
Georgia,2006-03-01,2,0,0,0,1,3
Georgia,2006-03-01,1,0,0,7,0,8
Georgia,2006-03-01,0,0,0,3,1,4
Georgia,2006-03-01,-3,0,0,3,0,0
Georgia,2006-03-01,0,0,0,-2,0,-2
Georgia,2006-03-01,1,0,0,0,2,3
Georgia,2006-03-01,0,0,0,0,0,0
Georgia,2006-03-01,-1,0,0,6,5,10
Georgia,2006-03-01,1,0,0,0,0,1
Georgia,2006-03-01,0,0,0,0,2,2
Georgia,2006-03-01,0,0,0,0,0,0
India,2006-03-01,6,2,0,6,0,14
India,2006-03-01,0,0,0,3,5,8
India,2006-03-01,7,0,1,6,4,18
India,2006-03-01,0,0,0,0,1,1
India,2006-03-01,0,0,0,3,1,4
India,2006-03-01,9,0,0,-4,1,6
India,2006-03-01,6,0,0,0,1,7
India,2006-03-01,2,0,0,0,6,8
India,2006-03-01,7,0,0,3,1,11
India,2006-03-01,0,0,-6,6,0,0
India,2006-03-01,2,0,0,0,0,2
India,2006-03-01,23,0,-2,4,0,25
India,2006-03-01,4,0,0,3,0,7
India,2006-03-01,0,0,0,0,3,3
India,2006-03-01,5,0,0,3,1,9
India,2006-03-01,8,0,-2,3,0,9
India,2006-03-01,11,0,0,0,0,11
India,2006-03-01,0,0,0,0,0,0
India,2006-03-01,2,0,0,0,0,2
India,2006-03-01,14,0,0,1,0,15
India,2006-03-01,20,0,1,0,5,26
India,2006-03-01,13,0,0,0,0,13
India,2006-03-01,2,0,0,3,0,5
India,2006-03-01,8,0,-4,3,0,7
India,2006-03-01,7,0,0,-2,0,5
India,2006-03-01,11,0,-2,0,1,10
India,2006-03-01,5,0,0,8,2,15
India,2006-03-01,15,2,0,15,1,33
India,2006-03-01,2,0,1,10,3,16
India,2006-03-01,5,0,0,0,1,6
India,2006-03-01,18,0,0,3,2,23
Iran,2006-03-01,8,0,0,3,3,14
Iran,2006-03-01,19,0,0,0,3,22
Iran,2006-03-01,-2,0,0,13,6,17
Iran,2006-03-01,23,0,-1,-5,0,17
Iran,2006-03-01,2,0,0,7,5,14
Iran,2006-03-01,15,0,0,4,0,19
Iran,2006-03-01,11,0,3,18,4,36
Iran,2006-03-01,38,0,0,-1,2,39
Iran,2006-03-01,18,0,2,0,4,24
Iran,2006-03-01,29,0,-1,3,0,31
Iran,2006-03-01,25,0,0,3,3,31
Iran,2006-03-01,15,0,0,-4,3,14
Iran,2006-03-01,31,0,1,6,4,42
Iran,2006-03-01,17,0,1,0,2,20
Iran,2006-03-01,14,0,1,4,2,21
Iran,2006-03-01,25,0,1,33,6,65
Iran,2006-03-01,34,0,0,21,8,63
Iran,2006-03-01,17,0,-2,10,9,34
Iran,2006-03-01,8,0,0,1,1,10
Iran,2006-03-01,51,8,0,9,9,77
Iran,2006-03-01,52,6,3,-1,1,61
Iran,2006-03-01,17,2,0,8,0,27
Iran,2006-03-01,10,0,1,4,0,15
Iran,2006-03-01,4,0,0,-1,0,3
Iran,2006-03-01,16,0,0,12,4,32
Iran,2006-03-01,22,0,1,6,0,29
Iran,2006-03-01,27,0,0,3,0,30
Iran,2006-03-01,21,0,0,35,8,64
Iran,2006-03-01,3,0,0,-4,1,0
Iran,2006-03-01,41,0,3,-6,1,39
Iran,2006-03-01,9,0,0,-5,0,4
Iraq,2006-03-01,49,0,0,35,7,91
Iraq,2006-03-01,35,0,0,3,4,42
Iraq,2006-03-01,32,0,0,27,4,63
Iraq,2006-03-01,35,0,0,4,5,44
Iraq,2006-03-01,10,0,0,27,0,37
Iraq,2006-03-01,49,0,0,48,3,100
Iraq,2006-03-01,84,0,4,27,3,118
Iraq,2006-03-01,40,0,0,19,2,61
Iraq,2006-03-01,59,2,0,-6,5,60
Iraq,2006-03-01,39,0,0,21,1,61
Iraq,2006-03-01,35,0,1,40,5,81
Iraq,2006-03-01,96,0,4,19,6,125
Iraq,2006-03-01,24,0,0,16,4,44
Iraq,2006-03-01,88,0,2,96,23,209
Iraq,2006-03-01,85,0,1,28,7,121
Iraq,2006-03-01,38,0,-1,25,9,71
Iraq,2006-03-01,82,0,0,5,17,104
Iraq,2006-03-01,41,0,1,9,30,81
Iraq,2006-03-01,73,0,1,-10,24,88
Iraq,2006-03-01,196,6,2,68,36,308
Iraq,2006-03-01,86,0,0,63,20,169
Iraq,2006-03-01,92,0,1,50,16,159
Iraq,2006-03-01,35,0,-5,18,2,50
Iraq,2006-03-01,31,0,-2,18,2,49
Iraq,2006-03-01,38,2,0,13,2,55
Iraq,2006-03-01,46,0,-2,13,14,71
Iraq,2006-03-01,46,0,4,24,12,86
Iraq,2006-03-01,63,0,0,2,2,67
Iraq,2006-03-01,43,0,-13,16,21,67
Iraq,2006-03-01,113,0,3,27,5,148
Iraq,2006-03-01,31,2,2,23,5,63
Morocco,2006-03-01,-1,0,0,0,0,-1
Morocco,2006-03-01,0,0,0,5,0,5
Morocco,2006-03-01,9,0,0,0,0,9
Morocco,2006-03-01,0,0,0,0,0,0
Morocco,2006-03-01,3,0,0,0,0,3
Morocco,2006-03-01,0,0,0,-4,0,-4
Morocco,2006-03-01,-5,0,0,0,1,-4
Morocco,2006-03-01,1,0,0,0,0,1
Morocco,2006-03-01,1,0,0,0,0,1
Morocco,2006-03-01,6,0,0,0,0,6
Morocco,2006-03-01,3,0,0,6,0,9
Morocco,2006-03-01,0,0,0,0,1,1
Morocco,2006-03-01,0,0,0,0,0,0
Morocco,2006-03-01,4,0,0,0,0,4
Morocco,2006-03-01,15,0,1,12,1,29
Morocco,2006-03-01,0,0,0,0,0,0
Morocco,2006-03-01,0,0,0,3,0,3
Morocco,2006-03-01,8,0,0,16,3,27
Morocco,2006-03-01,1,0,0,7,1,9
Morocco,2006-03-01,4,0,0,0,0,4
Morocco,2006-03-01,14,0,0,3,1,18
Morocco,2006-03-01,2,0,0,0,0,2
Morocco,2006-03-01,7,0,0,0,0,7
Morocco,2006-03-01,16,0,0,0,0,16
Morocco,2006-03-01,6,0,0,0,0,6
Morocco,2006-03-01,2,0,0,0,0,2
Morocco,2006-03-01,0,0,0,0,0,0
Morocco,2006-03-01,0,0,0,0,0,0
Nigeria,2006-03-01,16,0,0,-4,1,13
Nigeria,2006-03-01,4,0,1,6,2,13
Nigeria,2006-03-01,12,0,0,-4,2,10
Nigeria,2006-03-01,0,0,0,-4,0,-4
Nigeria,2006-03-01,6,0,0,3,0,9
Nigeria,2006-03-01,14,0,0,12,1,27
Nigeria,2006-03-01,7,0,-4,3,3,9
Nigeria,2006-03-01,25,0,0,3,2,30
Nigeria,2006-03-01,26,0,0,2,0,28
Nigeria,2006-03-01,5,0,0,-1,4,8
Nigeria,2006-03-01,3,0,0,0,0,3
Nigeria,2006-03-01,1,0,0,0,1,2
Nigeria,2006-03-01,13,0,0,-4,0,9
Nigeria,2006-03-01,5,0,0,15,0,20
Nigeria,2006-03-01,14,2,-2,0,2,16
Nigeria,2006-03-01,14,0,0,2,0,16
Nigeria,2006-03-01,5,0,0,2,5,12
Nigeria,2006-03-01,0,0,0,0,3,3
Nigeria,2006-03-01,5,0,0,9,2,16
Nigeria,2006-03-01,21,0,0,4,5,30
Nigeria,2006-03-01,12,0,0,-12,1,1
Nigeria,2006-03-01,26,0,2,-2,3,29
Nigeria,2006-03-01,32,0,1,-8,3,28
Nigeria,2006-03-01,4,0,0,-2,0,2
Nigeria,2006-03-01,5,0,0,17,0,22
Nigeria,2006-03-01,16,0,0,16,2,34
Nigeria,2006-03-01,16,0,0,-8,0,8
Nigeria,2006-03-01,26,2,-10,26,5,49
Nigeria,2006-03-01,29,0,-2,75,1,103
Nigeria,2006-03-01,25,0,0,19,1,45
Nigeria,2006-03-01,7,0,0,8,0,15
Pakistan,2006-03-01,31,0,0,-5,3,29
Pakistan,2006-03-01,13,0,0,9,4,26
Pakistan,2006-03-01,1,0,0,9,1,11
Pakistan,2006-03-01,5,0,0,0,0,5
Pakistan,2006-03-01,16,0,0,3,1,20
Pakistan,2006-03-01,18,0,0,15,0,33
Pakistan,2006-03-01,29,0,1,2,8,40
Pakistan,2006-03-01,24,0,0,12,3,39
Pakistan,2006-03-01,8,0,0,0,0,8
Pakistan,2006-03-01,20,0,0,9,0,29
Pakistan,2006-03-01,5,0,0,12,3,20
Pakistan,2006-03-01,23,0,0,4,0,27
Pakistan,2006-03-01,72,0,0,24,2,98
Pakistan,2006-03-01,17,0,0,21,0,38
Pakistan,2006-03-01,9,0,0,18,1,28
Pakistan,2006-03-01,37,0,0,37,2,76
Pakistan,2006-03-01,23,0,-1,22,2,46
Pakistan,2006-03-01,36,0,0,18,4,58
Pakistan,2006-03-01,5,0,0,12,3,20
Pakistan,2006-03-01,25,0,-2,10,5,38
Pakistan,2006-03-01,45,0,0,5,5,55
Pakistan,2006-03-01,47,0,0,34,0,81
Pakistan,2006-03-01,9,0,0,24,5,38
Pakistan,2006-03-01,0,0,0,0,2,2
Pakistan,2006-03-01,20,0,0,1,0,21
Pakistan,2006-03-01,25,0,0,4,3,32
Pakistan,2006-03-01,8,0,1,23,1,33
Pakistan,2006-03-01,38,0,0,0,5,43
Pakistan,2006-03-01,17,2,0,1,0,20
Pakistan,2006-03-01,22,0,0,40,8,70
Pakistan,2006-03-01,13,0,0,28,0,41
Sierra Leone,2006-03-01,14,0,0,0,0,14
Sierra Leone,2006-03-01,2,0,-2,0,0,0
Sierra Leone,2006-03-01,-5,0,0,0,0,-5
Sierra Leone,2006-03-01,0,0,0,3,1,4
Sierra Leone,2006-03-01,1,0,0,0,1,2
Sierra Leone,2006-03-01,4,0,0,3,0,7
Sierra Leone,2006-03-01,4,0,0,4,0,8
Sierra Leone,2006-03-01,2,0,0,0,0,2
Sierra Leone,2006-03-01,0,0,0,3,0,3
Sierra Leone,2006-03-01,1,0,0,0,0,1
Sierra Leone,2006-03-01,0,0,0,0,0,0
Sierra Leone,2006-03-01,-1,0,0,9,0,8
Sierra Leone,2006-03-01,2,0,0,3,0,5
Sierra Leone,2006-03-01,6,0,0,12,0,18
Sierra Leone,2006-03-01,0,0,0,0,2,2
Sierra Leone,2006-03-01,0,0,0,0,0,0
Sierra Leone,2006-03-01,1,0,0,2,2,5
Sierra Leone,2006-03-01,-2,0,0,22,0,20
Sierra Leone,2006-03-01,1,0,0,25,4,30
Sierra Leone,2006-03-01,0,0,0,3,0,3
Sierra Leone,2006-03-01,2,0,0,-4,0,-2
Sierra Leone,2006-03-01,5,0,-2,16,1,20
Sierra Leone,2006-03-01,5,0,0,7,3,15
Sierra Leone,2006-03-01,2,0,1,9,0,12
Sierra Leone,2006-03-01,23,0,-2,26,8,55
Sierra Leone,2006-03-01,38,0,0,56,14,108
Sierra Leone,2006-03-01,2,0,0,21,4,27
Sierra Leone,2006-03-01,6,0,0,36,3,45
Somalia,2006-03-01,0,0,0,0,0,0
Somalia,2006-03-01,5,0,-1,0,1,5
Somalia,2006-03-01,0,0,0,0,0,0
Somalia,2006-03-01,0,0,0,0,0,0
Somalia,2006-03-01,0,0,0,0,0,0
Somalia,2006-03-01,2,0,0,3,0,5
Somalia,2006-03-01,2,0,0,13,0,15
Somalia,2006-03-01,0,0,0,24,0,24
Somalia,2006-03-01,3,0,0,6,0,9
Somalia,2006-03-01,7,0,0,0,0,7
Somalia,2006-03-01,0,0,0,0,0,0
Somalia,2006-03-01,5,0,0,0,0,5
Somalia,2006-03-01,-1,0,0,0,0,-1
Somalia,2006-03-01,0,0,0,-2,0,-2
Somalia,2006-03-01,7,0,0,3,0,10
Somalia,2006-03-01,0,0,0,0,5,5
Somalia,2006-03-01,2,2,0,3,2,9
Somalia,2006-03-01,42,2,0,9,0,53
Somalia,2006-03-01,23,0,0,0,0,23
Somalia,2006-03-01,25,4,0,2,0,31
Somalia,2006-03-01,14,10,0,-2,1,23
Somalia,2006-03-01,2,0,0,0,0,2
Somalia,2006-03-01,4,2,0,0,0,6
Somalia,2006-03-01,0,0,0,0,0,0
Somalia,2006-03-01,1,0,0,3,0,4
Somalia,2006-03-01,3,0,0,0,0,3
Somalia,2006-03-01,2,0,0,0,0,2
Somalia,2006-03-01,0,0,0,0,0,0
Somalia,2006-03-01,1,0,0,9,2,12
Somalia,2006-03-01,2,0,0,3,1,6
Somalia,2006-03-01,0,0,0,0,0,0
Syria,2006-03-01,0,0,-2,0,0,-2
Syria,2006-03-01,18,0,0,0,0,18
Syria,2006-03-01,5,0,0,0,0,5
Syria,2006-03-01,2,0,0,0,0,2
Syria,2006-03-01,4,0,0,0,0,4
Syria,2006-03-01,28,0,0,2,5,35
Syria,2006-03-01,8,0,0,0,0,8
Syria,2006-03-01,20,0,0,15,1,36
Syria,2006-03-01,-2,0,0,1,0,-1
Syria,2006-03-01,1,0,0,6,0,7
Syria,2006-03-01,-3,0,0,0,1,-2
Syria,2006-03-01,7,0,0,0,0,7
Syria,2006-03-01,12,0,0,0,0,12
Syria,2006-03-01,39,2,0,17,2,60
Syria,2006-03-01,15,0,0,9,0,24
Syria,2006-03-01,25,0,0,3,3,31
Syria,2006-03-01,6,0,0,6,0,12
Syria,2006-03-01,3,0,-1,0,1,3
Syria,2006-03-01,9,0,0,3,0,12
Syria,2006-03-01,24,0,0,66,0,90
Syria,2006-03-01,12,0,0,1,0,13
Syria,2006-03-01,13,0,1,7,1,22
Syria,2006-03-01,17,0,-1,27,0,43
Syria,2006-03-01,0,0,0,0,0,0
Syria,2006-03-01,3,0,0,0,0,3
Syria,2006-03-01,22,0,0,0,0,22
Syria,2006-03-01,4,0,0,0,0,4
Syria,2006-03-01,-2,0,0,0,0,-2
Syria,2006-03-01,10,0,0,3,0,13
Syria,2006-03-01,2,0,-2,0,1,1
Syria,2006-03-01,-4,0,0,12,0,8
Yemen,2006-03-01,8,0,0,60,3,71
Yemen,2006-03-01,22,0,0,39,1,62
Yemen,2006-03-01,0,0,0,-1,0,-1
Yemen,2006-03-01,0,0,0,-4,0,-4
Yemen,2006-03-01,1,0,0,3,0,4
Yemen,2006-03-01,3,0,0,6,0,9
Yemen,2006-03-01,2,0,0,1,0,3
Yemen,2006-03-01,6,0,0,12,0,18
Yemen,2006-03-01,6,0,0,6,0,12
Yemen,2006-03-01,2,0,0,0,0,2
Yemen,2006-03-01,5,0,0,0,0,5
Yemen,2006-03-01,1,0,0,0,0,1
Yemen,2006-03-01,0,0,0,0,0,0
Yemen,2006-03-01,16,0,0,-2,0,14
Yemen,2006-03-01,0,0,0,3,0,3
Yemen,2006-03-01,5,0,0,6,0,11
Yemen,2006-03-01,-1,0,0,-2,0,-3
Yemen,2006-03-01,2,0,0,3,0,5
Yemen,2006-03-01,-1,0,0,3,0,2
Yemen,2006-03-01,0,0,0,0,0,0
Yemen,2006-03-01,0,0,0,0,0,0
Yemen,2006-03-01,0,0,0,0,2,2
Yemen,2006-03-01,24,0,0,9,1,34
Yemen,2006-03-01,6,0,0,0,0,6
Yemen,2006-03-01,2,0,0,0,0,2
Yemen,2006-03-01,2,0,0,0,0,2
Afghanistan,2008-08-01,84,0,0,47,11,142
Afghanistan,2008-08-01,85,10,0,10,20,125
Afghanistan,2008-08-01,89,0,0,39,5,133
Afghanistan,2008-08-01,142,0,0,49,12,203
Afghanistan,2008-08-01,135,0,1,86,8,230
Afghanistan,2008-08-01,67,0,2,51,8,128
Afghanistan,2008-08-01,51,0,0,55,5,111
Afghanistan,2008-08-01,174,0,0,82,30,286
Afghanistan,2008-08-01,66,0,0,0,13,79
Afghanistan,2008-08-01,17,0,0,0,10,27
Afghanistan,2008-08-01,35,2,0,4,5,46
Afghanistan,2008-08-01,473,0,-6,124,32,623
Afghanistan,2008-08-01,103,2,0,11,8,124
Afghanistan,2008-08-01,20,0,-4,0,7,23
Afghanistan,2008-08-01,39,0,0,9,0,48
Afghanistan,2008-08-01,33,0,0,12,2,47
Afghanistan,2008-08-01,40,0,-6,4,6,44
Afghanistan,2008-08-01,165,0,-9,21,26,203
Afghanistan,2008-08-01,133,4,-8,5,35,169
Afghanistan,2008-08-01,149,2,-1,43,13,206
Afghanistan,2008-08-01,176,4,-7,4,56,233
Afghanistan,2008-08-01,341,0,-1,49,39,428
Afghanistan,2008-08-01,200,0,2,14,38,254
Afghanistan,2008-08-01,150,0,0,1,13,164
Afghanistan,2008-08-01,224,2,-1,72,15,312
Afghanistan,2008-08-01,137,0,-1,41,15,192
Afghanistan,2008-08-01,195,0,2,66,7,270
Afghanistan,2008-08-01,210,0,-1,47,11,267
Afghanistan,2008-08-01,135,2,-1,35,36,207
Afghanistan,2008-08-01,73,2,0,17,22,114
Afghanistan,2008-08-01,133,0,1,27,30,191
Albania,2008-08-01,-1,0,-2,1,2,0
Albania,2008-08-01,-1,0,-2,3,0,0
Albania,2008-08-01,4,0,0,0,0,4
Albania,2008-08-01,4,0,1,0,0,5
Albania,2008-08-01,43,0,0,55,8,106
Albania,2008-08-01,2,0,0,-2,2,2
Albania,2008-08-01,1,0,0,0,0,1
Albania,2008-08-01,22,0,0,29,0,51
Albania,2008-08-01,2,0,0,0,0,2
Albania,2008-08-01,1,0,0,0,0,1
Albania,2008-08-01,2,0,0,0,0,2
Albania,2008-08-01,4,0,-1,0,0,3
Albania,2008-08-01,1,0,0,0,0,1
Albania,2008-08-01,7,0,0,0,0,7
Albania,2008-08-01,2,0,-1,0,0,1
Albania,2008-08-01,0,0,0,0,0,0
Albania,2008-08-01,16,0,0,4,0,20
Albania,2008-08-01,-1,0,0,0,0,-1
Albania,2008-08-01,16,0,0,0,4,20
Albania,2008-08-01,8,0,0,-2,0,6
Albania,2008-08-01,8,0,0,4,0,12
Albania,2008-08-01,6,0,-1,6,2,13
Albania,2008-08-01,15,0,0,0,0,15
Albania,2008-08-01,12,0,0,0,0,12
Albania,2008-08-01,8,0,-3,0,0,5
Albania,2008-08-01,6,0,0,0,0,6
Albania,2008-08-01,45,0,-1,0,10,54
Albania,2008-08-01,12,0,0,0,0,12
Albania,2008-08-01,6,0,0,0,8,14
Albania,2008-08-01,2,0,0,0,1,3
Algeria,2008-08-01,0,0,0,0,0,0
Algeria,2008-08-01,0,0,0,0,0,0
Algeria,2008-08-01,0,0,0,0,0,0
Algeria,2008-08-01,0,0,0,6,0,6
Algeria,2008-08-01,35,0,0,0,0,35
Algeria,2008-08-01,0,0,0,0,0,0
Algeria,2008-08-01,4,0,0,15,2,21
Algeria,2008-08-01,1,0,0,30,0,31
Algeria,2008-08-01,2,0,1,3,0,6
Algeria,2008-08-01,4,0,0,0,0,4
Algeria,2008-08-01,1,0,0,0,0,1
Algeria,2008-08-01,0,0,0,5,0,5
Algeria,2008-08-01,1,0,0,0,0,1
Algeria,2008-08-01,0,0,0,0,0,0
Algeria,2008-08-01,0,0,0,0,0,0
Algeria,2008-08-01,0,0,0,0,0,0
Algeria,2008-08-01,7,0,0,0,0,7
Algeria,2008-08-01,9,0,0,3,0,12
Algeria,2008-08-01,42,0,0,0,16,58
Algeria,2008-08-01,5,0,0,3,0,8
Algeria,2008-08-01,19,0,0,6,9,34
Algeria,2008-08-01,3,0,0,3,3,9
Algeria,2008-08-01,22,0,0,0,8,30
Algeria,2008-08-01,6,0,0,0,0,6
Algeria,2008-08-01,0,0,0,0,0,0
Algeria,2008-08-01,0,0,0,3,0,3
Algeria,2008-08-01,0,0,0,0,0,0
Algeria,2008-08-01,1,0,0,0,0,1
Algeria,2008-08-01,3,0,0,0,0,3
Bangladesh,2008-08-01,18,0,-2,3,0,19
Bangladesh,2008-08-01,15,0,-2,10,0,23
Bangladesh,2008-08-01,2,0,0,-2,1,1
Bangladesh,2008-08-01,17,0,0,14,1,32
Bangladesh,2008-08-01,7,0,-2,33,2,40
Bangladesh,2008-08-01,5,0,-6,6,1,6
Bangladesh,2008-08-01,0,0,1,1,2,4
Bangladesh,2008-08-01,42,0,-1,4,12,57
Bangladesh,2008-08-01,5,0,0,2,1,8
Bangladesh,2008-08-01,1,0,0,-6,0,-5
Bangladesh,2008-08-01,-1,0,0,0,0,-1
Bangladesh,2008-08-01,10,2,0,2,0,14
Bangladesh,2008-08-01,2,0,0,-2,0,0
Bangladesh,2008-08-01,0,0,0,12,0,12
Bangladesh,2008-08-01,11,0,0,0,0,11
Bangladesh,2008-08-01,0,0,0,0,0,0
Bangladesh,2008-08-01,0,0,0,0,0,0
Bangladesh,2008-08-01,13,0,-1,-3,0,9
Bangladesh,2008-08-01,13,0,0,15,0,28
Bangladesh,2008-08-01,9,2,1,19,0,31
Bangladesh,2008-08-01,6,0,0,2,0,8
Bangladesh,2008-08-01,6,0,0,0,0,6
Bangladesh,2008-08-01,0,0,0,9,0,9
Bangladesh,2008-08-01,28,0,0,7,1,36
Bangladesh,2008-08-01,12,0,0,9,7,28
Bangladesh,2008-08-01,31,0,1,30,2,64
Bangladesh,2008-08-01,4,0,0,4,3,11
Bangladesh,2008-08-01,7,2,0,6,3,18
Bangladesh,2008-08-01,1,0,0,3,1,5
Bangladesh,2008-08-01,2,0,0,-2,0,0
Bangladesh,2008-08-01,6,0,0,6,0,12
Cameroon,2008-08-01,0,0,0,-1,0,-1
Cameroon,2008-08-01,0,0,0,9,0,9
Cameroon,2008-08-01,0,0,0,0,0,0
Cameroon,2008-08-01,0,0,0,0,0,0
Cameroon,2008-08-01,1,0,0,0,0,1
Cameroon,2008-08-01,-1,0,0,0,0,-1
Cameroon,2008-08-01,13,0,0,9,4,26
Cameroon,2008-08-01,0,0,0,0,0,0
Cameroon,2008-08-01,6,0,0,0,0,6
Cameroon,2008-08-01,0,0,0,0,0,0
Cameroon,2008-08-01,16,0,0,0,0,16
Cameroon,2008-08-01,0,0,0,0,0,0
Cameroon,2008-08-01,0,0,0,-2,0,-2
Cameroon,2008-08-01,0,0,0,0,0,0
Cameroon,2008-08-01,0,0,0,0,0,0
Cameroon,2008-08-01,0,0,0,0,0,0
Cameroon,2008-08-01,0,0,0,0,0,0
Cameroon,2008-08-01,0,0,0,0,0,0
Cameroon,2008-08-01,0,0,0,0,0,0
Cameroon,2008-08-01,0,0,-2,0,0,-2
China,2008-08-01,53,2,0,107,14,176
China,2008-08-01,29,0,-2,8,4,39
China,2008-08-01,49,2,3,32,9,95
China,2008-08-01,45,0,0,7,12,64
China,2008-08-01,77,0,-1,130,12,218
China,2008-08-01,35,2,1,34,7,79
China,2008-08-01,-14,0,0,15,2,3
China,2008-08-01,119,0,-2,125,37,279
China,2008-08-01,14,0,0,30,0,44
China,2008-08-01,14,0,0,-2,2,14
China,2008-08-01,8,2,0,6,2,18
China,2008-08-01,145,2,0,41,18,206
China,2008-08-01,23,0,0,9,0,32
China,2008-08-01,30,0,0,21,12,63
China,2008-08-01,27,0,-1,-7,11,30
China,2008-08-01,11,0,-2,6,1,16
China,2008-08-01,10,0,-2,21,7,36
China,2008-08-01,108,2,-3,64,27,198
China,2008-08-01,4,0,1,11,0,16
China,2008-08-01,145,0,-5,41,6,187
China,2008-08-01,199,0,2,43,13,257
China,2008-08-01,118,0,-7,33,13,157
China,2008-08-01,38,0,0,2,8,48
China,2008-08-01,58,0,-1,18,16,91
China,2008-08-01,58,0,0,13,13,84
China,2008-08-01,46,0,0,27,4,77
China,2008-08-01,49,0,2,12,6,69
China,2008-08-01,90,2,0,63,8,163
China,2008-08-01,53,0,-1,15,3,70
China,2008-08-01,37,0,0,6,9,52
China,2008-08-01,25,2,1,17,9,54
Egypt,2008-08-01,15,0,0,21,2,38
Egypt,2008-08-01,81,0,1,34,0,116
Egypt,2008-08-01,31,0,1,20,5,57
Egypt,2008-08-01,47,0,0,27,8,82
Egypt,2008-08-01,25,0,0,7,0,32
Egypt,2008-08-01,10,0,0,1,2,13
Egypt,2008-08-01,6,0,0,3,0,9
Egypt,2008-08-01,30,0,0,34,2,66
Egypt,2008-08-01,14,0,0,-4,1,11
Egypt,2008-08-01,12,0,0,0,0,12
Egypt,2008-08-01,3,0,0,-1,2,4
Egypt,2008-08-01,89,0,3,22,4,118
Egypt,2008-08-01,21,0,0,0,0,21
Egypt,2008-08-01,0,0,0,0,0,0
Egypt,2008-08-01,0,0,0,0,0,0
Egypt,2008-08-01,1,0,0,0,0,1
Egypt,2008-08-01,2,0,0,-4,0,-2
Egypt,2008-08-01,23,0,0,15,2,40
Egypt,2008-08-01,6,0,0,0,5,11
Egypt,2008-08-01,27,0,0,3,1,31
Egypt,2008-08-01,19,0,0,15,0,34
Egypt,2008-08-01,8,0,0,0,0,8
Egypt,2008-08-01,21,0,-2,13,0,32
Egypt,2008-08-01,31,0,0,9,0,40
Egypt,2008-08-01,18,0,0,14,0,32
Egypt,2008-08-01,10,0,0,3,3,16
Egypt,2008-08-01,57,0,0,35,0,92
Egypt,2008-08-01,9,0,0,0,0,9
Egypt,2008-08-01,3,0,0,40,2,45
Egypt,2008-08-01,35,0,2,-14,0,23
Egypt,2008-08-01,39,0,1,2,0,42
Eritrea,2008-08-01,18,0,0,0,0,18
Eritrea,2008-08-01,3,0,0,0,1,4
Eritrea,2008-08-01,0,0,0,0,0,0
Eritrea,2008-08-01,9,0,0,0,0,9
Eritrea,2008-08-01,-2,0,0,0,0,-2
Eritrea,2008-08-01,6,0,0,3,5,14
Eritrea,2008-08-01,0,0,0,0,0,0
Eritrea,2008-08-01,7,0,1,0,1,9
Eritrea,2008-08-01,0,0,0,0,0,0
Eritrea,2008-08-01,2,0,0,-1,0,1
Eritrea,2008-08-01,2,0,0,12,0,14
Eritrea,2008-08-01,2,0,0,0,0,2
Eritrea,2008-08-01,2,0,0,6,0,8
Eritrea,2008-08-01,-2,0,0,0,0,-2
Eritrea,2008-08-01,5,0,0,0,0,5
Eritrea,2008-08-01,2,0,0,0,1,3
Eritrea,2008-08-01,22,0,0,3,0,25
Georgia,2008-08-01,0,0,0,3,0,3
Georgia,2008-08-01,0,0,0,0,0,0
Georgia,2008-08-01,0,0,0,0,0,0
Georgia,2008-08-01,10,0,0,0,0,10
Georgia,2008-08-01,4,0,0,6,0,10
Georgia,2008-08-01,5,0,0,0,1,6
Georgia,2008-08-01,0,0,0,0,0,0
Georgia,2008-08-01,38,4,0,1,0,43
Georgia,2008-08-01,15,0,0,3,0,18
Georgia,2008-08-01,3,0,0,3,0,6
Georgia,2008-08-01,3,0,0,0,2,5
Georgia,2008-08-01,77,2,0,4,9,92
Georgia,2008-08-01,14,0,0,3,1,18
Georgia,2008-08-01,40,0,0,6,1,47
Georgia,2008-08-01,16,0,0,3,0,19
Georgia,2008-08-01,4,0,0,0,1,5
Georgia,2008-08-01,1,0,0,3,0,4
Georgia,2008-08-01,34,0,-2,14,13,59
Georgia,2008-08-01,16,0,0,3,1,20
Georgia,2008-08-01,51,0,1,2,7,61
Georgia,2008-08-01,31,0,0,-1,9,39
Georgia,2008-08-01,37,0,1,5,6,49
Georgia,2008-08-01,0,0,0,3,2,5
Georgia,2008-08-01,0,0,0,3,2,5
Georgia,2008-08-01,34,0,0,0,0,34
Georgia,2008-08-01,12,0,0,-3,0,9
Georgia,2008-08-01,9,0,0,1,0,10
Georgia,2008-08-01,36,0,0,19,6,61
Georgia,2008-08-01,9,2,0,-1,2,12
Georgia,2008-08-01,-5,0,0,12,0,7
Georgia,2008-08-01,16,0,0,0,3,19
India,2008-08-01,67,2,1,9,1,80
India,2008-08-01,42,2,-4,-2,0,38
India,2008-08-01,67,0,0,6,8,81
India,2008-08-01,54,0,-1,7,16,76
India,2008-08-01,16,0,-4,37,1,50
India,2008-08-01,3,4,0,4,0,11
India,2008-08-01,3,0,0,0,6,9
India,2008-08-01,54,0,-1,4,4,61
India,2008-08-01,24,0,-1,12,3,38
India,2008-08-01,1,0,0,3,0,4
India,2008-08-01,10,0,-1,6,0,15
India,2008-08-01,14,0,0,-1,1,14
India,2008-08-01,20,0,1,3,4,28
India,2008-08-01,1,2,0,0,0,3
India,2008-08-01,0,0,0,0,0,0
India,2008-08-01,0,0,0,0,0,0
India,2008-08-01,36,0,-15,33,4,58
India,2008-08-01,17,0,0,10,2,29
India,2008-08-01,30,2,0,11,10,53
India,2008-08-01,47,0,-1,13,7,66
India,2008-08-01,18,0,-1,-7,4,14
India,2008-08-01,24,0,0,13,2,39
India,2008-08-01,33,0,1,17,1,52
India,2008-08-01,31,2,-2,5,12,48
India,2008-08-01,55,0,0,10,14,79
India,2008-08-01,54,0,2,3,8,67
India,2008-08-01,98,2,0,8,20,128
India,2008-08-01,79,0,3,8,19,109
India,2008-08-01,41,0,-6,17,9,61
India,2008-08-01,35,0,0,8,4,47
Iran,2008-08-01,27,0,1,16,1,45
Iran,2008-08-01,27,0,1,21,6,55
Iran,2008-08-01,9,0,0,16,9,34
Iran,2008-08-01,52,0,0,16,6,74
Iran,2008-08-01,6,0,0,-2,3,7
Iran,2008-08-01,5,0,0,10,4,19
Iran,2008-08-01,3,0,0,0,0,3
Iran,2008-08-01,52,0,1,13,4,70
Iran,2008-08-01,9,0,0,3,1,13
Iran,2008-08-01,16,0,0,3,0,19
Iran,2008-08-01,6,0,0,3,0,9
Iran,2008-08-01,20,0,1,22,4,47
Iran,2008-08-01,0,0,1,3,0,4
Iran,2008-08-01,6,0,0,0,0,6
Iran,2008-08-01,9,0,0,3,0,12
Iran,2008-08-01,9,0,0,3,0,12
Iran,2008-08-01,19,0,0,0,6,25
Iran,2008-08-01,89,0,2,62,15,168
Iran,2008-08-01,22,0,0,3,1,26
Iran,2008-08-01,39,0,0,16,14,69
Iran,2008-08-01,39,0,0,47,0,86
Iran,2008-08-01,47,2,0,5,1,55
Iran,2008-08-01,31,4,1,27,0,63
Iran,2008-08-01,26,0,2,43,3,74
Iran,2008-08-01,32,0,0,9,10,51
Iran,2008-08-01,35,2,2,45,7,91
Iran,2008-08-01,33,2,0,-7,7,35
Iran,2008-08-01,44,0,0,14,7,65
Iran,2008-08-01,32,0,1,6,11,50
Iran,2008-08-01,26,0,0,-2,16,40
Iran,2008-08-01,12,0,0,-2,7,17
Iraq,2008-08-01,109,2,1,14,22,148
Iraq,2008-08-01,64,2,2,14,0,82
Iraq,2008-08-01,77,2,1,13,5,98
Iraq,2008-08-01,101,0,-1,32,12,144
Iraq,2008-08-01,106,2,1,1,8,118
Iraq,2008-08-01,76,0,-1,17,14,106
Iraq,2008-08-01,10,0,0,-2,4,12
Iraq,2008-08-01,110,6,0,16,5,137
Iraq,2008-08-01,39,0,0,3,1,43
Iraq,2008-08-01,-8,0,0,0,2,-6
Iraq,2008-08-01,29,0,0,15,0,44
Iraq,2008-08-01,191,2,1,37,8,239
Iraq,2008-08-01,32,2,0,5,10,49
Iraq,2008-08-01,29,0,0,3,4,36
Iraq,2008-08-01,9,0,0,-1,0,8
Iraq,2008-08-01,3,0,0,0,0,3
Iraq,2008-08-01,27,0,1,1,4,33
Iraq,2008-08-01,89,0,5,-1,20,113
Iraq,2008-08-01,33,0,0,9,1,43
Iraq,2008-08-01,117,0,0,16,10,143
Iraq,2008-08-01,100,0,0,34,15,149
Iraq,2008-08-01,53,0,9,58,9,129
Iraq,2008-08-01,23,0,8,12,10,53
Iraq,2008-08-01,54,4,3,8,11,80
Iraq,2008-08-01,60,0,-2,14,7,79
Iraq,2008-08-01,135,6,12,63,11,227
Iraq,2008-08-01,58,0,8,5,9,80
Iraq,2008-08-01,126,0,4,40,2,172
Iraq,2008-08-01,41,2,6,34,13,96
Iraq,2008-08-01,56,0,-2,0,6,60
Iraq,2008-08-01,29,0,0,5,13,47
Morocco,2008-08-01,1,0,0,3,0,4
Morocco,2008-08-01,0,0,0,6,0,6
Morocco,2008-08-01,5,0,0,0,0,5
Morocco,2008-08-01,2,0,0,0,0,2
Morocco,2008-08-01,0,0,0,0,0,0
Morocco,2008-08-01,0,0,0,0,0,0
Morocco,2008-08-01,0,0,0,0,3,3
Morocco,2008-08-01,0,0,0,15,0,15
Morocco,2008-08-01,3,0,0,18,0,21
Morocco,2008-08-01,2,0,0,0,0,2
Morocco,2008-08-01,0,0,0,0,0,0
Morocco,2008-08-01,0,0,0,0,0,0
Morocco,2008-08-01,3,0,0,3,0,6
Morocco,2008-08-01,6,0,0,5,0,11
Morocco,2008-08-01,0,0,0,3,1,4
Morocco,2008-08-01,5,0,0,24,1,30
Morocco,2008-08-01,5,0,0,3,1,9
Morocco,2008-08-01,0,0,0,0,0,0
Morocco,2008-08-01,-1,0,0,0,0,-1
Morocco,2008-08-01,0,0,0,0,0,0
Morocco,2008-08-01,0,0,0,13,0,13
Morocco,2008-08-01,0,0,0,6,0,6
Morocco,2008-08-01,4,0,0,18,0,22
Morocco,2008-08-01,0,0,0,9,0,9
Morocco,2008-08-01,0,0,0,0,0,0
Nigeria,2008-08-01,10,0,0,3,6,19
Nigeria,2008-08-01,6,0,0,9,0,15
Nigeria,2008-08-01,5,0,0,3,0,8
Nigeria,2008-08-01,6,0,0,13,1,20
Nigeria,2008-08-01,12,0,0,0,3,15
Nigeria,2008-08-01,10,0,0,3,0,13
Nigeria,2008-08-01,0,0,0,3,0,3
Nigeria,2008-08-01,173,0,-1,71,12,255
Nigeria,2008-08-01,1,0,0,0,0,1
Nigeria,2008-08-01,0,0,0,0,0,0
Nigeria,2008-08-01,16,0,0,8,1,25
Nigeria,2008-08-01,7,0,0,0,0,7
Nigeria,2008-08-01,10,0,0,0,0,10
Nigeria,2008-08-01,0,0,0,3,0,3
Nigeria,2008-08-01,0,0,0,0,0,0
Nigeria,2008-08-01,7,0,-2,9,1,15
Nigeria,2008-08-01,9,0,0,3,2,14
Nigeria,2008-08-01,3,2,0,15,3,23
Nigeria,2008-08-01,31,2,-2,18,6,55
Nigeria,2008-08-01,21,0,0,35,0,56
Nigeria,2008-08-01,17,0,0,0,1,18
Nigeria,2008-08-01,11,0,0,18,0,29
Nigeria,2008-08-01,11,0,1,9,0,21
Nigeria,2008-08-01,8,0,0,15,0,23
Nigeria,2008-08-01,9,0,0,-4,0,5
Nigeria,2008-08-01,5,0,0,3,0,8
Nigeria,2008-08-01,10,0,0,4,3,17
Nigeria,2008-08-01,3,0,0,0,0,3
Nigeria,2008-08-01,19,0,0,0,1,20
Pakistan,2008-08-01,130,0,0,19,64,213
Pakistan,2008-08-01,156,0,1,17,7,181
Pakistan,2008-08-01,83,0,0,36,9,128
Pakistan,2008-08-01,123,0,1,6,17,147
Pakistan,2008-08-01,73,0,0,16,10,99
Pakistan,2008-08-01,21,0,0,12,3,36
Pakistan,2008-08-01,15,0,0,6,0,21
Pakistan,2008-08-01,97,0,-8,57,14,160
Pakistan,2008-08-01,38,0,0,18,4,60
Pakistan,2008-08-01,22,0,0,3,0,25
Pakistan,2008-08-01,20,0,0,0,2,22
Pakistan,2008-08-01,190,0,-1,28,23,240
Pakistan,2008-08-01,25,0,-2,2,13,38
Pakistan,2008-08-01,45,0,-6,-2,2,39
Pakistan,2008-08-01,3,0,-1,0,0,2
Pakistan,2008-08-01,7,0,0,3,1,11
Pakistan,2008-08-01,39,0,-11,20,2,50
Pakistan,2008-08-01,195,2,-73,30,20,174
Pakistan,2008-08-01,95,0,-35,24,22,106
Pakistan,2008-08-01,69,0,-9,22,26,108
Pakistan,2008-08-01,66,0,-7,82,20,161
Pakistan,2008-08-01,161,0,-8,13,9,175
Pakistan,2008-08-01,73,0,-14,10,21,90
Pakistan,2008-08-01,24,0,-3,13,4,38
Pakistan,2008-08-01,87,2,-2,35,12,134
Pakistan,2008-08-01,46,0,4,1,14,65
Pakistan,2008-08-01,73,0,3,44,7,127
Pakistan,2008-08-01,64,0,-2,13,4,79
Pakistan,2008-08-01,77,0,0,39,2,118
Pakistan,2008-08-01,74,0,0,10,0,84
Pakistan,2008-08-01,18,0,-2,5,4,25
Sierra Leone,2008-08-01,4,0,-2,0,0,2
Sierra Leone,2008-08-01,-1,0,0,0,0,-1
Sierra Leone,2008-08-01,4,0,0,0,0,4
Sierra Leone,2008-08-01,4,0,0,3,2,9
Sierra Leone,2008-08-01,0,0,0,0,0,0
Sierra Leone,2008-08-01,10,0,0,0,0,10
Sierra Leone,2008-08-01,0,0,0,0,0,0
Sierra Leone,2008-08-01,6,0,0,0,0,6
Sierra Leone,2008-08-01,0,0,0,0,0,0
Sierra Leone,2008-08-01,0,0,0,0,0,0
Sierra Leone,2008-08-01,0,0,0,0,0,0
Sierra Leone,2008-08-01,4,0,0,0,0,4
Sierra Leone,2008-08-01,3,0,0,0,0,3
Sierra Leone,2008-08-01,0,0,0,0,0,0
Somalia,2008-08-01,0,0,0,18,0,18
Somalia,2008-08-01,8,0,-4,0,0,4
Somalia,2008-08-01,22,0,-4,0,7,25
Somalia,2008-08-01,11,0,0,6,0,17
Somalia,2008-08-01,9,0,0,2,1,12
Somalia,2008-08-01,5,0,-4,4,0,5
Somalia,2008-08-01,8,0,0,0,0,8
Somalia,2008-08-01,17,0,0,3,0,20
Somalia,2008-08-01,3,0,0,-15,0,-12
Somalia,2008-08-01,0,0,0,0,0,0
Somalia,2008-08-01,7,0,0,0,0,7
Somalia,2008-08-01,15,4,0,1,0,20
Somalia,2008-08-01,3,0,0,0,2,5
Somalia,2008-08-01,3,0,0,0,0,3
Somalia,2008-08-01,2,0,0,0,0,2
Somalia,2008-08-01,2,0,0,0,0,2
Somalia,2008-08-01,11,0,0,-1,2,12
Somalia,2008-08-01,1,0,0,0,0,1
Somalia,2008-08-01,46,0,0,22,3,71
Somalia,2008-08-01,99,0,0,18,0,117
Somalia,2008-08-01,84,0,0,15,0,99
Somalia,2008-08-01,73,2,0,16,2,93
Somalia,2008-08-01,3,0,0,0,0,3
Somalia,2008-08-01,9,0,0,0,0,9
Somalia,2008-08-01,30,0,0,28,0,58
Somalia,2008-08-01,2,2,0,0,0,4
Somalia,2008-08-01,33,0,0,-6,0,27
Somalia,2008-08-01,38,0,0,0,2,40
Somalia,2008-08-01,20,0,0,0,0,20
Somalia,2008-08-01,0,0,0,0,0,0
Syria,2008-08-01,38,0,2,0,1,41
Syria,2008-08-01,12,0,0,6,4,22
Syria,2008-08-01,18,0,0,6,4,28
Syria,2008-08-01,3,0,0,9,5,17
Syria,2008-08-01,3,0,0,7,0,10
Syria,2008-08-01,14,0,1,0,0,15
Syria,2008-08-01,4,0,0,0,0,4
Syria,2008-08-01,8,0,-12,-2,1,-5
Syria,2008-08-01,0,0,0,0,0,0
Syria,2008-08-01,3,0,0,0,0,3
Syria,2008-08-01,7,0,0,0,0,7
Syria,2008-08-01,4,0,0,0,0,4
Syria,2008-08-01,29,0,0,-2,3,30
Syria,2008-08-01,3,0,0,15,2,20
Syria,2008-08-01,3,0,0,5,0,8
Syria,2008-08-01,-1,0,0,3,0,2
Syria,2008-08-01,9,0,0,0,0,9
Syria,2008-08-01,3,0,0,1,8,12
Syria,2008-08-01,0,0,0,0,0,0
Syria,2008-08-01,12,0,0,3,4,19
Syria,2008-08-01,14,0,3,3,4,24
Syria,2008-08-01,20,0,3,9,0,32
Syria,2008-08-01,0,0,0,0,0,0
Syria,2008-08-01,6,0,0,1,0,7
Syria,2008-08-01,9,0,0,6,6,21
Syria,2008-08-01,1,0,0,0,0,1
Syria,2008-08-01,3,0,0,0,0,3
Syria,2008-08-01,3,0,0,0,0,3
Syria,2008-08-01,17,0,0,6,0,23
Syria,2008-08-01,3,0,4,60,0,67
Syria,2008-08-01,19,0,0,0,0,19
Yemen,2008-08-01,4,0,0,32,3,39
Yemen,2008-08-01,15,0,0,29,9,53
Yemen,2008-08-01,7,0,0,7,1,15
Yemen,2008-08-01,33,0,0,32,8,73
Yemen,2008-08-01,22,0,0,21,4,47
Yemen,2008-08-01,11,0,1,9,3,24
Yemen,2008-08-01,2,0,0,27,4,33
Yemen,2008-08-01,29,0,0,72,1,102
Yemen,2008-08-01,2,0,0,4,3,9
Yemen,2008-08-01,1,0,0,0,3,4
Yemen,2008-08-01,0,0,0,0,0,0
Yemen,2008-08-01,27,0,0,31,1,59
Yemen,2008-08-01,0,0,0,0,0,0
Yemen,2008-08-01,12,0,0,0,0,12
Yemen,2008-08-01,6,0,0,6,0,12
Yemen,2008-08-01,1,0,0,6,2,9
Yemen,2008-08-01,12,0,0,17,0,29
Yemen,2008-08-01,8,0,0,3,0,11
Yemen,2008-08-01,2,0,0,0,0,2
Yemen,2008-08-01,1,0,0,-2,0,-1
Yemen,2008-08-01,11,0,0,0,2,13
Yemen,2008-08-01,9,0,0,0,0,9
Yemen,2008-08-01,0,0,0,12,0,12
Yemen,2008-08-01,7,0,0,0,1,8
Yemen,2008-08-01,19,0,0,3,0,22
Yemen,2008-08-01,1,0,0,6,0,7
Yemen,2008-08-01,16,0,0,6,0,22
Yemen,2008-08-01,2,0,0,0,0,2
Yemen,2008-08-01,15,0,0,0,0,15
Yemen,2008-08-01,2,0,0,-2,0,0
Afghanistan,2006-07-01,34,0,0,15,2,51
Afghanistan,2006-07-01,48,4,-2,11,7,68
Afghanistan,2006-07-01,60,0,-1,-2,2,59
Afghanistan,2006-07-01,34,2,0,13,4,53
Afghanistan,2006-07-01,27,0,0,3,4,34
Afghanistan,2006-07-01,39,0,0,6,3,48
Afghanistan,2006-07-01,32,0,-1,6,3,40
Afghanistan,2006-07-01,23,0,-2,13,0,34
Afghanistan,2006-07-01,26,0,0,0,0,26
Afghanistan,2006-07-01,51,0,0,-8,0,43
Afghanistan,2006-07-01,36,0,0,16,7,59
Afghanistan,2006-07-01,33,0,0,12,1,46
Afghanistan,2006-07-01,37,0,-2,7,10,52
Afghanistan,2006-07-01,10,0,0,12,0,22
Afghanistan,2006-07-01,20,0,-2,0,1,19
Afghanistan,2006-07-01,29,0,0,6,1,36
Afghanistan,2006-07-01,35,0,0,18,0,53
Afghanistan,2006-07-01,17,0,0,37,0,54
Afghanistan,2006-07-01,12,0,0,18,0,30
Afghanistan,2006-07-01,29,0,0,16,2,47
Afghanistan,2006-07-01,12,0,0,21,0,33
Afghanistan,2006-07-01,36,2,0,0,9,47
Afghanistan,2006-07-01,41,0,0,3,7,51
Afghanistan,2006-07-01,27,0,0,18,1,46
Afghanistan,2006-07-01,24,0,0,-8,2,18
Afghanistan,2006-07-01,49,0,1,27,0,77
Afghanistan,2006-07-01,64,0,0,18,7,89
Afghanistan,2006-07-01,19,0,0,14,12,45
Afghanistan,2006-07-01,10,0,0,6,1,17
Afghanistan,2006-07-01,26,0,0,3,0,29
Afghanistan,2006-07-01,59,0,0,0,0,59
Albania,2006-07-01,9,0,0,0,0,9
Albania,2006-07-01,1,0,1,0,1,3
Albania,2006-07-01,8,0,1,-6,2,5
Albania,2006-07-01,8,0,1,0,0,9
Albania,2006-07-01,4,0,-1,0,0,3
Albania,2006-07-01,17,0,0,6,0,23
Albania,2006-07-01,11,0,0,0,5,16
Albania,2006-07-01,0,0,0,0,0,0
Albania,2006-07-01,14,0,0,12,2,28
Albania,2006-07-01,20,0,0,15,2,37
Albania,2006-07-01,10,0,2,0,1,13
Albania,2006-07-01,0,0,0,0,0,0
Albania,2006-07-01,0,0,0,0,0,0
Albania,2006-07-01,3,0,0,0,0,3
Albania,2006-07-01,0,0,0,0,0,0
Albania,2006-07-01,3,0,0,0,0,3
Albania,2006-07-01,0,0,0,3,0,3
Albania,2006-07-01,1,0,0,0,0,1
Albania,2006-07-01,13,0,0,-1,0,12
Albania,2006-07-01,3,0,0,3,0,6
Albania,2006-07-01,3,0,0,0,1,4
Albania,2006-07-01,1,0,0,0,1,2
Albania,2006-07-01,1,0,-1,3,0,3
Albania,2006-07-01,9,0,-1,0,1,9
Albania,2006-07-01,0,0,0,3,2,5
Albania,2006-07-01,7,0,0,-8,0,-1
Albania,2006-07-01,3,0,0,-2,0,1
Albania,2006-07-01,-2,0,0,0,1,-1
Albania,2006-07-01,3,0,0,-3,0,0
Albania,2006-07-01,4,0,0,0,0,4
Albania,2006-07-01,21,0,0,12,0,33
Algeria,2006-07-01,0,0,0,0,0,0
Algeria,2006-07-01,4,0,0,3,0,7
Algeria,2006-07-01,4,0,1,3,0,8
Algeria,2006-07-01,4,0,0,1,0,5
Algeria,2006-07-01,2,0,-1,0,0,1
Algeria,2006-07-01,4,0,0,-1,0,3
Algeria,2006-07-01,0,0,0,0,0,0
Algeria,2006-07-01,0,0,0,0,0,0
Algeria,2006-07-01,0,0,0,0,0,0
Algeria,2006-07-01,11,0,0,19,0,30
Algeria,2006-07-01,-2,0,0,0,0,-2
Algeria,2006-07-01,7,0,0,0,0,7
Algeria,2006-07-01,17,0,0,0,0,17
Algeria,2006-07-01,0,0,0,0,0,0
Algeria,2006-07-01,-3,0,0,-4,0,-7
Algeria,2006-07-01,-2,0,0,0,0,-2
Algeria,2006-07-01,-1,0,0,0,0,-1
Algeria,2006-07-01,3,0,0,0,0,3
Algeria,2006-07-01,0,0,0,0,0,0
Algeria,2006-07-01,6,0,0,9,0,15
Algeria,2006-07-01,2,0,0,2,0,4
Algeria,2006-07-01,12,0,0,0,2,14
Algeria,2006-07-01,4,0,0,6,0,10
Algeria,2006-07-01,0,0,-1,0,6,5
Algeria,2006-07-01,0,0,0,0,0,0
Algeria,2006-07-01,0,0,0,0,0,0
Algeria,2006-07-01,0,0,0,0,0,0
Algeria,2006-07-01,12,0,0,0,0,12
Algeria,2006-07-01,24,0,0,0,0,24
Algeria,2006-07-01,0,0,1,0,0,1
Algeria,2006-07-01,1,0,0,0,0,1
Bangladesh,2006-07-01,0,0,0,0,0,0
Bangladesh,2006-07-01,2,0,0,0,0,2
Bangladesh,2006-07-01,0,0,0,0,0,0
Bangladesh,2006-07-01,-1,0,0,0,2,1
Bangladesh,2006-07-01,0,0,0,-2,0,-2
Bangladesh,2006-07-01,23,0,1,18,0,42
Bangladesh,2006-07-01,3,0,0,0,0,3
Bangladesh,2006-07-01,2,0,0,0,0,2
Bangladesh,2006-07-01,4,0,0,0,0,4
Bangladesh,2006-07-01,9,0,0,0,4,13
Bangladesh,2006-07-01,5,0,0,0,0,5
Bangladesh,2006-07-01,3,0,0,0,3,6
Bangladesh,2006-07-01,0,0,0,3,0,3
Bangladesh,2006-07-01,5,0,0,0,0,5
Bangladesh,2006-07-01,6,0,0,0,0,6
Bangladesh,2006-07-01,6,0,0,3,0,9
Bangladesh,2006-07-01,3,0,0,-2,0,1
Bangladesh,2006-07-01,-6,0,0,0,0,-6
Bangladesh,2006-07-01,4,0,0,3,0,7
Bangladesh,2006-07-01,0,0,0,0,0,0
Bangladesh,2006-07-01,25,6,0,9,2,42
Bangladesh,2006-07-01,1,0,0,3,0,4
Bangladesh,2006-07-01,0,0,0,0,0,0
Bangladesh,2006-07-01,0,0,0,3,3,6
Bangladesh,2006-07-01,8,0,0,0,3,11
Bangladesh,2006-07-01,3,0,0,0,0,3
Bangladesh,2006-07-01,3,0,0,3,0,6
Bangladesh,2006-07-01,2,0,0,0,6,8
Bangladesh,2006-07-01,-1,0,1,2,0,2
Bangladesh,2006-07-01,13,0,1,-2,0,12
Bangladesh,2006-07-01,3,0,0,0,0,3
Cameroon,2006-07-01,0,0,0,0,0,0
Cameroon,2006-07-01,2,0,0,3,0,5
Cameroon,2006-07-01,0,0,0,0,0,0
Cameroon,2006-07-01,0,0,0,0,0,0
Cameroon,2006-07-01,2,0,0,0,0,2
Cameroon,2006-07-01,3,0,0,3,0,6
Cameroon,2006-07-01,0,0,0,0,0,0
Cameroon,2006-07-01,4,0,0,0,0,4
Cameroon,2006-07-01,0,0,0,0,0,0
Cameroon,2006-07-01,0,0,0,0,0,0
Cameroon,2006-07-01,0,0,0,3,0,3
Cameroon,2006-07-01,3,0,0,0,0,3
Cameroon,2006-07-01,0,0,0,3,0,3
Cameroon,2006-07-01,-1,0,0,0,0,-1
Cameroon,2006-07-01,0,0,0,0,0,0
Cameroon,2006-07-01,3,0,0,0,1,4
Cameroon,2006-07-01,0,0,0,0,0,0
Cameroon,2006-07-01,0,0,0,0,0,0
Cameroon,2006-07-01,2,0,0,0,0,2
Cameroon,2006-07-01,4,0,0,0,0,4
Cameroon,2006-07-01,0,0,0,0,0,0
Cameroon,2006-07-01,0,0,0,0,0,0
Cameroon,2006-07-01,3,0,0,0,0,3
Cameroon,2006-07-01,2,0,0,0,0,2
Cameroon,2006-07-01,1,0,0,0,0,1
China,2006-07-01,12,0,0,4,6,22
China,2006-07-01,15,0,0,6,0,21
China,2006-07-01,18,0,-1,6,7,30
China,2006-07-01,45,0,-1,15,5,64
China,2006-07-01,45,6,0,10,3,64
China,2006-07-01,16,0,0,12,0,28
China,2006-07-01,16,0,0,12,7,35
China,2006-07-01,12,0,0,0,3,15
China,2006-07-01,20,0,0,4,0,24
China,2006-07-01,25,0,0,0,2,27
China,2006-07-01,15,2,0,3,22,42
China,2006-07-01,41,0,-1,18,0,58
China,2006-07-01,27,0,0,9,22,58
China,2006-07-01,18,0,0,-1,1,18
China,2006-07-01,20,2,-4,15,0,33
China,2006-07-01,22,0,0,5,0,27
China,2006-07-01,36,2,-7,-4,2,29
China,2006-07-01,28,2,0,18,0,48
China,2006-07-01,51,0,2,12,1,66
China,2006-07-01,33,0,1,16,2,52
China,2006-07-01,38,0,2,21,2,63
China,2006-07-01,25,2,-1,3,0,29
China,2006-07-01,26,0,1,9,1,37
China,2006-07-01,53,2,-2,7,7,67
China,2006-07-01,39,0,-2,2,1,40
China,2006-07-01,124,0,0,5,5,134
China,2006-07-01,59,0,0,10,8,77
China,2006-07-01,34,0,1,7,2,44
China,2006-07-01,-6,0,2,-7,0,-11
China,2006-07-01,16,0,0,21,7,44
China,2006-07-01,0,0,0,5,3,8
Egypt,2006-07-01,48,0,0,-19,0,29
Egypt,2006-07-01,39,0,1,6,2,48
Egypt,2006-07-01,30,0,0,6,0,36
Egypt,2006-07-01,17,0,0,-2,0,15
Egypt,2006-07-01,24,0,0,16,1,41
Egypt,2006-07-01,22,0,1,9,0,32
Egypt,2006-07-01,4,0,0,-1,0,3
Egypt,2006-07-01,2,0,0,0,0,2
Egypt,2006-07-01,5,0,0,-7,0,-2
Egypt,2006-07-01,-1,0,0,6,2,7
Egypt,2006-07-01,2,0,0,0,0,2
Egypt,2006-07-01,3,0,0,-10,1,-6
Egypt,2006-07-01,13,0,0,2,0,15
Egypt,2006-07-01,14,0,0,-4,6,16
Egypt,2006-07-01,56,0,0,6,11,73
Egypt,2006-07-01,-1,0,-2,0,0,-3
Egypt,2006-07-01,12,0,1,-2,0,11
Egypt,2006-07-01,10,0,0,0,1,11
Egypt,2006-07-01,25,0,0,0,0,25
Egypt,2006-07-01,19,2,0,10,0,31
Egypt,2006-07-01,1,0,0,3,14,18
Egypt,2006-07-01,0,0,0,0,0,0
Egypt,2006-07-01,8,0,0,0,2,10
Egypt,2006-07-01,7,0,0,3,0,10
Egypt,2006-07-01,0,0,0,-5,0,-5
Egypt,2006-07-01,5,0,1,3,0,9
Egypt,2006-07-01,10,0,0,3,1,14
Egypt,2006-07-01,0,0,0,-4,4,0
Egypt,2006-07-01,4,0,0,6,1,11
Egypt,2006-07-01,28,0,5,0,0,33
Egypt,2006-07-01,7,0,0,0,1,8
Eritrea,2006-07-01,0,0,0,0,2,2
Eritrea,2006-07-01,0,0,0,0,0,0
Eritrea,2006-07-01,0,0,0,3,0,3
Eritrea,2006-07-01,1,0,0,0,0,1
Eritrea,2006-07-01,2,0,0,0,0,2
Eritrea,2006-07-01,0,0,0,0,0,0
Eritrea,2006-07-01,0,0,0,0,0,0
Eritrea,2006-07-01,0,0,0,0,0,0
Eritrea,2006-07-01,0,0,0,0,0,0
Eritrea,2006-07-01,2,0,0,0,0,2
Eritrea,2006-07-01,5,0,0,0,0,5
Eritrea,2006-07-01,-3,0,0,0,0,-3
Eritrea,2006-07-01,6,0,0,0,0,6
Eritrea,2006-07-01,0,0,0,0,0,0
Eritrea,2006-07-01,-5,0,0,0,0,-5
Eritrea,2006-07-01,0,0,0,0,2,2
Eritrea,2006-07-01,14,0,0,0,0,14
Eritrea,2006-07-01,0,0,0,6,0,6
Eritrea,2006-07-01,0,0,0,0,0,0
Eritrea,2006-07-01,1,0,0,0,0,1
Eritrea,2006-07-01,-1,0,-4,0,0,-5
Eritrea,2006-07-01,14,0,0,0,0,14
Eritrea,2006-07-01,10,0,-6,0,0,4
Eritrea,2006-07-01,1,0,0,3,0,4
Eritrea,2006-07-01,26,0,0,3,3,32
Eritrea,2006-07-01,11,0,0,0,2,13
Eritrea,2006-07-01,4,0,0,0,0,4
Georgia,2006-07-01,6,0,0,0,0,6
Georgia,2006-07-01,0,0,0,3,0,3
Georgia,2006-07-01,6,0,0,0,1,7
Georgia,2006-07-01,2,0,0,1,0,3
Georgia,2006-07-01,3,0,0,18,0,21
Georgia,2006-07-01,3,0,0,3,0,6
Georgia,2006-07-01,0,0,0,0,0,0
Georgia,2006-07-01,0,0,0,0,0,0
Georgia,2006-07-01,0,0,0,0,0,0
Georgia,2006-07-01,-2,0,0,0,3,1
Georgia,2006-07-01,6,0,0,0,0,6
Georgia,2006-07-01,5,0,0,0,0,5
Georgia,2006-07-01,2,0,0,0,2,4
Georgia,2006-07-01,-3,0,0,0,0,-3
Georgia,2006-07-01,-1,0,0,0,1,0
Georgia,2006-07-01,2,0,0,-1,0,1
Georgia,2006-07-01,3,0,0,3,1,7
Georgia,2006-07-01,-1,0,0,0,0,-1
Georgia,2006-07-01,1,0,0,0,1,2
Georgia,2006-07-01,1,0,0,0,0,1
Georgia,2006-07-01,0,0,0,0,0,0
Georgia,2006-07-01,0,0,0,0,1,1
Georgia,2006-07-01,0,0,0,0,1,1
Georgia,2006-07-01,3,0,0,-1,0,2
Georgia,2006-07-01,0,0,0,12,0,12
Georgia,2006-07-01,0,0,0,9,0,9
Georgia,2006-07-01,0,0,0,0,0,0
Georgia,2006-07-01,0,0,0,0,0,0
Georgia,2006-07-01,2,0,0,0,0,2
India,2006-07-01,25,0,0,-2,2,25
India,2006-07-01,17,0,0,0,0,17
India,2006-07-01,36,2,0,13,1,52
India,2006-07-01,13,0,-2,-4,2,9
India,2006-07-01,5,0,0,0,2,7
India,2006-07-01,26,0,0,2,0,28
India,2006-07-01,0,2,0,0,0,2
India,2006-07-01,0,0,0,0,0,0
India,2006-07-01,2,0,0,1,0,3
India,2006-07-01,1,0,0,0,0,1
India,2006-07-01,9,0,-4,0,2,7
India,2006-07-01,2,0,-1,1,0,2
India,2006-07-01,15,0,0,1,2,18
India,2006-07-01,5,0,0,0,0,5
India,2006-07-01,25,0,0,1,0,26
India,2006-07-01,4,0,0,3,0,7
India,2006-07-01,21,0,0,0,0,21
India,2006-07-01,16,0,-1,9,0,24
India,2006-07-01,1,0,0,6,1,8
India,2006-07-01,16,0,0,0,0,16
India,2006-07-01,4,0,-2,0,1,3
India,2006-07-01,3,0,0,1,1,5
India,2006-07-01,8,0,0,0,3,11
India,2006-07-01,19,0,0,3,1,23
India,2006-07-01,5,0,-2,0,1,4
India,2006-07-01,11,0,0,-5,0,6
India,2006-07-01,5,0,1,-4,0,2
India,2006-07-01,7,0,1,0,4,12
India,2006-07-01,6,0,-1,6,0,11
India,2006-07-01,16,0,1,-6,1,12
India,2006-07-01,2,0,0,3,0,5
Iran,2006-07-01,14,0,0,0,1,15
Iran,2006-07-01,11,0,0,10,0,21
Iran,2006-07-01,14,0,0,0,2,16
Iran,2006-07-01,13,0,0,10,1,24
Iran,2006-07-01,12,0,0,7,1,20
Iran,2006-07-01,30,0,0,12,40,82
Iran,2006-07-01,30,0,0,3,22,55
Iran,2006-07-01,16,0,0,-1,9,24
Iran,2006-07-01,11,0,1,-3,0,9
Iran,2006-07-01,14,0,1,16,0,31
Iran,2006-07-01,8,0,0,18,1,27
Iran,2006-07-01,27,4,0,-2,4,33
Iran,2006-07-01,40,0,2,8,3,53
Iran,2006-07-01,55,0,0,3,0,58
Iran,2006-07-01,82,0,0,2,1,85
Iran,2006-07-01,57,0,0,-1,6,62
Iran,2006-07-01,36,0,-2,-5,22,51
Iran,2006-07-01,51,0,0,-5,16,62
Iran,2006-07-01,47,0,0,14,6,67
Iran,2006-07-01,56,0,0,5,11,72
Iran,2006-07-01,45,2,0,6,2,55
Iran,2006-07-01,22,2,0,3,18,45
Iran,2006-07-01,41,2,0,-2,9,50
Iran,2006-07-01,92,0,0,-2,2,92
Iran,2006-07-01,32,0,0,7,5,44
Iran,2006-07-01,36,0,0,0,0,36
Iran,2006-07-01,52,0,0,6,2,60
Iran,2006-07-01,48,0,0,0,4,52
Iran,2006-07-01,43,0,-1,0,6,48
Iran,2006-07-01,37,0,0,10,10,57
Iran,2006-07-01,113,0,1,12,1,127
Iraq,2006-07-01,70,0,0,-4,0,66
Iraq,2006-07-01,36,0,0,14,3,53
Iraq,2006-07-01,87,6,-3,7,9,106
Iraq,2006-07-01,74,4,0,18,8,104
Iraq,2006-07-01,32,0,-1,9,13,53
Iraq,2006-07-01,33,0,-1,27,14,73
Iraq,2006-07-01,10,4,0,21,8,43
Iraq,2006-07-01,28,0,0,22,0,50
Iraq,2006-07-01,43,0,0,19,12,74
Iraq,2006-07-01,35,0,-2,6,0,39
Iraq,2006-07-01,36,0,0,17,7,60
Iraq,2006-07-01,52,0,2,6,6,66
Iraq,2006-07-01,26,0,3,14,1,44
Iraq,2006-07-01,30,0,-3,2,2,31
Iraq,2006-07-01,41,0,0,5,1,47
Iraq,2006-07-01,26,0,0,15,11,52
Iraq,2006-07-01,70,0,0,-2,10,78
Iraq,2006-07-01,77,0,3,18,9,107
Iraq,2006-07-01,62,0,0,6,2,70
Iraq,2006-07-01,14,0,-2,-5,11,18
Iraq,2006-07-01,32,4,0,-5,6,37
Iraq,2006-07-01,37,0,0,3,1,41
Iraq,2006-07-01,27,0,0,4,9,40
Iraq,2006-07-01,67,0,1,4,6,78
Iraq,2006-07-01,54,0,2,15,6,77
Iraq,2006-07-01,60,0,-3,-1,23,79
Iraq,2006-07-01,65,0,-2,16,3,82
Iraq,2006-07-01,40,0,0,11,7,58
Iraq,2006-07-01,19,0,0,8,0,27
Iraq,2006-07-01,37,0,0,4,3,44
Iraq,2006-07-01,26,0,0,12,2,40
Morocco,2006-07-01,2,0,0,7,0,9
Morocco,2006-07-01,-2,0,0,0,0,-2
Morocco,2006-07-01,2,0,0,0,0,2
Morocco,2006-07-01,1,0,0,0,0,1
Morocco,2006-07-01,0,0,0,0,0,0
Morocco,2006-07-01,2,0,0,0,0,2
Morocco,2006-07-01,0,0,0,0,0,0
Morocco,2006-07-01,0,0,0,0,0,0
Morocco,2006-07-01,0,0,0,0,0,0
Morocco,2006-07-01,2,0,0,0,0,2
Morocco,2006-07-01,0,0,0,0,0,0
Morocco,2006-07-01,0,0,0,0,0,0
Morocco,2006-07-01,6,0,0,3,0,9
Morocco,2006-07-01,6,0,0,0,1,7
Morocco,2006-07-01,0,2,0,0,0,2
Morocco,2006-07-01,3,0,0,0,0,3
Morocco,2006-07-01,0,0,0,0,0,0
Morocco,2006-07-01,0,0,0,-2,0,-2
Morocco,2006-07-01,-1,0,0,0,0,-1
Morocco,2006-07-01,3,0,0,3,0,6
Morocco,2006-07-01,6,0,0,0,2,8
Morocco,2006-07-01,9,0,0,0,0,9
Morocco,2006-07-01,0,0,0,0,0,0
Morocco,2006-07-01,3,0,0,3,2,8
Morocco,2006-07-01,0,0,0,0,2,2
Morocco,2006-07-01,-1,0,0,0,0,-1
Morocco,2006-07-01,7,0,0,-2,0,5
Nigeria,2006-07-01,19,0,3,14,2,38
Nigeria,2006-07-01,0,0,-1,4,0,3
Nigeria,2006-07-01,16,0,1,1,1,19
Nigeria,2006-07-01,14,0,0,0,0,14
Nigeria,2006-07-01,20,0,-2,3,0,21
Nigeria,2006-07-01,8,0,0,15,0,23
Nigeria,2006-07-01,1,0,0,9,2,12
Nigeria,2006-07-01,1,0,0,4,0,5
Nigeria,2006-07-01,3,0,0,0,0,3
Nigeria,2006-07-01,5,0,0,0,3,8
Nigeria,2006-07-01,3,0,0,0,0,3
Nigeria,2006-07-01,11,0,0,6,1,18
Nigeria,2006-07-01,13,0,1,15,0,29
Nigeria,2006-07-01,2,0,0,6,0,8
Nigeria,2006-07-01,7,4,1,0,1,13
Nigeria,2006-07-01,1,0,0,0,0,1
Nigeria,2006-07-01,16,2,0,1,1,20
Nigeria,2006-07-01,1,0,0,21,4,26
Nigeria,2006-07-01,15,0,0,3,0,18
Nigeria,2006-07-01,22,0,0,6,3,31
Nigeria,2006-07-01,23,0,0,0,1,24
Nigeria,2006-07-01,18,0,0,0,1,19
Nigeria,2006-07-01,5,0,0,0,2,7
Nigeria,2006-07-01,14,0,1,-2,0,13
Nigeria,2006-07-01,15,0,0,0,3,18
Nigeria,2006-07-01,32,0,0,0,2,34
Nigeria,2006-07-01,29,0,1,19,1,50
Nigeria,2006-07-01,45,0,0,6,0,51
Nigeria,2006-07-01,20,0,0,0,0,20
Nigeria,2006-07-01,11,0,0,6,0,17
Nigeria,2006-07-01,20,0,-3,-3,1,15
Pakistan,2006-07-01,2,0,0,0,0,2
Pakistan,2006-07-01,11,0,0,1,0,12
Pakistan,2006-07-01,14,0,0,10,0,24
Pakistan,2006-07-01,28,0,0,-2,1,27
Pakistan,2006-07-01,9,0,0,3,0,12
Pakistan,2006-07-01,2,0,0,0,3,5
Pakistan,2006-07-01,0,0,0,9,1,10
Pakistan,2006-07-01,2,0,0,9,0,11
Pakistan,2006-07-01,5,0,0,9,0,14
Pakistan,2006-07-01,21,0,0,0,0,21
Pakistan,2006-07-01,38,0,0,0,16,54
Pakistan,2006-07-01,39,0,0,3,5,47
Pakistan,2006-07-01,78,0,0,4,10,92
Pakistan,2006-07-01,19,0,0,12,8,39
Pakistan,2006-07-01,38,0,0,3,0,41
Pakistan,2006-07-01,9,2,1,0,2,14
Pakistan,2006-07-01,33,0,0,18,0,51
Pakistan,2006-07-01,53,0,1,30,7,91
Pakistan,2006-07-01,41,0,0,12,2,55
Pakistan,2006-07-01,34,0,0,13,5,52
Pakistan,2006-07-01,23,0,0,21,2,46
Pakistan,2006-07-01,5,0,0,0,20,25
Pakistan,2006-07-01,8,0,0,16,2,26
Pakistan,2006-07-01,32,0,0,33,6,71
Pakistan,2006-07-01,34,0,0,3,6,43
Pakistan,2006-07-01,44,0,0,36,2,82
Pakistan,2006-07-01,26,0,0,12,2,40
Pakistan,2006-07-01,16,0,0,18,2,36
Pakistan,2006-07-01,14,0,0,10,3,27
Pakistan,2006-07-01,39,0,0,1,4,44
Pakistan,2006-07-01,51,0,0,9,1,61
Sierra Leone,2006-07-01,0,0,0,0,0,0
Sierra Leone,2006-07-01,2,0,0,0,0,2
Sierra Leone,2006-07-01,-1,0,0,0,-3,-4
Sierra Leone,2006-07-01,9,0,0,6,4,19
Sierra Leone,2006-07-01,0,0,0,6,2,8
Sierra Leone,2006-07-01,6,0,0,0,0,6
Sierra Leone,2006-07-01,0,0,0,0,0,0
Sierra Leone,2006-07-01,2,0,0,0,0,2
Sierra Leone,2006-07-01,6,0,0,0,3,9
Sierra Leone,2006-07-01,0,0,0,0,0,0
Sierra Leone,2006-07-01,0,0,0,0,2,2
Sierra Leone,2006-07-01,0,0,0,0,2,2
Sierra Leone,2006-07-01,0,0,0,0,0,0
Sierra Leone,2006-07-01,1,0,0,1,0,2
Sierra Leone,2006-07-01,9,0,0,6,0,15
Sierra Leone,2006-07-01,8,0,0,6,0,14
Sierra Leone,2006-07-01,2,0,0,0,2,4
Sierra Leone,2006-07-01,3,0,-2,18,0,19
Sierra Leone,2006-07-01,0,0,0,0,0,0
Sierra Leone,2006-07-01,3,0,0,6,0,9
Sierra Leone,2006-07-01,17,0,0,7,0,24
Sierra Leone,2006-07-01,3,0,0,0,1,4
Sierra Leone,2006-07-01,0,0,0,6,0,6
Sierra Leone,2006-07-01,-1,0,0,0,0,-1
Sierra Leone,2006-07-01,4,0,0,0,0,4
Somalia,2006-07-01,16,0,-1,-2,0,13
Somalia,2006-07-01,5,2,1,0,0,8
Somalia,2006-07-01,4,0,0,6,2,12
Somalia,2006-07-01,0,0,0,4,0,4
Somalia,2006-07-01,5,0,0,0,0,5
Somalia,2006-07-01,10,0,0,6,0,16
Somalia,2006-07-01,4,0,-2,0,0,2
Somalia,2006-07-01,5,0,0,0,0,5
Somalia,2006-07-01,-1,0,0,0,0,-1
Somalia,2006-07-01,11,0,1,6,1,19
Somalia,2006-07-01,-1,0,0,3,0,2
Somalia,2006-07-01,-4,0,0,0,0,-4
Somalia,2006-07-01,13,0,0,0,0,13
Somalia,2006-07-01,1,0,0,0,2,3
Somalia,2006-07-01,1,0,0,0,0,1
Somalia,2006-07-01,0,0,0,0,0,0
Somalia,2006-07-01,0,2,0,-19,0,-17
Somalia,2006-07-01,24,0,0,1,0,25
Somalia,2006-07-01,5,0,0,0,1,6
Somalia,2006-07-01,1,0,0,9,0,10
Somalia,2006-07-01,2,0,2,0,0,4
Somalia,2006-07-01,4,0,0,0,0,4
Somalia,2006-07-01,6,0,0,0,0,6
Somalia,2006-07-01,3,0,0,0,4,7
Somalia,2006-07-01,4,0,0,3,4,11
Somalia,2006-07-01,-3,0,0,0,5,2
Somalia,2006-07-01,1,0,-6,3,0,-2
Somalia,2006-07-01,8,0,0,12,1,21
Somalia,2006-07-01,16,0,-4,11,0,23
Somalia,2006-07-01,5,2,-8,1,2,2
Somalia,2006-07-01,-6,0,0,1,1,-4
Syria,2006-07-01,14,0,0,7,3,24
Syria,2006-07-01,10,0,0,5,1,16
Syria,2006-07-01,3,0,0,9,0,12
Syria,2006-07-01,16,0,0,3,0,19
Syria,2006-07-01,2,0,0,7,0,9
Syria,2006-07-01,18,0,0,7,2,27
Syria,2006-07-01,14,0,0,13,0,27
Syria,2006-07-01,3,0,0,0,0,3
Syria,2006-07-01,6,0,0,0,0,6
Syria,2006-07-01,0,0,0,0,1,1
Syria,2006-07-01,18,0,0,6,3,27
Syria,2006-07-01,28,0,0,9,0,37
Syria,2006-07-01,85,0,1,4,1,91
Syria,2006-07-01,47,0,0,6,5,58
Syria,2006-07-01,78,0,0,3,2,83
Syria,2006-07-01,58,0,0,0,0,58
Syria,2006-07-01,64,6,0,3,3,76
Syria,2006-07-01,62,0,0,4,10,76
Syria,2006-07-01,47,0,0,6,1,54
Syria,2006-07-01,75,4,0,5,5,89
Syria,2006-07-01,25,0,0,0,10,35
Syria,2006-07-01,21,0,0,0,4,25
Syria,2006-07-01,28,0,0,-2,0,26
Syria,2006-07-01,36,0,0,1,2,39
Syria,2006-07-01,50,0,0,5,3,58
Syria,2006-07-01,23,0,-1,-3,8,27
Syria,2006-07-01,31,2,0,0,1,34
Syria,2006-07-01,27,0,0,9,0,36
Syria,2006-07-01,39,0,0,-2,0,37
Syria,2006-07-01,33,0,-4,0,4,33
Syria,2006-07-01,68,0,0,15,5,88
Yemen,2006-07-01,1,0,0,0,0,1
Yemen,2006-07-01,2,0,0,0,0,2
Yemen,2006-07-01,2,0,0,3,4,9
Yemen,2006-07-01,2,0,0,3,0,5
Yemen,2006-07-01,0,0,0,0,0,0
Yemen,2006-07-01,6,0,0,0,0,6
Yemen,2006-07-01,1,0,0,3,0,4
Yemen,2006-07-01,-2,0,0,0,0,-2
Yemen,2006-07-01,0,0,0,3,0,3
Yemen,2006-07-01,0,0,0,3,0,3
Yemen,2006-07-01,2,0,0,3,0,5
Yemen,2006-07-01,0,0,0,0,0,0
Yemen,2006-07-01,0,0,0,12,0,12
Yemen,2006-07-01,-1,0,0,0,0,-1
Yemen,2006-07-01,5,0,0,0,0,5
Yemen,2006-07-01,0,0,0,0,0,0
Yemen,2006-07-01,0,0,0,0,0,0
Yemen,2006-07-01,0,0,0,0,0,0
Yemen,2006-07-01,0,0,0,0,0,0
Yemen,2006-07-01,0,0,0,0,0,0
Yemen,2006-07-01,0,0,0,0,0,0
Yemen,2006-07-01,0,0,0,6,0,6
Yemen,2006-07-01,3,0,0,0,0,3
Yemen,2006-07-01,1,0,0,0,0,1
Yemen,2006-07-01,-1,0,0,0,0,-1
Yemen,2006-07-01,0,0,0,0,0,0
Yemen,2006-07-01,0,0,0,0,0,0
Yemen,2006-07-01,0,0,0,0,0,0
Yemen,2006-07-01,2,0,0,0,0,2
Afghanistan,2011-09-01,253,0,1,29,10,293
Afghanistan,2011-09-01,197,0,-1,139,9,344
Afghanistan,2011-09-01,172,0,0,134,3,309
Afghanistan,2011-09-01,116,0,0,54,3,173
Afghanistan,2011-09-01,191,0,-2,72,19,280
Afghanistan,2011-09-01,196,4,0,47,27,274
Afghanistan,2011-09-01,256,4,0,113,58,431
Afghanistan,2011-09-01,361,2,2,100,25,490
Afghanistan,2011-09-01,418,12,-2,113,23,564
Afghanistan,2011-09-01,234,8,-1,67,9,317
Afghanistan,2011-09-01,515,2,0,60,103,680
Afghanistan,2011-09-01,308,0,2,14,45,369
Afghanistan,2011-09-01,204,2,1,37,8,252
Afghanistan,2011-09-01,178,8,2,30,20,238
Afghanistan,2011-09-01,248,2,2,36,46,334
Afghanistan,2011-09-01,183,0,1,28,20,232
Afghanistan,2011-09-01,165,0,0,8,14,187
Afghanistan,2011-09-01,205,0,0,-8,8,205
Afghanistan,2011-09-01,296,4,-7,46,47,386
Afghanistan,2011-09-01,252,8,-8,6,40,298
Afghanistan,2011-09-01,267,4,-2,23,23,315
Afghanistan,2011-09-01,339,0,2,75,27,443
Afghanistan,2011-09-01,335,0,-2,78,14,425
Afghanistan,2011-09-01,184,0,-3,55,14,250
Afghanistan,2011-09-01,89,8,0,3,14,114
Afghanistan,2011-09-01,173,2,0,25,11,211
Afghanistan,2011-09-01,171,0,0,1,20,192
Afghanistan,2011-09-01,203,2,-2,30,24,257
Afghanistan,2011-09-01,92,4,0,34,15,145
Afghanistan,2011-09-01,23,0,0,5,0,28
Albania,2011-09-01,16,0,-2,0,0,14
Albania,2011-09-01,21,0,-1,12,0,32
Albania,2011-09-01,15,0,-1,3,4,21
Albania,2011-09-01,10,0,-2,7,2,17
Albania,2011-09-01,13,0,-3,16,0,26
Albania,2011-09-01,10,0,-1,22,10,41
Albania,2011-09-01,14,0,-2,1,0,13
Albania,2011-09-01,22,0,-2,10,10,40
Albania,2011-09-01,21,0,-1,6,4,30
Albania,2011-09-01,17,0,-1,9,2,27
Albania,2011-09-01,3,0,-1,0,1,3
Albania,2011-09-01,28,0,-1,3,0,30
Albania,2011-09-01,21,0,-8,18,4,35
Albania,2011-09-01,39,0,-2,11,8,56
Albania,2011-09-01,74,0,-3,6,1,78
Albania,2011-09-01,56,0,-3,15,7,75
Albania,2011-09-01,13,0,0,15,14,42
Albania,2011-09-01,14,0,0,0,2,16
Albania,2011-09-01,6,0,0,9,0,15
Albania,2011-09-01,2,0,0,-2,3,3
Albania,2011-09-01,5,0,-1,9,4,17
Albania,2011-09-01,3,0,0,4,2,9
Albania,2011-09-01,4,0,-1,0,0,3
Albania,2011-09-01,5,0,0,0,2,7
Albania,2011-09-01,3,0,-4,0,0,-1
Albania,2011-09-01,6,0,0,12,3,21
Albania,2011-09-01,24,0,-1,24,13,60
Albania,2011-09-01,82,0,0,48,7,137
Albania,2011-09-01,10,0,0,-2,2,10
Albania,2011-09-01,4,0,0,0,0,4
Algeria,2011-09-01,127,0,3,-16,1,115
Algeria,2011-09-01,24,0,0,1,1,26
Algeria,2011-09-01,18,0,0,12,0,30
Algeria,2011-09-01,35,0,0,22,3,60
Algeria,2011-09-01,47,0,0,29,2,78
Algeria,2011-09-01,57,0,-2,13,0,68
Algeria,2011-09-01,48,0,-4,10,0,54
Algeria,2011-09-01,35,0,-4,9,9,49
Algeria,2011-09-01,5,0,-2,1,8,12
Algeria,2011-09-01,11,0,0,11,2,24
Algeria,2011-09-01,4,0,0,9,6,19
Algeria,2011-09-01,27,0,0,-5,2,24
Algeria,2011-09-01,51,0,-2,-10,1,40
Algeria,2011-09-01,45,0,-4,-2,9,48
Algeria,2011-09-01,5,0,0,1,2,8
Algeria,2011-09-01,17,0,-2,4,5,24
Algeria,2011-09-01,63,0,0,3,6,72
Algeria,2011-09-01,28,0,0,9,6,43
Algeria,2011-09-01,4,0,0,0,4,8
Algeria,2011-09-01,4,0,0,7,6,17
Algeria,2011-09-01,132,0,1,16,0,149
Algeria,2011-09-01,65,0,0,77,0,142
Algeria,2011-09-01,40,0,0,29,3,72
Algeria,2011-09-01,21,0,0,3,6,30
Algeria,2011-09-01,108,0,0,3,2,113
Algeria,2011-09-01,68,0,1,30,0,99
Algeria,2011-09-01,62,0,0,173,4,239
Algeria,2011-09-01,70,0,0,36,2,108
Algeria,2011-09-01,39,0,0,74,0,113
Algeria,2011-09-01,4,0,0,9,0,13
Bangladesh,2011-09-01,7,0,0,0,2,9
Bangladesh,2011-09-01,19,0,0,-2,5,22
Bangladesh,2011-09-01,26,0,0,-2,3,27
Bangladesh,2011-09-01,16,0,0,9,3,28
Bangladesh,2011-09-01,10,0,0,6,3,19
Bangladesh,2011-09-01,21,0,0,-3,0,18
Bangladesh,2011-09-01,40,0,0,16,10,66
Bangladesh,2011-09-01,20,0,0,12,7,39
Bangladesh,2011-09-01,22,0,1,-1,4,26
Bangladesh,2011-09-01,36,0,1,3,0,40
Bangladesh,2011-09-01,16,0,0,17,4,37
Bangladesh,2011-09-01,24,0,0,10,0,34
Bangladesh,2011-09-01,26,2,0,5,5,38
Bangladesh,2011-09-01,27,0,0,4,3,34
Bangladesh,2011-09-01,1,0,0,5,2,8
Bangladesh,2011-09-01,21,0,2,3,2,28
Bangladesh,2011-09-01,31,0,-1,15,10,55
Bangladesh,2011-09-01,23,2,1,-4,7,29
Bangladesh,2011-09-01,14,2,0,-2,1,15
Bangladesh,2011-09-01,10,2,0,18,0,30
Bangladesh,2011-09-01,24,0,0,-2,1,23
Bangladesh,2011-09-01,25,0,0,-1,2,26
Bangladesh,2011-09-01,20,0,0,18,1,39
Bangladesh,2011-09-01,23,0,-4,6,3,28
Bangladesh,2011-09-01,15,0,0,12,1,28
Bangladesh,2011-09-01,41,2,-4,28,4,71
Bangladesh,2011-09-01,12,0,0,9,2,23
Bangladesh,2011-09-01,10,10,1,3,6,30
Bangladesh,2011-09-01,16,0,0,8,5,29
Bangladesh,2011-09-01,5,0,0,0,10,15
Cameroon,2011-09-01,4,0,0,-2,0,2
Cameroon,2011-09-01,3,0,0,0,0,3
Cameroon,2011-09-01,2,0,0,6,4,12
Cameroon,2011-09-01,6,0,-4,0,0,2
Cameroon,2011-09-01,2,0,0,0,0,2
Cameroon,2011-09-01,4,0,0,0,0,4
Cameroon,2011-09-01,4,0,0,0,0,4
Cameroon,2011-09-01,4,0,0,0,0,4
Cameroon,2011-09-01,1,0,0,21,0,22
Cameroon,2011-09-01,11,0,0,0,0,11
Cameroon,2011-09-01,5,0,0,0,0,5
Cameroon,2011-09-01,14,0,0,0,0,14
Cameroon,2011-09-01,1,0,0,0,0,1
Cameroon,2011-09-01,0,0,0,3,0,3
Cameroon,2011-09-01,2,0,0,-2,0,0
Cameroon,2011-09-01,0,0,0,0,0,0
Cameroon,2011-09-01,4,0,0,-2,0,2
Cameroon,2011-09-01,0,0,0,0,0,0
Cameroon,2011-09-01,0,0,0,0,0,0
Cameroon,2011-09-01,0,0,0,0,0,0
Cameroon,2011-09-01,0,0,0,-6,0,-6
Cameroon,2011-09-01,0,0,0,3,0,3
Cameroon,2011-09-01,2,0,0,3,0,5
Cameroon,2011-09-01,0,0,0,3,0,3
Cameroon,2011-09-01,-1,0,0,0,0,-1
Cameroon,2011-09-01,0,0,0,0,0,0
Cameroon,2011-09-01,6,0,0,0,0,6
China,2011-09-01,195,4,-2,59,40,296
China,2011-09-01,123,4,-4,32,27,182
China,2011-09-01,83,0,-4,16,20,115
China,2011-09-01,116,0,-3,61,14,188
China,2011-09-01,175,2,-3,84,26,284
China,2011-09-01,220,0,0,143,21,384
China,2011-09-01,207,2,0,135,31,375
China,2011-09-01,201,6,-3,43,24,271
China,2011-09-01,110,0,1,126,19,256
China,2011-09-01,97,0,0,19,8,124
China,2011-09-01,118,0,-1,26,9,152
China,2011-09-01,203,6,-3,28,26,260
China,2011-09-01,157,2,-2,58,22,237
China,2011-09-01,116,8,-2,34,12,168
China,2011-09-01,176,2,6,32,12,228
China,2011-09-01,142,0,-2,31,17,188
China,2011-09-01,65,0,2,10,24,101
China,2011-09-01,125,4,0,53,5,187
China,2011-09-01,236,12,-1,81,18,346
China,2011-09-01,181,10,-1,22,22,234
China,2011-09-01,153,8,1,72,11,245
China,2011-09-01,191,16,-1,36,28,270
China,2011-09-01,148,6,-5,-4,19,164
China,2011-09-01,101,4,-2,0,4,107
China,2011-09-01,85,0,0,2,8,95
China,2011-09-01,173,2,-4,52,34,257
China,2011-09-01,146,2,1,71,20,240
China,2011-09-01,176,0,1,68,18,263
China,2011-09-01,44,0,2,80,2,128
China,2011-09-01,6,0,-2,0,1,5
Egypt,2011-09-01,29,0,0,30,7,66
Egypt,2011-09-01,27,0,0,34,4,65
Egypt,2011-09-01,22,0,0,23,10,55
Egypt,2011-09-01,32,0,0,60,12,104
Egypt,2011-09-01,90,0,2,74,27,193
Egypt,2011-09-01,90,0,0,34,18,142
Egypt,2011-09-01,69,2,-2,95,30,194
Egypt,2011-09-01,86,4,-2,60,29,177
Egypt,2011-09-01,55,4,1,42,13,115
Egypt,2011-09-01,110,0,-1,29,24,162
Egypt,2011-09-01,59,2,-4,55,5,117
Egypt,2011-09-01,64,0,-1,30,14,107
Egypt,2011-09-01,152,0,-8,40,18,202
Egypt,2011-09-01,51,0,-4,34,11,92
Egypt,2011-09-01,109,0,0,111,14,234
Egypt,2011-09-01,96,0,0,27,9,132
Egypt,2011-09-01,32,0,-4,17,7,52
Egypt,2011-09-01,49,8,-1,30,3,89
Egypt,2011-09-01,50,2,0,39,15,106
Egypt,2011-09-01,78,0,-1,49,18,144
Egypt,2011-09-01,49,0,-1,16,23,87
Egypt,2011-09-01,45,0,0,-4,21,62
Egypt,2011-09-01,91,0,5,13,21,130
Egypt,2011-09-01,71,0,1,21,8,101
Egypt,2011-09-01,103,0,-3,45,12,157
Egypt,2011-09-01,52,0,2,27,23,104
Egypt,2011-09-01,74,2,0,15,22,113
Egypt,2011-09-01,76,0,-3,75,10,158
Egypt,2011-09-01,47,0,1,52,8,108
Egypt,2011-09-01,0,0,0,0,0,0
Eritrea,2011-09-01,2,0,0,3,0,5
Eritrea,2011-09-01,0,0,0,0,0,0
Eritrea,2011-09-01,4,0,0,0,0,4
Eritrea,2011-09-01,6,0,2,3,0,11
Eritrea,2011-09-01,7,0,0,-2,2,7
Eritrea,2011-09-01,2,0,0,1,0,3
Eritrea,2011-09-01,0,0,0,0,0,0
Eritrea,2011-09-01,1,0,0,0,0,1
Eritrea,2011-09-01,0,0,0,0,0,0
Eritrea,2011-09-01,5,0,0,0,0,5
Eritrea,2011-09-01,0,0,0,-3,0,-3
Eritrea,2011-09-01,0,0,0,3,0,3
Eritrea,2011-09-01,4,0,0,6,0,10
Eritrea,2011-09-01,8,0,1,-1,0,8
Eritrea,2011-09-01,10,0,1,-2,0,9
Eritrea,2011-09-01,19,0,0,-1,1,19
Eritrea,2011-09-01,5,0,0,0,1,6
Eritrea,2011-09-01,0,0,0,0,0,0
Eritrea,2011-09-01,6,0,0,0,0,6
Eritrea,2011-09-01,13,0,0,-4,4,13
Eritrea,2011-09-01,13,0,0,7,0,20
Eritrea,2011-09-01,8,0,0,24,0,32
Eritrea,2011-09-01,2,0,3,0,4,9
Eritrea,2011-09-01,3,0,2,3,0,8
Eritrea,2011-09-01,0,0,0,15,0,15
Eritrea,2011-09-01,2,0,0,13,0,15
Eritrea,2011-09-01,1,0,0,-2,0,-1
Georgia,2011-09-01,19,0,-12,28,3,38
Georgia,2011-09-01,8,0,0,9,2,19
Georgia,2011-09-01,7,2,0,15,0,24
Georgia,2011-09-01,19,0,1,3,1,24
Georgia,2011-09-01,12,0,0,6,3,21
Georgia,2011-09-01,47,0,-2,9,3,57
Georgia,2011-09-01,21,6,0,13,1,41
Georgia,2011-09-01,10,4,0,16,3,33
Georgia,2011-09-01,15,4,0,6,0,25
Georgia,2011-09-01,12,4,0,1,0,17
Georgia,2011-09-01,22,0,0,1,0,23
Georgia,2011-09-01,11,0,1,15,6,33
Georgia,2011-09-01,48,0,0,27,6,81
Georgia,2011-09-01,41,0,0,13,7,61
Georgia,2011-09-01,14,0,0,0,1,15
Georgia,2011-09-01,55,0,0,44,3,102
Georgia,2011-09-01,43,0,0,28,4,75
Georgia,2011-09-01,39,2,0,18,4,63
Georgia,2011-09-01,34,2,1,52,16,105
Georgia,2011-09-01,97,0,2,64,12,175
Georgia,2011-09-01,28,0,1,12,8,49
Georgia,2011-09-01,147,6,15,46,7,221
Georgia,2011-09-01,60,2,0,45,8,115
Georgia,2011-09-01,43,0,0,9,9,61
Georgia,2011-09-01,20,0,0,24,5,49
Georgia,2011-09-01,29,0,1,31,8,69
Georgia,2011-09-01,19,0,0,33,3,55
Georgia,2011-09-01,35,0,-1,19,6,59
Georgia,2011-09-01,27,0,-5,22,5,49
India,2011-09-01,58,0,0,18,10,86
India,2011-09-01,28,0,-2,9,7,42
India,2011-09-01,29,0,0,-4,7,32
India,2011-09-01,32,0,1,12,7,52
India,2011-09-01,78,0,-3,17,10,102
India,2011-09-01,69,2,-3,20,3,91
India,2011-09-01,64,2,1,-10,6,63
India,2011-09-01,83,2,-1,27,9,120
India,2011-09-01,49,0,-7,34,4,80
India,2011-09-01,59,0,1,3,0,63
India,2011-09-01,58,0,-2,12,2,70
India,2011-09-01,74,0,0,10,1,85
India,2011-09-01,61,0,0,10,15,86
India,2011-09-01,78,2,0,32,5,117
India,2011-09-01,70,0,-2,18,7,93
India,2011-09-01,61,2,-2,26,11,98
India,2011-09-01,56,0,0,3,2,61
India,2011-09-01,50,0,0,6,11,67
India,2011-09-01,44,2,0,25,11,82
India,2011-09-01,60,0,-1,-2,12,69
India,2011-09-01,47,2,0,4,4,57
India,2011-09-01,52,4,-1,10,13,78
India,2011-09-01,87,2,0,16,3,108
India,2011-09-01,68,6,0,0,4,78
India,2011-09-01,45,2,2,10,3,62
India,2011-09-01,46,4,-2,13,19,80
India,2011-09-01,73,4,0,1,3,81
India,2011-09-01,40,2,0,4,5,51
India,2011-09-01,14,0,-2,-4,2,10
India,2011-09-01,0,0,0,0,0,0
Iran,2011-09-01,57,0,0,5,5,67
Iran,2011-09-01,64,0,7,21,4,96
Iran,2011-09-01,37,0,6,19,6,68
Iran,2011-09-01,35,0,0,7,7,49
Iran,2011-09-01,78,0,-3,77,9,161
Iran,2011-09-01,32,0,9,32,13,86
Iran,2011-09-01,103,0,1,-2,4,106
Iran,2011-09-01,73,0,3,25,10,111
Iran,2011-09-01,127,0,-3,4,12,140
Iran,2011-09-01,78,4,-6,13,7,96
Iran,2011-09-01,93,0,-7,8,6,100
Iran,2011-09-01,101,0,1,63,8,173
Iran,2011-09-01,85,0,1,28,16,130
Iran,2011-09-01,132,0,1,-9,11,135
Iran,2011-09-01,63,0,1,31,7,102
Iran,2011-09-01,103,0,0,36,0,139
Iran,2011-09-01,66,0,0,18,8,92
Iran,2011-09-01,65,0,1,-29,6,43
Iran,2011-09-01,112,0,1,22,9,144
Iran,2011-09-01,154,2,0,30,12,198
Iran,2011-09-01,161,0,-2,13,3,175
Iran,2011-09-01,214,0,-8,61,38,305
Iran,2011-09-01,106,0,2,50,5,163
Iran,2011-09-01,55,0,-1,16,5,75
Iran,2011-09-01,76,0,0,56,4,136
Iran,2011-09-01,93,6,3,45,7,154
Iran,2011-09-01,61,0,2,21,9,93
Iran,2011-09-01,130,2,2,76,21,231
Iran,2011-09-01,68,0,0,124,8,200
Iran,2011-09-01,4,0,0,5,2,11
Iraq,2011-09-01,176,4,0,36,18,234
Iraq,2011-09-01,179,0,0,21,12,212
Iraq,2011-09-01,107,0,1,38,11,157
Iraq,2011-09-01,191,0,0,15,6,212
Iraq,2011-09-01,139,2,-2,27,5,171
Iraq,2011-09-01,144,8,-8,27,14,185
Iraq,2011-09-01,213,6,0,26,21,266
Iraq,2011-09-01,251,2,11,119,31,414
Iraq,2011-09-01,239,0,-5,110,87,431
Iraq,2011-09-01,284,4,-1,30,53,370
Iraq,2011-09-01,495,4,-18,93,14,588
Iraq,2011-09-01,277,2,-10,-1,28,296
Iraq,2011-09-01,262,8,0,74,17,361
Iraq,2011-09-01,139,0,-4,23,15,173
Iraq,2011-09-01,215,2,-6,57,23,291
Iraq,2011-09-01,215,2,-2,52,21,288
Iraq,2011-09-01,38,2,0,-25,12,27
Iraq,2011-09-01,119,0,0,-14,15,120
Iraq,2011-09-01,97,0,-2,30,20,145
Iraq,2011-09-01,209,0,-2,32,15,254
Iraq,2011-09-01,192,0,-10,48,17,247
Iraq,2011-09-01,130,0,-3,48,9,184
Iraq,2011-09-01,182,0,0,41,6,229
Iraq,2011-09-01,109,0,-5,45,6,155
Iraq,2011-09-01,82,0,1,50,6,139
Iraq,2011-09-01,115,0,-5,24,12,146
Iraq,2011-09-01,126,0,1,5,5,137
Iraq,2011-09-01,72,0,0,63,4,139
Iraq,2011-09-01,67,0,0,59,5,131
Iraq,2011-09-01,-1,0,0,0,0,-1
Morocco,2011-09-01,0,0,0,31,2,33
Morocco,2011-09-01,5,0,1,22,5,33
Morocco,2011-09-01,0,0,1,6,0,7
Morocco,2011-09-01,3,0,0,3,0,6
Morocco,2011-09-01,10,0,0,9,0,19
Morocco,2011-09-01,0,0,0,0,0,0
Morocco,2011-09-01,8,0,0,0,1,9
Morocco,2011-09-01,2,0,-2,4,0,4
Morocco,2011-09-01,6,0,0,5,0,11
Morocco,2011-09-01,13,0,0,4,0,17
Morocco,2011-09-01,9,0,0,6,3,18
Morocco,2011-09-01,2,0,0,0,1,3
Morocco,2011-09-01,6,0,0,6,2,14
Morocco,2011-09-01,16,0,0,9,0,25
Morocco,2011-09-01,6,0,-2,6,0,10
Morocco,2011-09-01,9,0,0,3,0,12
Morocco,2011-09-01,1,0,0,0,3,4
Morocco,2011-09-01,9,0,-1,2,3,13
Morocco,2011-09-01,11,0,0,0,8,19
Morocco,2011-09-01,12,0,0,0,0,12
Morocco,2011-09-01,10,0,-1,0,7,16
Morocco,2011-09-01,35,0,0,6,0,41
Morocco,2011-09-01,2,0,0,0,0,2
Morocco,2011-09-01,0,0,0,0,0,0
Morocco,2011-09-01,4,0,2,0,0,6
Morocco,2011-09-01,15,0,0,6,0,21
Morocco,2011-09-01,6,0,0,14,2,22
Morocco,2011-09-01,1,0,0,18,0,19
Morocco,2011-09-01,-1,0,0,0,0,-1
Morocco,2011-09-01,0,0,0,0,0,0
Nigeria,2011-09-01,16,0,0,8,6,30
Nigeria,2011-09-01,61,0,0,-4,7,64
Nigeria,2011-09-01,77,0,0,10,10,97
Nigeria,2011-09-01,27,0,2,31,13,73
Nigeria,2011-09-01,69,0,0,15,8,92
Nigeria,2011-09-01,48,0,0,15,3,66
Nigeria,2011-09-01,43,0,3,25,8,79
Nigeria,2011-09-01,46,0,4,25,2,77
Nigeria,2011-09-01,68,0,0,10,2,80
Nigeria,2011-09-01,50,0,0,9,6,65
Nigeria,2011-09-01,84,0,0,12,9,105
Nigeria,2011-09-01,47,2,0,24,12,85
Nigeria,2011-09-01,25,0,0,22,1,48
Nigeria,2011-09-01,44,0,0,8,3,55
Nigeria,2011-09-01,33,0,1,32,1,67
Nigeria,2011-09-01,15,0,0,6,1,22
Nigeria,2011-09-01,41,0,0,37,2,80
Nigeria,2011-09-01,14,0,0,6,2,22
Nigeria,2011-09-01,14,0,-4,11,4,25
Nigeria,2011-09-01,22,0,-3,16,4,39
Nigeria,2011-09-01,21,0,1,32,9,63
Nigeria,2011-09-01,46,0,0,21,9,76
Nigeria,2011-09-01,13,0,0,7,12,32
Nigeria,2011-09-01,18,0,0,28,24,70
Nigeria,2011-09-01,24,0,-3,20,7,48
Nigeria,2011-09-01,60,0,0,11,2,73
Nigeria,2011-09-01,41,0,0,9,4,54
Nigeria,2011-09-01,37,0,0,36,4,77
Nigeria,2011-09-01,3,0,0,-3,2,2
Nigeria,2011-09-01,3,0,0,0,0,3
Pakistan,2011-09-01,134,0,1,20,3,158
Pakistan,2011-09-01,150,0,-4,89,8,243
Pakistan,2011-09-01,52,0,0,71,9,132
Pakistan,2011-09-01,46,0,0,61,13,120
Pakistan,2011-09-01,109,4,0,74,9,196
Pakistan,2011-09-01,121,0,-2,103,19,241
Pakistan,2011-09-01,398,0,0,101,133,632
Pakistan,2011-09-01,175,2,-1,58,9,243
Pakistan,2011-09-01,283,0,-1,52,9,343
Pakistan,2011-09-01,159,2,1,22,20,204
Pakistan,2011-09-01,270,10,3,82,25,390
Pakistan,2011-09-01,124,10,2,34,6,176
Pakistan,2011-09-01,104,4,0,11,8,127
Pakistan,2011-09-01,151,2,-1,52,0,204
Pakistan,2011-09-01,147,2,0,40,22,211
Pakistan,2011-09-01,176,2,-2,-10,9,175
Pakistan,2011-09-01,72,2,0,4,4,82
Pakistan,2011-09-01,112,6,0,17,5,140
Pakistan,2011-09-01,93,12,4,27,10,146
Pakistan,2011-09-01,207,2,-2,23,33,263
Pakistan,2011-09-01,108,0,-3,25,11,141
Pakistan,2011-09-01,151,14,-10,19,4,178
Pakistan,2011-09-01,202,2,-2,17,12,231
Pakistan,2011-09-01,91,0,-6,0,13,98
Pakistan,2011-09-01,210,0,0,53,12,275
Pakistan,2011-09-01,218,4,-2,54,16,290
Pakistan,2011-09-01,148,0,-5,66,40,249
Pakistan,2011-09-01,154,2,0,40,9,205
Pakistan,2011-09-01,91,0,0,31,7,129
Pakistan,2011-09-01,30,0,0,0,2,32
Sierra Leone,2011-09-01,4,0,0,0,2,6
Sierra Leone,2011-09-01,14,0,0,0,0,14
Sierra Leone,2011-09-01,10,0,0,-2,0,8
Sierra Leone,2011-09-01,2,0,0,0,0,2
Sierra Leone,2011-09-01,-6,0,0,6,0,0
Sierra Leone,2011-09-01,11,0,0,3,0,14
Sierra Leone,2011-09-01,3,0,0,6,3,12
Sierra Leone,2011-09-01,5,0,0,0,2,7
Sierra Leone,2011-09-01,2,0,1,3,4,10
Sierra Leone,2011-09-01,2,0,0,0,0,2
Sierra Leone,2011-09-01,1,0,0,-1,0,0
Sierra Leone,2011-09-01,15,0,0,0,1,16
Sierra Leone,2011-09-01,1,0,0,-6,0,-5
Sierra Leone,2011-09-01,8,0,0,0,0,8
Sierra Leone,2011-09-01,2,0,0,0,0,2
Sierra Leone,2011-09-01,7,0,0,-4,0,3
Sierra Leone,2011-09-01,0,0,0,1,0,1
Sierra Leone,2011-09-01,21,0,0,3,0,24
Sierra Leone,2011-09-01,3,0,0,0,0,3
Sierra Leone,2011-09-01,4,0,0,6,6,16
Sierra Leone,2011-09-01,0,0,0,0,2,2
Sierra Leone,2011-09-01,3,0,0,3,0,6
Sierra Leone,2011-09-01,2,0,0,0,2,4
Sierra Leone,2011-09-01,2,2,0,3,0,7
Sierra Leone,2011-09-01,6,0,0,0,0,6
Sierra Leone,2011-09-01,16,0,0,3,0,19
Sierra Leone,2011-09-01,3,0,0,0,0,3
Sierra Leone,2011-09-01,7,0,-2,9,0,14
Sierra Leone,2011-09-01,3,0,0,0,0,3
Somalia,2011-09-01,17,0,0,11,0,28
Somalia,2011-09-01,11,4,-1,4,2,20
Somalia,2011-09-01,40,0,0,7,0,47
Somalia,2011-09-01,55,8,0,0,0,63
Somalia,2011-09-01,71,0,0,35,0,106
Somalia,2011-09-01,37,0,0,14,3,54
Somalia,2011-09-01,49,0,-6,11,10,64
Somalia,2011-09-01,64,0,-1,70,6,139
Somalia,2011-09-01,88,14,-1,26,7,134
Somalia,2011-09-01,46,0,0,33,0,79
Somalia,2011-09-01,163,0,0,112,9,284
Somalia,2011-09-01,167,0,0,76,11,254
Somalia,2011-09-01,74,2,0,83,4,163
Somalia,2011-09-01,84,0,1,23,1,109
Somalia,2011-09-01,52,0,0,-1,1,52
Somalia,2011-09-01,46,0,0,13,11,70
Somalia,2011-09-01,80,0,0,36,3,119
Somalia,2011-09-01,91,0,2,34,6,133
Somalia,2011-09-01,66,0,1,58,1,126
Somalia,2011-09-01,37,4,0,18,6,65
Somalia,2011-09-01,48,0,2,54,7,111
Somalia,2011-09-01,48,2,0,27,1,78
Somalia,2011-09-01,51,2,0,19,4,76
Somalia,2011-09-01,28,4,0,-1,4,35
Somalia,2011-09-01,29,2,0,-1,1,31
Somalia,2011-09-01,15,0,0,17,8,40
Somalia,2011-09-01,38,0,0,4,8,50
Somalia,2011-09-01,19,0,0,-19,1,1
Somalia,2011-09-01,31,0,0,24,0,55
Somalia,2011-09-01,3,0,0,0,0,3
Syria,2011-09-01,209,0,-16,72,37,302
Syria,2011-09-01,103,0,-1,32,29,163
Syria,2011-09-01,84,0,-2,5,10,97
Syria,2011-09-01,198,0,-2,1,28,225
Syria,2011-09-01,129,0,0,27,25,181
Syria,2011-09-01,126,0,2,21,28,177
Syria,2011-09-01,138,0,-20,62,17,197
Syria,2011-09-01,174,14,1,32,26,247
Syria,2011-09-01,248,4,-2,22,26,298
Syria,2011-09-01,109,2,0,31,8,150
Syria,2011-09-01,79,0,-4,23,8,106
Syria,2011-09-01,240,14,-4,24,8,282
Syria,2011-09-01,128,2,0,17,27,174
Syria,2011-09-01,137,4,-2,33,20,192
Syria,2011-09-01,176,0,-5,24,22,217
Syria,2011-09-01,144,2,-4,16,14,172
Syria,2011-09-01,102,0,-6,-1,14,109
Syria,2011-09-01,66,0,0,16,17,99
Syria,2011-09-01,85,0,0,21,19,125
Syria,2011-09-01,163,8,-9,6,5,173
Syria,2011-09-01,116,0,-7,38,14,161
Syria,2011-09-01,43,0,0,23,25,91
Syria,2011-09-01,71,0,-8,56,8,127
Syria,2011-09-01,122,0,0,45,8,175
Syria,2011-09-01,56,0,-4,4,13,69
Syria,2011-09-01,93,0,-7,35,15,136
Syria,2011-09-01,158,2,-9,42,11,204
Syria,2011-09-01,170,0,-11,38,12,209
Syria,2011-09-01,65,0,-5,9,9,78
Syria,2011-09-01,47,0,1,0,4,52
Yemen,2011-09-01,21,0,0,-2,3,22
Yemen,2011-09-01,18,0,-2,6,6,28
Yemen,2011-09-01,15,0,-4,5,4,20
Yemen,2011-09-01,30,0,0,4,5,39
Yemen,2011-09-01,69,0,-4,3,7,75
Yemen,2011-09-01,17,0,-4,4,0,17
Yemen,2011-09-01,42,0,-3,7,13,59
Yemen,2011-09-01,17,0,-2,15,7,37
Yemen,2011-09-01,38,0,0,3,1,42
Yemen,2011-09-01,15,0,0,28,2,45
Yemen,2011-09-01,54,2,0,8,1,65
Yemen,2011-09-01,16,0,0,0,9,25
Yemen,2011-09-01,20,0,-2,17,5,40
Yemen,2011-09-01,32,0,0,7,2,41
Yemen,2011-09-01,29,0,-4,0,11,36
Yemen,2011-09-01,41,0,-2,5,4,48
Yemen,2011-09-01,72,0,2,0,9,83
Yemen,2011-09-01,60,0,0,0,9,69
Yemen,2011-09-01,97,0,-4,1,8,102
Yemen,2011-09-01,95,0,0,12,11,118
Yemen,2011-09-01,45,0,1,0,7,53
Yemen,2011-09-01,50,0,0,-1,6,55
Yemen,2011-09-01,81,0,-2,6,25,110
Yemen,2011-09-01,53,0,2,3,11,69
Yemen,2011-09-01,49,0,-5,0,13,57
Yemen,2011-09-01,68,0,1,4,6,79
Yemen,2011-09-01,20,0,-3,6,13,36
Yemen,2011-09-01,67,0,-2,32,17,114
Yemen,2011-09-01,43,0,0,6,2,51
Yemen,2011-09-01,64,0,-2,-2,6,66
Afghanistan,2011-08-01,160,0,-3,0,18,175
Afghanistan,2011-08-01,240,0,0,15,15,270
Afghanistan,2011-08-01,247,2,-2,56,41,344
Afghanistan,2011-08-01,223,2,-4,3,13,237
Afghanistan,2011-08-01,331,2,0,58,21,412
Afghanistan,2011-08-01,645,0,-1,76,16,736
Afghanistan,2011-08-01,724,4,0,30,26,784
Afghanistan,2011-08-01,798,10,1,16,10,835
Afghanistan,2011-08-01,727,2,-1,11,7,746
Afghanistan,2011-08-01,809,0,3,26,32,870
Afghanistan,2011-08-01,811,4,0,9,38,862
Afghanistan,2011-08-01,309,0,-4,8,19,332
Afghanistan,2011-08-01,141,4,0,34,12,191
Afghanistan,2011-08-01,325,0,3,39,33,400
Afghanistan,2011-08-01,288,0,-4,32,37,353
Afghanistan,2011-08-01,396,0,1,13,28,438
Afghanistan,2011-08-01,249,8,-4,27,10,290
Afghanistan,2011-08-01,259,0,-4,1,23,279
Afghanistan,2011-08-01,283,6,0,29,36,354
Afghanistan,2011-08-01,200,0,1,90,44,335
Afghanistan,2011-08-01,180,2,0,37,15,234
Afghanistan,2011-08-01,224,0,0,11,21,256
Afghanistan,2011-08-01,117,0,-4,32,8,153
Afghanistan,2011-08-01,210,2,0,-9,13,216
Afghanistan,2011-08-01,222,0,0,36,8,266
Afghanistan,2011-08-01,182,0,0,5,12,199
Afghanistan,2011-08-01,306,2,1,19,17,345
Afghanistan,2011-08-01,224,0,0,27,11,262
Afghanistan,2011-08-01,226,0,0,31,21,278
Afghanistan,2011-08-01,172,0,-4,26,14,208
Afghanistan,2011-08-01,200,4,7,47,29,287
Albania,2011-08-01,29,0,0,6,1,36
Albania,2011-08-01,30,0,0,-2,3,31
Albania,2011-08-01,5,0,0,13,7,25
Albania,2011-08-01,5,0,0,0,2,7
Albania,2011-08-01,1,0,0,-4,3,0
Albania,2011-08-01,4,0,0,0,0,4
Albania,2011-08-01,1,0,0,0,0,1
Albania,2011-08-01,14,0,1,19,1,35
Albania,2011-08-01,10,0,0,0,9,19
Albania,2011-08-01,15,0,0,6,6,27
Albania,2011-08-01,2,0,0,0,6,8
Albania,2011-08-01,11,0,0,0,0,11
Albania,2011-08-01,1,0,0,0,0,1
Albania,2011-08-01,0,0,-1,0,0,-1
Albania,2011-08-01,1,0,0,0,2,3
Albania,2011-08-01,1,0,0,9,4,14
Albania,2011-08-01,6,0,-2,10,0,14
Albania,2011-08-01,35,0,0,29,2,66
Albania,2011-08-01,3,0,-1,2,2,6
Albania,2011-08-01,6,0,0,0,6,12
Albania,2011-08-01,0,0,0,-2,0,-2
Albania,2011-08-01,3,0,0,3,2,8
Albania,2011-08-01,10,0,0,3,11,24
Albania,2011-08-01,8,0,0,0,4,12
Albania,2011-08-01,5,0,-2,0,7,10
Albania,2011-08-01,4,0,0,0,4,8
Albania,2011-08-01,8,0,0,-2,2,8
Albania,2011-08-01,0,0,0,6,0,6
Albania,2011-08-01,34,0,-5,0,9,38
Albania,2011-08-01,25,0,-1,4,6,34
Albania,2011-08-01,44,0,-1,6,0,49
Algeria,2011-08-01,8,0,1,3,1,13
Algeria,2011-08-01,2,0,0,0,0,2
Algeria,2011-08-01,3,0,0,0,0,3
Algeria,2011-08-01,9,0,-2,0,0,7
Algeria,2011-08-01,2,0,0,0,0,2
Algeria,2011-08-01,-1,0,0,0,0,-1
Algeria,2011-08-01,3,0,0,0,0,3
Algeria,2011-08-01,9,0,0,0,0,9
Algeria,2011-08-01,0,0,0,0,0,0
Algeria,2011-08-01,-2,0,0,3,2,3
Algeria,2011-08-01,4,0,0,4,0,8
Algeria,2011-08-01,2,0,0,-2,0,0
Algeria,2011-08-01,0,0,0,1,0,1
Algeria,2011-08-01,7,0,0,3,2,12
Algeria,2011-08-01,9,0,0,1,4,14
Algeria,2011-08-01,2,0,0,0,0,2
Algeria,2011-08-01,13,0,0,0,0,13
Algeria,2011-08-01,21,0,0,3,7,31
Algeria,2011-08-01,-1,0,0,0,0,-1
Algeria,2011-08-01,29,0,0,21,0,50
Algeria,2011-08-01,5,0,0,6,0,11
Algeria,2011-08-01,17,0,1,16,0,34
Algeria,2011-08-01,61,0,0,6,10,77
Algeria,2011-08-01,22,0,0,0,10,32
Algeria,2011-08-01,3,4,1,-2,6,12
Algeria,2011-08-01,64,0,0,-1,4,67
Algeria,2011-08-01,335,0,0,4,4,343
Algeria,2011-08-01,78,0,0,6,1,85
Algeria,2011-08-01,262,0,1,5,4,272
Algeria,2011-08-01,373,0,-2,33,24,428
Algeria,2011-08-01,73,0,-1,-2,14,84
Bangladesh,2011-08-01,24,0,0,-4,4,24
Bangladesh,2011-08-01,7,0,0,18,1,26
Bangladesh,2011-08-01,31,0,0,8,2,41
Bangladesh,2011-08-01,23,2,0,8,3,36
Bangladesh,2011-08-01,28,0,0,6,2,36
Bangladesh,2011-08-01,18,0,0,9,1,28
Bangladesh,2011-08-01,2,0,0,4,2,8
Bangladesh,2011-08-01,20,0,-4,20,1,37
Bangladesh,2011-08-01,24,0,-4,9,0,29
Bangladesh,2011-08-01,31,0,0,13,3,47
Bangladesh,2011-08-01,24,0,0,4,4,32
Bangladesh,2011-08-01,15,0,0,5,1,21
Bangladesh,2011-08-01,36,0,1,15,6,58
Bangladesh,2011-08-01,12,0,0,1,0,13
Bangladesh,2011-08-01,13,0,2,1,3,19
Bangladesh,2011-08-01,13,0,0,2,5,20
Bangladesh,2011-08-01,20,0,0,22,2,44
Bangladesh,2011-08-01,7,0,-2,15,5,25
Bangladesh,2011-08-01,14,0,0,10,6,30
Bangladesh,2011-08-01,13,0,0,3,0,16
Bangladesh,2011-08-01,10,0,0,3,2,15
Bangladesh,2011-08-01,38,0,-10,6,3,37
Bangladesh,2011-08-01,41,0,0,-3,3,41
Bangladesh,2011-08-01,29,0,-7,19,4,45
Bangladesh,2011-08-01,37,0,-1,5,2,43
Bangladesh,2011-08-01,99,0,0,13,5,117
Bangladesh,2011-08-01,-6,0,0,9,1,4
Bangladesh,2011-08-01,13,0,0,9,0,22
Bangladesh,2011-08-01,5,0,0,21,3,29
Bangladesh,2011-08-01,18,0,0,4,1,23
Bangladesh,2011-08-01,0,0,-6,3,6,3
Cameroon,2011-08-01,0,0,0,0,0,0
Cameroon,2011-08-01,0,0,0,0,0,0
Cameroon,2011-08-01,1,0,2,0,1,4
Cameroon,2011-08-01,-2,0,0,0,0,-2
Cameroon,2011-08-01,0,0,0,0,0,0
Cameroon,2011-08-01,0,0,0,0,0,0
Cameroon,2011-08-01,0,0,0,0,0,0
Cameroon,2011-08-01,0,0,0,6,0,6
Cameroon,2011-08-01,0,0,0,0,0,0
Cameroon,2011-08-01,1,0,0,0,0,1
Cameroon,2011-08-01,0,0,0,0,0,0
Cameroon,2011-08-01,0,0,0,0,0,0
Cameroon,2011-08-01,2,0,0,18,0,20
Cameroon,2011-08-01,2,0,0,0,0,2
Cameroon,2011-08-01,4,0,0,4,0,8
Cameroon,2011-08-01,0,0,0,6,0,6
Cameroon,2011-08-01,-2,0,0,0,0,-2
Cameroon,2011-08-01,-4,0,0,0,0,-4
Cameroon,2011-08-01,0,0,0,0,0,0
Cameroon,2011-08-01,-2,0,0,0,2,0
Cameroon,2011-08-01,-1,0,0,1,0,0
Cameroon,2011-08-01,5,0,0,12,0,17
Cameroon,2011-08-01,15,0,0,-6,0,9
Cameroon,2011-08-01,3,0,0,0,0,3
Cameroon,2011-08-01,0,0,0,0,0,0
Cameroon,2011-08-01,0,0,0,0,0,0
Cameroon,2011-08-01,-3,0,0,-12,0,-15
Cameroon,2011-08-01,6,0,-2,0,0,4
Cameroon,2011-08-01,0,0,0,0,0,0
China,2011-08-01,292,0,2,62,18,374
China,2011-08-01,234,0,-6,72,13,313
China,2011-08-01,191,0,3,78,10,282
China,2011-08-01,208,0,2,104,16,330
China,2011-08-01,148,0,2,34,52,236
China,2011-08-01,79,4,0,28,10,121
China,2011-08-01,80,6,0,13,22,121
China,2011-08-01,151,2,-17,42,20,198
China,2011-08-01,173,0,0,33,37,243
China,2011-08-01,163,4,-2,33,11,209
China,2011-08-01,110,0,2,62,14,188
China,2011-08-01,144,0,1,81,33,259
China,2011-08-01,93,2,2,10,13,120
China,2011-08-01,100,2,0,78,6,186
China,2011-08-01,123,2,0,61,15,201
China,2011-08-01,198,6,-8,44,17,257
China,2011-08-01,163,2,-6,20,14,193
China,2011-08-01,143,4,-1,54,23,223
China,2011-08-01,156,0,-5,41,24,216
China,2011-08-01,78,2,-2,51,9,138
China,2011-08-01,75,0,0,14,5,94
China,2011-08-01,137,0,-3,62,37,233
China,2011-08-01,170,2,-10,115,15,292
China,2011-08-01,120,6,-17,38,17,164
China,2011-08-01,136,0,-1,92,15,242
China,2011-08-01,133,0,-2,52,13,196
China,2011-08-01,56,2,-4,23,4,81
China,2011-08-01,82,2,-2,18,32,132
China,2011-08-01,120,2,-8,59,19,192
China,2011-08-01,125,0,-5,73,15,208
China,2011-08-01,92,0,1,53,19,165
Egypt,2011-08-01,98,0,-3,42,18,155
Egypt,2011-08-01,46,0,-1,45,10,100
Egypt,2011-08-01,95,0,-2,56,9,158
Egypt,2011-08-01,599,14,-35,238,79,895
Egypt,2011-08-01,353,8,-7,160,46,560
Egypt,2011-08-01,16,0,-2,13,14,41
Egypt,2011-08-01,47,2,2,51,17,119
Egypt,2011-08-01,25,0,0,40,12,77
Egypt,2011-08-01,64,0,-2,21,18,101
Egypt,2011-08-01,57,0,0,20,7,84
Egypt,2011-08-01,95,0,-1,51,10,155
Egypt,2011-08-01,81,2,-10,23,11,107
Egypt,2011-08-01,27,0,5,1,2,35
Egypt,2011-08-01,77,0,4,80,15,176
Egypt,2011-08-01,186,0,0,72,15,273
Egypt,2011-08-01,39,0,2,15,14,70
Egypt,2011-08-01,141,0,-14,68,14,209
Egypt,2011-08-01,560,0,-3,103,67,727
Egypt,2011-08-01,371,0,6,47,71,495
Egypt,2011-08-01,327,0,7,2,30,366
Egypt,2011-08-01,141,2,0,16,17,176
Egypt,2011-08-01,211,4,-14,21,28,250
Egypt,2011-08-01,81,0,-6,39,22,136
Egypt,2011-08-01,195,0,4,33,14,246
Egypt,2011-08-01,116,2,-1,30,11,158
Egypt,2011-08-01,120,0,-3,29,16,162
Egypt,2011-08-01,122,0,0,21,6,149
Egypt,2011-08-01,110,0,-8,46,13,161
Egypt,2011-08-01,155,0,-1,67,11,232
Egypt,2011-08-01,137,0,-4,40,12,185
Egypt,2011-08-01,71,0,1,36,12,120
Eritrea,2011-08-01,8,4,0,0,0,12
Eritrea,2011-08-01,10,2,0,0,0,12
Eritrea,2011-08-01,0,0,0,0,0,0
Eritrea,2011-08-01,10,0,0,-3,0,7
Eritrea,2011-08-01,5,0,0,0,0,5
Eritrea,2011-08-01,11,0,0,0,0,11
Eritrea,2011-08-01,-1,0,0,0,0,-1
Eritrea,2011-08-01,1,0,0,3,0,4
Eritrea,2011-08-01,7,0,0,6,0,13
Eritrea,2011-08-01,2,0,0,-1,0,1
Eritrea,2011-08-01,3,0,0,21,0,24
Eritrea,2011-08-01,0,0,-1,12,0,11
Eritrea,2011-08-01,0,0,-1,0,0,-1
Eritrea,2011-08-01,9,0,0,3,0,12
Eritrea,2011-08-01,2,0,0,-4,0,-2
Eritrea,2011-08-01,4,0,0,-4,0,0
Eritrea,2011-08-01,-1,0,0,-2,0,-3
Eritrea,2011-08-01,4,0,0,0,0,4
Eritrea,2011-08-01,3,0,0,0,0,3
Eritrea,2011-08-01,5,0,0,0,0,5
Eritrea,2011-08-01,9,0,0,6,0,15
Eritrea,2011-08-01,3,6,0,10,0,19
Eritrea,2011-08-01,33,0,0,0,0,33
Eritrea,2011-08-01,2,0,0,0,0,2
Eritrea,2011-08-01,0,0,0,9,0,9
Eritrea,2011-08-01,2,0,0,1,0,3
Eritrea,2011-08-01,0,0,0,0,0,0
Eritrea,2011-08-01,0,0,0,0,0,0
Eritrea,2011-08-01,2,0,0,0,0,2
Eritrea,2011-08-01,0,0,0,0,0,0
Georgia,2011-08-01,61,0,1,33,6,101
Georgia,2011-08-01,12,0,0,19,2,33
Georgia,2011-08-01,70,2,0,12,5,89
Georgia,2011-08-01,55,0,-2,17,2,72
Georgia,2011-08-01,59,2,0,21,2,84
Georgia,2011-08-01,23,0,0,12,0,35
Georgia,2011-08-01,26,0,0,0,4,30
Georgia,2011-08-01,38,0,-2,15,3,54
Georgia,2011-08-01,87,0,-4,2,10,95
Georgia,2011-08-01,18,0,0,-4,2,16
Georgia,2011-08-01,54,2,1,28,12,97
Georgia,2011-08-01,54,0,-6,8,16,72
Georgia,2011-08-01,23,0,0,7,3,33
Georgia,2011-08-01,10,2,0,1,1,14
Georgia,2011-08-01,53,0,0,13,8,74
Georgia,2011-08-01,10,0,2,12,0,24
Georgia,2011-08-01,37,2,0,34,10,83
Georgia,2011-08-01,56,0,0,31,23,110
Georgia,2011-08-01,49,2,-2,35,10,94
Georgia,2011-08-01,23,2,-5,13,0,33
Georgia,2011-08-01,11,0,0,15,1,27
Georgia,2011-08-01,43,0,2,33,2,80
Georgia,2011-08-01,28,0,-2,34,10,70
Georgia,2011-08-01,43,4,2,19,2,70
Georgia,2011-08-01,33,4,0,43,2,82
Georgia,2011-08-01,31,0,0,15,5,51
Georgia,2011-08-01,35,2,1,21,0,59
Georgia,2011-08-01,17,0,1,9,-2,25
Georgia,2011-08-01,37,0,-6,20,0,51
Georgia,2011-08-01,0,0,0,13,0,13
Georgia,2011-08-01,23,0,0,6,4,33
India,2011-08-01,97,0,-1,20,18,134
India,2011-08-01,87,0,0,25,13,125
India,2011-08-01,70,0,-4,13,15,94
India,2011-08-01,91,0,0,16,3,110
India,2011-08-01,37,0,-2,8,4,47
India,2011-08-01,40,0,1,7,12,60
India,2011-08-01,48,0,-2,12,3,61
India,2011-08-01,72,0,-7,10,2,77
India,2011-08-01,96,0,7,2,13,118
India,2011-08-01,130,2,2,24,6,164
India,2011-08-01,68,2,0,19,5,94
India,2011-08-01,70,0,-4,26,10,102
India,2011-08-01,41,0,1,6,5,53
India,2011-08-01,38,0,1,4,10,53
India,2011-08-01,66,0,-14,20,4,76
India,2011-08-01,64,0,-2,-4,22,80
India,2011-08-01,248,4,2,129,145,528
India,2011-08-01,57,0,-3,4,16,74
India,2011-08-01,50,4,-3,14,18,83
India,2011-08-01,65,0,0,23,18,106
India,2011-08-01,40,0,-4,6,18,60
India,2011-08-01,53,0,-7,16,14,76
India,2011-08-01,60,6,-3,-8,20,75
India,2011-08-01,76,0,2,16,20,114
India,2011-08-01,54,0,-2,2,11,65
India,2011-08-01,70,2,-1,23,16,110
India,2011-08-01,57,0,-4,4,7,64
India,2011-08-01,40,0,-2,28,13,79
India,2011-08-01,52,0,-3,8,11,68
India,2011-08-01,67,2,1,16,7,93
India,2011-08-01,42,0,1,12,20,75
Iran,2011-08-01,45,2,1,34,7,89
Iran,2011-08-01,67,0,3,27,8,105
Iran,2011-08-01,88,4,-2,11,8,109
Iran,2011-08-01,62,0,0,2,12,76
Iran,2011-08-01,57,0,0,15,4,76
Iran,2011-08-01,31,0,-2,-16,4,17
Iran,2011-08-01,59,0,0,5,12,76
Iran,2011-08-01,64,0,0,12,9,85
Iran,2011-08-01,58,4,-1,40,12,113
Iran,2011-08-01,71,2,0,57,9,139
Iran,2011-08-01,75,0,0,93,18,186
Iran,2011-08-01,50,0,0,26,11,87
Iran,2011-08-01,29,0,0,33,14,76
Iran,2011-08-01,47,0,0,30,5,82
Iran,2011-08-01,73,2,0,57,4,136
Iran,2011-08-01,59,2,2,31,3,97
Iran,2011-08-01,66,0,1,56,2,125
Iran,2011-08-01,42,0,0,50,5,97
Iran,2011-08-01,40,0,2,13,8,63
Iran,2011-08-01,91,0,0,186,8,285
Iran,2011-08-01,91,0,2,57,8,158
Iran,2011-08-01,48,0,0,68,4,120
Iran,2011-08-01,49,0,-3,16,7,69
Iran,2011-08-01,68,0,-1,41,16,124
Iran,2011-08-01,67,0,0,64,17,148
Iran,2011-08-01,25,6,-1,3,8,41
Iran,2011-08-01,42,0,-3,35,9,83
Iran,2011-08-01,108,0,-4,60,7,171
Iran,2011-08-01,77,0,-2,8,9,92
Iran,2011-08-01,75,0,1,29,4,109
Iran,2011-08-01,100,0,1,10,4,115
Iraq,2011-08-01,90,2,1,39,13,145
Iraq,2011-08-01,217,2,0,96,17,332
Iraq,2011-08-01,89,0,0,38,5,132
Iraq,2011-08-01,77,0,0,30,10,117
Iraq,2011-08-01,74,0,0,53,3,130
Iraq,2011-08-01,81,0,0,-25,17,73
Iraq,2011-08-01,136,0,-4,17,19,168
Iraq,2011-08-01,140,2,-4,24,18,180
Iraq,2011-08-01,141,2,8,86,15,252
Iraq,2011-08-01,173,0,-2,37,15,223
Iraq,2011-08-01,158,2,0,26,14,200
Iraq,2011-08-01,129,0,-2,19,7,153
Iraq,2011-08-01,21,0,0,11,2,34
Iraq,2011-08-01,48,2,0,12,16,78
Iraq,2011-08-01,188,0,0,44,15,247
Iraq,2011-08-01,86,0,0,59,9,154
Iraq,2011-08-01,152,0,0,54,19,225
Iraq,2011-08-01,302,2,-8,36,27,359
Iraq,2011-08-01,247,0,0,39,19,305
Iraq,2011-08-01,171,0,2,127,15,315
Iraq,2011-08-01,327,0,1,43,18,389
Iraq,2011-08-01,123,0,-3,60,9,189
Iraq,2011-08-01,263,16,-4,60,21,356
Iraq,2011-08-01,202,2,0,45,21,270
Iraq,2011-08-01,172,2,1,67,19,261
Iraq,2011-08-01,198,0,-2,13,22,231
Iraq,2011-08-01,58,2,0,18,1,79
Iraq,2011-08-01,170,0,0,82,17,269
Iraq,2011-08-01,276,10,-2,32,32,348
Iraq,2011-08-01,248,6,-6,9,32,289
Iraq,2011-08-01,112,4,0,58,17,191
Morocco,2011-08-01,13,0,0,0,1,14
Morocco,2011-08-01,12,2,-4,29,5,44
Morocco,2011-08-01,10,0,0,27,0,37
Morocco,2011-08-01,-10,0,1,0,4,-5
Morocco,2011-08-01,8,0,-1,9,10,26
Morocco,2011-08-01,6,0,0,0,0,6
Morocco,2011-08-01,0,0,0,3,0,3
Morocco,2011-08-01,2,0,0,3,0,5
Morocco,2011-08-01,0,0,0,0,1,1
Morocco,2011-08-01,4,0,0,-2,0,2
Morocco,2011-08-01,8,6,0,0,0,14
Morocco,2011-08-01,4,0,-1,0,0,3
Morocco,2011-08-01,0,0,0,0,2,2
Morocco,2011-08-01,1,0,2,0,2,5
Morocco,2011-08-01,12,0,-3,0,0,9
Morocco,2011-08-01,1,0,-5,-7,5,-6
Morocco,2011-08-01,6,0,-2,24,1,29
Morocco,2011-08-01,4,0,0,0,0,4
Morocco,2011-08-01,-5,0,0,4,0,-1
Morocco,2011-08-01,16,0,3,15,0,34
Morocco,2011-08-01,6,0,1,18,0,25
Morocco,2011-08-01,2,0,0,-5,2,-1
Morocco,2011-08-01,14,0,0,6,2,22
Morocco,2011-08-01,10,0,0,11,0,21
Morocco,2011-08-01,5,0,0,0,0,5
Morocco,2011-08-01,2,0,0,2,0,4
Morocco,2011-08-01,3,0,0,0,0,3
Morocco,2011-08-01,12,0,0,0,0,12
Morocco,2011-08-01,6,0,0,5,3,14
Morocco,2011-08-01,8,0,0,6,0,14
Morocco,2011-08-01,9,0,0,-8,0,1
Nigeria,2011-08-01,26,0,0,25,4,55
Nigeria,2011-08-01,35,0,0,4,2,41
Nigeria,2011-08-01,19,0,0,10,0,29
Nigeria,2011-08-01,34,0,0,36,1,71
Nigeria,2011-08-01,29,0,0,30,1,60
Nigeria,2011-08-01,9,0,0,0,0,9
Nigeria,2011-08-01,21,0,0,11,1,33
Nigeria,2011-08-01,36,0,0,15,3,54
Nigeria,2011-08-01,43,0,0,9,7,59
Nigeria,2011-08-01,26,0,0,6,1,33
Nigeria,2011-08-01,53,0,1,39,3,96
Nigeria,2011-08-01,48,0,0,16,1,65
Nigeria,2011-08-01,31,0,-6,10,1,36
Nigeria,2011-08-01,34,0,0,13,1,48
Nigeria,2011-08-01,26,0,0,4,0,30
Nigeria,2011-08-01,53,2,0,47,2,104
Nigeria,2011-08-01,22,0,0,33,3,58
Nigeria,2011-08-01,17,0,0,13,2,32
Nigeria,2011-08-01,13,0,-5,8,2,18
Nigeria,2011-08-01,21,0,-6,0,3,18
Nigeria,2011-08-01,42,2,0,0,5,49
Nigeria,2011-08-01,23,0,0,3,2,28
Nigeria,2011-08-01,68,0,-2,-2,4,68
Nigeria,2011-08-01,31,0,0,2,2,35
Nigeria,2011-08-01,21,0,2,9,2,34
Nigeria,2011-08-01,27,0,0,39,4,70
Nigeria,2011-08-01,23,0,0,0,7,30
Nigeria,2011-08-01,59,0,0,49,16,124
Nigeria,2011-08-01,90,0,0,-1,3,92
Nigeria,2011-08-01,71,2,0,9,2,84
Nigeria,2011-08-01,34,0,0,4,11,49
Pakistan,2011-08-01,101,4,0,43,5,153
Pakistan,2011-08-01,128,0,0,24,24,176
Pakistan,2011-08-01,67,2,2,31,10,112
Pakistan,2011-08-01,69,0,-2,3,11,81
Pakistan,2011-08-01,82,0,0,32,9,123
Pakistan,2011-08-01,142,0,0,18,4,164
Pakistan,2011-08-01,188,2,-4,3,7,196
Pakistan,2011-08-01,192,0,0,3,10,205
Pakistan,2011-08-01,104,0,-2,38,13,153
Pakistan,2011-08-01,149,0,0,45,28,222
Pakistan,2011-08-01,248,0,1,78,11,338
Pakistan,2011-08-01,125,2,-2,56,12,193
Pakistan,2011-08-01,104,0,0,52,14,170
Pakistan,2011-08-01,95,0,3,30,11,139
Pakistan,2011-08-01,127,8,1,83,18,237
Pakistan,2011-08-01,82,2,-1,52,6,141
Pakistan,2011-08-01,52,0,0,62,8,122
Pakistan,2011-08-01,111,0,1,46,46,204
Pakistan,2011-08-01,172,0,-2,44,20,234
Pakistan,2011-08-01,145,0,-1,24,21,189
Pakistan,2011-08-01,54,0,-2,8,4,64
Pakistan,2011-08-01,61,2,-2,24,7,92
Pakistan,2011-08-01,63,0,-3,3,11,74
Pakistan,2011-08-01,61,0,2,10,8,81
Pakistan,2011-08-01,49,0,-2,31,10,88
Pakistan,2011-08-01,56,0,0,32,12,100
Pakistan,2011-08-01,193,2,-2,11,13,217
Pakistan,2011-08-01,118,0,0,9,18,145
Pakistan,2011-08-01,68,0,-2,11,16,93
Pakistan,2011-08-01,86,0,0,37,16,139
Pakistan,2011-08-01,116,0,0,17,79,212
Sierra Leone,2011-08-01,3,0,-4,0,1,0
Sierra Leone,2011-08-01,6,0,0,0,0,6
Sierra Leone,2011-08-01,2,0,0,3,0,5
Sierra Leone,2011-08-01,-2,0,1,1,3,3
Sierra Leone,2011-08-01,36,0,0,6,2,44
Sierra Leone,2011-08-01,9,0,0,0,0,9
Sierra Leone,2011-08-01,-1,0,0,3,0,2
Sierra Leone,2011-08-01,3,0,0,0,1,4
Sierra Leone,2011-08-01,9,0,0,0,0,9
Sierra Leone,2011-08-01,9,0,0,0,0,9
Sierra Leone,2011-08-01,3,0,0,0,2,5
Sierra Leone,2011-08-01,4,0,0,0,0,4
Sierra Leone,2011-08-01,0,0,1,0,0,1
Sierra Leone,2011-08-01,6,0,0,1,0,7
Sierra Leone,2011-08-01,2,0,0,0,0,2
Sierra Leone,2011-08-01,0,0,0,3,1,4
Sierra Leone,2011-08-01,0,0,0,6,0,6
Sierra Leone,2011-08-01,0,0,0,0,0,0
Sierra Leone,2011-08-01,1,0,0,3,0,4
Sierra Leone,2011-08-01,1,0,0,0,0,1
Sierra Leone,2011-08-01,0,0,0,0,0,0
Sierra Leone,2011-08-01,7,0,1,0,2,10
Sierra Leone,2011-08-01,2,0,0,-2,3,3
Sierra Leone,2011-08-01,0,0,0,4,8,12
Sierra Leone,2011-08-01,23,0,0,0,8,31
Sierra Leone,2011-08-01,-1,0,-2,0,1,-2
Sierra Leone,2011-08-01,3,0,0,-4,0,-1
Sierra Leone,2011-08-01,4,0,0,0,0,4
Sierra Leone,2011-08-01,3,0,0,0,0,3
Sierra Leone,2011-08-01,4,0,0,0,0,4
Sierra Leone,2011-08-01,2,0,0,0,3,5
Somalia,2011-08-01,84,8,0,4,9,105
Somalia,2011-08-01,90,6,0,52,5,153
Somalia,2011-08-01,99,6,0,6,4,115
Somalia,2011-08-01,57,12,1,25,1,96
Somalia,2011-08-01,83,14,2,44,6,149
Somalia,2011-08-01,2,6,0,2,1,11
Somalia,2011-08-01,25,6,0,-1,0,30
Somalia,2011-08-01,57,10,0,2,2,71
Somalia,2011-08-01,84,6,-5,1,0,86
Somalia,2011-08-01,73,4,0,30,12,119
Somalia,2011-08-01,110,12,0,26,12,160
Somalia,2011-08-01,231,10,1,232,33,507
Somalia,2011-08-01,48,4,0,43,8,103
Somalia,2011-08-01,29,6,0,-15,7,27
Somalia,2011-08-01,52,2,1,46,7,108
Somalia,2011-08-01,72,0,4,10,5,91
Somalia,2011-08-01,47,14,3,14,13,91
Somalia,2011-08-01,60,14,1,39,15,129
Somalia,2011-08-01,73,2,0,23,4,102
Somalia,2011-08-01,38,2,0,-5,7,42
Somalia,2011-08-01,20,2,0,-3,0,19
Somalia,2011-08-01,33,10,4,63,0,110
Somalia,2011-08-01,28,4,2,27,1,62
Somalia,2011-08-01,17,0,0,-13,0,4
Somalia,2011-08-01,36,2,1,25,2,66
Somalia,2011-08-01,63,4,1,-14,24,78
Somalia,2011-08-01,61,0,0,-3,0,58
Somalia,2011-08-01,29,0,0,-4,0,25
Somalia,2011-08-01,8,0,0,14,0,22
Somalia,2011-08-01,20,12,0,7,-2,37
Somalia,2011-08-01,21,2,0,3,1,27
Syria,2011-08-01,377,2,-3,43,105,524
Syria,2011-08-01,197,0,-2,47,76,318
Syria,2011-08-01,335,0,-19,68,87,471
Syria,2011-08-01,347,0,-17,65,65,460
Syria,2011-08-01,468,0,-11,147,88,692
Syria,2011-08-01,575,4,-3,53,122,751
Syria,2011-08-01,340,2,0,-19,51,374
Syria,2011-08-01,257,8,-3,27,39,328
Syria,2011-08-01,238,0,-13,30,29,284
Syria,2011-08-01,224,0,-9,68,49,332
Syria,2011-08-01,222,0,-13,86,62,357
Syria,2011-08-01,165,0,-12,31,39,223
Syria,2011-08-01,147,4,-5,18,33,197
Syria,2011-08-01,224,0,-6,6,72,296
Syria,2011-08-01,278,0,-1,22,89,388
Syria,2011-08-01,238,0,-16,29,77,328
Syria,2011-08-01,246,0,-10,50,63,349
Syria,2011-08-01,362,0,-167,150,95,440
Syria,2011-08-01,239,0,-44,54,54,303
Syria,2011-08-01,86,0,-14,39,17,128
Syria,2011-08-01,111,0,-56,16,26,97
Syria,2011-08-01,166,2,-43,41,15,181
Syria,2011-08-01,249,0,-14,61,30,326
Syria,2011-08-01,187,0,-2,45,14,244
Syria,2011-08-01,109,0,-14,36,15,146
Syria,2011-08-01,127,0,-13,98,16,228
Syria,2011-08-01,85,0,2,16,17,120
Syria,2011-08-01,100,0,-5,26,7,128
Syria,2011-08-01,85,0,-10,20,11,106
Syria,2011-08-01,108,0,-4,17,17,138
Syria,2011-08-01,134,0,0,59,43,236
Yemen,2011-08-01,8,0,0,12,0,20
Yemen,2011-08-01,1,0,-2,-2,1,-2
Yemen,2011-08-01,22,0,3,-6,2,21
Yemen,2011-08-01,39,0,0,6,0,45
Yemen,2011-08-01,18,0,-2,3,2,21
Yemen,2011-08-01,23,0,0,4,4,31
Yemen,2011-08-01,38,0,0,0,0,38
Yemen,2011-08-01,32,0,0,-5,0,27
Yemen,2011-08-01,67,0,-3,-3,5,66
Yemen,2011-08-01,57,0,-10,1,4,52
Yemen,2011-08-01,19,0,-2,3,7,27
Yemen,2011-08-01,19,0,-3,6,6,28
Yemen,2011-08-01,23,0,-1,0,4,26
Yemen,2011-08-01,14,0,0,3,3,20
Yemen,2011-08-01,30,0,0,9,1,40
Yemen,2011-08-01,26,0,0,2,0,28
Yemen,2011-08-01,12,0,-4,3,1,12
Yemen,2011-08-01,25,0,-6,6,8,33
Yemen,2011-08-01,15,0,0,6,0,21
Yemen,2011-08-01,14,0,0,0,2,16
Yemen,2011-08-01,25,0,0,9,5,39
Yemen,2011-08-01,19,0,-6,0,11,24
Yemen,2011-08-01,37,0,-1,0,5,41
Yemen,2011-08-01,66,0,-6,3,2,65
Yemen,2011-08-01,22,0,-6,6,5,27
Yemen,2011-08-01,16,0,0,-20,6,2
Yemen,2011-08-01,16,0,-2,-8,5,11
Yemen,2011-08-01,9,0,0,0,1,10
Yemen,2011-08-01,27,0,1,0,3,31
Yemen,2011-08-01,5,0,0,4,1,10
Yemen,2011-08-01,29,0,0,0,2,31
Afghanistan,2006-06-01,31,0,0,-1,8,38
Afghanistan,2006-06-01,38,0,0,24,0,62
Afghanistan,2006-06-01,25,0,0,14,0,39
Afghanistan,2006-06-01,32,0,0,15,5,52
Afghanistan,2006-06-01,37,0,0,5,2,44
Afghanistan,2006-06-01,57,0,-3,5,4,63
Afghanistan,2006-06-01,28,0,0,28,3,59
Afghanistan,2006-06-01,57,6,0,5,2,70
Afghanistan,2006-06-01,69,2,0,-2,0,69
Afghanistan,2006-06-01,20,0,0,0,0,20
Afghanistan,2006-06-01,71,0,-4,34,0,101
Afghanistan,2006-06-01,57,2,0,21,1,81
Afghanistan,2006-06-01,29,0,1,3,2,35
Afghanistan,2006-06-01,52,0,1,47,1,101
Afghanistan,2006-06-01,69,2,1,11,15,98
Afghanistan,2006-06-01,41,0,0,33,6,80
Afghanistan,2006-06-01,21,0,0,3,0,24
Afghanistan,2006-06-01,42,0,0,15,2,59
Afghanistan,2006-06-01,32,0,0,12,1,45
Afghanistan,2006-06-01,41,0,0,16,3,60
Afghanistan,2006-06-01,29,0,0,-29,9,9
Afghanistan,2006-06-01,36,0,1,-19,2,20
Afghanistan,2006-06-01,41,0,0,15,0,56
Afghanistan,2006-06-01,11,0,0,11,0,22
Afghanistan,2006-06-01,82,0,0,-2,5,85
Afghanistan,2006-06-01,42,0,0,-3,2,41
Afghanistan,2006-06-01,45,0,2,7,1,55
Afghanistan,2006-06-01,37,0,1,7,5,50
Afghanistan,2006-06-01,45,0,1,25,2,73
Afghanistan,2006-06-01,2,0,0,39,4,45
Albania,2006-06-01,3,2,-1,0,0,4
Albania,2006-06-01,4,0,0,0,0,4
Albania,2006-06-01,2,0,0,-2,0,0
Albania,2006-06-01,11,0,0,10,0,21
Albania,2006-06-01,9,0,2,4,0,15
Albania,2006-06-01,21,0,0,0,0,21
Albania,2006-06-01,8,0,0,-2,0,6
Albania,2006-06-01,2,0,0,6,2,10
Albania,2006-06-01,20,0,0,4,5,29
Albania,2006-06-01,3,0,0,0,0,3
Albania,2006-06-01,0,0,0,0,0,0
Albania,2006-06-01,-1,0,0,2,0,1
Albania,2006-06-01,5,0,1,0,4,10
Albania,2006-06-01,0,0,0,0,0,0
Albania,2006-06-01,2,2,-1,-2,7,8
Albania,2006-06-01,1,0,-1,9,0,9
Albania,2006-06-01,-1,0,0,0,0,-1
Albania,2006-06-01,0,0,0,0,0,0
Albania,2006-06-01,3,0,0,3,1,7
Albania,2006-06-01,7,0,0,0,2,9
Albania,2006-06-01,2,0,0,-1,1,2
Albania,2006-06-01,2,0,0,0,0,2
Albania,2006-06-01,7,0,0,3,0,10
Albania,2006-06-01,-2,0,0,6,0,4
Albania,2006-06-01,0,0,0,12,0,12
Albania,2006-06-01,6,0,0,0,0,6
Albania,2006-06-01,8,0,0,0,1,9
Albania,2006-06-01,30,0,0,15,4,49
Albania,2006-06-01,3,0,-2,0,0,1
Albania,2006-06-01,1,0,0,0,0,1
Algeria,2006-06-01,0,0,0,0,1,1
Algeria,2006-06-01,0,0,0,6,0,6
Algeria,2006-06-01,0,0,0,6,2,8
Algeria,2006-06-01,0,0,0,0,0,0
Algeria,2006-06-01,0,0,0,0,0,0
Algeria,2006-06-01,1,0,-2,3,0,2
Algeria,2006-06-01,-5,0,0,0,0,-5
Algeria,2006-06-01,6,0,0,9,0,15
Algeria,2006-06-01,1,0,0,0,0,1
Algeria,2006-06-01,0,0,0,-2,0,-2
Algeria,2006-06-01,0,0,0,0,0,0
Algeria,2006-06-01,8,0,0,0,0,8
Algeria,2006-06-01,0,0,0,3,0,3
Algeria,2006-06-01,-7,0,0,5,0,-2
Algeria,2006-06-01,3,0,0,3,0,6
Algeria,2006-06-01,0,0,0,0,0,0
Algeria,2006-06-01,9,0,0,6,0,15
Algeria,2006-06-01,6,0,0,0,0,6
Algeria,2006-06-01,4,0,0,12,0,16
Algeria,2006-06-01,0,0,0,4,0,4
Algeria,2006-06-01,-3,0,0,0,0,-3
Algeria,2006-06-01,2,0,0,15,1,18
Algeria,2006-06-01,-1,0,0,0,0,-1
Algeria,2006-06-01,0,0,0,12,0,12
Algeria,2006-06-01,0,0,0,3,0,3
Algeria,2006-06-01,-3,0,0,3,0,0
Algeria,2006-06-01,0,0,0,6,0,6
Algeria,2006-06-01,0,0,0,6,0,6
Algeria,2006-06-01,0,0,0,0,0,0
Algeria,2006-06-01,0,0,0,3,0,3
Bangladesh,2006-06-01,-2,0,-4,0,0,-6
Bangladesh,2006-06-01,0,0,0,0,0,0
Bangladesh,2006-06-01,18,0,0,12,0,30
Bangladesh,2006-06-01,11,0,0,-6,0,5
Bangladesh,2006-06-01,8,0,0,-2,0,6
Bangladesh,2006-06-01,-4,0,-1,0,0,-5
Bangladesh,2006-06-01,-1,0,0,0,0,-1
Bangladesh,2006-06-01,1,0,0,3,0,4
Bangladesh,2006-06-01,7,0,0,0,1,8
Bangladesh,2006-06-01,0,0,0,0,0,0
Bangladesh,2006-06-01,4,0,0,0,0,4
Bangladesh,2006-06-01,2,2,0,1,0,5
Bangladesh,2006-06-01,4,0,1,3,0,8
Bangladesh,2006-06-01,0,0,0,0,0,0
Bangladesh,2006-06-01,0,0,0,6,0,6
Bangladesh,2006-06-01,1,0,0,0,2,3
Bangladesh,2006-06-01,4,0,0,0,0,4
Bangladesh,2006-06-01,7,0,0,-2,0,5
Bangladesh,2006-06-01,4,0,0,3,0,7
Bangladesh,2006-06-01,-5,0,0,0,22,17
Bangladesh,2006-06-01,2,0,0,0,0,2
Bangladesh,2006-06-01,6,0,0,9,0,15
Bangladesh,2006-06-01,9,2,0,-3,2,10
Bangladesh,2006-06-01,2,0,0,0,0,2
Bangladesh,2006-06-01,15,0,0,0,1,16
Bangladesh,2006-06-01,10,0,0,0,0,10
Bangladesh,2006-06-01,4,0,0,0,0,4
Bangladesh,2006-06-01,3,0,0,0,0,3
Bangladesh,2006-06-01,1,0,0,0,0,1
Cameroon,2006-06-01,0,0,0,0,0,0
Cameroon,2006-06-01,0,0,0,0,0,0
Cameroon,2006-06-01,0,0,0,0,0,0
Cameroon,2006-06-01,0,0,0,3,0,3
Cameroon,2006-06-01,2,0,0,3,0,5
Cameroon,2006-06-01,5,0,0,0,0,5
Cameroon,2006-06-01,0,0,0,0,0,0
Cameroon,2006-06-01,5,0,0,0,0,5
Cameroon,2006-06-01,4,0,0,0,0,4
Cameroon,2006-06-01,10,0,0,0,0,10
Cameroon,2006-06-01,6,0,0,0,0,6
Cameroon,2006-06-01,-4,0,0,3,0,-1
Cameroon,2006-06-01,-5,0,0,0,1,-4
Cameroon,2006-06-01,0,0,0,0,0,0
Cameroon,2006-06-01,0,0,0,0,0,0
Cameroon,2006-06-01,0,0,0,3,0,3
Cameroon,2006-06-01,-1,0,0,0,0,-1
Cameroon,2006-06-01,0,0,0,-2,0,-2
Cameroon,2006-06-01,0,0,0,-2,0,-2
Cameroon,2006-06-01,1,0,0,3,0,4
Cameroon,2006-06-01,2,0,0,0,0,2
Cameroon,2006-06-01,0,0,0,6,0,6
Cameroon,2006-06-01,18,0,0,1,0,19
Cameroon,2006-06-01,0,0,0,0,0,0
China,2006-06-01,-10,0,0,-4,2,-12
China,2006-06-01,13,0,-1,4,3,19
China,2006-06-01,19,0,1,-1,3,22
China,2006-06-01,2,0,0,-2,0,0
China,2006-06-01,14,0,0,6,3,23
China,2006-06-01,4,2,0,10,1,17
China,2006-06-01,10,0,-4,17,3,26
China,2006-06-01,24,0,-1,1,3,27
China,2006-06-01,10,0,0,26,0,36
China,2006-06-01,-3,0,0,3,0,0
China,2006-06-01,9,0,0,15,0,24
China,2006-06-01,11,0,0,3,0,14
China,2006-06-01,5,0,0,-2,4,7
China,2006-06-01,13,0,1,9,5,28
China,2006-06-01,13,0,-1,1,0,13
China,2006-06-01,10,0,1,0,5,16
China,2006-06-01,6,0,0,0,2,8
China,2006-06-01,4,0,0,-6,1,-1
China,2006-06-01,31,0,1,3,4,39
China,2006-06-01,7,0,0,2,5,14
China,2006-06-01,-11,2,0,25,4,20
China,2006-06-01,6,2,-5,12,1,16
China,2006-06-01,14,0,-3,3,0,14
China,2006-06-01,46,0,0,12,1,59
China,2006-06-01,19,0,0,11,1,31
China,2006-06-01,22,0,0,18,5,45
China,2006-06-01,46,0,-3,29,3,75
China,2006-06-01,25,0,-2,9,1,33
China,2006-06-01,22,0,0,2,2,26
China,2006-06-01,15,0,-2,15,1,29
Egypt,2006-06-01,5,0,0,0,0,5
Egypt,2006-06-01,52,0,0,3,3,58
Egypt,2006-06-01,30,0,2,1,2,35
Egypt,2006-06-01,27,0,0,16,1,44
Egypt,2006-06-01,19,0,0,19,1,39
Egypt,2006-06-01,2,0,0,3,0,5
Egypt,2006-06-01,0,0,0,3,3,6
Egypt,2006-06-01,12,0,0,0,0,12
Egypt,2006-06-01,23,2,0,1,0,26
Egypt,2006-06-01,6,0,0,-8,0,-2
Egypt,2006-06-01,0,0,0,0,0,0
Egypt,2006-06-01,2,0,0,0,3,5
Egypt,2006-06-01,1,0,0,3,1,5
Egypt,2006-06-01,23,2,0,-4,5,26
Egypt,2006-06-01,20,0,0,2,1,23
Egypt,2006-06-01,1,0,0,3,0,4
Egypt,2006-06-01,18,0,0,3,0,21
Egypt,2006-06-01,8,0,0,0,2,10
Egypt,2006-06-01,15,0,0,3,0,18
Egypt,2006-06-01,12,0,0,-6,0,6
Egypt,2006-06-01,11,0,0,2,9,22
Egypt,2006-06-01,13,0,0,24,1,38
Egypt,2006-06-01,4,0,0,-3,1,2
Egypt,2006-06-01,5,0,0,0,0,5
Egypt,2006-06-01,31,0,0,3,0,34
Egypt,2006-06-01,12,0,0,-2,1,11
Egypt,2006-06-01,9,0,0,11,0,20
Egypt,2006-06-01,11,0,0,3,0,14
Egypt,2006-06-01,29,0,0,27,4,60
Egypt,2006-06-01,40,0,0,-29,3,14
Eritrea,2006-06-01,2,0,0,0,0,2
Eritrea,2006-06-01,0,0,0,0,0,0
Eritrea,2006-06-01,5,0,0,0,0,5
Eritrea,2006-06-01,3,0,0,0,0,3
Eritrea,2006-06-01,0,0,0,0,0,0
Eritrea,2006-06-01,-3,0,0,0,0,-3
Eritrea,2006-06-01,0,0,0,0,0,0
Eritrea,2006-06-01,2,0,0,0,0,2
Eritrea,2006-06-01,0,0,0,0,0,0
Eritrea,2006-06-01,5,0,0,-4,0,1
Eritrea,2006-06-01,4,0,0,0,0,4
Eritrea,2006-06-01,9,0,0,0,0,9
Eritrea,2006-06-01,0,0,0,0,0,0
Eritrea,2006-06-01,0,0,0,0,0,0
Eritrea,2006-06-01,2,0,0,0,0,2
Eritrea,2006-06-01,2,0,0,0,0,2
Eritrea,2006-06-01,6,0,0,0,0,6
Eritrea,2006-06-01,0,0,0,3,0,3
Eritrea,2006-06-01,4,0,0,6,0,10
Eritrea,2006-06-01,1,0,0,0,0,1
Eritrea,2006-06-01,0,0,0,3,0,3
Eritrea,2006-06-01,7,0,0,0,0,7
Eritrea,2006-06-01,2,0,0,0,1,3
Eritrea,2006-06-01,4,0,0,0,0,4
Eritrea,2006-06-01,3,0,0,4,0,7
Eritrea,2006-06-01,0,0,0,0,0,0
Georgia,2006-06-01,-7,2,0,0,0,-5
Georgia,2006-06-01,0,0,0,0,0,0
Georgia,2006-06-01,2,0,0,3,0,5
Georgia,2006-06-01,3,0,0,0,0,3
Georgia,2006-06-01,0,0,0,3,0,3
Georgia,2006-06-01,3,0,0,3,0,6
Georgia,2006-06-01,13,0,0,-2,0,11
Georgia,2006-06-01,0,0,0,3,0,3
Georgia,2006-06-01,5,0,-2,6,0,9
Georgia,2006-06-01,2,0,0,0,0,2
Georgia,2006-06-01,3,0,0,0,0,3
Georgia,2006-06-01,0,0,0,1,0,1
Georgia,2006-06-01,0,0,0,0,0,0
Georgia,2006-06-01,2,0,0,3,0,5
Georgia,2006-06-01,0,0,-1,9,0,8
Georgia,2006-06-01,-1,0,0,0,0,-1
Georgia,2006-06-01,-5,0,0,0,0,-5
Georgia,2006-06-01,0,0,0,0,2,2
Georgia,2006-06-01,6,0,0,13,0,19
Georgia,2006-06-01,6,0,0,8,0,14
Georgia,2006-06-01,3,0,0,0,0,3
Georgia,2006-06-01,9,0,0,3,0,12
Georgia,2006-06-01,0,0,0,0,0,0
Georgia,2006-06-01,2,0,0,3,0,5
Georgia,2006-06-01,1,0,0,0,0,1
Georgia,2006-06-01,11,0,0,3,0,14
Georgia,2006-06-01,8,0,0,9,0,17
Georgia,2006-06-01,2,0,0,-4,0,-2
Georgia,2006-06-01,0,0,0,-2,3,1
India,2006-06-01,18,0,-1,-1,1,17
India,2006-06-01,0,0,0,-2,0,-2
India,2006-06-01,5,0,0,1,0,6
India,2006-06-01,1,0,0,3,0,4
India,2006-06-01,6,0,0,3,0,9
India,2006-06-01,13,0,0,10,0,23
India,2006-06-01,5,0,0,7,4,16
India,2006-06-01,4,0,-2,9,0,11
India,2006-06-01,15,0,0,3,1,19
India,2006-06-01,0,0,0,3,0,3
India,2006-06-01,0,0,0,0,0,0
India,2006-06-01,4,0,0,0,0,4
India,2006-06-01,0,0,0,1,0,1
India,2006-06-01,14,0,0,0,2,16
India,2006-06-01,13,0,0,0,0,13
India,2006-06-01,6,0,0,0,0,6
India,2006-06-01,4,0,0,-3,2,3
India,2006-06-01,8,0,0,3,0,11
India,2006-06-01,5,0,0,4,1,10
India,2006-06-01,10,0,-4,0,2,8
India,2006-06-01,14,0,0,-2,1,13
India,2006-06-01,-4,0,0,0,0,-4
India,2006-06-01,12,0,0,5,0,17
India,2006-06-01,17,0,0,-2,3,18
India,2006-06-01,3,0,0,0,0,3
India,2006-06-01,17,0,-2,10,7,32
India,2006-06-01,24,0,0,3,0,27
India,2006-06-01,27,0,0,4,7,38
India,2006-06-01,14,0,-2,0,0,12
India,2006-06-01,9,0,0,-4,5,10
Iran,2006-06-01,21,0,0,10,2,33
Iran,2006-06-01,14,0,-1,7,1,21
Iran,2006-06-01,6,0,0,3,3,12
Iran,2006-06-01,2,0,0,9,1,12
Iran,2006-06-01,36,0,0,6,17,59
Iran,2006-06-01,26,0,0,15,14,55
Iran,2006-06-01,22,0,2,17,16,57
Iran,2006-06-01,25,0,-2,1,3,27
Iran,2006-06-01,33,0,-2,0,5,36
Iran,2006-06-01,3,0,0,3,2,8
Iran,2006-06-01,5,0,0,3,0,8
Iran,2006-06-01,14,0,0,10,1,25
Iran,2006-06-01,25,0,0,0,1,26
Iran,2006-06-01,26,2,0,15,3,46
Iran,2006-06-01,17,0,0,9,1,27
Iran,2006-06-01,10,0,0,3,3,16
Iran,2006-06-01,15,0,0,1,4,20
Iran,2006-06-01,29,0,0,4,5,38
Iran,2006-06-01,22,0,0,24,7,53
Iran,2006-06-01,20,0,0,9,5,34
Iran,2006-06-01,13,0,-1,-4,0,8
Iran,2006-06-01,29,0,1,12,0,42
Iran,2006-06-01,18,0,-2,0,3,19
Iran,2006-06-01,15,0,0,1,3,19
Iran,2006-06-01,9,0,0,0,2,11
Iran,2006-06-01,5,0,0,-8,4,1
Iran,2006-06-01,34,0,0,10,5,49
Iran,2006-06-01,27,2,0,-2,1,28
Iran,2006-06-01,30,0,0,1,0,31
Iran,2006-06-01,29,0,0,6,2,37
Iraq,2006-06-01,85,0,0,59,8,152
Iraq,2006-06-01,86,0,0,30,13,129
Iraq,2006-06-01,50,0,0,15,18,83
Iraq,2006-06-01,47,0,1,-3,9,54
Iraq,2006-06-01,59,0,-2,6,2,65
Iraq,2006-06-01,98,0,1,9,3,111
Iraq,2006-06-01,42,0,1,24,4,71
Iraq,2006-06-01,277,0,0,80,15,372
Iraq,2006-06-01,150,2,2,11,10,175
Iraq,2006-06-01,23,0,0,0,0,23
Iraq,2006-06-01,46,0,0,8,3,57
Iraq,2006-06-01,73,0,0,26,10,109
Iraq,2006-06-01,59,0,-4,24,2,81
Iraq,2006-06-01,91,2,-3,65,5,160
Iraq,2006-06-01,77,0,0,-1,10,86
Iraq,2006-06-01,45,2,-2,16,2,63
Iraq,2006-06-01,14,0,0,6,2,22
Iraq,2006-06-01,10,0,0,-3,4,11
Iraq,2006-06-01,63,0,0,45,0,108
Iraq,2006-06-01,166,0,7,71,11,255
Iraq,2006-06-01,152,2,1,38,8,201
Iraq,2006-06-01,68,0,1,21,14,104
Iraq,2006-06-01,79,0,0,10,8,97
Iraq,2006-06-01,88,0,0,15,2,105
Iraq,2006-06-01,102,2,-2,9,28,139
Iraq,2006-06-01,97,0,-1,31,11,138
Iraq,2006-06-01,164,0,-3,32,8,201
Iraq,2006-06-01,93,0,-9,17,5,106
Iraq,2006-06-01,14,0,-7,9,8,24
Iraq,2006-06-01,61,0,-6,10,2,67
Morocco,2006-06-01,-3,0,0,6,0,3
Morocco,2006-06-01,0,0,0,3,0,3
Morocco,2006-06-01,1,0,0,6,0,7
Morocco,2006-06-01,0,0,0,0,0,0
Morocco,2006-06-01,0,0,0,3,0,3
Morocco,2006-06-01,1,0,0,0,0,1
Morocco,2006-06-01,10,0,0,3,0,13
Morocco,2006-06-01,-2,0,0,3,0,1
Morocco,2006-06-01,4,0,0,0,0,4
Morocco,2006-06-01,0,0,0,6,0,6
Morocco,2006-06-01,0,0,0,3,0,3
Morocco,2006-06-01,-6,0,0,0,0,-6
Morocco,2006-06-01,5,0,0,-2,0,3
Morocco,2006-06-01,0,0,0,3,0,3
Morocco,2006-06-01,0,0,0,0,0,0
Morocco,2006-06-01,3,0,0,9,0,12
Morocco,2006-06-01,0,0,0,2,0,2
Morocco,2006-06-01,6,0,0,0,0,6
Morocco,2006-06-01,0,0,0,0,0,0
Morocco,2006-06-01,1,0,0,0,0,1
Morocco,2006-06-01,0,0,0,0,2,2
Morocco,2006-06-01,0,0,0,3,2,5
Morocco,2006-06-01,6,0,0,0,0,6
Morocco,2006-06-01,2,0,0,0,0,2
Morocco,2006-06-01,6,0,0,3,0,9
Morocco,2006-06-01,2,0,0,0,0,2
Morocco,2006-06-01,3,0,0,9,0,12
Nigeria,2006-06-01,20,0,-2,8,1,27
Nigeria,2006-06-01,6,0,-1,12,0,17
Nigeria,2006-06-01,3,0,0,6,0,9
Nigeria,2006-06-01,5,0,0,11,1,17
Nigeria,2006-06-01,14,0,0,13,0,27
Nigeria,2006-06-01,23,0,0,1,5,29
Nigeria,2006-06-01,13,0,0,33,3,49
Nigeria,2006-06-01,20,0,0,24,1,45
Nigeria,2006-06-01,2,0,0,3,3,8
Nigeria,2006-06-01,6,0,0,0,0,6
Nigeria,2006-06-01,9,0,0,0,2,11
Nigeria,2006-06-01,-11,0,0,2,0,-9
Nigeria,2006-06-01,4,0,0,6,4,14
Nigeria,2006-06-01,3,0,0,11,0,14
Nigeria,2006-06-01,-3,0,2,27,2,28
Nigeria,2006-06-01,0,0,2,6,0,8
Nigeria,2006-06-01,3,0,0,6,2,11
Nigeria,2006-06-01,4,0,0,0,0,4
Nigeria,2006-06-01,12,0,0,6,0,18
Nigeria,2006-06-01,-1,0,1,3,3,6
Nigeria,2006-06-01,24,0,1,13,13,51
Nigeria,2006-06-01,-20,0,2,1,1,-16
Nigeria,2006-06-01,3,0,0,0,5,8
Nigeria,2006-06-01,4,0,0,0,1,5
Nigeria,2006-06-01,5,0,0,0,1,6
Nigeria,2006-06-01,21,0,0,7,8,36
Nigeria,2006-06-01,35,0,0,33,3,71
Nigeria,2006-06-01,1,0,0,12,0,13
Nigeria,2006-06-01,15,0,0,13,0,28
Nigeria,2006-06-01,9,0,0,3,1,13
Pakistan,2006-06-01,22,0,-2,10,0,30
Pakistan,2006-06-01,36,0,0,5,3,44
Pakistan,2006-06-01,30,6,0,12,5,53
Pakistan,2006-06-01,15,0,1,-1,0,15
Pakistan,2006-06-01,20,0,0,3,0,23
Pakistan,2006-06-01,13,0,0,12,6,31
Pakistan,2006-06-01,8,0,0,12,1,21
Pakistan,2006-06-01,21,0,0,4,1,26
Pakistan,2006-06-01,47,0,-2,14,1,60
Pakistan,2006-06-01,4,0,0,3,0,7
Pakistan,2006-06-01,15,0,0,3,0,18
Pakistan,2006-06-01,22,0,1,4,0,27
Pakistan,2006-06-01,15,0,0,4,2,21
Pakistan,2006-06-01,70,0,1,3,2,76
Pakistan,2006-06-01,16,0,0,9,0,25
Pakistan,2006-06-01,10,0,0,1,0,11
Pakistan,2006-06-01,9,0,0,0,0,9
Pakistan,2006-06-01,18,0,0,-1,0,17
Pakistan,2006-06-01,16,0,0,6,0,22
Pakistan,2006-06-01,31,0,0,-4,2,29
Pakistan,2006-06-01,38,0,0,3,0,41
Pakistan,2006-06-01,25,0,0,0,4,29
Pakistan,2006-06-01,20,0,0,0,4,24
Pakistan,2006-06-01,16,0,0,3,0,19
Pakistan,2006-06-01,18,0,0,3,5,26
Pakistan,2006-06-01,12,0,0,0,1,13
Pakistan,2006-06-01,23,0,0,0,0,23
Pakistan,2006-06-01,29,0,0,9,0,38
Pakistan,2006-06-01,22,0,0,3,0,25
Pakistan,2006-06-01,13,0,0,0,2,15
Sierra Leone,2006-06-01,-1,0,0,0,1,0
Sierra Leone,2006-06-01,-1,0,0,0,2,1
Sierra Leone,2006-06-01,0,0,0,0,0,0
Sierra Leone,2006-06-01,0,0,0,0,0,0
Sierra Leone,2006-06-01,1,0,0,0,0,1
Sierra Leone,2006-06-01,0,0,0,3,0,3
Sierra Leone,2006-06-01,0,0,0,6,0,6
Sierra Leone,2006-06-01,0,0,0,6,1,7
Sierra Leone,2006-06-01,1,0,0,3,0,4
Sierra Leone,2006-06-01,4,0,0,3,0,7
Sierra Leone,2006-06-01,8,0,0,0,1,9
Sierra Leone,2006-06-01,0,0,-4,0,0,-4
Sierra Leone,2006-06-01,10,0,2,27,8,47
Sierra Leone,2006-06-01,9,0,0,18,0,27
Sierra Leone,2006-06-01,0,0,0,0,0,0
Sierra Leone,2006-06-01,0,0,0,0,2,2
Sierra Leone,2006-06-01,12,0,1,21,2,36
Sierra Leone,2006-06-01,22,0,0,1,2,25
Sierra Leone,2006-06-01,3,0,0,0,0,3
Sierra Leone,2006-06-01,2,0,0,12,0,14
Sierra Leone,2006-06-01,0,0,0,0,0,0
Sierra Leone,2006-06-01,0,0,0,0,0,0
Sierra Leone,2006-06-01,0,0,-2,12,0,10
Sierra Leone,2006-06-01,2,0,0,3,0,5
Sierra Leone,2006-06-01,2,0,0,0,0,2
Sierra Leone,2006-06-01,1,4,0,-2,0,3
Somalia,2006-06-01,5,0,0,0,0,5
Somalia,2006-06-01,-1,0,0,2,0,1
Somalia,2006-06-01,0,0,0,-2,0,-2
Somalia,2006-06-01,3,0,0,-4,0,-1
Somalia,2006-06-01,31,0,0,0,0,31
Somalia,2006-06-01,8,0,0,0,0,8
Somalia,2006-06-01,0,0,0,3,0,3
Somalia,2006-06-01,5,0,0,0,0,5
Somalia,2006-06-01,3,0,0,0,0,3
Somalia,2006-06-01,3,0,0,0,0,3
Somalia,2006-06-01,9,0,0,9,1,19
Somalia,2006-06-01,0,0,0,0,0,0
Somalia,2006-06-01,9,0,0,3,1,13
Somalia,2006-06-01,10,0,0,3,0,13
Somalia,2006-06-01,4,0,0,0,0,4
Somalia,2006-06-01,4,0,0,0,1,5
Somalia,2006-06-01,18,0,0,0,0,18
Somalia,2006-06-01,0,0,0,0,0,0
Somalia,2006-06-01,0,0,0,0,0,0
Somalia,2006-06-01,-1,0,0,4,0,3
Somalia,2006-06-01,23,2,0,8,0,33
Somalia,2006-06-01,16,4,0,8,0,28
Somalia,2006-06-01,7,0,0,0,0,7
Somalia,2006-06-01,0,0,0,6,0,6
Somalia,2006-06-01,3,0,0,0,0,3
Somalia,2006-06-01,3,0,0,0,0,3
Somalia,2006-06-01,8,0,0,0,1,9
Somalia,2006-06-01,4,0,0,6,3,13
Somalia,2006-06-01,14,0,-4,6,3,19
Somalia,2006-06-01,5,0,-7,-4,3,-3
Syria,2006-06-01,-9,0,0,3,0,-6
Syria,2006-06-01,-1,0,0,0,2,1
Syria,2006-06-01,11,0,0,-2,0,9
Syria,2006-06-01,4,0,0,6,3,13
Syria,2006-06-01,10,0,0,4,2,16
Syria,2006-06-01,6,0,0,13,0,19
Syria,2006-06-01,0,0,0,6,0,6
Syria,2006-06-01,3,0,0,-1,0,2
Syria,2006-06-01,-1,0,0,0,0,-1
Syria,2006-06-01,40,0,0,21,1,62
Syria,2006-06-01,17,0,0,0,0,17
Syria,2006-06-01,8,0,0,3,1,12
Syria,2006-06-01,8,0,0,5,0,13
Syria,2006-06-01,3,0,2,9,0,14
Syria,2006-06-01,11,0,0,4,0,15
Syria,2006-06-01,-5,0,0,0,0,-5
Syria,2006-06-01,7,0,0,0,0,7
Syria,2006-06-01,6,0,0,-2,0,4
Syria,2006-06-01,0,0,0,-2,0,-2
Syria,2006-06-01,8,0,1,0,0,9
Syria,2006-06-01,3,0,0,4,8,15
Syria,2006-06-01,-6,0,0,12,2,8
Syria,2006-06-01,1,0,0,0,0,1
Syria,2006-06-01,21,0,0,0,0,21
Syria,2006-06-01,2,0,0,6,0,8
Syria,2006-06-01,5,0,0,0,2,7
Syria,2006-06-01,4,0,0,4,0,8
Syria,2006-06-01,29,0,0,10,2,41
Syria,2006-06-01,12,0,2,9,1,24
Syria,2006-06-01,13,0,0,-3,1,11
Yemen,2006-06-01,-2,0,0,0,0,-2
Yemen,2006-06-01,0,0,-1,0,0,-1
Yemen,2006-06-01,0,0,-1,0,0,-1
Yemen,2006-06-01,1,0,0,0,0,1
Yemen,2006-06-01,0,0,0,3,0,3
Yemen,2006-06-01,3,0,0,0,0,3
Yemen,2006-06-01,9,0,0,0,0,9
Yemen,2006-06-01,6,0,0,6,0,12
Yemen,2006-06-01,0,0,0,0,0,0
Yemen,2006-06-01,2,0,0,0,4,6
Yemen,2006-06-01,4,0,0,3,0,7
Yemen,2006-06-01,7,0,0,6,0,13
Yemen,2006-06-01,16,0,0,15,12,43
Yemen,2006-06-01,2,0,1,0,0,3
Yemen,2006-06-01,-1,0,1,0,0,0
Yemen,2006-06-01,5,0,0,12,0,17
Yemen,2006-06-01,-1,0,0,0,0,-1
Yemen,2006-06-01,19,4,0,4,0,27
Yemen,2006-06-01,0,0,0,0,0,0
Yemen,2006-06-01,2,0,0,0,0,2
Yemen,2006-06-01,0,0,-4,0,0,-4
Yemen,2006-06-01,2,0,0,1,0,3
Yemen,2006-06-01,4,0,-4,-2,0,-2
Yemen,2006-06-01,0,0,0,-8,0,-8
Yemen,2006-06-01,0,0,0,0,0,0
Yemen,2006-06-01,0,0,0,0,0,0
Yemen,2006-06-01,14,0,0,17,0,31
Yemen,2006-06-01,17,0,0,21,2,40
Afghanistan,2006-12-01,35,0,0,-5,2,32
Afghanistan,2006-12-01,35,0,0,9,9,53
Afghanistan,2006-12-01,64,0,0,3,19,86
Afghanistan,2006-12-01,44,0,0,11,8,63
Afghanistan,2006-12-01,66,0,0,6,19,91
Afghanistan,2006-12-01,65,2,0,28,84,179
Afghanistan,2006-12-01,52,0,1,27,13,93
Afghanistan,2006-12-01,22,0,0,5,2,29
Afghanistan,2006-12-01,15,0,0,14,3,32
Afghanistan,2006-12-01,19,0,0,3,1,23
Afghanistan,2006-12-01,21,0,0,1,2,24
Afghanistan,2006-12-01,48,0,0,-1,3,50
Afghanistan,2006-12-01,44,0,0,8,2,54
Afghanistan,2006-12-01,32,0,-2,8,8,46
Afghanistan,2006-12-01,18,0,-2,-10,3,9
Afghanistan,2006-12-01,22,0,0,-7,1,16
Afghanistan,2006-12-01,65,0,2,-7,2,62
Afghanistan,2006-12-01,44,0,0,20,4,68
Afghanistan,2006-12-01,64,0,-2,20,6,88
Afghanistan,2006-12-01,49,0,0,9,0,58
Afghanistan,2006-12-01,19,0,-1,14,2,34
Afghanistan,2006-12-01,6,0,-2,9,3,16
Afghanistan,2006-12-01,17,0,0,3,4,24
Afghanistan,2006-12-01,27,0,0,-3,5,29
Afghanistan,2006-12-01,4,0,0,18,6,28
Afghanistan,2006-12-01,60,0,0,11,28,99
Afghanistan,2006-12-01,79,0,0,0,9,88
Afghanistan,2006-12-01,79,0,0,8,12,99
Afghanistan,2006-12-01,28,0,0,14,2,44
Afghanistan,2006-12-01,57,0,0,-2,2,57
Afghanistan,2006-12-01,63,0,0,20,0,83
Albania,2006-12-01,14,0,0,3,0,17
Albania,2006-12-01,6,0,-4,0,1,3
Albania,2006-12-01,-2,0,0,0,0,-2
Albania,2006-12-01,4,0,0,0,0,4
Albania,2006-12-01,3,0,0,0,0,3
Albania,2006-12-01,0,0,-1,0,0,-1
Albania,2006-12-01,1,0,0,0,4,5
Albania,2006-12-01,9,0,1,10,0,20
Albania,2006-12-01,3,0,0,0,0,3
Albania,2006-12-01,2,0,0,6,0,8
Albania,2006-12-01,9,0,0,0,0,9
Albania,2006-12-01,10,0,-2,0,0,8
Albania,2006-12-01,13,0,0,3,0,16
Albania,2006-12-01,2,0,2,-6,2,0
Albania,2006-12-01,6,0,-2,9,2,15
Albania,2006-12-01,0,0,-2,1,1,0
Albania,2006-12-01,0,0,0,8,0,8
Albania,2006-12-01,2,0,0,-2,0,0
Albania,2006-12-01,6,0,0,3,0,9
Albania,2006-12-01,0,0,0,3,0,3
Albania,2006-12-01,6,0,-4,6,0,8
Albania,2006-12-01,3,0,0,3,0,6
Albania,2006-12-01,-2,4,0,3,0,5
Albania,2006-12-01,7,0,0,0,0,7
Albania,2006-12-01,0,0,0,0,0,0
Albania,2006-12-01,1,2,0,0,3,6
Albania,2006-12-01,8,0,-3,0,0,5
Albania,2006-12-01,0,0,0,-4,0,-4
Albania,2006-12-01,9,0,-2,0,0,7
Albania,2006-12-01,3,0,-1,-6,0,-4
Algeria,2006-12-01,0,0,0,0,0,0
Algeria,2006-12-01,0,0,0,0,0,0
Algeria,2006-12-01,3,0,0,0,0,3
Algeria,2006-12-01,0,0,0,0,0,0
Algeria,2006-12-01,-2,0,0,0,0,-2
Algeria,2006-12-01,4,0,0,0,0,4
Algeria,2006-12-01,2,0,0,0,0,2
Algeria,2006-12-01,0,0,0,162,0,162
Algeria,2006-12-01,0,0,0,0,0,0
Algeria,2006-12-01,0,0,0,0,0,0
Algeria,2006-12-01,18,0,1,0,0,19
Algeria,2006-12-01,0,0,0,1,0,1
Algeria,2006-12-01,0,0,0,0,0,0
Algeria,2006-12-01,0,0,0,0,0,0
Algeria,2006-12-01,0,0,0,0,0,0
Algeria,2006-12-01,18,0,0,0,0,18
Algeria,2006-12-01,0,0,0,0,0,0
Algeria,2006-12-01,5,0,0,3,0,8
Algeria,2006-12-01,0,0,0,0,0,0
Algeria,2006-12-01,1,0,0,3,0,4
Algeria,2006-12-01,18,0,0,3,0,21
Algeria,2006-12-01,2,0,0,0,0,2
Algeria,2006-12-01,-5,0,0,0,0,-5
Algeria,2006-12-01,3,0,0,6,0,9
Algeria,2006-12-01,3,0,0,12,0,15
Algeria,2006-12-01,0,0,0,3,0,3
Algeria,2006-12-01,0,0,0,0,0,0
Algeria,2006-12-01,0,0,0,0,0,0
Algeria,2006-12-01,0,0,0,0,0,0
Bangladesh,2006-12-01,6,0,-2,-2,2,4
Bangladesh,2006-12-01,17,0,0,3,0,20
Bangladesh,2006-12-01,0,0,0,0,1,1
Bangladesh,2006-12-01,16,0,0,6,6,28
Bangladesh,2006-12-01,5,0,0,3,3,11
Bangladesh,2006-12-01,3,0,0,0,0,3
Bangladesh,2006-12-01,8,0,0,1,6,15
Bangladesh,2006-12-01,4,0,0,0,0,4
Bangladesh,2006-12-01,15,0,-2,0,1,14
Bangladesh,2006-12-01,15,0,-2,3,0,16
Bangladesh,2006-12-01,5,0,-6,0,0,-1
Bangladesh,2006-12-01,18,0,0,0,0,18
Bangladesh,2006-12-01,9,0,1,6,1,17
Bangladesh,2006-12-01,4,0,-2,9,0,11
Bangladesh,2006-12-01,14,0,0,0,0,14
Bangladesh,2006-12-01,8,0,0,5,0,13
Bangladesh,2006-12-01,6,0,0,1,0,7
Bangladesh,2006-12-01,2,2,3,4,-2,9
Bangladesh,2006-12-01,1,0,0,3,1,5
Bangladesh,2006-12-01,6,0,2,3,4,15
Bangladesh,2006-12-01,12,0,0,0,0,12
Bangladesh,2006-12-01,2,0,2,0,0,4
Bangladesh,2006-12-01,5,0,0,0,2,7
Bangladesh,2006-12-01,-2,0,0,0,0,-2
Bangladesh,2006-12-01,0,0,-4,0,-2,-6
Bangladesh,2006-12-01,2,0,0,6,0,8
Bangladesh,2006-12-01,6,0,0,3,0,9
Bangladesh,2006-12-01,9,0,-2,0,1,8
Bangladesh,2006-12-01,18,0,-2,7,2,25
Bangladesh,2006-12-01,0,0,0,0,1,1
Bangladesh,2006-12-01,10,0,0,9,1,20
Cameroon,2006-12-01,3,0,0,0,0,3
Cameroon,2006-12-01,3,0,0,0,0,3
Cameroon,2006-12-01,0,0,0,0,0,0
Cameroon,2006-12-01,0,0,0,0,0,0
Cameroon,2006-12-01,0,0,0,0,0,0
Cameroon,2006-12-01,-1,0,0,0,0,-1
Cameroon,2006-12-01,0,0,0,0,0,0
Cameroon,2006-12-01,0,0,0,0,0,0
Cameroon,2006-12-01,0,0,0,3,0,3
Cameroon,2006-12-01,0,0,0,0,0,0
Cameroon,2006-12-01,-1,0,0,0,0,-1
Cameroon,2006-12-01,0,0,0,0,0,0
Cameroon,2006-12-01,0,0,0,0,0,0
Cameroon,2006-12-01,0,0,0,3,0,3
Cameroon,2006-12-01,0,0,0,0,0,0
Cameroon,2006-12-01,0,0,0,0,0,0
Cameroon,2006-12-01,0,0,0,0,0,0
Cameroon,2006-12-01,0,0,0,0,0,0
Cameroon,2006-12-01,0,0,0,0,0,0
Cameroon,2006-12-01,0,0,0,0,1,1
Cameroon,2006-12-01,-3,0,0,0,0,-3
Cameroon,2006-12-01,2,0,0,0,0,2
Cameroon,2006-12-01,0,0,0,0,0,0
China,2006-12-01,45,0,0,5,5,55
China,2006-12-01,7,0,0,4,3,14
China,2006-12-01,18,0,1,6,0,25
China,2006-12-01,33,0,-1,0,4,36
China,2006-12-01,16,0,-4,27,2,41
China,2006-12-01,29,0,4,21,6,60
China,2006-12-01,19,0,1,8,9,37
China,2006-12-01,13,0,-1,49,0,61
China,2006-12-01,6,0,0,9,3,18
China,2006-12-01,7,0,-2,6,3,14
China,2006-12-01,29,2,0,11,2,44
China,2006-12-01,50,0,0,6,3,59
China,2006-12-01,34,0,0,19,2,55
China,2006-12-01,27,0,0,3,2,32
China,2006-12-01,16,0,0,31,3,50
China,2006-12-01,-2,0,-4,21,6,21
China,2006-12-01,7,0,0,6,1,14
China,2006-12-01,22,0,0,1,2,25
China,2006-12-01,34,2,-1,21,0,56
China,2006-12-01,58,0,-1,39,1,97
China,2006-12-01,35,0,3,3,3,44
China,2006-12-01,18,0,2,25,7,52
China,2006-12-01,33,0,-2,11,1,43
China,2006-12-01,10,0,0,15,2,27
China,2006-12-01,9,0,0,0,6,15
China,2006-12-01,12,0,0,6,0,18
China,2006-12-01,3,0,0,3,2,8
China,2006-12-01,34,0,0,9,2,45
China,2006-12-01,72,0,0,29,5,106
China,2006-12-01,16,0,1,6,1,24
China,2006-12-01,27,0,-2,10,2,37
Egypt,2006-12-01,13,0,0,12,0,25
Egypt,2006-12-01,1,0,0,0,0,1
Egypt,2006-12-01,19,0,0,6,0,25
Egypt,2006-12-01,9,0,0,3,1,13
Egypt,2006-12-01,4,0,0,12,0,16
Egypt,2006-12-01,3,0,0,0,0,3
Egypt,2006-12-01,3,0,-2,4,0,5
Egypt,2006-12-01,15,0,0,6,0,21
Egypt,2006-12-01,2,0,-2,9,1,10
Egypt,2006-12-01,12,0,0,12,3,27
Egypt,2006-12-01,11,0,2,-3,3,13
Egypt,2006-12-01,13,0,0,0,0,13
Egypt,2006-12-01,35,0,0,0,0,35
Egypt,2006-12-01,28,0,0,9,2,39
Egypt,2006-12-01,85,0,3,1,8,97
Egypt,2006-12-01,30,0,0,6,4,40
Egypt,2006-12-01,13,0,0,2,0,15
Egypt,2006-12-01,46,0,0,7,1,54
Egypt,2006-12-01,26,0,3,0,0,29
Egypt,2006-12-01,16,0,0,-2,2,16
Egypt,2006-12-01,3,0,2,0,0,5
Egypt,2006-12-01,24,0,0,0,0,24
Egypt,2006-12-01,3,0,0,-2,1,2
Egypt,2006-12-01,10,0,0,0,0,10
Egypt,2006-12-01,10,0,0,0,0,10
Egypt,2006-12-01,10,0,3,0,0,13
Egypt,2006-12-01,32,0,0,22,1,55
Egypt,2006-12-01,4,0,0,1,0,5
Egypt,2006-12-01,2,0,0,3,2,7
Egypt,2006-12-01,1,0,0,6,4,11
Egypt,2006-12-01,27,0,0,-10,4,21
Eritrea,2006-12-01,8,0,0,0,0,8
Eritrea,2006-12-01,12,0,1,3,0,16
Eritrea,2006-12-01,2,0,0,0,0,2
Eritrea,2006-12-01,6,0,0,0,0,6
Eritrea,2006-12-01,3,0,0,3,0,6
Eritrea,2006-12-01,1,0,0,0,0,1
Eritrea,2006-12-01,29,0,0,0,0,29
Eritrea,2006-12-01,11,0,0,15,0,26
Eritrea,2006-12-01,7,0,0,0,0,7
Eritrea,2006-12-01,0,0,0,6,0,6
Eritrea,2006-12-01,5,0,0,0,0,5
Eritrea,2006-12-01,8,0,0,3,0,11
Eritrea,2006-12-01,0,0,0,6,0,6
Eritrea,2006-12-01,4,0,0,0,0,4
Eritrea,2006-12-01,3,0,0,0,0,3
Eritrea,2006-12-01,0,0,0,0,0,0
Eritrea,2006-12-01,0,0,0,0,0,0
Eritrea,2006-12-01,3,0,0,0,0,3
Eritrea,2006-12-01,1,0,0,3,0,4
Eritrea,2006-12-01,21,0,0,0,0,21
Eritrea,2006-12-01,23,0,0,0,0,23
Eritrea,2006-12-01,13,0,0,2,0,15
Eritrea,2006-12-01,35,0,0,0,1,36
Eritrea,2006-12-01,13,0,0,0,0,13
Eritrea,2006-12-01,23,0,0,0,1,24
Eritrea,2006-12-01,18,0,0,0,0,18
Eritrea,2006-12-01,17,0,0,0,0,17
Eritrea,2006-12-01,6,0,0,0,2,8
Eritrea,2006-12-01,4,0,0,0,0,4
Eritrea,2006-12-01,8,0,0,6,0,14
Eritrea,2006-12-01,8,0,0,0,0,8
Georgia,2006-12-01,-2,0,0,0,0,-2
Georgia,2006-12-01,2,0,0,0,0,2
Georgia,2006-12-01,0,0,0,0,0,0
Georgia,2006-12-01,14,0,0,0,0,14
Georgia,2006-12-01,3,0,0,-2,0,1
Georgia,2006-12-01,2,0,0,0,0,2
Georgia,2006-12-01,0,0,0,4,0,4
Georgia,2006-12-01,3,0,0,0,1,4
Georgia,2006-12-01,5,0,0,6,0,11
Georgia,2006-12-01,0,0,0,0,0,0
Georgia,2006-12-01,1,0,0,0,0,1
Georgia,2006-12-01,4,0,0,0,0,4
Georgia,2006-12-01,2,0,0,-2,1,1
Georgia,2006-12-01,-3,0,-1,3,2,1
Georgia,2006-12-01,2,0,0,0,0,2
Georgia,2006-12-01,6,0,0,0,0,6
Georgia,2006-12-01,5,0,0,0,0,5
Georgia,2006-12-01,1,0,-2,1,0,0
Georgia,2006-12-01,6,0,0,1,1,8
Georgia,2006-12-01,1,0,-2,0,0,-1
Georgia,2006-12-01,3,0,0,12,0,15
Georgia,2006-12-01,-1,0,0,0,0,-1
Georgia,2006-12-01,-1,0,0,0,0,-1
Georgia,2006-12-01,-1,0,0,0,0,-1
Georgia,2006-12-01,0,0,0,0,2,2
Georgia,2006-12-01,0,0,-1,0,0,-1
Georgia,2006-12-01,5,0,0,0,2,7
Georgia,2006-12-01,0,0,0,0,0,0
Georgia,2006-12-01,5,0,0,0,0,5
Georgia,2006-12-01,0,0,0,0,0,0
India,2006-12-01,12,0,0,1,0,13
India,2006-12-01,3,0,0,9,0,12
India,2006-12-01,20,0,0,6,0,26
India,2006-12-01,18,0,0,-2,3,19
India,2006-12-01,7,0,0,3,1,11
India,2006-12-01,7,2,3,15,6,33
India,2006-12-01,5,2,0,4,0,11
India,2006-12-01,17,0,0,-5,1,13
India,2006-12-01,22,0,0,6,0,28
India,2006-12-01,5,0,0,0,0,5
India,2006-12-01,38,0,0,8,1,47
India,2006-12-01,7,0,0,11,1,19
India,2006-12-01,16,0,0,-2,6,20
India,2006-12-01,8,0,0,6,2,16
India,2006-12-01,14,0,0,7,0,21
India,2006-12-01,10,0,0,0,1,11
India,2006-12-01,6,0,0,3,3,12
India,2006-12-01,6,0,0,7,0,13
India,2006-12-01,23,0,0,-2,3,24
India,2006-12-01,27,0,0,11,3,41
India,2006-12-01,6,0,0,4,2,12
India,2006-12-01,19,0,1,2,4,26
India,2006-12-01,8,0,0,6,4,18
India,2006-12-01,8,0,0,0,0,8
India,2006-12-01,2,0,-2,0,-1,-1
India,2006-12-01,12,0,0,-2,1,11
India,2006-12-01,34,6,0,8,8,56
India,2006-12-01,12,2,0,-1,4,17
India,2006-12-01,16,0,2,-4,1,15
India,2006-12-01,11,0,0,3,2,16
India,2006-12-01,8,0,0,1,1,10
Iran,2006-12-01,26,0,0,7,1,34
Iran,2006-12-01,27,0,1,9,4,41
Iran,2006-12-01,25,0,0,0,1,26
Iran,2006-12-01,29,0,-9,6,2,28
Iran,2006-12-01,96,6,-8,14,4,112
Iran,2006-12-01,62,4,0,28,10,104
Iran,2006-12-01,42,8,0,3,10,63
Iran,2006-12-01,42,6,0,12,3,63
Iran,2006-12-01,17,0,-2,-1,5,19
Iran,2006-12-01,37,0,-3,-8,3,29
Iran,2006-12-01,52,0,-2,11,16,77
Iran,2006-12-01,66,0,-6,27,14,101
Iran,2006-12-01,64,0,3,-1,3,69
Iran,2006-12-01,33,0,-1,7,5,44
Iran,2006-12-01,44,2,2,18,3,69
Iran,2006-12-01,23,0,1,-2,2,24
Iran,2006-12-01,36,4,0,-7,0,33
Iran,2006-12-01,26,0,-2,23,0,47
Iran,2006-12-01,50,0,-2,20,3,71
Iran,2006-12-01,42,2,1,14,1,60
Iran,2006-12-01,18,2,1,18,2,41
Iran,2006-12-01,8,0,0,2,3,13
Iran,2006-12-01,35,4,0,13,0,52
Iran,2006-12-01,54,0,0,17,19,90
Iran,2006-12-01,31,0,1,42,0,74
Iran,2006-12-01,27,0,0,4,1,32
Iran,2006-12-01,32,2,1,18,4,57
Iran,2006-12-01,42,0,5,7,6,60
Iran,2006-12-01,21,0,3,-4,5,25
Iran,2006-12-01,47,0,1,36,7,91
Iran,2006-12-01,22,0,0,1,4,27
Iraq,2006-12-01,88,4,0,12,9,113
Iraq,2006-12-01,33,10,0,19,6,68
Iraq,2006-12-01,50,8,2,15,10,85
Iraq,2006-12-01,66,0,0,20,23,109
Iraq,2006-12-01,160,0,-2,18,12,188
Iraq,2006-12-01,130,0,4,17,21,172
Iraq,2006-12-01,132,4,-5,26,17,174
Iraq,2006-12-01,94,4,2,29,14,143
Iraq,2006-12-01,56,0,-3,11,13,77
Iraq,2006-12-01,49,2,1,-3,15,64
Iraq,2006-12-01,73,0,0,27,13,113
Iraq,2006-12-01,69,2,1,41,14,127
Iraq,2006-12-01,83,8,-3,14,23,125
Iraq,2006-12-01,80,8,-5,26,17,126
Iraq,2006-12-01,134,0,-3,24,2,157
Iraq,2006-12-01,107,0,1,11,3,122
Iraq,2006-12-01,40,0,-2,6,3,47
Iraq,2006-12-01,105,0,0,20,19,144
Iraq,2006-12-01,128,0,-4,17,6,147
Iraq,2006-12-01,151,0,-5,36,8,190
Iraq,2006-12-01,53,0,-2,13,10,74
Iraq,2006-12-01,80,0,0,16,4,100
Iraq,2006-12-01,76,0,0,33,9,118
Iraq,2006-12-01,57,0,0,-7,0,50
Iraq,2006-12-01,34,0,-1,65,3,101
Iraq,2006-12-01,49,0,0,15,0,64
Iraq,2006-12-01,79,0,4,18,13,114
Iraq,2006-12-01,109,2,5,13,13,142
Iraq,2006-12-01,118,0,-2,19,18,153
Iraq,2006-12-01,137,0,5,39,21,202
Iraq,2006-12-01,198,0,-1,35,25,257
Morocco,2006-12-01,5,0,0,0,0,5
Morocco,2006-12-01,0,0,0,9,1,10
Morocco,2006-12-01,3,0,0,0,0,3
Morocco,2006-12-01,2,0,0,0,0,2
Morocco,2006-12-01,0,0,0,0,0,0
Morocco,2006-12-01,0,0,0,0,0,0
Morocco,2006-12-01,0,0,0,0,0,0
Morocco,2006-12-01,0,0,0,0,0,0
Morocco,2006-12-01,2,0,0,0,0,2
Morocco,2006-12-01,0,0,0,6,0,6
Morocco,2006-12-01,24,0,0,0,0,24
Morocco,2006-12-01,9,0,0,0,0,9
Morocco,2006-12-01,9,0,0,6,0,15
Morocco,2006-12-01,12,0,0,0,0,12
Morocco,2006-12-01,9,0,0,0,0,9
Morocco,2006-12-01,0,0,0,0,0,0
Morocco,2006-12-01,0,0,0,0,0,0
Morocco,2006-12-01,6,0,0,9,0,15
Morocco,2006-12-01,2,0,0,6,0,8
Morocco,2006-12-01,0,0,0,0,0,0
Morocco,2006-12-01,-5,0,0,0,0,-5
Morocco,2006-12-01,0,0,0,0,0,0
Morocco,2006-12-01,0,0,0,0,0,0
Morocco,2006-12-01,0,0,0,6,1,7
Morocco,2006-12-01,12,0,0,6,0,18
Nigeria,2006-12-01,4,0,-2,6,0,8
Nigeria,2006-12-01,3,0,0,3,0,6
Nigeria,2006-12-01,5,0,0,12,4,21
Nigeria,2006-12-01,11,0,0,0,0,11
Nigeria,2006-12-01,-1,2,-2,-2,0,-3
Nigeria,2006-12-01,4,0,0,-1,1,4
Nigeria,2006-12-01,18,0,0,3,2,23
Nigeria,2006-12-01,11,0,0,9,0,20
Nigeria,2006-12-01,12,0,0,0,0,12
Nigeria,2006-12-01,1,0,-2,0,0,-1
Nigeria,2006-12-01,8,0,0,5,2,15
Nigeria,2006-12-01,9,0,0,6,3,18
Nigeria,2006-12-01,8,0,1,3,1,13
Nigeria,2006-12-01,1,0,0,10,2,13
Nigeria,2006-12-01,26,0,0,0,1,27
Nigeria,2006-12-01,7,0,0,0,1,8
Nigeria,2006-12-01,11,0,0,9,2,22
Nigeria,2006-12-01,27,0,0,6,0,33
Nigeria,2006-12-01,14,0,0,5,4,23
Nigeria,2006-12-01,4,0,0,6,7,17
Nigeria,2006-12-01,10,0,0,3,1,14
Nigeria,2006-12-01,17,0,0,1,3,21
Nigeria,2006-12-01,8,0,0,9,0,17
Nigeria,2006-12-01,19,0,0,9,2,30
Nigeria,2006-12-01,26,0,0,9,11,46
Nigeria,2006-12-01,21,0,2,3,4,30
Nigeria,2006-12-01,7,4,0,1,1,13
Nigeria,2006-12-01,13,0,0,2,5,20
Nigeria,2006-12-01,2,0,0,0,0,2
Nigeria,2006-12-01,3,0,0,0,0,3
Nigeria,2006-12-01,13,0,0,2,0,15
Pakistan,2006-12-01,37,0,0,21,4,62
Pakistan,2006-12-01,16,0,0,0,4,20
Pakistan,2006-12-01,11,0,0,1,2,14
Pakistan,2006-12-01,8,0,0,3,0,11
Pakistan,2006-12-01,25,0,0,15,4,44
Pakistan,2006-12-01,23,0,0,3,3,29
Pakistan,2006-12-01,21,0,0,-4,16,33
Pakistan,2006-12-01,49,0,3,3,13,68
Pakistan,2006-12-01,23,0,2,7,0,32
Pakistan,2006-12-01,39,0,5,22,1,67
Pakistan,2006-12-01,18,0,0,3,0,21
Pakistan,2006-12-01,25,0,0,-1,2,26
Pakistan,2006-12-01,27,0,0,14,7,48
Pakistan,2006-12-01,15,0,1,9,2,27
Pakistan,2006-12-01,42,0,0,1,0,43
Pakistan,2006-12-01,17,0,0,10,0,27
Pakistan,2006-12-01,12,0,0,1,5,18
Pakistan,2006-12-01,17,0,0,-6,6,17
Pakistan,2006-12-01,18,0,0,6,3,27
Pakistan,2006-12-01,9,0,0,12,0,21
Pakistan,2006-12-01,5,0,0,7,0,12
Pakistan,2006-12-01,21,0,0,3,0,24
Pakistan,2006-12-01,56,0,0,6,0,62
Pakistan,2006-12-01,56,0,0,21,1,78
Pakistan,2006-12-01,34,0,0,18,1,53
Pakistan,2006-12-01,15,0,0,27,0,42
Pakistan,2006-12-01,22,0,0,0,0,22
Pakistan,2006-12-01,8,0,0,12,0,20
Pakistan,2006-12-01,7,0,0,24,0,31
Pakistan,2006-12-01,11,0,0,6,0,17
Pakistan,2006-12-01,18,0,0,12,0,30
Sierra Leone,2006-12-01,0,0,0,0,0,0
Sierra Leone,2006-12-01,0,0,0,0,0,0
Sierra Leone,2006-12-01,3,0,0,0,0,3
Sierra Leone,2006-12-01,2,0,0,6,0,8
Sierra Leone,2006-12-01,2,0,0,18,0,20
Sierra Leone,2006-12-01,0,0,0,8,0,8
Sierra Leone,2006-12-01,-3,0,0,6,0,3
Sierra Leone,2006-12-01,2,0,0,0,0,2
Sierra Leone,2006-12-01,0,0,0,0,0,0
Sierra Leone,2006-12-01,2,0,0,0,0,2
Sierra Leone,2006-12-01,3,0,0,0,1,4
Sierra Leone,2006-12-01,3,0,0,0,0,3
Sierra Leone,2006-12-01,0,0,0,0,0,0
Sierra Leone,2006-12-01,0,0,0,0,0,0
Sierra Leone,2006-12-01,1,0,0,3,0,4
Sierra Leone,2006-12-01,0,0,0,0,0,0
Sierra Leone,2006-12-01,0,0,0,0,0,0
Sierra Leone,2006-12-01,9,0,0,0,0,9
Sierra Leone,2006-12-01,1,0,0,0,0,1
Sierra Leone,2006-12-01,1,0,0,0,0,1
Sierra Leone,2006-12-01,3,0,0,-2,0,1
Sierra Leone,2006-12-01,0,0,0,0,0,0
Sierra Leone,2006-12-01,0,0,0,0,1,1
Sierra Leone,2006-12-01,4,0,0,3,0,7
Sierra Leone,2006-12-01,0,0,0,3,0,3
Sierra Leone,2006-12-01,0,0,0,0,0,0
Somalia,2006-12-01,9,0,0,0,1,10
Somalia,2006-12-01,3,0,0,3,0,6
Somalia,2006-12-01,2,0,0,0,0,2
Somalia,2006-12-01,14,0,0,11,3,28
Somalia,2006-12-01,30,2,1,2,0,35
Somalia,2006-12-01,3,0,0,0,0,3
Somalia,2006-12-01,67,4,0,9,0,80
Somalia,2006-12-01,12,0,0,4,0,16
Somalia,2006-12-01,7,0,0,0,0,7
Somalia,2006-12-01,0,0,0,18,0,18
Somalia,2006-12-01,6,2,0,-2,0,6
Somalia,2006-12-01,5,0,0,0,0,5
Somalia,2006-12-01,13,0,0,0,0,13
Somalia,2006-12-01,6,2,0,0,0,8
Somalia,2006-12-01,11,0,0,-4,0,7
Somalia,2006-12-01,3,0,0,0,2,5
Somalia,2006-12-01,11,0,0,0,0,11
Somalia,2006-12-01,4,0,0,0,0,4
Somalia,2006-12-01,1,0,0,-2,0,-1
Somalia,2006-12-01,18,0,0,18,0,36
Somalia,2006-12-01,11,0,0,6,5,22
Somalia,2006-12-01,8,0,0,0,0,8
Somalia,2006-12-01,25,0,0,0,0,25
Somalia,2006-12-01,5,0,0,0,0,5
Somalia,2006-12-01,15,0,0,3,0,18
Somalia,2006-12-01,36,0,0,3,0,39
Somalia,2006-12-01,45,8,3,1,0,57
Somalia,2006-12-01,28,2,-1,10,2,41
Somalia,2006-12-01,17,0,0,7,2,26
Somalia,2006-12-01,2,0,0,0,0,2
Somalia,2006-12-01,-6,0,0,0,0,-6
Syria,2006-12-01,51,0,-2,0,12,61
Syria,2006-12-01,16,0,3,6,4,29
Syria,2006-12-01,34,0,0,-2,1,33
Syria,2006-12-01,60,0,0,5,8,73
Syria,2006-12-01,34,4,2,9,7,56
Syria,2006-12-01,27,0,0,9,3,39
Syria,2006-12-01,61,0,0,27,18,106
Syria,2006-12-01,27,0,2,2,12,43
Syria,2006-12-01,6,0,2,18,6,32
Syria,2006-12-01,36,0,0,46,9,91
Syria,2006-12-01,8,0,-3,0,3,8
Syria,2006-12-01,10,0,0,22,-8,24
Syria,2006-12-01,10,0,-2,6,5,19
Syria,2006-12-01,31,0,0,15,3,49
Syria,2006-12-01,20,0,0,12,2,34
Syria,2006-12-01,20,0,1,0,1,22
Syria,2006-12-01,25,2,0,0,0,27
Syria,2006-12-01,15,0,1,0,1,17
Syria,2006-12-01,25,0,0,7,2,34
Syria,2006-12-01,5,2,-2,12,1,18
Syria,2006-12-01,17,4,0,24,0,45
Syria,2006-12-01,3,0,0,0,0,3
Syria,2006-12-01,5,0,0,0,1,6
Syria,2006-12-01,12,0,-4,-4,0,4
Syria,2006-12-01,4,0,1,0,0,5
Syria,2006-12-01,14,0,-2,3,0,15
Syria,2006-12-01,4,0,-2,3,1,6
Syria,2006-12-01,6,0,0,3,0,9
Syria,2006-12-01,5,0,-2,3,0,6
Syria,2006-12-01,12,0,0,0,0,12
Syria,2006-12-01,12,0,0,0,0,12
Yemen,2006-12-01,3,0,0,7,0,10
Yemen,2006-12-01,3,0,0,0,0,3
Yemen,2006-12-01,7,0,0,0,0,7
Yemen,2006-12-01,0,0,0,0,0,0
Yemen,2006-12-01,7,0,1,3,2,13
Yemen,2006-12-01,5,0,0,36,0,41
Yemen,2006-12-01,9,0,0,9,0,18
Yemen,2006-12-01,5,0,0,8,1,14
Yemen,2006-12-01,-1,0,0,0,0,-1
Yemen,2006-12-01,4,0,0,6,2,12
Yemen,2006-12-01,0,0,0,-2,0,-2
Yemen,2006-12-01,2,0,0,0,0,2
Yemen,2006-12-01,-1,0,0,6,0,5
Yemen,2006-12-01,4,0,0,12,0,16
Yemen,2006-12-01,4,0,0,0,3,7
Yemen,2006-12-01,4,0,0,6,0,10
Yemen,2006-12-01,-3,0,0,-1,0,-4
Yemen,2006-12-01,-1,0,0,-4,0,-5
Yemen,2006-12-01,-6,0,0,-4,0,-10
Yemen,2006-12-01,6,2,0,9,0,17
Yemen,2006-12-01,0,0,0,0,0,0
Yemen,2006-12-01,0,0,0,0,0,0
Yemen,2006-12-01,0,0,0,0,0,0
Yemen,2006-12-01,2,0,0,0,0,2
Yemen,2006-12-01,1,0,0,0,0,1
Yemen,2006-12-01,6,0,0,12,0,18
Yemen,2006-12-01,28,0,0,12,0,40
Yemen,2006-12-01,27,0,0,15,0,42
Yemen,2006-12-01,4,0,0,0,0,4
Yemen,2006-12-01,3,0,0,0,0,3
Afghanistan,2008-09-01,164,0,1,8,9,182
Afghanistan,2008-09-01,54,0,-3,12,3,66
Afghanistan,2008-09-01,33,0,0,3,1,37
Afghanistan,2008-09-01,82,0,0,10,3,95
Afghanistan,2008-09-01,58,0,0,12,4,74
Afghanistan,2008-09-01,26,0,1,3,4,34
Afghanistan,2008-09-01,258,0,3,5,66,332
Afghanistan,2008-09-01,132,0,0,21,15,168
Afghanistan,2008-09-01,300,0,-5,47,30,372
Afghanistan,2008-09-01,294,0,-2,25,16,333
Afghanistan,2008-09-01,347,6,0,31,44,428
Afghanistan,2008-09-01,294,2,0,26,8,330
Afghanistan,2008-09-01,132,0,0,24,17,173
Afghanistan,2008-09-01,172,4,0,7,21,204
Afghanistan,2008-09-01,223,0,0,-1,11,233
Afghanistan,2008-09-01,265,0,-2,81,10,354
Afghanistan,2008-09-01,214,0,-1,-4,6,215
Afghanistan,2008-09-01,129,0,-3,28,8,162
Afghanistan,2008-09-01,58,0,-1,13,0,70
Afghanistan,2008-09-01,161,0,0,18,14,193
Afghanistan,2008-09-01,119,0,-2,16,5,138
Afghanistan,2008-09-01,279,0,-3,70,48,394
Afghanistan,2008-09-01,188,0,0,74,22,284
Afghanistan,2008-09-01,108,0,-3,53,13,171
Afghanistan,2008-09-01,171,4,4,21,11,211
Afghanistan,2008-09-01,200,2,-6,36,25,257
Afghanistan,2008-09-01,82,0,0,2,3,87
Afghanistan,2008-09-01,143,0,0,24,10,177
Afghanistan,2008-09-01,232,0,0,8,25,265
Afghanistan,2008-09-01,223,6,0,-1,4,232
Albania,2008-09-01,0,2,0,0,0,2
Albania,2008-09-01,6,0,0,0,0,6
Albania,2008-09-01,12,0,0,0,0,12
Albania,2008-09-01,2,0,0,-2,1,1
Albania,2008-09-01,4,0,0,6,0,10
Albania,2008-09-01,0,0,0,0,0,0
Albania,2008-09-01,4,0,0,9,2,15
Albania,2008-09-01,5,0,0,3,3,11
Albania,2008-09-01,4,0,0,0,0,4
Albania,2008-09-01,6,0,-1,4,0,9
Albania,2008-09-01,1,0,-2,12,0,11
Albania,2008-09-01,5,0,0,0,0,5
Albania,2008-09-01,14,0,0,-2,0,12
Albania,2008-09-01,5,0,0,0,0,5
Albania,2008-09-01,6,0,1,0,0,7
Albania,2008-09-01,6,0,0,0,0,6
Albania,2008-09-01,9,0,0,0,1,10
Albania,2008-09-01,0,0,0,3,0,3
Albania,2008-09-01,7,0,0,3,0,10
Albania,2008-09-01,3,0,0,6,0,9
Albania,2008-09-01,1,0,0,0,0,1
Albania,2008-09-01,0,0,0,0,0,0
Albania,2008-09-01,0,0,0,9,0,9
Albania,2008-09-01,12,0,0,-2,0,10
Albania,2008-09-01,3,0,0,0,0,3
Albania,2008-09-01,7,0,0,0,0,7
Albania,2008-09-01,8,0,0,0,0,8
Albania,2008-09-01,6,0,0,3,0,9
Albania,2008-09-01,10,0,-2,0,2,10
Algeria,2008-09-01,0,0,0,0,6,6
Algeria,2008-09-01,1,0,0,0,0,1
Algeria,2008-09-01,0,0,0,0,0,0
Algeria,2008-09-01,0,0,0,0,0,0
Algeria,2008-09-01,0,0,0,0,0,0
Algeria,2008-09-01,1,0,0,0,0,1
Algeria,2008-09-01,57,0,0,3,1,61
Algeria,2008-09-01,3,0,0,0,0,3
Algeria,2008-09-01,2,0,0,0,0,2
Algeria,2008-09-01,0,0,0,3,0,3
Algeria,2008-09-01,4,0,0,1,0,5
Algeria,2008-09-01,3,0,0,12,0,15
Algeria,2008-09-01,0,0,0,0,0,0
Algeria,2008-09-01,0,0,0,0,0,0
Algeria,2008-09-01,5,0,0,6,0,11
Algeria,2008-09-01,3,0,0,0,0,3
Algeria,2008-09-01,5,0,0,0,0,5
Algeria,2008-09-01,1,0,0,0,0,1
Algeria,2008-09-01,1,0,0,0,0,1
Algeria,2008-09-01,12,2,0,3,0,17
Algeria,2008-09-01,6,0,0,-2,0,4
Algeria,2008-09-01,6,0,0,3,0,9
Algeria,2008-09-01,6,0,0,0,0,6
Algeria,2008-09-01,5,0,-2,3,0,6
Algeria,2008-09-01,7,0,0,0,0,7
Algeria,2008-09-01,0,0,0,0,0,0
Algeria,2008-09-01,0,0,0,0,0,0
Algeria,2008-09-01,4,0,0,0,0,4
Algeria,2008-09-01,5,0,0,0,0,5
Algeria,2008-09-01,4,0,0,-8,0,-4
Bangladesh,2008-09-01,4,0,7,4,0,15
Bangladesh,2008-09-01,-2,0,0,30,0,28
Bangladesh,2008-09-01,0,0,0,6,2,8
Bangladesh,2008-09-01,3,0,2,-4,0,1
Bangladesh,2008-09-01,17,0,0,0,0,17
Bangladesh,2008-09-01,17,0,0,-4,4,17
Bangladesh,2008-09-01,0,0,0,3,2,5
Bangladesh,2008-09-01,6,0,0,9,0,15
Bangladesh,2008-09-01,2,0,0,-2,6,6
Bangladesh,2008-09-01,12,2,0,-1,0,13
Bangladesh,2008-09-01,2,0,-2,-11,0,-11
Bangladesh,2008-09-01,0,0,0,14,1,15
Bangladesh,2008-09-01,6,0,0,-1,2,7
Bangladesh,2008-09-01,8,0,0,-10,0,-2
Bangladesh,2008-09-01,1,0,0,0,2,3
Bangladesh,2008-09-01,0,0,0,-10,0,-10
Bangladesh,2008-09-01,6,0,0,12,2,20
Bangladesh,2008-09-01,8,0,0,21,0,29
Bangladesh,2008-09-01,1,0,0,5,0,6
Bangladesh,2008-09-01,-2,0,-4,10,1,5
Bangladesh,2008-09-01,-1,0,0,3,0,2
Bangladesh,2008-09-01,2,0,0,12,1,15
Bangladesh,2008-09-01,-2,0,0,9,0,7
Bangladesh,2008-09-01,0,0,0,12,0,12
Bangladesh,2008-09-01,16,0,0,6,0,22
Bangladesh,2008-09-01,1,0,0,0,0,1
Bangladesh,2008-09-01,0,0,0,0,0,0
Bangladesh,2008-09-01,3,0,2,14,0,19
Bangladesh,2008-09-01,4,0,0,9,1,14
Cameroon,2008-09-01,0,0,0,0,0,0
Cameroon,2008-09-01,0,0,-4,0,0,-4
Cameroon,2008-09-01,0,0,0,0,0,0
Cameroon,2008-09-01,0,0,0,0,0,0
Cameroon,2008-09-01,0,0,0,0,0,0
Cameroon,2008-09-01,0,0,0,0,0,0
Cameroon,2008-09-01,0,0,0,0,0,0
Cameroon,2008-09-01,0,0,0,0,0,0
Cameroon,2008-09-01,0,0,0,0,0,0
Cameroon,2008-09-01,2,0,0,0,0,2
Cameroon,2008-09-01,0,0,0,3,0,3
Cameroon,2008-09-01,0,0,0,0,0,0
Cameroon,2008-09-01,3,0,0,3,0,6
Cameroon,2008-09-01,10,0,0,0,0,10
Cameroon,2008-09-01,0,0,0,0,0,0
Cameroon,2008-09-01,1,0,0,0,0,1
Cameroon,2008-09-01,0,0,0,0,0,0
China,2008-09-01,61,0,-6,32,3,90
China,2008-09-01,37,0,1,51,6,95
China,2008-09-01,30,0,0,9,0,39
China,2008-09-01,9,0,0,-2,3,10
China,2008-09-01,8,0,0,6,-2,12
China,2008-09-01,1,0,-1,0,0,0
China,2008-09-01,45,0,-1,9,3,56
China,2008-09-01,15,2,0,22,0,39
China,2008-09-01,100,0,-2,20,10,128
China,2008-09-01,50,2,1,20,16,89
China,2008-09-01,63,4,-1,9,12,87
China,2008-09-01,31,0,-2,49,12,90
China,2008-09-01,58,6,0,35,7,106
China,2008-09-01,44,2,0,23,5,74
China,2008-09-01,39,0,-8,53,13,97
China,2008-09-01,52,0,0,29,2,83
China,2008-09-01,55,2,-5,22,3,77
China,2008-09-01,28,0,-2,18,7,51
China,2008-09-01,55,0,2,56,15,128
China,2008-09-01,28,0,0,6,1,35
China,2008-09-01,43,0,0,9,2,54
China,2008-09-01,127,0,1,36,2,166
China,2008-09-01,16,6,0,51,1,74
China,2008-09-01,68,4,-2,75,4,149
China,2008-09-01,42,2,-6,69,3,110
China,2008-09-01,59,0,-2,36,2,95
China,2008-09-01,-6,0,0,1,0,-5
China,2008-09-01,23,0,0,9,12,44
China,2008-09-01,19,0,0,18,9,46
China,2008-09-01,56,6,0,27,8,97
Egypt,2008-09-01,23,0,1,8,0,32
Egypt,2008-09-01,9,0,0,4,1,14
Egypt,2008-09-01,10,0,2,1,2,15
Egypt,2008-09-01,3,0,0,0,0,3
Egypt,2008-09-01,3,0,0,3,0,6
Egypt,2008-09-01,4,0,0,3,0,7
Egypt,2008-09-01,79,0,-1,9,22,109
Egypt,2008-09-01,5,0,0,3,0,8
Egypt,2008-09-01,4,0,0,-3,2,3
Egypt,2008-09-01,15,0,0,4,5,24
Egypt,2008-09-01,25,0,0,1,2,28
Egypt,2008-09-01,9,0,0,4,4,17
Egypt,2008-09-01,8,0,0,0,4,12
Egypt,2008-09-01,10,0,1,2,0,13
Egypt,2008-09-01,32,0,0,9,0,41
Egypt,2008-09-01,17,0,0,3,2,22
Egypt,2008-09-01,6,0,0,3,2,11
Egypt,2008-09-01,47,0,1,1,3,52
Egypt,2008-09-01,3,0,0,13,0,16
Egypt,2008-09-01,11,0,0,9,2,22
Egypt,2008-09-01,11,0,0,12,0,23
Egypt,2008-09-01,50,0,0,73,7,130
Egypt,2008-09-01,9,0,0,8,2,19
Egypt,2008-09-01,48,0,0,22,4,74
Egypt,2008-09-01,54,0,0,30,4,88
Egypt,2008-09-01,9,0,0,14,0,23
Egypt,2008-09-01,14,0,0,-4,0,10
Egypt,2008-09-01,35,0,0,17,4,56
Egypt,2008-09-01,36,0,0,56,11,103
Egypt,2008-09-01,30,0,0,42,10,82
Eritrea,2008-09-01,11,0,0,-4,0,7
Eritrea,2008-09-01,0,0,0,0,0,0
Eritrea,2008-09-01,3,0,0,0,0,3
Eritrea,2008-09-01,0,0,0,0,0,0
Eritrea,2008-09-01,0,0,0,0,0,0
Eritrea,2008-09-01,0,0,0,3,0,3
Eritrea,2008-09-01,4,0,0,0,0,4
Eritrea,2008-09-01,0,0,0,0,0,0
Eritrea,2008-09-01,0,0,0,3,0,3
Eritrea,2008-09-01,-2,0,0,0,0,-2
Eritrea,2008-09-01,4,0,0,-4,0,0
Eritrea,2008-09-01,3,0,0,0,0,3
Eritrea,2008-09-01,0,0,0,0,0,0
Eritrea,2008-09-01,0,0,0,0,0,0
Eritrea,2008-09-01,0,0,0,0,0,0
Eritrea,2008-09-01,6,0,0,3,0,9
Eritrea,2008-09-01,6,0,0,3,0,9
Eritrea,2008-09-01,0,0,0,0,0,0
Eritrea,2008-09-01,5,0,0,0,2,7
Eritrea,2008-09-01,-1,0,0,0,0,-1
Eritrea,2008-09-01,-1,0,0,0,0,-1
Georgia,2008-09-01,15,0,0,15,1,31
Georgia,2008-09-01,6,0,0,3,1,10
Georgia,2008-09-01,0,0,0,0,0,0
Georgia,2008-09-01,-1,0,0,0,0,-1
Georgia,2008-09-01,3,0,0,0,0,3
Georgia,2008-09-01,-1,0,0,0,0,-1
Georgia,2008-09-01,5,0,0,6,5,16
Georgia,2008-09-01,-1,0,0,0,2,1
Georgia,2008-09-01,18,0,-2,4,1,21
Georgia,2008-09-01,2,0,0,5,0,7
Georgia,2008-09-01,7,0,0,7,0,14
Georgia,2008-09-01,21,0,0,0,1,22
Georgia,2008-09-01,-2,0,0,2,4,4
Georgia,2008-09-01,7,0,0,0,0,7
Georgia,2008-09-01,11,0,0,-2,1,10
Georgia,2008-09-01,6,0,-2,1,0,5
Georgia,2008-09-01,5,0,0,0,2,7
Georgia,2008-09-01,6,0,0,0,0,6
Georgia,2008-09-01,9,0,0,0,2,11
Georgia,2008-09-01,2,0,0,0,0,2
Georgia,2008-09-01,0,0,0,0,0,0
Georgia,2008-09-01,2,0,0,0,0,2
Georgia,2008-09-01,9,0,0,0,0,9
Georgia,2008-09-01,6,0,0,-5,1,2
Georgia,2008-09-01,8,0,0,9,2,19
Georgia,2008-09-01,-1,0,0,3,2,4
Georgia,2008-09-01,2,0,0,3,1,6
Georgia,2008-09-01,7,0,0,0,0,7
Georgia,2008-09-01,15,2,0,3,0,20
Georgia,2008-09-01,7,0,0,-2,0,5
India,2008-09-01,35,0,1,6,3,45
India,2008-09-01,33,0,-1,1,9,42
India,2008-09-01,0,0,0,0,0,0
India,2008-09-01,0,0,0,0,1,1
India,2008-09-01,-1,0,0,3,1,3
India,2008-09-01,9,0,0,0,0,9
India,2008-09-01,40,0,0,10,9,59
India,2008-09-01,9,0,0,9,3,21
India,2008-09-01,41,0,1,34,4,80
India,2008-09-01,45,0,1,10,3,59
India,2008-09-01,16,4,1,9,2,32
India,2008-09-01,6,0,0,11,0,17
India,2008-09-01,19,4,0,7,5,35
India,2008-09-01,16,2,0,1,0,19
India,2008-09-01,45,0,-1,3,4,51
India,2008-09-01,29,0,0,4,1,34
India,2008-09-01,26,0,0,9,0,35
India,2008-09-01,14,0,0,0,0,14
India,2008-09-01,23,0,0,3,2,28
India,2008-09-01,21,0,0,0,0,21
India,2008-09-01,33,0,0,0,0,33
India,2008-09-01,21,0,0,0,1,22
India,2008-09-01,14,0,0,14,1,29
India,2008-09-01,10,0,0,7,1,18
India,2008-09-01,18,2,-1,3,1,23
India,2008-09-01,0,0,-5,0,0,-5
India,2008-09-01,24,0,0,9,5,38
India,2008-09-01,21,0,0,4,4,29
India,2008-09-01,31,0,-2,1,10,40
India,2008-09-01,61,2,1,10,21,95
Iran,2008-09-01,10,0,-2,19,16,43
Iran,2008-09-01,45,0,0,49,2,96
Iran,2008-09-01,4,0,0,-1,0,3
Iran,2008-09-01,4,0,0,3,0,7
Iran,2008-09-01,1,0,0,8,2,11
Iran,2008-09-01,7,0,0,0,2,9
Iran,2008-09-01,26,0,-2,-8,4,20
Iran,2008-09-01,19,0,0,6,0,25
Iran,2008-09-01,35,4,-2,7,4,48
Iran,2008-09-01,44,4,0,29,23,100
Iran,2008-09-01,62,0,0,12,1,75
Iran,2008-09-01,20,0,1,10,10,41
Iran,2008-09-01,27,4,0,27,0,58
Iran,2008-09-01,34,0,0,3,4,41
Iran,2008-09-01,68,0,3,4,9,84
Iran,2008-09-01,20,0,2,-7,10,25
Iran,2008-09-01,21,0,-1,6,5,31
Iran,2008-09-01,42,0,0,18,4,64
Iran,2008-09-01,25,0,-1,0,0,24
Iran,2008-09-01,19,0,0,9,4,32
Iran,2008-09-01,24,2,-4,0,0,22
Iran,2008-09-01,20,0,1,24,6,51
Iran,2008-09-01,118,4,0,13,13,148
Iran,2008-09-01,47,0,1,7,0,55
Iran,2008-09-01,31,0,-7,7,6,37
Iran,2008-09-01,66,0,-4,-3,0,59
Iran,2008-09-01,54,0,0,5,9,68
Iran,2008-09-01,28,0,0,9,0,37
Iran,2008-09-01,24,6,0,2,0,32
Iran,2008-09-01,30,0,0,3,2,35
Iraq,2008-09-01,141,6,4,32,12,195
Iraq,2008-09-01,51,6,2,37,9,105
Iraq,2008-09-01,19,0,0,5,7,31
Iraq,2008-09-01,10,0,1,4,2,17
Iraq,2008-09-01,7,0,0,9,0,16
Iraq,2008-09-01,4,0,0,0,2,6
Iraq,2008-09-01,111,0,3,25,11,150
Iraq,2008-09-01,29,0,0,3,7,39
Iraq,2008-09-01,144,2,-5,37,30,208
Iraq,2008-09-01,111,0,0,17,17,145
Iraq,2008-09-01,94,2,1,39,12,148
Iraq,2008-09-01,63,2,0,21,7,93
Iraq,2008-09-01,65,0,2,34,24,125
Iraq,2008-09-01,49,0,2,11,14,76
Iraq,2008-09-01,55,0,-1,26,10,90
Iraq,2008-09-01,72,0,-2,30,8,108
Iraq,2008-09-01,55,0,0,26,17,98
Iraq,2008-09-01,46,0,0,16,21,83
Iraq,2008-09-01,43,0,0,9,6,58
Iraq,2008-09-01,36,0,0,0,5,41
Iraq,2008-09-01,54,4,-4,1,0,55
Iraq,2008-09-01,70,0,-8,-1,5,66
Iraq,2008-09-01,85,0,-6,22,0,101
Iraq,2008-09-01,32,6,0,43,2,83
Iraq,2008-09-01,129,2,1,28,13,173
Iraq,2008-09-01,86,0,0,-2,6,90
Iraq,2008-09-01,112,0,0,-5,8,115
Iraq,2008-09-01,37,0,2,9,4,52
Iraq,2008-09-01,95,0,-5,20,11,121
Iraq,2008-09-01,88,0,-1,35,5,127
Morocco,2008-09-01,0,0,0,0,0,0
Morocco,2008-09-01,-2,0,0,6,0,4
Morocco,2008-09-01,0,0,0,4,0,4
Morocco,2008-09-01,0,0,0,0,0,0
Morocco,2008-09-01,0,0,0,0,0,0
Morocco,2008-09-01,0,0,0,0,0,0
Morocco,2008-09-01,7,0,0,1,0,8
Morocco,2008-09-01,0,0,0,0,0,0
Morocco,2008-09-01,3,0,0,0,0,3
Morocco,2008-09-01,0,0,0,-4,0,-4
Morocco,2008-09-01,1,0,0,0,0,1
Morocco,2008-09-01,0,0,0,0,0,0
Morocco,2008-09-01,3,0,0,0,0,3
Morocco,2008-09-01,0,0,0,0,0,0
Morocco,2008-09-01,2,0,0,0,0,2
Morocco,2008-09-01,0,0,0,3,0,3
Morocco,2008-09-01,0,0,0,3,3,6
Morocco,2008-09-01,-2,0,0,0,0,-2
Morocco,2008-09-01,1,0,0,0,0,1
Morocco,2008-09-01,0,0,0,0,0,0
Morocco,2008-09-01,0,0,0,0,0,0
Morocco,2008-09-01,8,0,0,0,0,8
Morocco,2008-09-01,0,0,0,0,0,0
Morocco,2008-09-01,0,0,0,3,0,3
Morocco,2008-09-01,1,0,0,1,0,2
Morocco,2008-09-01,3,0,0,0,0,3
Morocco,2008-09-01,0,0,0,0,0,0
Morocco,2008-09-01,0,0,0,3,0,3
Morocco,2008-09-01,2,0,0,0,0,2
Morocco,2008-09-01,0,0,0,-8,0,-8
Nigeria,2008-09-01,14,0,0,6,3,23
Nigeria,2008-09-01,14,0,0,6,0,20
Nigeria,2008-09-01,1,0,0,0,0,1
Nigeria,2008-09-01,0,0,0,0,0,0
Nigeria,2008-09-01,0,0,-2,0,0,-2
Nigeria,2008-09-01,0,0,0,0,0,0
Nigeria,2008-09-01,6,0,0,9,1,16
Nigeria,2008-09-01,0,0,0,6,0,6
Nigeria,2008-09-01,1,0,1,6,1,9
Nigeria,2008-09-01,5,0,0,12,0,17
Nigeria,2008-09-01,3,0,-3,0,0,0
Nigeria,2008-09-01,17,0,0,0,0,17
Nigeria,2008-09-01,15,0,0,0,0,15
Nigeria,2008-09-01,0,0,0,0,0,0
Nigeria,2008-09-01,18,0,0,0,0,18
Nigeria,2008-09-01,10,0,0,21,0,31
Nigeria,2008-09-01,4,0,0,2,0,6
Nigeria,2008-09-01,22,0,0,0,0,22
Nigeria,2008-09-01,-1,0,0,3,0,2
Nigeria,2008-09-01,4,0,0,0,0,4
Nigeria,2008-09-01,0,0,0,1,0,1
Nigeria,2008-09-01,9,0,0,9,0,18
Nigeria,2008-09-01,2,0,0,0,0,2
Nigeria,2008-09-01,4,0,0,0,0,4
Nigeria,2008-09-01,0,0,0,3,0,3
Nigeria,2008-09-01,-2,0,1,3,1,3
Nigeria,2008-09-01,0,0,0,0,0,0
Nigeria,2008-09-01,0,0,0,0,4,4
Nigeria,2008-09-01,4,0,0,3,0,7
Nigeria,2008-09-01,8,0,0,3,2,13
Pakistan,2008-09-01,46,0,0,17,2,65
Pakistan,2008-09-01,31,0,0,26,0,57
Pakistan,2008-09-01,8,0,0,0,0,8
Pakistan,2008-09-01,25,0,0,-2,4,27
Pakistan,2008-09-01,8,0,0,0,0,8
Pakistan,2008-09-01,11,0,-2,0,0,9
Pakistan,2008-09-01,178,0,-12,49,22,237
Pakistan,2008-09-01,42,0,1,3,0,46
Pakistan,2008-09-01,150,0,-2,40,4,192
Pakistan,2008-09-01,111,0,-4,25,21,153
Pakistan,2008-09-01,142,0,1,19,7,169
Pakistan,2008-09-01,76,2,-4,31,0,105
Pakistan,2008-09-01,108,0,-1,33,3,143
Pakistan,2008-09-01,134,0,1,26,5,166
Pakistan,2008-09-01,92,0,2,24,26,144
Pakistan,2008-09-01,164,2,0,37,12,215
Pakistan,2008-09-01,49,0,-2,-1,8,54
Pakistan,2008-09-01,80,0,0,19,2,101
Pakistan,2008-09-01,26,0,0,22,3,51
Pakistan,2008-09-01,64,0,0,20,4,88
Pakistan,2008-09-01,50,0,0,3,0,53
Pakistan,2008-09-01,27,0,0,2,11,40
Pakistan,2008-09-01,69,0,0,3,2,74
Pakistan,2008-09-01,45,2,-2,29,3,77
Pakistan,2008-09-01,168,0,2,49,3,222
Pakistan,2008-09-01,126,2,0,18,5,151
Pakistan,2008-09-01,55,0,0,2,4,61
Pakistan,2008-09-01,32,0,0,9,9,50
Pakistan,2008-09-01,116,0,0,8,8,132
Pakistan,2008-09-01,64,0,-2,7,2,71
Sierra Leone,2008-09-01,1,0,0,-2,1,0
Sierra Leone,2008-09-01,0,0,0,0,0,0
Sierra Leone,2008-09-01,0,0,0,9,0,9
Sierra Leone,2008-09-01,0,0,0,0,0,0
Sierra Leone,2008-09-01,0,0,0,12,0,12
Sierra Leone,2008-09-01,0,0,0,-4,0,-4
Sierra Leone,2008-09-01,-1,2,0,0,0,1
Sierra Leone,2008-09-01,0,0,0,0,0,0
Sierra Leone,2008-09-01,0,0,0,-2,0,-2
Sierra Leone,2008-09-01,3,0,0,9,0,12
Sierra Leone,2008-09-01,0,0,0,12,0,12
Sierra Leone,2008-09-01,3,0,0,-2,1,2
Sierra Leone,2008-09-01,0,0,0,0,0,0
Sierra Leone,2008-09-01,0,0,0,0,0,0
Sierra Leone,2008-09-01,1,0,0,3,6,10
Sierra Leone,2008-09-01,0,0,0,3,0,3
Sierra Leone,2008-09-01,3,0,0,3,0,6
Sierra Leone,2008-09-01,0,0,0,0,0,0
Sierra Leone,2008-09-01,-1,0,0,0,0,-1
Sierra Leone,2008-09-01,3,0,0,0,0,3
Somalia,2008-09-01,44,0,0,-4,0,40
Somalia,2008-09-01,39,2,0,40,1,82
Somalia,2008-09-01,1,0,0,3,0,4
Somalia,2008-09-01,6,0,0,3,0,9
Somalia,2008-09-01,6,2,0,3,0,11
Somalia,2008-09-01,7,0,0,3,0,10
Somalia,2008-09-01,20,0,0,4,2,26
Somalia,2008-09-01,23,0,0,8,2,33
Somalia,2008-09-01,52,0,0,58,3,113
Somalia,2008-09-01,43,0,0,20,0,63
Somalia,2008-09-01,39,0,3,-6,2,38
Somalia,2008-09-01,25,0,-6,13,1,33
Somalia,2008-09-01,4,0,-1,0,0,3
Somalia,2008-09-01,32,0,1,0,0,33
Somalia,2008-09-01,58,4,0,57,5,124
Somalia,2008-09-01,40,0,0,92,3,135
Somalia,2008-09-01,34,0,0,27,4,65
Somalia,2008-09-01,29,0,0,6,6,41
Somalia,2008-09-01,23,0,0,24,0,47
Somalia,2008-09-01,25,2,0,-6,3,24
Somalia,2008-09-01,11,2,1,5,6,25
Somalia,2008-09-01,47,4,1,20,6,78
Somalia,2008-09-01,38,0,-2,3,0,39
Somalia,2008-09-01,38,0,-4,-2,2,34
Somalia,2008-09-01,44,0,1,2,0,47
Somalia,2008-09-01,57,0,0,57,4,118
Somalia,2008-09-01,40,0,1,18,16,75
Somalia,2008-09-01,35,0,0,-1,0,34
Somalia,2008-09-01,85,0,0,4,0,89
Somalia,2008-09-01,172,0,0,-21,16,167
Syria,2008-09-01,41,0,2,69,2,114
Syria,2008-09-01,12,0,0,0,1,13
Syria,2008-09-01,3,0,0,3,0,6
Syria,2008-09-01,15,0,0,0,0,15
Syria,2008-09-01,0,0,0,0,0,0
Syria,2008-09-01,3,0,0,0,0,3
Syria,2008-09-01,4,0,0,1,0,5
Syria,2008-09-01,3,0,0,1,0,4
Syria,2008-09-01,6,0,0,6,0,12
Syria,2008-09-01,14,0,0,0,10,24
Syria,2008-09-01,63,0,-2,4,6,71
Syria,2008-09-01,25,0,0,3,0,28
Syria,2008-09-01,9,0,0,0,0,9
Syria,2008-09-01,7,0,-4,0,0,3
Syria,2008-09-01,16,0,1,6,0,23
Syria,2008-09-01,13,0,1,0,6,20
Syria,2008-09-01,11,0,-2,9,0,18
Syria,2008-09-01,4,0,0,3,0,7
Syria,2008-09-01,1,0,0,0,0,1
Syria,2008-09-01,3,0,0,0,0,3
Syria,2008-09-01,10,0,0,0,0,10
Syria,2008-09-01,22,0,0,0,0,22
Syria,2008-09-01,21,0,1,3,0,25
Syria,2008-09-01,9,0,0,6,0,15
Syria,2008-09-01,7,0,0,0,1,8
Syria,2008-09-01,-2,0,0,0,0,-2
Syria,2008-09-01,5,0,0,0,0,5
Syria,2008-09-01,0,0,0,3,0,3
Syria,2008-09-01,28,0,-6,7,21,50
Syria,2008-09-01,64,0,0,3,0,67
Yemen,2008-09-01,12,0,0,0,0,12
Yemen,2008-09-01,0,0,0,7,0,7
Yemen,2008-09-01,0,0,0,-8,0,-8
Yemen,2008-09-01,0,0,0,-2,0,-2
Yemen,2008-09-01,0,0,0,6,0,6
Yemen,2008-09-01,0,0,0,-2,0,-2
Yemen,2008-09-01,1,0,0,0,0,1
Yemen,2008-09-01,16,0,0,6,0,22
Yemen,2008-09-01,8,0,0,-6,6,8
Yemen,2008-09-01,2,0,0,-6,0,-4
Yemen,2008-09-01,0,0,0,6,0,6
Yemen,2008-09-01,2,0,0,0,1,3
Yemen,2008-09-01,6,0,0,15,0,21
Yemen,2008-09-01,82,0,2,16,16,116
Yemen,2008-09-01,163,0,0,78,29,270
Yemen,2008-09-01,7,0,0,0,2,9
Yemen,2008-09-01,10,0,0,0,0,10
Yemen,2008-09-01,0,0,0,0,0,0
Yemen,2008-09-01,23,0,0,0,0,23
Yemen,2008-09-01,34,0,0,0,0,34
Yemen,2008-09-01,14,0,0,4,0,18
Yemen,2008-09-01,8,0,0,10,0,18
Yemen,2008-09-01,10,0,0,10,0,20
Yemen,2008-09-01,0,0,0,0,0,0
Yemen,2008-09-01,18,0,0,0,0,18
Yemen,2008-09-01,22,0,0,-1,4,25
Yemen,2008-09-01,4,0,0,0,3,7
Afghanistan,2006-04-01,36,0,0,4,6,46
Afghanistan,2006-04-01,33,0,0,2,13,48
Afghanistan,2006-04-01,26,0,0,7,7,40
Afghanistan,2006-04-01,19,0,0,10,1,30
Afghanistan,2006-04-01,59,0,1,16,3,79
Afghanistan,2006-04-01,24,0,0,19,2,45
Afghanistan,2006-04-01,14,0,0,12,4,30
Afghanistan,2006-04-01,40,0,0,0,8,48
Afghanistan,2006-04-01,4,0,0,-8,3,-1
Afghanistan,2006-04-01,28,0,0,10,7,45
Afghanistan,2006-04-01,41,0,0,3,10,54
Afghanistan,2006-04-01,30,0,0,13,0,43
Afghanistan,2006-04-01,36,0,0,0,1,37
Afghanistan,2006-04-01,158,0,0,12,4,174
Afghanistan,2006-04-01,34,0,1,4,4,43
Afghanistan,2006-04-01,17,0,0,0,6,23
Afghanistan,2006-04-01,49,0,1,18,2,70
Afghanistan,2006-04-01,27,0,0,-2,2,27
Afghanistan,2006-04-01,21,0,0,8,10,39
Afghanistan,2006-04-01,59,0,1,8,11,79
Afghanistan,2006-04-01,15,0,1,16,4,36
Afghanistan,2006-04-01,31,0,0,-2,1,30
Afghanistan,2006-04-01,66,0,2,3,6,77
Afghanistan,2006-04-01,61,0,0,-1,1,61
Afghanistan,2006-04-01,77,0,0,13,0,90
Afghanistan,2006-04-01,38,0,0,4,2,44
Afghanistan,2006-04-01,16,0,0,-4,1,13
Afghanistan,2006-04-01,17,0,0,27,0,44
Afghanistan,2006-04-01,2,0,0,-2,4,4
Afghanistan,2006-04-01,25,0,0,13,0,38
Albania,2006-04-01,2,0,0,9,0,11
Albania,2006-04-01,2,0,0,3,0,5
Albania,2006-04-01,6,0,-2,15,0,19
Albania,2006-04-01,6,0,-3,6,0,9
Albania,2006-04-01,2,0,0,12,0,14
Albania,2006-04-01,0,0,0,0,0,0
Albania,2006-04-01,10,0,0,-2,2,10
Albania,2006-04-01,1,0,0,0,1,2
Albania,2006-04-01,0,0,0,0,0,0
Albania,2006-04-01,0,0,0,0,0,0
Albania,2006-04-01,0,0,0,16,1,17
Albania,2006-04-01,3,0,0,-2,0,1
Albania,2006-04-01,8,0,0,0,0,8
Albania,2006-04-01,3,0,-2,0,0,1
Albania,2006-04-01,0,0,0,-3,1,-2
Albania,2006-04-01,2,0,0,0,2,4
Albania,2006-04-01,5,0,0,0,0,5
Albania,2006-04-01,1,0,-1,-8,0,-8
Albania,2006-04-01,1,0,0,3,1,5
Albania,2006-04-01,6,0,0,0,0,6
Albania,2006-04-01,5,0,0,-4,0,1
Albania,2006-04-01,0,0,0,0,0,0
Albania,2006-04-01,2,0,0,0,0,2
Albania,2006-04-01,0,0,0,0,1,1
Albania,2006-04-01,5,0,0,0,5,10
Albania,2006-04-01,-1,0,0,10,1,10
Albania,2006-04-01,0,0,0,-2,0,-2
Albania,2006-04-01,3,0,0,-2,0,1
Albania,2006-04-01,0,0,0,0,2,2
Albania,2006-04-01,2,0,0,9,0,11
Algeria,2006-04-01,0,0,0,0,0,0
Algeria,2006-04-01,0,0,0,0,0,0
Algeria,2006-04-01,3,0,0,9,0,12
Algeria,2006-04-01,1,0,0,0,0,1
Algeria,2006-04-01,7,0,0,0,0,7
Algeria,2006-04-01,6,0,0,0,4,10
Algeria,2006-04-01,0,0,0,0,0,0
Algeria,2006-04-01,-1,0,0,0,0,-1
Algeria,2006-04-01,5,2,0,0,0,7
Algeria,2006-04-01,2,0,0,0,0,2
Algeria,2006-04-01,-1,0,0,3,0,2
Algeria,2006-04-01,1,0,0,6,0,7
Algeria,2006-04-01,0,0,0,0,0,0
Algeria,2006-04-01,0,0,0,0,2,2
Algeria,2006-04-01,0,0,0,0,0,0
Algeria,2006-04-01,0,0,0,-2,0,-2
Algeria,2006-04-01,0,0,0,0,14,14
Algeria,2006-04-01,4,0,0,24,0,28
Algeria,2006-04-01,0,0,0,0,2,2
Algeria,2006-04-01,5,0,0,3,0,8
Algeria,2006-04-01,3,0,0,3,0,6
Algeria,2006-04-01,2,0,0,-4,0,-2
Algeria,2006-04-01,1,0,0,5,0,6
Algeria,2006-04-01,3,0,0,9,0,12
Algeria,2006-04-01,2,0,0,0,0,2
Algeria,2006-04-01,0,0,0,0,0,0
Algeria,2006-04-01,5,0,0,6,0,11
Algeria,2006-04-01,5,0,0,0,2,7
Algeria,2006-04-01,0,0,0,0,0,0
Bangladesh,2006-04-01,9,0,0,0,0,9
Bangladesh,2006-04-01,3,0,0,0,0,3
Bangladesh,2006-04-01,9,0,0,6,0,15
Bangladesh,2006-04-01,0,0,0,3,0,3
Bangladesh,2006-04-01,8,0,1,9,3,21
Bangladesh,2006-04-01,0,0,0,3,0,3
Bangladesh,2006-04-01,1,0,0,0,1,2
Bangladesh,2006-04-01,0,0,0,0,0,0
Bangladesh,2006-04-01,4,0,0,6,0,10
Bangladesh,2006-04-01,-2,0,0,0,0,-2
Bangladesh,2006-04-01,0,0,0,3,0,3
Bangladesh,2006-04-01,-2,0,0,0,1,-1
Bangladesh,2006-04-01,1,0,0,7,0,8
Bangladesh,2006-04-01,21,0,0,1,0,22
Bangladesh,2006-04-01,0,0,0,0,0,0
Bangladesh,2006-04-01,5,0,0,-4,0,1
Bangladesh,2006-04-01,3,0,0,3,0,6
Bangladesh,2006-04-01,0,0,0,6,0,6
Bangladesh,2006-04-01,0,0,0,0,1,1
Bangladesh,2006-04-01,2,0,0,-2,0,0
Bangladesh,2006-04-01,4,0,0,0,0,4
Bangladesh,2006-04-01,1,0,0,0,0,1
Bangladesh,2006-04-01,2,0,0,0,0,2
Bangladesh,2006-04-01,-1,0,0,0,0,-1
Bangladesh,2006-04-01,9,0,0,9,2,20
Bangladesh,2006-04-01,0,0,0,0,3,3
Cameroon,2006-04-01,10,0,0,6,0,16
Cameroon,2006-04-01,3,0,0,-2,0,1
Cameroon,2006-04-01,10,0,-4,1,2,9
Cameroon,2006-04-01,9,0,0,-2,0,7
Cameroon,2006-04-01,0,0,0,-4,0,-4
Cameroon,2006-04-01,3,0,0,0,0,3
Cameroon,2006-04-01,3,0,0,0,0,3
Cameroon,2006-04-01,0,0,0,0,0,0
Cameroon,2006-04-01,7,0,0,-2,0,5
Cameroon,2006-04-01,0,0,0,6,0,6
Cameroon,2006-04-01,5,0,0,0,0,5
Cameroon,2006-04-01,0,0,0,0,0,0
Cameroon,2006-04-01,0,0,0,0,0,0
Cameroon,2006-04-01,0,0,0,0,0,0
Cameroon,2006-04-01,0,0,0,0,1,1
Cameroon,2006-04-01,0,0,0,0,0,0
Cameroon,2006-04-01,0,0,0,3,0,3
Cameroon,2006-04-01,2,0,0,0,0,2
Cameroon,2006-04-01,0,0,0,0,0,0
Cameroon,2006-04-01,8,0,0,0,0,8
Cameroon,2006-04-01,-1,0,-2,0,0,-3
Cameroon,2006-04-01,1,0,0,0,0,1
Cameroon,2006-04-01,0,0,0,0,0,0
China,2006-04-01,6,0,0,9,3,18
China,2006-04-01,15,0,0,0,3,18
China,2006-04-01,11,2,-1,0,1,13
China,2006-04-01,41,2,-1,18,6,66
China,2006-04-01,31,0,0,30,4,65
China,2006-04-01,42,0,0,26,1,69
China,2006-04-01,31,0,0,2,2,35
China,2006-04-01,8,0,0,3,0,11
China,2006-04-01,3,0,0,17,6,26
China,2006-04-01,22,0,-1,3,0,24
China,2006-04-01,3,0,-3,8,6,14
China,2006-04-01,14,0,0,3,3,20
China,2006-04-01,22,0,0,6,1,29
China,2006-04-01,15,0,0,15,1,31
China,2006-04-01,3,0,0,3,0,6
China,2006-04-01,8,0,0,3,1,12
China,2006-04-01,12,0,0,7,2,21
China,2006-04-01,67,0,-9,15,19,92
China,2006-04-01,27,0,0,12,6,45
China,2006-04-01,71,0,0,36,15,122
China,2006-04-01,28,0,0,16,6,50
China,2006-04-01,17,0,-4,12,0,25
China,2006-04-01,13,0,-2,4,5,20
China,2006-04-01,14,0,1,9,13,37
China,2006-04-01,26,0,1,9,5,41
China,2006-04-01,-2,0,-6,-4,6,-6
China,2006-04-01,7,0,-6,3,1,5
China,2006-04-01,8,0,-1,6,4,17
China,2006-04-01,14,0,0,8,0,22
China,2006-04-01,8,0,1,0,0,9
Egypt,2006-04-01,15,0,0,0,3,18
Egypt,2006-04-01,2,0,0,-7,0,-5
Egypt,2006-04-01,21,0,0,27,0,48
Egypt,2006-04-01,2,0,0,3,5,10
Egypt,2006-04-01,2,0,0,2,0,4
Egypt,2006-04-01,6,0,0,-4,0,2
Egypt,2006-04-01,22,0,0,18,6,46
Egypt,2006-04-01,3,0,0,0,0,3
Egypt,2006-04-01,6,0,0,0,0,6
Egypt,2006-04-01,-1,0,0,3,4,6
Egypt,2006-04-01,14,0,0,1,0,15
Egypt,2006-04-01,0,0,0,0,0,0
Egypt,2006-04-01,29,0,0,4,0,33
Egypt,2006-04-01,27,0,0,0,0,27
Egypt,2006-04-01,12,0,0,9,0,21
Egypt,2006-04-01,2,0,0,0,1,3
Egypt,2006-04-01,9,0,0,0,0,9
Egypt,2006-04-01,27,0,0,12,0,39
Egypt,2006-04-01,27,0,0,6,5,38
Egypt,2006-04-01,-2,0,0,9,4,11
Egypt,2006-04-01,9,0,0,3,0,12
Egypt,2006-04-01,9,0,1,0,3,13
Egypt,2006-04-01,12,0,0,0,6,18
Egypt,2006-04-01,24,0,0,0,8,32
Egypt,2006-04-01,17,0,2,9,22,50
Egypt,2006-04-01,15,0,2,21,18,56
Egypt,2006-04-01,20,0,0,6,4,30
Egypt,2006-04-01,2,0,0,0,0,2
Egypt,2006-04-01,3,0,0,0,0,3
Egypt,2006-04-01,0,0,0,0,0,0
Eritrea,2006-04-01,0,0,0,0,1,1
Eritrea,2006-04-01,0,0,0,0,0,0
Eritrea,2006-04-01,0,0,0,0,1,1
Eritrea,2006-04-01,3,0,0,0,0,3
Eritrea,2006-04-01,4,0,0,0,0,4
Eritrea,2006-04-01,0,0,0,6,0,6
Eritrea,2006-04-01,0,0,0,0,0,0
Eritrea,2006-04-01,0,0,0,0,1,1
Eritrea,2006-04-01,-3,0,0,0,0,-3
Eritrea,2006-04-01,0,0,0,0,0,0
Eritrea,2006-04-01,0,0,0,0,0,0
Eritrea,2006-04-01,6,0,0,3,0,9
Eritrea,2006-04-01,0,0,0,0,0,0
Eritrea,2006-04-01,0,0,0,0,0,0
Eritrea,2006-04-01,0,0,0,3,0,3
Eritrea,2006-04-01,14,0,0,0,0,14
Eritrea,2006-04-01,0,0,0,0,0,0
Eritrea,2006-04-01,0,2,0,0,0,2
Eritrea,2006-04-01,0,0,0,0,0,0
Eritrea,2006-04-01,-1,0,0,0,0,-1
Eritrea,2006-04-01,0,0,0,0,0,0
Eritrea,2006-04-01,0,0,0,0,0,0
Eritrea,2006-04-01,3,0,0,0,0,3
Eritrea,2006-04-01,0,0,0,0,0,0
Georgia,2006-04-01,2,0,0,0,0,2
Georgia,2006-04-01,0,0,0,0,0,0
Georgia,2006-04-01,4,0,0,0,0,4
Georgia,2006-04-01,1,0,1,6,0,8
Georgia,2006-04-01,6,0,0,-2,4,8
Georgia,2006-04-01,8,0,0,0,0,8
Georgia,2006-04-01,0,0,0,6,0,6
Georgia,2006-04-01,0,0,0,6,0,6
Georgia,2006-04-01,0,0,0,3,0,3
Georgia,2006-04-01,0,0,0,9,0,9
Georgia,2006-04-01,1,0,0,0,0,1
Georgia,2006-04-01,2,0,0,-2,0,0
Georgia,2006-04-01,10,0,0,-2,0,8
Georgia,2006-04-01,0,0,0,0,0,0
Georgia,2006-04-01,0,0,0,0,0,0
Georgia,2006-04-01,0,0,0,0,0,0
Georgia,2006-04-01,11,0,0,2,1,14
Georgia,2006-04-01,4,0,0,3,0,7
Georgia,2006-04-01,1,0,0,3,0,4
Georgia,2006-04-01,0,0,0,3,0,3
Georgia,2006-04-01,0,0,0,0,0,0
Georgia,2006-04-01,0,0,0,0,0,0
Georgia,2006-04-01,5,0,0,3,0,8
Georgia,2006-04-01,0,0,0,3,0,3
Georgia,2006-04-01,2,0,0,6,0,8
Georgia,2006-04-01,0,0,0,0,0,0
Georgia,2006-04-01,0,0,0,0,0,0
India,2006-04-01,8,0,0,6,0,14
India,2006-04-01,7,0,-2,0,0,5
India,2006-04-01,2,0,2,10,1,15
India,2006-04-01,9,0,0,9,0,18
India,2006-04-01,4,0,1,-1,2,6
India,2006-04-01,10,0,0,4,1,15
India,2006-04-01,30,0,0,-4,3,29
India,2006-04-01,3,0,0,0,2,5
India,2006-04-01,14,0,0,0,3,17
India,2006-04-01,0,0,0,9,3,12
India,2006-04-01,3,0,0,0,0,3
India,2006-04-01,0,0,0,15,4,19
India,2006-04-01,10,0,0,3,0,13
India,2006-04-01,-1,0,0,0,0,-1
India,2006-04-01,0,0,0,0,1,1
India,2006-04-01,0,0,0,0,0,0
India,2006-04-01,13,0,0,0,0,13
India,2006-04-01,32,0,0,-1,3,34
India,2006-04-01,11,0,1,6,0,18
India,2006-04-01,29,0,2,9,1,41
India,2006-04-01,15,0,0,9,2,26
India,2006-04-01,0,0,0,0,0,0
India,2006-04-01,6,0,0,2,0,8
India,2006-04-01,9,0,0,3,2,14
India,2006-04-01,22,0,-4,15,1,34
India,2006-04-01,12,0,0,0,1,13
India,2006-04-01,12,0,0,9,0,21
India,2006-04-01,4,0,0,-3,0,1
India,2006-04-01,9,0,0,0,2,11
India,2006-04-01,2,0,0,1,2,5
Iran,2006-04-01,22,0,0,6,0,28
Iran,2006-04-01,33,0,0,9,1,43
Iran,2006-04-01,58,0,0,16,10,84
Iran,2006-04-01,18,0,-7,15,3,29
Iran,2006-04-01,33,0,0,9,3,45
Iran,2006-04-01,27,0,1,6,2,36
Iran,2006-04-01,26,2,1,16,2,47
Iran,2006-04-01,10,0,0,3,0,13
Iran,2006-04-01,9,0,0,0,0,9
Iran,2006-04-01,20,0,0,3,1,24
Iran,2006-04-01,74,0,0,9,4,87
Iran,2006-04-01,25,0,0,0,2,27
Iran,2006-04-01,24,0,1,3,4,32
Iran,2006-04-01,2,0,-2,-3,2,-1
Iran,2006-04-01,13,0,0,4,0,17
Iran,2006-04-01,32,0,0,-1,2,33
Iran,2006-04-01,53,0,0,13,14,80
Iran,2006-04-01,101,0,-3,15,12,125
Iran,2006-04-01,34,0,-6,6,6,40
Iran,2006-04-01,58,4,3,0,8,73
Iran,2006-04-01,18,0,0,-2,5,21
Iran,2006-04-01,8,0,-4,3,2,9
Iran,2006-04-01,10,2,-2,-2,1,9
Iran,2006-04-01,32,0,2,9,12,55
Iran,2006-04-01,18,0,1,12,4,35
Iran,2006-04-01,35,0,0,6,1,42
Iran,2006-04-01,22,0,3,25,2,52
Iran,2006-04-01,36,0,0,6,0,42
Iran,2006-04-01,24,0,0,6,2,32
Iran,2006-04-01,29,0,0,15,1,45
Iraq,2006-04-01,65,6,0,15,6,92
Iraq,2006-04-01,36,0,1,0,10,47
Iraq,2006-04-01,93,0,1,6,3,103
Iraq,2006-04-01,15,4,3,19,2,43
Iraq,2006-04-01,44,4,-10,17,-2,53
Iraq,2006-04-01,23,0,0,31,4,58
Iraq,2006-04-01,83,4,0,30,8,125
Iraq,2006-04-01,38,0,0,1,10,49
Iraq,2006-04-01,34,0,1,3,7,45
Iraq,2006-04-01,27,0,0,19,9,55
Iraq,2006-04-01,29,0,1,15,1,46
Iraq,2006-04-01,78,0,6,1,1,86
Iraq,2006-04-01,55,0,1,31,3,90
Iraq,2006-04-01,32,0,-11,20,4,45
Iraq,2006-04-01,41,0,-2,0,0,39
Iraq,2006-04-01,44,0,-2,-2,0,40
Iraq,2006-04-01,57,0,-3,6,0,60
Iraq,2006-04-01,108,2,-21,36,8,133
Iraq,2006-04-01,47,0,-4,18,0,61
Iraq,2006-04-01,71,4,-4,66,4,141
Iraq,2006-04-01,24,0,1,9,5,39
Iraq,2006-04-01,10,0,1,6,0,17
Iraq,2006-04-01,46,0,1,8,7,62
Iraq,2006-04-01,55,0,0,30,5,90
Iraq,2006-04-01,122,0,1,17,23,163
Iraq,2006-04-01,67,0,0,10,3,80
Iraq,2006-04-01,48,0,-6,16,2,60
Iraq,2006-04-01,15,0,0,17,4,36
Iraq,2006-04-01,7,0,-6,6,2,9
Iraq,2006-04-01,23,0,-2,18,4,43
Morocco,2006-04-01,6,0,0,0,0,6
Morocco,2006-04-01,2,0,0,6,0,8
Morocco,2006-04-01,8,0,0,9,0,17
Morocco,2006-04-01,0,0,0,-2,0,-2
Morocco,2006-04-01,4,0,0,12,0,16
Morocco,2006-04-01,7,0,0,6,2,15
Morocco,2006-04-01,2,0,0,-4,0,-2
Morocco,2006-04-01,24,0,0,45,0,69
Morocco,2006-04-01,0,0,0,3,0,3
Morocco,2006-04-01,1,0,0,0,0,1
Morocco,2006-04-01,0,0,0,3,0,3
Morocco,2006-04-01,1,2,0,0,0,3
Morocco,2006-04-01,0,0,0,3,0,3
Morocco,2006-04-01,16,0,0,0,0,16
Morocco,2006-04-01,3,0,0,0,0,3
Morocco,2006-04-01,3,0,0,0,0,3
Morocco,2006-04-01,-1,0,1,0,0,0
Morocco,2006-04-01,-7,0,0,-4,1,-10
Morocco,2006-04-01,0,0,0,0,0,0
Morocco,2006-04-01,0,0,0,-4,0,-4
Morocco,2006-04-01,-1,0,0,0,0,-1
Morocco,2006-04-01,-1,0,0,0,0,-1
Morocco,2006-04-01,2,0,0,0,0,2
Morocco,2006-04-01,-8,0,0,0,0,-8
Morocco,2006-04-01,3,0,0,0,0,3
Morocco,2006-04-01,6,0,0,0,0,6
Nigeria,2006-04-01,7,0,-2,20,0,25
Nigeria,2006-04-01,6,0,0,18,0,24
Nigeria,2006-04-01,14,0,0,46,2,62
Nigeria,2006-04-01,21,0,1,24,2,48
Nigeria,2006-04-01,12,0,-5,15,5,27
Nigeria,2006-04-01,23,0,2,3,1,29
Nigeria,2006-04-01,24,2,0,9,1,36
Nigeria,2006-04-01,0,0,0,1,0,1
Nigeria,2006-04-01,1,0,0,3,1,5
Nigeria,2006-04-01,6,0,-2,10,4,18
Nigeria,2006-04-01,3,0,0,3,1,7
Nigeria,2006-04-01,3,0,-2,6,0,7
Nigeria,2006-04-01,16,0,0,6,10,32
Nigeria,2006-04-01,19,0,0,0,2,21
Nigeria,2006-04-01,0,0,0,0,0,0
Nigeria,2006-04-01,7,0,-1,0,2,8
Nigeria,2006-04-01,15,0,0,0,1,16
Nigeria,2006-04-01,23,0,0,12,3,38
Nigeria,2006-04-01,30,0,0,6,4,40
Nigeria,2006-04-01,17,0,0,-1,3,19
Nigeria,2006-04-01,10,0,1,0,2,13
Nigeria,2006-04-01,1,0,0,0,0,1
Nigeria,2006-04-01,0,0,0,0,0,0
Nigeria,2006-04-01,7,0,0,0,0,7
Nigeria,2006-04-01,26,0,0,2,0,28
Nigeria,2006-04-01,15,0,0,-8,7,14
Nigeria,2006-04-01,35,0,1,-1,2,37
Nigeria,2006-04-01,6,0,0,9,1,16
Nigeria,2006-04-01,6,2,0,0,4,12
Nigeria,2006-04-01,2,0,0,3,0,5
Pakistan,2006-04-01,5,0,0,18,1,24
Pakistan,2006-04-01,16,0,1,12,2,31
Pakistan,2006-04-01,13,0,0,24,3,40
Pakistan,2006-04-01,14,0,0,9,0,23
Pakistan,2006-04-01,19,0,0,33,3,55
Pakistan,2006-04-01,14,0,0,4,0,18
Pakistan,2006-04-01,8,0,0,6,0,14
Pakistan,2006-04-01,-8,0,3,3,1,-1
Pakistan,2006-04-01,0,0,0,0,0,0
Pakistan,2006-04-01,9,2,0,-2,0,9
Pakistan,2006-04-01,13,0,0,2,0,15
Pakistan,2006-04-01,26,0,0,13,2,41
Pakistan,2006-04-01,3,0,0,12,0,15
Pakistan,2006-04-01,3,0,0,0,4,7
Pakistan,2006-04-01,11,0,0,0,1,12
Pakistan,2006-04-01,3,0,0,3,0,6
Pakistan,2006-04-01,14,0,0,6,1,21
Pakistan,2006-04-01,8,0,0,24,1,33
Pakistan,2006-04-01,0,0,0,12,0,12
Pakistan,2006-04-01,17,0,0,11,0,28
Pakistan,2006-04-01,14,0,0,21,0,35
Pakistan,2006-04-01,12,2,0,12,0,26
Pakistan,2006-04-01,9,0,0,9,0,18
Pakistan,2006-04-01,34,0,0,15,2,51
Pakistan,2006-04-01,15,6,0,18,4,43
Pakistan,2006-04-01,14,0,0,4,0,18
Pakistan,2006-04-01,5,0,0,12,0,17
Pakistan,2006-04-01,7,0,0,5,1,13
Pakistan,2006-04-01,5,0,0,1,1,7
Pakistan,2006-04-01,5,0,0,-2,0,3
Sierra Leone,2006-04-01,7,0,0,27,0,34
Sierra Leone,2006-04-01,0,0,0,9,0,9
Sierra Leone,2006-04-01,11,0,0,27,1,39
Sierra Leone,2006-04-01,5,0,0,3,1,9
Sierra Leone,2006-04-01,2,0,0,3,5,10
Sierra Leone,2006-04-01,4,0,-2,6,1,9
Sierra Leone,2006-04-01,6,0,1,6,2,15
Sierra Leone,2006-04-01,-3,0,0,3,0,0
Sierra Leone,2006-04-01,3,0,0,0,0,3
Sierra Leone,2006-04-01,-1,0,0,4,0,3
Sierra Leone,2006-04-01,0,0,0,0,0,0
Sierra Leone,2006-04-01,0,0,0,0,0,0
Sierra Leone,2006-04-01,0,0,0,0,0,0
Sierra Leone,2006-04-01,1,0,0,0,0,1
Sierra Leone,2006-04-01,13,0,0,0,0,13
Sierra Leone,2006-04-01,-3,0,0,6,0,3
Sierra Leone,2006-04-01,0,0,0,12,4,16
Sierra Leone,2006-04-01,3,0,0,0,1,4
Sierra Leone,2006-04-01,6,0,0,0,0,6
Sierra Leone,2006-04-01,7,0,0,12,0,19
Sierra Leone,2006-04-01,2,0,0,4,3,9
Sierra Leone,2006-04-01,2,0,0,9,0,11
Sierra Leone,2006-04-01,0,0,0,3,0,3
Sierra Leone,2006-04-01,7,0,0,1,0,8
Somalia,2006-04-01,3,4,0,3,0,10
Somalia,2006-04-01,3,2,0,-2,6,9
Somalia,2006-04-01,5,0,0,6,0,11
Somalia,2006-04-01,6,2,0,3,0,11
Somalia,2006-04-01,11,0,0,3,2,16
Somalia,2006-04-01,0,0,0,0,1,1
Somalia,2006-04-01,1,2,0,0,0,3
Somalia,2006-04-01,12,0,0,5,0,17
Somalia,2006-04-01,0,0,0,-2,0,-2
Somalia,2006-04-01,2,0,0,6,0,8
Somalia,2006-04-01,1,0,0,0,0,1
Somalia,2006-04-01,6,0,0,9,0,15
Somalia,2006-04-01,3,4,0,0,1,8
Somalia,2006-04-01,0,0,0,0,0,0
Somalia,2006-04-01,9,0,-2,15,1,23
Somalia,2006-04-01,3,0,0,0,0,3
Somalia,2006-04-01,11,0,0,0,0,11
Somalia,2006-04-01,6,0,-6,1,0,1
Somalia,2006-04-01,0,0,0,0,0,0
Somalia,2006-04-01,4,2,0,0,6,12
Somalia,2006-04-01,0,0,0,0,0,0
Somalia,2006-04-01,2,0,0,1,0,3
Somalia,2006-04-01,3,0,0,0,1,4
Somalia,2006-04-01,11,0,0,0,0,11
Somalia,2006-04-01,10,0,0,0,0,10
Somalia,2006-04-01,7,2,0,-1,0,8
Somalia,2006-04-01,0,0,0,3,0,3
Somalia,2006-04-01,0,0,0,6,0,6
Somalia,2006-04-01,16,0,0,3,0,19
Somalia,2006-04-01,6,0,0,-8,2,0
Syria,2006-04-01,15,0,-1,0,2,16
Syria,2006-04-01,12,0,0,3,2,17
Syria,2006-04-01,31,0,0,6,2,39
Syria,2006-04-01,8,0,0,30,0,38
Syria,2006-04-01,9,0,-2,22,0,29
Syria,2006-04-01,16,0,0,9,0,25
Syria,2006-04-01,8,0,0,12,0,20
Syria,2006-04-01,6,0,0,0,0,6
Syria,2006-04-01,0,0,0,3,0,3
Syria,2006-04-01,7,0,-2,3,0,8
Syria,2006-04-01,2,0,0,0,0,2
Syria,2006-04-01,0,0,0,9,0,9
Syria,2006-04-01,0,0,0,0,0,0
Syria,2006-04-01,0,0,0,6,0,6
Syria,2006-04-01,-2,0,0,0,0,-2
Syria,2006-04-01,0,0,0,0,0,0
Syria,2006-04-01,17,0,0,0,0,17
Syria,2006-04-01,10,0,0,6,3,19
Syria,2006-04-01,-6,0,0,0,0,-6
Syria,2006-04-01,20,0,-2,14,4,36
Syria,2006-04-01,2,0,-4,0,0,-2
Syria,2006-04-01,2,0,0,0,2,4
Syria,2006-04-01,8,0,0,3,0,11
Syria,2006-04-01,3,0,0,0,0,3
Syria,2006-04-01,3,0,0,-1,0,2
Syria,2006-04-01,-5,0,0,9,0,4
Syria,2006-04-01,-4,0,0,-2,0,-6
Syria,2006-04-01,9,0,-2,0,0,7
Syria,2006-04-01,4,0,0,0,0,4
Syria,2006-04-01,5,0,0,0,0,5
Yemen,2006-04-01,0,0,0,0,0,0
Yemen,2006-04-01,0,0,0,-1,0,-1
Yemen,2006-04-01,0,0,0,3,0,3
Yemen,2006-04-01,0,2,0,7,0,9
Yemen,2006-04-01,9,0,0,10,0,19
Yemen,2006-04-01,3,0,0,0,0,3
Yemen,2006-04-01,2,0,0,4,0,6
Yemen,2006-04-01,1,0,0,0,0,1
Yemen,2006-04-01,1,0,0,3,0,4
Yemen,2006-04-01,-2,0,0,0,0,-2
Yemen,2006-04-01,0,0,0,6,0,6
Yemen,2006-04-01,0,0,0,0,0,0
Yemen,2006-04-01,15,0,0,0,0,15
Yemen,2006-04-01,0,0,0,0,0,0
Yemen,2006-04-01,0,0,0,0,0,0
Yemen,2006-04-01,6,0,0,0,0,6
Yemen,2006-04-01,3,0,0,-4,0,-1
Yemen,2006-04-01,6,0,0,0,0,6
Yemen,2006-04-01,0,0,0,0,6,6
Yemen,2006-04-01,0,0,0,0,0,0
Yemen,2006-04-01,0,0,0,0,0,0
Yemen,2006-04-01,3,0,0,0,0,3
Yemen,2006-04-01,0,0,0,0,0,0
Yemen,2006-04-01,5,0,0,0,0,5
Yemen,2006-04-01,3,0,0,-2,0,1
Yemen,2006-04-01,2,0,0,0,0,2
Afghanistan,2006-10-01,62,0,0,29,2,93
Afghanistan,2006-10-01,30,2,0,5,5,42
Afghanistan,2006-10-01,62,0,0,2,12,76
Afghanistan,2006-10-01,44,0,0,21,12,77
Afghanistan,2006-10-01,58,2,1,-1,2,62
Afghanistan,2006-10-01,51,0,0,15,5,71
Afghanistan,2006-10-01,45,0,0,30,4,79
Afghanistan,2006-10-01,21,0,0,3,0,24
Afghanistan,2006-10-01,21,0,0,-11,2,12
Afghanistan,2006-10-01,32,0,0,3,0,35
Afghanistan,2006-10-01,23,0,0,0,1,24
Afghanistan,2006-10-01,23,0,0,4,11,38
Afghanistan,2006-10-01,35,0,0,4,29,68
Afghanistan,2006-10-01,32,0,0,15,3,50
Afghanistan,2006-10-01,9,0,0,0,0,9
Afghanistan,2006-10-01,32,0,0,30,11,73
Afghanistan,2006-10-01,27,0,0,-2,6,31
Afghanistan,2006-10-01,48,0,0,27,0,75
Afghanistan,2006-10-01,27,0,0,7,5,39
Afghanistan,2006-10-01,16,0,0,3,0,19
Afghanistan,2006-10-01,6,0,0,6,0,12
Afghanistan,2006-10-01,22,0,0,3,0,25
Afghanistan,2006-10-01,39,4,-1,-2,4,44
Afghanistan,2006-10-01,71,0,-3,8,4,80
Afghanistan,2006-10-01,13,0,0,3,4,20
Afghanistan,2006-10-01,22,0,-2,6,2,28
Afghanistan,2006-10-01,111,0,-3,21,19,148
Afghanistan,2006-10-01,56,4,-1,-4,1,56
Afghanistan,2006-10-01,21,0,1,7,6,35
Afghanistan,2006-10-01,66,0,-3,5,3,71
Afghanistan,2006-10-01,76,4,-1,17,6,102
Albania,2006-10-01,8,0,0,0,0,8
Albania,2006-10-01,10,0,0,15,0,25
Albania,2006-10-01,1,0,-2,0,0,-1
Albania,2006-10-01,4,0,0,4,0,8
Albania,2006-10-01,0,0,0,0,0,0
Albania,2006-10-01,0,0,0,0,0,0
Albania,2006-10-01,0,0,0,0,0,0
Albania,2006-10-01,0,0,0,0,0,0
Albania,2006-10-01,7,0,0,0,0,7
Albania,2006-10-01,1,0,0,0,0,1
Albania,2006-10-01,2,0,0,0,1,3
Albania,2006-10-01,3,0,-1,18,0,20
Albania,2006-10-01,-3,0,0,0,0,-3
Albania,2006-10-01,0,0,0,-2,0,-2
Albania,2006-10-01,0,0,0,0,0,0
Albania,2006-10-01,4,0,0,3,1,8
Albania,2006-10-01,4,0,0,0,0,4
Albania,2006-10-01,2,0,0,0,0,2
Albania,2006-10-01,11,0,0,6,0,17
Albania,2006-10-01,17,0,0,9,0,26
Albania,2006-10-01,2,0,-1,-2,0,-1
Albania,2006-10-01,0,0,0,0,0,0
Albania,2006-10-01,-1,0,0,6,0,5
Albania,2006-10-01,4,0,0,0,0,4
Albania,2006-10-01,0,0,0,0,1,1
Albania,2006-10-01,5,0,0,-2,0,3
Albania,2006-10-01,4,0,0,2,2,8
Albania,2006-10-01,16,0,-1,0,4,19
Albania,2006-10-01,11,0,0,0,1,12
Albania,2006-10-01,11,0,-7,3,9,16
Albania,2006-10-01,12,0,0,9,6,27
Algeria,2006-10-01,1,0,0,0,0,1
Algeria,2006-10-01,3,0,0,18,0,21
Algeria,2006-10-01,5,0,0,6,0,11
Algeria,2006-10-01,0,0,0,3,0,3
Algeria,2006-10-01,0,0,0,0,0,0
Algeria,2006-10-01,2,0,0,0,0,2
Algeria,2006-10-01,0,0,0,3,0,3
Algeria,2006-10-01,13,0,0,1,0,14
Algeria,2006-10-01,4,0,0,3,0,7
Algeria,2006-10-01,11,0,0,-6,2,7
Algeria,2006-10-01,0,0,0,-5,0,-5
Algeria,2006-10-01,2,0,0,3,0,5
Algeria,2006-10-01,0,0,0,0,4,4
Algeria,2006-10-01,0,0,0,0,0,0
Algeria,2006-10-01,-8,0,0,0,0,-8
Algeria,2006-10-01,0,0,0,0,0,0
Algeria,2006-10-01,1,0,0,0,0,1
Algeria,2006-10-01,-1,0,0,6,0,5
Algeria,2006-10-01,0,0,0,0,0,0
Algeria,2006-10-01,0,0,0,3,0,3
Algeria,2006-10-01,8,0,0,0,0,8
Algeria,2006-10-01,3,0,0,1,0,4
Algeria,2006-10-01,1,0,0,6,3,10
Algeria,2006-10-01,1,0,0,0,0,1
Algeria,2006-10-01,4,0,0,3,0,7
Algeria,2006-10-01,2,0,0,0,0,2
Algeria,2006-10-01,1,0,0,0,2,3
Algeria,2006-10-01,17,0,0,6,0,23
Algeria,2006-10-01,10,0,0,0,0,10
Bangladesh,2006-10-01,7,0,2,0,2,11
Bangladesh,2006-10-01,4,0,1,0,0,5
Bangladesh,2006-10-01,2,0,0,0,1,3
Bangladesh,2006-10-01,11,0,2,0,1,14
Bangladesh,2006-10-01,4,0,2,18,0,24
Bangladesh,2006-10-01,0,0,0,0,0,0
Bangladesh,2006-10-01,19,0,0,0,4,23
Bangladesh,2006-10-01,12,0,0,0,4,16
Bangladesh,2006-10-01,2,0,0,3,0,5
Bangladesh,2006-10-01,2,0,0,0,0,2
Bangladesh,2006-10-01,2,2,0,0,1,5
Bangladesh,2006-10-01,9,0,0,0,2,11
Bangladesh,2006-10-01,0,0,0,0,0,0
Bangladesh,2006-10-01,-1,0,0,0,0,-1
Bangladesh,2006-10-01,0,0,0,0,0,0
Bangladesh,2006-10-01,0,0,0,0,0,0
Bangladesh,2006-10-01,2,0,0,0,0,2
Bangladesh,2006-10-01,0,0,0,6,0,6
Bangladesh,2006-10-01,0,0,0,-4,0,-4
Bangladesh,2006-10-01,0,0,0,0,0,0
Bangladesh,2006-10-01,5,0,-2,0,0,3
Bangladesh,2006-10-01,2,0,0,0,0,2
Bangladesh,2006-10-01,3,0,0,4,0,7
Bangladesh,2006-10-01,16,0,-4,6,1,19
Bangladesh,2006-10-01,4,0,-2,0,1,3
Bangladesh,2006-10-01,25,0,1,3,3,32
Bangladesh,2006-10-01,7,0,0,0,2,9
Cameroon,2006-10-01,3,0,0,0,1,4
Cameroon,2006-10-01,0,0,0,0,0,0
Cameroon,2006-10-01,-3,0,0,0,0,-3
Cameroon,2006-10-01,0,0,0,0,0,0
Cameroon,2006-10-01,0,0,0,0,0,0
Cameroon,2006-10-01,0,0,0,3,0,3
Cameroon,2006-10-01,0,0,0,0,0,0
Cameroon,2006-10-01,0,0,0,12,0,12
Cameroon,2006-10-01,0,0,0,0,1,1
Cameroon,2006-10-01,0,0,0,3,0,3
Cameroon,2006-10-01,2,0,0,0,0,2
Cameroon,2006-10-01,0,0,0,0,0,0
Cameroon,2006-10-01,0,0,0,-2,0,-2
Cameroon,2006-10-01,0,0,0,3,1,4
Cameroon,2006-10-01,0,0,0,0,0,0
Cameroon,2006-10-01,0,0,0,0,0,0
Cameroon,2006-10-01,0,0,0,0,0,0
Cameroon,2006-10-01,0,0,0,0,0,0
Cameroon,2006-10-01,0,0,0,3,0,3
Cameroon,2006-10-01,0,0,0,0,0,0
Cameroon,2006-10-01,0,0,0,0,0,0
Cameroon,2006-10-01,0,0,0,0,2,2
China,2006-10-01,-2,0,0,6,0,4
China,2006-10-01,12,0,4,10,2,28
China,2006-10-01,36,0,0,12,1,49
China,2006-10-01,26,0,0,4,3,33
China,2006-10-01,37,0,0,7,4,48
China,2006-10-01,14,0,0,7,2,23
China,2006-10-01,2,0,0,7,1,10
China,2006-10-01,9,0,0,3,1,13
China,2006-10-01,17,0,0,-2,10,25
China,2006-10-01,36,0,1,-6,6,37
China,2006-10-01,13,0,0,0,4,17
China,2006-10-01,-4,2,-5,-1,1,-7
China,2006-10-01,18,0,0,0,1,19
China,2006-10-01,27,0,0,4,2,33
China,2006-10-01,1,0,0,12,0,13
China,2006-10-01,17,0,-4,12,3,28
China,2006-10-01,16,0,1,21,0,38
China,2006-10-01,14,0,1,15,1,31
China,2006-10-01,13,0,0,4,0,17
China,2006-10-01,22,0,0,9,2,33
China,2006-10-01,2,0,-2,0,0,0
China,2006-10-01,7,0,0,-4,0,3
China,2006-10-01,35,4,2,13,3,57
China,2006-10-01,48,0,0,18,0,66
China,2006-10-01,3,0,3,12,9,27
China,2006-10-01,12,0,1,13,0,26
China,2006-10-01,26,0,0,1,4,31
China,2006-10-01,10,0,0,-2,2,10
China,2006-10-01,8,0,0,8,2,18
China,2006-10-01,18,6,-2,44,11,77
China,2006-10-01,33,2,-2,22,5,60
Egypt,2006-10-01,20,0,0,10,2,32
Egypt,2006-10-01,2,2,-2,6,0,8
Egypt,2006-10-01,9,0,0,1,0,10
Egypt,2006-10-01,1,0,-1,3,0,3
Egypt,2006-10-01,37,0,0,7,0,44
Egypt,2006-10-01,20,0,0,12,0,32
Egypt,2006-10-01,16,0,0,-1,0,15
Egypt,2006-10-01,4,0,0,3,0,7
Egypt,2006-10-01,0,0,0,0,0,0
Egypt,2006-10-01,5,0,1,6,1,13
Egypt,2006-10-01,3,0,2,0,0,5
Egypt,2006-10-01,7,0,0,5,0,12
Egypt,2006-10-01,7,0,0,6,0,13
Egypt,2006-10-01,7,0,0,0,0,7
Egypt,2006-10-01,1,0,0,3,0,4
Egypt,2006-10-01,-3,0,0,6,0,3
Egypt,2006-10-01,15,2,0,3,3,23
Egypt,2006-10-01,5,0,0,6,1,12
Egypt,2006-10-01,12,0,0,3,0,15
Egypt,2006-10-01,16,0,0,11,0,27
Egypt,2006-10-01,0,0,0,0,0,0
Egypt,2006-10-01,0,0,1,-1,1,1
Egypt,2006-10-01,18,0,0,6,0,24
Egypt,2006-10-01,4,0,0,15,0,19
Egypt,2006-10-01,12,0,0,3,0,15
Egypt,2006-10-01,5,0,0,0,6,11
Egypt,2006-10-01,19,0,0,3,1,23
Egypt,2006-10-01,33,0,0,4,0,37
Egypt,2006-10-01,17,0,0,1,0,18
Egypt,2006-10-01,11,0,0,22,0,33
Egypt,2006-10-01,4,0,0,33,3,40
Eritrea,2006-10-01,4,0,0,0,0,4
Eritrea,2006-10-01,0,0,0,0,0,0
Eritrea,2006-10-01,4,0,0,0,0,4
Eritrea,2006-10-01,0,0,0,4,0,4
Eritrea,2006-10-01,0,0,0,0,0,0
Eritrea,2006-10-01,0,0,0,0,0,0
Eritrea,2006-10-01,3,0,0,0,0,3
Eritrea,2006-10-01,0,0,0,0,0,0
Eritrea,2006-10-01,0,0,0,0,0,0
Eritrea,2006-10-01,0,0,0,0,0,0
Eritrea,2006-10-01,3,0,0,0,1,4
Eritrea,2006-10-01,0,0,0,0,0,0
Eritrea,2006-10-01,0,0,2,0,0,2
Eritrea,2006-10-01,5,0,0,0,0,5
Eritrea,2006-10-01,4,0,0,0,1,5
Eritrea,2006-10-01,13,0,0,0,4,17
Eritrea,2006-10-01,1,0,0,0,0,1
Eritrea,2006-10-01,0,0,0,0,0,0
Eritrea,2006-10-01,0,0,0,0,0,0
Eritrea,2006-10-01,0,0,0,9,0,9
Eritrea,2006-10-01,3,0,0,0,0,3
Eritrea,2006-10-01,8,0,0,0,0,8
Eritrea,2006-10-01,10,0,0,0,0,10
Eritrea,2006-10-01,11,0,0,3,0,14
Eritrea,2006-10-01,9,0,0,3,0,12
Eritrea,2006-10-01,0,0,0,0,0,0
Georgia,2006-10-01,5,0,0,0,0,5
Georgia,2006-10-01,3,0,0,7,1,11
Georgia,2006-10-01,0,0,0,9,2,11
Georgia,2006-10-01,9,0,0,12,0,21
Georgia,2006-10-01,4,0,0,1,1,6
Georgia,2006-10-01,4,2,0,8,0,14
Georgia,2006-10-01,2,2,0,0,0,4
Georgia,2006-10-01,8,0,0,3,2,13
Georgia,2006-10-01,0,0,0,0,0,0
Georgia,2006-10-01,-1,0,0,0,0,-1
Georgia,2006-10-01,3,0,0,0,0,3
Georgia,2006-10-01,3,0,0,0,0,3
Georgia,2006-10-01,3,0,0,0,1,4
Georgia,2006-10-01,3,0,0,0,0,3
Georgia,2006-10-01,3,0,0,0,0,3
Georgia,2006-10-01,0,0,0,3,0,3
Georgia,2006-10-01,9,0,0,3,1,13
Georgia,2006-10-01,11,0,0,0,0,11
Georgia,2006-10-01,0,0,-1,0,0,-1
Georgia,2006-10-01,4,0,-2,3,1,6
Georgia,2006-10-01,0,0,0,0,0,0
Georgia,2006-10-01,1,0,0,0,0,1
Georgia,2006-10-01,6,0,0,0,0,6
Georgia,2006-10-01,5,0,0,-2,0,3
Georgia,2006-10-01,6,0,0,0,0,6
Georgia,2006-10-01,5,2,0,6,0,13
Georgia,2006-10-01,0,0,0,0,0,0
Georgia,2006-10-01,0,0,-2,0,2,0
Georgia,2006-10-01,0,0,0,0,0,0
Georgia,2006-10-01,7,0,0,3,0,10
Georgia,2006-10-01,2,0,0,-2,1,1
India,2006-10-01,3,0,0,15,6,24
India,2006-10-01,1,0,1,0,0,2
India,2006-10-01,4,0,0,5,0,9
India,2006-10-01,15,2,0,3,4,24
India,2006-10-01,18,0,0,1,0,19
India,2006-10-01,4,0,0,9,3,16
India,2006-10-01,7,0,0,3,0,10
India,2006-10-01,0,0,0,0,0,0
India,2006-10-01,16,0,0,3,0,19
India,2006-10-01,4,0,0,0,3,7
India,2006-10-01,2,0,1,0,0,3
India,2006-10-01,1,0,0,0,0,1
India,2006-10-01,31,0,0,3,0,34
India,2006-10-01,3,0,0,0,2,5
India,2006-10-01,0,0,0,3,1,4
India,2006-10-01,4,0,0,0,0,4
India,2006-10-01,3,0,0,0,3,6
India,2006-10-01,2,0,0,-2,0,0
India,2006-10-01,9,0,0,9,2,20
India,2006-10-01,10,0,0,9,0,19
India,2006-10-01,0,0,0,0,0,0
India,2006-10-01,0,0,0,3,0,3
India,2006-10-01,11,2,0,0,3,16
India,2006-10-01,11,0,1,-2,2,12
India,2006-10-01,8,0,-2,0,0,6
India,2006-10-01,3,0,-1,0,1,3
India,2006-10-01,2,2,0,9,1,14
India,2006-10-01,5,0,0,-2,2,5
India,2006-10-01,3,0,0,0,0,3
India,2006-10-01,11,0,0,0,0,11
India,2006-10-01,15,0,0,4,1,20
Iran,2006-10-01,14,0,0,-6,0,8
Iran,2006-10-01,13,0,0,0,1,14
Iran,2006-10-01,23,0,0,6,4,33
Iran,2006-10-01,21,0,-1,6,2,28
Iran,2006-10-01,20,0,0,5,2,27
Iran,2006-10-01,13,0,0,3,1,17
Iran,2006-10-01,11,0,0,0,0,11
Iran,2006-10-01,6,0,0,2,0,8
Iran,2006-10-01,9,0,0,4,1,14
Iran,2006-10-01,34,0,3,4,0,41
Iran,2006-10-01,3,0,0,-1,0,2
Iran,2006-10-01,5,2,0,-6,0,1
Iran,2006-10-01,2,0,0,1,1,4
Iran,2006-10-01,2,0,0,0,1,3
Iran,2006-10-01,17,0,0,0,2,19
Iran,2006-10-01,32,0,-2,9,8,47
Iran,2006-10-01,15,0,0,19,5,39
Iran,2006-10-01,21,0,0,0,0,21
Iran,2006-10-01,26,0,0,8,0,34
Iran,2006-10-01,5,0,0,9,2,16
Iran,2006-10-01,2,0,0,0,-1,1
Iran,2006-10-01,-2,0,0,0,2,0
Iran,2006-10-01,34,0,0,-4,2,32
Iran,2006-10-01,4,0,-2,1,3,6
Iran,2006-10-01,10,0,-1,6,0,15
Iran,2006-10-01,14,0,0,0,1,15
Iran,2006-10-01,18,0,1,15,0,34
Iran,2006-10-01,10,0,2,18,1,31
Iran,2006-10-01,14,0,3,4,4,25
Iran,2006-10-01,12,0,-8,15,1,20
Iran,2006-10-01,51,0,-4,14,2,63
Iraq,2006-10-01,38,0,-5,14,5,52
Iraq,2006-10-01,75,0,-2,14,7,94
Iraq,2006-10-01,97,0,0,-10,6,93
Iraq,2006-10-01,52,0,0,33,7,92
Iraq,2006-10-01,59,0,0,22,7,88
Iraq,2006-10-01,120,0,-10,12,13,135
Iraq,2006-10-01,76,0,-5,48,0,119
Iraq,2006-10-01,6,0,0,3,1,10
Iraq,2006-10-01,24,0,1,9,4,38
Iraq,2006-10-01,38,0,0,24,5,67
Iraq,2006-10-01,29,2,0,19,2,52
Iraq,2006-10-01,36,0,0,21,0,57
Iraq,2006-10-01,83,2,0,1,2,88
Iraq,2006-10-01,44,0,0,8,6,58
Iraq,2006-10-01,29,0,0,-2,0,27
Iraq,2006-10-01,50,0,0,30,0,80
Iraq,2006-10-01,39,0,1,3,1,44
Iraq,2006-10-01,40,0,2,-1,2,43
Iraq,2006-10-01,46,0,2,23,8,79
Iraq,2006-10-01,23,0,-2,6,2,29
Iraq,2006-10-01,12,2,3,-6,1,12
Iraq,2006-10-01,48,0,0,6,1,55
Iraq,2006-10-01,70,6,-2,54,26,154
Iraq,2006-10-01,82,0,-10,20,4,96
Iraq,2006-10-01,21,0,-8,7,4,24
Iraq,2006-10-01,17,0,1,18,8,44
Iraq,2006-10-01,100,0,2,35,15,152
Iraq,2006-10-01,92,2,-2,5,3,100
Iraq,2006-10-01,68,6,1,10,14,99
Iraq,2006-10-01,78,0,0,24,4,106
Iraq,2006-10-01,171,0,-4,-1,23,189
Morocco,2006-10-01,0,0,0,0,1,1
Morocco,2006-10-01,6,0,0,0,0,6
Morocco,2006-10-01,6,0,0,0,0,6
Morocco,2006-10-01,0,0,0,0,0,0
Morocco,2006-10-01,2,0,0,0,0,2
Morocco,2006-10-01,50,2,1,38,14,105
Morocco,2006-10-01,2,0,0,6,2,10
Morocco,2006-10-01,2,0,0,0,2,4
Morocco,2006-10-01,0,0,0,0,6,6
Morocco,2006-10-01,0,0,0,0,3,3
Morocco,2006-10-01,2,0,0,18,0,20
Morocco,2006-10-01,1,0,0,9,0,10
Morocco,2006-10-01,0,0,0,0,0,0
Morocco,2006-10-01,2,0,0,0,0,2
Morocco,2006-10-01,0,0,0,0,0,0
Morocco,2006-10-01,2,0,0,0,1,3
Morocco,2006-10-01,1,0,0,-6,0,-5
Morocco,2006-10-01,2,0,0,0,0,2
Morocco,2006-10-01,0,0,0,-1,0,-1
Morocco,2006-10-01,0,0,0,0,0,0
Morocco,2006-10-01,0,0,0,3,0,3
Morocco,2006-10-01,-1,0,0,0,0,-1
Morocco,2006-10-01,4,0,0,3,1,8
Morocco,2006-10-01,1,0,0,11,0,12
Morocco,2006-10-01,4,0,0,6,0,10
Morocco,2006-10-01,0,0,0,0,0,0
Morocco,2006-10-01,-6,0,0,0,0,-6
Nigeria,2006-10-01,3,2,1,10,0,16
Nigeria,2006-10-01,21,0,0,0,0,21
Nigeria,2006-10-01,18,0,1,14,0,33
Nigeria,2006-10-01,8,0,0,9,1,18
Nigeria,2006-10-01,5,0,-2,0,2,5
Nigeria,2006-10-01,12,0,-2,12,0,22
Nigeria,2006-10-01,0,0,0,0,0,0
Nigeria,2006-10-01,4,0,0,3,0,7
Nigeria,2006-10-01,15,0,-2,3,0,16
Nigeria,2006-10-01,19,0,4,1,0,24
Nigeria,2006-10-01,11,0,0,7,3,21
Nigeria,2006-10-01,8,0,0,3,0,11
Nigeria,2006-10-01,12,0,2,0,1,15
Nigeria,2006-10-01,1,0,0,0,1,2
Nigeria,2006-10-01,0,0,0,0,0,0
Nigeria,2006-10-01,8,0,0,3,0,11
Nigeria,2006-10-01,3,0,1,0,1,5
Nigeria,2006-10-01,15,2,0,-2,2,17
Nigeria,2006-10-01,16,0,0,-2,0,14
Nigeria,2006-10-01,7,0,0,-3,2,6
Nigeria,2006-10-01,4,0,0,0,0,4
Nigeria,2006-10-01,15,0,2,2,1,20
Nigeria,2006-10-01,16,0,0,3,0,19
Nigeria,2006-10-01,11,0,0,2,3,16
Nigeria,2006-10-01,0,0,0,0,0,0
Nigeria,2006-10-01,-1,0,0,0,0,-1
Nigeria,2006-10-01,10,0,0,-2,2,10
Nigeria,2006-10-01,3,0,0,6,1,10
Nigeria,2006-10-01,39,2,0,33,11,85
Nigeria,2006-10-01,43,0,0,31,6,80
Nigeria,2006-10-01,21,0,-2,9,0,28
Pakistan,2006-10-01,19,0,0,9,0,28
Pakistan,2006-10-01,6,0,0,9,0,15
Pakistan,2006-10-01,8,0,0,3,3,14
Pakistan,2006-10-01,31,0,0,-1,0,30
Pakistan,2006-10-01,17,2,0,1,2,22
Pakistan,2006-10-01,31,4,0,19,9,63
Pakistan,2006-10-01,6,6,0,9,0,21
Pakistan,2006-10-01,16,0,0,3,1,20
Pakistan,2006-10-01,61,0,0,0,5,66
Pakistan,2006-10-01,32,0,0,6,1,39
Pakistan,2006-10-01,13,0,0,6,0,19
Pakistan,2006-10-01,10,0,0,3,0,13
Pakistan,2006-10-01,4,0,0,1,0,5
Pakistan,2006-10-01,17,0,-1,3,0,19
Pakistan,2006-10-01,30,0,-1,0,2,31
Pakistan,2006-10-01,17,0,0,9,0,26
Pakistan,2006-10-01,21,0,0,5,8,34
Pakistan,2006-10-01,27,0,0,15,0,42
Pakistan,2006-10-01,2,0,0,9,0,11
Pakistan,2006-10-01,6,0,0,6,0,12
Pakistan,2006-10-01,0,0,-1,0,3,2
Pakistan,2006-10-01,8,0,0,6,0,14
Pakistan,2006-10-01,5,0,0,4,0,9
Pakistan,2006-10-01,14,0,-4,10,2,22
Pakistan,2006-10-01,2,0,0,0,0,2
Pakistan,2006-10-01,4,0,0,-3,1,2
Pakistan,2006-10-01,30,0,0,21,1,52
Pakistan,2006-10-01,16,0,0,3,0,19
Pakistan,2006-10-01,9,0,0,0,1,10
Pakistan,2006-10-01,68,0,0,24,4,96
Pakistan,2006-10-01,34,0,-2,13,4,49
Sierra Leone,2006-10-01,0,0,0,3,0,3
Sierra Leone,2006-10-01,0,0,0,0,0,0
Sierra Leone,2006-10-01,3,0,0,9,0,12
Sierra Leone,2006-10-01,2,0,0,3,0,5
Sierra Leone,2006-10-01,0,0,0,0,0,0
Sierra Leone,2006-10-01,4,0,0,0,0,4
Sierra Leone,2006-10-01,3,0,0,0,0,3
Sierra Leone,2006-10-01,-1,0,-2,0,0,-3
Sierra Leone,2006-10-01,1,0,0,0,0,1
Sierra Leone,2006-10-01,0,0,0,0,1,1
Sierra Leone,2006-10-01,10,0,0,3,0,13
Sierra Leone,2006-10-01,0,0,0,-2,0,-2
Sierra Leone,2006-10-01,2,0,0,0,0,2
Sierra Leone,2006-10-01,0,0,0,0,2,2
Sierra Leone,2006-10-01,3,0,0,0,1,4
Sierra Leone,2006-10-01,0,0,0,0,0,0
Sierra Leone,2006-10-01,0,0,0,0,0,0
Sierra Leone,2006-10-01,0,0,0,-2,0,-2
Sierra Leone,2006-10-01,3,0,0,0,0,3
Sierra Leone,2006-10-01,2,0,0,0,0,2
Sierra Leone,2006-10-01,4,0,0,0,0,4
Sierra Leone,2006-10-01,0,0,0,0,0,0
Sierra Leone,2006-10-01,0,0,0,0,0,0
Sierra Leone,2006-10-01,4,0,-2,0,0,2
Somalia,2006-10-01,3,0,0,0,0,3
Somalia,2006-10-01,10,0,0,0,0,10
Somalia,2006-10-01,2,0,0,0,0,2
Somalia,2006-10-01,19,0,0,-2,1,18
Somalia,2006-10-01,6,0,0,0,2,8
Somalia,2006-10-01,6,0,0,0,2,8
Somalia,2006-10-01,9,0,0,0,0,9
Somalia,2006-10-01,0,0,0,0,0,0
Somalia,2006-10-01,5,0,0,3,0,8
Somalia,2006-10-01,9,0,0,-2,2,9
Somalia,2006-10-01,-1,0,0,0,4,3
Somalia,2006-10-01,1,0,0,0,0,1
Somalia,2006-10-01,1,2,0,0,3,6
Somalia,2006-10-01,8,0,-6,0,0,2
Somalia,2006-10-01,3,0,0,0,0,3
Somalia,2006-10-01,0,0,-4,0,0,-4
Somalia,2006-10-01,5,4,-4,0,0,5
Somalia,2006-10-01,8,0,-2,0,0,6
Somalia,2006-10-01,7,0,0,0,0,7
Somalia,2006-10-01,3,0,0,0,2,5
Somalia,2006-10-01,12,0,0,-2,0,10
Somalia,2006-10-01,1,0,0,0,0,1
Somalia,2006-10-01,6,0,0,0,0,6
Somalia,2006-10-01,0,0,0,0,0,0
Somalia,2006-10-01,4,0,0,0,1,5
Somalia,2006-10-01,0,0,0,12,0,12
Somalia,2006-10-01,10,0,0,27,0,37
Somalia,2006-10-01,8,0,0,9,3,20
Somalia,2006-10-01,3,0,0,6,0,9
Somalia,2006-10-01,6,0,0,6,0,12
Somalia,2006-10-01,6,0,1,3,0,10
Syria,2006-10-01,7,0,0,9,2,18
Syria,2006-10-01,3,0,0,0,0,3
Syria,2006-10-01,2,0,0,0,0,2
Syria,2006-10-01,12,0,0,13,0,25
Syria,2006-10-01,15,0,0,0,1,16
Syria,2006-10-01,14,0,0,6,6,26
Syria,2006-10-01,12,0,0,3,2,17
Syria,2006-10-01,5,0,0,0,0,5
Syria,2006-10-01,2,0,0,0,0,2
Syria,2006-10-01,19,0,0,0,1,20
Syria,2006-10-01,15,0,2,3,0,20
Syria,2006-10-01,12,0,2,6,0,20
Syria,2006-10-01,2,0,0,1,0,3
Syria,2006-10-01,5,0,0,0,0,5
Syria,2006-10-01,1,0,0,0,0,1
Syria,2006-10-01,0,0,0,0,0,0
Syria,2006-10-01,1,0,0,-2,0,-1
Syria,2006-10-01,9,0,0,0,0,9
Syria,2006-10-01,1,0,0,1,0,2
Syria,2006-10-01,2,0,0,0,0,2
Syria,2006-10-01,2,0,0,0,0,2
Syria,2006-10-01,0,0,0,0,0,0
Syria,2006-10-01,11,0,0,0,1,12
Syria,2006-10-01,9,0,0,0,0,9
Syria,2006-10-01,12,0,0,0,0,12
Syria,2006-10-01,0,0,0,3,0,3
Syria,2006-10-01,15,0,-1,3,0,17
Syria,2006-10-01,9,0,2,-2,0,9
Syria,2006-10-01,23,0,0,0,4,27
Syria,2006-10-01,6,0,0,9,2,17
Syria,2006-10-01,20,0,0,12,0,32
Yemen,2006-10-01,18,0,0,27,15,60
Yemen,2006-10-01,3,0,0,9,0,12
Yemen,2006-10-01,0,0,0,6,0,6
Yemen,2006-10-01,0,0,0,0,0,0
Yemen,2006-10-01,0,0,0,18,0,18
Yemen,2006-10-01,0,0,0,0,0,0
Yemen,2006-10-01,1,0,0,0,0,1
Yemen,2006-10-01,1,0,0,0,0,1
Yemen,2006-10-01,-2,0,0,0,0,-2
Yemen,2006-10-01,7,0,0,6,2,15
Yemen,2006-10-01,0,0,0,0,0,0
Yemen,2006-10-01,0,0,0,0,0,0
Yemen,2006-10-01,0,0,0,0,0,0
Yemen,2006-10-01,0,0,0,0,0,0
Yemen,2006-10-01,0,0,0,12,0,12
Yemen,2006-10-01,9,0,0,-4,0,5
Yemen,2006-10-01,2,0,0,0,0,2
Yemen,2006-10-01,0,0,1,3,0,4
Yemen,2006-10-01,2,0,0,0,2,4
Yemen,2006-10-01,0,0,0,0,12,12
Yemen,2006-10-01,4,0,0,21,0,25
Yemen,2006-10-01,4,0,0,21,0,25
Yemen,2006-10-01,8,0,1,21,0,30
Afghanistan,2003-01-01,45,0,0,7,5,57
Afghanistan,2003-01-01,30,0,0,7,38,75
Afghanistan,2003-01-01,73,0,0,13,1,87
Afghanistan,2003-01-01,25,0,-2,9,2,34
Afghanistan,2003-01-01,15,0,0,2,0,17
Afghanistan,2003-01-01,16,0,0,4,1,21
Afghanistan,2003-01-01,54,0,0,6,3,63
Afghanistan,2003-01-01,40,0,0,14,8,62
Afghanistan,2003-01-01,41,0,0,28,8,77
Afghanistan,2003-01-01,8,0,1,33,1,43
Afghanistan,2003-01-01,40,0,0,-9,0,31
Afghanistan,2003-01-01,15,0,0,13,6,34
Afghanistan,2003-01-01,19,0,-1,52,6,76
Afghanistan,2003-01-01,24,0,0,24,0,48
Afghanistan,2003-01-01,17,6,0,0,0,23
Afghanistan,2003-01-01,21,0,0,15,0,36
Afghanistan,2003-01-01,36,0,0,21,2,59
Afghanistan,2003-01-01,8,0,0,-5,4,7
Afghanistan,2003-01-01,19,0,0,5,3,27
Afghanistan,2003-01-01,16,0,0,15,1,32
Afghanistan,2003-01-01,37,0,-2,27,2,64
Afghanistan,2003-01-01,47,4,1,27,2,81
Afghanistan,2003-01-01,35,0,0,22,0,57
Afghanistan,2003-01-01,24,0,0,6,0,30
Afghanistan,2003-01-01,17,0,0,3,4,24
Afghanistan,2003-01-01,31,2,0,28,0,61
Afghanistan,2003-01-01,33,0,0,10,7,50
Afghanistan,2003-01-01,50,0,0,16,3,69
Afghanistan,2003-01-01,59,0,0,13,3,75
Afghanistan,2003-01-01,47,0,0,9,7,63
Afghanistan,2003-01-01,42,0,0,21,11,74
Afghanistan,2003-02-01,13,0,0,-8,0,5
Afghanistan,2003-02-01,19,0,0,9,5,33
Afghanistan,2003-02-01,24,4,1,-7,0,22
Afghanistan,2003-02-01,40,0,0,24,6,70
Afghanistan,2003-02-01,10,0,0,9,2,21
Afghanistan,2003-02-01,67,0,0,-14,3,56
Afghanistan,2003-02-01,44,0,0,4,7,55
Afghanistan,2003-02-01,22,0,0,6,1,29
Afghanistan,2003-02-01,36,2,0,2,0,40
Afghanistan,2003-02-01,22,0,0,9,0,31
Afghanistan,2003-02-01,21,0,0,-4,0,17
Afghanistan,2003-02-01,31,0,0,5,0,36
Afghanistan,2003-02-01,11,0,0,0,0,11
Afghanistan,2003-02-01,31,0,1,13,1,46
Afghanistan,2003-02-01,5,0,3,6,0,14
Afghanistan,2003-02-01,14,0,0,5,0,19
Afghanistan,2003-02-01,13,0,0,15,0,28
Afghanistan,2003-02-01,22,0,0,5,3,30
Afghanistan,2003-02-01,66,0,0,11,1,78
Afghanistan,2003-02-01,54,0,0,4,3,61
Afghanistan,2003-02-01,30,4,2,12,0,48
Afghanistan,2003-02-01,37,0,0,9,3,49
Afghanistan,2003-02-01,15,0,0,0,1,16
Afghanistan,2003-02-01,63,0,0,18,2,83
Afghanistan,2003-02-01,71,0,0,9,0,80
Afghanistan,2003-02-01,50,0,0,4,0,54
Afghanistan,2003-02-01,12,0,0,0,5,17
Afghanistan,2003-02-01,25,0,0,21,0,46
Afghanistan,2003-03-01,53,0,0,19,0,72
Afghanistan,2003-03-01,20,0,0,13,0,33
Afghanistan,2003-03-01,32,0,0,7,3,42
Afghanistan,2003-03-01,25,0,0,-10,3,18
Afghanistan,2003-03-01,26,0,0,2,5,33
Afghanistan,2003-03-01,30,0,0,19,0,49
Afghanistan,2003-03-01,42,0,0,46,0,88
Afghanistan,2003-03-01,17,0,0,24,0,41
Afghanistan,2003-03-01,17,0,0,15,0,32
Afghanistan,2003-03-01,12,0,0,-3,2,11
Afghanistan,2003-03-01,25,2,0,10,1,38
Afghanistan,2003-03-01,32,0,0,-3,7,36
Afghanistan,2003-03-01,26,0,0,15,2,43
Afghanistan,2003-03-01,34,0,0,-2,4,36
Afghanistan,2003-03-01,7,0,0,2,0,9
Afghanistan,2003-03-01,26,0,0,9,2,37
Afghanistan,2003-03-01,31,10,0,23,6,70
Afghanistan,2003-03-01,15,6,0,8,1,30
Afghanistan,2003-03-01,36,0,0,-6,1,31
Afghanistan,2003-03-01,50,0,0,9,14,73
Afghanistan,2003-03-01,29,0,0,9,4,42
Afghanistan,2003-03-01,12,0,0,6,0,18
Afghanistan,2003-03-01,33,0,0,-2,6,37
Afghanistan,2003-03-01,16,0,0,16,1,33
Afghanistan,2003-03-01,49,2,0,2,6,59
Afghanistan,2003-03-01,31,0,-4,12,6,45
Afghanistan,2003-03-01,15,0,0,-3,6,18
Afghanistan,2003-03-01,6,0,0,-3,0,3
Afghanistan,2003-03-01,6,0,0,6,0,12
Afghanistan,2003-03-01,7,0,0,-1,0,6
Afghanistan,2003-03-01,10,0,1,9,2,22
Afghanistan,2003-04-01,13,0,0,21,4,38
Afghanistan,2003-04-01,21,0,0,3,2,26
Afghanistan,2003-04-01,15,0,0,9,1,25
Afghanistan,2003-04-01,9,0,0,0,2,11
Afghanistan,2003-04-01,14,0,0,4,0,18
Afghanistan,2003-04-01,31,0,0,6,0,37
Afghanistan,2003-04-01,57,0,0,6,2,65
Afghanistan,2003-04-01,37,0,-5,-2,3,33
Afghanistan,2003-04-01,28,0,0,0,3,31
Afghanistan,2003-04-01,23,0,0,16,2,41
Afghanistan,2003-04-01,19,0,0,15,2,36
Afghanistan,2003-04-01,38,0,0,0,2,40
Afghanistan,2003-04-01,28,0,0,0,2,30
Afghanistan,2003-04-01,36,0,1,15,6,58
Afghanistan,2003-04-01,15,2,0,12,3,32
Afghanistan,2003-04-01,33,0,0,6,1,40
Afghanistan,2003-04-01,3,2,0,-2,2,5
Afghanistan,2003-04-01,9,0,0,-7,0,2
Afghanistan,2003-04-01,25,0,0,0,0,25
Afghanistan,2003-04-01,6,0,0,-9,0,-3
Afghanistan,2003-04-01,28,0,0,-14,2,16
Afghanistan,2003-04-01,23,0,-1,2,2,26
Afghanistan,2003-04-01,20,0,0,12,4,36
Afghanistan,2003-04-01,25,0,0,11,1,37
Afghanistan,2003-04-01,28,0,0,16,3,47
Afghanistan,2003-04-01,7,0,0,2,0,9
Afghanistan,2003-04-01,39,0,-2,6,3,46
Afghanistan,2003-04-01,34,0,-4,12,7,49
Afghanistan,2003-04-01,15,0,0,0,4,19
Afghanistan,2003-04-01,28,0,0,20,0,48
Afghanistan,2003-05-01,19,0,0,21,0,40
Afghanistan,2003-05-01,16,0,0,10,4,30
Afghanistan,2003-05-01,16,2,0,1,1,20
Afghanistan,2003-05-01,11,0,0,9,8,28
Afghanistan,2003-05-01,10,0,0,24,1,35
Afghanistan,2003-05-01,34,0,0,4,3,41
Afghanistan,2003-05-01,22,0,-7,4,2,21
Afghanistan,2003-05-01,17,0,0,6,0,23
Afghanistan,2003-05-01,26,0,1,24,6,57
Afghanistan,2003-05-01,40,0,1,12,5,58
Afghanistan,2003-05-01,24,2,0,11,1,38
Afghanistan,2003-05-01,26,0,0,1,0,27
Afghanistan,2003-05-01,13,0,0,15,0,28
Afghanistan,2003-05-01,23,0,0,4,7,34
Afghanistan,2003-05-01,38,4,0,12,1,55
Afghanistan,2003-05-01,17,0,0,3,0,20
Afghanistan,2003-05-01,25,0,0,-7,2,20
Afghanistan,2003-05-01,42,0,0,1,4,47
Afghanistan,2003-05-01,37,0,1,12,0,50
Afghanistan,2003-05-01,22,0,-6,8,2,26
Afghanistan,2003-05-01,32,0,-2,3,6,39
Afghanistan,2003-05-01,66,0,0,21,6,93
Afghanistan,2003-05-01,30,0,0,-3,8,35
Afghanistan,2003-05-01,16,4,1,13,2,36
Afghanistan,2003-05-01,28,0,0,11,0,39
Afghanistan,2003-05-01,5,0,0,3,0,8
Afghanistan,2003-05-01,7,0,0,3,0,10
Afghanistan,2003-05-01,47,0,0,29,2,78
Afghanistan,2003-05-01,8,2,0,12,2,24
Afghanistan,2003-05-01,17,0,0,6,0,23
Afghanistan,2003-05-01,15,2,0,-10,2,9
Afghanistan,2003-06-01,2,2,0,20,3,27
Afghanistan,2003-06-01,51,0,0,12,0,63
Afghanistan,2003-06-01,6,0,0,1,4,11
Afghanistan,2003-06-01,33,0,1,12,3,49
Afghanistan,2003-06-01,6,0,0,20,8,34
Afghanistan,2003-06-01,49,0,0,-11,4,42
Afghanistan,2003-06-01,2,0,0,-14,0,-12
Afghanistan,2003-06-01,10,2,0,2,3,17
Afghanistan,2003-06-01,19,0,0,19,3,41
Afghanistan,2003-06-01,23,0,0,15,6,44
Afghanistan,2003-06-01,24,0,0,16,4,44
Afghanistan,2003-06-01,39,2,0,9,0,50
Afghanistan,2003-06-01,6,0,0,2,0,8
Afghanistan,2003-06-01,-6,0,0,8,1,3
Afghanistan,2003-06-01,10,0,0,9,2,21
Afghanistan,2003-06-01,32,0,0,15,5,52
Afghanistan,2003-06-01,14,0,0,2,0,16
Afghanistan,2003-06-01,46,0,-1,19,5,69
Afghanistan,2003-06-01,40,0,-2,29,6,73
Afghanistan,2003-06-01,9,0,0,-15,7,1
Afghanistan,2003-06-01,20,0,0,8,6,34
Afghanistan,2003-06-01,25,0,0,21,0,46
Afghanistan,2003-06-01,45,0,-1,32,0,76
Afghanistan,2003-06-01,20,0,0,13,2,35
Afghanistan,2003-06-01,10,0,0,-6,8,12
Afghanistan,2003-06-01,54,0,0,-3,3,54
Afghanistan,2003-06-01,29,0,0,0,1,30
Afghanistan,2003-06-01,44,0,0,4,4,52
Afghanistan,2003-06-01,22,0,0,9,0,31
Afghanistan,2003-06-01,18,0,0,12,2,32
Afghanistan,2003-07-01,38,0,0,20,3,61
Afghanistan,2003-07-01,28,0,0,14,0,42
Afghanistan,2003-07-01,58,0,0,9,9,76
Afghanistan,2003-07-01,23,0,0,27,2,52
Afghanistan,2003-07-01,25,0,0,12,0,37
Afghanistan,2003-07-01,42,0,1,15,1,59
Afghanistan,2003-07-01,36,0,0,13,0,49
Afghanistan,2003-07-01,24,0,-2,5,3,30
Afghanistan,2003-07-01,25,0,0,8,2,35
Afghanistan,2003-07-01,57,0,0,16,3,76
Afghanistan,2003-07-01,14,0,0,-7,0,7
Afghanistan,2003-07-01,7,0,0,-6,2,3
Afghanistan,2003-07-01,40,0,0,7,0,47
Afghanistan,2003-07-01,32,0,0,0,0,32
Afghanistan,2003-07-01,8,0,-2,27,2,35
Afghanistan,2003-07-01,28,0,0,15,2,45
Afghanistan,2003-07-01,25,0,0,23,0,48
Afghanistan,2003-07-01,21,0,0,21,0,42
Afghanistan,2003-07-01,23,0,0,38,0,61
Afghanistan,2003-07-01,14,0,0,6,0,20
Afghanistan,2003-07-01,24,0,0,12,0,36
Afghanistan,2003-07-01,44,0,0,6,0,50
Afghanistan,2003-07-01,25,0,0,10,0,35
Afghanistan,2003-07-01,41,0,0,-2,14,53
Afghanistan,2003-07-01,13,0,0,5,5,23
Afghanistan,2003-07-01,17,0,0,9,8,34
Afghanistan,2003-07-01,11,0,0,3,4,18
Afghanistan,2003-07-01,12,0,0,14,3,29
Afghanistan,2003-07-01,16,0,0,2,3,21
Afghanistan,2003-07-01,47,0,0,6,5,58
Afghanistan,2003-07-01,36,0,0,7,8,51
Afghanistan,2003-08-01,16,0,0,0,0,16
Afghanistan,2003-08-01,11,0,0,-4,0,7
Afghanistan,2003-08-01,8,0,0,11,0,19
Afghanistan,2003-08-01,43,2,0,6,0,51
Afghanistan,2003-08-01,15,0,0,3,0,18
Afghanistan,2003-08-01,34,0,0,15,0,49
Afghanistan,2003-08-01,20,0,0,17,8,45
Afghanistan,2003-08-01,12,0,0,36,1,49
Afghanistan,2003-08-01,13,0,0,-3,7,17
Afghanistan,2003-08-01,12,0,0,27,2,41
Afghanistan,2003-08-01,28,0,-1,10,4,41
Afghanistan,2003-08-01,11,0,0,7,3,21
Afghanistan,2003-08-01,32,0,0,3,-1,34
Afghanistan,2003-08-01,49,0,0,11,0,60
Afghanistan,2003-08-01,3,0,0,7,0,10
Afghanistan,2003-08-01,15,0,0,-1,0,14
Afghanistan,2003-08-01,19,0,0,6,6,31
Afghanistan,2003-08-01,9,0,0,2,0,11
Afghanistan,2003-08-01,11,0,0,6,5,22
Afghanistan,2003-08-01,34,0,0,3,0,37
Afghanistan,2003-08-01,20,0,2,7,6,35
Afghanistan,2003-08-01,35,0,0,1,2,38
Afghanistan,2003-08-01,33,0,0,-3,2,32
Afghanistan,2003-08-01,9,0,0,7,1,17
Afghanistan,2003-08-01,29,0,0,9,0,38
Afghanistan,2003-08-01,24,0,0,10,2,36
Afghanistan,2003-08-01,36,0,0,20,5,61
Afghanistan,2003-08-01,34,0,0,0,0,34
Afghanistan,2003-08-01,8,0,0,0,2,10
Afghanistan,2003-08-01,35,0,0,8,0,43
Afghanistan,2003-08-01,21,0,0,3,2,26
Afghanistan,2003-09-01,29,0,0,6,0,35
Afghanistan,2003-09-01,31,4,1,24,4,64
Afghanistan,2003-09-01,23,0,-3,14,5,39
Afghanistan,2003-09-01,22,0,-2,-1,4,23
Afghanistan,2003-09-01,15,0,0,9,0,24
Afghanistan,2003-09-01,33,4,0,27,0,64
Afghanistan,2003-09-01,43,0,0,38,2,83
Afghanistan,2003-09-01,24,0,0,-4,5,25
Afghanistan,2003-09-01,18,2,0,0,0,20
Afghanistan,2003-09-01,67,0,-1,31,0,97
Afghanistan,2003-09-01,71,0,3,24,0,98
Afghanistan,2003-09-01,34,0,0,24,3,61
Afghanistan,2003-09-01,16,0,0,4,3,23
Afghanistan,2003-09-01,21,0,0,12,2,35
Afghanistan,2003-09-01,41,0,0,13,0,54
Afghanistan,2003-09-01,18,0,0,15,2,35
Afghanistan,2003-09-01,8,0,0,-2,2,8
Afghanistan,2003-09-01,26,0,0,9,2,37
Afghanistan,2003-09-01,10,0,0,15,0,25
Afghanistan,2003-09-01,10,0,0,18,4,32
Afghanistan,2003-09-01,30,2,0,3,0,35
Afghanistan,2003-09-01,22,0,-4,8,10,36
Afghanistan,2003-09-01,27,0,0,21,0,48
Afghanistan,2003-09-01,28,0,0,30,4,62
Afghanistan,2003-09-01,38,0,0,19,2,59
Afghanistan,2003-09-01,14,0,0,17,3,34
Afghanistan,2003-09-01,8,0,0,3,2,13
Afghanistan,2003-09-01,7,0,-2,6,0,11
Afghanistan,2003-09-01,39,2,0,22,1,64
Afghanistan,2003-09-01,21,2,2,3,1,29
Afghanistan,2003-10-01,29,6,0,13,7,55
Afghanistan,2003-10-01,29,4,0,2,7,42
Afghanistan,2003-10-01,14,0,0,21,3,38
Afghanistan,2003-10-01,1,0,0,16,2,19
Afghanistan,2003-10-01,25,0,1,-3,0,23
Afghanistan,2003-10-01,4,2,0,2,0,8
Afghanistan,2003-10-01,35,0,0,8,2,45
Afghanistan,2003-10-01,49,0,0,10,0,59
Afghanistan,2003-10-01,24,0,0,6,1,31
Afghanistan,2003-10-01,39,0,2,14,1,56
Afghanistan,2003-10-01,25,0,0,13,0,38
Afghanistan,2003-10-01,14,0,0,1,0,15
Afghanistan,2003-10-01,14,0,0,19,1,34
Afghanistan,2003-10-01,11,0,0,24,3,38
Afghanistan,2003-10-01,21,0,0,21,4,46
Afghanistan,2003-10-01,17,0,0,3,2,22
Afghanistan,2003-10-01,25,4,0,15,0,44
Afghanistan,2003-10-01,22,0,0,6,3,31
Afghanistan,2003-10-01,25,0,0,13,0,38
Afghanistan,2003-10-01,15,0,0,4,2,21
Afghanistan,2003-10-01,23,0,0,-1,0,22
Afghanistan,2003-10-01,21,0,-1,18,6,44
Afghanistan,2003-10-01,11,0,0,6,2,19
Afghanistan,2003-10-01,-5,0,0,0,6,1
Afghanistan,2003-10-01,25,2,0,11,0,38
Afghanistan,2003-10-01,13,0,0,3,1,17
Afghanistan,2003-10-01,34,0,0,23,2,59
Afghanistan,2003-10-01,52,0,-1,-3,1,49
Afghanistan,2003-10-01,39,0,0,-2,0,37
Afghanistan,2003-10-01,24,2,0,14,0,40
Afghanistan,2003-10-01,18,0,0,15,1,34
Afghanistan,2003-11-01,56,0,0,1,5,62
Afghanistan,2003-11-01,32,0,0,0,0,32
Afghanistan,2003-11-01,42,0,0,18,7,67
Afghanistan,2003-11-01,8,0,0,0,3,11
Afghanistan,2003-11-01,25,0,0,22,4,51
Afghanistan,2003-11-01,9,2,0,7,0,18
Afghanistan,2003-11-01,16,0,0,13,1,30
Afghanistan,2003-11-01,2,0,0,0,1,3
Afghanistan,2003-11-01,10,0,0,0,12,22
Afghanistan,2003-11-01,23,0,0,16,3,42
Afghanistan,2003-11-01,20,0,0,32,7,59
Afghanistan,2003-11-01,44,6,0,13,16,79
Afghanistan,2003-11-01,22,0,0,16,7,45
Afghanistan,2003-11-01,46,0,0,25,2,73
Afghanistan,2003-11-01,49,0,0,-4,2,47
Afghanistan,2003-11-01,39,0,0,9,0,48
Afghanistan,2003-11-01,39,0,0,15,2,56
Afghanistan,2003-11-01,20,0,0,22,6,48
Afghanistan,2003-11-01,37,0,0,-3,5,39
Afghanistan,2003-11-01,59,0,-1,25,5,88
Afghanistan,2003-11-01,34,0,0,1,2,37
Afghanistan,2003-11-01,73,0,0,-4,7,76
Afghanistan,2003-11-01,30,0,0,6,1,37
Afghanistan,2003-11-01,38,0,0,10,4,52
Afghanistan,2003-11-01,36,0,0,24,1,61
Afghanistan,2003-11-01,22,0,0,33,0,55
Afghanistan,2003-11-01,16,0,-3,5,1,19
Afghanistan,2003-11-01,27,0,-6,-6,2,17
Afghanistan,2003-11-01,22,0,0,8,2,32
Afghanistan,2003-11-01,54,0,0,18,1,73
Afghanistan,2003-12-01,60,6,0,15,0,81
Afghanistan,2003-12-01,20,0,0,-5,2,17
Afghanistan,2003-12-01,22,0,0,19,0,41
Afghanistan,2003-12-01,37,0,0,42,2,81
Afghanistan,2003-12-01,17,0,-1,13,0,29
Afghanistan,2003-12-01,25,0,-2,-3,0,20
Afghanistan,2003-12-01,20,0,0,10,0,30
Afghanistan,2003-12-01,10,0,0,0,1,11
Afghanistan,2003-12-01,11,0,0,37,1,49
Afghanistan,2003-12-01,23,0,-4,-3,2,18
Afghanistan,2003-12-01,21,6,0,0,23,50
Afghanistan,2003-12-01,27,6,0,6,2,41
Afghanistan,2003-12-01,21,0,0,4,4,29
Afghanistan,2003-12-01,18,0,0,18,5,41
Afghanistan,2003-12-01,22,0,0,1,0,23
Afghanistan,2003-12-01,26,0,-2,37,1,62
Afghanistan,2003-12-01,19,0,1,36,1,57
Afghanistan,2003-12-01,26,0,0,29,1,56
Afghanistan,2003-12-01,46,0,0,27,2,75
Afghanistan,2003-12-01,19,0,0,24,0,43
Afghanistan,2003-12-01,15,0,-2,9,3,25
Afghanistan,2003-12-01,25,0,0,24,4,53
Afghanistan,2003-12-01,34,0,3,30,1,68
Afghanistan,2003-12-01,31,0,0,0,7,38
Afghanistan,2003-12-01,33,2,-3,36,7,75
Afghanistan,2003-12-01,17,0,0,9,2,28
Afghanistan,2003-12-01,30,0,0,-2,2,30
Afghanistan,2003-12-01,4,0,0,6,6,16
Afghanistan,2003-12-01,14,8,0,19,1,42
Afghanistan,2003-12-01,20,0,0,23,3,46
Afghanistan,2003-12-01,20,0,0,13,2,35
Albania,2003-01-01,0,0,0,6,0,6
Albania,2003-01-01,5,0,0,0,0,5
Albania,2003-01-01,12,0,0,15,0,27
Albania,2003-01-01,18,0,-1,3,0,20
Albania,2003-01-01,2,0,0,0,0,2
Albania,2003-01-01,3,0,0,0,0,3
Albania,2003-01-01,-1,0,0,0,0,-1
Albania,2003-01-01,10,0,-1,3,1,13
Albania,2003-01-01,21,0,0,6,3,30
Albania,2003-01-01,9,0,0,0,0,9
Albania,2003-01-01,2,0,0,0,0,2
Albania,2003-01-01,7,0,0,3,0,10
Albania,2003-01-01,0,0,0,0,0,0
Albania,2003-01-01,10,0,0,0,2,12
Albania,2003-01-01,14,0,0,1,3,18
Albania,2003-01-01,10,0,0,4,2,16
Albania,2003-01-01,19,0,0,6,0,25
Albania,2003-01-01,13,0,1,0,0,14
Albania,2003-01-01,15,0,-2,15,0,28
Albania,2003-01-01,3,0,0,7,4,14
Albania,2003-01-01,17,0,-2,0,0,15
Albania,2003-01-01,0,0,0,2,3,5
Albania,2003-01-01,7,0,0,0,0,7
Albania,2003-01-01,2,0,0,0,0,2
Albania,2003-01-01,21,0,0,9,0,30
Albania,2003-01-01,2,0,0,8,0,10
Albania,2003-01-01,0,0,2,0,0,2
Albania,2003-01-01,9,0,0,3,3,15
Albania,2003-01-01,2,0,0,0,0,2
Albania,2003-01-01,1,0,0,3,2,6
Albania,2003-02-01,4,0,0,3,0,7
Albania,2003-02-01,5,0,0,9,0,14
Albania,2003-02-01,15,0,-1,48,0,62
Albania,2003-02-01,35,0,0,6,0,41
Albania,2003-02-01,9,0,3,12,4,28
Albania,2003-02-01,7,0,4,10,2,23
Albania,2003-02-01,9,0,0,3,0,12
Albania,2003-02-01,0,0,0,14,3,17
Albania,2003-02-01,25,0,0,15,4,44
Albania,2003-02-01,14,0,-2,18,3,33
Albania,2003-02-01,17,4,0,3,0,24
Albania,2003-02-01,30,0,1,3,0,34
Albania,2003-02-01,11,0,0,5,0,16
Albania,2003-02-01,2,0,0,3,0,5
Albania,2003-02-01,2,0,0,0,1,3
Albania,2003-02-01,7,0,0,3,0,10
Albania,2003-02-01,11,0,0,57,5,73
Albania,2003-02-01,58,0,4,47,4,113
Albania,2003-02-01,15,0,0,51,5,71
Albania,2003-02-01,10,0,0,21,0,31
Albania,2003-02-01,0,0,0,7,2,9
Albania,2003-02-01,2,0,0,3,0,5
Albania,2003-02-01,4,0,0,0,0,4
Albania,2003-02-01,1,0,0,6,4,11
Albania,2003-02-01,41,0,0,18,3,62
Albania,2003-02-01,7,0,0,12,3,22
Albania,2003-02-01,3,0,0,-2,0,1
Albania,2003-02-01,15,0,0,-8,1,8
Albania,2003-03-01,10,0,0,12,1,23
Albania,2003-03-01,3,0,0,6,0,9
Albania,2003-03-01,5,0,0,0,0,5
Albania,2003-03-01,20,0,0,36,0,56
Albania,2003-03-01,37,0,0,33,3,73
Albania,2003-03-01,-2,0,0,3,0,1
Albania,2003-03-01,9,0,-1,12,24,44
Albania,2003-03-01,11,0,1,0,0,12
Albania,2003-03-01,4,0,0,0,0,4
Albania,2003-03-01,15,0,0,16,10,41
Albania,2003-03-01,2,0,0,16,0,18
Albania,2003-03-01,10,0,0,0,0,10
Albania,2003-03-01,19,0,0,6,0,25
Albania,2003-03-01,2,0,-6,2,0,-2
Albania,2003-03-01,4,0,0,10,0,14
Albania,2003-03-01,3,0,0,0,0,3
Albania,2003-03-01,4,0,0,0,0,4
Albania,2003-03-01,34,0,0,-2,9,41
Albania,2003-03-01,30,0,0,0,1,31
Albania,2003-03-01,3,0,0,4,2,9
Albania,2003-03-01,2,0,0,1,1,4
Albania,2003-03-01,1,0,0,6,0,7
Albania,2003-03-01,0,0,0,0,0,0
Albania,2003-03-01,3,0,0,0,0,3
Albania,2003-03-01,4,0,0,0,1,5
Albania,2003-03-01,4,0,0,0,0,4
Albania,2003-03-01,0,0,0,0,0,0
Albania,2003-03-01,4,0,0,-4,0,0
Albania,2003-03-01,0,0,0,0,0,0
Albania,2003-03-01,8,0,0,0,0,8
Albania,2003-03-01,5,0,0,0,1,6
Albania,2003-04-01,9,0,0,0,0,9
Albania,2003-04-01,3,0,0,3,0,6
Albania,2003-04-01,26,0,0,0,0,26
Albania,2003-04-01,9,0,-4,6,0,11
Albania,2003-04-01,2,0,0,0,0,2
Albania,2003-04-01,2,0,0,-2,0,0
Albania,2003-04-01,4,0,0,4,0,8
Albania,2003-04-01,5,0,0,0,0,5
Albania,2003-04-01,9,0,0,0,1,10
Albania,2003-04-01,8,0,0,-10,2,0
Albania,2003-04-01,-1,0,0,4,0,3
Albania,2003-04-01,8,0,2,0,6,16
Albania,2003-04-01,7,0,0,9,0,16
Albania,2003-04-01,7,0,0,0,0,7
Albania,2003-04-01,0,0,0,2,0,2
Albania,2003-04-01,9,0,0,-2,0,7
Albania,2003-04-01,4,0,-12,8,0,0
Albania,2003-04-01,15,0,0,4,0,19
Albania,2003-04-01,2,0,0,2,0,4
Albania,2003-04-01,9,0,0,0,0,9
Albania,2003-04-01,14,0,0,6,1,21
Albania,2003-04-01,0,0,0,25,13,38
Albania,2003-04-01,2,0,0,4,0,6
Albania,2003-04-01,5,0,0,0,1,6
Albania,2003-04-01,10,0,0,0,0,10
Albania,2003-04-01,0,0,0,0,0,0
Albania,2003-04-01,7,0,0,15,0,22
Albania,2003-04-01,0,0,0,0,0,0
Albania,2003-04-01,0,0,-1,0,0,-1
Albania,2003-05-01,8,0,0,4,0,12
Albania,2003-05-01,2,0,0,-2,0,0
Albania,2003-05-01,3,0,0,0,0,3
Albania,2003-05-01,5,0,0,-1,0,4
Albania,2003-05-01,6,0,0,-2,0,4
Albania,2003-05-01,2,0,0,0,0,2
Albania,2003-05-01,16,0,0,4,3,23
Albania,2003-05-01,13,0,0,9,0,22
Albania,2003-05-01,6,0,0,0,0,6
Albania,2003-05-01,0,0,0,0,1,1
Albania,2003-05-01,-6,0,0,0,0,-6
Albania,2003-05-01,7,0,0,0,0,7
Albania,2003-05-01,6,0,0,3,2,11
Albania,2003-05-01,11,0,0,15,0,26
Albania,2003-05-01,10,0,-1,7,2,18
Albania,2003-05-01,20,0,0,-1,5,24
Albania,2003-05-01,19,0,0,6,2,27
Albania,2003-05-01,12,0,-1,0,0,11
Albania,2003-05-01,19,0,0,0,0,19
Albania,2003-05-01,6,0,0,3,3,12
Albania,2003-05-01,1,0,-2,5,3,7
Albania,2003-05-01,5,0,-2,0,0,3
Albania,2003-05-01,-6,0,0,3,1,-2
Albania,2003-05-01,12,0,0,4,0,16
Albania,2003-05-01,-1,0,0,-4,0,-5
Albania,2003-05-01,13,0,0,18,0,31
Albania,2003-05-01,-5,0,0,6,0,1
Albania,2003-05-01,4,0,0,-6,1,-1
Albania,2003-05-01,0,0,0,0,1,1
Albania,2003-05-01,2,0,0,6,0,8
Albania,2003-05-01,0,0,0,9,0,9
Albania,2003-06-01,0,0,0,3,0,3
Albania,2003-06-01,13,0,0,3,2,18
Albania,2003-06-01,8,0,0,7,0,15
Albania,2003-06-01,23,0,0,0,4,27
Albania,2003-06-01,11,0,-1,0,1,11
Albania,2003-06-01,11,0,0,3,3,17
Albania,2003-06-01,9,0,0,6,2,17
Albania,2003-06-01,-1,0,0,0,0,-1
Albania,2003-06-01,21,0,0,0,2,23
Albania,2003-06-01,11,0,0,16,0,27
Albania,2003-06-01,22,0,0,6,0,28
Albania,2003-06-01,5,0,-1,12,0,16
Albania,2003-06-01,13,0,0,3,0,16
Albania,2003-06-01,2,2,0,3,0,7
Albania,2003-06-01,0,0,0,0,0,0
Albania,2003-06-01,8,0,0,10,0,18
Albania,2003-06-01,12,0,0,8,1,21
Albania,2003-06-01,10,0,0,14,0,24
Albania,2003-06-01,1,0,0,3,3,7
Albania,2003-06-01,7,0,0,2,2,11
Albania,2003-06-01,6,0,0,3,0,9
Albania,2003-06-01,2,0,0,0,3,5
Albania,2003-06-01,31,0,1,-2,0,30
Albania,2003-06-01,2,0,0,0,0,2
Albania,2003-06-01,9,0,0,3,2,14
Albania,2003-06-01,0,0,0,12,0,12
Albania,2003-06-01,1,0,0,0,1,2
Albania,2003-06-01,1,0,0,0,2,3
Albania,2003-06-01,2,0,0,-4,0,-2
Albania,2003-06-01,5,0,0,9,3,17
Albania,2003-07-01,7,0,0,19,0,26
Albania,2003-07-01,4,0,0,6,5,15
Albania,2003-07-01,3,0,-1,0,0,2
Albania,2003-07-01,1,0,0,29,0,30
Albania,2003-07-01,17,0,0,10,0,27
Albania,2003-07-01,0,0,0,3,0,3
Albania,2003-07-01,10,0,0,-4,0,6
Albania,2003-07-01,10,0,0,15,2,27
Albania,2003-07-01,9,0,0,10,0,19
Albania,2003-07-01,25,0,0,-1,6,30
Albania,2003-07-01,-1,0,0,9,2,10
Albania,2003-07-01,3,0,-3,5,0,5
Albania,2003-07-01,3,0,0,3,0,6
Albania,2003-07-01,8,0,0,15,0,23
Albania,2003-07-01,13,0,0,0,0,13
Albania,2003-07-01,10,0,0,54,9,73
Albania,2003-07-01,26,0,0,12,6,44
Albania,2003-07-01,9,0,4,6,0,19
Albania,2003-07-01,9,0,-9,0,0,0
Albania,2003-07-01,19,0,-8,6,0,17
Albania,2003-07-01,11,0,-4,6,0,13
Albania,2003-07-01,21,0,0,9,0,30
Albania,2003-07-01,19,0,0,0,2,21
Albania,2003-07-01,20,0,-1,3,1,23
Albania,2003-07-01,15,0,0,6,0,21
Albania,2003-07-01,2,0,0,0,0,2
Albania,2003-07-01,0,0,0,0,-2,-2
Albania,2003-07-01,0,0,0,0,0,0
Albania,2003-07-01,7,0,-8,6,0,5
Albania,2003-07-01,7,0,0,0,0,7
Albania,2003-07-01,8,0,0,0,0,8
Albania,2003-08-01,3,0,0,7,0,10
Albania,2003-08-01,1,0,0,0,0,1
Albania,2003-08-01,20,0,-2,9,2,29
Albania,2003-08-01,8,0,0,6,0,14
Albania,2003-08-01,10,0,0,9,0,19
Albania,2003-08-01,0,0,0,6,0,6
Albania,2003-08-01,3,0,0,9,-4,8
Albania,2003-08-01,6,0,0,0,0,6
Albania,2003-08-01,1,0,0,0,0,1
Albania,2003-08-01,20,0,0,9,0,29
Albania,2003-08-01,66,0,0,27,0,93
Albania,2003-08-01,59,0,-2,1,17,75
Albania,2003-08-01,33,0,0,-4,8,37
Albania,2003-08-01,22,0,0,9,14,45
Albania,2003-08-01,18,0,0,0,0,18
Albania,2003-08-01,52,0,0,0,0,52
Albania,2003-08-01,18,0,0,0,0,18
Albania,2003-08-01,46,0,0,3,25,74
Albania,2003-08-01,0,0,0,3,0,3
Albania,2003-08-01,0,0,0,0,0,0
Albania,2003-08-01,29,0,0,0,0,29
Albania,2003-08-01,6,0,0,0,0,6
Albania,2003-08-01,6,0,1,0,0,7
Albania,2003-08-01,11,0,0,0,4,15
Albania,2003-08-01,9,0,0,0,0,9
Albania,2003-08-01,36,0,-2,-3,0,31
Albania,2003-08-01,6,0,0,20,0,26
Albania,2003-08-01,4,0,0,0,0,4
Albania,2003-08-01,14,0,0,0,0,14
Albania,2003-09-01,22,0,0,13,3,38
Albania,2003-09-01,17,0,0,-2,1,16
Albania,2003-09-01,22,0,2,14,0,38
Albania,2003-09-01,23,0,0,6,4,33
Albania,2003-09-01,4,0,0,15,0,19
Albania,2003-09-01,7,0,0,0,0,7
Albania,2003-09-01,9,0,0,-1,2,10
Albania,2003-09-01,40,0,-2,0,0,38
Albania,2003-09-01,34,0,0,24,0,58
Albania,2003-09-01,23,0,0,0,0,23
Albania,2003-09-01,10,0,-2,0,0,8
Albania,2003-09-01,22,0,0,3,2,27
Albania,2003-09-01,6,0,0,6,0,12
Albania,2003-09-01,6,0,0,0,0,6
Albania,2003-09-01,10,2,0,0,0,12
Albania,2003-09-01,32,4,0,0,6,42
Albania,2003-09-01,6,0,0,6,6,18
Albania,2003-09-01,7,0,0,0,1,8
Albania,2003-09-01,3,0,0,3,6,12
Albania,2003-09-01,0,0,0,0,0,0
Albania,2003-09-01,11,0,2,0,0,13
Albania,2003-09-01,2,0,0,6,0,8
Albania,2003-09-01,0,0,0,3,0,3
Albania,2003-09-01,18,0,0,8,0,26
Albania,2003-09-01,10,0,0,1,4,15
Albania,2003-09-01,26,0,0,3,13,42
Albania,2003-09-01,3,0,2,0,0,5
Albania,2003-09-01,2,0,0,0,0,2
Albania,2003-09-01,7,0,0,7,0,14
Albania,2003-09-01,8,0,0,6,0,14
Albania,2003-10-01,12,0,0,-4,0,8
Albania,2003-10-01,10,0,0,5,1,16
Albania,2003-10-01,-1,0,0,0,0,-1
Albania,2003-10-01,8,0,0,6,0,14
Albania,2003-10-01,-1,0,0,6,0,5
Albania,2003-10-01,4,0,0,-2,0,2
Albania,2003-10-01,17,0,0,3,0,20
Albania,2003-10-01,18,0,0,0,1,19
Albania,2003-10-01,2,0,0,0,1,3
Albania,2003-10-01,2,0,-2,6,1,7
Albania,2003-10-01,22,0,0,0,0,22
Albania,2003-10-01,3,0,0,0,0,3
Albania,2003-10-01,23,2,0,13,2,40
Albania,2003-10-01,3,0,-2,9,3,13
Albania,2003-10-01,8,0,0,9,4,21
Albania,2003-10-01,8,0,0,-4,0,4
Albania,2003-10-01,11,0,0,0,3,14
Albania,2003-10-01,6,0,0,0,0,6
Albania,2003-10-01,9,0,0,0,0,9
Albania,2003-10-01,10,0,-2,36,2,46
Albania,2003-10-01,10,0,0,16,0,26
Albania,2003-10-01,6,0,0,30,6,42
Albania,2003-10-01,12,0,0,3,3,18
Albania,2003-10-01,3,0,0,15,0,18
Albania,2003-10-01,8,0,-2,0,0,6
Albania,2003-10-01,6,0,-2,0,2,6
Albania,2003-10-01,7,0,0,20,6,33
Albania,2003-10-01,2,0,0,30,13,45
Albania,2003-10-01,9,0,0,18,3,30
Albania,2003-10-01,-4,0,-2,3,0,-3
Albania,2003-10-01,7,0,0,0,0,7
Albania,2003-11-01,4,0,0,1,0,5
Albania,2003-11-01,0,0,0,-4,0,-4
Albania,2003-11-01,4,0,0,2,3,9
Albania,2003-11-01,4,0,1,9,2,16
Albania,2003-11-01,6,0,0,3,0,9
Albania,2003-11-01,11,0,1,15,0,27
Albania,2003-11-01,4,0,0,15,0,19
Albania,2003-11-01,3,0,0,3,2,8
Albania,2003-11-01,6,0,0,-2,3,7
Albania,2003-11-01,11,0,1,3,0,15
Albania,2003-11-01,7,0,0,3,0,10
Albania,2003-11-01,-1,0,0,-4,1,-4
Albania,2003-11-01,25,0,-1,9,2,35
Albania,2003-11-01,3,0,-1,0,7,9
Albania,2003-11-01,14,0,0,0,0,14
Albania,2003-11-01,2,0,-2,0,2,2
Albania,2003-11-01,8,0,0,6,0,14
Albania,2003-11-01,3,0,0,6,3,12
Albania,2003-11-01,1,0,0,4,10,15
Albania,2003-11-01,1,0,0,-6,0,-5
Albania,2003-11-01,0,0,0,0,2,2
Albania,2003-11-01,3,0,0,0,4,7
Albania,2003-11-01,17,0,-1,0,2,18
Albania,2003-11-01,5,0,0,0,10,15
Albania,2003-11-01,21,0,-6,3,1,19
Albania,2003-11-01,4,0,0,3,3,10
Albania,2003-11-01,9,0,-2,-2,2,7
Albania,2003-11-01,18,0,0,0,0,18
Albania,2003-11-01,0,0,0,0,0,0
Albania,2003-12-01,19,0,-2,8,0,25
Albania,2003-12-01,3,0,-2,0,3,4
Albania,2003-12-01,16,0,0,-2,3,17
Albania,2003-12-01,27,0,0,4,2,33
Albania,2003-12-01,-1,0,0,-3,0,-4
Albania,2003-12-01,18,0,0,0,5,23
Albania,2003-12-01,0,0,0,0,0,0
Albania,2003-12-01,6,0,0,0,0,6
Albania,2003-12-01,11,0,0,0,2,13
Albania,2003-12-01,10,0,0,3,11,24
Albania,2003-12-01,7,0,0,6,0,13
Albania,2003-12-01,0,0,-4,1,2,-1
Albania,2003-12-01,-1,0,0,12,2,13
Albania,2003-12-01,4,0,0,0,2,6
Albania,2003-12-01,3,0,0,0,0,3
Albania,2003-12-01,-7,0,0,0,0,-7
Albania,2003-12-01,13,0,0,6,0,19
Albania,2003-12-01,10,0,0,14,4,28
Albania,2003-12-01,6,0,0,0,0,6
Albania,2003-12-01,8,0,0,6,3,17
Albania,2003-12-01,0,0,0,0,1,1
Albania,2003-12-01,14,0,0,0,1,15
Albania,2003-12-01,12,0,-1,16,0,27
Albania,2003-12-01,1,0,0,0,0,1
Albania,2003-12-01,3,0,0,0,0,3
Albania,2003-12-01,-5,0,0,-2,0,-7
Albania,2003-12-01,7,0,0,0,0,7
Albania,2003-12-01,11,0,0,0,1,12
Albania,2003-12-01,9,0,0,0,13,22
Albania,2003-12-01,17,0,0,-2,3,18
Albania,2003-12-01,25,0,0,0,0,25
Algeria,2003-01-01,4,0,0,15,0,19
Algeria,2003-01-01,0,0,0,0,0,0
Algeria,2003-01-01,1,0,0,12,0,13
Algeria,2003-01-01,0,0,0,3,1,4
Algeria,2003-01-01,1,0,0,0,0,1
Algeria,2003-01-01,0,0,0,0,0,0
Algeria,2003-01-01,14,0,0,6,0,20
Algeria,2003-01-01,1,0,0,9,0,10
Algeria,2003-01-01,1,0,0,0,0,1
Algeria,2003-01-01,39,0,0,-3,0,36
Algeria,2003-01-01,15,0,0,9,0,24
Algeria,2003-01-01,2,0,0,0,0,2
Algeria,2003-01-01,4,0,0,9,0,13
Algeria,2003-01-01,6,0,-1,18,2,25
Algeria,2003-01-01,6,0,0,18,0,24
Algeria,2003-01-01,44,0,0,24,2,70
Algeria,2003-01-01,8,0,0,24,0,32
Algeria,2003-01-01,5,0,0,6,0,11
Algeria,2003-01-01,0,0,0,0,0,0
Algeria,2003-01-01,11,0,0,30,0,41
Algeria,2003-01-01,4,0,0,30,0,34
Algeria,2003-01-01,8,0,0,21,1,30
Algeria,2003-01-01,0,0,0,0,0,0
Algeria,2003-01-01,6,0,0,9,0,15
Algeria,2003-01-01,6,0,0,15,0,21
Algeria,2003-01-01,0,0,0,9,0,9
Algeria,2003-01-01,8,0,0,3,0,11
Algeria,2003-01-01,4,0,0,2,0,6
Algeria,2003-01-01,0,0,0,0,0,0
Algeria,2003-01-01,8,0,0,6,0,14
Algeria,2003-01-01,8,0,0,6,0,14
Algeria,2003-02-01,9,0,0,6,0,15
Algeria,2003-02-01,0,0,0,3,0,3
Algeria,2003-02-01,12,0,0,0,0,12
Algeria,2003-02-01,6,0,0,6,0,12
Algeria,2003-02-01,9,0,0,0,0,9
Algeria,2003-02-01,0,0,0,9,1,10
Algeria,2003-02-01,5,0,0,12,0,17
Algeria,2003-02-01,0,0,0,0,0,0
Algeria,2003-02-01,0,0,0,0,0,0
Algeria,2003-02-01,7,0,0,3,0,10
Algeria,2003-02-01,0,0,0,3,0,3
Algeria,2003-02-01,7,0,0,3,0,10
Algeria,2003-02-01,0,0,0,3,0,3
Algeria,2003-02-01,2,0,0,0,0,2
Algeria,2003-02-01,1,0,0,-6,1,-4
Algeria,2003-02-01,2,0,0,3,0,5
Algeria,2003-02-01,16,0,0,6,0,22
Algeria,2003-02-01,0,0,0,0,0,0
Algeria,2003-02-01,0,0,0,0,0,0
Algeria,2003-02-01,0,0,0,0,0,0
Algeria,2003-02-01,1,0,0,0,0,1
Algeria,2003-02-01,11,0,0,0,0,11
Algeria,2003-02-01,0,0,0,0,0,0
Algeria,2003-02-01,0,0,0,0,0,0
Algeria,2003-02-01,7,0,0,12,2,21
Algeria,2003-02-01,1,0,0,6,4,11
Algeria,2003-02-01,34,0,0,21,4,59
Algeria,2003-02-01,1,0,1,0,0,2
Algeria,2003-03-01,-1,0,0,0,0,-1
Algeria,2003-03-01,0,0,0,0,0,0
Algeria,2003-03-01,1,0,-2,0,0,-1
Algeria,2003-03-01,0,0,0,9,0,9
Algeria,2003-03-01,1,0,0,3,0,4
Algeria,2003-03-01,4,0,0,0,0,4
Algeria,2003-03-01,0,0,0,0,1,1
Algeria,2003-03-01,0,0,0,0,0,0
Algeria,2003-03-01,3,0,0,6,0,9
Algeria,2003-03-01,16,0,0,15,1,32
Algeria,2003-03-01,7,0,0,-2,0,5
Algeria,2003-03-01,0,0,0,3,0,3
Algeria,2003-03-01,0,0,0,3,0,3
Algeria,2003-03-01,0,0,0,3,0,3
Algeria,2003-03-01,7,0,0,6,0,13
Algeria,2003-03-01,5,0,0,3,0,8
Algeria,2003-03-01,-1,0,0,0,0,-1
Algeria,2003-03-01,0,0,0,3,0,3
Algeria,2003-03-01,0,0,0,3,0,3
Algeria,2003-03-01,0,0,0,9,0,9
Algeria,2003-03-01,-1,0,3,-4,0,-2
Algeria,2003-03-01,0,0,0,0,0,0
Algeria,2003-03-01,2,0,0,0,0,2
Algeria,2003-03-01,17,0,0,-4,0,13
Algeria,2003-03-01,2,0,0,-2,0,0
Algeria,2003-03-01,1,0,0,6,0,7
Algeria,2003-03-01,0,0,0,0,0,0
Algeria,2003-03-01,0,0,0,0,5,5
Algeria,2003-03-01,0,0,0,0,0,0
Algeria,2003-03-01,3,0,0,0,0,3
Algeria,2003-03-01,12,0,0,0,1,13
Algeria,2003-04-01,1,4,2,15,1,23
Algeria,2003-04-01,0,4,0,3,3,10
Algeria,2003-04-01,5,0,0,0,0,5
Algeria,2003-04-01,12,0,0,30,1,43
Algeria,2003-04-01,2,6,0,18,0,26
Algeria,2003-04-01,0,0,0,0,0,0
Algeria,2003-04-01,2,0,1,0,0,3
Algeria,2003-04-01,3,0,0,9,0,12
Algeria,2003-04-01,6,0,0,6,0,12
Algeria,2003-04-01,0,0,0,0,0,0
Algeria,2003-04-01,-1,0,0,0,0,-1
Algeria,2003-04-01,1,0,0,9,0,10
Algeria,2003-04-01,2,0,0,9,0,11
Algeria,2003-04-01,2,0,0,6,0,8
Algeria,2003-04-01,2,0,0,0,0,2
Algeria,2003-04-01,3,0,0,3,0,6
Algeria,2003-04-01,2,0,0,0,0,2
Algeria,2003-04-01,5,0,-4,0,0,1
Algeria,2003-04-01,0,0,2,0,2,4
Algeria,2003-04-01,2,0,0,0,1,3
Algeria,2003-04-01,4,0,0,0,0,4
Algeria,2003-04-01,0,0,0,0,1,1
Algeria,2003-04-01,4,0,0,0,0,4
Algeria,2003-04-01,0,0,0,0,0,0
Algeria,2003-04-01,0,0,0,12,0,12
Algeria,2003-04-01,2,0,0,3,0,5
Algeria,2003-04-01,1,0,0,0,0,1
Algeria,2003-04-01,0,0,0,0,0,0
Algeria,2003-04-01,5,0,0,9,0,14
Algeria,2003-05-01,0,0,0,0,0,0
Algeria,2003-05-01,0,0,0,0,0,0
Algeria,2003-05-01,0,0,0,0,1,1
Algeria,2003-05-01,0,0,0,0,0,0
Algeria,2003-05-01,0,0,0,-6,0,-6
Algeria,2003-05-01,3,0,0,0,0,3
Algeria,2003-05-01,6,0,0,1,1,8
Algeria,2003-05-01,0,0,0,0,0,0
Algeria,2003-05-01,1,0,0,3,0,4
Algeria,2003-05-01,1,0,0,0,0,1
Algeria,2003-05-01,0,0,0,0,0,0
Algeria,2003-05-01,6,0,0,-4,0,2
Algeria,2003-05-01,1,0,0,0,0,1
Algeria,2003-05-01,-2,0,0,0,1,-1
Algeria,2003-05-01,4,0,0,-6,0,-2
Algeria,2003-05-01,0,0,0,0,0,0
Algeria,2003-05-01,3,0,0,0,0,3
Algeria,2003-05-01,0,0,0,6,4,10
Algeria,2003-05-01,2,0,0,-11,0,-9
Algeria,2003-05-01,11,0,0,0,0,11
Algeria,2003-05-01,0,0,0,6,0,6
Algeria,2003-05-01,14,2,0,3,2,21
Algeria,2003-05-01,-4,0,0,0,0,-4
Algeria,2003-05-01,0,0,0,3,0,3
Algeria,2003-05-01,0,0,0,6,0,6
Algeria,2003-05-01,4,0,0,0,1,5
Algeria,2003-05-01,3,0,0,0,1,4
Algeria,2003-05-01,2,0,0,3,0,5
Algeria,2003-05-01,2,0,0,-2,0,0
Algeria,2003-05-01,4,0,0,0,0,4
Algeria,2003-05-01,6,0,0,0,0,6
Algeria,2003-06-01,0,2,0,6,0,8
Algeria,2003-06-01,0,0,0,0,0,0
Algeria,2003-06-01,-1,0,0,-2,2,-1
Algeria,2003-06-01,1,0,0,9,2,12
Algeria,2003-06-01,-6,0,0,3,0,-3
Algeria,2003-06-01,0,0,0,0,4,4
Algeria,2003-06-01,9,0,0,0,0,9
Algeria,2003-06-01,5,0,0,0,0,5
Algeria,2003-06-01,1,0,0,0,0,1
Algeria,2003-06-01,4,0,0,0,0,4
Algeria,2003-06-01,2,0,0,0,0,2
Algeria,2003-06-01,1,0,0,0,0,1
Algeria,2003-06-01,3,0,0,0,2,5
Algeria,2003-06-01,0,0,0,0,0,0
Algeria,2003-06-01,3,0,0,3,0,6
Algeria,2003-06-01,1,0,0,3,0,4
Algeria,2003-06-01,0,0,0,6,0,6
Algeria,2003-06-01,4,0,0,3,0,7
Algeria,2003-06-01,0,0,0,3,6,9
Algeria,2003-06-01,0,0,0,0,0,0
Algeria,2003-06-01,0,0,0,0,0,0
Algeria,2003-06-01,0,0,0,0,0,0
Algeria,2003-06-01,3,0,0,0,1,4
Algeria,2003-06-01,0,0,0,3,0,3
Algeria,2003-06-01,0,0,0,6,0,6
Algeria,2003-06-01,6,0,0,3,1,10
Algeria,2003-06-01,2,0,0,0,0,2
Algeria,2003-06-01,0,0,0,0,0,0
Algeria,2003-06-01,6,0,0,0,0,6
Algeria,2003-07-01,0,0,0,-1,0,-1
Algeria,2003-07-01,12,0,0,7,2,21
Algeria,2003-07-01,0,0,0,-2,0,-2
Algeria,2003-07-01,2,0,0,0,1,3
Algeria,2003-07-01,0,0,0,0,0,0
Algeria,2003-07-01,7,0,0,0,0,7
Algeria,2003-07-01,3,0,0,0,0,3
Algeria,2003-07-01,3,0,0,3,0,6
Algeria,2003-07-01,6,0,0,0,0,6
Algeria,2003-07-01,1,0,0,0,2,3
Algeria,2003-07-01,0,0,0,0,0,0
Algeria,2003-07-01,2,0,0,0,0,2
Algeria,2003-07-01,11,0,0,-2,0,9
Algeria,2003-07-01,1,0,0,6,0,7
Algeria,2003-07-01,4,0,0,12,0,16
Algeria,2003-07-01,0,0,0,3,0,3
Algeria,2003-07-01,4,0,0,3,0,7
Algeria,2003-07-01,3,0,0,3,1,7
Algeria,2003-07-01,0,0,0,0,0,0
Algeria,2003-07-01,3,0,0,0,0,3
Algeria,2003-07-01,3,0,0,3,0,6
Algeria,2003-07-01,-3,0,0,3,1,1
Algeria,2003-07-01,6,0,0,0,0,6
Algeria,2003-07-01,0,0,0,0,0,0
Algeria,2003-07-01,-1,0,0,0,0,-1
Algeria,2003-07-01,0,0,0,0,0,0
Algeria,2003-07-01,0,0,0,0,0,0
Algeria,2003-07-01,16,0,0,0,0,16
Algeria,2003-07-01,0,0,0,0,0,0
Algeria,2003-07-01,0,0,0,3,0,3
Algeria,2003-07-01,2,0,0,14,0,16
Algeria,2003-08-01,6,0,0,5,1,12
Algeria,2003-08-01,3,0,0,2,0,5
Algeria,2003-08-01,2,0,0,26,0,28
Algeria,2003-08-01,4,0,0,0,0,4
Algeria,2003-08-01,9,0,0,0,0,9
Algeria,2003-08-01,12,0,0,14,0,26
Algeria,2003-08-01,4,0,0,9,0,13
Algeria,2003-08-01,1,0,0,15,0,16
Algeria,2003-08-01,3,0,0,3,0,6
Algeria,2003-08-01,1,0,0,15,0,16
Algeria,2003-08-01,0,0,0,-1,0,-1
Algeria,2003-08-01,-2,0,0,0,0,-2
Algeria,2003-08-01,0,0,0,3,0,3
Algeria,2003-08-01,6,0,-2,-5,0,-1
Algeria,2003-08-01,3,0,0,-1,5,7
Algeria,2003-08-01,11,0,0,3,0,14
Algeria,2003-08-01,4,0,0,2,0,6
Algeria,2003-08-01,13,0,0,-5,0,8
Algeria,2003-08-01,9,0,0,-1,1,9
Algeria,2003-08-01,2,0,0,0,0,2
Algeria,2003-08-01,0,0,0,-4,0,-4
Algeria,2003-08-01,7,0,0,-2,4,9
Algeria,2003-08-01,5,0,1,39,2,47
Algeria,2003-08-01,-4,0,0,4,0,0
Algeria,2003-08-01,1,0,0,10,0,11
Algeria,2003-08-01,0,0,0,1,0,1
Algeria,2003-08-01,0,0,0,0,0,0
Algeria,2003-08-01,0,0,0,0,0,0
Algeria,2003-08-01,0,0,0,0,0,0
Algeria,2003-08-01,0,0,0,0,0,0
Algeria,2003-08-01,15,0,0,0,0,15
Algeria,2003-09-01,8,0,-2,13,0,19
Algeria,2003-09-01,7,0,0,0,0,7
Algeria,2003-09-01,2,0,1,5,0,8
Algeria,2003-09-01,0,0,0,1,3,4
Algeria,2003-09-01,0,0,0,3,0,3
Algeria,2003-09-01,-2,0,0,3,1,2
Algeria,2003-09-01,1,0,0,0,0,1
Algeria,2003-09-01,0,0,0,0,0,0
Algeria,2003-09-01,10,0,0,-1,0,9
Algeria,2003-09-01,1,0,0,0,0,1
Algeria,2003-09-01,8,0,0,24,0,32
Algeria,2003-09-01,0,0,0,9,0,9
Algeria,2003-09-01,4,0,0,0,0,4
Algeria,2003-09-01,0,0,0,0,0,0
Algeria,2003-09-01,6,0,0,3,0,9
Algeria,2003-09-01,2,0,0,3,0,5
Algeria,2003-09-01,11,0,0,3,0,14
Algeria,2003-09-01,0,0,0,0,0,0
Algeria,2003-09-01,5,0,0,7,0,12
Algeria,2003-09-01,0,0,0,0,0,0
Algeria,2003-09-01,1,0,0,3,0,4
Algeria,2003-09-01,3,0,0,0,0,3
Algeria,2003-09-01,-1,0,0,0,0,-1
Algeria,2003-09-01,6,2,-1,0,2,9
Algeria,2003-09-01,8,0,0,27,0,35
Algeria,2003-09-01,0,0,0,31,0,31
Algeria,2003-09-01,0,0,0,3,0,3
Algeria,2003-09-01,1,0,0,0,0,1
Algeria,2003-09-01,7,0,0,12,2,21
Algeria,2003-10-01,0,0,0,9,0,9
Algeria,2003-10-01,-5,0,0,3,2,0
Algeria,2003-10-01,0,0,0,0,0,0
Algeria,2003-10-01,2,0,0,4,0,6
Algeria,2003-10-01,2,0,0,18,0,20
Algeria,2003-10-01,6,0,0,3,3,12
Algeria,2003-10-01,-3,0,0,0,2,-1
Algeria,2003-10-01,0,0,0,0,0,0
Algeria,2003-10-01,5,0,0,0,1,6
Algeria,2003-10-01,0,0,0,12,0,12
Algeria,2003-10-01,1,0,0,9,0,10
Algeria,2003-10-01,6,0,0,9,0,15
Algeria,2003-10-01,-4,0,0,9,0,5
Algeria,2003-10-01,6,0,1,2,1,10
Algeria,2003-10-01,1,0,0,15,4,20
Algeria,2003-10-01,2,0,0,0,0,2
Algeria,2003-10-01,0,0,0,6,0,6
Algeria,2003-10-01,-1,0,0,0,0,-1
Algeria,2003-10-01,0,0,0,3,0,3
Algeria,2003-10-01,2,0,0,8,0,10
Algeria,2003-10-01,0,0,0,2,0,2
Algeria,2003-10-01,1,0,0,0,0,1
Algeria,2003-10-01,0,0,0,0,0,0
Algeria,2003-10-01,-1,0,0,0,0,-1
Algeria,2003-10-01,1,0,0,-2,0,-1
Algeria,2003-10-01,1,0,1,6,0,8
Algeria,2003-10-01,0,0,0,0,0,0
Algeria,2003-10-01,-1,0,0,0,0,-1
Algeria,2003-10-01,10,0,0,25,0,35
Algeria,2003-10-01,8,0,0,18,0,26
Algeria,2003-10-01,15,0,0,12,0,27
Algeria,2003-11-01,12,0,0,3,0,15
Algeria,2003-11-01,0,0,-4,0,0,-4
Algeria,2003-11-01,3,0,0,0,0,3
Algeria,2003-11-01,0,0,0,0,0,0
Algeria,2003-11-01,4,0,0,12,0,16
Algeria,2003-11-01,-1,0,0,0,0,-1
Algeria,2003-11-01,1,0,0,-5,0,-4
Algeria,2003-11-01,0,0,0,6,0,6
Algeria,2003-11-01,0,0,0,9,0,9
Algeria,2003-11-01,3,0,0,6,0,9
Algeria,2003-11-01,2,0,0,0,2,4
Algeria,2003-11-01,1,0,0,-2,0,-1
Algeria,2003-11-01,2,0,0,3,0,5
Algeria,2003-11-01,0,0,0,0,0,0
Algeria,2003-11-01,1,0,0,-4,0,-3
Algeria,2003-11-01,2,0,0,6,0,8
Algeria,2003-11-01,2,0,0,0,0,2
Algeria,2003-11-01,2,0,0,6,0,8
Algeria,2003-11-01,8,0,0,0,0,8
Algeria,2003-11-01,0,0,0,0,0,0
Algeria,2003-11-01,0,0,0,-6,0,-6
Algeria,2003-11-01,7,0,0,-5,0,2
Algeria,2003-11-01,1,0,0,0,0,1
Algeria,2003-11-01,2,0,0,0,0,2
Algeria,2003-11-01,1,0,0,12,0,13
Algeria,2003-11-01,5,0,0,9,0,14
Algeria,2003-11-01,8,0,0,36,6,50
Algeria,2003-11-01,4,0,0,11,0,15
Algeria,2003-11-01,10,0,0,6,0,16
Algeria,2003-11-01,-3,0,-2,0,0,-5
Algeria,2003-12-01,1,0,0,0,0,1
Algeria,2003-12-01,6,0,0,-1,0,5
Algeria,2003-12-01,13,0,0,6,0,19
Algeria,2003-12-01,0,0,0,18,0,18
Algeria,2003-12-01,0,0,0,6,0,6
Algeria,2003-12-01,1,0,0,0,0,1
Algeria,2003-12-01,-2,0,0,0,0,-2
Algeria,2003-12-01,0,0,0,5,0,5
Algeria,2003-12-01,0,0,0,9,0,9
Algeria,2003-12-01,10,0,0,9,0,19
Algeria,2003-12-01,-1,0,0,3,0,2
Algeria,2003-12-01,3,0,0,-2,0,1
Algeria,2003-12-01,0,0,0,0,0,0
Algeria,2003-12-01,3,0,0,0,0,3
Algeria,2003-12-01,0,0,0,0,0,0
Algeria,2003-12-01,0,0,0,0,0,0
Algeria,2003-12-01,0,0,0,0,0,0
Algeria,2003-12-01,3,0,0,12,3,18
Algeria,2003-12-01,15,0,0,9,3,27
Algeria,2003-12-01,0,0,0,3,0,3
Algeria,2003-12-01,2,0,0,13,0,15
Algeria,2003-12-01,2,0,0,9,0,11
Algeria,2003-12-01,7,0,0,24,0,31
Algeria,2003-12-01,5,0,0,1,2,8
Algeria,2003-12-01,0,0,0,9,0,9
Algeria,2003-12-01,3,0,0,6,0,9
Algeria,2003-12-01,2,0,0,0,0,2
Algeria,2003-12-01,0,0,0,0,0,0
Algeria,2003-12-01,0,0,0,6,0,6
Algeria,2003-12-01,4,0,0,9,0,13
Algeria,2003-12-01,0,0,0,0,2,2
Bangladesh,2003-01-01,3,0,0,0,0,3
Bangladesh,2003-01-01,-1,0,0,0,0,-1
Bangladesh,2003-01-01,0,0,0,0,0,0
Bangladesh,2003-01-01,2,0,0,3,0,5
Bangladesh,2003-01-01,6,0,0,9,0,15
Bangladesh,2003-01-01,9,0,0,9,0,18
Bangladesh,2003-01-01,-1,0,0,0,0,-1
Bangladesh,2003-01-01,0,0,0,0,0,0
Bangladesh,2003-01-01,11,0,0,-2,0,9
Bangladesh,2003-01-01,3,0,0,5,0,8
Bangladesh,2003-01-01,0,0,0,0,0,0
Bangladesh,2003-01-01,3,0,0,3,0,6
Bangladesh,2003-01-01,0,0,0,4,0,4
Bangladesh,2003-01-01,0,0,0,-1,0,-1
Bangladesh,2003-01-01,3,0,0,-2,1,2
Bangladesh,2003-01-01,2,0,0,0,3,5
Bangladesh,2003-01-01,-4,0,0,0,0,-4
Bangladesh,2003-01-01,9,0,0,0,0,9
Bangladesh,2003-01-01,6,0,0,0,0,6
Bangladesh,2003-01-01,0,0,0,0,0,0
Bangladesh,2003-01-01,0,0,0,0,0,0
Bangladesh,2003-01-01,3,0,0,18,0,21
Bangladesh,2003-01-01,0,0,0,0,0,0
Bangladesh,2003-01-01,0,0,0,0,0,0
Bangladesh,2003-01-01,12,0,0,0,0,12
Bangladesh,2003-01-01,0,2,0,0,0,2
Bangladesh,2003-01-01,6,0,0,0,0,6
Bangladesh,2003-01-01,-1,2,0,0,0,1
Bangladesh,2003-01-01,0,0,0,3,0,3
Bangladesh,2003-02-01,6,0,0,-2,0,4
Bangladesh,2003-02-01,1,0,0,0,0,1
Bangladesh,2003-02-01,1,0,0,3,0,4
Bangladesh,2003-02-01,2,0,0,0,0,2
Bangladesh,2003-02-01,6,0,0,0,0,6
Bangladesh,2003-02-01,0,0,0,0,0,0
Bangladesh,2003-02-01,0,0,0,0,0,0
Bangladesh,2003-02-01,0,0,0,0,0,0
Bangladesh,2003-02-01,0,0,0,6,0,6
Bangladesh,2003-02-01,0,0,0,0,0,0
Bangladesh,2003-02-01,0,0,0,0,0,0
Bangladesh,2003-02-01,0,0,0,0,0,0
Bangladesh,2003-02-01,0,0,0,0,0,0
Bangladesh,2003-02-01,12,0,1,6,0,19
Bangladesh,2003-02-01,2,0,0,0,0,2
Bangladesh,2003-02-01,6,0,0,9,0,15
Bangladesh,2003-02-01,1,0,0,3,0,4
Bangladesh,2003-02-01,0,0,0,0,0,0
Bangladesh,2003-02-01,0,0,0,0,0,0
Bangladesh,2003-02-01,0,0,0,2,2,4
Bangladesh,2003-02-01,15,0,0,6,0,21
Bangladesh,2003-02-01,5,0,0,10,0,15
Bangladesh,2003-03-01,0,0,0,1,2,3
Bangladesh,2003-03-01,7,0,0,0,0,7
Bangladesh,2003-03-01,4,0,0,0,0,4
Bangladesh,2003-03-01,0,0,0,0,2,2
Bangladesh,2003-03-01,0,0,0,0,0,0
Bangladesh,2003-03-01,0,0,0,3,0,3
Bangladesh,2003-03-01,0,0,-2,0,0,-2
Bangladesh,2003-03-01,-1,0,0,0,0,-1
Bangladesh,2003-03-01,0,0,0,0,1,1
Bangladesh,2003-03-01,-1,0,0,0,0,-1
Bangladesh,2003-03-01,1,0,0,0,0,1
Bangladesh,2003-03-01,0,0,0,0,0,0
Bangladesh,2003-03-01,0,0,0,0,0,0
Bangladesh,2003-03-01,8,0,0,0,0,8
Bangladesh,2003-03-01,1,0,0,6,0,7
Bangladesh,2003-03-01,0,0,0,0,0,0
Bangladesh,2003-03-01,0,0,0,0,0,0
Bangladesh,2003-03-01,0,0,0,0,5,5
Bangladesh,2003-03-01,0,0,0,6,0,6
Bangladesh,2003-03-01,0,0,0,0,0,0
Bangladesh,2003-03-01,1,0,0,0,0,1
Bangladesh,2003-03-01,3,0,0,3,0,6
Bangladesh,2003-03-01,0,0,0,0,1,1
Bangladesh,2003-03-01,6,0,0,0,2,8
Bangladesh,2003-03-01,3,0,0,0,0,3
Bangladesh,2003-03-01,3,0,0,0,0,3
Bangladesh,2003-03-01,-2,0,0,0,0,-2
Bangladesh,2003-04-01,5,0,0,3,0,8
Bangladesh,2003-04-01,-3,0,0,0,0,-3
Bangladesh,2003-04-01,6,0,0,3,0,9
Bangladesh,2003-04-01,0,0,0,0,0,0
Bangladesh,2003-04-01,3,0,1,0,0,4
Bangladesh,2003-04-01,0,0,0,3,0,3
Bangladesh,2003-04-01,0,0,0,-4,1,-3
Bangladesh,2003-04-01,5,0,0,3,0,8
Bangladesh,2003-04-01,0,0,0,6,0,6
Bangladesh,2003-04-01,0,0,0,0,0,0
Bangladesh,2003-04-01,0,0,0,0,0,0
Bangladesh,2003-04-01,0,0,0,0,0,0
Bangladesh,2003-04-01,1,0,0,0,0,1
Bangladesh,2003-04-01,0,0,0,0,1,1
Bangladesh,2003-04-01,0,0,0,0,0,0
Bangladesh,2003-04-01,0,0,0,0,0,0
Bangladesh,2003-04-01,0,0,0,0,0,0
Bangladesh,2003-04-01,0,0,0,0,0,0
Bangladesh,2003-04-01,1,0,0,0,0,1
Bangladesh,2003-04-01,3,0,0,3,0,6
Bangladesh,2003-04-01,0,0,0,0,0,0
Bangladesh,2003-04-01,9,0,0,0,0,9
Bangladesh,2003-04-01,0,0,0,0,0,0
Bangladesh,2003-04-01,0,0,0,0,0,0
Bangladesh,2003-05-01,3,0,0,0,0,3
Bangladesh,2003-05-01,0,0,0,0,0,0
Bangladesh,2003-05-01,2,0,0,0,0,2
Bangladesh,2003-05-01,-6,0,0,0,0,-6
Bangladesh,2003-05-01,1,0,0,0,0,1
Bangladesh,2003-05-01,0,0,0,0,1,1
Bangladesh,2003-05-01,6,0,0,0,0,6
Bangladesh,2003-05-01,0,0,0,0,0,0
Bangladesh,2003-05-01,3,0,0,3,0,6
Bangladesh,2003-05-01,0,0,0,0,0,0
Bangladesh,2003-05-01,1,0,0,0,0,1
Bangladesh,2003-05-01,0,0,0,0,0,0
Bangladesh,2003-05-01,11,0,0,0,0,11
Bangladesh,2003-05-01,0,0,0,0,0,0
Bangladesh,2003-05-01,0,0,0,0,0,0
Bangladesh,2003-05-01,3,0,0,3,0,6
Bangladesh,2003-05-01,0,0,0,3,0,3
Bangladesh,2003-05-01,0,0,0,0,0,0
Bangladesh,2003-05-01,1,0,0,3,0,4
Bangladesh,2003-05-01,0,0,0,0,0,0
Bangladesh,2003-05-01,0,0,0,0,2,2
Bangladesh,2003-05-01,0,0,0,0,0,0
Bangladesh,2003-05-01,0,0,0,3,0,3
Bangladesh,2003-05-01,3,0,0,3,0,6
Bangladesh,2003-05-01,5,0,0,0,0,5
Bangladesh,2003-05-01,14,0,0,6,0,20
Bangladesh,2003-05-01,2,0,0,0,0,2
Bangladesh,2003-05-01,0,0,0,6,0,6
Bangladesh,2003-05-01,0,0,0,0,0,0
Bangladesh,2003-06-01,0,0,0,6,0,6
Bangladesh,2003-06-01,19,0,0,3,0,22
Bangladesh,2003-06-01,0,0,0,18,0,18
Bangladesh,2003-06-01,0,0,0,4,0,4
Bangladesh,2003-06-01,6,0,0,6,0,12
Bangladesh,2003-06-01,3,0,0,0,1,4
Bangladesh,2003-06-01,1,0,0,0,2,3
Bangladesh,2003-06-01,1,0,0,0,1,2
Bangladesh,2003-06-01,0,0,0,0,0,0
Bangladesh,2003-06-01,2,0,0,0,0,2
Bangladesh,2003-06-01,0,0,0,3,0,3
Bangladesh,2003-06-01,0,0,0,6,0,6
Bangladesh,2003-06-01,0,0,0,0,0,0
Bangladesh,2003-06-01,0,0,0,21,0,21
Bangladesh,2003-06-01,0,0,0,0,0,0
Bangladesh,2003-06-01,1,0,0,12,0,13
Bangladesh,2003-06-01,-3,0,0,-4,0,-7
Bangladesh,2003-06-01,3,0,0,-4,0,-1
Bangladesh,2003-06-01,-1,0,0,6,0,5
Bangladesh,2003-06-01,3,0,0,6,1,10
Bangladesh,2003-06-01,2,0,0,0,0,2
Bangladesh,2003-06-01,0,0,0,6,0,6
Bangladesh,2003-06-01,0,0,0,0,0,0
Bangladesh,2003-06-01,0,0,0,0,0,0
Bangladesh,2003-06-01,0,0,0,0,0,0
Bangladesh,2003-07-01,11,0,0,7,0,18
Bangladesh,2003-07-01,6,0,0,6,0,12
Bangladesh,2003-07-01,0,0,0,0,0,0
Bangladesh,2003-07-01,0,0,0,0,0,0
Bangladesh,2003-07-01,0,0,0,3,0,3
Bangladesh,2003-07-01,0,0,0,0,0,0
Bangladesh,2003-07-01,4,0,0,0,0,4
Bangladesh,2003-07-01,1,0,0,3,0,4
Bangladesh,2003-07-01,0,0,0,0,0,0
Bangladesh,2003-07-01,0,0,0,0,0,0
Bangladesh,2003-07-01,2,0,0,0,0,2
Bangladesh,2003-07-01,0,0,0,0,0,0
Bangladesh,2003-07-01,3,0,0,0,0,3
Bangladesh,2003-07-01,2,0,0,3,0,5
Bangladesh,2003-07-01,1,0,0,0,0,1
Bangladesh,2003-07-01,0,0,0,0,0,0
Bangladesh,2003-07-01,9,0,0,0,0,9
Bangladesh,2003-07-01,1,0,0,0,0,1
Bangladesh,2003-07-01,4,0,0,3,0,7
Bangladesh,2003-07-01,0,0,0,3,0,3
Bangladesh,2003-07-01,0,0,0,3,0,3
Bangladesh,2003-07-01,7,0,0,0,0,7
Bangladesh,2003-07-01,2,0,0,22,0,24
Bangladesh,2003-07-01,9,0,0,0,0,9
Bangladesh,2003-07-01,0,0,0,0,0,0
Bangladesh,2003-07-01,1,0,0,0,0,1
Bangladesh,2003-07-01,1,0,0,-2,2,1
Bangladesh,2003-07-01,2,0,0,6,2,10
Bangladesh,2003-07-01,1,0,0,0,0,1
Bangladesh,2003-08-01,0,0,0,0,0,0
Bangladesh,2003-08-01,0,0,0,0,0,0
Bangladesh,2003-08-01,0,0,0,0,0,0
Bangladesh,2003-08-01,0,0,0,0,0,0
Bangladesh,2003-08-01,3,0,0,0,0,3
Bangladesh,2003-08-01,3,0,0,9,0,12
Bangladesh,2003-08-01,0,0,0,3,0,3
Bangladesh,2003-08-01,0,0,0,3,2,5
Bangladesh,2003-08-01,0,0,0,0,0,0
Bangladesh,2003-08-01,19,0,0,12,0,31
Bangladesh,2003-08-01,3,0,0,0,0,3
Bangladesh,2003-08-01,-4,0,0,0,0,-4
Bangladesh,2003-08-01,0,0,0,0,0,0
Bangladesh,2003-08-01,0,0,0,6,0,6
Bangladesh,2003-08-01,5,0,1,0,0,6
Bangladesh,2003-08-01,0,0,0,3,0,3
Bangladesh,2003-08-01,3,0,0,0,0,3
Bangladesh,2003-08-01,0,0,0,0,0,0
Bangladesh,2003-08-01,6,0,0,0,0,6
Bangladesh,2003-08-01,5,0,0,-2,0,3
Bangladesh,2003-08-01,0,0,0,0,0,0
Bangladesh,2003-08-01,2,0,0,0,0,2
Bangladesh,2003-08-01,1,0,0,-2,0,-1
Bangladesh,2003-08-01,0,0,0,0,0,0
Bangladesh,2003-08-01,0,0,0,0,0,0
Bangladesh,2003-08-01,0,0,0,6,0,6
Bangladesh,2003-09-01,10,2,0,0,0,12
Bangladesh,2003-09-01,0,0,0,0,0,0
Bangladesh,2003-09-01,1,0,0,0,0,1
Bangladesh,2003-09-01,6,0,0,0,0,6
Bangladesh,2003-09-01,0,0,0,0,0,0
Bangladesh,2003-09-01,0,0,0,0,0,0
Bangladesh,2003-09-01,0,0,0,0,0,0
Bangladesh,2003-09-01,3,0,0,0,0,3
Bangladesh,2003-09-01,-1,0,0,0,0,-1
Bangladesh,2003-09-01,0,0,0,0,0,0
Bangladesh,2003-09-01,1,0,0,0,0,1
Bangladesh,2003-09-01,-1,0,0,0,0,-1
Bangladesh,2003-09-01,0,0,0,0,0,0
Bangladesh,2003-09-01,0,0,0,0,0,0
Bangladesh,2003-09-01,0,0,0,3,0,3
Bangladesh,2003-09-01,9,0,0,3,0,12
Bangladesh,2003-09-01,1,0,-1,-2,0,-2
Bangladesh,2003-09-01,0,0,0,0,0,0
Bangladesh,2003-09-01,0,0,0,0,0,0
Bangladesh,2003-09-01,3,0,0,0,0,3
Bangladesh,2003-09-01,6,0,0,3,0,9
Bangladesh,2003-09-01,0,0,0,0,0,0
Bangladesh,2003-09-01,12,0,0,0,0,12
Bangladesh,2003-09-01,10,0,0,3,2,15
Bangladesh,2003-09-01,2,0,0,0,0,2
Bangladesh,2003-09-01,0,0,0,0,0,0
Bangladesh,2003-09-01,0,0,0,30,1,31
Bangladesh,2003-09-01,0,0,0,0,0,0
Bangladesh,2003-10-01,8,2,0,0,0,10
Bangladesh,2003-10-01,19,0,0,4,0,23
Bangladesh,2003-10-01,6,0,0,0,1,7
Bangladesh,2003-10-01,3,0,0,0,0,3
Bangladesh,2003-10-01,0,0,0,0,0,0
Bangladesh,2003-10-01,-1,0,0,0,0,-1
Bangladesh,2003-10-01,16,0,0,0,0,16
Bangladesh,2003-10-01,8,0,0,0,0,8
Bangladesh,2003-10-01,-4,0,0,0,0,-4
Bangladesh,2003-10-01,0,0,0,0,0,0
Bangladesh,2003-10-01,5,0,0,0,1,6
Bangladesh,2003-10-01,0,0,0,0,0,0
Bangladesh,2003-10-01,0,0,0,0,0,0
Bangladesh,2003-10-01,4,0,0,3,0,7
Bangladesh,2003-10-01,0,0,0,0,0,0
Bangladesh,2003-10-01,1,0,0,0,0,1
Bangladesh,2003-10-01,3,0,0,0,0,3
Bangladesh,2003-10-01,2,0,0,0,0,2
Bangladesh,2003-10-01,0,0,0,0,0,0
Bangladesh,2003-10-01,5,0,0,0,0,5
Bangladesh,2003-10-01,4,0,0,0,0,4
Bangladesh,2003-10-01,1,0,0,3,0,4
Bangladesh,2003-10-01,0,0,0,0,0,0
Bangladesh,2003-10-01,0,0,0,0,0,0
Bangladesh,2003-10-01,0,0,0,3,0,3
Bangladesh,2003-10-01,3,0,0,0,1,4
Bangladesh,2003-10-01,0,0,0,0,0,0
Bangladesh,2003-10-01,6,0,0,0,0,6
Bangladesh,2003-10-01,12,0,0,6,9,27
Bangladesh,2003-10-01,0,0,0,3,0,3
Bangladesh,2003-11-01,0,0,0,3,0,3
Bangladesh,2003-11-01,1,0,0,3,0,4
Bangladesh,2003-11-01,0,0,0,-2,0,-2
Bangladesh,2003-11-01,0,0,0,0,0,0
Bangladesh,2003-11-01,9,0,0,0,0,9
Bangladesh,2003-11-01,3,0,0,0,0,3
Bangladesh,2003-11-01,10,0,0,0,0,10
Bangladesh,2003-11-01,3,0,0,0,0,3
Bangladesh,2003-11-01,0,0,0,3,0,3
Bangladesh,2003-11-01,0,0,0,0,0,0
Bangladesh,2003-11-01,4,0,0,0,0,4
Bangladesh,2003-11-01,0,0,0,0,0,0
Bangladesh,2003-11-01,0,0,0,0,1,1
Bangladesh,2003-11-01,0,0,0,0,0,0
Bangladesh,2003-11-01,1,0,0,0,0,1
Bangladesh,2003-11-01,1,0,0,3,0,4
Bangladesh,2003-11-01,0,0,0,6,4,10
Bangladesh,2003-11-01,0,0,0,0,1,1
Bangladesh,2003-11-01,0,0,0,0,0,0
Bangladesh,2003-11-01,7,0,0,0,0,7
Bangladesh,2003-11-01,0,0,0,0,0,0
Bangladesh,2003-11-01,0,0,0,0,0,0
Bangladesh,2003-11-01,10,0,0,12,0,22
Bangladesh,2003-11-01,0,0,0,0,0,0
Bangladesh,2003-11-01,3,0,-4,6,0,5
Bangladesh,2003-11-01,0,0,0,6,0,6
Bangladesh,2003-11-01,0,0,0,15,0,15
Bangladesh,2003-12-01,0,0,0,0,1,1
Bangladesh,2003-12-01,0,0,0,0,0,0
Bangladesh,2003-12-01,0,0,0,21,0,21
Bangladesh,2003-12-01,2,0,0,22,0,24
Bangladesh,2003-12-01,3,0,0,0,0,3
Bangladesh,2003-12-01,1,0,0,0,0,1
Bangladesh,2003-12-01,0,0,0,-4,2,-2
Bangladesh,2003-12-01,6,0,2,9,2,19
Bangladesh,2003-12-01,2,0,0,3,0,5
Bangladesh,2003-12-01,0,0,0,-4,1,-3
Bangladesh,2003-12-01,0,0,0,0,0,0
Bangladesh,2003-12-01,0,0,0,0,0,0
Bangladesh,2003-12-01,0,0,0,0,0,0
Bangladesh,2003-12-01,-2,0,0,3,0,1
Bangladesh,2003-12-01,0,0,0,-2,0,-2
Bangladesh,2003-12-01,11,0,0,10,0,21
Bangladesh,2003-12-01,5,0,0,0,0,5
Bangladesh,2003-12-01,-1,0,0,0,0,-1
Bangladesh,2003-12-01,4,0,0,3,2,9
Bangladesh,2003-12-01,11,0,0,9,2,22
Bangladesh,2003-12-01,5,0,0,6,0,11
Bangladesh,2003-12-01,0,0,0,0,0,0
Bangladesh,2003-12-01,0,0,0,6,0,6
Bangladesh,2003-12-01,0,0,0,0,0,0
Bangladesh,2003-12-01,0,0,0,1,0,1
Bangladesh,2003-12-01,0,0,0,-6,0,-6
Bangladesh,2003-12-01,0,0,0,0,0,0
Bangladesh,2003-12-01,0,0,0,0,5,5
Bangladesh,2003-12-01,3,0,0,-2,0,1
Cameroon,2003-01-01,0,0,0,0,0,0
Cameroon,2003-01-01,0,0,0,0,0,0
Cameroon,2003-01-01,0,0,0,0,0,0
Cameroon,2003-01-01,0,0,0,0,0,0
Cameroon,2003-01-01,0,0,0,0,0,0
Cameroon,2003-01-01,0,0,0,0,0,0
Cameroon,2003-01-01,0,0,0,0,0,0
Cameroon,2003-01-01,2,0,0,0,0,2
Cameroon,2003-01-01,0,0,0,0,0,0
Cameroon,2003-01-01,0,0,0,0,0,0
Cameroon,2003-01-01,0,0,0,0,0,0
Cameroon,2003-01-01,9,0,0,0,0,9
Cameroon,2003-01-01,-1,0,0,0,0,-1
Cameroon,2003-02-01,2,0,0,0,0,2
Cameroon,2003-02-01,4,0,0,0,0,4
Cameroon,2003-02-01,4,0,0,0,0,4
Cameroon,2003-02-01,0,0,0,0,0,0
Cameroon,2003-02-01,0,0,0,0,0,0
Cameroon,2003-02-01,0,0,0,0,0,0
Cameroon,2003-02-01,0,0,0,-2,0,-2
Cameroon,2003-02-01,0,0,0,0,0,0
Cameroon,2003-02-01,0,0,0,6,0,6
Cameroon,2003-02-01,0,0,0,0,0,0
Cameroon,2003-02-01,0,0,0,0,0,0
Cameroon,2003-02-01,0,0,0,0,0,0
Cameroon,2003-02-01,0,0,0,0,0,0
Cameroon,2003-02-01,0,0,0,0,0,0
Cameroon,2003-02-01,0,0,0,0,0,0
Cameroon,2003-02-01,0,0,0,0,0,0
Cameroon,2003-02-01,0,0,0,0,0,0
Cameroon,2003-02-01,0,0,0,0,3,3
Cameroon,2003-02-01,1,0,0,0,0,1
Cameroon,2003-03-01,0,0,0,0,0,0
Cameroon,2003-03-01,0,0,0,0,3,3
Cameroon,2003-03-01,3,0,0,0,0,3
Cameroon,2003-03-01,6,0,0,0,1,7
Cameroon,2003-03-01,3,0,0,0,0,3
Cameroon,2003-03-01,0,0,0,0,2,2
Cameroon,2003-03-01,-1,0,0,0,0,-1
Cameroon,2003-03-01,0,0,0,0,0,0
Cameroon,2003-03-01,1,0,0,0,0,1
Cameroon,2003-03-01,38,0,0,0,0,38
Cameroon,2003-03-01,0,0,0,0,0,0
Cameroon,2003-03-01,0,0,0,0,2,2
Cameroon,2003-03-01,7,0,0,0,0,7
Cameroon,2003-03-01,14,0,0,3,1,18
Cameroon,2003-03-01,3,0,0,0,0,3
Cameroon,2003-03-01,12,0,0,3,0,15
Cameroon,2003-03-01,10,0,0,3,0,13
Cameroon,2003-03-01,4,0,0,3,0,7
Cameroon,2003-03-01,1,0,0,0,0,1
Cameroon,2003-03-01,4,0,0,6,0,10
Cameroon,2003-03-01,1,0,0,0,2,3
Cameroon,2003-03-01,0,0,0,0,0,0
Cameroon,2003-03-01,0,0,0,-10,0,-10
Cameroon,2003-03-01,1,0,0,0,0,1
Cameroon,2003-03-01,0,0,0,0,0,0
Cameroon,2003-03-01,0,0,0,0,0,0
Cameroon,2003-03-01,0,0,0,0,0,0
Cameroon,2003-04-01,2,0,0,0,0,2
Cameroon,2003-04-01,0,0,0,0,1,1
Cameroon,2003-04-01,0,0,0,0,0,0
Cameroon,2003-04-01,0,0,0,0,0,0
Cameroon,2003-04-01,0,0,0,0,0,0
Cameroon,2003-04-01,0,0,0,0,0,0
Cameroon,2003-04-01,0,0,0,0,0,0
Cameroon,2003-04-01,0,0,0,0,0,0
Cameroon,2003-04-01,2,0,0,0,0,2
Cameroon,2003-04-01,2,0,0,-2,0,0
Cameroon,2003-04-01,0,0,0,0,0,0
Cameroon,2003-04-01,2,0,0,6,0,8
Cameroon,2003-04-01,1,0,0,3,0,4
Cameroon,2003-04-01,0,0,0,0,0,0
Cameroon,2003-04-01,0,0,0,0,0,0
Cameroon,2003-05-01,0,0,0,0,0,0
Cameroon,2003-05-01,0,0,0,0,0,0
Cameroon,2003-05-01,0,0,0,0,0,0
Cameroon,2003-05-01,0,0,0,0,0,0
Cameroon,2003-05-01,1,0,0,0,0,1
Cameroon,2003-05-01,3,0,0,0,0,3
Cameroon,2003-05-01,0,0,0,0,0,0
Cameroon,2003-05-01,2,0,0,0,0,2
Cameroon,2003-05-01,0,0,0,3,0,3
Cameroon,2003-05-01,7,0,0,0,0,7
Cameroon,2003-05-01,0,0,0,0,0,0
Cameroon,2003-05-01,0,0,0,0,0,0
Cameroon,2003-05-01,-6,0,0,0,0,-6
Cameroon,2003-05-01,0,0,0,0,0,0
Cameroon,2003-05-01,0,0,0,0,0,0
Cameroon,2003-05-01,-7,0,0,0,0,-7
Cameroon,2003-05-01,0,0,0,0,0,0
Cameroon,2003-05-01,1,0,0,0,0,1
Cameroon,2003-05-01,5,0,0,0,0,5
Cameroon,2003-06-01,3,0,0,0,0,3
Cameroon,2003-06-01,0,0,0,0,0,0
Cameroon,2003-06-01,0,0,0,0,0,0
Cameroon,2003-06-01,0,0,0,0,0,0
Cameroon,2003-06-01,1,0,0,0,0,1
Cameroon,2003-06-01,0,0,0,0,0,0
Cameroon,2003-06-01,0,0,0,0,0,0
Cameroon,2003-06-01,2,0,0,0,0,2
Cameroon,2003-06-01,0,0,0,0,0,0
Cameroon,2003-06-01,0,0,0,0,0,0
Cameroon,2003-06-01,0,0,0,0,0,0
Cameroon,2003-06-01,0,0,0,0,0,0
Cameroon,2003-06-01,0,0,0,0,0,0
Cameroon,2003-06-01,0,0,0,0,0,0
Cameroon,2003-06-01,0,0,0,0,0,0
Cameroon,2003-06-01,1,0,0,0,0,1
Cameroon,2003-06-01,0,0,0,0,0,0
Cameroon,2003-06-01,2,0,0,6,0,8
Cameroon,2003-06-01,0,0,0,0,0,0
Cameroon,2003-07-01,-2,0,0,0,0,-2
Cameroon,2003-07-01,-1,0,0,0,0,-1
Cameroon,2003-07-01,0,0,0,0,0,0
Cameroon,2003-07-01,0,0,0,0,0,0
Cameroon,2003-07-01,0,0,0,0,0,0
Cameroon,2003-07-01,0,0,0,0,0,0
Cameroon,2003-07-01,0,0,0,0,0,0
Cameroon,2003-07-01,0,0,0,0,0,0
Cameroon,2003-07-01,0,0,0,0,0,0
Cameroon,2003-07-01,0,0,0,0,0,0
Cameroon,2003-07-01,0,0,0,0,0,0
Cameroon,2003-07-01,0,0,0,0,0,0
Cameroon,2003-07-01,4,0,0,0,0,4
Cameroon,2003-07-01,0,0,0,0,0,0
Cameroon,2003-07-01,0,0,0,0,0,0
Cameroon,2003-07-01,0,0,0,0,0,0
Cameroon,2003-07-01,-1,0,0,0,0,-1
Cameroon,2003-08-01,1,0,0,6,0,7
Cameroon,2003-08-01,0,0,0,0,0,0
Cameroon,2003-08-01,0,0,0,0,0,0
Cameroon,2003-08-01,0,0,0,0,1,1
Cameroon,2003-08-01,0,0,0,0,0,0
Cameroon,2003-08-01,0,0,0,3,0,3
Cameroon,2003-08-01,0,0,0,0,0,0
Cameroon,2003-08-01,2,0,0,0,0,2
Cameroon,2003-08-01,0,0,0,0,0,0
Cameroon,2003-08-01,4,0,0,6,1,11
Cameroon,2003-08-01,0,0,0,0,0,0
Cameroon,2003-08-01,6,0,0,0,0,6
Cameroon,2003-08-01,0,0,0,0,0,0
Cameroon,2003-08-01,2,0,0,6,0,8
Cameroon,2003-08-01,2,0,0,0,0,2
Cameroon,2003-08-01,0,0,0,0,0,0
Cameroon,2003-08-01,0,0,0,0,0,0
Cameroon,2003-08-01,0,0,0,0,0,0
Cameroon,2003-09-01,0,0,0,0,0,0
Cameroon,2003-09-01,10,0,0,0,0,10
Cameroon,2003-09-01,14,0,0,0,0,14
Cameroon,2003-09-01,0,0,0,0,0,0
Cameroon,2003-09-01,0,0,0,0,0,0
Cameroon,2003-09-01,12,0,0,0,0,12
Cameroon,2003-09-01,2,0,0,-2,0,0
Cameroon,2003-09-01,0,0,0,0,0,0
Cameroon,2003-09-01,0,0,0,0,0,0
Cameroon,2003-09-01,0,0,0,0,0,0
Cameroon,2003-09-01,0,0,0,0,0,0
Cameroon,2003-09-01,1,0,0,0,0,1
Cameroon,2003-09-01,0,0,0,0,0,0
Cameroon,2003-09-01,2,0,0,0,0,2
Cameroon,2003-09-01,2,0,0,0,0,2
Cameroon,2003-09-01,0,0,0,0,0,0
Cameroon,2003-09-01,3,0,0,0,0,3
Cameroon,2003-09-01,2,0,0,0,0,2
Cameroon,2003-10-01,0,2,0,0,0,2
Cameroon,2003-10-01,0,0,0,0,0,0
Cameroon,2003-10-01,0,0,0,0,0,0
Cameroon,2003-10-01,0,0,0,0,0,0
Cameroon,2003-10-01,0,0,0,0,0,0
Cameroon,2003-10-01,-1,0,-4,0,0,-5
Cameroon,2003-10-01,0,0,0,0,0,0
Cameroon,2003-10-01,0,0,0,0,0,0
Cameroon,2003-10-01,4,0,0,0,1,5
Cameroon,2003-10-01,4,0,0,-2,1,3
Cameroon,2003-10-01,2,0,0,1,0,3
Cameroon,2003-10-01,0,0,0,0,0,0
Cameroon,2003-10-01,1,0,0,0,0,1
Cameroon,2003-10-01,1,0,0,0,0,1
Cameroon,2003-10-01,0,0,0,0,0,0
Cameroon,2003-10-01,0,0,0,0,0,0
Cameroon,2003-10-01,0,0,0,0,0,0
Cameroon,2003-10-01,2,0,0,0,0,2
Cameroon,2003-10-01,0,0,0,0,0,0
Cameroon,2003-10-01,0,0,0,-2,1,-1
Cameroon,2003-10-01,0,0,0,-2,0,-2
Cameroon,2003-10-01,1,0,0,0,0,1
Cameroon,2003-11-01,6,0,0,3,0,9
Cameroon,2003-11-01,0,0,0,0,0,0
Cameroon,2003-11-01,3,0,0,0,0,3
Cameroon,2003-11-01,0,0,0,3,0,3
Cameroon,2003-11-01,0,0,0,0,0,0
Cameroon,2003-11-01,0,0,0,0,0,0
Cameroon,2003-11-01,0,0,0,0,0,0
Cameroon,2003-11-01,0,0,0,0,0,0
Cameroon,2003-11-01,0,0,0,0,0,0
Cameroon,2003-11-01,-1,0,0,0,1,0
Cameroon,2003-11-01,0,0,0,0,0,0
Cameroon,2003-11-01,0,0,0,0,0,0
Cameroon,2003-11-01,0,0,0,0,0,0
Cameroon,2003-11-01,0,0,0,0,0,0
Cameroon,2003-11-01,0,0,0,-2,0,-2
Cameroon,2003-11-01,3,0,0,0,0,3
Cameroon,2003-11-01,0,0,0,1,0,1
Cameroon,2003-12-01,1,0,0,0,0,1
Cameroon,2003-12-01,0,0,0,6,0,6
Cameroon,2003-12-01,0,0,0,18,0,18
Cameroon,2003-12-01,0,0,0,6,0,6
Cameroon,2003-12-01,0,0,0,3,0,3
Cameroon,2003-12-01,0,0,0,0,0,0
Cameroon,2003-12-01,0,0,0,0,0,0
Cameroon,2003-12-01,0,0,0,0,0,0
Cameroon,2003-12-01,1,0,0,-5,0,-4
Cameroon,2003-12-01,2,0,0,3,0,5
Cameroon,2003-12-01,0,0,0,1,0,1
Cameroon,2003-12-01,1,0,0,0,0,1
Cameroon,2003-12-01,-3,0,0,9,0,6
Cameroon,2003-12-01,0,0,0,0,0,0
Cameroon,2003-12-01,0,0,0,3,2,5
Cameroon,2003-12-01,0,0,0,0,0,0
Cameroon,2003-12-01,0,0,-2,6,0,4
Cameroon,2003-12-01,0,0,0,0,0,0
Cameroon,2003-12-01,0,0,0,0,0,0
Cameroon,2003-12-01,0,0,0,0,0,0
Cameroon,2003-12-01,9,0,0,0,0,9
China,2003-01-01,18,0,0,9,2,29
China,2003-01-01,4,0,0,-4,0,0
China,2003-01-01,17,0,1,-2,0,16
China,2003-01-01,-2,0,-2,22,0,18
China,2003-01-01,3,0,-3,0,0,0
China,2003-01-01,23,0,0,18,11,52
China,2003-01-01,5,0,0,24,2,31
China,2003-01-01,29,0,0,0,-1,28
China,2003-01-01,12,0,0,9,2,23
China,2003-01-01,11,0,0,2,0,13
China,2003-01-01,2,0,0,0,0,2
China,2003-01-01,15,0,0,0,0,15
China,2003-01-01,23,0,0,24,5,52
China,2003-01-01,12,0,0,7,5,24
China,2003-01-01,20,0,0,6,1,27
China,2003-01-01,10,0,0,6,0,16
China,2003-01-01,7,0,0,0,0,7
China,2003-01-01,3,0,0,6,0,9
China,2003-01-01,-1,0,-2,10,0,7
China,2003-01-01,41,0,0,9,3,53
China,2003-01-01,23,0,-1,3,2,27
China,2003-01-01,20,0,0,6,0,26
China,2003-01-01,29,2,-7,30,0,54
China,2003-01-01,0,0,0,0,0,0
China,2003-01-01,3,0,0,9,0,12
China,2003-01-01,21,0,0,0,0,21
China,2003-01-01,21,0,0,12,1,34
China,2003-01-01,21,0,0,12,2,35
China,2003-01-01,31,0,0,26,6,63
China,2003-01-01,12,2,0,1,0,15
China,2003-01-01,9,0,-2,12,3,22
China,2003-02-01,10,0,0,0,3,13
China,2003-02-01,1,0,0,0,2,3
China,2003-02-01,5,0,0,4,0,9
China,2003-02-01,10,0,0,12,4,26
China,2003-02-01,31,0,0,0,2,33
China,2003-02-01,19,0,0,9,0,28
China,2003-02-01,13,0,0,3,0,16
China,2003-02-01,16,0,0,18,4,38
China,2003-02-01,15,0,0,3,0,18
China,2003-02-01,10,2,0,21,1,34
China,2003-02-01,19,0,1,2,12,34
China,2003-02-01,20,0,0,-2,1,19
China,2003-02-01,15,0,3,7,1,26
China,2003-02-01,19,0,1,15,2,37
China,2003-02-01,27,0,2,7,0,36
China,2003-02-01,5,0,0,6,0,11
China,2003-02-01,18,0,2,9,1,30
China,2003-02-01,23,0,0,8,1,32
China,2003-02-01,0,0,-1,3,1,3
China,2003-02-01,23,0,0,4,1,28
China,2003-02-01,1,6,0,3,1,11
China,2003-02-01,8,0,0,-9,0,-1
China,2003-02-01,13,0,0,6,1,20
China,2003-02-01,9,0,0,9,1,19
China,2003-02-01,18,0,1,17,3,39
China,2003-02-01,6,0,0,0,3,9
China,2003-02-01,11,0,1,12,0,24
China,2003-02-01,25,0,-2,8,1,32
China,2003-03-01,11,0,0,0,0,11
China,2003-03-01,3,0,0,3,0,6
China,2003-03-01,7,0,0,0,1,8
China,2003-03-01,11,0,0,0,2,13
China,2003-03-01,3,0,0,3,4,10
China,2003-03-01,40,0,0,9,5,54
China,2003-03-01,17,2,-2,0,6,23
China,2003-03-01,15,0,0,-6,2,11
China,2003-03-01,34,0,2,0,5,41
China,2003-03-01,21,0,0,0,7,28
China,2003-03-01,26,0,0,5,1,32
China,2003-03-01,26,0,0,3,2,31
China,2003-03-01,24,0,-1,-7,8,24
China,2003-03-01,29,0,0,3,3,35
China,2003-03-01,6,0,1,9,0,16
China,2003-03-01,7,0,-4,7,1,11
China,2003-03-01,25,0,-1,7,1,32
China,2003-03-01,30,0,-1,6,1,36
China,2003-03-01,19,0,0,12,0,31
China,2003-03-01,32,0,3,0,5,40
China,2003-03-01,28,0,0,3,3,34
China,2003-03-01,12,0,0,3,0,15
China,2003-03-01,2,0,0,0,2,4
China,2003-03-01,9,0,0,0,2,11
China,2003-03-01,16,0,0,15,0,31
China,2003-03-01,28,0,0,10,0,38
China,2003-03-01,15,0,0,2,1,18
China,2003-03-01,13,0,0,8,14,35
China,2003-03-01,17,0,-1,21,5,42
China,2003-03-01,0,0,0,3,0,3
China,2003-03-01,31,0,0,17,2,50
China,2003-04-01,40,0,2,6,4,52
China,2003-04-01,21,0,0,20,3,44
China,2003-04-01,28,0,0,12,4,44
China,2003-04-01,44,0,0,11,1,56
China,2003-04-01,10,0,0,3,7,20
China,2003-04-01,17,0,0,0,0,17
China,2003-04-01,3,0,-2,10,1,12
China,2003-04-01,5,0,0,0,4,9
China,2003-04-01,24,0,0,30,0,54
China,2003-04-01,43,0,0,18,3,64
China,2003-04-01,19,0,0,12,0,31
China,2003-04-01,25,0,0,3,0,28
China,2003-04-01,4,0,0,18,2,24
China,2003-04-01,26,0,0,24,1,51
China,2003-04-01,27,0,0,36,1,64
China,2003-04-01,14,2,0,5,2,23
China,2003-04-01,2,0,0,9,0,11
China,2003-04-01,8,0,0,3,0,11
China,2003-04-01,2,0,0,6,4,12
China,2003-04-01,1,0,3,4,1,9
China,2003-04-01,27,0,0,3,2,32
China,2003-04-01,13,0,1,12,0,26
China,2003-04-01,19,0,0,7,0,26
China,2003-04-01,21,0,0,3,4,28
China,2003-04-01,16,0,0,-4,2,14
China,2003-04-01,10,0,0,27,0,37
China,2003-04-01,13,0,0,-2,0,11
China,2003-04-01,11,0,0,24,1,36
China,2003-04-01,35,0,5,30,6,76
China,2003-04-01,33,0,0,9,7,49
China,2003-05-01,23,0,0,4,1,28
China,2003-05-01,2,0,0,0,4,6
China,2003-05-01,6,0,1,1,4,12
China,2003-05-01,20,0,1,0,6,27
China,2003-05-01,11,0,0,4,0,15
China,2003-05-01,19,0,0,21,3,43
China,2003-05-01,24,0,0,15,0,39
China,2003-05-01,60,4,-2,60,2,124
China,2003-05-01,23,0,1,26,2,52
China,2003-05-01,1,0,0,15,1,17
China,2003-05-01,13,0,0,12,0,25
China,2003-05-01,18,0,0,14,1,33
China,2003-05-01,35,0,0,17,7,59
China,2003-05-01,24,0,0,33,5,62
China,2003-05-01,6,0,0,18,1,25
China,2003-05-01,5,0,0,3,5,13
China,2003-05-01,9,0,0,9,0,18
China,2003-05-01,8,0,0,0,0,8
China,2003-05-01,23,0,-6,9,2,28
China,2003-05-01,9,2,0,-1,4,14
China,2003-05-01,9,0,1,0,0,10
China,2003-05-01,43,2,-4,10,2,53
China,2003-05-01,26,0,4,34,1,65
China,2003-05-01,12,0,2,12,0,26
China,2003-05-01,6,0,0,6,0,12
China,2003-05-01,5,0,1,20,0,26
China,2003-05-01,14,0,0,4,0,18
China,2003-05-01,20,0,0,20,2,42
China,2003-05-01,17,0,0,3,0,20
China,2003-05-01,22,0,-3,18,0,37
China,2003-05-01,7,0,-4,-2,2,3
China,2003-06-01,-4,0,0,-2,6,0
China,2003-06-01,21,2,0,6,2,31
China,2003-06-01,17,0,0,7,1,25
China,2003-06-01,23,0,-1,30,1,53
China,2003-06-01,15,2,0,-2,1,16
China,2003-06-01,2,0,-2,2,5,7
China,2003-06-01,2,0,0,0,2,4
China,2003-06-01,2,0,0,0,0,2
China,2003-06-01,31,0,0,3,2,36
China,2003-06-01,35,0,-6,21,4,54
China,2003-06-01,11,0,0,2,6,19
China,2003-06-01,14,0,0,8,3,25
China,2003-06-01,20,2,0,8,3,33
China,2003-06-01,10,0,0,0,0,10
China,2003-06-01,10,0,0,-6,3,7
China,2003-06-01,18,0,-2,14,1,31
China,2003-06-01,6,0,0,-6,0,0
China,2003-06-01,11,0,2,1,4,18
China,2003-06-01,1,0,0,44,4,49
China,2003-06-01,11,0,0,3,1,15
China,2003-06-01,7,0,-6,6,0,7
China,2003-06-01,4,0,0,0,3,7
China,2003-06-01,21,0,-1,6,0,26
China,2003-06-01,18,0,0,0,0,18
China,2003-06-01,15,0,1,-2,2,16
China,2003-06-01,26,0,0,0,0,26
China,2003-06-01,6,0,0,20,0,26
China,2003-06-01,8,0,0,9,2,19
China,2003-06-01,7,0,0,0,1,8
China,2003-06-01,10,0,1,24,0,35
China,2003-07-01,12,0,3,12,3,30
China,2003-07-01,5,0,-4,11,5,17
China,2003-07-01,9,0,0,-2,2,9
China,2003-07-01,14,0,0,7,2,23
China,2003-07-01,9,0,0,7,2,18
China,2003-07-01,7,0,0,3,2,12
China,2003-07-01,6,0,0,18,3,27
China,2003-07-01,7,0,1,6,1,15
China,2003-07-01,12,0,-2,15,0,25
China,2003-07-01,5,0,0,15,1,21
China,2003-07-01,7,0,0,0,0,7
China,2003-07-01,5,0,-1,-2,0,2
China,2003-07-01,6,0,0,15,0,21
China,2003-07-01,8,0,3,0,2,13
China,2003-07-01,16,0,0,6,3,25
China,2003-07-01,16,0,0,14,0,30
China,2003-07-01,20,0,-2,3,3,24
China,2003-07-01,12,0,0,10,0,22
China,2003-07-01,21,0,0,24,0,45
China,2003-07-01,12,0,0,0,0,12
China,2003-07-01,2,0,0,1,0,3
China,2003-07-01,11,2,-4,10,1,20
China,2003-07-01,11,0,1,10,0,22
China,2003-07-01,8,0,-1,9,3,19
China,2003-07-01,15,0,1,6,1,23
China,2003-07-01,-2,0,0,-6,0,-8
China,2003-07-01,17,2,0,0,1,20
China,2003-07-01,22,0,0,-10,4,16
China,2003-07-01,8,0,1,7,1,17
China,2003-07-01,4,0,0,-1,1,4
China,2003-07-01,3,0,0,8,2,13
China,2003-08-01,22,0,0,6,5,33
China,2003-08-01,21,0,-2,23,2,44
China,2003-08-01,18,0,0,0,0,18
China,2003-08-01,3,0,0,11,4,18
China,2003-08-01,9,0,0,-2,0,7
China,2003-08-01,12,0,0,3,0,15
China,2003-08-01,9,0,-2,19,0,26
China,2003-08-01,6,0,0,8,0,14
China,2003-08-01,12,0,1,0,0,13
China,2003-08-01,-1,0,0,0,1,0
China,2003-08-01,12,0,0,27,0,39
China,2003-08-01,7,0,1,12,0,20
China,2003-08-01,24,0,1,6,0,31
China,2003-08-01,12,0,0,-4,1,9
China,2003-08-01,11,0,-1,0,2,12
China,2003-08-01,10,0,0,4,3,17
China,2003-08-01,4,0,-2,4,0,6
China,2003-08-01,19,0,0,13,0,32
China,2003-08-01,11,0,0,12,-2,21
China,2003-08-01,16,0,0,-3,1,14
China,2003-08-01,2,0,0,-16,4,-10
China,2003-08-01,7,0,0,4,4,15
China,2003-08-01,14,0,0,18,3,35
China,2003-08-01,9,0,0,1,0,10
China,2003-08-01,28,2,0,15,0,45
China,2003-08-01,13,0,0,6,5,24
China,2003-08-01,14,0,0,-12,0,2
China,2003-08-01,5,0,0,-7,0,-2
China,2003-08-01,9,0,0,15,3,27
China,2003-08-01,-2,0,0,-2,2,-2
China,2003-08-01,12,0,0,6,0,18
China,2003-09-01,23,0,-2,22,2,45
China,2003-09-01,8,0,0,19,0,27
China,2003-09-01,13,0,1,18,2,34
China,2003-09-01,8,2,0,11,1,22
China,2003-09-01,14,0,0,1,1,16
China,2003-09-01,14,0,0,18,0,32
China,2003-09-01,6,0,0,-2,0,4
China,2003-09-01,17,2,-1,0,1,19
China,2003-09-01,7,0,0,2,0,9
China,2003-09-01,5,0,-1,0,0,4
China,2003-09-01,12,2,-1,15,2,30
China,2003-09-01,9,0,-4,9,4,18
China,2003-09-01,4,0,0,-4,7,7
China,2003-09-01,11,0,0,0,6,17
China,2003-09-01,8,0,0,4,0,12
China,2003-09-01,2,0,0,5,1,8
China,2003-09-01,14,0,-1,0,1,14
China,2003-09-01,-7,0,0,0,0,-7
China,2003-09-01,5,0,0,3,0,8
China,2003-09-01,15,0,0,2,4,21
China,2003-09-01,3,0,0,0,0,3
China,2003-09-01,17,0,0,0,0,17
China,2003-09-01,25,2,0,1,2,30
China,2003-09-01,10,0,0,0,1,11
China,2003-09-01,11,0,0,0,0,11
China,2003-09-01,16,0,0,-2,0,14
China,2003-09-01,3,0,0,-3,1,1
China,2003-09-01,11,0,0,9,3,23
China,2003-09-01,12,0,0,-4,3,11
China,2003-09-01,13,0,0,9,1,23
China,2003-10-01,3,2,0,6,0,11
China,2003-10-01,-1,0,0,3,0,2
China,2003-10-01,4,0,0,1,0,5
China,2003-10-01,-1,0,0,0,0,-1
China,2003-10-01,25,0,0,0,0,25
China,2003-10-01,8,0,0,0,5,13
China,2003-10-01,22,0,0,7,4,33
China,2003-10-01,12,0,-1,10,6,27
China,2003-10-01,33,0,-1,3,1,36
China,2003-10-01,7,0,0,30,0,37
China,2003-10-01,0,0,0,6,0,6
China,2003-10-01,9,0,-1,0,0,8
China,2003-10-01,15,2,0,1,-4,14
China,2003-10-01,1,4,0,0,1,6
China,2003-10-01,27,2,0,21,0,50
China,2003-10-01,12,0,-4,6,4,18
China,2003-10-01,7,0,-1,5,1,12
China,2003-10-01,27,0,0,0,1,28
China,2003-10-01,10,0,0,3,2,15
China,2003-10-01,15,0,0,10,0,25
China,2003-10-01,34,0,-6,5,3,36
China,2003-10-01,34,0,0,28,0,62
China,2003-10-01,16,0,0,30,1,47
China,2003-10-01,34,0,0,3,1,38
China,2003-10-01,-2,0,0,0,1,-1
China,2003-10-01,25,2,0,2,1,30
China,2003-10-01,6,0,-4,13,2,17
China,2003-10-01,12,0,0,0,3,15
China,2003-10-01,21,0,0,2,2,25
China,2003-10-01,18,0,0,3,2,23
China,2003-10-01,8,0,0,21,0,29
China,2003-11-01,11,0,0,0,0,11
China,2003-11-01,6,0,0,0,0,6
China,2003-11-01,10,4,0,0,1,15
China,2003-11-01,6,0,-1,2,1,8
China,2003-11-01,5,0,0,11,1,17
China,2003-11-01,1,4,0,15,0,20
China,2003-11-01,28,2,0,11,4,45
China,2003-11-01,2,0,0,0,0,2
China,2003-11-01,9,0,0,0,3,12
China,2003-11-01,22,0,0,0,5,27
China,2003-11-01,23,0,0,27,1,51
China,2003-11-01,8,0,1,11,0,20
China,2003-11-01,31,0,1,3,0,35
China,2003-11-01,8,0,2,37,4,51
China,2003-11-01,19,0,0,12,0,31
China,2003-11-01,11,0,0,9,3,23
China,2003-11-01,11,0,0,0,2,13
China,2003-11-01,40,0,0,7,4,51
China,2003-11-01,1,0,0,33,0,34
China,2003-11-01,16,0,0,0,0,16
China,2003-11-01,6,0,1,15,4,26
China,2003-11-01,14,0,0,6,2,22
China,2003-11-01,5,0,0,0,3,8
China,2003-11-01,26,0,0,12,1,39
China,2003-11-01,12,0,0,3,10,25
China,2003-11-01,34,0,0,9,0,43
China,2003-11-01,8,0,0,6,6,20
China,2003-11-01,3,0,1,3,5,12
China,2003-11-01,0,0,0,0,1,1
China,2003-11-01,7,2,0,3,0,12
China,2003-12-01,9,0,-2,-2,1,6
China,2003-12-01,17,0,0,4,2,23
China,2003-12-01,18,0,0,6,5,29
China,2003-12-01,11,0,0,9,0,20
China,2003-12-01,36,0,0,-1,1,36
China,2003-12-01,5,0,0,0,0,5
China,2003-12-01,6,0,0,3,1,10
China,2003-12-01,6,0,-1,-5,2,2
China,2003-12-01,17,0,-4,1,2,16
China,2003-12-01,10,4,-1,9,1,23
China,2003-12-01,2,2,0,15,2,21
China,2003-12-01,21,0,0,24,1,46
China,2003-12-01,15,0,0,-2,2,15
China,2003-12-01,8,0,0,0,4,12
China,2003-12-01,7,0,0,15,1,23
China,2003-12-01,8,0,0,0,0,8
China,2003-12-01,3,0,0,30,2,35
China,2003-12-01,14,0,0,1,0,15
China,2003-12-01,17,0,0,4,2,23
China,2003-12-01,19,0,0,0,5,24
China,2003-12-01,16,0,-1,3,2,20
China,2003-12-01,12,0,-2,0,0,10
China,2003-12-01,17,0,0,-10,0,7
China,2003-12-01,9,0,0,15,0,24
China,2003-12-01,15,0,-2,4,0,17
China,2003-12-01,8,0,0,12,0,20
China,2003-12-01,7,0,0,39,0,46
China,2003-12-01,0,0,-3,0,0,-3
China,2003-12-01,1,0,0,2,2,5
China,2003-12-01,5,0,0,6,1,12
China,2003-12-01,14,0,-2,5,0,17
Egypt,2003-01-01,7,0,0,3,0,10
Egypt,2003-01-01,3,0,0,4,4,11
Egypt,2003-01-01,4,0,0,-4,0,0
Egypt,2003-01-01,23,0,0,0,1,24
Egypt,2003-01-01,16,0,0,3,2,21
Egypt,2003-01-01,34,0,0,3,0,37
Egypt,2003-01-01,7,0,0,0,0,7
Egypt,2003-01-01,-1,0,0,0,0,-1
Egypt,2003-01-01,3,0,0,6,0,9
Egypt,2003-01-01,6,0,0,9,0,15
Egypt,2003-01-01,11,0,0,0,0,11
Egypt,2003-01-01,20,0,0,1,0,21
Egypt,2003-01-01,37,2,0,21,4,64
Egypt,2003-01-01,4,0,0,7,0,11
Egypt,2003-01-01,5,0,0,3,0,8
Egypt,2003-01-01,13,0,0,9,4,26
Egypt,2003-01-01,14,0,0,0,2,16
Egypt,2003-01-01,-14,0,0,0,2,-12
Egypt,2003-01-01,5,0,0,1,0,6
Egypt,2003-01-01,24,0,1,5,3,33
Egypt,2003-01-01,15,0,-6,21,4,34
Egypt,2003-01-01,16,0,0,0,5,21
Egypt,2003-01-01,18,0,0,12,1,31
Egypt,2003-01-01,16,0,-2,0,2,16
Egypt,2003-01-01,12,0,0,3,0,15
Egypt,2003-01-01,14,0,0,0,0,14
Egypt,2003-01-01,17,0,1,15,4,37
Egypt,2003-01-01,37,4,-1,12,0,52
Egypt,2003-01-01,16,0,0,0,2,18
Egypt,2003-01-01,1,0,0,12,4,17
Egypt,2003-01-01,2,0,0,15,2,19
Egypt,2003-02-01,7,0,0,3,3,13
Egypt,2003-02-01,6,0,0,21,0,27
Egypt,2003-02-01,6,0,0,6,0,12
Egypt,2003-02-01,3,0,0,3,0,6
Egypt,2003-02-01,7,0,0,-2,0,5
Egypt,2003-02-01,9,0,0,3,3,15
Egypt,2003-02-01,0,0,0,0,0,0
Egypt,2003-02-01,10,2,0,0,0,12
Egypt,2003-02-01,15,0,0,0,0,15
Egypt,2003-02-01,2,0,0,0,0,2
Egypt,2003-02-01,-4,0,0,12,0,8
Egypt,2003-02-01,0,0,0,3,0,3
Egypt,2003-02-01,7,0,-2,6,3,14
Egypt,2003-02-01,21,0,0,0,0,21
Egypt,2003-02-01,2,0,0,0,0,2
Egypt,2003-02-01,0,0,0,0,0,0
Egypt,2003-02-01,2,0,0,6,2,10
Egypt,2003-02-01,16,0,0,18,0,34
Egypt,2003-02-01,23,0,0,-8,0,15
Egypt,2003-02-01,0,0,0,3,0,3
Egypt,2003-02-01,15,0,0,9,3,27
Egypt,2003-02-01,8,0,0,0,1,9
Egypt,2003-02-01,13,0,0,3,1,17
Egypt,2003-02-01,20,0,0,0,0,20
Egypt,2003-02-01,10,0,0,0,0,10
Egypt,2003-02-01,8,0,0,0,1,9
Egypt,2003-02-01,1,0,0,0,0,1
Egypt,2003-02-01,5,0,0,0,2,7
Egypt,2003-03-01,18,0,-4,3,7,24
Egypt,2003-03-01,5,0,-6,12,0,11
Egypt,2003-03-01,14,0,0,3,0,17
Egypt,2003-03-01,19,0,0,26,0,45
Egypt,2003-03-01,1,0,0,0,0,1
Egypt,2003-03-01,9,0,-2,15,0,22
Egypt,2003-03-01,3,0,0,0,4,7
Egypt,2003-03-01,5,4,0,0,0,9
Egypt,2003-03-01,7,0,0,0,4,11
Egypt,2003-03-01,1,0,0,3,0,4
Egypt,2003-03-01,0,6,0,-4,0,2
Egypt,2003-03-01,5,0,0,0,0,5
Egypt,2003-03-01,25,0,-2,9,2,34
Egypt,2003-03-01,12,0,0,3,1,16
Egypt,2003-03-01,6,0,0,0,1,7
Egypt,2003-03-01,17,0,0,0,3,20
Egypt,2003-03-01,3,0,0,0,0,3
Egypt,2003-03-01,15,0,0,4,0,19
Egypt,2003-03-01,5,0,0,6,0,11
Egypt,2003-03-01,0,0,0,3,2,5
Egypt,2003-03-01,2,0,0,-12,0,-10
Egypt,2003-03-01,0,0,0,0,1,1
Egypt,2003-03-01,7,0,0,0,2,9
Egypt,2003-03-01,18,0,0,3,0,21
Egypt,2003-03-01,0,0,0,0,2,2
Egypt,2003-03-01,0,0,0,0,0,0
Egypt,2003-03-01,6,0,0,1,1,8
Egypt,2003-03-01,3,0,0,0,0,3
Egypt,2003-03-01,1,0,0,0,4,5
Egypt,2003-03-01,0,0,2,0,4,6
Egypt,2003-03-01,1,0,0,0,0,1
Egypt,2003-04-01,0,0,0,9,2,11
Egypt,2003-04-01,4,0,0,6,0,10
Egypt,2003-04-01,27,0,0,4,7,38
Egypt,2003-04-01,-2,0,0,0,1,-1
Egypt,2003-04-01,4,0,0,9,0,13
Egypt,2003-04-01,17,0,0,6,0,23
Egypt,2003-04-01,32,0,0,0,0,32
Egypt,2003-04-01,4,0,0,3,0,7
Egypt,2003-04-01,10,0,0,3,2,15
Egypt,2003-04-01,2,0,0,0,6,8
Egypt,2003-04-01,3,0,0,5,2,10
Egypt,2003-04-01,6,0,0,6,1,13
Egypt,2003-04-01,3,0,0,0,0,3
Egypt,2003-04-01,3,0,0,0,0,3
Egypt,2003-04-01,3,0,0,-5,0,-2
Egypt,2003-04-01,2,0,1,15,1,19
Egypt,2003-04-01,2,0,0,-2,0,0
Egypt,2003-04-01,8,0,0,0,0,8
Egypt,2003-04-01,22,0,0,0,0,22
Egypt,2003-04-01,23,0,0,4,3,30
Egypt,2003-04-01,26,0,0,3,0,29
Egypt,2003-04-01,-3,0,0,0,0,-3
Egypt,2003-04-01,-5,0,0,0,0,-5
Egypt,2003-04-01,8,0,0,9,2,19
Egypt,2003-04-01,-10,0,-2,9,1,-2
Egypt,2003-04-01,2,0,0,9,0,11
Egypt,2003-04-01,0,0,0,25,0,25
Egypt,2003-04-01,1,0,0,0,0,1
Egypt,2003-04-01,-1,0,0,-2,3,0
Egypt,2003-04-01,0,0,0,0,0,0
Egypt,2003-05-01,21,0,0,7,1,29
Egypt,2003-05-01,2,0,0,1,0,3
Egypt,2003-05-01,6,0,0,3,0,9
Egypt,2003-05-01,12,0,0,18,3,33
Egypt,2003-05-01,-1,0,0,6,0,5
Egypt,2003-05-01,9,0,0,0,0,9
Egypt,2003-05-01,3,0,0,1,0,4
Egypt,2003-05-01,14,0,-4,0,0,10
Egypt,2003-05-01,0,0,-2,3,0,1
Egypt,2003-05-01,9,0,0,7,6,22
Egypt,2003-05-01,0,0,0,6,0,6
Egypt,2003-05-01,8,0,0,3,0,11
Egypt,2003-05-01,15,0,0,3,5,23
Egypt,2003-05-01,-6,0,0,0,0,-6
Egypt,2003-05-01,14,0,0,0,0,14
Egypt,2003-05-01,1,0,-2,0,2,1
Egypt,2003-05-01,7,0,0,6,0,13
Egypt,2003-05-01,9,0,0,3,0,12
Egypt,2003-05-01,6,0,0,3,5,14
Egypt,2003-05-01,0,0,0,0,0,0
Egypt,2003-05-01,8,0,0,6,3,17
Egypt,2003-05-01,2,0,0,0,2,4
Egypt,2003-05-01,5,0,0,0,3,8
Egypt,2003-05-01,5,0,0,1,0,6
Egypt,2003-05-01,14,0,0,6,6,26
Egypt,2003-05-01,8,0,0,6,0,14
Egypt,2003-05-01,20,0,0,3,3,26
Egypt,2003-05-01,16,0,0,21,0,37
Egypt,2003-05-01,10,0,1,16,1,28
Egypt,2003-05-01,0,2,0,7,0,9
Egypt,2003-05-01,8,0,0,7,0,15
Egypt,2003-06-01,11,0,0,0,1,12
Egypt,2003-06-01,2,0,0,0,0,2
Egypt,2003-06-01,18,0,0,-2,3,19
Egypt,2003-06-01,10,0,0,6,0,16
Egypt,2003-06-01,0,0,0,0,0,0
Egypt,2003-06-01,6,0,0,4,0,10
Egypt,2003-06-01,6,0,0,0,1,7
Egypt,2003-06-01,6,0,0,0,0,6
Egypt,2003-06-01,17,0,0,3,1,21
Egypt,2003-06-01,6,0,0,0,2,8
Egypt,2003-06-01,20,0,0,0,6,26
Egypt,2003-06-01,15,0,0,3,0,18
Egypt,2003-06-01,6,0,0,12,0,18
Egypt,2003-06-01,-4,0,-2,-6,0,-12
Egypt,2003-06-01,18,0,0,24,4,46
Egypt,2003-06-01,15,0,0,12,2,29
Egypt,2003-06-01,9,0,0,14,1,24
Egypt,2003-06-01,7,0,-1,5,0,11
Egypt,2003-06-01,6,0,0,2,2,10
Egypt,2003-06-01,0,0,0,6,9,15
Egypt,2003-06-01,15,0,0,6,0,21
Egypt,2003-06-01,10,0,0,12,1,23
Egypt,2003-06-01,2,0,0,3,0,5
Egypt,2003-06-01,0,0,0,-1,0,-1
Egypt,2003-06-01,7,0,0,9,0,16
Egypt,2003-06-01,-2,0,0,0,0,-2
Egypt,2003-06-01,0,0,0,0,0,0
Egypt,2003-06-01,4,0,0,10,0,14
Egypt,2003-06-01,10,0,0,0,0,10
Egypt,2003-06-01,4,0,0,-1,0,3
Egypt,2003-07-01,5,0,0,0,0,5
Egypt,2003-07-01,10,0,0,1,0,11
Egypt,2003-07-01,1,0,0,0,0,1
Egypt,2003-07-01,5,0,0,0,0,5
Egypt,2003-07-01,16,0,0,0,0,16
Egypt,2003-07-01,0,0,0,9,0,9
Egypt,2003-07-01,6,0,0,0,0,6
Egypt,2003-07-01,14,0,0,0,0,14
Egypt,2003-07-01,3,0,0,3,2,8
Egypt,2003-07-01,15,0,-4,-8,5,8
Egypt,2003-07-01,6,0,0,0,0,6
Egypt,2003-07-01,8,0,0,0,0,8
Egypt,2003-07-01,7,0,0,0,0,7
Egypt,2003-07-01,2,0,0,0,0,2
Egypt,2003-07-01,-3,0,0,3,0,0
Egypt,2003-07-01,3,0,0,1,2,6
Egypt,2003-07-01,2,0,0,3,0,5
Egypt,2003-07-01,18,0,1,6,0,25
Egypt,2003-07-01,-1,0,0,-5,0,-6
Egypt,2003-07-01,3,0,1,0,0,4
Egypt,2003-07-01,9,0,0,0,0,9
Egypt,2003-07-01,1,0,0,0,2,3
Egypt,2003-07-01,0,0,0,0,0,0
Egypt,2003-07-01,9,0,0,0,0,9
Egypt,2003-07-01,12,0,0,0,1,13
Egypt,2003-07-01,11,0,0,-2,0,9
Egypt,2003-07-01,2,0,0,0,0,2
Egypt,2003-07-01,1,0,0,6,0,7
Egypt,2003-07-01,4,0,0,0,0,4
Egypt,2003-07-01,7,0,0,0,0,7
Egypt,2003-07-01,0,0,0,9,0,9
Egypt,2003-08-01,5,0,0,20,0,25
Egypt,2003-08-01,5,0,0,2,0,7
Egypt,2003-08-01,2,0,0,4,5,11
Egypt,2003-08-01,1,0,0,0,0,1
Egypt,2003-08-01,13,0,0,6,0,19
Egypt,2003-08-01,29,0,0,1,1,31
Egypt,2003-08-01,17,0,0,9,1,27
Egypt,2003-08-01,7,0,0,0,0,7
Egypt,2003-08-01,6,0,0,9,0,15
Egypt,2003-08-01,5,0,0,0,0,5
Egypt,2003-08-01,4,0,0,0,0,4
Egypt,2003-08-01,5,0,0,0,0,5
Egypt,2003-08-01,6,0,0,4,2,12
Egypt,2003-08-01,5,0,0,5,0,10
Egypt,2003-08-01,0,0,0,1,0,1
Egypt,2003-08-01,2,0,0,3,2,7
Egypt,2003-08-01,0,0,0,-4,0,-4
Egypt,2003-08-01,3,0,0,0,0,3
Egypt,2003-08-01,2,0,0,0,0,2
Egypt,2003-08-01,0,0,0,3,0,3
Egypt,2003-08-01,14,0,0,-2,1,13
Egypt,2003-08-01,15,2,1,1,0,19
Egypt,2003-08-01,6,0,0,3,0,9
Egypt,2003-08-01,39,0,0,0,1,40
Egypt,2003-08-01,5,0,0,0,0,5
Egypt,2003-08-01,9,0,0,3,3,15
Egypt,2003-08-01,11,0,0,9,0,20
Egypt,2003-08-01,14,0,0,0,0,14
Egypt,2003-08-01,3,0,0,6,0,9
Egypt,2003-08-01,0,0,0,4,3,7
Egypt,2003-08-01,7,0,0,0,0,7
Egypt,2003-09-01,0,0,0,9,3,12
Egypt,2003-09-01,2,0,-2,0,2,2
Egypt,2003-09-01,6,0,0,3,2,11
Egypt,2003-09-01,14,0,0,4,0,18
Egypt,2003-09-01,15,0,0,3,1,19
Egypt,2003-09-01,5,0,0,0,0,5
Egypt,2003-09-01,2,0,0,4,0,6
Egypt,2003-09-01,2,0,0,9,0,11
Egypt,2003-09-01,12,0,0,9,0,21
Egypt,2003-09-01,3,0,0,18,3,24
Egypt,2003-09-01,21,2,0,-2,4,25
Egypt,2003-09-01,3,0,0,0,0,3
Egypt,2003-09-01,6,0,0,3,0,9
Egypt,2003-09-01,2,0,0,6,0,8
Egypt,2003-09-01,4,0,0,0,2,6
Egypt,2003-09-01,12,0,0,0,0,12
Egypt,2003-09-01,10,0,0,21,2,33
Egypt,2003-09-01,5,0,0,0,0,5
Egypt,2003-09-01,3,0,0,21,0,24
Egypt,2003-09-01,2,0,0,0,0,2
Egypt,2003-09-01,0,0,0,0,0,0
Egypt,2003-09-01,4,0,0,0,0,4
Egypt,2003-09-01,0,0,0,3,0,3
Egypt,2003-09-01,15,0,0,18,0,33
Egypt,2003-09-01,0,0,0,-4,0,-4
Egypt,2003-09-01,-5,0,0,0,0,-5
Egypt,2003-09-01,4,0,0,-4,0,0
Egypt,2003-09-01,3,0,1,-2,0,2
Egypt,2003-09-01,11,4,0,6,0,21
Egypt,2003-09-01,4,0,0,0,0,4
Egypt,2003-10-01,25,0,-5,12,1,33
Egypt,2003-10-01,4,0,0,11,0,15
Egypt,2003-10-01,10,0,-2,0,0,8
Egypt,2003-10-01,0,0,0,4,1,5
Egypt,2003-10-01,9,0,0,0,0,9
Egypt,2003-10-01,0,0,0,0,0,0
Egypt,2003-10-01,18,0,0,-2,0,16
Egypt,2003-10-01,7,0,0,0,3,10
Egypt,2003-10-01,11,0,0,12,1,24
Egypt,2003-10-01,13,0,0,10,0,23
Egypt,2003-10-01,21,0,0,0,0,21
Egypt,2003-10-01,1,0,0,5,1,7
Egypt,2003-10-01,8,0,0,-2,2,8
Egypt,2003-10-01,6,0,1,0,0,7
Egypt,2003-10-01,21,0,0,0,0,21
Egypt,2003-10-01,20,0,0,4,0,24
Egypt,2003-10-01,34,0,0,9,0,43
Egypt,2003-10-01,10,0,0,6,5,21
Egypt,2003-10-01,4,0,0,0,4,8
Egypt,2003-10-01,2,0,0,0,0,2
Egypt,2003-10-01,8,0,0,7,3,18
Egypt,2003-10-01,22,0,0,3,0,25
Egypt,2003-10-01,0,0,0,-4,0,-4
Egypt,2003-10-01,6,0,0,3,0,9
Egypt,2003-10-01,-1,0,0,9,0,8
Egypt,2003-10-01,3,0,0,3,0,6
Egypt,2003-10-01,2,0,0,-2,1,1
Egypt,2003-10-01,6,0,0,-2,0,4
Egypt,2003-10-01,29,0,0,3,1,33
Egypt,2003-10-01,5,0,0,0,0,5
Egypt,2003-10-01,0,0,0,3,0,3
Egypt,2003-11-01,18,0,0,3,0,21
Egypt,2003-11-01,9,0,0,6,0,15
Egypt,2003-11-01,22,0,0,9,2,33
Egypt,2003-11-01,0,0,0,0,2,2
Egypt,2003-11-01,0,0,0,0,0,0
Egypt,2003-11-01,8,0,0,6,0,14
Egypt,2003-11-01,3,0,0,9,0,12
Egypt,2003-11-01,1,0,0,3,0,4
Egypt,2003-11-01,12,12,2,15,0,41
Egypt,2003-11-01,10,0,0,3,2,15
Egypt,2003-11-01,10,0,0,-4,2,8
Egypt,2003-11-01,6,0,0,9,0,15
Egypt,2003-11-01,14,0,2,6,1,23
Egypt,2003-11-01,1,0,0,3,0,4
Egypt,2003-11-01,7,0,0,-5,4,6
Egypt,2003-11-01,3,0,0,18,0,21
Egypt,2003-11-01,2,0,0,0,0,2
Egypt,2003-11-01,9,0,0,3,2,14
Egypt,2003-11-01,4,0,0,0,0,4
Egypt,2003-11-01,15,0,0,9,0,24
Egypt,2003-11-01,27,0,0,0,3,30
Egypt,2003-11-01,3,0,0,0,1,4
Egypt,2003-11-01,-1,0,0,-2,0,-3
Egypt,2003-11-01,3,0,0,3,1,7
Egypt,2003-11-01,0,0,0,0,0,0
Egypt,2003-11-01,8,0,0,0,0,8
Egypt,2003-11-01,0,0,1,0,0,1
Egypt,2003-11-01,2,0,0,0,0,2
Egypt,2003-11-01,12,0,-2,15,0,25
Egypt,2003-11-01,2,0,0,10,1,13
Egypt,2003-12-01,0,2,0,5,0,7
Egypt,2003-12-01,3,0,0,0,1,4
Egypt,2003-12-01,10,0,0,3,1,14
Egypt,2003-12-01,23,0,0,0,2,25
Egypt,2003-12-01,-1,0,0,0,0,-1
Egypt,2003-12-01,5,0,0,0,0,5
Egypt,2003-12-01,0,0,0,0,0,0
Egypt,2003-12-01,6,4,0,3,0,13
Egypt,2003-12-01,7,0,0,0,0,7
Egypt,2003-12-01,5,0,0,3,4,12
Egypt,2003-12-01,9,0,0,0,3,12
Egypt,2003-12-01,16,0,0,-6,5,15
Egypt,2003-12-01,-1,0,0,0,3,2
Egypt,2003-12-01,2,0,0,3,0,5
Egypt,2003-12-01,15,0,0,-2,0,13
Egypt,2003-12-01,4,0,0,16,2,22
Egypt,2003-12-01,7,0,-1,3,0,9
Egypt,2003-12-01,7,0,0,12,0,19
Egypt,2003-12-01,3,0,0,0,2,5
Egypt,2003-12-01,-3,0,0,-2,0,-5
Egypt,2003-12-01,-1,0,0,0,0,-1
Egypt,2003-12-01,58,0,0,3,14,75
Egypt,2003-12-01,22,0,0,12,2,36
Egypt,2003-12-01,13,0,0,0,3,16
Egypt,2003-12-01,18,0,1,12,5,36
Egypt,2003-12-01,13,0,0,-4,6,15
Egypt,2003-12-01,1,0,0,2,0,3
Egypt,2003-12-01,0,0,0,3,4,7
Egypt,2003-12-01,13,0,0,-9,1,5
Egypt,2003-12-01,6,0,0,-1,0,5
Egypt,2003-12-01,21,0,0,8,5,34
Eritrea,2003-01-01,1,0,0,0,0,1
Eritrea,2003-01-01,6,0,0,0,0,6
Eritrea,2003-01-01,0,0,0,0,0,0
Eritrea,2003-01-01,0,0,0,0,0,0
Eritrea,2003-01-01,1,0,1,0,0,2
Eritrea,2003-01-01,0,0,0,0,0,0
Eritrea,2003-01-01,3,0,0,0,0,3
Eritrea,2003-01-01,8,0,0,0,0,8
Eritrea,2003-01-01,11,0,0,0,0,11
Eritrea,2003-01-01,0,0,0,0,0,0
Eritrea,2003-01-01,2,0,0,0,0,2
Eritrea,2003-01-01,0,0,0,0,0,0
Eritrea,2003-01-01,1,0,0,0,0,1
Eritrea,2003-01-01,3,0,0,0,0,3
Eritrea,2003-01-01,0,0,0,0,0,0
Eritrea,2003-01-01,0,0,0,0,0,0
Eritrea,2003-01-01,0,0,0,0,0,0
Eritrea,2003-01-01,0,0,0,0,0,0
Eritrea,2003-01-01,-3,0,0,0,0,-3
Eritrea,2003-01-01,2,2,0,0,0,4
Eritrea,2003-01-01,6,0,0,0,0,6
Eritrea,2003-01-01,0,0,0,0,0,0
Eritrea,2003-02-01,0,0,0,0,0,0
Eritrea,2003-02-01,0,0,0,0,0,0
Eritrea,2003-02-01,0,0,0,0,0,0
Eritrea,2003-02-01,0,0,0,3,1,4
Eritrea,2003-02-01,2,0,0,0,0,2
Eritrea,2003-02-01,0,0,0,0,0,0
Eritrea,2003-02-01,0,0,0,0,0,0
Eritrea,2003-02-01,0,0,0,0,0,0
Eritrea,2003-02-01,0,0,0,0,0,0
Eritrea,2003-02-01,3,0,0,0,0,3
Eritrea,2003-02-01,3,0,0,0,0,3
Eritrea,2003-02-01,3,0,0,0,0,3
Eritrea,2003-02-01,2,0,0,0,1,3
Eritrea,2003-02-01,0,0,0,3,0,3
Eritrea,2003-02-01,2,0,0,0,0,2
Eritrea,2003-02-01,0,0,0,0,0,0
Eritrea,2003-02-01,0,0,0,-2,0,-2
Eritrea,2003-02-01,10,0,0,0,0,10
Eritrea,2003-02-01,1,0,0,0,2,3
Eritrea,2003-02-01,0,0,0,0,0,0
Eritrea,2003-02-01,0,0,0,0,0,0
Eritrea,2003-02-01,1,0,0,0,0,1
Eritrea,2003-02-01,2,0,0,0,0,2
Eritrea,2003-03-01,0,0,0,0,0,0
Eritrea,2003-03-01,0,0,0,0,0,0
Eritrea,2003-03-01,0,0,0,0,0,0
Eritrea,2003-03-01,0,0,0,0,0,0
Eritrea,2003-03-01,3,0,0,0,0,3
Eritrea,2003-03-01,0,0,0,0,0,0
Eritrea,2003-03-01,0,0,0,0,0,0
Eritrea,2003-03-01,0,0,0,0,0,0
Eritrea,2003-03-01,0,0,0,0,0,0
Eritrea,2003-03-01,0,0,0,0,0,0
Eritrea,2003-03-01,0,0,0,0,0,0
Eritrea,2003-03-01,4,0,0,0,0,4
Eritrea,2003-03-01,0,0,0,0,0,0
Eritrea,2003-03-01,0,0,0,0,0,0
Eritrea,2003-03-01,0,0,0,0,0,0
Eritrea,2003-03-01,0,0,0,0,0,0
Eritrea,2003-03-01,-1,0,0,0,0,-1
Eritrea,2003-03-01,0,0,0,0,1,1
Eritrea,2003-03-01,0,0,0,0,0,0
Eritrea,2003-03-01,10,0,0,0,0,10
Eritrea,2003-03-01,0,0,0,0,0,0
Eritrea,2003-03-01,0,0,-2,0,0,-2
Eritrea,2003-03-01,2,0,0,0,1,3
Eritrea,2003-03-01,0,0,0,0,0,0
Eritrea,2003-03-01,0,0,0,0,0,0
Eritrea,2003-03-01,4,0,0,-1,0,3
Eritrea,2003-04-01,-7,0,0,3,1,-3
Eritrea,2003-04-01,4,0,0,0,0,4
Eritrea,2003-04-01,2,0,0,3,0,5
Eritrea,2003-04-01,2,0,0,0,0,2
Eritrea,2003-04-01,-4,0,0,0,0,-4
Eritrea,2003-04-01,2,0,0,0,0,2
Eritrea,2003-04-01,0,0,0,3,0,3
Eritrea,2003-04-01,36,0,0,0,0,36
Eritrea,2003-04-01,0,0,0,0,0,0
Eritrea,2003-04-01,2,0,0,0,0,2
Eritrea,2003-04-01,0,0,0,0,0,0
Eritrea,2003-04-01,0,0,0,-10,0,-10
Eritrea,2003-04-01,6,0,0,0,0,6
Eritrea,2003-04-01,7,0,0,6,0,13
Eritrea,2003-04-01,0,0,0,0,0,0
Eritrea,2003-04-01,0,0,0,0,0,0
Eritrea,2003-04-01,3,0,0,0,0,3
Eritrea,2003-04-01,10,0,0,0,0,10
Eritrea,2003-04-01,0,0,0,0,0,0
Eritrea,2003-04-01,0,0,0,0,0,0
Eritrea,2003-04-01,0,0,0,0,0,0
Eritrea,2003-04-01,8,0,0,3,0,11
Eritrea,2003-04-01,0,0,0,0,0,0
Eritrea,2003-04-01,1,0,0,3,0,4
Eritrea,2003-05-01,5,0,0,2,0,7
Eritrea,2003-05-01,10,0,0,0,0,10
Eritrea,2003-05-01,13,0,0,0,0,13
Eritrea,2003-05-01,0,0,0,3,0,3
Eritrea,2003-05-01,0,0,0,0,0,0
Eritrea,2003-05-01,4,0,0,0,0,4
Eritrea,2003-05-01,0,0,0,0,0,0
Eritrea,2003-05-01,0,0,0,3,3,6
Eritrea,2003-05-01,0,0,0,0,0,0
Eritrea,2003-05-01,4,0,-1,0,0,3
Eritrea,2003-05-01,0,0,0,0,0,0
Eritrea,2003-05-01,0,0,0,0,0,0
Eritrea,2003-05-01,0,0,0,6,0,6
Eritrea,2003-05-01,0,0,0,0,0,0
Eritrea,2003-05-01,2,0,0,0,0,2
Eritrea,2003-05-01,2,0,0,0,0,2
Eritrea,2003-05-01,0,0,0,0,0,0
Eritrea,2003-05-01,0,0,0,0,0,0
Eritrea,2003-05-01,0,0,0,0,0,0
Eritrea,2003-05-01,3,0,0,0,0,3
Eritrea,2003-05-01,0,0,0,0,0,0
Eritrea,2003-05-01,0,0,0,0,0,0
Eritrea,2003-05-01,6,0,0,0,0,6
Eritrea,2003-05-01,3,0,0,0,0,3
Eritrea,2003-05-01,3,0,0,0,0,3
Eritrea,2003-06-01,0,0,0,0,0,0
Eritrea,2003-06-01,0,0,0,0,1,1
Eritrea,2003-06-01,2,0,0,0,0,2
Eritrea,2003-06-01,0,0,0,0,0,0
Eritrea,2003-06-01,0,2,0,9,0,11
Eritrea,2003-06-01,0,4,0,0,0,4
Eritrea,2003-06-01,0,0,0,0,0,0
Eritrea,2003-06-01,3,0,0,0,0,3
Eritrea,2003-06-01,-3,0,0,0,1,-2
Eritrea,2003-06-01,2,0,0,0,0,2
Eritrea,2003-06-01,0,0,0,0,0,0
Eritrea,2003-06-01,0,0,0,0,0,0
Eritrea,2003-06-01,1,0,0,0,0,1
Eritrea,2003-06-01,1,0,0,0,0,1
Eritrea,2003-06-01,0,0,0,0,0,0
Eritrea,2003-06-01,0,0,0,0,0,0
Eritrea,2003-06-01,-1,0,0,0,0,-1
Eritrea,2003-06-01,0,0,0,3,0,3
Eritrea,2003-06-01,6,0,0,3,0,9
Eritrea,2003-06-01,0,0,0,0,0,0
Eritrea,2003-06-01,0,0,0,0,0,0
Eritrea,2003-07-01,0,0,0,0,0,0
Eritrea,2003-07-01,3,0,0,0,0,3
Eritrea,2003-07-01,3,0,0,0,0,3
Eritrea,2003-07-01,0,0,0,0,0,0
Eritrea,2003-07-01,0,0,0,0,0,0
Eritrea,2003-07-01,1,0,0,-7,0,-6
Eritrea,2003-07-01,0,0,0,-2,0,-2
Eritrea,2003-07-01,0,0,0,9,0,9
Eritrea,2003-07-01,0,0,0,0,0,0
Eritrea,2003-07-01,0,0,0,0,0,0
Eritrea,2003-07-01,0,0,0,0,0,0
Eritrea,2003-07-01,0,0,0,0,0,0
Eritrea,2003-07-01,0,0,0,0,0,0
Eritrea,2003-07-01,0,0,0,3,0,3
Eritrea,2003-07-01,0,0,0,0,0,0
Eritrea,2003-07-01,0,0,0,0,0,0
Eritrea,2003-07-01,1,0,0,0,2,3
Eritrea,2003-07-01,0,0,0,0,0,0
Eritrea,2003-07-01,6,0,0,0,0,6
Eritrea,2003-07-01,0,0,0,0,0,0
Eritrea,2003-07-01,-2,0,0,0,0,-2
Eritrea,2003-07-01,0,0,0,0,0,0
Eritrea,2003-07-01,0,0,0,0,0,0
Eritrea,2003-08-01,1,0,0,0,0,1
Eritrea,2003-08-01,0,0,0,0,0,0
Eritrea,2003-08-01,0,0,0,0,0,0
Eritrea,2003-08-01,0,0,0,0,0,0
Eritrea,2003-08-01,0,0,0,0,0,0
Eritrea,2003-08-01,0,0,0,0,0,0
Eritrea,2003-08-01,-5,0,0,0,0,-5
Eritrea,2003-08-01,0,0,0,6,0,6
Eritrea,2003-08-01,0,0,0,0,1,1
Eritrea,2003-08-01,0,0,0,0,0,0
Eritrea,2003-08-01,6,0,0,3,0,9
Eritrea,2003-08-01,6,0,0,0,0,6
Eritrea,2003-08-01,0,0,0,0,0,0
Eritrea,2003-08-01,5,0,0,0,0,5
Eritrea,2003-08-01,3,0,0,0,0,3
Eritrea,2003-08-01,0,0,0,0,0,0
Eritrea,2003-08-01,0,0,0,24,0,24
Eritrea,2003-08-01,0,0,0,6,0,6
Eritrea,2003-08-01,0,0,0,0,0,0
Eritrea,2003-08-01,0,0,0,0,0,0
Eritrea,2003-08-01,0,0,0,0,0,0
Eritrea,2003-08-01,0,0,0,0,0,0
Eritrea,2003-08-01,9,0,0,0,0,9
Eritrea,2003-08-01,0,0,0,3,0,3
Eritrea,2003-08-01,-1,0,0,0,0,-1
Eritrea,2003-08-01,2,0,0,0,0,2
Eritrea,2003-09-01,2,0,0,0,0,2
Eritrea,2003-09-01,0,0,0,0,0,0
Eritrea,2003-09-01,0,0,0,0,0,0
Eritrea,2003-09-01,0,0,0,0,0,0
Eritrea,2003-09-01,3,0,0,0,0,3
Eritrea,2003-09-01,0,0,0,0,0,0
Eritrea,2003-09-01,0,0,0,0,0,0
Eritrea,2003-09-01,5,0,0,3,0,8
Eritrea,2003-09-01,0,0,0,0,1,1
Eritrea,2003-09-01,0,0,0,0,0,0
Eritrea,2003-09-01,0,0,0,0,0,0
Eritrea,2003-09-01,0,0,0,0,0,0
Eritrea,2003-09-01,0,0,0,0,0,0
Eritrea,2003-09-01,1,0,0,0,0,1
Eritrea,2003-09-01,3,0,0,0,0,3
Eritrea,2003-09-01,0,0,0,7,0,7
Eritrea,2003-09-01,0,0,0,0,0,0
Eritrea,2003-09-01,0,0,0,0,0,0
Eritrea,2003-09-01,0,0,0,0,0,0
Eritrea,2003-09-01,0,0,0,0,0,0
Eritrea,2003-09-01,0,0,0,0,0,0
Eritrea,2003-09-01,3,0,2,0,0,5
Eritrea,2003-09-01,0,0,2,0,0,2
Eritrea,2003-09-01,0,0,0,0,0,0
Eritrea,2003-09-01,0,0,0,0,0,0
Eritrea,2003-09-01,8,0,0,3,4,15
Eritrea,2003-09-01,2,0,0,6,0,8
Eritrea,2003-10-01,6,0,0,0,0,6
Eritrea,2003-10-01,7,0,0,3,0,10
Eritrea,2003-10-01,0,0,0,0,0,0
Eritrea,2003-10-01,0,0,0,0,0,0
Eritrea,2003-10-01,3,0,0,0,0,3
Eritrea,2003-10-01,0,0,0,0,0,0
Eritrea,2003-10-01,1,0,0,0,0,1
Eritrea,2003-10-01,5,0,0,0,0,5
Eritrea,2003-10-01,0,0,0,0,0,0
Eritrea,2003-10-01,0,0,0,0,0,0
Eritrea,2003-10-01,3,0,0,0,0,3
Eritrea,2003-10-01,0,0,0,-4,0,-4
Eritrea,2003-10-01,2,0,0,-8,0,-6
Eritrea,2003-10-01,2,0,0,0,0,2
Eritrea,2003-10-01,2,0,0,0,0,2
Eritrea,2003-10-01,2,0,0,0,0,2
Eritrea,2003-10-01,5,0,0,0,0,5
Eritrea,2003-10-01,2,0,0,0,0,2
Eritrea,2003-10-01,0,0,0,6,0,6
Eritrea,2003-10-01,10,0,0,0,0,10
Eritrea,2003-10-01,5,0,0,-2,0,3
Eritrea,2003-10-01,4,0,0,0,0,4
Eritrea,2003-10-01,0,0,0,6,0,6
Eritrea,2003-10-01,0,0,0,0,0,0
Eritrea,2003-10-01,0,0,0,0,0,0
Eritrea,2003-10-01,1,0,0,3,0,4
Eritrea,2003-10-01,0,0,0,0,0,0
Eritrea,2003-10-01,0,0,0,3,0,3
Eritrea,2003-10-01,0,0,0,0,0,0
Eritrea,2003-11-01,0,0,0,0,0,0
Eritrea,2003-11-01,0,0,0,0,0,0
Eritrea,2003-11-01,3,0,0,0,0,3
Eritrea,2003-11-01,6,0,0,-2,4,8
Eritrea,2003-11-01,0,0,0,0,0,0
Eritrea,2003-11-01,5,0,0,0,0,5
Eritrea,2003-11-01,3,0,0,6,0,9
Eritrea,2003-11-01,0,0,0,0,0,0
Eritrea,2003-11-01,0,0,0,0,0,0
Eritrea,2003-11-01,3,0,0,0,0,3
Eritrea,2003-11-01,12,0,0,-6,0,6
Eritrea,2003-11-01,0,0,0,0,1,1
Eritrea,2003-11-01,10,0,0,0,0,10
Eritrea,2003-11-01,0,0,0,-2,0,-2
Eritrea,2003-11-01,2,0,0,0,0,2
Eritrea,2003-11-01,0,0,0,0,0,0
Eritrea,2003-11-01,0,0,0,0,0,0
Eritrea,2003-11-01,0,0,0,0,0,0
Eritrea,2003-11-01,5,0,0,0,0,5
Eritrea,2003-11-01,4,0,0,0,0,4
Eritrea,2003-11-01,0,0,0,0,0,0
Eritrea,2003-11-01,2,0,0,0,0,2
Eritrea,2003-11-01,0,0,0,0,1,1
Eritrea,2003-11-01,5,0,0,0,0,5
Eritrea,2003-11-01,0,0,0,0,0,0
Eritrea,2003-11-01,5,0,0,0,0,5
Eritrea,2003-11-01,0,0,0,0,0,0
Eritrea,2003-12-01,0,0,0,0,0,0
Eritrea,2003-12-01,1,0,0,0,0,1
Eritrea,2003-12-01,7,0,0,0,0,7
Eritrea,2003-12-01,0,0,0,0,0,0
Eritrea,2003-12-01,0,0,0,-4,0,-4
Eritrea,2003-12-01,0,0,0,0,0,0
Eritrea,2003-12-01,0,0,0,0,0,0
Eritrea,2003-12-01,0,0,0,0,0,0
Eritrea,2003-12-01,0,0,0,6,0,6
Eritrea,2003-12-01,0,0,0,0,0,0
Eritrea,2003-12-01,6,0,0,0,0,6
Eritrea,2003-12-01,0,0,0,0,0,0
Eritrea,2003-12-01,0,0,0,0,0,0
Eritrea,2003-12-01,0,0,0,0,0,0
Eritrea,2003-12-01,2,0,0,0,0,2
Eritrea,2003-12-01,6,0,0,0,0,6
Eritrea,2003-12-01,1,0,0,0,1,2
Eritrea,2003-12-01,6,0,0,0,0,6
Eritrea,2003-12-01,6,0,0,0,0,6
Eritrea,2003-12-01,6,0,0,0,0,6
Eritrea,2003-12-01,3,0,0,-1,0,2
Eritrea,2003-12-01,6,0,0,0,0,6
Eritrea,2003-12-01,2,0,0,0,0,2
Eritrea,2003-12-01,0,0,-2,0,0,-2
Eritrea,2003-12-01,3,0,0,0,0,3
Eritrea,2003-12-01,0,0,0,0,0,0
Eritrea,2003-12-01,2,0,0,6,0,8
Georgia,2003-01-01,0,0,0,0,0,0
Georgia,2003-01-01,6,0,0,0,0,6
Georgia,2003-01-01,5,0,0,0,0,5
Georgia,2003-01-01,0,0,0,0,0,0
Georgia,2003-01-01,1,0,0,0,0,1
Georgia,2003-01-01,0,0,0,0,1,1
Georgia,2003-01-01,2,0,0,0,1,3
Georgia,2003-01-01,2,0,-2,0,0,0
Georgia,2003-01-01,0,0,0,-4,0,-4
Georgia,2003-01-01,8,0,0,0,0,8
Georgia,2003-01-01,0,0,0,-2,0,-2
Georgia,2003-01-01,3,0,0,0,0,3
Georgia,2003-01-01,1,0,0,0,0,1
Georgia,2003-01-01,0,0,0,0,0,0
Georgia,2003-01-01,0,0,0,0,0,0
Georgia,2003-01-01,0,0,0,0,3,3
Georgia,2003-01-01,0,0,0,0,0,0
Georgia,2003-01-01,1,0,0,0,0,1
Georgia,2003-01-01,2,0,0,3,0,5
Georgia,2003-01-01,2,0,2,0,0,4
Georgia,2003-01-01,5,0,0,0,0,5
Georgia,2003-01-01,2,0,0,0,0,2
Georgia,2003-01-01,0,0,0,3,0,3
Georgia,2003-01-01,0,0,0,0,0,0
Georgia,2003-01-01,6,0,0,0,0,6
Georgia,2003-01-01,0,0,0,0,0,0
Georgia,2003-01-01,-2,0,0,0,2,0
Georgia,2003-01-01,1,0,0,1,0,2
Georgia,2003-01-01,0,0,0,-4,0,-4
Georgia,2003-02-01,0,0,0,0,0,0
Georgia,2003-02-01,4,0,0,0,0,4
Georgia,2003-02-01,0,0,0,-2,0,-2
Georgia,2003-02-01,6,0,0,3,0,9
Georgia,2003-02-01,2,0,0,0,0,2
Georgia,2003-02-01,0,0,0,0,0,0
Georgia,2003-02-01,0,0,0,0,0,0
Georgia,2003-02-01,1,0,0,0,0,1
Georgia,2003-02-01,0,0,0,-2,0,-2
Georgia,2003-02-01,3,0,0,0,0,3
Georgia,2003-02-01,0,0,0,0,0,0
Georgia,2003-02-01,-1,0,0,0,0,-1
Georgia,2003-02-01,0,0,0,0,0,0
Georgia,2003-02-01,1,0,0,0,0,1
Georgia,2003-02-01,-2,0,0,0,0,-2
Georgia,2003-02-01,0,0,0,0,0,0
Georgia,2003-02-01,2,0,1,0,1,4
Georgia,2003-02-01,5,0,0,0,2,7
Georgia,2003-02-01,0,0,0,0,0,0
Georgia,2003-02-01,0,0,0,0,0,0
Georgia,2003-02-01,0,0,0,0,0,0
Georgia,2003-02-01,1,0,0,0,0,1
Georgia,2003-03-01,0,0,0,0,0,0
Georgia,2003-03-01,0,0,0,0,0,0
Georgia,2003-03-01,3,0,0,0,0,3
Georgia,2003-03-01,3,0,0,0,0,3
Georgia,2003-03-01,2,0,0,0,0,2
Georgia,2003-03-01,0,0,0,0,0,0
Georgia,2003-03-01,1,0,0,0,-1,0
Georgia,2003-03-01,10,0,0,0,0,10
Georgia,2003-03-01,0,0,0,0,0,0
Georgia,2003-03-01,0,0,0,0,0,0
Georgia,2003-03-01,10,0,0,0,0,10
Georgia,2003-03-01,5,0,0,0,0,5
Georgia,2003-03-01,0,0,0,0,0,0
Georgia,2003-03-01,-1,0,0,0,0,-1
Georgia,2003-03-01,2,0,0,0,0,2
Georgia,2003-03-01,0,0,0,0,1,1
Georgia,2003-03-01,0,0,0,0,0,0
Georgia,2003-03-01,0,0,0,0,0,0
Georgia,2003-03-01,3,0,0,3,0,6
Georgia,2003-03-01,0,0,1,3,0,4
Georgia,2003-03-01,0,0,0,0,0,0
Georgia,2003-03-01,3,0,0,0,0,3
Georgia,2003-03-01,2,0,0,0,0,2
Georgia,2003-04-01,1,0,0,3,0,4
Georgia,2003-04-01,-2,0,0,0,2,0
Georgia,2003-04-01,8,0,0,0,0,8
Georgia,2003-04-01,5,0,0,0,0,5
Georgia,2003-04-01,5,0,0,0,0,5
Georgia,2003-04-01,3,0,0,3,0,6
Georgia,2003-04-01,8,0,-2,0,2,8
Georgia,2003-04-01,4,0,0,0,0,4
Georgia,2003-04-01,2,0,1,0,1,4
Georgia,2003-04-01,1,0,0,27,0,28
Georgia,2003-04-01,0,0,0,0,0,0
Georgia,2003-04-01,0,0,0,0,0,0
Georgia,2003-04-01,0,0,0,-2,1,-1
Georgia,2003-04-01,5,0,-1,0,0,4
Georgia,2003-04-01,4,0,0,0,0,4
Georgia,2003-04-01,4,0,0,0,0,4
Georgia,2003-04-01,0,0,0,0,0,0
Georgia,2003-04-01,4,0,0,0,0,4
Georgia,2003-04-01,1,0,0,0,0,1
Georgia,2003-04-01,9,0,0,0,1,10
Georgia,2003-04-01,0,0,0,0,0,0
Georgia,2003-04-01,2,0,0,0,1,3
Georgia,2003-04-01,2,0,0,0,0,2
Georgia,2003-04-01,7,0,0,0,0,7
Georgia,2003-04-01,0,0,0,0,0,0
Georgia,2003-04-01,0,0,0,0,0,0
Georgia,2003-04-01,-2,0,0,0,0,-2
Georgia,2003-04-01,8,0,0,0,0,8
Georgia,2003-05-01,8,0,0,3,0,11
Georgia,2003-05-01,3,0,0,0,0,3
Georgia,2003-05-01,3,0,0,0,0,3
Georgia,2003-05-01,3,0,0,3,2,8
Georgia,2003-05-01,0,0,0,0,0,0
Georgia,2003-05-01,14,0,0,0,0,14
Georgia,2003-05-01,3,0,0,0,0,3
Georgia,2003-05-01,2,0,-2,0,0,0
Georgia,2003-05-01,2,0,0,0,0,2
Georgia,2003-05-01,4,0,0,3,0,7
Georgia,2003-05-01,3,0,0,0,0,3
Georgia,2003-05-01,3,0,0,0,0,3
Georgia,2003-05-01,4,0,0,0,0,4
Georgia,2003-05-01,2,0,2,0,0,4
Georgia,2003-05-01,3,0,0,0,1,4
Georgia,2003-05-01,3,0,0,0,0,3
Georgia,2003-05-01,6,0,-4,0,0,2
Georgia,2003-05-01,2,0,0,0,0,2
Georgia,2003-05-01,7,0,0,0,0,7
Georgia,2003-05-01,0,0,0,0,0,0
Georgia,2003-05-01,0,0,0,3,0,3
Georgia,2003-05-01,0,0,0,0,0,0
Georgia,2003-05-01,6,0,1,0,0,7
Georgia,2003-05-01,3,0,0,0,0,3
Georgia,2003-05-01,9,0,0,0,1,10
Georgia,2003-05-01,0,0,0,3,0,3
Georgia,2003-06-01,2,0,0,0,0,2
Georgia,2003-06-01,0,0,0,0,0,0
Georgia,2003-06-01,2,0,0,0,0,2
Georgia,2003-06-01,0,0,0,5,1,6
Georgia,2003-06-01,3,0,0,-4,6,5
Georgia,2003-06-01,-1,0,0,0,0,-1
Georgia,2003-06-01,0,0,0,0,0,0
Georgia,2003-06-01,0,0,1,3,0,4
Georgia,2003-06-01,0,0,0,0,0,0
Georgia,2003-06-01,0,0,0,0,0,0
Georgia,2003-06-01,0,0,0,-4,0,-4
Georgia,2003-06-01,0,0,0,0,0,0
Georgia,2003-06-01,1,0,0,-2,0,-1
Georgia,2003-06-01,0,0,0,0,0,0
Georgia,2003-06-01,-1,0,0,0,0,-1
Georgia,2003-06-01,0,0,0,3,2,5
Georgia,2003-06-01,3,0,0,3,0,6
Georgia,2003-06-01,0,0,0,0,0,0
Georgia,2003-06-01,1,0,0,0,0,1
Georgia,2003-06-01,2,0,0,0,0,2
Georgia,2003-06-01,0,0,0,0,0,0
Georgia,2003-06-01,-3,0,0,0,0,-3
Georgia,2003-06-01,-2,0,0,9,0,7
Georgia,2003-06-01,1,0,-1,-2,0,-2
Georgia,2003-06-01,4,0,0,0,0,4
Georgia,2003-06-01,2,0,0,0,0,2
Georgia,2003-06-01,1,0,1,0,2,4
Georgia,2003-06-01,0,0,0,0,0,0
Georgia,2003-07-01,0,0,0,0,0,0
Georgia,2003-07-01,0,0,0,0,0,0
Georgia,2003-07-01,4,0,0,0,0,4
Georgia,2003-07-01,2,0,0,0,0,2
Georgia,2003-07-01,0,0,0,0,0,0
Georgia,2003-07-01,1,0,0,0,0,1
Georgia,2003-07-01,2,0,0,0,0,2
Georgia,2003-07-01,-2,0,0,6,0,4
Georgia,2003-07-01,3,0,0,0,0,3
Georgia,2003-07-01,0,0,0,0,0,0
Georgia,2003-07-01,2,0,0,0,0,2
Georgia,2003-07-01,2,0,0,0,0,2
Georgia,2003-07-01,5,0,0,0,0,5
Georgia,2003-07-01,3,0,0,0,0,3
Georgia,2003-07-01,3,0,0,3,0,6
Georgia,2003-07-01,0,0,0,0,1,1
Georgia,2003-07-01,2,0,0,0,0,2
Georgia,2003-07-01,0,0,0,0,0,0
Georgia,2003-07-01,4,0,0,0,0,4
Georgia,2003-07-01,0,0,0,0,0,0
Georgia,2003-07-01,0,0,0,0,0,0
Georgia,2003-07-01,-2,0,0,0,0,-2
Georgia,2003-07-01,6,0,0,0,0,6
Georgia,2003-07-01,0,0,0,0,2,2
Georgia,2003-07-01,1,0,0,0,0,1
Georgia,2003-07-01,0,0,0,0,0,0
Georgia,2003-08-01,2,0,0,0,0,2
Georgia,2003-08-01,0,0,0,0,0,0
Georgia,2003-08-01,2,0,0,0,0,2
Georgia,2003-08-01,6,0,0,0,0,6
Georgia,2003-08-01,0,0,0,0,0,0
Georgia,2003-08-01,0,0,0,0,0,0
Georgia,2003-08-01,4,0,0,0,0,4
Georgia,2003-08-01,0,0,0,0,1,1
Georgia,2003-08-01,2,0,0,0,0,2
Georgia,2003-08-01,0,0,0,0,0,0
Georgia,2003-08-01,0,0,0,0,0,0
Georgia,2003-08-01,0,0,-2,0,0,-2
Georgia,2003-08-01,5,0,0,0,0,5
Georgia,2003-08-01,0,0,0,0,0,0
Georgia,2003-08-01,2,0,0,0,0,2
Georgia,2003-08-01,5,0,0,0,0,5
Georgia,2003-08-01,6,0,0,0,2,8
Georgia,2003-08-01,3,0,0,0,0,3
Georgia,2003-08-01,0,0,0,2,1,3
Georgia,2003-08-01,0,0,0,0,0,0
Georgia,2003-08-01,0,0,0,9,0,9
Georgia,2003-08-01,0,0,0,0,1,1
Georgia,2003-08-01,2,0,0,0,0,2
Georgia,2003-09-01,2,0,0,0,0,2
Georgia,2003-09-01,1,0,0,0,0,1
Georgia,2003-09-01,-1,0,0,0,0,-1
Georgia,2003-09-01,0,0,0,0,0,0
Georgia,2003-09-01,5,0,0,0,-2,3
Georgia,2003-09-01,0,0,0,6,1,7
Georgia,2003-09-01,0,0,0,0,0,0
Georgia,2003-09-01,2,0,0,0,0,2
Georgia,2003-09-01,3,0,0,3,0,6
Georgia,2003-09-01,0,0,0,0,1,1
Georgia,2003-09-01,0,0,0,-2,0,-2
Georgia,2003-09-01,-2,0,0,0,0,-2
Georgia,2003-09-01,0,0,0,0,0,0
Georgia,2003-09-01,3,0,0,0,0,3
Georgia,2003-09-01,0,0,0,0,0,0
Georgia,2003-09-01,3,0,0,0,0,3
Georgia,2003-09-01,1,0,0,0,0,1
Georgia,2003-09-01,0,0,0,0,0,0
Georgia,2003-09-01,0,0,0,0,0,0
Georgia,2003-09-01,0,0,0,0,0,0
Georgia,2003-09-01,2,0,0,6,0,8
Georgia,2003-09-01,0,0,0,0,0,0
Georgia,2003-09-01,4,0,0,0,0,4
Georgia,2003-09-01,0,0,0,0,1,1
Georgia,2003-09-01,0,0,0,0,0,0
Georgia,2003-09-01,2,0,0,0,0,2
Georgia,2003-09-01,6,0,0,0,1,7
Georgia,2003-10-01,0,0,0,1,0,1
Georgia,2003-10-01,0,0,0,3,0,3
Georgia,2003-10-01,1,0,0,0,0,1
Georgia,2003-10-01,4,0,0,0,0,4
Georgia,2003-10-01,0,0,0,0,0,0
Georgia,2003-10-01,0,0,0,0,0,0
Georgia,2003-10-01,0,0,0,0,0,0
Georgia,2003-10-01,0,0,0,0,0,0
Georgia,2003-10-01,0,0,0,0,0,0
Georgia,2003-10-01,0,0,0,0,0,0
Georgia,2003-10-01,3,0,0,0,0,3
Georgia,2003-10-01,0,0,1,0,0,1
Georgia,2003-10-01,2,4,0,0,0,6
Georgia,2003-10-01,0,0,0,0,0,0
Georgia,2003-10-01,0,0,0,0,0,0
Georgia,2003-10-01,0,0,0,0,0,0
Georgia,2003-10-01,-1,0,0,0,0,-1
Georgia,2003-10-01,-1,0,0,0,0,-1
Georgia,2003-10-01,0,0,0,0,0,0
Georgia,2003-10-01,0,0,-2,0,0,-2
Georgia,2003-10-01,0,0,0,0,0,0
Georgia,2003-10-01,0,0,0,0,0,0
Georgia,2003-10-01,0,0,0,0,0,0
Georgia,2003-10-01,2,0,0,0,0,2
Georgia,2003-10-01,0,0,0,0,0,0
Georgia,2003-10-01,1,0,0,0,0,1
Georgia,2003-11-01,0,0,1,0,0,1
Georgia,2003-11-01,0,0,0,0,1,1
Georgia,2003-11-01,2,0,0,0,0,2
Georgia,2003-11-01,4,0,0,-4,0,0
Georgia,2003-11-01,4,0,-2,0,0,2
Georgia,2003-11-01,0,0,0,0,0,0
Georgia,2003-11-01,0,0,0,0,0,0
Georgia,2003-11-01,3,0,1,0,1,5
Georgia,2003-11-01,2,0,1,2,1,6
Georgia,2003-11-01,2,0,0,0,0,2
Georgia,2003-11-01,0,0,0,0,0,0
Georgia,2003-11-01,3,0,0,0,1,4
Georgia,2003-11-01,1,0,0,0,0,1
Georgia,2003-11-01,0,0,0,0,0,0
Georgia,2003-11-01,2,0,0,0,0,2
Georgia,2003-11-01,0,0,0,3,0,3
Georgia,2003-11-01,3,0,0,0,0,3
Georgia,2003-11-01,3,0,-7,0,0,-4
Georgia,2003-11-01,0,0,0,0,0,0
Georgia,2003-11-01,0,0,0,0,1,1
Georgia,2003-11-01,5,0,0,-2,5,8
Georgia,2003-11-01,14,0,-8,3,3,12
Georgia,2003-11-01,11,0,-7,-1,1,4
Georgia,2003-11-01,19,0,0,0,5,24
Georgia,2003-11-01,9,0,0,-4,0,5
Georgia,2003-11-01,-1,0,0,0,2,1
Georgia,2003-11-01,0,0,0,0,0,0
Georgia,2003-11-01,-2,0,0,0,0,-2
Georgia,2003-11-01,0,0,0,0,0,0
Georgia,2003-12-01,0,0,0,3,0,3
Georgia,2003-12-01,11,0,0,0,0,11
Georgia,2003-12-01,4,0,0,3,0,7
Georgia,2003-12-01,0,2,0,0,0,2
Georgia,2003-12-01,-2,0,0,0,0,-2
Georgia,2003-12-01,0,0,0,0,0,0
Georgia,2003-12-01,0,0,0,0,0,0
Georgia,2003-12-01,0,0,0,0,0,0
Georgia,2003-12-01,0,0,0,-2,0,-2
Georgia,2003-12-01,5,0,0,6,0,11
Georgia,2003-12-01,0,0,0,-2,0,-2
Georgia,2003-12-01,0,0,0,3,0,3
Georgia,2003-12-01,0,0,0,0,0,0
Georgia,2003-12-01,0,0,0,0,0,0
Georgia,2003-12-01,26,0,0,0,1,27
Georgia,2003-12-01,0,0,0,0,0,0
Georgia,2003-12-01,5,0,0,3,0,8
Georgia,2003-12-01,7,0,0,3,3,13
Georgia,2003-12-01,2,0,0,6,1,9
Georgia,2003-12-01,12,0,0,3,0,15
Georgia,2003-12-01,0,0,0,0,0,0
Georgia,2003-12-01,0,0,0,0,0,0
Georgia,2003-12-01,0,0,0,0,0,0
Georgia,2003-12-01,-1,0,0,3,0,2
Georgia,2003-12-01,3,0,0,0,0,3
Georgia,2003-12-01,0,0,0,0,0,0
Georgia,2003-12-01,3,0,0,0,0,3
Georgia,2003-12-01,2,0,0,0,0,2
Georgia,2003-12-01,3,0,0,3,0,6
Georgia,2003-12-01,0,0,0,6,0,6
India,2003-01-01,5,0,0,0,0,5
India,2003-01-01,5,0,0,3,0,8
India,2003-01-01,15,0,0,6,2,23
India,2003-01-01,29,0,0,3,0,32
India,2003-01-01,2,0,0,0,0,2
India,2003-01-01,6,0,0,0,0,6
India,2003-01-01,0,0,0,0,0,0
India,2003-01-01,3,0,0,-2,2,3
India,2003-01-01,1,0,0,-4,0,-3
India,2003-01-01,2,0,0,6,0,8
India,2003-01-01,3,0,0,9,0,12
India,2003-01-01,0,0,0,0,0,0
India,2003-01-01,17,2,0,-2,0,17
India,2003-01-01,8,0,0,9,1,18
India,2003-01-01,-1,0,0,0,2,1
India,2003-01-01,3,0,0,0,1,4
India,2003-01-01,9,0,0,-2,0,7
India,2003-01-01,16,0,0,0,0,16
India,2003-01-01,5,0,0,0,0,5
India,2003-01-01,20,0,0,12,0,32
India,2003-01-01,17,0,0,0,-2,15
India,2003-01-01,8,0,0,18,4,30
India,2003-01-01,15,0,0,9,3,27
India,2003-01-01,17,0,0,18,0,35
India,2003-01-01,7,0,0,15,2,24
India,2003-01-01,5,0,0,0,0,5
India,2003-01-01,1,0,0,6,2,9
India,2003-01-01,18,0,0,0,0,18
India,2003-01-01,18,0,0,3,3,24
India,2003-01-01,12,0,0,0,5,17
India,2003-01-01,15,0,0,-1,0,14
India,2003-02-01,12,0,0,-2,0,10
India,2003-02-01,0,0,0,0,2,2
India,2003-02-01,7,0,0,0,2,9
India,2003-02-01,11,0,0,0,2,13
India,2003-02-01,8,0,0,0,3,11
India,2003-02-01,12,0,0,12,0,24
India,2003-02-01,7,0,0,3,0,10
India,2003-02-01,5,0,0,3,0,8
India,2003-02-01,0,0,0,0,0,0
India,2003-02-01,6,0,0,6,0,12
India,2003-02-01,16,0,0,3,0,19
India,2003-02-01,-2,0,0,6,0,4
India,2003-02-01,7,0,0,0,1,8
India,2003-02-01,7,0,0,3,0,10
India,2003-02-01,4,0,0,0,2,6
India,2003-02-01,0,0,0,-4,1,-3
India,2003-02-01,2,0,0,0,0,2
India,2003-02-01,1,0,0,0,0,1
India,2003-02-01,4,0,0,0,3,7
India,2003-02-01,5,0,0,6,1,12
India,2003-02-01,6,0,0,0,0,6
India,2003-02-01,8,0,2,0,0,10
India,2003-02-01,15,0,0,0,0,15
India,2003-02-01,5,0,0,-8,0,-3
India,2003-02-01,7,0,0,-4,2,5
India,2003-02-01,5,0,0,0,0,5
India,2003-02-01,-2,0,0,0,0,-2
India,2003-02-01,-7,0,0,3,0,-4
India,2003-03-01,2,0,0,-4,0,-2
India,2003-03-01,13,0,0,3,0,16
India,2003-03-01,0,0,0,0,0,0
India,2003-03-01,9,2,0,0,0,11
India,2003-03-01,3,0,0,6,0,9
India,2003-03-01,0,0,0,3,0,3
India,2003-03-01,0,2,0,3,0,5
India,2003-03-01,3,0,0,3,0,6
India,2003-03-01,4,0,-1,0,1,4
India,2003-03-01,0,0,0,3,0,3
India,2003-03-01,1,0,0,0,0,1
India,2003-03-01,10,0,0,9,2,21
India,2003-03-01,10,0,0,0,2,12
India,2003-03-01,10,0,0,12,0,22
India,2003-03-01,0,0,0,6,0,6
India,2003-03-01,0,0,0,0,1,1
India,2003-03-01,5,0,0,3,0,8
India,2003-03-01,10,0,0,3,0,13
India,2003-03-01,3,0,0,-2,2,3
India,2003-03-01,4,0,0,0,1,5
India,2003-03-01,10,0,0,3,3,16
India,2003-03-01,0,0,0,0,0,0
India,2003-03-01,12,0,-2,0,0,10
India,2003-03-01,5,0,0,0,0,5
India,2003-03-01,3,0,0,3,0,6
India,2003-03-01,13,0,0,0,4,17
India,2003-03-01,0,0,0,0,0,0
India,2003-03-01,3,0,0,0,0,3
India,2003-03-01,3,0,0,-2,1,2
India,2003-03-01,3,0,0,0,0,3
India,2003-03-01,3,0,0,0,0,3
India,2003-04-01,0,0,0,0,0,0
India,2003-04-01,19,0,0,0,2,21
India,2003-04-01,7,0,0,-6,0,1
India,2003-04-01,2,0,0,0,0,2
India,2003-04-01,6,0,0,0,0,6
India,2003-04-01,0,0,0,3,0,3
India,2003-04-01,3,0,0,3,0,6
India,2003-04-01,4,0,0,0,0,4
India,2003-04-01,5,0,0,0,0,5
India,2003-04-01,0,0,0,0,2,2
India,2003-04-01,11,0,0,3,0,14
India,2003-04-01,17,0,-2,0,0,15
India,2003-04-01,5,0,0,0,0,5
India,2003-04-01,2,0,0,0,0,2
India,2003-04-01,2,0,0,6,0,8
India,2003-04-01,11,0,0,0,0,11
India,2003-04-01,1,0,0,0,1,2
India,2003-04-01,2,0,0,3,0,5
India,2003-04-01,2,0,0,3,0,5
India,2003-04-01,2,0,0,-4,2,0
India,2003-04-01,6,0,0,0,0,6
India,2003-04-01,17,0,0,0,2,19
India,2003-04-01,2,0,0,3,0,5
India,2003-04-01,3,0,0,-2,0,1
India,2003-04-01,0,0,0,-6,0,-6
India,2003-04-01,0,0,0,0,0,0
India,2003-04-01,0,0,0,3,0,3
India,2003-04-01,17,0,0,0,0,17
India,2003-04-01,-2,0,0,0,0,-2
India,2003-04-01,11,0,0,0,0,11
India,2003-05-01,18,0,-2,0,4,20
India,2003-05-01,2,0,0,-2,0,0
India,2003-05-01,1,0,0,0,0,1
India,2003-05-01,1,0,2,0,0,3
India,2003-05-01,17,0,0,3,2,22
India,2003-05-01,18,0,0,9,1,28
India,2003-05-01,7,0,0,3,0,10
India,2003-05-01,9,2,0,0,0,11
India,2003-05-01,11,0,0,0,3,14
India,2003-05-01,5,0,0,1,0,6
India,2003-05-01,5,0,0,1,0,6
India,2003-05-01,7,0,0,3,0,10
India,2003-05-01,8,0,0,0,0,8
India,2003-05-01,8,0,1,-1,0,8
India,2003-05-01,4,0,0,3,3,10
India,2003-05-01,5,0,0,0,1,6
India,2003-05-01,9,0,0,0,0,9
India,2003-05-01,8,0,0,-4,6,10
India,2003-05-01,7,0,0,3,3,13
India,2003-05-01,5,0,0,0,3,8
India,2003-05-01,16,0,0,0,0,16
India,2003-05-01,1,0,0,3,0,4
India,2003-05-01,4,0,0,0,1,5
India,2003-05-01,5,0,0,-2,6,9
India,2003-05-01,0,0,0,-2,2,0
India,2003-05-01,4,0,0,3,1,8
India,2003-05-01,6,0,0,-2,0,4
India,2003-05-01,5,0,0,1,6,12
India,2003-05-01,5,0,1,0,0,6
India,2003-05-01,14,0,0,0,1,15
India,2003-05-01,7,0,0,-4,0,3
India,2003-06-01,8,0,-4,0,0,4
India,2003-06-01,5,0,1,-2,0,4
India,2003-06-01,5,0,0,0,3,8
India,2003-06-01,10,0,0,0,5,15
India,2003-06-01,7,0,2,-2,2,9
India,2003-06-01,-1,0,0,-2,0,-3
India,2003-06-01,2,0,0,0,1,3
India,2003-06-01,0,0,0,-4,1,-3
India,2003-06-01,4,4,-2,0,0,6
India,2003-06-01,1,0,0,0,0,1
India,2003-06-01,16,2,0,9,0,27
India,2003-06-01,9,0,0,6,3,18
India,2003-06-01,8,0,0,3,0,11
India,2003-06-01,3,0,0,3,0,6
India,2003-06-01,1,0,0,3,1,5
India,2003-06-01,4,0,2,3,0,9
India,2003-06-01,11,0,0,-2,2,11
India,2003-06-01,19,0,0,0,2,21
India,2003-06-01,12,0,-1,0,3,14
India,2003-06-01,6,0,0,3,0,9
India,2003-06-01,6,0,0,0,3,9
India,2003-06-01,4,0,0,0,0,4
India,2003-06-01,3,0,0,3,0,6
India,2003-06-01,8,0,0,6,1,15
India,2003-06-01,12,0,0,0,2,14
India,2003-06-01,11,0,0,0,0,11
India,2003-06-01,11,0,0,0,2,13
India,2003-06-01,17,0,0,0,0,17
India,2003-06-01,14,0,0,-2,4,16
India,2003-06-01,11,0,0,0,0,11
India,2003-07-01,9,0,0,0,0,9
India,2003-07-01,5,0,0,3,1,9
India,2003-07-01,0,0,0,0,0,0
India,2003-07-01,15,0,0,3,0,18
India,2003-07-01,7,0,0,0,0,7
India,2003-07-01,-1,0,0,6,0,5
India,2003-07-01,6,0,0,9,0,15
India,2003-07-01,1,0,0,-2,3,2
India,2003-07-01,4,4,1,9,0,18
India,2003-07-01,-3,0,0,0,2,-1
India,2003-07-01,7,0,0,0,0,7
India,2003-07-01,2,0,0,3,0,5
India,2003-07-01,3,0,0,0,0,3
India,2003-07-01,10,0,0,0,0,10
India,2003-07-01,15,0,0,6,3,24
India,2003-07-01,9,0,0,6,1,16
India,2003-07-01,7,0,0,3,0,10
India,2003-07-01,9,0,0,0,0,9
India,2003-07-01,11,0,0,3,0,14
India,2003-07-01,4,0,0,3,0,7
India,2003-07-01,7,0,0,4,4,15
India,2003-07-01,6,0,0,15,0,21
India,2003-07-01,15,0,0,0,2,17
India,2003-07-01,25,0,0,6,0,31
India,2003-07-01,16,0,0,0,0,16
India,2003-07-01,3,0,0,-2,0,1
India,2003-07-01,5,0,0,0,2,7
India,2003-07-01,9,0,0,0,5,14
India,2003-07-01,4,0,0,0,0,4
India,2003-07-01,10,0,0,0,0,10
India,2003-07-01,2,0,0,0,0,2
India,2003-08-01,10,0,0,3,1,14
India,2003-08-01,2,0,0,0,0,2
India,2003-08-01,0,0,0,6,0,6
India,2003-08-01,20,2,0,0,0,22
India,2003-08-01,3,0,0,0,2,5
India,2003-08-01,20,0,0,-1,2,21
India,2003-08-01,8,0,0,6,0,14
India,2003-08-01,0,0,0,1,2,3
India,2003-08-01,4,0,0,0,0,4
India,2003-08-01,3,0,0,0,2,5
India,2003-08-01,2,0,0,0,1,3
India,2003-08-01,4,0,0,0,0,4
India,2003-08-01,0,0,0,0,3,3
India,2003-08-01,15,0,0,12,1,28
India,2003-08-01,9,0,0,0,0,9
India,2003-08-01,10,0,0,0,0,10
India,2003-08-01,2,0,0,0,2,4
India,2003-08-01,5,0,0,0,1,6
India,2003-08-01,5,0,0,3,0,8
India,2003-08-01,0,0,0,0,0,0
India,2003-08-01,0,0,0,0,0,0
India,2003-08-01,19,0,0,0,0,19
India,2003-08-01,5,0,0,0,0,5
India,2003-08-01,0,0,0,2,0,2
India,2003-08-01,6,0,0,6,0,12
India,2003-08-01,1,0,0,0,0,1
India,2003-08-01,31,0,0,8,2,41
India,2003-08-01,13,0,0,-2,0,11
India,2003-08-01,10,0,0,0,0,10
India,2003-08-01,41,0,0,0,0,41
India,2003-08-01,0,0,0,0,0,0
India,2003-09-01,4,0,0,-8,2,-2
India,2003-09-01,0,0,0,3,0,3
India,2003-09-01,16,0,0,0,0,16
India,2003-09-01,9,0,0,1,2,12
India,2003-09-01,7,0,0,1,1,9
India,2003-09-01,14,0,0,-2,1,13
India,2003-09-01,8,0,-1,0,2,9
India,2003-09-01,18,0,0,-2,2,18
India,2003-09-01,17,0,0,-2,9,24
India,2003-09-01,10,0,0,6,2,18
India,2003-09-01,28,0,0,6,7,41
India,2003-09-01,11,0,0,4,0,15
India,2003-09-01,13,0,0,0,2,15
India,2003-09-01,17,0,0,0,2,19
India,2003-09-01,10,0,0,0,0,10
India,2003-09-01,16,0,0,0,0,16
India,2003-09-01,4,0,0,9,0,13
India,2003-09-01,7,0,0,9,0,16
India,2003-09-01,11,0,0,2,0,13
India,2003-09-01,25,0,0,-2,0,23
India,2003-09-01,14,0,0,0,0,14
India,2003-09-01,10,0,0,7,0,17
India,2003-09-01,1,0,0,0,2,3
India,2003-09-01,11,0,0,0,0,11
India,2003-09-01,-2,0,0,0,0,-2
India,2003-09-01,11,2,0,0,0,13
India,2003-09-01,8,0,-2,0,0,6
India,2003-09-01,8,0,-6,0,4,6
India,2003-09-01,28,0,0,-10,-1,17
India,2003-09-01,7,0,0,0,0,7
India,2003-10-01,10,0,0,0,1,11
India,2003-10-01,9,0,-2,0,0,7
India,2003-10-01,8,0,0,3,1,12
India,2003-10-01,6,0,0,1,2,9
India,2003-10-01,5,0,0,0,4,9
India,2003-10-01,8,0,0,1,0,9
India,2003-10-01,4,0,0,-2,0,2
India,2003-10-01,5,0,0,0,0,5
India,2003-10-01,11,0,0,0,4,15
India,2003-10-01,9,0,-2,-2,0,5
India,2003-10-01,2,0,0,9,0,11
India,2003-10-01,6,0,0,0,0,6
India,2003-10-01,8,0,0,0,0,8
India,2003-10-01,6,2,0,3,1,12
India,2003-10-01,10,0,0,3,1,14
India,2003-10-01,6,0,0,2,1,9
India,2003-10-01,5,0,0,6,0,11
India,2003-10-01,15,0,0,3,0,18
India,2003-10-01,-1,0,0,3,1,3
India,2003-10-01,6,0,0,0,1,7
India,2003-10-01,15,0,0,1,0,16
India,2003-10-01,8,0,0,6,1,15
India,2003-10-01,2,0,0,6,0,8
India,2003-10-01,9,0,0,1,0,10
India,2003-10-01,1,0,1,0,0,2
India,2003-10-01,0,0,0,0,1,1
India,2003-10-01,25,0,-2,-6,0,17
India,2003-10-01,8,0,0,-6,0,2
India,2003-10-01,4,0,0,-2,0,2
India,2003-10-01,2,0,0,1,0,3
India,2003-10-01,3,0,1,3,0,7
India,2003-11-01,7,0,0,0,0,7
India,2003-11-01,5,0,0,3,0,8
India,2003-11-01,4,0,0,0,0,4
India,2003-11-01,46,0,0,3,0,49
India,2003-11-01,37,0,0,3,0,40
India,2003-11-01,7,0,0,0,0,7
India,2003-11-01,4,0,0,0,0,4
India,2003-11-01,13,0,0,16,0,29
India,2003-11-01,9,0,0,6,0,15
India,2003-11-01,6,0,0,6,0,12
India,2003-11-01,2,0,0,6,0,8
India,2003-11-01,10,0,0,6,0,16
India,2003-11-01,11,0,0,18,4,33
India,2003-11-01,8,0,1,3,0,12
India,2003-11-01,8,0,0,15,1,24
India,2003-11-01,9,0,0,7,0,16
India,2003-11-01,15,0,0,12,0,27
India,2003-11-01,4,0,0,0,0,4
India,2003-11-01,3,0,0,3,0,6
India,2003-11-01,0,0,0,21,2,23
India,2003-11-01,12,0,0,4,0,16
India,2003-11-01,7,0,1,0,1,9
India,2003-11-01,9,2,0,0,0,11
India,2003-11-01,10,2,0,9,0,21
India,2003-11-01,18,0,-1,0,0,17
India,2003-11-01,2,0,0,0,0,2
India,2003-11-01,2,0,0,0,0,2
India,2003-11-01,3,0,0,0,0,3
India,2003-11-01,0,0,0,3,0,3
India,2003-11-01,2,0,0,0,0,2
India,2003-12-01,-2,0,0,0,0,-2
India,2003-12-01,10,0,0,-8,1,3
India,2003-12-01,18,0,1,0,0,19
India,2003-12-01,19,0,0,4,1,24
India,2003-12-01,3,0,0,0,3,6
India,2003-12-01,13,0,-1,-2,1,11
India,2003-12-01,6,0,0,0,2,8
India,2003-12-01,3,0,0,2,0,5
India,2003-12-01,3,0,0,6,5,14
India,2003-12-01,5,0,0,0,0,5
India,2003-12-01,5,0,0,0,0,5
India,2003-12-01,4,0,0,9,1,14
India,2003-12-01,6,0,0,3,0,9
India,2003-12-01,-2,0,0,6,0,4
India,2003-12-01,25,0,0,0,0,25
India,2003-12-01,9,0,0,3,3,15
India,2003-12-01,5,0,0,4,0,9
India,2003-12-01,36,0,0,7,2,45
India,2003-12-01,5,0,0,0,0,5
India,2003-12-01,4,0,0,3,4,11
India,2003-12-01,11,0,0,0,0,11
India,2003-12-01,6,0,0,-2,0,4
India,2003-12-01,9,0,0,0,0,9
India,2003-12-01,1,0,0,0,0,1
India,2003-12-01,9,0,-1,4,0,12
India,2003-12-01,5,0,0,0,0,5
India,2003-12-01,3,0,0,3,0,6
India,2003-12-01,7,0,0,0,0,7
India,2003-12-01,8,0,0,-2,0,6
India,2003-12-01,35,0,0,-8,13,40
India,2003-12-01,9,0,0,-2,3,10
Iran,2003-01-01,13,0,1,0,0,14
Iran,2003-01-01,3,0,0,0,2,5
Iran,2003-01-01,6,0,0,0,0,6
Iran,2003-01-01,2,0,0,6,0,8
Iran,2003-01-01,2,0,0,0,0,2
Iran,2003-01-01,10,0,0,2,0,12
Iran,2003-01-01,21,0,0,4,6,31
Iran,2003-01-01,3,0,1,12,0,16
Iran,2003-01-01,27,0,0,9,0,36
Iran,2003-01-01,6,0,0,3,0,9
Iran,2003-01-01,0,0,0,0,0,0
Iran,2003-01-01,3,0,1,3,0,7
Iran,2003-01-01,9,0,0,7,2,18
Iran,2003-01-01,13,0,-2,6,10,27
Iran,2003-01-01,6,2,0,3,1,12
Iran,2003-01-01,11,0,-2,6,1,16
Iran,2003-01-01,14,0,0,0,4,18
Iran,2003-01-01,-4,0,0,15,1,12
Iran,2003-01-01,30,0,-2,4,0,32
Iran,2003-01-01,3,0,0,0,0,3
Iran,2003-01-01,4,0,2,4,2,12
Iran,2003-01-01,19,0,0,-12,1,8
Iran,2003-01-01,43,0,0,12,7,62
Iran,2003-01-01,2,0,0,3,0,5
Iran,2003-01-01,21,0,0,0,1,22
Iran,2003-01-01,35,0,-1,6,0,40
Iran,2003-01-01,9,0,0,10,3,22
Iran,2003-01-01,21,0,-2,12,0,31
Iran,2003-01-01,12,0,0,-9,2,5
Iran,2003-01-01,19,0,0,-10,0,9
Iran,2003-01-01,18,0,0,-2,0,16
Iran,2003-02-01,16,0,-3,-9,5,9
Iran,2003-02-01,-2,0,0,2,0,0
Iran,2003-02-01,9,0,0,9,0,18
Iran,2003-02-01,23,0,0,4,1,28
Iran,2003-02-01,12,0,0,-8,1,5
Iran,2003-02-01,24,0,0,2,4,30
Iran,2003-02-01,39,0,0,6,2,47
Iran,2003-02-01,43,0,-2,16,5,62
Iran,2003-02-01,28,0,0,7,0,35
Iran,2003-02-01,16,0,0,1,3,20
Iran,2003-02-01,16,0,-2,3,3,20
Iran,2003-02-01,15,0,0,0,0,15
Iran,2003-02-01,24,0,0,0,6,30
Iran,2003-02-01,7,0,0,3,1,11
Iran,2003-02-01,12,0,0,2,1,15
Iran,2003-02-01,10,0,0,6,0,16
Iran,2003-02-01,13,0,0,1,1,15
Iran,2003-02-01,12,0,0,13,0,25
Iran,2003-02-01,8,0,0,3,3,14
Iran,2003-02-01,26,0,0,0,0,26
Iran,2003-02-01,13,0,0,0,1,14
Iran,2003-02-01,21,0,0,0,0,21
Iran,2003-02-01,47,0,1,0,2,50
Iran,2003-02-01,8,0,0,-1,0,7
Iran,2003-02-01,33,0,0,9,0,42
Iran,2003-02-01,6,0,1,0,1,8
Iran,2003-02-01,17,0,0,4,0,21
Iran,2003-02-01,50,0,0,-4,6,52
Iran,2003-03-01,11,0,0,3,0,14
Iran,2003-03-01,12,0,0,7,3,22
Iran,2003-03-01,1,0,-2,0,1,0
Iran,2003-03-01,9,0,0,6,0,15
Iran,2003-03-01,19,0,1,12,0,32
Iran,2003-03-01,3,0,0,0,1,4
Iran,2003-03-01,3,2,0,15,0,20
Iran,2003-03-01,33,0,-4,5,0,34
Iran,2003-03-01,10,0,0,0,1,11
Iran,2003-03-01,11,0,-8,21,2,26
Iran,2003-03-01,19,0,-4,13,1,29
Iran,2003-03-01,17,0,0,1,0,18
Iran,2003-03-01,8,0,0,-25,0,-17
Iran,2003-03-01,4,0,0,-3,0,1
Iran,2003-03-01,15,0,0,6,2,23
Iran,2003-03-01,-3,0,0,-4,0,-7
Iran,2003-03-01,21,0,0,11,1,33
Iran,2003-03-01,24,0,0,-7,0,17
Iran,2003-03-01,26,0,0,-13,0,13
Iran,2003-03-01,20,0,1,6,2,29
Iran,2003-03-01,31,0,0,-7,6,30
Iran,2003-03-01,11,0,0,9,3,23
Iran,2003-03-01,3,0,0,1,5,9
Iran,2003-03-01,6,0,0,3,0,9
Iran,2003-03-01,16,0,0,1,0,17
Iran,2003-03-01,40,0,0,6,0,46
Iran,2003-03-01,13,0,0,0,1,14
Iran,2003-03-01,5,0,1,6,4,16
Iran,2003-03-01,15,0,0,0,1,16
Iran,2003-03-01,9,0,0,0,3,12
Iran,2003-03-01,11,0,0,9,1,21
Iran,2003-04-01,26,0,1,3,0,30
Iran,2003-04-01,14,0,0,9,1,24
Iran,2003-04-01,43,0,0,-2,1,42
Iran,2003-04-01,5,0,0,0,0,5
Iran,2003-04-01,23,0,0,1,1,25
Iran,2003-04-01,46,0,2,6,1,55
Iran,2003-04-01,29,0,0,3,3,35
Iran,2003-04-01,25,0,0,3,2,30
Iran,2003-04-01,8,0,0,-4,10,14
Iran,2003-04-01,16,0,0,3,1,20
Iran,2003-04-01,11,0,1,0,2,14
Iran,2003-04-01,17,0,0,1,0,18
Iran,2003-04-01,39,0,0,12,3,54
Iran,2003-04-01,41,0,0,26,2,69
Iran,2003-04-01,81,0,0,10,13,104
Iran,2003-04-01,37,0,-2,-4,0,31
Iran,2003-04-01,41,0,0,0,1,42
Iran,2003-04-01,11,0,0,0,1,12
Iran,2003-04-01,18,0,0,16,0,34
Iran,2003-04-01,4,0,0,1,0,5
Iran,2003-04-01,29,0,0,-2,2,29
Iran,2003-04-01,12,0,0,12,0,24
Iran,2003-04-01,9,0,0,0,2,11
Iran,2003-04-01,12,0,1,5,4,22
Iran,2003-04-01,2,0,0,0,0,2
Iran,2003-04-01,12,0,0,16,0,28
Iran,2003-04-01,20,0,0,6,2,28
Iran,2003-04-01,11,0,0,6,6,23
Iran,2003-04-01,23,0,0,0,6,29
Iran,2003-04-01,13,0,0,3,3,19
Iran,2003-05-01,29,0,0,0,0,29
Iran,2003-05-01,7,0,0,0,0,7
Iran,2003-05-01,32,0,0,3,0,35
Iran,2003-05-01,6,0,0,3,0,9
Iran,2003-05-01,15,0,1,-4,2,14
Iran,2003-05-01,11,0,0,4,0,15
Iran,2003-05-01,12,0,0,1,1,14
Iran,2003-05-01,8,0,0,-4,0,4
Iran,2003-05-01,19,0,0,5,7,31
Iran,2003-05-01,21,0,0,0,3,24
Iran,2003-05-01,24,0,0,6,1,31
Iran,2003-05-01,21,0,0,18,8,47
Iran,2003-05-01,19,0,0,-4,0,15
Iran,2003-05-01,9,0,-2,-5,2,4
Iran,2003-05-01,38,0,0,0,1,39
Iran,2003-05-01,1,0,0,0,0,1
Iran,2003-05-01,23,0,0,15,0,38
Iran,2003-05-01,4,0,0,9,0,13
Iran,2003-05-01,8,0,0,0,1,9
Iran,2003-05-01,7,0,0,-1,3,9
Iran,2003-05-01,20,0,2,-2,2,22
Iran,2003-05-01,24,0,0,9,0,33
Iran,2003-05-01,3,0,0,3,0,6
Iran,2003-05-01,14,0,0,6,2,22
Iran,2003-05-01,13,0,0,17,1,31
Iran,2003-05-01,17,0,0,17,3,37
Iran,2003-05-01,14,0,0,1,1,16
Iran,2003-05-01,2,0,0,2,7,11
Iran,2003-05-01,49,0,4,-2,2,53
Iran,2003-05-01,18,0,0,8,15,41
Iran,2003-05-01,17,0,0,1,0,18
Iran,2003-06-01,29,0,0,18,3,50
Iran,2003-06-01,8,0,0,27,2,37
Iran,2003-06-01,17,0,0,4,2,23
Iran,2003-06-01,23,0,0,6,2,31
Iran,2003-06-01,44,0,0,1,16,61
Iran,2003-06-01,21,0,1,3,1,26
Iran,2003-06-01,10,0,1,1,0,12
Iran,2003-06-01,18,0,3,0,2,23
Iran,2003-06-01,27,0,1,6,2,36
Iran,2003-06-01,7,0,0,6,0,13
Iran,2003-06-01,4,0,-1,9,2,14
Iran,2003-06-01,14,0,0,4,4,22
Iran,2003-06-01,6,0,0,10,2,18
Iran,2003-06-01,12,0,0,6,1,19
Iran,2003-06-01,1,0,0,-10,0,-9
Iran,2003-06-01,38,0,0,12,8,58
Iran,2003-06-01,19,0,0,21,7,47
Iran,2003-06-01,46,0,0,12,35,93
Iran,2003-06-01,41,0,0,25,29,95
Iran,2003-06-01,32,0,0,20,13,65
Iran,2003-06-01,22,0,0,14,5,41
Iran,2003-06-01,8,0,1,2,3,14
Iran,2003-06-01,14,0,0,16,24,54
Iran,2003-06-01,19,0,0,40,5,64
Iran,2003-06-01,21,0,0,11,1,33
Iran,2003-06-01,11,0,0,9,4,24
Iran,2003-06-01,15,0,0,0,2,17
Iran,2003-06-01,41,0,0,7,5,53
Iran,2003-06-01,1,0,0,7,3,11
Iran,2003-06-01,44,0,3,28,4,79
Iran,2003-07-01,23,0,1,-6,16,34
Iran,2003-07-01,10,0,0,1,1,12
Iran,2003-07-01,14,0,0,2,1,17
Iran,2003-07-01,10,0,0,7,2,19
Iran,2003-07-01,23,0,1,6,4,34
Iran,2003-07-01,7,0,0,-1,10,16
Iran,2003-07-01,14,0,-2,3,1,16
Iran,2003-07-01,28,0,0,-2,1,27
Iran,2003-07-01,18,0,0,13,0,31
Iran,2003-07-01,29,0,0,6,3,38
Iran,2003-07-01,13,0,0,1,2,16
Iran,2003-07-01,12,0,0,18,7,37
Iran,2003-07-01,40,0,0,-2,0,38
Iran,2003-07-01,6,0,1,0,0,7
Iran,2003-07-01,14,0,0,13,0,27
Iran,2003-07-01,12,0,0,0,0,12
Iran,2003-07-01,13,0,0,6,1,20
Iran,2003-07-01,16,0,0,3,2,21
Iran,2003-07-01,15,0,0,17,0,32
Iran,2003-07-01,2,0,1,3,0,6
Iran,2003-07-01,2,0,0,17,0,19
Iran,2003-07-01,14,0,0,7,3,24
Iran,2003-07-01,29,0,1,6,0,36
Iran,2003-07-01,33,0,0,-3,0,30
Iran,2003-07-01,5,0,0,12,0,17
Iran,2003-07-01,24,0,0,4,5,33
Iran,2003-07-01,11,0,0,17,2,30
Iran,2003-07-01,19,0,-4,-3,5,17
Iran,2003-07-01,23,0,-2,-6,1,16
Iran,2003-07-01,8,0,0,-1,1,8
Iran,2003-07-01,28,0,0,10,1,39
Iran,2003-08-01,6,0,0,9,0,15
Iran,2003-08-01,13,0,0,3,1,17
Iran,2003-08-01,14,0,0,1,0,15
Iran,2003-08-01,20,0,0,5,3,28
Iran,2003-08-01,15,0,0,3,2,20
Iran,2003-08-01,6,0,0,-2,0,4
Iran,2003-08-01,19,0,1,-4,0,16
Iran,2003-08-01,16,0,0,15,0,31
Iran,2003-08-01,20,0,0,-1,5,24
Iran,2003-08-01,17,0,-2,11,2,28
Iran,2003-08-01,12,0,1,18,2,33
Iran,2003-08-01,22,0,0,-4,2,20
Iran,2003-08-01,22,0,0,4,0,26
Iran,2003-08-01,17,0,0,22,2,41
Iran,2003-08-01,0,0,0,-2,2,0
Iran,2003-08-01,5,0,0,6,2,13
Iran,2003-08-01,14,0,0,3,0,17
Iran,2003-08-01,9,0,0,1,0,10
Iran,2003-08-01,4,0,1,-2,0,3
Iran,2003-08-01,18,0,0,6,5,29
Iran,2003-08-01,18,0,0,9,0,27
Iran,2003-08-01,27,0,0,10,0,37
Iran,2003-08-01,25,0,-2,3,2,28
Iran,2003-08-01,19,0,0,29,1,49
Iran,2003-08-01,11,0,0,10,2,23
Iran,2003-08-01,6,0,0,0,0,6
Iran,2003-08-01,9,0,0,8,0,17
Iran,2003-08-01,18,0,0,9,1,28
Iran,2003-08-01,12,0,0,3,0,15
Iran,2003-08-01,6,0,0,6,1,13
Iran,2003-08-01,7,0,0,0,3,10
Iran,2003-09-01,50,0,0,11,6,67
Iran,2003-09-01,30,0,0,-16,0,14
Iran,2003-09-01,36,0,0,4,0,40
Iran,2003-09-01,8,0,0,0,1,9
Iran,2003-09-01,12,0,0,7,0,19
Iran,2003-09-01,7,0,0,3,0,10
Iran,2003-09-01,3,0,0,16,5,24
Iran,2003-09-01,21,0,0,7,0,28
Iran,2003-09-01,14,0,0,13,8,35
Iran,2003-09-01,8,0,0,3,4,15
Iran,2003-09-01,13,0,0,-4,3,12
Iran,2003-09-01,30,0,0,-20,0,10
Iran,2003-09-01,30,0,-2,-8,10,30
Iran,2003-09-01,13,0,1,0,4,18
Iran,2003-09-01,6,0,0,3,2,11
Iran,2003-09-01,22,0,0,3,0,25
Iran,2003-09-01,26,0,0,5,2,33
Iran,2003-09-01,24,0,1,0,0,25
Iran,2003-09-01,3,0,0,-2,2,3
Iran,2003-09-01,10,0,0,-4,1,7
Iran,2003-09-01,6,0,0,6,0,12
Iran,2003-09-01,27,0,-2,-5,1,21
Iran,2003-09-01,13,0,1,0,0,14
Iran,2003-09-01,11,0,0,7,0,18
Iran,2003-09-01,7,0,2,26,5,40
Iran,2003-09-01,28,0,0,12,0,40
Iran,2003-09-01,19,0,0,7,2,28
Iran,2003-09-01,13,0,1,0,0,14
Iran,2003-09-01,5,0,0,7,2,14
Iran,2003-09-01,14,0,0,0,3,17
Iran,2003-10-01,39,0,0,9,3,51
Iran,2003-10-01,4,0,-2,0,3,5
Iran,2003-10-01,7,0,0,3,0,10
Iran,2003-10-01,16,0,-1,-2,0,13
Iran,2003-10-01,8,0,1,-2,0,7
Iran,2003-10-01,38,0,0,3,0,41
Iran,2003-10-01,19,0,0,15,0,34
Iran,2003-10-01,17,0,0,1,10,28
Iran,2003-10-01,15,0,0,4,0,19
Iran,2003-10-01,9,0,0,13,1,23
Iran,2003-10-01,25,0,1,14,1,41
Iran,2003-10-01,21,0,0,12,0,33
Iran,2003-10-01,17,0,2,10,1,30
Iran,2003-10-01,46,0,0,6,3,55
Iran,2003-10-01,39,0,0,-1,1,39
Iran,2003-10-01,5,0,0,-2,2,5
Iran,2003-10-01,20,0,0,0,1,21
Iran,2003-10-01,7,0,-2,3,2,10
Iran,2003-10-01,16,0,0,3,0,19
Iran,2003-10-01,-1,0,0,5,0,4
Iran,2003-10-01,18,0,0,4,0,22
Iran,2003-10-01,6,0,-2,8,0,12
Iran,2003-10-01,11,0,0,13,3,27
Iran,2003-10-01,6,0,0,0,0,6
Iran,2003-10-01,2,0,0,4,0,6
Iran,2003-10-01,8,0,0,3,2,13
Iran,2003-10-01,25,0,0,3,1,29
Iran,2003-10-01,8,0,0,4,3,15
Iran,2003-10-01,17,0,0,15,3,35
Iran,2003-10-01,15,0,0,6,2,23
Iran,2003-10-01,8,0,0,0,0,8
Iran,2003-11-01,14,0,0,3,4,21
Iran,2003-11-01,0,0,1,6,2,9
Iran,2003-11-01,29,0,0,0,0,29
Iran,2003-11-01,6,2,0,-1,0,7
Iran,2003-11-01,21,0,0,7,0,28
Iran,2003-11-01,11,0,0,3,5,19
Iran,2003-11-01,7,0,0,2,3,12
Iran,2003-11-01,16,0,0,-3,4,17
Iran,2003-11-01,26,0,0,16,1,43
Iran,2003-11-01,21,0,0,26,5,52
Iran,2003-11-01,15,0,0,0,1,16
Iran,2003-11-01,12,0,1,0,0,13
Iran,2003-11-01,15,0,1,0,4,20
Iran,2003-11-01,10,0,0,12,1,23
Iran,2003-11-01,45,0,0,1,3,49
Iran,2003-11-01,2,0,0,0,0,2
Iran,2003-11-01,26,0,0,-1,0,25
Iran,2003-11-01,36,0,0,-2,16,50
Iran,2003-11-01,33,0,0,4,1,38
Iran,2003-11-01,27,0,2,3,2,34
Iran,2003-11-01,26,0,-1,6,3,34
Iran,2003-11-01,37,0,-3,-4,3,33
Iran,2003-11-01,19,0,-1,-1,0,17
Iran,2003-11-01,15,0,-4,3,3,17
Iran,2003-11-01,13,0,-2,0,1,12
Iran,2003-11-01,5,0,3,0,0,8
Iran,2003-11-01,7,0,0,0,0,7
Iran,2003-11-01,9,0,1,3,0,13
Iran,2003-11-01,6,0,0,0,1,7
Iran,2003-11-01,7,0,0,1,1,9
Iran,2003-12-01,47,0,0,9,1,57
Iran,2003-12-01,17,0,0,0,0,17
Iran,2003-12-01,13,0,1,6,2,22
Iran,2003-12-01,15,0,1,27,4,47
Iran,2003-12-01,5,0,0,0,2,7
Iran,2003-12-01,5,0,0,0,0,5
Iran,2003-12-01,6,0,1,0,0,7
Iran,2003-12-01,14,0,-2,9,1,22
Iran,2003-12-01,22,0,1,-4,10,29
Iran,2003-12-01,16,0,-1,0,3,18
Iran,2003-12-01,25,0,-1,-1,5,28
Iran,2003-12-01,39,0,3,1,1,44
Iran,2003-12-01,12,0,1,0,0,13
Iran,2003-12-01,20,0,1,18,6,45
Iran,2003-12-01,14,2,1,4,2,23
Iran,2003-12-01,14,0,0,4,0,18
Iran,2003-12-01,26,0,0,5,0,31
Iran,2003-12-01,20,0,0,-6,2,16
Iran,2003-12-01,10,0,0,6,2,18
Iran,2003-12-01,-1,0,1,6,0,6
Iran,2003-12-01,20,0,0,15,0,35
Iran,2003-12-01,17,0,0,18,0,35
Iran,2003-12-01,-13,0,0,6,0,-7
Iran,2003-12-01,15,8,0,1,7,31
Iran,2003-12-01,22,0,-1,-2,0,19
Iran,2003-12-01,20,6,0,1,2,29
Iran,2003-12-01,14,8,0,-4,8,26
Iran,2003-12-01,24,4,0,0,5,33
Iran,2003-12-01,9,8,0,3,5,25
Iran,2003-12-01,7,2,0,0,1,10
Iran,2003-12-01,16,0,0,-1,4,19
Iraq,2003-01-01,46,0,0,19,8,73
Iraq,2003-01-01,53,0,0,9,5,67
Iraq,2003-01-01,52,0,0,9,11,72
Iraq,2003-01-01,53,0,2,26,4,85
Iraq,2003-01-01,64,0,0,3,3,70
Iraq,2003-01-01,119,0,-6,34,8,155
Iraq,2003-01-01,174,0,-4,0,17,187
Iraq,2003-01-01,127,0,-2,15,10,150
Iraq,2003-01-01,190,4,0,17,10,221
Iraq,2003-01-01,133,1,4,11,11,160
Iraq,2003-01-01,73,0,-1,18,9,99
Iraq,2003-01-01,77,0,1,10,21,109
Iraq,2003-01-01,85,0,1,50,16,152
Iraq,2003-01-01,133,2,0,14,16,165
Iraq,2003-01-01,150,0,1,25,11,187
Iraq,2003-01-01,105,0,-1,18,28,150
Iraq,2003-01-01,109,0,0,18,20,147
Iraq,2003-01-01,139,0,1,40,43,223
Iraq,2003-01-01,97,0,2,15,18,132
Iraq,2003-01-01,133,0,2,15,27,177
Iraq,2003-01-01,188,0,6,28,34,256
Iraq,2003-01-01,169,0,-4,25,24,214
Iraq,2003-01-01,218,0,-2,17,16,249
Iraq,2003-01-01,109,0,-6,8,25,136
Iraq,2003-01-01,106,0,5,4,30,145
Iraq,2003-01-01,119,0,0,22,24,165
Iraq,2003-01-01,128,0,2,14,28,172
Iraq,2003-01-01,208,1,8,15,34,266
Iraq,2003-01-01,284,0,-2,22,36,340
Iraq,2003-01-01,209,0,4,-2,38,249
Iraq,2003-01-01,194,6,6,12,23,241
Iraq,2003-02-01,99,0,10,24,16,149
Iraq,2003-02-01,83,0,3,15,14,115
Iraq,2003-02-01,148,0,1,19,9,177
Iraq,2003-02-01,149,2,1,10,18,180
Iraq,2003-02-01,211,6,6,31,14,268
Iraq,2003-02-01,235,0,8,20,41,304
Iraq,2003-02-01,189,0,3,13,33,238
Iraq,2003-02-01,138,0,3,12,23,176
Iraq,2003-02-01,145,0,-1,4,23,171
Iraq,2003-02-01,206,2,-1,22,25,254
Iraq,2003-02-01,213,4,-4,20,36,269
Iraq,2003-02-01,282,2,3,16,24,327
Iraq,2003-02-01,225,6,8,3,25,267
Iraq,2003-02-01,204,0,3,61,41,309
Iraq,2003-02-01,154,8,-10,50,127,329
Iraq,2003-02-01,156,2,-1,16,42,215
Iraq,2003-02-01,208,2,3,10,61,284
Iraq,2003-02-01,244,2,6,11,38,301
Iraq,2003-02-01,259,4,4,3,55,325
Iraq,2003-02-01,171,2,3,26,37,239
Iraq,2003-02-01,181,2,2,68,29,282
Iraq,2003-02-01,153,0,0,20,22,195
Iraq,2003-02-01,182,0,5,15,20,222
Iraq,2003-02-01,192,0,2,21,19,234
Iraq,2003-02-01,223,2,-3,10,29,261
Iraq,2003-02-01,260,8,-4,8,40,312
Iraq,2003-02-01,202,4,-2,10,30,244
Iraq,2003-02-01,205,0,-17,7,28,223
Iraq,2003-03-01,155,0,-7,29,46,223
Iraq,2003-03-01,121,0,-2,26,31,176
Iraq,2003-03-01,205,4,-5,35,26,265
Iraq,2003-03-01,221,4,-2,18,20,261
Iraq,2003-03-01,305,0,-9,48,48,392
Iraq,2003-03-01,261,0,-2,24,24,307
Iraq,2003-03-01,319,4,17,68,38,446
Iraq,2003-03-01,189,0,1,37,43,270
Iraq,2003-03-01,194,0,-21,34,46,253
Iraq,2003-03-01,262,4,-26,38,55,333
Iraq,2003-03-01,265,6,-15,36,25,317
Iraq,2003-03-01,231,8,-1,7,39,284
Iraq,2003-03-01,317,2,-6,7,33,353
Iraq,2003-03-01,325,0,-7,9,56,383
Iraq,2003-03-01,196,0,1,24,58,279
Iraq,2003-03-01,197,4,4,29,47,281
Iraq,2003-03-01,382,8,-17,47,42,462
Iraq,2003-03-01,594,2,-24,104,97,773
Iraq,2003-03-01,648,4,1,35,88,776
Iraq,2003-03-01,1119,20,10,175,196,1520
Iraq,2003-03-01,885,18,5,130,185,1223
Iraq,2003-03-01,538,4,-1,99,94,734
Iraq,2003-03-01,490,0,3,101,70,664
Iraq,2003-03-01,382,2,-5,139,88,606
Iraq,2003-03-01,415,20,0,142,94,671
Iraq,2003-03-01,518,12,-4,78,100,704
Iraq,2003-03-01,332,4,-5,57,74,462
Iraq,2003-03-01,330,24,5,49,85,493
Iraq,2003-03-01,398,6,0,60,85,549
Iraq,2003-03-01,201,2,-1,39,40,281
Iraq,2003-03-01,399,6,-2,44,104,551
Iraq,2003-04-01,398,6,-7,58,98,553
Iraq,2003-04-01,413,0,1,23,52,489
Iraq,2003-04-01,377,10,0,40,54,481
Iraq,2003-04-01,258,18,-1,45,60,380
Iraq,2003-04-01,196,4,2,28,54,284
Iraq,2003-04-01,233,0,6,22,50,311
Iraq,2003-04-01,276,14,2,21,53,366
Iraq,2003-04-01,400,10,6,86,49,551
Iraq,2003-04-01,242,2,-3,55,42,338
Iraq,2003-04-01,256,8,4,42,39,349
Iraq,2003-04-01,277,2,2,47,51,379
Iraq,2003-04-01,159,2,-2,1,60,220
Iraq,2003-04-01,235,0,3,50,32,320
Iraq,2003-04-01,262,0,0,60,38,360
Iraq,2003-04-01,228,1,-1,17,45,290
Iraq,2003-04-01,283,6,-7,9,39,330
Iraq,2003-04-01,155,2,0,31,19,207
Iraq,2003-04-01,128,1,3,26,26,184
Iraq,2003-04-01,129,2,-1,-4,33,159
Iraq,2003-04-01,118,2,0,4,21,145
Iraq,2003-04-01,188,5,-1,37,16,245
Iraq,2003-04-01,108,0,-5,21,20,144
Iraq,2003-04-01,123,2,0,19,31,175
Iraq,2003-04-01,131,2,-2,8,18,157
Iraq,2003-04-01,93,0,0,49,9,151
Iraq,2003-04-01,60,2,2,22,13,99
Iraq,2003-04-01,55,0,-11,33,16,93
Iraq,2003-04-01,76,1,0,-3,21,95
Iraq,2003-04-01,141,4,-4,14,15,170
Iraq,2003-04-01,162,0,-1,23,12,196
Iraq,2003-05-01,99,0,0,16,11,126
Iraq,2003-05-01,111,2,-4,15,3,127
Iraq,2003-05-01,88,0,0,4,8,100
Iraq,2003-05-01,77,0,2,10,0,89
Iraq,2003-05-01,88,0,-3,12,14,111
Iraq,2003-05-01,140,0,-9,0,14,145
Iraq,2003-05-01,102,7,-2,3,15,125
Iraq,2003-05-01,114,2,-5,13,15,139
Iraq,2003-05-01,90,4,-1,17,8,118
Iraq,2003-05-01,103,1,5,9,4,122
Iraq,2003-05-01,55,0,-3,-2,17,67
Iraq,2003-05-01,95,2,-13,15,18,117
Iraq,2003-05-01,64,4,-5,31,5,99
Iraq,2003-05-01,121,1,-11,0,2,113
Iraq,2003-05-01,92,2,1,16,8,119
Iraq,2003-05-01,26,1,0,3,10,40
Iraq,2003-05-01,21,0,-1,21,10,51
Iraq,2003-05-01,78,4,0,-13,14,83
Iraq,2003-05-01,84,2,-4,1,20,103
Iraq,2003-05-01,81,0,0,8,8,97
Iraq,2003-05-01,123,2,0,7,10,142
Iraq,2003-05-01,149,2,1,1,25,178
Iraq,2003-05-01,89,3,-3,45,10,144
Iraq,2003-05-01,52,2,0,21,9,84
Iraq,2003-05-01,54,3,0,7,3,67
Iraq,2003-05-01,43,0,-1,12,9,63
Iraq,2003-05-01,49,0,0,-3,5,51
Iraq,2003-05-01,65,2,-2,15,3,83
Iraq,2003-05-01,85,0,-2,25,7,115
Iraq,2003-05-01,43,0,2,34,9,88
Iraq,2003-05-01,40,0,-3,-3,0,34
Iraq,2003-06-01,59,2,3,12,12,88
Iraq,2003-06-01,55,2,-2,9,15,79
Iraq,2003-06-01,72,0,-3,23,10,102
Iraq,2003-06-01,25,0,-2,11,5,39
Iraq,2003-06-01,131,0,-2,8,13,150
Iraq,2003-06-01,57,0,4,15,2,78
Iraq,2003-06-01,31,0,0,6,2,39
Iraq,2003-06-01,32,0,-6,31,2,59
Iraq,2003-06-01,46,2,0,-4,5,49
Iraq,2003-06-01,46,0,0,-5,10,51
Iraq,2003-06-01,57,6,-2,7,9,77
Iraq,2003-06-01,52,0,-4,19,3,70
Iraq,2003-06-01,55,2,0,7,6,70
Iraq,2003-06-01,32,0,0,-2,6,36
Iraq,2003-06-01,55,0,-4,12,2,65
Iraq,2003-06-01,70,0,-10,34,12,106
Iraq,2003-06-01,76,0,-6,23,7,100
Iraq,2003-06-01,72,0,-2,12,24,106
Iraq,2003-06-01,59,0,-10,9,10,68
Iraq,2003-06-01,51,6,-11,24,12,82
Iraq,2003-06-01,53,0,0,3,9,65
Iraq,2003-06-01,22,0,0,9,6,37
Iraq,2003-06-01,57,2,1,7,9,76
Iraq,2003-06-01,98,0,-8,15,8,113
Iraq,2003-06-01,61,8,0,4,8,81
Iraq,2003-06-01,36,0,-2,13,6,53
Iraq,2003-06-01,65,2,-4,12,17,92
Iraq,2003-06-01,33,0,0,28,5,66
Iraq,2003-06-01,54,0,0,9,12,75
Iraq,2003-06-01,38,4,-7,6,15,56
Iraq,2003-07-01,54,4,-4,7,5,66
Iraq,2003-07-01,51,0,0,-2,12,61
Iraq,2003-07-01,100,2,-2,-13,5,92
Iraq,2003-07-01,67,2,1,13,12,95
Iraq,2003-07-01,35,0,1,15,4,55
Iraq,2003-07-01,62,0,0,18,8,88
Iraq,2003-07-01,83,8,0,6,8,105
Iraq,2003-07-01,85,0,-2,21,14,118
Iraq,2003-07-01,99,4,-4,11,5,115
Iraq,2003-07-01,80,0,0,13,11,104
Iraq,2003-07-01,89,0,0,9,3,101
Iraq,2003-07-01,47,8,-3,-2,17,67
Iraq,2003-07-01,79,2,1,-2,3,83
Iraq,2003-07-01,45,2,-9,-8,9,39
Iraq,2003-07-01,44,8,-1,-7,9,53
Iraq,2003-07-01,79,2,-4,-1,20,96
Iraq,2003-07-01,87,2,-4,15,2,102
Iraq,2003-07-01,117,8,3,22,19,169
Iraq,2003-07-01,81,0,5,39,4,129
Iraq,2003-07-01,90,2,-3,38,8,135
Iraq,2003-07-01,138,0,-6,20,3,155
Iraq,2003-07-01,116,2,-1,10,13,140
Iraq,2003-07-01,133,4,0,17,12,166
Iraq,2003-07-01,65,0,-4,4,6,71
Iraq,2003-07-01,52,0,1,-10,15,58
Iraq,2003-07-01,58,0,0,32,11,101
Iraq,2003-07-01,76,0,0,16,7,99
Iraq,2003-07-01,54,2,-6,8,7,65
Iraq,2003-07-01,56,2,1,-1,8,66
Iraq,2003-07-01,52,2,0,7,13,74
Iraq,2003-07-01,46,2,5,15,4,72
Iraq,2003-08-01,56,0,0,8,14,78
Iraq,2003-08-01,21,0,-4,7,0,24
Iraq,2003-08-01,16,0,-7,-2,3,10
Iraq,2003-08-01,33,0,2,12,5,52
Iraq,2003-08-01,74,0,2,6,5,87
Iraq,2003-08-01,66,2,3,-3,5,73
Iraq,2003-08-01,53,2,-1,22,7,83
Iraq,2003-08-01,57,0,-4,12,3,68
Iraq,2003-08-01,21,0,0,9,11,41
Iraq,2003-08-01,57,0,0,1,5,63
Iraq,2003-08-01,57,2,2,16,10,87
Iraq,2003-08-01,114,0,0,20,16,150
Iraq,2003-08-01,57,0,0,6,5,68
Iraq,2003-08-01,75,2,8,11,5,101
Iraq,2003-08-01,55,0,0,-3,4,56
Iraq,2003-08-01,25,2,-2,-6,6,25
Iraq,2003-08-01,48,0,-1,4,4,55
Iraq,2003-08-01,62,0,0,34,5,101
Iraq,2003-08-01,87,2,-2,18,10,115
Iraq,2003-08-01,70,2,0,-2,7,77
Iraq,2003-08-01,79,4,2,12,5,102
Iraq,2003-08-01,76,2,0,14,13,105
Iraq,2003-08-01,37,0,0,10,3,50
Iraq,2003-08-01,32,0,0,-2,6,36
Iraq,2003-08-01,69,0,-2,-8,3,62
Iraq,2003-08-01,78,0,0,13,7,98
Iraq,2003-08-01,53,0,0,4,6,63
Iraq,2003-08-01,45,0,-4,21,15,77
Iraq,2003-08-01,99,2,-13,10,9,107
Iraq,2003-08-01,38,0,-4,5,8,47
Iraq,2003-08-01,56,0,-1,9,18,82
Iraq,2003-09-01,138,0,-1,44,12,193
Iraq,2003-09-01,76,0,-6,26,13,109
Iraq,2003-09-01,139,0,-3,22,10,168
Iraq,2003-09-01,93,4,-2,6,12,113
Iraq,2003-09-01,131,0,-2,19,19,167
Iraq,2003-09-01,35,2,2,-1,6,44
Iraq,2003-09-01,109,0,0,7,4,120
Iraq,2003-09-01,140,14,-5,17,24,190
Iraq,2003-09-01,129,16,-5,8,10,158
Iraq,2003-09-01,133,0,-1,14,18,164
Iraq,2003-09-01,166,2,-1,7,17,191
Iraq,2003-09-01,108,0,-3,-4,10,111
Iraq,2003-09-01,40,10,3,6,10,69
Iraq,2003-09-01,47,2,0,15,9,73
Iraq,2003-09-01,28,2,-2,0,3,31
Iraq,2003-09-01,96,0,-4,8,9,109
Iraq,2003-09-01,72,2,-6,14,8,90
Iraq,2003-09-01,51,4,-1,17,13,84
Iraq,2003-09-01,80,4,2,0,8,94
Iraq,2003-09-01,65,6,3,0,6,80
Iraq,2003-09-01,36,2,2,-4,1,37
Iraq,2003-09-01,93,2,-2,16,6,115
Iraq,2003-09-01,108,4,-4,16,2,126
Iraq,2003-09-01,90,8,-5,19,13,125
Iraq,2003-09-01,109,0,-6,20,12,135
Iraq,2003-09-01,80,0,-5,2,7,84
Iraq,2003-09-01,63,10,1,-5,16,85
Iraq,2003-09-01,54,0,2,5,16,77
Iraq,2003-09-01,47,0,-1,-4,5,47
Iraq,2003-09-01,82,0,2,1,11,96
Iraq,2003-10-01,45,8,-3,6,13,69
Iraq,2003-10-01,91,8,2,51,7,159
Iraq,2003-10-01,125,2,-4,20,7,150
Iraq,2003-10-01,89,2,0,22,15,128
Iraq,2003-10-01,57,0,-4,3,5,61
Iraq,2003-10-01,54,0,1,-4,6,57
Iraq,2003-10-01,101,0,0,3,8,112
Iraq,2003-10-01,59,2,1,1,8,71
Iraq,2003-10-01,86,0,1,9,4,100
Iraq,2003-10-01,91,2,3,9,5,110
Iraq,2003-10-01,86,2,1,7,6,102
Iraq,2003-10-01,92,2,-2,18,10,120
Iraq,2003-10-01,104,16,-2,-4,10,124
Iraq,2003-10-01,85,2,-3,27,10,121
Iraq,2003-10-01,82,2,-3,11,13,105
Iraq,2003-10-01,100,4,0,-3,22,123
Iraq,2003-10-01,96,0,-3,-3,6,96
Iraq,2003-10-01,53,4,-2,-3,3,55
Iraq,2003-10-01,42,12,0,18,11,83
Iraq,2003-10-01,96,8,1,0,10,115
Iraq,2003-10-01,84,4,-7,-2,5,84
Iraq,2003-10-01,77,6,2,23,7,115
Iraq,2003-10-01,99,14,1,50,11,175
Iraq,2003-10-01,42,10,0,8,4,64
Iraq,2003-10-01,58,6,0,6,26,96
Iraq,2003-10-01,33,6,-2,12,7,56
Iraq,2003-10-01,62,2,0,27,8,99
Iraq,2003-10-01,123,2,2,5,7,139
Iraq,2003-10-01,72,0,1,3,9,85
Iraq,2003-10-01,34,2,0,19,4,59
Iraq,2003-10-01,27,6,1,6,8,48
Iraq,2003-11-01,40,0,1,8,6,55
Iraq,2003-11-01,80,2,0,-1,4,85
Iraq,2003-11-01,81,0,0,16,7,104
Iraq,2003-11-01,160,0,0,18,8,186
Iraq,2003-11-01,21,4,0,4,5,34
Iraq,2003-11-01,46,0,-1,-3,5,47
Iraq,2003-11-01,90,0,1,2,9,102
Iraq,2003-11-01,51,0,0,3,4,58
Iraq,2003-11-01,69,0,0,11,22,102
Iraq,2003-11-01,82,0,-2,38,13,131
Iraq,2003-11-01,58,0,0,-2,8,64
Iraq,2003-11-01,115,2,0,12,19,148
Iraq,2003-11-01,127,4,-3,17,28,173
Iraq,2003-11-01,83,0,-4,5,16,100
Iraq,2003-11-01,81,0,-9,6,14,92
Iraq,2003-11-01,43,0,0,4,18,65
Iraq,2003-11-01,93,0,1,16,20,130
Iraq,2003-11-01,84,0,-11,-3,5,75
Iraq,2003-11-01,137,2,-2,21,19,177
Iraq,2003-11-01,108,0,0,5,9,122
Iraq,2003-11-01,98,2,0,6,24,130
Iraq,2003-11-01,59,0,-2,0,7,64
Iraq,2003-11-01,75,0,0,9,4,88
Iraq,2003-11-01,69,0,-2,11,31,109
Iraq,2003-11-01,49,0,-2,3,5,55
Iraq,2003-11-01,26,0,0,-5,3,24
Iraq,2003-11-01,59,0,-8,23,6,80
Iraq,2003-11-01,55,4,-6,17,18,88
Iraq,2003-11-01,34,0,-4,18,8,56
Iraq,2003-11-01,64,2,0,-4,11,73
Iraq,2003-12-01,136,0,0,29,13,178
Iraq,2003-12-01,125,0,1,17,6,149
Iraq,2003-12-01,50,4,0,15,3,72
Iraq,2003-12-01,91,2,4,49,15,161
Iraq,2003-12-01,52,0,0,5,7,64
Iraq,2003-12-01,50,4,0,8,7,69
Iraq,2003-12-01,37,0,0,12,2,51
Iraq,2003-12-01,75,0,-5,-9,13,74
Iraq,2003-12-01,76,0,-1,48,12,135
Iraq,2003-12-01,58,0,3,17,10,88
Iraq,2003-12-01,93,10,0,45,24,172
Iraq,2003-12-01,73,8,0,24,5,110
Iraq,2003-12-01,49,0,1,21,16,87
Iraq,2003-12-01,74,0,-2,117,8,197
Iraq,2003-12-01,102,2,0,105,6,215
Iraq,2003-12-01,137,2,-2,69,18,224
Iraq,2003-12-01,87,0,-3,47,15,146
Iraq,2003-12-01,108,2,1,55,16,182
Iraq,2003-12-01,56,4,2,24,12,98
Iraq,2003-12-01,68,0,0,35,12,115
Iraq,2003-12-01,66,0,-3,31,1,95
Iraq,2003-12-01,64,0,0,40,10,114
Iraq,2003-12-01,75,0,0,14,8,97
Iraq,2003-12-01,38,2,0,27,3,70
Iraq,2003-12-01,28,4,0,-1,1,32
Iraq,2003-12-01,58,0,0,1,13,72
Iraq,2003-12-01,37,2,0,36,6,81
Iraq,2003-12-01,16,0,-2,1,4,19
Iraq,2003-12-01,27,2,1,4,2,36
Iraq,2003-12-01,37,2,1,7,17,64
Iraq,2003-12-01,52,2,1,7,3,65
Morocco,2003-01-01,2,0,0,0,0,2
Morocco,2003-01-01,0,0,0,0,0,0
Morocco,2003-01-01,0,0,0,6,2,8
Morocco,2003-01-01,6,0,0,0,0,6
Morocco,2003-01-01,0,0,0,0,0,0
Morocco,2003-01-01,0,0,0,0,0,0
Morocco,2003-01-01,10,0,0,3,0,13
Morocco,2003-01-01,2,0,0,8,0,10
Morocco,2003-01-01,2,0,0,6,0,8
Morocco,2003-01-01,0,0,0,0,0,0
Morocco,2003-01-01,0,0,0,0,0,0
Morocco,2003-01-01,4,0,0,0,0,4
Morocco,2003-01-01,0,0,0,6,0,6
Morocco,2003-01-01,2,0,0,0,0,2
Morocco,2003-01-01,6,0,0,18,0,24
Morocco,2003-01-01,0,0,0,2,0,2
Morocco,2003-01-01,4,0,0,0,0,4
Morocco,2003-01-01,-15,0,0,0,0,-15
Morocco,2003-01-01,2,0,0,6,0,8
Morocco,2003-01-01,0,0,0,0,0,0
Morocco,2003-01-01,2,0,0,6,0,8
Morocco,2003-01-01,1,0,0,3,1,5
Morocco,2003-01-01,6,0,0,8,0,14
Morocco,2003-01-01,3,0,0,27,0,30
Morocco,2003-01-01,0,0,0,3,0,3
Morocco,2003-01-01,0,0,0,0,0,0
Morocco,2003-01-01,1,0,0,3,2,6
Morocco,2003-01-01,5,2,0,0,2,9
Morocco,2003-01-01,0,0,0,-2,0,-2
Morocco,2003-01-01,-1,0,0,3,1,3
Morocco,2003-01-01,-3,0,0,9,0,6
Morocco,2003-02-01,11,0,0,4,0,15
Morocco,2003-02-01,0,0,0,0,0,0
Morocco,2003-02-01,3,0,0,0,0,3
Morocco,2003-02-01,6,0,0,9,0,15
Morocco,2003-02-01,9,0,0,12,6,27
Morocco,2003-02-01,2,0,0,0,0,2
Morocco,2003-02-01,0,0,0,0,0,0
Morocco,2003-02-01,0,0,0,-2,0,-2
Morocco,2003-02-01,3,0,0,1,2,6
Morocco,2003-02-01,-1,0,0,-4,0,-5
Morocco,2003-02-01,12,2,0,2,0,16
Morocco,2003-02-01,2,0,0,-4,0,-2
Morocco,2003-02-01,0,0,0,0,0,0
Morocco,2003-02-01,0,0,-2,0,0,-2
Morocco,2003-02-01,0,0,0,0,0,0
Morocco,2003-02-01,3,0,0,0,1,4
Morocco,2003-02-01,1,0,0,6,0,7
Morocco,2003-02-01,22,0,0,33,0,55
Morocco,2003-02-01,-2,0,0,0,2,0
Morocco,2003-02-01,0,0,0,-2,0,-2
Morocco,2003-02-01,0,0,0,9,0,9
Morocco,2003-02-01,3,0,0,0,0,3
Morocco,2003-02-01,0,0,0,0,0,0
Morocco,2003-02-01,5,0,0,0,0,5
Morocco,2003-02-01,0,0,0,-2,0,-2
Morocco,2003-02-01,5,0,0,1,0,6
Morocco,2003-02-01,4,0,0,0,0,4
Morocco,2003-03-01,0,0,0,3,0,3
Morocco,2003-03-01,0,0,0,0,0,0
Morocco,2003-03-01,0,0,0,0,0,0
Morocco,2003-03-01,14,0,0,0,1,15
Morocco,2003-03-01,-2,0,0,-3,0,-5
Morocco,2003-03-01,5,0,0,3,0,8
Morocco,2003-03-01,8,0,0,0,0,8
Morocco,2003-03-01,2,0,0,3,0,5
Morocco,2003-03-01,2,0,0,3,1,6
Morocco,2003-03-01,0,0,0,-9,0,-9
Morocco,2003-03-01,15,0,0,0,0,15
Morocco,2003-03-01,0,0,0,6,0,6
Morocco,2003-03-01,-1,0,0,0,0,-1
Morocco,2003-03-01,2,0,0,21,1,24
Morocco,2003-03-01,0,0,0,6,0,6
Morocco,2003-03-01,0,0,0,15,0,15
Morocco,2003-03-01,2,0,0,6,0,8
Morocco,2003-03-01,2,0,0,7,0,9
Morocco,2003-03-01,0,0,0,9,0,9
Morocco,2003-03-01,1,0,0,0,0,1
Morocco,2003-03-01,0,0,0,0,2,2
Morocco,2003-03-01,0,0,0,3,0,3
Morocco,2003-03-01,0,0,0,3,0,3
Morocco,2003-03-01,3,0,0,0,0,3
Morocco,2003-03-01,4,0,0,-4,0,0
Morocco,2003-03-01,4,0,0,0,0,4
Morocco,2003-03-01,0,0,0,0,0,0
Morocco,2003-03-01,0,0,0,3,0,3
Morocco,2003-03-01,0,0,0,0,4,4
Morocco,2003-03-01,0,0,0,6,0,6
Morocco,2003-04-01,3,0,1,9,0,13
Morocco,2003-04-01,0,0,0,5,0,5
Morocco,2003-04-01,0,0,0,0,0,0
Morocco,2003-04-01,2,0,0,0,0,2
Morocco,2003-04-01,0,0,0,2,4,6
Morocco,2003-04-01,0,0,0,0,0,0
Morocco,2003-04-01,0,0,0,0,0,0
Morocco,2003-04-01,0,0,0,3,0,3
Morocco,2003-04-01,0,0,0,-4,0,-4
Morocco,2003-04-01,4,0,0,0,0,4
Morocco,2003-04-01,0,0,-1,0,0,-1
Morocco,2003-04-01,-1,0,0,0,0,-1
Morocco,2003-04-01,0,0,0,0,3,3
Morocco,2003-04-01,0,0,0,0,0,0
Morocco,2003-04-01,0,0,0,0,0,0
Morocco,2003-04-01,-1,0,0,6,2,7
Morocco,2003-04-01,1,0,0,0,0,1
Morocco,2003-04-01,6,0,0,6,0,12
Morocco,2003-04-01,6,0,0,3,2,11
Morocco,2003-04-01,0,0,0,0,0,0
Morocco,2003-04-01,0,0,0,6,0,6
Morocco,2003-04-01,0,0,0,3,4,7
Morocco,2003-04-01,0,0,0,0,0,0
Morocco,2003-04-01,0,0,0,0,0,0
Morocco,2003-04-01,0,0,0,0,0,0
Morocco,2003-04-01,0,0,0,0,0,0
Morocco,2003-05-01,0,0,0,0,1,1
Morocco,2003-05-01,6,0,0,3,1,10
Morocco,2003-05-01,7,0,0,0,0,7
Morocco,2003-05-01,2,0,0,16,0,18
Morocco,2003-05-01,0,0,0,0,0,0
Morocco,2003-05-01,-1,0,0,0,0,-1
Morocco,2003-05-01,-1,0,0,-1,0,-2
Morocco,2003-05-01,15,0,0,4,0,19
Morocco,2003-05-01,0,0,0,6,0,6
Morocco,2003-05-01,0,0,0,3,0,3
Morocco,2003-05-01,1,0,0,9,0,10
Morocco,2003-05-01,5,0,0,-4,0,1
Morocco,2003-05-01,0,0,0,-2,0,-2
Morocco,2003-05-01,10,0,0,0,0,10
Morocco,2003-05-01,6,0,0,3,0,9
Morocco,2003-05-01,6,0,0,3,3,12
Morocco,2003-05-01,13,0,0,3,9,25
Morocco,2003-05-01,9,0,0,24,6,39
Morocco,2003-05-01,9,0,2,3,1,15
Morocco,2003-05-01,21,0,0,24,3,48
Morocco,2003-05-01,2,0,0,21,1,24
Morocco,2003-05-01,4,0,0,6,0,10
Morocco,2003-05-01,3,0,0,0,0,3
Morocco,2003-05-01,3,0,0,6,0,9
Morocco,2003-05-01,0,0,0,0,0,0
Morocco,2003-05-01,12,0,0,0,0,12
Morocco,2003-05-01,-2,0,0,0,0,-2
Morocco,2003-05-01,1,0,0,0,0,1
Morocco,2003-05-01,12,0,0,0,0,12
Morocco,2003-05-01,23,0,0,5,0,28
Morocco,2003-06-01,0,0,0,0,0,0
Morocco,2003-06-01,3,0,0,3,0,6
Morocco,2003-06-01,3,0,0,10,0,13
Morocco,2003-06-01,1,0,0,0,0,1
Morocco,2003-06-01,-4,0,0,27,1,24
Morocco,2003-06-01,6,0,0,39,1,46
Morocco,2003-06-01,9,0,0,15,0,24
Morocco,2003-06-01,3,0,0,0,0,3
Morocco,2003-06-01,6,0,0,6,0,12
Morocco,2003-06-01,0,0,0,0,0,0
Morocco,2003-06-01,0,0,0,0,0,0
Morocco,2003-06-01,0,0,3,3,0,6
Morocco,2003-06-01,0,0,0,0,0,0
Morocco,2003-06-01,0,0,0,0,0,0
Morocco,2003-06-01,4,0,0,0,0,4
Morocco,2003-06-01,6,0,0,-4,1,3
Morocco,2003-06-01,1,0,0,3,0,4
Morocco,2003-06-01,0,0,0,0,0,0
Morocco,2003-06-01,-1,0,0,3,0,2
Morocco,2003-06-01,45,0,0,21,1,67
Morocco,2003-06-01,0,0,0,0,0,0
Morocco,2003-06-01,0,0,0,0,0,0
Morocco,2003-06-01,0,0,0,6,1,7
Morocco,2003-06-01,37,0,0,6,0,43
Morocco,2003-06-01,1,0,0,-3,0,-2
Morocco,2003-06-01,-1,0,0,0,0,-1
Morocco,2003-06-01,0,0,0,9,0,9
Morocco,2003-06-01,0,0,0,0,0,0
Morocco,2003-06-01,0,0,0,1,0,1
Morocco,2003-06-01,1,0,0,3,0,4
Morocco,2003-07-01,2,0,0,6,0,8
Morocco,2003-07-01,7,0,0,18,0,25
Morocco,2003-07-01,0,0,0,0,0,0
Morocco,2003-07-01,1,0,0,0,0,1
Morocco,2003-07-01,0,0,0,0,0,0
Morocco,2003-07-01,0,0,0,3,0,3
Morocco,2003-07-01,0,0,0,0,0,0
Morocco,2003-07-01,0,0,0,2,0,2
Morocco,2003-07-01,1,0,0,0,0,1
Morocco,2003-07-01,0,0,0,2,0,2
Morocco,2003-07-01,6,0,0,6,0,12
Morocco,2003-07-01,3,0,1,0,0,4
Morocco,2003-07-01,0,0,0,0,0,0
Morocco,2003-07-01,5,0,0,0,0,5
Morocco,2003-07-01,1,0,0,0,0,1
Morocco,2003-07-01,2,0,-1,6,0,7
Morocco,2003-07-01,6,0,0,0,0,6
Morocco,2003-07-01,6,0,0,0,0,6
Morocco,2003-07-01,0,0,0,0,0,0
Morocco,2003-07-01,0,0,0,0,0,0
Morocco,2003-07-01,4,0,0,0,0,4
Morocco,2003-07-01,-3,0,0,3,0,0
Morocco,2003-07-01,2,0,0,3,0,5
Morocco,2003-07-01,1,0,0,9,0,10
Morocco,2003-07-01,8,0,0,0,0,8
Morocco,2003-07-01,0,0,0,0,0,0
Morocco,2003-07-01,-2,0,0,0,0,-2
Morocco,2003-07-01,11,0,0,-2,0,9
Morocco,2003-07-01,10,0,0,0,2,12
Morocco,2003-07-01,6,0,0,0,0,6
Morocco,2003-08-01,-1,0,0,15,0,14
Morocco,2003-08-01,3,0,0,3,0,6
Morocco,2003-08-01,5,0,0,0,0,5
Morocco,2003-08-01,21,0,0,3,0,24
Morocco,2003-08-01,2,0,0,0,0,2
Morocco,2003-08-01,3,0,0,15,1,19
Morocco,2003-08-01,1,0,0,6,0,7
Morocco,2003-08-01,0,0,0,0,3,3
Morocco,2003-08-01,1,0,0,0,0,1
Morocco,2003-08-01,1,0,0,0,1,2
Morocco,2003-08-01,4,0,0,6,0,10
Morocco,2003-08-01,3,0,0,6,0,9
Morocco,2003-08-01,4,0,0,6,0,10
Morocco,2003-08-01,8,0,0,12,1,21
Morocco,2003-08-01,1,0,0,-14,0,-13
Morocco,2003-08-01,4,0,0,-3,0,1
Morocco,2003-08-01,-2,0,0,-2,0,-4
Morocco,2003-08-01,0,0,0,0,0,0
Morocco,2003-08-01,0,0,0,0,0,0
Morocco,2003-08-01,0,0,0,3,0,3
Morocco,2003-08-01,0,0,0,0,0,0
Morocco,2003-08-01,6,0,0,3,0,9
Morocco,2003-08-01,0,0,0,0,0,0
Morocco,2003-08-01,4,0,0,0,0,4
Morocco,2003-08-01,6,0,0,-2,0,4
Morocco,2003-08-01,1,0,0,9,0,10
Morocco,2003-08-01,3,0,0,3,0,6
Morocco,2003-08-01,1,0,0,0,3,4
Morocco,2003-08-01,4,0,0,9,1,14
Morocco,2003-09-01,11,0,0,-20,0,-9
Morocco,2003-09-01,8,0,0,-2,0,6
Morocco,2003-09-01,3,0,0,0,0,3
Morocco,2003-09-01,4,0,2,6,0,12
Morocco,2003-09-01,0,0,0,0,0,0
Morocco,2003-09-01,-3,0,0,7,0,4
Morocco,2003-09-01,3,0,0,3,0,6
Morocco,2003-09-01,0,0,0,-4,0,-4
Morocco,2003-09-01,4,0,0,6,0,10
Morocco,2003-09-01,13,0,0,6,1,20
Morocco,2003-09-01,2,0,0,0,0,2
Morocco,2003-09-01,6,0,0,0,0,6
Morocco,2003-09-01,1,0,0,3,1,5
Morocco,2003-09-01,0,0,0,0,0,0
Morocco,2003-09-01,0,0,0,0,0,0
Morocco,2003-09-01,0,0,0,3,0,3
Morocco,2003-09-01,3,0,0,0,0,3
Morocco,2003-09-01,2,0,0,12,0,14
Morocco,2003-09-01,0,0,0,0,0,0
Morocco,2003-09-01,2,0,0,6,0,8
Morocco,2003-09-01,0,0,0,0,0,0
Morocco,2003-09-01,0,0,0,0,0,0
Morocco,2003-09-01,5,0,0,6,5,16
Morocco,2003-09-01,0,0,0,0,0,0
Morocco,2003-09-01,4,0,-4,9,0,9
Morocco,2003-09-01,1,0,0,9,0,10
Morocco,2003-09-01,3,0,0,0,0,3
Morocco,2003-09-01,0,0,0,0,0,0
Morocco,2003-09-01,2,0,0,0,0,2
Morocco,2003-09-01,1,0,0,0,0,1
Morocco,2003-10-01,6,0,0,15,0,21
Morocco,2003-10-01,-6,0,0,0,0,-6
Morocco,2003-10-01,-6,0,0,0,1,-5
Morocco,2003-10-01,2,0,0,0,0,2
Morocco,2003-10-01,0,0,0,0,0,0
Morocco,2003-10-01,0,0,0,3,0,3
Morocco,2003-10-01,5,0,0,0,0,5
Morocco,2003-10-01,2,0,0,9,2,13
Morocco,2003-10-01,0,0,0,10,3,13
Morocco,2003-10-01,4,0,0,9,0,13
Morocco,2003-10-01,0,0,0,3,0,3
Morocco,2003-10-01,-1,0,0,0,0,-1
Morocco,2003-10-01,3,0,0,0,0,3
Morocco,2003-10-01,-4,0,0,12,0,8
Morocco,2003-10-01,0,0,0,0,0,0
Morocco,2003-10-01,3,0,0,6,0,9
Morocco,2003-10-01,0,0,0,6,1,7
Morocco,2003-10-01,1,0,0,3,0,4
Morocco,2003-10-01,7,0,0,6,1,14
Morocco,2003-10-01,-2,0,0,0,0,-2
Morocco,2003-10-01,3,0,0,0,0,3
Morocco,2003-10-01,4,0,0,6,1,11
Morocco,2003-10-01,5,0,0,9,0,14
Morocco,2003-10-01,3,0,0,0,0,3
Morocco,2003-10-01,4,0,0,0,0,4
Morocco,2003-10-01,10,0,0,1,1,12
Morocco,2003-10-01,2,0,0,3,2,7
Morocco,2003-10-01,15,0,0,15,0,30
Morocco,2003-10-01,0,0,0,0,0,0
Morocco,2003-10-01,4,0,0,3,0,7
Morocco,2003-11-01,0,0,0,0,0,0
Morocco,2003-11-01,2,0,0,0,0,2
Morocco,2003-11-01,9,0,0,20,0,29
Morocco,2003-11-01,0,0,0,18,0,18
Morocco,2003-11-01,2,0,0,12,1,15
Morocco,2003-11-01,18,0,0,9,0,27
Morocco,2003-11-01,5,0,0,-6,0,-1
Morocco,2003-11-01,3,0,0,9,0,12
Morocco,2003-11-01,-2,0,0,3,0,1
Morocco,2003-11-01,3,0,0,5,0,8
Morocco,2003-11-01,1,0,0,4,0,5
Morocco,2003-11-01,0,0,0,6,1,7
Morocco,2003-11-01,2,0,0,-5,0,-3
Morocco,2003-11-01,6,0,0,6,0,12
Morocco,2003-11-01,24,0,0,0,0,24
Morocco,2003-11-01,1,0,0,-3,0,-2
Morocco,2003-11-01,0,0,0,0,0,0
Morocco,2003-11-01,3,0,0,0,0,3
Morocco,2003-11-01,7,0,0,9,0,16
Morocco,2003-11-01,11,0,0,6,0,17
Morocco,2003-11-01,15,0,0,1,0,16
Morocco,2003-11-01,1,0,0,6,0,7
Morocco,2003-11-01,2,0,0,0,0,2
Morocco,2003-11-01,0,0,0,6,0,6
Morocco,2003-11-01,4,0,0,9,0,13
Morocco,2003-11-01,3,0,0,8,3,14
Morocco,2003-11-01,2,0,0,3,0,5
Morocco,2003-11-01,0,0,0,3,0,3
Morocco,2003-11-01,0,0,0,0,0,0
Morocco,2003-12-01,4,0,0,3,0,7
Morocco,2003-12-01,0,0,0,6,0,6
Morocco,2003-12-01,8,0,0,0,0,8
Morocco,2003-12-01,3,0,0,3,0,6
Morocco,2003-12-01,2,0,0,3,1,6
Morocco,2003-12-01,5,0,0,-1,2,6
Morocco,2003-12-01,0,0,0,3,0,3
Morocco,2003-12-01,0,0,0,-2,0,-2
Morocco,2003-12-01,4,0,0,7,0,11
Morocco,2003-12-01,0,0,0,3,0,3
Morocco,2003-12-01,-1,0,0,4,0,3
Morocco,2003-12-01,2,0,0,9,0,11
Morocco,2003-12-01,2,0,0,3,0,5
Morocco,2003-12-01,1,0,0,0,0,1
Morocco,2003-12-01,-2,0,0,-2,0,-4
Morocco,2003-12-01,2,0,0,-3,0,-1
Morocco,2003-12-01,19,0,0,15,0,34
Morocco,2003-12-01,-1,0,0,3,0,2
Morocco,2003-12-01,13,0,0,6,0,19
Morocco,2003-12-01,6,0,2,11,0,19
Morocco,2003-12-01,3,0,-1,0,0,2
Morocco,2003-12-01,4,0,0,-4,0,0
Morocco,2003-12-01,2,0,0,-6,0,-4
Morocco,2003-12-01,1,0,0,-2,0,-1
Morocco,2003-12-01,-3,0,0,0,0,-3
Morocco,2003-12-01,1,0,0,0,0,1
Morocco,2003-12-01,0,0,0,0,0,0
Morocco,2003-12-01,0,0,0,0,0,0
Morocco,2003-12-01,0,0,0,9,0,9
Nigeria,2003-01-01,-1,0,3,9,0,11
Nigeria,2003-01-01,4,0,0,0,0,4
Nigeria,2003-01-01,5,0,0,0,0,5
Nigeria,2003-01-01,0,0,0,0,0,0
Nigeria,2003-01-01,11,0,0,0,6,17
Nigeria,2003-01-01,6,0,0,3,3,12
Nigeria,2003-01-01,11,0,3,0,1,15
Nigeria,2003-01-01,12,0,0,0,0,12
Nigeria,2003-01-01,1,0,0,7,2,10
Nigeria,2003-01-01,5,0,-2,3,0,6
Nigeria,2003-01-01,0,0,0,0,2,2
Nigeria,2003-01-01,2,0,0,-2,1,1
Nigeria,2003-01-01,7,0,0,0,0,7
Nigeria,2003-01-01,21,0,0,9,1,31
Nigeria,2003-01-01,13,0,1,0,2,16
Nigeria,2003-01-01,15,0,-2,7,0,20
Nigeria,2003-01-01,6,0,0,3,2,11
Nigeria,2003-01-01,5,0,-2,-4,0,-1
Nigeria,2003-01-01,4,0,0,3,0,7
Nigeria,2003-01-01,20,4,0,12,0,36
Nigeria,2003-01-01,23,0,-2,13,1,35
Nigeria,2003-01-01,20,0,-2,22,3,43
Nigeria,2003-01-01,15,0,0,6,0,21
Nigeria,2003-01-01,19,0,0,6,0,25
Nigeria,2003-01-01,-1,0,1,1,0,1
Nigeria,2003-01-01,8,0,0,0,1,9
Nigeria,2003-01-01,9,0,0,0,1,10
Nigeria,2003-01-01,4,0,-4,9,2,11
Nigeria,2003-01-01,9,0,0,0,2,11
Nigeria,2003-01-01,15,0,0,3,0,18
Nigeria,2003-01-01,13,2,0,20,0,35
Nigeria,2003-02-01,3,0,0,0,2,5
Nigeria,2003-02-01,1,0,0,3,0,4
Nigeria,2003-02-01,17,0,0,0,1,18
Nigeria,2003-02-01,14,0,0,12,3,29
Nigeria,2003-02-01,17,0,1,15,1,34
Nigeria,2003-02-01,6,0,1,7,3,17
Nigeria,2003-02-01,1,0,0,-2,2,1
Nigeria,2003-02-01,13,0,0,1,0,14
Nigeria,2003-02-01,4,0,0,0,0,4
Nigeria,2003-02-01,13,0,0,0,0,13
Nigeria,2003-02-01,10,0,-2,3,2,13
Nigeria,2003-02-01,12,0,1,6,3,22
Nigeria,2003-02-01,11,0,0,3,0,14
Nigeria,2003-02-01,9,0,0,3,1,13
Nigeria,2003-02-01,0,0,0,4,1,5
Nigeria,2003-02-01,2,0,0,-4,1,-1
Nigeria,2003-02-01,2,0,0,12,0,14
Nigeria,2003-02-01,16,0,0,3,4,23
Nigeria,2003-02-01,19,0,0,0,4,23
Nigeria,2003-02-01,14,0,0,16,6,36
Nigeria,2003-02-01,20,0,0,12,2,34
Nigeria,2003-02-01,13,0,-1,3,0,15
Nigeria,2003-02-01,2,0,0,0,1,3
Nigeria,2003-02-01,20,0,0,12,0,32
Nigeria,2003-02-01,12,0,-2,9,1,20
Nigeria,2003-02-01,5,0,0,0,0,5
Nigeria,2003-02-01,10,0,0,6,2,18
Nigeria,2003-02-01,-3,0,0,0,4,1
Nigeria,2003-03-01,2,0,0,3,0,5
Nigeria,2003-03-01,3,0,0,0,0,3
Nigeria,2003-03-01,29,0,1,6,0,36
Nigeria,2003-03-01,5,0,0,2,2,9
Nigeria,2003-03-01,16,0,2,6,6,30
Nigeria,2003-03-01,16,0,0,21,0,37
Nigeria,2003-03-01,1,0,1,6,3,11
Nigeria,2003-03-01,6,0,-2,5,2,11
Nigeria,2003-03-01,10,0,0,0,0,10
Nigeria,2003-03-01,17,0,0,1,-2,16
Nigeria,2003-03-01,14,0,0,12,3,29
Nigeria,2003-03-01,11,0,-1,0,2,12
Nigeria,2003-03-01,9,0,0,25,3,37
Nigeria,2003-03-01,11,0,0,3,0,14
Nigeria,2003-03-01,13,0,-2,4,0,15
Nigeria,2003-03-01,4,2,-4,0,3,5
Nigeria,2003-03-01,9,0,0,0,0,9
Nigeria,2003-03-01,4,0,0,3,0,7
Nigeria,2003-03-01,19,0,0,-4,6,21
Nigeria,2003-03-01,5,0,0,0,1,6
Nigeria,2003-03-01,4,0,0,1,4,9
Nigeria,2003-03-01,4,0,0,3,1,8
Nigeria,2003-03-01,2,0,0,0,0,2
Nigeria,2003-03-01,19,0,0,-2,0,17
Nigeria,2003-03-01,6,0,0,0,1,7
Nigeria,2003-03-01,11,0,0,0,0,11
Nigeria,2003-03-01,19,0,0,3,0,22
Nigeria,2003-03-01,6,0,0,7,0,13
Nigeria,2003-03-01,6,0,0,0,0,6
Nigeria,2003-03-01,3,0,0,0,0,3
Nigeria,2003-03-01,11,0,0,9,-3,17
Nigeria,2003-04-01,0,0,0,9,0,9
Nigeria,2003-04-01,1,0,1,3,0,5
Nigeria,2003-04-01,6,0,0,3,0,9
Nigeria,2003-04-01,2,0,0,9,2,13
Nigeria,2003-04-01,6,0,0,0,0,6
Nigeria,2003-04-01,6,0,0,9,0,15
Nigeria,2003-04-01,9,0,0,3,0,12
Nigeria,2003-04-01,12,0,0,0,0,12
Nigeria,2003-04-01,7,0,-4,3,1,7
Nigeria,2003-04-01,6,0,0,-2,1,5
Nigeria,2003-04-01,7,0,1,3,4,15
Nigeria,2003-04-01,6,0,0,6,1,13
Nigeria,2003-04-01,4,0,0,-4,0,0
Nigeria,2003-04-01,4,0,0,9,2,15
Nigeria,2003-04-01,13,0,2,0,1,16
Nigeria,2003-04-01,20,0,0,-1,1,20
Nigeria,2003-04-01,10,0,-2,1,1,10
Nigeria,2003-04-01,2,0,0,0,0,2
Nigeria,2003-04-01,4,0,0,0,0,4
Nigeria,2003-04-01,-1,0,0,9,0,8
Nigeria,2003-04-01,14,0,0,7,2,23
Nigeria,2003-04-01,8,0,0,6,0,14
Nigeria,2003-04-01,18,0,0,3,1,22
Nigeria,2003-04-01,7,0,-2,9,3,17
Nigeria,2003-04-01,1,0,0,0,0,1
Nigeria,2003-04-01,10,0,-2,1,6,15
Nigeria,2003-04-01,0,0,1,3,-2,2
Nigeria,2003-04-01,13,0,0,0,3,16
Nigeria,2003-04-01,15,0,0,3,1,19
Nigeria,2003-04-01,10,0,0,4,6,20
Nigeria,2003-05-01,8,0,0,-4,0,4
Nigeria,2003-05-01,12,0,1,-4,0,9
Nigeria,2003-05-01,8,0,0,0,0,8
Nigeria,2003-05-01,4,0,0,0,0,4
Nigeria,2003-05-01,10,0,-2,3,0,11
Nigeria,2003-05-01,22,0,-4,3,-2,19
Nigeria,2003-05-01,29,0,-2,1,3,31
Nigeria,2003-05-01,24,0,1,7,1,33
Nigeria,2003-05-01,18,0,0,-1,0,17
Nigeria,2003-05-01,6,0,0,0,0,6
Nigeria,2003-05-01,1,0,0,3,1,5
Nigeria,2003-05-01,16,0,2,3,0,21
Nigeria,2003-05-01,12,0,0,6,-2,16
Nigeria,2003-05-01,11,0,0,0,0,11
Nigeria,2003-05-01,14,0,1,0,0,15
Nigeria,2003-05-01,20,0,2,-2,3,23
Nigeria,2003-05-01,4,0,2,3,0,9
Nigeria,2003-05-01,12,0,1,3,0,16
Nigeria,2003-05-01,7,0,1,0,2,10
Nigeria,2003-05-01,8,0,2,6,3,19
Nigeria,2003-05-01,16,0,0,8,2,26
Nigeria,2003-05-01,5,0,0,9,3,17
Nigeria,2003-05-01,-3,0,0,8,2,7
Nigeria,2003-05-01,5,0,1,0,0,6
Nigeria,2003-05-01,21,0,0,0,2,23
Nigeria,2003-05-01,9,0,0,9,0,18
Nigeria,2003-05-01,31,0,1,7,0,39
Nigeria,2003-05-01,13,0,0,43,1,57
Nigeria,2003-05-01,2,0,-1,1,5,7
Nigeria,2003-05-01,4,0,0,3,3,10
Nigeria,2003-05-01,6,0,0,9,0,15
Nigeria,2003-06-01,-2,0,0,-2,3,-1
Nigeria,2003-06-01,39,0,-1,-6,8,40
Nigeria,2003-06-01,27,0,1,-2,0,26
Nigeria,2003-06-01,12,0,1,6,0,19
Nigeria,2003-06-01,18,0,-2,9,0,25
Nigeria,2003-06-01,16,0,0,6,0,22
Nigeria,2003-06-01,3,0,-2,0,1,2
Nigeria,2003-06-01,7,0,0,-2,1,6
Nigeria,2003-06-01,4,0,-1,3,0,6
Nigeria,2003-06-01,15,0,1,-6,0,10
Nigeria,2003-06-01,6,0,2,9,0,17
Nigeria,2003-06-01,0,0,2,7,0,9
Nigeria,2003-06-01,3,0,0,4,0,7
Nigeria,2003-06-01,0,0,0,0,0,0
Nigeria,2003-06-01,8,0,0,0,0,8
Nigeria,2003-06-01,19,0,0,2,5,26
Nigeria,2003-06-01,14,0,-4,6,1,17
Nigeria,2003-06-01,1,2,0,0,1,4
Nigeria,2003-06-01,33,0,0,9,5,47
Nigeria,2003-06-01,20,0,-3,2,0,19
Nigeria,2003-06-01,0,0,0,0,0,0
Nigeria,2003-06-01,4,0,0,0,1,5
Nigeria,2003-06-01,10,0,-2,3,2,13
Nigeria,2003-06-01,21,0,0,0,9,30
Nigeria,2003-06-01,15,0,0,-2,3,16
Nigeria,2003-06-01,12,0,1,1,1,15
Nigeria,2003-06-01,5,0,0,3,5,13
Nigeria,2003-06-01,3,0,-6,0,0,-3
Nigeria,2003-06-01,1,0,0,0,1,2
Nigeria,2003-06-01,4,0,0,2,1,7
Nigeria,2003-07-01,17,0,0,1,6,24
Nigeria,2003-07-01,13,0,1,9,0,23
Nigeria,2003-07-01,9,4,0,1,1,15
Nigeria,2003-07-01,14,0,-2,1,1,14
Nigeria,2003-07-01,14,0,-2,0,2,14
Nigeria,2003-07-01,9,0,-4,6,3,14
Nigeria,2003-07-01,10,0,0,10,1,21
Nigeria,2003-07-01,14,0,-8,1,2,9
Nigeria,2003-07-01,13,0,1,9,1,24
Nigeria,2003-07-01,11,0,0,3,0,14
Nigeria,2003-07-01,8,0,0,1,2,11
Nigeria,2003-07-01,7,0,-2,3,1,9
Nigeria,2003-07-01,9,0,0,0,1,10
Nigeria,2003-07-01,20,0,1,-4,2,19
Nigeria,2003-07-01,18,0,0,-18,0,0
Nigeria,2003-07-01,4,0,-2,-8,5,-1
Nigeria,2003-07-01,3,0,0,1,0,4
Nigeria,2003-07-01,43,2,0,5,3,53
Nigeria,2003-07-01,11,0,0,-2,0,9
Nigeria,2003-07-01,11,0,-3,-2,0,6
Nigeria,2003-07-01,21,0,-2,-1,5,23
Nigeria,2003-07-01,44,0,-2,-2,3,43
Nigeria,2003-07-01,20,0,0,21,2,43
Nigeria,2003-07-01,19,2,0,-6,3,18
Nigeria,2003-07-01,14,0,-2,12,1,25
Nigeria,2003-07-01,4,0,0,1,0,5
Nigeria,2003-07-01,6,0,0,0,0,6
Nigeria,2003-07-01,29,0,-4,-4,2,23
Nigeria,2003-07-01,18,2,0,12,4,36
Nigeria,2003-07-01,30,0,-2,12,3,43
Nigeria,2003-07-01,56,0,-6,0,5,55
Nigeria,2003-08-01,24,0,-1,4,4,31
Nigeria,2003-08-01,17,0,-6,6,4,21
Nigeria,2003-08-01,19,0,-2,6,1,24
Nigeria,2003-08-01,23,0,-14,8,2,19
Nigeria,2003-08-01,21,0,-14,-10,1,-2
Nigeria,2003-08-01,15,2,-7,-4,0,6
Nigeria,2003-08-01,29,0,4,-1,4,36
Nigeria,2003-08-01,22,0,-1,1,4,26
Nigeria,2003-08-01,8,0,0,12,6,26
Nigeria,2003-08-01,15,0,-2,-2,1,12
Nigeria,2003-08-01,28,0,-10,3,2,23
Nigeria,2003-08-01,9,0,-1,5,2,15
Nigeria,2003-08-01,25,0,0,-2,1,24
Nigeria,2003-08-01,20,0,0,38,5,63
Nigeria,2003-08-01,28,0,1,16,4,49
Nigeria,2003-08-01,12,0,0,6,0,18
Nigeria,2003-08-01,25,0,0,5,2,32
Nigeria,2003-08-01,23,2,-2,9,7,39
Nigeria,2003-08-01,27,0,0,-2,1,26
Nigeria,2003-08-01,22,0,0,-1,1,22
Nigeria,2003-08-01,11,0,0,-2,1,10
Nigeria,2003-08-01,13,0,0,-2,0,11
Nigeria,2003-08-01,3,0,0,0,0,3
Nigeria,2003-08-01,1,0,0,3,0,4
Nigeria,2003-08-01,18,0,0,9,2,29
Nigeria,2003-08-01,20,0,0,-1,2,21
Nigeria,2003-08-01,21,0,-4,12,0,29
Nigeria,2003-08-01,16,0,0,4,0,20
Nigeria,2003-08-01,12,0,0,3,5,20
Nigeria,2003-08-01,8,0,0,1,0,9
Nigeria,2003-08-01,4,0,0,0,1,5
Nigeria,2003-09-01,19,0,0,0,1,20
Nigeria,2003-09-01,10,2,0,-2,2,12
Nigeria,2003-09-01,10,0,0,0,4,14
Nigeria,2003-09-01,22,0,0,-2,5,25
Nigeria,2003-09-01,2,0,1,-2,0,1
Nigeria,2003-09-01,2,0,1,0,0,3
Nigeria,2003-09-01,2,0,0,3,0,5
Nigeria,2003-09-01,19,0,0,6,2,27
Nigeria,2003-09-01,-2,0,0,9,0,7
Nigeria,2003-09-01,21,0,0,29,2,52
Nigeria,2003-09-01,9,0,-10,1,0,0
Nigeria,2003-09-01,11,0,-4,2,8,17
Nigeria,2003-09-01,5,0,0,0,5,10
Nigeria,2003-09-01,6,0,0,0,0,6
Nigeria,2003-09-01,21,0,-2,3,0,22
Nigeria,2003-09-01,5,0,0,-2,1,4
Nigeria,2003-09-01,9,0,0,6,1,16
Nigeria,2003-09-01,17,0,0,9,3,29
Nigeria,2003-09-01,-1,0,0,5,1,5
Nigeria,2003-09-01,-1,0,0,0,3,2
Nigeria,2003-09-01,11,0,0,0,0,11
Nigeria,2003-09-01,10,0,1,20,1,32
Nigeria,2003-09-01,17,0,0,-5,8,20
Nigeria,2003-09-01,15,0,0,5,1,21
Nigeria,2003-09-01,23,0,0,17,8,48
Nigeria,2003-09-01,14,2,0,5,3,24
Nigeria,2003-09-01,1,0,0,0,2,3
Nigeria,2003-09-01,1,0,0,-2,0,-1
Nigeria,2003-09-01,10,0,0,-4,0,6
Nigeria,2003-09-01,1,0,0,0,0,1
Nigeria,2003-10-01,38,0,0,5,5,48
Nigeria,2003-10-01,10,0,0,0,1,11
Nigeria,2003-10-01,7,0,1,-1,2,9
Nigeria,2003-10-01,1,0,0,3,0,4
Nigeria,2003-10-01,2,0,0,0,0,2
Nigeria,2003-10-01,7,0,0,3,2,12
Nigeria,2003-10-01,17,0,0,1,1,19
Nigeria,2003-10-01,2,0,0,3,4,9
Nigeria,2003-10-01,19,0,0,1,0,20
Nigeria,2003-10-01,25,0,-1,13,3,40
Nigeria,2003-10-01,7,0,0,0,-1,6
Nigeria,2003-10-01,3,0,-2,0,0,1
Nigeria,2003-10-01,17,2,-2,7,3,27
Nigeria,2003-10-01,41,2,-6,6,3,46
Nigeria,2003-10-01,18,0,0,-2,0,16
Nigeria,2003-10-01,10,0,-2,4,0,12
Nigeria,2003-10-01,6,4,0,-2,0,8
Nigeria,2003-10-01,3,0,0,0,0,3
Nigeria,2003-10-01,1,0,0,0,0,1
Nigeria,2003-10-01,4,0,0,8,1,13
Nigeria,2003-10-01,13,0,0,8,2,23
Nigeria,2003-10-01,16,0,0,-3,0,13
Nigeria,2003-10-01,-2,0,0,2,0,0
Nigeria,2003-10-01,7,0,0,3,2,12
Nigeria,2003-10-01,4,0,-2,-4,0,-2
Nigeria,2003-10-01,1,0,0,6,0,7
Nigeria,2003-10-01,11,0,0,-1,8,18
Nigeria,2003-10-01,9,0,0,-5,1,5
Nigeria,2003-10-01,16,0,0,6,1,23
Nigeria,2003-10-01,17,0,0,20,6,43
Nigeria,2003-10-01,22,0,-2,1,1,22
Nigeria,2003-11-01,6,0,0,3,0,9
Nigeria,2003-11-01,8,0,0,0,2,10
Nigeria,2003-11-01,19,0,0,-3,0,16
Nigeria,2003-11-01,15,0,-2,3,4,20
Nigeria,2003-11-01,5,0,1,0,9,15
Nigeria,2003-11-01,26,0,1,12,7,46
Nigeria,2003-11-01,11,0,0,13,1,25
Nigeria,2003-11-01,7,0,0,0,0,7
Nigeria,2003-11-01,0,0,0,0,0,0
Nigeria,2003-11-01,13,2,0,3,1,19
Nigeria,2003-11-01,14,0,2,6,2,24
Nigeria,2003-11-01,0,0,0,-2,0,-2
Nigeria,2003-11-01,4,0,0,15,1,20
Nigeria,2003-11-01,41,0,0,13,2,56
Nigeria,2003-11-01,18,0,0,-4,0,14
Nigeria,2003-11-01,3,0,0,3,2,8
Nigeria,2003-11-01,21,0,0,-4,5,22
Nigeria,2003-11-01,4,0,-3,4,1,6
Nigeria,2003-11-01,6,0,0,-5,1,2
Nigeria,2003-11-01,1,0,0,6,1,8
Nigeria,2003-11-01,17,0,0,-2,2,17
Nigeria,2003-11-01,0,0,0,0,0,0
Nigeria,2003-11-01,4,0,0,0,4,8
Nigeria,2003-11-01,6,0,0,15,1,22
Nigeria,2003-11-01,8,0,0,13,3,24
Nigeria,2003-11-01,9,0,0,0,5,14
Nigeria,2003-11-01,4,0,2,-4,0,2
Nigeria,2003-11-01,1,0,1,9,0,11
Nigeria,2003-11-01,3,0,0,-4,2,1
Nigeria,2003-11-01,0,0,0,-1,0,-1
Nigeria,2003-12-01,5,0,0,4,0,9
Nigeria,2003-12-01,8,0,0,0,7,15
Nigeria,2003-12-01,11,0,0,9,2,22
Nigeria,2003-12-01,17,0,0,24,2,43
Nigeria,2003-12-01,12,0,1,3,0,16
Nigeria,2003-12-01,10,0,0,0,1,11
Nigeria,2003-12-01,10,0,0,3,0,13
Nigeria,2003-12-01,6,0,0,3,2,11
Nigeria,2003-12-01,16,0,0,16,8,40
Nigeria,2003-12-01,14,0,0,3,2,19
Nigeria,2003-12-01,8,0,-1,12,2,21
Nigeria,2003-12-01,3,0,0,15,2,20
Nigeria,2003-12-01,0,0,2,0,0,2
Nigeria,2003-12-01,0,0,1,0,0,1
Nigeria,2003-12-01,4,0,0,16,6,26
Nigeria,2003-12-01,0,0,0,6,0,6
Nigeria,2003-12-01,12,0,0,5,6,23
Nigeria,2003-12-01,16,0,0,13,2,31
Nigeria,2003-12-01,8,2,0,3,2,15
Nigeria,2003-12-01,9,0,0,-6,0,3
Nigeria,2003-12-01,2,0,0,3,0,5
Nigeria,2003-12-01,8,0,0,3,0,11
Nigeria,2003-12-01,8,0,0,2,0,10
Nigeria,2003-12-01,4,0,0,9,3,16
Nigeria,2003-12-01,3,0,0,0,0,3
Nigeria,2003-12-01,5,0,0,3,0,8
Nigeria,2003-12-01,0,0,0,3,0,3
Nigeria,2003-12-01,1,0,0,0,0,1
Nigeria,2003-12-01,10,0,0,-2,0,8
Nigeria,2003-12-01,8,0,0,6,0,14
Nigeria,2003-12-01,2,0,0,-1,3,4
Pakistan,2003-01-01,26,0,-2,9,0,33
Pakistan,2003-01-01,34,0,0,0,0,34
Pakistan,2003-01-01,31,0,0,15,2,48
Pakistan,2003-01-01,26,0,0,1,0,27
Pakistan,2003-01-01,57,0,0,3,1,61
Pakistan,2003-01-01,28,0,0,2,8,38
Pakistan,2003-01-01,22,0,0,11,1,34
Pakistan,2003-01-01,34,0,0,7,6,47
Pakistan,2003-01-01,54,0,0,6,0,60
Pakistan,2003-01-01,5,0,0,-3,0,2
Pakistan,2003-01-01,9,0,0,1,0,10
Pakistan,2003-01-01,19,0,0,1,0,20
Pakistan,2003-01-01,19,0,0,6,0,25
Pakistan,2003-01-01,11,0,0,6,0,17
Pakistan,2003-01-01,12,0,0,0,0,12
Pakistan,2003-01-01,13,0,0,6,0,19
Pakistan,2003-01-01,29,0,0,21,0,50
Pakistan,2003-01-01,1,0,0,6,0,7
Pakistan,2003-01-01,19,0,0,-2,0,17
Pakistan,2003-01-01,31,0,0,0,6,37
Pakistan,2003-01-01,6,0,0,6,0,12
Pakistan,2003-01-01,23,0,0,12,4,39
Pakistan,2003-01-01,25,0,0,19,6,50
Pakistan,2003-01-01,8,0,0,0,0,8
Pakistan,2003-01-01,3,0,0,1,0,4
Pakistan,2003-01-01,5,0,0,2,2,9
Pakistan,2003-01-01,10,0,0,0,1,11
Pakistan,2003-01-01,68,0,0,6,1,75
Pakistan,2003-01-01,35,0,0,3,1,39
Pakistan,2003-01-01,46,0,0,8,0,54
Pakistan,2003-01-01,24,0,0,12,0,36
Pakistan,2003-02-01,14,0,0,0,2,16
Pakistan,2003-02-01,24,0,0,15,2,41
Pakistan,2003-02-01,31,0,0,15,3,49
Pakistan,2003-02-01,13,0,0,3,4,20
Pakistan,2003-02-01,15,0,0,13,2,30
Pakistan,2003-02-01,37,0,-1,9,0,45
Pakistan,2003-02-01,19,0,0,10,3,32
Pakistan,2003-02-01,9,0,0,2,0,11
Pakistan,2003-02-01,7,0,0,18,1,26
Pakistan,2003-02-01,14,0,0,13,0,27
Pakistan,2003-02-01,18,0,0,8,5,31
Pakistan,2003-02-01,9,0,0,0,0,9
Pakistan,2003-02-01,17,0,1,1,0,19
Pakistan,2003-02-01,8,0,0,1,2,11
Pakistan,2003-02-01,2,0,0,0,3,5
Pakistan,2003-02-01,0,0,0,0,0,0
Pakistan,2003-02-01,4,0,0,3,0,7
Pakistan,2003-02-01,7,0,0,-10,0,-3
Pakistan,2003-02-01,20,0,0,0,1,21
Pakistan,2003-02-01,12,0,0,3,4,19
Pakistan,2003-02-01,8,0,0,1,1,10
Pakistan,2003-02-01,8,0,0,4,5,17
Pakistan,2003-02-01,17,0,0,6,0,23
Pakistan,2003-02-01,20,0,0,6,1,27
Pakistan,2003-02-01,40,0,0,31,0,71
Pakistan,2003-02-01,6,0,0,6,2,14
Pakistan,2003-02-01,2,0,0,6,1,9
Pakistan,2003-02-01,10,2,0,11,0,23
Pakistan,2003-03-01,18,0,0,4,0,22
Pakistan,2003-03-01,8,0,0,1,0,9
Pakistan,2003-03-01,36,0,0,24,0,60
Pakistan,2003-03-01,38,0,1,36,2,77
Pakistan,2003-03-01,9,0,0,24,2,35
Pakistan,2003-03-01,36,0,0,23,1,60
Pakistan,2003-03-01,42,0,0,45,0,87
Pakistan,2003-03-01,18,0,0,12,3,33
Pakistan,2003-03-01,8,0,0,9,0,17
Pakistan,2003-03-01,46,0,2,-2,6,52
Pakistan,2003-03-01,20,0,0,22,1,43
Pakistan,2003-03-01,25,2,0,9,0,36
Pakistan,2003-03-01,18,0,0,18,0,36
Pakistan,2003-03-01,25,0,-1,6,2,32
Pakistan,2003-03-01,21,0,0,18,8,47
Pakistan,2003-03-01,22,4,0,0,3,29
Pakistan,2003-03-01,45,0,0,2,0,47
Pakistan,2003-03-01,9,0,0,7,1,17
Pakistan,2003-03-01,24,0,0,-9,7,22
Pakistan,2003-03-01,28,4,1,4,7,44
Pakistan,2003-03-01,20,0,0,3,0,23
Pakistan,2003-03-01,0,0,0,9,0,9
Pakistan,2003-03-01,14,0,0,-3,0,11
Pakistan,2003-03-01,3,0,-1,3,0,5
Pakistan,2003-03-01,26,0,0,3,6,35
Pakistan,2003-03-01,34,0,0,0,5,39
Pakistan,2003-03-01,12,0,0,0,3,15
Pakistan,2003-03-01,3,0,0,3,8,14
Pakistan,2003-03-01,16,0,0,0,4,20
Pakistan,2003-03-01,12,0,0,0,0,12
Pakistan,2003-03-01,24,0,0,6,0,30
Pakistan,2003-04-01,19,0,0,7,0,26
Pakistan,2003-04-01,30,0,0,3,2,35
Pakistan,2003-04-01,10,0,0,-3,0,7
Pakistan,2003-04-01,0,0,0,3,1,4
Pakistan,2003-04-01,16,0,0,1,2,19
Pakistan,2003-04-01,15,0,-2,0,1,14
Pakistan,2003-04-01,17,0,0,0,1,18
Pakistan,2003-04-01,1,0,0,-5,0,-4
Pakistan,2003-04-01,14,0,0,15,2,31
Pakistan,2003-04-01,-1,0,0,15,0,14
Pakistan,2003-04-01,30,0,0,9,0,39
Pakistan,2003-04-01,20,0,0,0,2,22
Pakistan,2003-04-01,15,0,0,9,0,24
Pakistan,2003-04-01,12,0,-4,6,1,15
Pakistan,2003-04-01,24,0,0,3,2,29
Pakistan,2003-04-01,18,0,0,3,4,25
Pakistan,2003-04-01,17,0,0,12,2,31
Pakistan,2003-04-01,13,0,0,2,5,20
Pakistan,2003-04-01,21,0,0,18,0,39
Pakistan,2003-04-01,3,0,0,3,0,6
Pakistan,2003-04-01,3,0,0,45,4,52
Pakistan,2003-04-01,8,0,0,7,2,17
Pakistan,2003-04-01,19,0,0,0,1,20
Pakistan,2003-04-01,33,0,0,24,0,57
Pakistan,2003-04-01,33,2,0,17,0,52
Pakistan,2003-04-01,50,0,0,9,0,59
Pakistan,2003-04-01,7,0,0,3,0,10
Pakistan,2003-04-01,19,0,0,6,1,26
Pakistan,2003-04-01,42,0,0,15,6,63
Pakistan,2003-04-01,30,0,0,12,3,45
Pakistan,2003-05-01,24,0,-3,4,0,25
Pakistan,2003-05-01,32,0,0,4,0,36
Pakistan,2003-05-01,12,0,1,0,0,13
Pakistan,2003-05-01,3,2,0,0,1,6
Pakistan,2003-05-01,34,0,0,19,0,53
Pakistan,2003-05-01,31,0,0,-4,3,30
Pakistan,2003-05-01,14,0,0,-8,3,9
Pakistan,2003-05-01,8,0,-4,1,0,5
Pakistan,2003-05-01,15,0,0,9,1,25
Pakistan,2003-05-01,55,0,-2,4,0,57
Pakistan,2003-05-01,34,0,0,3,18,55
Pakistan,2003-05-01,28,0,0,-1,0,27
Pakistan,2003-05-01,10,0,-1,0,0,9
Pakistan,2003-05-01,15,0,0,-2,3,16
Pakistan,2003-05-01,15,0,-2,12,1,26
Pakistan,2003-05-01,51,0,1,9,0,61
Pakistan,2003-05-01,18,0,0,19,6,43
Pakistan,2003-05-01,16,0,0,0,1,17
Pakistan,2003-05-01,24,0,0,24,2,50
Pakistan,2003-05-01,9,0,0,1,6,16
Pakistan,2003-05-01,13,0,0,20,0,33
Pakistan,2003-05-01,28,0,0,13,0,41
Pakistan,2003-05-01,15,0,0,9,2,26
Pakistan,2003-05-01,7,0,0,15,0,22
Pakistan,2003-05-01,9,0,0,3,0,12
Pakistan,2003-05-01,33,0,0,-2,0,31
Pakistan,2003-05-01,13,0,-2,4,2,17
Pakistan,2003-05-01,12,0,0,55,0,67
Pakistan,2003-05-01,9,4,0,1,1,15
Pakistan,2003-05-01,13,0,0,12,0,25
Pakistan,2003-05-01,7,0,0,-3,0,4
Pakistan,2003-06-01,2,0,0,6,0,8
Pakistan,2003-06-01,11,0,0,-1,0,10
Pakistan,2003-06-01,12,0,0,3,0,15
Pakistan,2003-06-01,16,0,0,15,2,33
Pakistan,2003-06-01,21,0,0,6,5,32
Pakistan,2003-06-01,4,0,0,6,0,10
Pakistan,2003-06-01,19,0,0,0,0,19
Pakistan,2003-06-01,1,0,0,0,0,1
Pakistan,2003-06-01,3,0,0,3,5,11
Pakistan,2003-06-01,38,0,0,0,0,38
Pakistan,2003-06-01,34,0,0,0,-1,33
Pakistan,2003-06-01,10,0,0,20,2,32
Pakistan,2003-06-01,8,0,0,24,5,37
Pakistan,2003-06-01,8,0,0,0,1,9
Pakistan,2003-06-01,25,0,0,2,1,28
Pakistan,2003-06-01,5,0,0,14,2,21
Pakistan,2003-06-01,41,0,0,3,0,44
Pakistan,2003-06-01,21,0,0,45,0,66
Pakistan,2003-06-01,12,0,1,5,2,20
Pakistan,2003-06-01,23,0,0,9,7,39
Pakistan,2003-06-01,3,0,0,15,0,18
Pakistan,2003-06-01,20,0,-2,6,7,31
Pakistan,2003-06-01,36,0,0,-4,0,32
Pakistan,2003-06-01,12,0,0,15,0,27
Pakistan,2003-06-01,14,0,0,2,1,17
Pakistan,2003-06-01,18,0,0,38,4,60
Pakistan,2003-06-01,34,0,0,6,1,41
Pakistan,2003-06-01,41,0,1,4,1,47
Pakistan,2003-06-01,26,2,0,10,0,38
Pakistan,2003-06-01,40,0,-2,0,8,46
Pakistan,2003-07-01,32,0,0,14,1,47
Pakistan,2003-07-01,25,0,0,9,7,41
Pakistan,2003-07-01,48,0,0,15,4,67
Pakistan,2003-07-01,28,0,0,9,3,40
Pakistan,2003-07-01,48,0,0,12,15,75
Pakistan,2003-07-01,20,0,1,5,1,27
Pakistan,2003-07-01,51,2,1,14,2,70
Pakistan,2003-07-01,91,0,0,24,27,142
Pakistan,2003-07-01,31,0,0,8,2,41
Pakistan,2003-07-01,17,0,0,3,10,30
Pakistan,2003-07-01,23,0,0,15,9,47
Pakistan,2003-07-01,8,0,0,3,1,12
Pakistan,2003-07-01,40,0,0,6,0,46
Pakistan,2003-07-01,48,0,0,3,2,53
Pakistan,2003-07-01,25,0,-2,24,2,49
Pakistan,2003-07-01,18,2,0,9,0,29
Pakistan,2003-07-01,23,0,0,21,1,45
Pakistan,2003-07-01,64,0,2,15,1,82
Pakistan,2003-07-01,19,0,0,31,5,55
Pakistan,2003-07-01,8,0,0,18,2,28
Pakistan,2003-07-01,56,0,0,7,4,67
Pakistan,2003-07-01,54,0,0,0,2,56
Pakistan,2003-07-01,38,0,0,52,2,92
Pakistan,2003-07-01,26,0,0,15,2,43
Pakistan,2003-07-01,31,0,0,7,2,40
Pakistan,2003-07-01,15,0,0,6,3,24
Pakistan,2003-07-01,4,0,0,9,0,13
Pakistan,2003-07-01,21,0,0,18,0,39
Pakistan,2003-07-01,0,0,0,6,2,8
Pakistan,2003-07-01,19,0,0,6,0,25
Pakistan,2003-07-01,14,0,0,6,4,24
Pakistan,2003-08-01,31,0,0,55,5,91
Pakistan,2003-08-01,15,0,0,-1,0,14
Pakistan,2003-08-01,3,0,0,6,3,12
Pakistan,2003-08-01,7,0,0,22,3,32
Pakistan,2003-08-01,15,0,0,15,0,30
Pakistan,2003-08-01,16,0,-5,11,0,22
Pakistan,2003-08-01,21,0,0,4,0,25
Pakistan,2003-08-01,22,0,0,5,1,28
Pakistan,2003-08-01,13,0,0,-2,0,11
Pakistan,2003-08-01,4,0,0,12,6,22
Pakistan,2003-08-01,2,0,2,3,0,7
Pakistan,2003-08-01,17,0,0,3,0,20
Pakistan,2003-08-01,21,0,0,-4,3,20
Pakistan,2003-08-01,20,4,0,3,0,27
Pakistan,2003-08-01,15,0,0,21,5,41
Pakistan,2003-08-01,22,0,-2,-2,4,22
Pakistan,2003-08-01,82,0,0,6,7,95
Pakistan,2003-08-01,69,0,2,9,1,81
Pakistan,2003-08-01,48,0,0,4,0,52
Pakistan,2003-08-01,50,0,0,3,4,57
Pakistan,2003-08-01,26,0,0,10,3,39
Pakistan,2003-08-01,5,0,0,3,4,12
Pakistan,2003-08-01,46,0,0,28,0,74
Pakistan,2003-08-01,30,0,0,21,10,61
Pakistan,2003-08-01,44,0,0,39,2,85
Pakistan,2003-08-01,56,0,0,18,1,75
Pakistan,2003-08-01,21,0,0,10,1,32
Pakistan,2003-08-01,26,0,0,9,4,39
Pakistan,2003-08-01,3,0,0,6,1,10
Pakistan,2003-08-01,37,0,0,12,2,51
Pakistan,2003-08-01,33,0,0,3,10,46
Pakistan,2003-09-01,20,0,0,5,0,25
Pakistan,2003-09-01,16,0,0,5,0,21
Pakistan,2003-09-01,43,0,0,1,6,50
Pakistan,2003-09-01,35,0,0,38,1,74
Pakistan,2003-09-01,16,2,0,-1,0,17
Pakistan,2003-09-01,34,0,0,13,0,47
Pakistan,2003-09-01,32,0,0,15,2,49
Pakistan,2003-09-01,24,0,-2,24,4,50
Pakistan,2003-09-01,11,0,0,3,0,14
Pakistan,2003-09-01,27,0,0,2,5,34
Pakistan,2003-09-01,24,0,-2,9,0,31
Pakistan,2003-09-01,11,0,0,2,0,13
Pakistan,2003-09-01,17,0,0,-2,0,15
Pakistan,2003-09-01,34,0,0,12,2,48
Pakistan,2003-09-01,22,0,0,15,0,37
Pakistan,2003-09-01,11,0,0,-4,0,7
Pakistan,2003-09-01,19,0,0,12,2,33
Pakistan,2003-09-01,10,0,0,-1,0,9
Pakistan,2003-09-01,10,0,-2,27,3,38
Pakistan,2003-09-01,34,0,0,2,0,36
Pakistan,2003-09-01,28,0,0,1,0,29
Pakistan,2003-09-01,21,0,2,9,0,32
Pakistan,2003-09-01,32,2,0,27,3,64
Pakistan,2003-09-01,15,0,0,19,8,42
Pakistan,2003-09-01,18,0,0,16,1,35
Pakistan,2003-09-01,17,0,0,2,5,24
Pakistan,2003-09-01,6,0,0,15,2,23
Pakistan,2003-09-01,27,0,0,15,1,43
Pakistan,2003-09-01,43,0,0,14,2,59
Pakistan,2003-09-01,22,2,0,9,0,33
Pakistan,2003-10-01,6,0,0,12,0,18
Pakistan,2003-10-01,15,0,0,6,0,21
Pakistan,2003-10-01,16,0,0,9,0,25
Pakistan,2003-10-01,33,2,0,0,3,38
Pakistan,2003-10-01,8,0,0,3,0,11
Pakistan,2003-10-01,50,0,0,18,2,70
Pakistan,2003-10-01,6,0,0,15,6,27
Pakistan,2003-10-01,46,0,1,6,0,53
Pakistan,2003-10-01,11,0,0,0,0,11
Pakistan,2003-10-01,15,0,0,0,1,16
Pakistan,2003-10-01,40,0,0,9,2,51
Pakistan,2003-10-01,11,0,0,15,0,26
Pakistan,2003-10-01,60,4,0,21,0,85
Pakistan,2003-10-01,11,0,0,6,2,19
Pakistan,2003-10-01,22,0,0,0,4,26
Pakistan,2003-10-01,36,0,0,0,0,36
Pakistan,2003-10-01,38,0,-2,3,4,43
Pakistan,2003-10-01,7,0,0,0,0,7
Pakistan,2003-10-01,6,0,0,6,0,12
Pakistan,2003-10-01,14,0,0,6,3,23
Pakistan,2003-10-01,30,0,-2,3,3,34
Pakistan,2003-10-01,19,0,0,12,5,36
Pakistan,2003-10-01,4,0,0,6,0,10
Pakistan,2003-10-01,23,0,0,10,2,35
Pakistan,2003-10-01,6,0,0,0,0,6
Pakistan,2003-10-01,16,0,0,3,2,21
Pakistan,2003-10-01,0,0,0,3,0,3
Pakistan,2003-10-01,31,0,0,9,0,40
Pakistan,2003-10-01,25,0,0,3,0,28
Pakistan,2003-10-01,21,0,-2,3,2,24
Pakistan,2003-10-01,40,0,0,3,4,47
Pakistan,2003-11-01,17,0,0,-2,0,15
Pakistan,2003-11-01,11,0,0,-7,2,6
Pakistan,2003-11-01,18,0,0,-1,0,17
Pakistan,2003-11-01,0,0,0,13,2,15
Pakistan,2003-11-01,17,0,0,6,0,23
Pakistan,2003-11-01,2,0,0,0,0,2
Pakistan,2003-11-01,-1,0,0,5,0,4
Pakistan,2003-11-01,30,0,0,9,0,39
Pakistan,2003-11-01,56,0,0,0,0,56
Pakistan,2003-11-01,2,0,0,15,5,22
Pakistan,2003-11-01,5,0,0,33,0,38
Pakistan,2003-11-01,10,0,0,3,4,17
Pakistan,2003-11-01,10,0,0,0,1,11
Pakistan,2003-11-01,15,0,0,3,0,18
Pakistan,2003-11-01,40,0,0,8,7,55
Pakistan,2003-11-01,38,0,0,15,0,53
Pakistan,2003-11-01,38,0,0,19,2,59
Pakistan,2003-11-01,13,0,0,-6,0,7
Pakistan,2003-11-01,8,0,0,13,0,21
Pakistan,2003-11-01,-2,0,0,10,0,8
Pakistan,2003-11-01,17,0,0,12,0,29
Pakistan,2003-11-01,23,0,0,23,0,46
Pakistan,2003-11-01,-2,0,0,-5,2,-5
Pakistan,2003-11-01,80,0,0,-2,1,79
Pakistan,2003-11-01,11,0,0,12,2,25
Pakistan,2003-11-01,33,0,3,7,0,43
Pakistan,2003-11-01,26,0,0,10,4,40
Pakistan,2003-11-01,-2,0,0,-1,0,-3
Pakistan,2003-11-01,5,0,0,0,0,5
Pakistan,2003-11-01,14,0,0,9,0,23
Pakistan,2003-12-01,13,0,0,28,0,41
Pakistan,2003-12-01,35,0,0,0,2,37
Pakistan,2003-12-01,12,0,0,1,3,16
Pakistan,2003-12-01,13,0,2,1,1,17
Pakistan,2003-12-01,12,0,0,1,0,13
Pakistan,2003-12-01,12,0,0,21,1,34
Pakistan,2003-12-01,9,0,0,12,0,21
Pakistan,2003-12-01,55,0,0,9,2,66
Pakistan,2003-12-01,25,0,0,4,7,36
Pakistan,2003-12-01,22,0,0,23,1,46
Pakistan,2003-12-01,35,0,0,28,8,71
Pakistan,2003-12-01,25,4,0,14,0,43
Pakistan,2003-12-01,14,0,0,18,8,40
Pakistan,2003-12-01,12,0,0,6,0,18
Pakistan,2003-12-01,26,0,0,3,0,29
Pakistan,2003-12-01,17,0,0,11,0,28
Pakistan,2003-12-01,24,0,0,6,0,30
Pakistan,2003-12-01,1,0,0,24,3,28
Pakistan,2003-12-01,15,0,0,0,3,18
Pakistan,2003-12-01,-1,0,0,0,0,-1
Pakistan,2003-12-01,12,0,0,-5,2,9
Pakistan,2003-12-01,27,0,0,3,0,30
Pakistan,2003-12-01,60,0,0,6,0,66
Pakistan,2003-12-01,18,0,-2,4,4,24
Pakistan,2003-12-01,1,0,0,6,0,7
Pakistan,2003-12-01,19,0,-1,3,0,21
Pakistan,2003-12-01,21,2,0,4,0,27
Pakistan,2003-12-01,17,0,0,1,2,20
Pakistan,2003-12-01,12,0,0,4,4,20
Pakistan,2003-12-01,42,0,0,12,0,54
Pakistan,2003-12-01,7,0,-2,15,0,20
Sierra Leone,2003-01-01,4,0,0,0,0,4
Sierra Leone,2003-01-01,2,0,0,0,0,2
Sierra Leone,2003-01-01,0,0,0,0,0,0
Sierra Leone,2003-01-01,-3,0,0,0,0,-3
Sierra Leone,2003-01-01,0,0,0,0,0,0
Sierra Leone,2003-01-01,2,0,0,0,0,2
Sierra Leone,2003-01-01,0,0,0,0,0,0
Sierra Leone,2003-01-01,3,0,0,0,0,3
Sierra Leone,2003-01-01,2,0,0,0,0,2
Sierra Leone,2003-01-01,3,0,0,0,2,5
Sierra Leone,2003-01-01,2,0,0,0,4,6
Sierra Leone,2003-01-01,0,0,0,0,4,4
Sierra Leone,2003-01-01,2,0,0,3,1,6
Sierra Leone,2003-01-01,2,0,0,3,3,8
Sierra Leone,2003-01-01,1,0,0,9,0,10
Sierra Leone,2003-01-01,5,0,0,0,0,5
Sierra Leone,2003-01-01,-2,0,0,0,0,-2
Sierra Leone,2003-01-01,-2,0,0,0,0,-2
Sierra Leone,2003-01-01,2,0,0,0,0,2
Sierra Leone,2003-01-01,1,0,0,0,0,1
Sierra Leone,2003-01-01,0,0,0,0,0,0
Sierra Leone,2003-01-01,4,0,0,-2,0,2
Sierra Leone,2003-01-01,-2,0,0,0,0,-2
Sierra Leone,2003-01-01,0,0,0,0,0,0
Sierra Leone,2003-01-01,0,0,0,0,0,0
Sierra Leone,2003-02-01,0,0,0,0,0,0
Sierra Leone,2003-02-01,0,0,0,0,0,0
Sierra Leone,2003-02-01,0,0,0,0,0,0
Sierra Leone,2003-02-01,1,0,0,3,0,4
Sierra Leone,2003-02-01,0,0,0,-1,0,-1
Sierra Leone,2003-02-01,-2,0,0,0,0,-2
Sierra Leone,2003-02-01,0,0,0,0,0,0
Sierra Leone,2003-02-01,0,0,0,0,0,0
Sierra Leone,2003-02-01,0,0,0,0,0,0
Sierra Leone,2003-02-01,0,0,0,0,0,0
Sierra Leone,2003-02-01,9,0,0,0,0,9
Sierra Leone,2003-02-01,0,0,0,0,0,0
Sierra Leone,2003-02-01,9,0,0,0,0,9
Sierra Leone,2003-02-01,19,0,0,3,0,22
Sierra Leone,2003-02-01,10,0,0,0,0,10
Sierra Leone,2003-02-01,18,0,0,0,0,18
Sierra Leone,2003-02-01,1,0,0,0,0,1
Sierra Leone,2003-02-01,4,0,0,9,0,13
Sierra Leone,2003-02-01,-1,0,0,0,0,-1
Sierra Leone,2003-02-01,2,0,0,3,0,5
Sierra Leone,2003-02-01,0,0,0,0,0,0
Sierra Leone,2003-03-01,0,0,0,0,0,0
Sierra Leone,2003-03-01,0,0,0,0,0,0
Sierra Leone,2003-03-01,-1,0,0,0,0,-1
Sierra Leone,2003-03-01,0,0,0,0,0,0
Sierra Leone,2003-03-01,0,0,0,6,0,6
Sierra Leone,2003-03-01,0,0,0,0,0,0
Sierra Leone,2003-03-01,15,0,0,12,1,28
Sierra Leone,2003-03-01,4,0,0,12,0,16
Sierra Leone,2003-03-01,18,0,1,-3,0,16
Sierra Leone,2003-03-01,0,0,0,16,0,16
Sierra Leone,2003-03-01,2,0,0,0,0,2
Sierra Leone,2003-03-01,0,0,0,0,0,0
Sierra Leone,2003-03-01,2,0,0,0,0,2
Sierra Leone,2003-03-01,9,0,0,4,2,15
Sierra Leone,2003-03-01,0,0,0,4,2,6
Sierra Leone,2003-03-01,0,0,0,0,0,0
Sierra Leone,2003-03-01,0,0,0,0,0,0
Sierra Leone,2003-03-01,0,0,0,0,0,0
Sierra Leone,2003-03-01,3,0,0,0,0,3
Sierra Leone,2003-03-01,0,0,0,0,6,6
Sierra Leone,2003-03-01,0,0,0,0,0,0
Sierra Leone,2003-03-01,0,0,0,0,0,0
Sierra Leone,2003-04-01,0,0,0,0,0,0
Sierra Leone,2003-04-01,6,0,0,0,0,6
Sierra Leone,2003-04-01,3,0,0,0,0,3
Sierra Leone,2003-04-01,4,0,0,0,0,4
Sierra Leone,2003-04-01,0,0,0,6,0,6
Sierra Leone,2003-04-01,0,0,0,0,0,0
Sierra Leone,2003-04-01,1,0,0,0,0,1
Sierra Leone,2003-04-01,0,0,0,0,0,0
Sierra Leone,2003-04-01,0,0,0,0,0,0
Sierra Leone,2003-04-01,0,0,1,0,0,1
Sierra Leone,2003-04-01,3,0,0,3,2,8
Sierra Leone,2003-04-01,0,0,1,0,0,1
Sierra Leone,2003-04-01,0,0,0,0,0,0
Sierra Leone,2003-04-01,3,0,0,3,0,6
Sierra Leone,2003-04-01,2,0,0,0,0,2
Sierra Leone,2003-04-01,0,2,0,0,0,2
Sierra Leone,2003-04-01,0,0,0,3,0,3
Sierra Leone,2003-04-01,0,0,0,0,0,0
Sierra Leone,2003-04-01,0,0,0,0,0,0
Sierra Leone,2003-04-01,2,0,0,0,0,2
Sierra Leone,2003-04-01,0,0,0,0,0,0
Sierra Leone,2003-04-01,16,0,0,0,0,16
Sierra Leone,2003-04-01,17,0,0,3,6,26
Sierra Leone,2003-04-01,4,2,0,-1,0,5
Sierra Leone,2003-05-01,4,0,0,9,0,13
Sierra Leone,2003-05-01,6,0,0,0,4,10
Sierra Leone,2003-05-01,4,0,0,3,0,7
Sierra Leone,2003-05-01,40,0,0,33,0,73
Sierra Leone,2003-05-01,13,0,0,13,1,27
Sierra Leone,2003-05-01,7,0,0,7,0,14
Sierra Leone,2003-05-01,16,0,0,3,0,19
Sierra Leone,2003-05-01,0,0,0,3,0,3
Sierra Leone,2003-05-01,2,0,0,-3,0,-1
Sierra Leone,2003-05-01,5,0,0,5,0,10
Sierra Leone,2003-05-01,2,0,0,-2,1,1
Sierra Leone,2003-05-01,2,0,0,6,0,8
Sierra Leone,2003-05-01,0,0,0,3,0,3
Sierra Leone,2003-05-01,3,0,0,0,0,3
Sierra Leone,2003-05-01,2,0,0,0,0,2
Sierra Leone,2003-05-01,3,0,0,0,0,3
Sierra Leone,2003-05-01,1,0,0,0,0,1
Sierra Leone,2003-05-01,7,0,0,0,0,7
Sierra Leone,2003-05-01,3,0,0,0,0,3
Sierra Leone,2003-05-01,0,0,0,0,0,0
Sierra Leone,2003-05-01,0,0,0,0,0,0
Sierra Leone,2003-05-01,0,0,-2,6,0,4
Sierra Leone,2003-05-01,5,0,0,-1,2,6
Sierra Leone,2003-05-01,0,0,0,2,0,2
Sierra Leone,2003-05-01,9,0,0,0,0,9
Sierra Leone,2003-06-01,-1,0,0,-2,0,-3
Sierra Leone,2003-06-01,0,0,0,6,0,6
Sierra Leone,2003-06-01,0,0,0,21,0,21
Sierra Leone,2003-06-01,6,0,0,12,1,19
Sierra Leone,2003-06-01,4,0,0,16,2,22
Sierra Leone,2003-06-01,1,0,0,10,0,11
Sierra Leone,2003-06-01,0,0,0,6,0,6
Sierra Leone,2003-06-01,10,0,0,0,3,13
Sierra Leone,2003-06-01,4,0,0,2,0,6
Sierra Leone,2003-06-01,4,0,-2,6,0,8
Sierra Leone,2003-06-01,3,0,0,9,0,12
Sierra Leone,2003-06-01,-2,0,0,9,0,7
Sierra Leone,2003-06-01,0,0,0,3,0,3
Sierra Leone,2003-06-01,0,0,0,3,0,3
Sierra Leone,2003-06-01,2,2,0,6,0,10
Sierra Leone,2003-06-01,-1,0,0,22,0,21
Sierra Leone,2003-06-01,4,0,-2,24,2,28
Sierra Leone,2003-06-01,4,0,-2,1,0,3
Sierra Leone,2003-06-01,5,0,0,11,1,17
Sierra Leone,2003-06-01,1,0,0,3,0,4
Sierra Leone,2003-06-01,11,0,0,6,2,19
Sierra Leone,2003-06-01,19,0,0,-2,0,17
Sierra Leone,2003-06-01,0,0,0,12,0,12
Sierra Leone,2003-06-01,3,0,0,5,3,11
Sierra Leone,2003-06-01,5,0,-2,-2,0,1
Sierra Leone,2003-06-01,1,0,-6,0,0,-5
Sierra Leone,2003-06-01,0,0,0,1,0,1
Sierra Leone,2003-06-01,3,0,0,3,0,6
Sierra Leone,2003-07-01,8,0,0,15,0,23
Sierra Leone,2003-07-01,12,0,-2,18,4,32
Sierra Leone,2003-07-01,1,0,0,12,5,18
Sierra Leone,2003-07-01,16,0,-2,0,1,15
Sierra Leone,2003-07-01,4,0,0,-2,2,4
Sierra Leone,2003-07-01,4,0,0,9,0,13
Sierra Leone,2003-07-01,3,0,-2,6,1,8
Sierra Leone,2003-07-01,12,0,0,9,2,23
Sierra Leone,2003-07-01,6,0,1,12,0,19
Sierra Leone,2003-07-01,5,0,0,9,1,15
Sierra Leone,2003-07-01,4,0,-4,3,6,9
Sierra Leone,2003-07-01,4,0,0,3,0,7
Sierra Leone,2003-07-01,0,0,0,0,0,0
Sierra Leone,2003-07-01,1,0,-1,7,1,8
Sierra Leone,2003-07-01,7,0,-2,19,0,24
Sierra Leone,2003-07-01,-1,0,1,6,0,6
Sierra Leone,2003-07-01,9,0,0,15,0,24
Sierra Leone,2003-07-01,6,4,0,10,0,20
Sierra Leone,2003-07-01,16,0,0,0,0,16
Sierra Leone,2003-07-01,9,0,0,6,0,15
Sierra Leone,2003-07-01,14,0,0,17,4,35
Sierra Leone,2003-07-01,10,2,0,7,3,22
Sierra Leone,2003-07-01,9,0,-4,24,0,29
Sierra Leone,2003-07-01,11,0,0,-2,0,9
Sierra Leone,2003-07-01,6,0,-2,3,0,7
Sierra Leone,2003-07-01,13,0,0,0,2,15
Sierra Leone,2003-07-01,0,0,0,0,0,0
Sierra Leone,2003-07-01,-1,0,-2,0,0,-3
Sierra Leone,2003-07-01,4,0,0,0,0,4
Sierra Leone,2003-07-01,1,0,-4,6,0,3
Sierra Leone,2003-07-01,5,0,0,3,0,8
Sierra Leone,2003-08-01,8,0,0,9,0,17
Sierra Leone,2003-08-01,3,0,-2,9,0,10
Sierra Leone,2003-08-01,14,0,-2,6,0,18
Sierra Leone,2003-08-01,29,0,-10,21,2,42
Sierra Leone,2003-08-01,11,0,0,12,0,23
Sierra Leone,2003-08-01,6,0,0,15,0,21
Sierra Leone,2003-08-01,13,0,-2,21,0,32
Sierra Leone,2003-08-01,23,0,-5,4,0,22
Sierra Leone,2003-08-01,0,0,0,3,1,4
Sierra Leone,2003-08-01,4,0,-6,6,0,4
Sierra Leone,2003-08-01,10,0,-12,-3,1,-4
Sierra Leone,2003-08-01,18,0,-4,37,1,52
Sierra Leone,2003-08-01,8,0,0,1,2,11
Sierra Leone,2003-08-01,10,0,0,0,0,10
Sierra Leone,2003-08-01,0,0,0,6,0,6
Sierra Leone,2003-08-01,6,0,0,0,0,6
Sierra Leone,2003-08-01,0,0,0,0,0,0
Sierra Leone,2003-08-01,2,0,0,0,0,2
Sierra Leone,2003-08-01,0,0,0,6,2,8
Sierra Leone,2003-08-01,0,0,0,-2,2,0
Sierra Leone,2003-08-01,6,0,0,1,0,7
Sierra Leone,2003-08-01,5,0,0,15,0,20
Sierra Leone,2003-08-01,2,0,0,0,0,2
Sierra Leone,2003-08-01,2,0,0,0,0,2
Sierra Leone,2003-08-01,0,0,0,0,0,0
Sierra Leone,2003-08-01,5,0,0,6,0,11
Sierra Leone,2003-08-01,0,0,0,3,0,3
Sierra Leone,2003-08-01,2,0,0,0,0,2
Sierra Leone,2003-08-01,0,0,0,0,0,0
Sierra Leone,2003-08-01,0,0,0,-2,0,-2
Sierra Leone,2003-08-01,0,0,0,0,0,0
Sierra Leone,2003-09-01,0,0,0,14,0,14
Sierra Leone,2003-09-01,0,0,-2,3,0,1
Sierra Leone,2003-09-01,10,0,0,3,0,13
Sierra Leone,2003-09-01,0,0,0,0,0,0
Sierra Leone,2003-09-01,6,0,0,7,0,13
Sierra Leone,2003-09-01,1,0,0,0,0,1
Sierra Leone,2003-09-01,0,0,0,0,0,0
Sierra Leone,2003-09-01,0,0,0,-1,0,-1
Sierra Leone,2003-09-01,9,0,0,0,0,9
Sierra Leone,2003-09-01,0,0,0,0,0,0
Sierra Leone,2003-09-01,0,0,0,0,0,0
Sierra Leone,2003-09-01,0,0,0,0,0,0
Sierra Leone,2003-09-01,-1,0,0,0,0,-1
Sierra Leone,2003-09-01,5,0,0,0,0,5
Sierra Leone,2003-09-01,0,0,0,0,0,0
Sierra Leone,2003-09-01,0,0,0,0,0,0
Sierra Leone,2003-09-01,0,0,0,0,0,0
Sierra Leone,2003-09-01,0,0,0,0,2,2
Sierra Leone,2003-09-01,0,0,0,0,0,0
Sierra Leone,2003-09-01,9,0,0,3,0,12
Sierra Leone,2003-09-01,-1,0,0,0,0,-1
Sierra Leone,2003-09-01,0,0,0,0,2,2
Sierra Leone,2003-09-01,4,0,0,6,0,10
Sierra Leone,2003-09-01,0,0,0,0,0,0
Sierra Leone,2003-10-01,6,0,0,18,0,24
Sierra Leone,2003-10-01,4,0,0,9,1,14
Sierra Leone,2003-10-01,2,0,0,0,6,8
Sierra Leone,2003-10-01,0,0,0,0,0,0
Sierra Leone,2003-10-01,0,0,0,0,0,0
Sierra Leone,2003-10-01,1,0,0,0,2,3
Sierra Leone,2003-10-01,3,0,0,9,0,12
Sierra Leone,2003-10-01,7,0,0,3,0,10
Sierra Leone,2003-10-01,0,2,0,3,0,5
Sierra Leone,2003-10-01,0,0,0,0,0,0
Sierra Leone,2003-10-01,6,0,0,0,0,6
Sierra Leone,2003-10-01,2,0,0,0,3,5
Sierra Leone,2003-10-01,7,0,0,1,0,8
Sierra Leone,2003-10-01,-1,0,0,0,0,-1
Sierra Leone,2003-10-01,-1,0,0,6,0,5
Sierra Leone,2003-10-01,1,0,0,0,0,1
Sierra Leone,2003-10-01,0,0,0,0,0,0
Sierra Leone,2003-10-01,2,0,1,7,0,10
Sierra Leone,2003-10-01,8,0,0,3,0,11
Sierra Leone,2003-10-01,3,0,0,5,0,8
Sierra Leone,2003-10-01,2,0,0,-2,0,0
Sierra Leone,2003-10-01,0,0,0,0,0,0
Sierra Leone,2003-10-01,0,0,0,3,0,3
Sierra Leone,2003-10-01,0,0,0,6,0,6
Sierra Leone,2003-10-01,0,0,-2,0,0,-2
Sierra Leone,2003-10-01,0,0,0,0,0,0
Sierra Leone,2003-10-01,0,0,0,3,0,3
Sierra Leone,2003-10-01,2,0,0,-2,1,1
Sierra Leone,2003-10-01,3,0,0,0,0,3
Sierra Leone,2003-11-01,0,0,0,0,0,0
Sierra Leone,2003-11-01,0,0,0,0,0,0
Sierra Leone,2003-11-01,5,0,0,3,3,11
Sierra Leone,2003-11-01,2,0,0,0,0,2
Sierra Leone,2003-11-01,2,0,0,3,1,6
Sierra Leone,2003-11-01,4,0,0,3,0,7
Sierra Leone,2003-11-01,1,0,0,6,0,7
Sierra Leone,2003-11-01,2,0,0,15,0,17
Sierra Leone,2003-11-01,2,0,0,4,2,8
Sierra Leone,2003-11-01,2,0,0,12,0,14
Sierra Leone,2003-11-01,3,0,0,0,1,4
Sierra Leone,2003-11-01,1,0,0,0,0,1
Sierra Leone,2003-11-01,2,0,0,0,0,2
Sierra Leone,2003-11-01,3,0,0,0,0,3
Sierra Leone,2003-11-01,0,0,0,0,0,0
Sierra Leone,2003-11-01,0,2,0,0,0,2
Sierra Leone,2003-11-01,5,0,0,0,0,5
Sierra Leone,2003-11-01,2,0,0,18,0,20
Sierra Leone,2003-11-01,1,0,0,6,0,7
Sierra Leone,2003-11-01,0,0,0,0,0,0
Sierra Leone,2003-11-01,0,0,0,0,0,0
Sierra Leone,2003-11-01,-2,0,0,3,0,1
Sierra Leone,2003-11-01,0,0,0,0,0,0
Sierra Leone,2003-11-01,0,0,0,0,0,0
Sierra Leone,2003-12-01,0,0,0,6,0,6
Sierra Leone,2003-12-01,0,0,0,0,0,0
Sierra Leone,2003-12-01,0,0,0,0,0,0
Sierra Leone,2003-12-01,14,0,1,12,0,27
Sierra Leone,2003-12-01,10,0,0,12,1,23
Sierra Leone,2003-12-01,0,0,0,0,0,0
Sierra Leone,2003-12-01,0,0,0,3,1,4
Sierra Leone,2003-12-01,-2,0,0,3,1,2
Sierra Leone,2003-12-01,3,0,0,7,0,10
Sierra Leone,2003-12-01,0,0,0,4,0,4
Sierra Leone,2003-12-01,6,0,0,0,0,6
Sierra Leone,2003-12-01,2,0,0,9,0,11
Sierra Leone,2003-12-01,0,0,0,3,0,3
Sierra Leone,2003-12-01,0,0,0,6,0,6
Sierra Leone,2003-12-01,0,0,0,0,0,0
Sierra Leone,2003-12-01,0,0,0,0,0,0
Sierra Leone,2003-12-01,1,0,0,0,0,1
Sierra Leone,2003-12-01,0,0,0,0,1,1
Sierra Leone,2003-12-01,0,0,0,0,0,0
Sierra Leone,2003-12-01,2,0,0,3,2,7
Sierra Leone,2003-12-01,0,0,0,0,0,0
Sierra Leone,2003-12-01,0,0,0,0,0,0
Sierra Leone,2003-12-01,0,0,0,0,0,0
Sierra Leone,2003-12-01,0,0,0,0,0,0
Sierra Leone,2003-12-01,0,0,0,0,0,0
Sierra Leone,2003-12-01,2,0,0,0,2,4
Sierra Leone,2003-12-01,2,0,0,3,2,7
Sierra Leone,2003-12-01,0,0,0,0,0,0
Somalia,2003-01-01,0,0,0,3,0,3
Somalia,2003-01-01,2,0,0,0,0,2
Somalia,2003-01-01,1,4,0,0,0,5
Somalia,2003-01-01,0,0,0,0,0,0
Somalia,2003-01-01,5,0,0,0,2,7
Somalia,2003-01-01,1,0,0,3,0,4
Somalia,2003-01-01,3,0,0,0,0,3
Somalia,2003-01-01,2,0,0,9,0,11
Somalia,2003-01-01,4,0,0,6,0,10
Somalia,2003-01-01,2,0,0,0,0,2
Somalia,2003-01-01,6,0,0,3,0,9
Somalia,2003-01-01,6,0,0,0,0,6
Somalia,2003-01-01,1,0,0,0,0,1
Somalia,2003-01-01,5,0,0,0,0,5
Somalia,2003-01-01,9,0,0,0,0,9
Somalia,2003-01-01,0,0,1,0,0,1
Somalia,2003-01-01,24,0,0,-6,0,18
Somalia,2003-01-01,0,0,0,0,0,0
Somalia,2003-01-01,4,0,-4,9,1,10
Somalia,2003-01-01,6,0,-4,9,0,11
Somalia,2003-01-01,1,0,0,0,0,1
Somalia,2003-01-01,0,0,0,0,2,2
Somalia,2003-01-01,7,0,0,0,0,7
Somalia,2003-01-01,3,0,0,0,0,3
Somalia,2003-01-01,-3,0,0,0,0,-3
Somalia,2003-01-01,5,0,0,3,0,8
Somalia,2003-01-01,9,0,0,3,0,12
Somalia,2003-01-01,1,0,0,3,2,6
Somalia,2003-01-01,9,0,0,0,6,15
Somalia,2003-01-01,5,0,0,0,0,5
Somalia,2003-02-01,0,0,0,0,0,0
Somalia,2003-02-01,8,0,0,9,0,17
Somalia,2003-02-01,-1,0,0,0,0,-1
Somalia,2003-02-01,0,0,0,0,0,0
Somalia,2003-02-01,0,0,0,0,0,0
Somalia,2003-02-01,0,0,0,0,0,0
Somalia,2003-02-01,-3,0,0,0,0,-3
Somalia,2003-02-01,8,0,0,0,0,8
Somalia,2003-02-01,3,0,0,1,0,4
Somalia,2003-02-01,2,0,0,0,1,3
Somalia,2003-02-01,0,0,0,0,0,0
Somalia,2003-02-01,1,0,0,0,0,1
Somalia,2003-02-01,5,0,0,0,0,5
Somalia,2003-02-01,1,0,0,0,0,1
Somalia,2003-02-01,0,0,0,0,0,0
Somalia,2003-02-01,7,0,0,0,0,7
Somalia,2003-02-01,6,4,0,9,2,21
Somalia,2003-02-01,3,0,0,6,0,9
Somalia,2003-02-01,0,0,0,0,0,0
Somalia,2003-02-01,2,0,0,0,0,2
Somalia,2003-02-01,2,0,0,0,0,2
Somalia,2003-02-01,0,0,0,0,0,0
Somalia,2003-02-01,0,0,0,3,0,3
Somalia,2003-02-01,3,2,0,0,0,5
Somalia,2003-02-01,0,0,0,0,0,0
Somalia,2003-02-01,0,0,0,0,0,0
Somalia,2003-02-01,2,0,0,0,0,2
Somalia,2003-03-01,0,0,-1,0,1,0
Somalia,2003-03-01,3,0,0,6,0,9
Somalia,2003-03-01,7,0,0,3,0,10
Somalia,2003-03-01,1,0,0,-6,0,-5
Somalia,2003-03-01,0,0,0,4,0,4
Somalia,2003-03-01,6,0,0,0,0,6
Somalia,2003-03-01,2,0,0,0,0,2
Somalia,2003-03-01,6,0,0,0,2,8
Somalia,2003-03-01,15,0,0,0,3,18
Somalia,2003-03-01,0,0,0,0,0,0
Somalia,2003-03-01,6,0,0,-2,0,4
Somalia,2003-03-01,2,0,0,0,0,2
Somalia,2003-03-01,0,0,0,3,3,6
Somalia,2003-03-01,12,0,0,-2,0,10
Somalia,2003-03-01,5,0,-2,0,0,3
Somalia,2003-03-01,0,0,0,0,0,0
Somalia,2003-03-01,6,0,0,0,0,6
Somalia,2003-03-01,2,0,0,-2,0,0
Somalia,2003-03-01,2,0,0,3,0,5
Somalia,2003-03-01,-10,0,0,-26,1,-35
Somalia,2003-03-01,0,0,0,0,0,0
Somalia,2003-03-01,0,0,0,3,0,3
Somalia,2003-03-01,9,0,0,0,0,9
Somalia,2003-03-01,0,0,0,0,0,0
Somalia,2003-03-01,2,0,0,0,0,2
Somalia,2003-03-01,3,0,0,0,0,3
Somalia,2003-03-01,5,0,0,0,2,7
Somalia,2003-03-01,9,0,0,0,0,9
Somalia,2003-03-01,6,0,0,-2,0,4
Somalia,2003-03-01,4,0,0,0,0,4
Somalia,2003-04-01,0,0,1,0,0,1
Somalia,2003-04-01,0,0,0,0,0,0
Somalia,2003-04-01,3,0,-3,7,1,8
Somalia,2003-04-01,0,0,0,3,0,3
Somalia,2003-04-01,6,0,0,0,0,6
Somalia,2003-04-01,-2,0,1,0,0,-1
Somalia,2003-04-01,6,0,0,0,0,6
Somalia,2003-04-01,1,0,1,0,0,2
Somalia,2003-04-01,7,0,0,0,0,7
Somalia,2003-04-01,0,0,0,9,3,12
Somalia,2003-04-01,0,0,0,0,0,0
Somalia,2003-04-01,1,0,0,0,0,1
Somalia,2003-04-01,2,0,1,0,1,4
Somalia,2003-04-01,5,0,0,0,0,5
Somalia,2003-04-01,-3,0,0,0,0,-3
Somalia,2003-04-01,0,0,0,0,2,2
Somalia,2003-04-01,0,0,0,0,0,0
Somalia,2003-04-01,0,0,0,0,0,0
Somalia,2003-04-01,0,0,0,0,0,0
Somalia,2003-04-01,0,0,0,0,0,0
Somalia,2003-04-01,-2,0,0,0,0,-2
Somalia,2003-04-01,1,0,0,0,0,1
Somalia,2003-04-01,0,0,0,6,1,7
Somalia,2003-04-01,1,0,0,0,0,1
Somalia,2003-04-01,-3,0,0,0,0,-3
Somalia,2003-05-01,0,0,2,0,0,2
Somalia,2003-05-01,8,0,0,0,0,8
Somalia,2003-05-01,0,0,0,0,0,0
Somalia,2003-05-01,9,0,1,0,0,10
Somalia,2003-05-01,0,0,0,0,3,3
Somalia,2003-05-01,0,0,0,0,0,0
Somalia,2003-05-01,6,0,0,-6,1,1
Somalia,2003-05-01,0,0,0,3,0,3
Somalia,2003-05-01,1,0,0,0,0,1
Somalia,2003-05-01,1,0,0,3,0,4
Somalia,2003-05-01,2,0,0,-6,0,-4
Somalia,2003-05-01,16,0,1,0,3,20
Somalia,2003-05-01,8,0,0,3,0,11
Somalia,2003-05-01,6,0,0,-6,0,0
Somalia,2003-05-01,3,0,0,0,1,4
Somalia,2003-05-01,12,0,0,-2,3,13
Somalia,2003-05-01,0,0,0,-1,0,-1
Somalia,2003-05-01,5,0,0,4,0,9
Somalia,2003-05-01,0,0,0,0,0,0
Somalia,2003-05-01,3,0,0,3,0,6
Somalia,2003-05-01,0,0,0,0,0,0
Somalia,2003-05-01,4,0,0,0,0,4
Somalia,2003-05-01,0,0,0,0,0,0
Somalia,2003-05-01,0,0,0,3,0,3
Somalia,2003-05-01,-1,0,0,0,0,-1
Somalia,2003-06-01,0,0,0,0,0,0
Somalia,2003-06-01,-2,0,0,0,0,-2
Somalia,2003-06-01,1,0,0,0,0,1
Somalia,2003-06-01,0,0,0,0,0,0
Somalia,2003-06-01,6,0,0,0,0,6
Somalia,2003-06-01,0,0,0,-6,0,-6
Somalia,2003-06-01,0,0,0,0,0,0
Somalia,2003-06-01,2,0,0,0,0,2
Somalia,2003-06-01,0,0,0,0,0,0
Somalia,2003-06-01,1,0,0,0,0,1
Somalia,2003-06-01,1,0,0,0,0,1
Somalia,2003-06-01,-3,0,0,0,0,-3
Somalia,2003-06-01,2,0,0,0,0,2
Somalia,2003-06-01,2,0,0,0,0,2
Somalia,2003-06-01,0,0,0,-2,0,-2
Somalia,2003-06-01,4,0,0,0,0,4
Somalia,2003-06-01,0,0,0,0,0,0
Somalia,2003-06-01,0,0,0,4,0,4
Somalia,2003-06-01,0,0,0,-4,0,-4
Somalia,2003-06-01,3,0,0,9,0,12
Somalia,2003-06-01,3,0,0,36,1,40
Somalia,2003-06-01,20,1,0,18,1,40
Somalia,2003-06-01,3,0,0,6,3,12
Somalia,2003-06-01,11,0,0,6,0,17
Somalia,2003-06-01,11,0,0,3,0,14
Somalia,2003-06-01,7,0,0,15,0,22
Somalia,2003-06-01,2,0,0,0,0,2
Somalia,2003-06-01,0,0,0,3,0,3
Somalia,2003-06-01,1,0,0,0,0,1
Somalia,2003-07-01,9,0,0,3,0,12
Somalia,2003-07-01,0,0,0,3,0,3
Somalia,2003-07-01,0,0,0,0,0,0
Somalia,2003-07-01,3,1,0,3,0,7
Somalia,2003-07-01,2,0,0,15,0,17
Somalia,2003-07-01,5,0,0,3,0,8
Somalia,2003-07-01,14,0,0,0,0,14
Somalia,2003-07-01,7,0,0,15,0,22
Somalia,2003-07-01,3,0,0,0,0,3
Somalia,2003-07-01,8,0,0,0,2,10
Somalia,2003-07-01,2,0,0,0,0,2
Somalia,2003-07-01,1,0,0,0,0,1
Somalia,2003-07-01,0,0,0,0,0,0
Somalia,2003-07-01,1,0,0,0,0,1
Somalia,2003-07-01,0,0,0,0,0,0
Somalia,2003-07-01,4,0,0,0,0,4
Somalia,2003-07-01,3,0,0,0,0,3
Somalia,2003-07-01,15,0,0,0,0,15
Somalia,2003-07-01,0,0,0,0,0,0
Somalia,2003-07-01,5,0,0,0,0,5
Somalia,2003-07-01,2,0,0,0,2,4
Somalia,2003-07-01,0,0,0,0,0,0
Somalia,2003-07-01,6,0,0,0,0,6
Somalia,2003-07-01,13,0,0,0,0,13
Somalia,2003-07-01,13,0,0,0,0,13
Somalia,2003-07-01,0,0,0,0,0,0
Somalia,2003-07-01,10,0,0,0,0,10
Somalia,2003-07-01,5,0,0,0,1,6
Somalia,2003-07-01,2,0,1,0,0,3
Somalia,2003-08-01,0,0,0,0,0,0
Somalia,2003-08-01,0,0,0,0,0,0
Somalia,2003-08-01,9,0,0,6,0,15
Somalia,2003-08-01,4,0,0,1,0,5
Somalia,2003-08-01,5,0,0,9,0,14
Somalia,2003-08-01,16,0,0,0,0,16
Somalia,2003-08-01,8,0,0,0,0,8
Somalia,2003-08-01,10,0,0,0,0,10
Somalia,2003-08-01,3,0,0,0,0,3
Somalia,2003-08-01,2,0,0,7,0,9
Somalia,2003-08-01,0,0,0,0,0,0
Somalia,2003-08-01,4,0,0,0,0,4
Somalia,2003-08-01,7,0,0,0,0,7
Somalia,2003-08-01,0,0,0,-2,0,-2
Somalia,2003-08-01,0,0,0,0,0,0
Somalia,2003-08-01,0,0,0,0,0,0
Somalia,2003-08-01,-1,0,0,0,3,2
Somalia,2003-08-01,0,0,0,0,0,0
Somalia,2003-08-01,6,0,0,6,0,12
Somalia,2003-08-01,5,0,0,2,0,7
Somalia,2003-08-01,6,0,0,-2,1,5
Somalia,2003-08-01,0,0,0,-4,1,-3
Somalia,2003-08-01,0,0,0,0,0,0
Somalia,2003-08-01,0,0,0,0,0,0
Somalia,2003-08-01,0,0,0,3,0,3
Somalia,2003-08-01,1,0,0,-1,0,0
Somalia,2003-08-01,0,0,0,0,0,0
Somalia,2003-08-01,0,0,0,0,0,0
Somalia,2003-08-01,0,0,0,0,0,0
Somalia,2003-08-01,0,0,0,3,0,3
Somalia,2003-09-01,1,0,0,9,0,10
Somalia,2003-09-01,2,0,0,0,0,2
Somalia,2003-09-01,2,0,0,0,0,2
Somalia,2003-09-01,18,2,0,-4,0,16
Somalia,2003-09-01,4,0,0,0,0,4
Somalia,2003-09-01,0,0,-1,0,0,-1
Somalia,2003-09-01,18,0,0,0,0,18
Somalia,2003-09-01,0,0,0,0,0,0
Somalia,2003-09-01,0,0,0,0,0,0
Somalia,2003-09-01,0,0,0,0,0,0
Somalia,2003-09-01,0,0,0,0,0,0
Somalia,2003-09-01,7,0,0,0,0,7
Somalia,2003-09-01,14,0,0,0,2,16
Somalia,2003-09-01,0,0,0,0,0,0
Somalia,2003-09-01,6,0,0,0,2,8
Somalia,2003-09-01,9,0,0,0,0,9
Somalia,2003-09-01,1,0,0,0,0,1
Somalia,2003-09-01,0,0,0,9,0,9
Somalia,2003-09-01,2,0,0,0,0,2
Somalia,2003-09-01,0,0,0,0,0,0
Somalia,2003-09-01,7,0,0,0,0,7
Somalia,2003-09-01,16,0,0,0,1,17
Somalia,2003-09-01,15,0,0,0,1,16
Somalia,2003-09-01,6,0,0,0,0,6
Somalia,2003-09-01,0,0,0,0,0,0
Somalia,2003-09-01,-7,0,0,0,2,-5
Somalia,2003-09-01,7,0,1,0,0,8
Somalia,2003-10-01,0,0,0,0,0,0
Somalia,2003-10-01,2,0,0,0,0,2
Somalia,2003-10-01,0,0,0,3,0,3
Somalia,2003-10-01,-3,0,0,0,0,-3
Somalia,2003-10-01,9,0,0,0,0,9
Somalia,2003-10-01,39,0,0,0,0,39
Somalia,2003-10-01,6,0,0,0,0,6
Somalia,2003-10-01,5,0,0,3,0,8
Somalia,2003-10-01,9,0,0,0,0,9
Somalia,2003-10-01,0,0,0,0,0,0
Somalia,2003-10-01,4,0,0,0,0,4
Somalia,2003-10-01,0,0,0,0,0,0
Somalia,2003-10-01,0,0,0,0,0,0
Somalia,2003-10-01,0,0,0,3,0,3
Somalia,2003-10-01,0,0,0,0,1,1
Somalia,2003-10-01,0,0,0,0,0,0
Somalia,2003-10-01,18,0,0,0,0,18
Somalia,2003-10-01,16,0,0,0,0,16
Somalia,2003-10-01,-1,0,0,0,1,0
Somalia,2003-10-01,0,0,0,0,0,0
Somalia,2003-10-01,4,0,0,0,0,4
Somalia,2003-10-01,6,0,0,3,3,12
Somalia,2003-10-01,-6,0,0,0,0,-6
Somalia,2003-10-01,0,0,0,0,0,0
Somalia,2003-10-01,12,0,0,0,0,12
Somalia,2003-10-01,5,0,0,6,0,11
Somalia,2003-10-01,16,0,0,27,0,43
Somalia,2003-10-01,0,0,0,-2,0,-2
Somalia,2003-10-01,10,0,0,0,0,10
Somalia,2003-11-01,6,0,0,0,0,6
Somalia,2003-11-01,2,0,0,-2,0,0
Somalia,2003-11-01,6,0,0,0,0,6
Somalia,2003-11-01,-3,0,0,0,0,-3
Somalia,2003-11-01,6,0,0,0,0,6
Somalia,2003-11-01,9,0,0,24,0,33
Somalia,2003-11-01,4,0,0,0,0,4
Somalia,2003-11-01,0,0,0,0,0,0
Somalia,2003-11-01,0,0,0,0,0,0
Somalia,2003-11-01,3,0,0,0,0,3
Somalia,2003-11-01,0,0,0,9,0,9
Somalia,2003-11-01,0,0,0,0,0,0
Somalia,2003-11-01,0,0,0,0,0,0
Somalia,2003-11-01,12,0,0,0,0,12
Somalia,2003-11-01,3,0,0,0,0,3
Somalia,2003-11-01,0,0,0,0,0,0
Somalia,2003-11-01,0,0,0,0,0,0
Somalia,2003-11-01,7,0,1,0,1,9
Somalia,2003-11-01,0,0,0,0,0,0
Somalia,2003-11-01,2,0,0,0,0,2
Somalia,2003-11-01,0,0,0,-4,0,-4
Somalia,2003-11-01,3,0,0,0,0,3
Somalia,2003-11-01,10,0,-4,4,0,10
Somalia,2003-11-01,4,0,-6,3,0,1
Somalia,2003-11-01,2,0,0,0,0,2
Somalia,2003-11-01,-1,0,0,9,0,8
Somalia,2003-11-01,-3,0,0,3,0,0
Somalia,2003-11-01,11,0,0,9,0,20
Somalia,2003-12-01,3,2,0,0,1,6
Somalia,2003-12-01,2,0,0,2,0,4
Somalia,2003-12-01,4,0,0,0,0,4
Somalia,2003-12-01,0,0,0,-2,0,-2
Somalia,2003-12-01,0,0,0,0,0,0
Somalia,2003-12-01,0,0,0,0,0,0
Somalia,2003-12-01,0,2,0,0,0,2
Somalia,2003-12-01,8,0,1,3,0,12
Somalia,2003-12-01,8,0,0,0,0,8
Somalia,2003-12-01,0,0,0,0,0,0
Somalia,2003-12-01,0,0,0,0,0,0
Somalia,2003-12-01,7,0,0,6,0,13
Somalia,2003-12-01,0,0,0,0,0,0
Somalia,2003-12-01,0,0,0,0,0,0
Somalia,2003-12-01,0,0,0,0,0,0
Somalia,2003-12-01,0,0,0,6,0,6
Somalia,2003-12-01,0,0,0,0,0,0
Somalia,2003-12-01,2,0,0,0,0,2
Somalia,2003-12-01,0,0,0,0,0,0
Somalia,2003-12-01,0,0,0,0,0,0
Somalia,2003-12-01,1,0,0,0,0,1
Somalia,2003-12-01,0,0,0,-4,0,-4
Somalia,2003-12-01,3,0,0,0,0,3
Somalia,2003-12-01,5,0,0,0,0,5
Somalia,2003-12-01,6,0,0,0,0,6
Somalia,2003-12-01,0,0,0,0,0,0
Syria,2003-01-01,0,0,0,0,0,0
Syria,2003-01-01,-1,0,0,0,0,-1
Syria,2003-01-01,1,0,0,0,0,1
Syria,2003-01-01,-1,0,0,0,0,-1
Syria,2003-01-01,2,0,0,19,0,21
Syria,2003-01-01,0,0,0,0,0,0
Syria,2003-01-01,2,0,0,0,0,2
Syria,2003-01-01,0,0,0,0,0,0
Syria,2003-01-01,3,0,0,10,0,13
Syria,2003-01-01,9,0,0,12,0,21
Syria,2003-01-01,4,0,0,0,0,4
Syria,2003-01-01,-1,0,0,0,0,-1
Syria,2003-01-01,3,0,0,-5,0,-2
Syria,2003-01-01,6,0,0,0,6,12
Syria,2003-01-01,2,0,2,0,0,4
Syria,2003-01-01,8,0,0,0,0,8
Syria,2003-01-01,0,0,0,0,2,2
Syria,2003-01-01,-35,0,0,6,1,-28
Syria,2003-01-01,5,0,0,0,0,5
Syria,2003-01-01,0,0,0,0,0,0
Syria,2003-01-01,7,0,1,0,0,8
Syria,2003-01-01,3,0,0,0,0,3
Syria,2003-01-01,7,0,0,0,0,7
Syria,2003-01-01,4,0,0,0,0,4
Syria,2003-01-01,4,0,0,0,0,4
Syria,2003-01-01,0,0,0,6,0,6
Syria,2003-01-01,9,0,0,0,0,9
Syria,2003-01-01,2,0,0,4,0,6
Syria,2003-01-01,3,0,0,4,0,7
Syria,2003-01-01,4,0,0,3,0,7
Syria,2003-01-01,-2,0,0,0,1,-1
Syria,2003-02-01,2,0,0,6,0,8
Syria,2003-02-01,2,0,0,0,0,2
Syria,2003-02-01,10,0,0,0,0,10
Syria,2003-02-01,2,0,0,6,0,8
Syria,2003-02-01,6,0,0,0,0,6
Syria,2003-02-01,0,0,0,6,0,6
Syria,2003-02-01,2,0,0,-6,1,-3
Syria,2003-02-01,0,0,0,0,0,0
Syria,2003-02-01,0,0,0,0,1,1
Syria,2003-02-01,2,0,0,0,0,2
Syria,2003-02-01,4,0,0,0,0,4
Syria,2003-02-01,0,0,0,0,0,0
Syria,2003-02-01,0,0,1,0,0,1
Syria,2003-02-01,4,0,0,0,0,4
Syria,2003-02-01,1,0,0,0,0,1
Syria,2003-02-01,3,0,0,0,0,3
Syria,2003-02-01,0,0,0,0,0,0
Syria,2003-02-01,2,0,0,0,0,2
Syria,2003-02-01,0,0,0,3,0,3
Syria,2003-02-01,21,0,-2,6,2,27
Syria,2003-02-01,6,0,0,2,4,12
Syria,2003-02-01,0,0,0,0,0,0
Syria,2003-02-01,2,0,0,0,0,2
Syria,2003-02-01,12,2,0,0,0,14
Syria,2003-02-01,18,0,0,0,0,18
Syria,2003-02-01,2,0,0,0,0,2
Syria,2003-02-01,15,0,0,0,0,15
Syria,2003-02-01,15,0,0,0,3,18
Syria,2003-03-01,-1,0,0,0,0,-1
Syria,2003-03-01,4,0,0,0,1,5
Syria,2003-03-01,7,0,0,-2,2,7
Syria,2003-03-01,0,0,0,0,1,1
Syria,2003-03-01,3,0,0,6,3,12
Syria,2003-03-01,8,0,0,6,2,16
Syria,2003-03-01,4,0,0,3,1,8
Syria,2003-03-01,25,0,0,-4,3,24
Syria,2003-03-01,6,0,0,0,0,6
Syria,2003-03-01,14,0,0,0,0,14
Syria,2003-03-01,-1,0,0,-4,0,-5
Syria,2003-03-01,11,0,0,0,2,13
Syria,2003-03-01,9,0,0,3,0,12
Syria,2003-03-01,5,0,-1,0,0,4
Syria,2003-03-01,6,0,0,0,0,6
Syria,2003-03-01,13,0,0,0,0,13
Syria,2003-03-01,14,0,0,0,0,14
Syria,2003-03-01,9,0,0,0,2,11
Syria,2003-03-01,11,0,0,-1,0,10
Syria,2003-03-01,2,0,0,0,2,4
Syria,2003-03-01,1,0,0,0,0,1
Syria,2003-03-01,1,0,0,12,1,14
Syria,2003-03-01,6,0,0,-18,4,-8
Syria,2003-03-01,49,0,0,0,2,51
Syria,2003-03-01,15,0,0,-2,0,13
Syria,2003-03-01,1,0,0,0,0,1
Syria,2003-03-01,5,0,0,0,0,5
Syria,2003-03-01,6,0,0,3,4,13
Syria,2003-03-01,27,0,1,0,0,28
Syria,2003-03-01,9,0,0,0,0,9
Syria,2003-03-01,6,0,0,3,0,9
Syria,2003-04-01,19,0,0,9,3,31
Syria,2003-04-01,25,0,-6,12,6,37
Syria,2003-04-01,8,0,0,0,0,8
Syria,2003-04-01,9,0,0,6,0,15
Syria,2003-04-01,20,0,0,7,0,27
Syria,2003-04-01,29,0,0,3,4,36
Syria,2003-04-01,25,0,0,3,6,34
Syria,2003-04-01,17,0,-6,12,0,23
Syria,2003-04-01,30,0,4,0,0,34
Syria,2003-04-01,40,0,0,-2,0,38
Syria,2003-04-01,21,0,-1,15,4,39
Syria,2003-04-01,56,0,0,15,6,77
Syria,2003-04-01,76,0,0,12,0,88
Syria,2003-04-01,76,0,0,8,9,93
Syria,2003-04-01,67,0,-2,3,4,72
Syria,2003-04-01,42,0,0,-2,1,41
Syria,2003-04-01,12,0,0,8,5,25
Syria,2003-04-01,29,0,2,10,1,42
Syria,2003-04-01,38,2,2,3,2,47
Syria,2003-04-01,5,0,0,-2,4,7
Syria,2003-04-01,27,0,0,8,0,35
Syria,2003-04-01,18,0,-2,3,2,21
Syria,2003-04-01,10,0,0,0,0,10
Syria,2003-04-01,17,0,0,0,1,18
Syria,2003-04-01,7,0,0,3,0,10
Syria,2003-04-01,3,0,0,0,0,3
Syria,2003-04-01,6,0,0,0,0,6
Syria,2003-04-01,6,0,0,5,0,11
Syria,2003-04-01,11,0,0,5,0,16
Syria,2003-04-01,9,0,0,2,0,11
Syria,2003-05-01,10,0,0,0,0,10
Syria,2003-05-01,2,0,0,0,0,2
Syria,2003-05-01,13,0,0,9,0,22
Syria,2003-05-01,11,0,0,3,0,14
Syria,2003-05-01,5,0,0,1,1,7
Syria,2003-05-01,1,0,0,0,0,1
Syria,2003-05-01,0,0,0,3,0,3
Syria,2003-05-01,3,0,-2,0,0,1
Syria,2003-05-01,7,0,0,6,0,13
Syria,2003-05-01,5,0,1,3,0,9
Syria,2003-05-01,2,0,0,3,4,9
Syria,2003-05-01,13,0,0,0,0,13
Syria,2003-05-01,4,0,0,0,0,4
Syria,2003-05-01,9,0,0,0,0,9
Syria,2003-05-01,17,0,0,0,0,17
Syria,2003-05-01,3,0,0,6,0,9
Syria,2003-05-01,4,0,0,0,0,4
Syria,2003-05-01,12,0,0,0,0,12
Syria,2003-05-01,0,0,0,0,2,2
Syria,2003-05-01,7,0,0,0,1,8
Syria,2003-05-01,19,0,0,0,2,21
Syria,2003-05-01,21,0,0,3,2,26
Syria,2003-05-01,12,0,0,6,1,19
Syria,2003-05-01,6,0,0,2,0,8
Syria,2003-05-01,-1,0,0,0,0,-1
Syria,2003-05-01,1,0,0,-8,0,-7
Syria,2003-05-01,-11,0,0,7,2,-2
Syria,2003-05-01,0,0,0,24,2,26
Syria,2003-05-01,2,0,0,9,0,11
Syria,2003-05-01,23,0,0,6,0,29
Syria,2003-05-01,19,0,0,0,0,19
Syria,2003-06-01,0,0,0,0,2,2
Syria,2003-06-01,0,0,0,0,0,0
Syria,2003-06-01,7,0,0,0,0,7
Syria,2003-06-01,-1,0,0,15,0,14
Syria,2003-06-01,7,0,0,0,0,7
Syria,2003-06-01,-2,0,2,12,0,12
Syria,2003-06-01,0,0,0,5,0,5
Syria,2003-06-01,0,0,0,0,0,0
Syria,2003-06-01,10,0,0,0,8,18
Syria,2003-06-01,1,0,0,0,0,1
Syria,2003-06-01,0,0,0,0,0,0
Syria,2003-06-01,8,0,0,12,0,20
Syria,2003-06-01,4,0,0,13,5,22
Syria,2003-06-01,6,0,0,0,4,10
Syria,2003-06-01,12,0,0,-4,0,8
Syria,2003-06-01,-1,0,0,1,0,0
Syria,2003-06-01,7,0,0,3,0,10
Syria,2003-06-01,11,0,0,4,0,15
Syria,2003-06-01,3,0,0,0,0,3
Syria,2003-06-01,1,0,0,0,0,1
Syria,2003-06-01,5,0,0,0,0,5
Syria,2003-06-01,-7,0,0,3,0,-4
Syria,2003-06-01,18,0,0,3,0,21
Syria,2003-06-01,42,0,1,5,0,48
Syria,2003-06-01,29,0,0,0,1,30
Syria,2003-06-01,1,0,0,15,0,16
Syria,2003-06-01,0,0,0,0,0,0
Syria,2003-06-01,17,0,0,-2,0,15
Syria,2003-06-01,10,0,0,0,0,10
Syria,2003-06-01,6,0,0,9,0,15
Syria,2003-07-01,2,0,0,10,0,12
Syria,2003-07-01,5,0,0,0,0,5
Syria,2003-07-01,19,0,0,0,0,19
Syria,2003-07-01,3,0,0,0,0,3
Syria,2003-07-01,5,0,1,3,0,9
Syria,2003-07-01,0,0,0,0,0,0
Syria,2003-07-01,5,0,0,9,0,14
Syria,2003-07-01,3,0,0,3,2,8
Syria,2003-07-01,2,0,0,0,0,2
Syria,2003-07-01,19,0,0,0,0,19
Syria,2003-07-01,4,0,0,0,0,4
Syria,2003-07-01,8,0,0,0,0,8
Syria,2003-07-01,2,0,0,6,0,8
Syria,2003-07-01,0,0,0,9,0,9
Syria,2003-07-01,-15,0,0,-2,0,-17
Syria,2003-07-01,-16,0,1,-2,0,-17
Syria,2003-07-01,2,0,0,0,0,2
Syria,2003-07-01,10,0,0,3,0,13
Syria,2003-07-01,4,0,0,-2,0,2
Syria,2003-07-01,2,0,1,0,0,3
Syria,2003-07-01,6,0,0,0,0,6
Syria,2003-07-01,10,0,0,4,0,14
Syria,2003-07-01,12,0,0,6,0,18
Syria,2003-07-01,3,0,1,0,0,4
Syria,2003-07-01,2,0,0,3,0,5
Syria,2003-07-01,0,0,0,0,0,0
Syria,2003-07-01,1,0,0,0,0,1
Syria,2003-07-01,-3,0,0,0,0,-3
Syria,2003-07-01,6,0,0,0,0,6
Syria,2003-07-01,2,0,0,12,0,14
Syria,2003-07-01,2,0,-1,0,0,1
Syria,2003-08-01,3,0,0,0,0,3
Syria,2003-08-01,0,0,0,0,0,0
Syria,2003-08-01,6,0,0,0,0,6
Syria,2003-08-01,3,0,0,0,0,3
Syria,2003-08-01,3,2,-4,0,2,3
Syria,2003-08-01,4,0,0,0,0,4
Syria,2003-08-01,10,0,0,9,0,19
Syria,2003-08-01,14,0,0,9,0,23
Syria,2003-08-01,5,0,0,6,2,13
Syria,2003-08-01,78,0,0,12,0,90
Syria,2003-08-01,9,0,0,0,2,11
Syria,2003-08-01,2,0,0,3,0,5
Syria,2003-08-01,12,0,0,14,0,26
Syria,2003-08-01,14,0,0,18,0,32
Syria,2003-08-01,2,0,0,3,4,9
Syria,2003-08-01,14,0,0,2,2,18
Syria,2003-08-01,11,0,0,0,0,11
Syria,2003-08-01,-1,0,0,3,0,2
Syria,2003-08-01,1,0,0,3,0,4
Syria,2003-08-01,12,0,0,0,0,12
Syria,2003-08-01,9,0,0,0,0,9
Syria,2003-08-01,26,0,0,1,2,29
Syria,2003-08-01,1,0,0,0,0,1
Syria,2003-08-01,-5,0,0,0,0,-5
Syria,2003-08-01,1,0,0,0,0,1
Syria,2003-08-01,2,0,0,-6,0,-4
Syria,2003-08-01,1,0,0,3,0,4
Syria,2003-08-01,5,0,0,18,0,23
Syria,2003-08-01,8,0,0,3,0,11
Syria,2003-08-01,7,0,0,6,0,13
Syria,2003-08-01,7,0,0,0,1,8
Syria,2003-09-01,6,0,0,0,3,9
Syria,2003-09-01,8,0,0,17,0,25
Syria,2003-09-01,0,0,0,0,0,0
Syria,2003-09-01,1,0,0,3,1,5
Syria,2003-09-01,-2,0,0,4,0,2
Syria,2003-09-01,2,0,0,6,0,8
Syria,2003-09-01,2,0,0,10,0,12
Syria,2003-09-01,25,0,1,2,3,31
Syria,2003-09-01,12,0,0,4,0,16
Syria,2003-09-01,8,0,3,6,0,17
Syria,2003-09-01,6,2,0,3,0,11
Syria,2003-09-01,10,0,0,12,0,22
Syria,2003-09-01,0,0,0,0,0,0
Syria,2003-09-01,-3,0,0,6,0,3
Syria,2003-09-01,0,0,0,12,2,14
Syria,2003-09-01,3,0,0,3,0,6
Syria,2003-09-01,11,0,0,4,0,15
Syria,2003-09-01,8,0,0,33,1,42
Syria,2003-09-01,0,0,0,15,0,15
Syria,2003-09-01,5,0,0,9,0,14
Syria,2003-09-01,6,0,0,0,0,6
Syria,2003-09-01,5,0,0,3,0,8
Syria,2003-09-01,0,2,0,15,2,19
Syria,2003-09-01,3,0,0,48,0,51
Syria,2003-09-01,11,0,0,15,1,27
Syria,2003-09-01,1,0,0,11,0,12
Syria,2003-09-01,0,0,0,0,3,3
Syria,2003-09-01,0,0,1,9,0,10
Syria,2003-09-01,23,0,-2,6,0,27
Syria,2003-09-01,5,0,1,43,0,49
Syria,2003-10-01,2,0,1,15,0,18
Syria,2003-10-01,3,0,0,0,0,3
Syria,2003-10-01,4,0,0,0,2,6
Syria,2003-10-01,9,0,0,0,2,11
Syria,2003-10-01,94,2,0,-3,0,93
Syria,2003-10-01,73,0,0,-2,5,76
Syria,2003-10-01,58,0,2,17,3,80
Syria,2003-10-01,43,0,0,13,0,56
Syria,2003-10-01,32,0,0,6,7,45
Syria,2003-10-01,9,0,0,6,5,20
Syria,2003-10-01,15,0,0,6,2,23
Syria,2003-10-01,10,0,0,0,0,10
Syria,2003-10-01,16,0,0,6,0,22
Syria,2003-10-01,7,2,0,6,0,15
Syria,2003-10-01,35,0,0,6,0,41
Syria,2003-10-01,18,0,0,0,0,18
Syria,2003-10-01,15,0,0,3,4,22
Syria,2003-10-01,9,0,0,3,1,13
Syria,2003-10-01,3,0,0,0,0,3
Syria,2003-10-01,4,0,0,-8,0,-4
Syria,2003-10-01,2,0,2,0,0,4
Syria,2003-10-01,9,0,0,0,1,10
Syria,2003-10-01,12,4,0,0,0,16
Syria,2003-10-01,4,0,0,13,0,17
Syria,2003-10-01,0,0,0,3,1,4
Syria,2003-10-01,2,0,0,7,0,9
Syria,2003-10-01,25,0,0,0,0,25
Syria,2003-10-01,45,0,0,3,2,50
Syria,2003-10-01,11,0,0,0,4,15
Syria,2003-10-01,23,0,0,-1,0,22
Syria,2003-10-01,11,0,0,-1,0,10
Syria,2003-11-01,6,0,0,3,0,9
Syria,2003-11-01,6,0,0,4,0,10
Syria,2003-11-01,0,0,0,0,0,0
Syria,2003-11-01,-1,0,1,1,3,4
Syria,2003-11-01,9,0,0,4,0,13
Syria,2003-11-01,16,0,0,16,0,32
Syria,2003-11-01,5,0,0,19,0,24
Syria,2003-11-01,19,0,0,3,0,22
Syria,2003-11-01,5,0,0,3,0,8
Syria,2003-11-01,2,0,0,9,0,11
Syria,2003-11-01,2,0,0,9,0,11
Syria,2003-11-01,13,0,0,2,0,15
Syria,2003-11-01,37,0,0,18,1,56
Syria,2003-11-01,0,0,0,0,3,3
Syria,2003-11-01,0,0,0,-6,0,-6
Syria,2003-11-01,5,0,0,3,0,8
Syria,2003-11-01,14,0,-1,0,0,13
Syria,2003-11-01,3,0,0,15,2,20
Syria,2003-11-01,0,2,0,19,0,21
Syria,2003-11-01,10,0,0,15,0,25
Syria,2003-11-01,0,0,0,0,0,0
Syria,2003-11-01,7,0,0,0,0,7
Syria,2003-11-01,8,0,0,0,0,8
Syria,2003-11-01,9,0,0,3,0,12
Syria,2003-11-01,0,0,0,10,0,10
Syria,2003-11-01,6,0,0,0,0,6
Syria,2003-11-01,3,0,0,6,0,9
Syria,2003-11-01,1,0,0,15,3,19
Syria,2003-11-01,0,0,0,0,0,0
Syria,2003-11-01,1,0,0,5,10,16
Syria,2003-12-01,3,0,0,-8,0,-5
Syria,2003-12-01,10,0,0,-10,0,0
Syria,2003-12-01,7,0,0,19,0,26
Syria,2003-12-01,2,0,0,19,0,21
Syria,2003-12-01,3,0,0,3,0,6
Syria,2003-12-01,7,0,0,0,0,7
Syria,2003-12-01,15,0,0,3,3,21
Syria,2003-12-01,3,0,-2,8,0,9
Syria,2003-12-01,13,0,0,0,0,13
Syria,2003-12-01,1,0,1,6,0,8
Syria,2003-12-01,12,0,0,6,0,18
Syria,2003-12-01,0,0,0,0,0,0
Syria,2003-12-01,3,0,-2,3,2,6
Syria,2003-12-01,9,0,0,6,0,15
Syria,2003-12-01,3,0,0,3,0,6
Syria,2003-12-01,20,0,0,6,0,26
Syria,2003-12-01,20,0,0,0,0,20
Syria,2003-12-01,2,0,0,12,0,14
Syria,2003-12-01,0,0,0,18,0,18
Syria,2003-12-01,0,0,0,3,0,3
Syria,2003-12-01,0,0,0,3,0,3
Syria,2003-12-01,5,0,0,0,0,5
Syria,2003-12-01,11,0,0,9,0,20
Syria,2003-12-01,22,0,0,-3,1,20
Syria,2003-12-01,0,0,0,0,0,0
Syria,2003-12-01,6,0,0,6,3,15
Syria,2003-12-01,1,0,0,3,0,4
Syria,2003-12-01,-1,0,0,-2,0,-3
Syria,2003-12-01,7,0,0,0,0,7
Syria,2003-12-01,0,0,1,0,0,1
Syria,2003-12-01,5,0,0,0,0,5
Yemen,2003-01-01,3,0,0,-1,0,2
Yemen,2003-01-01,3,0,0,3,0,6
Yemen,2003-01-01,0,0,0,0,0,0
Yemen,2003-01-01,2,0,0,0,1,3
Yemen,2003-01-01,0,0,0,0,0,0
Yemen,2003-01-01,3,0,0,0,0,3
Yemen,2003-01-01,20,0,0,9,0,29
Yemen,2003-01-01,2,0,0,0,0,2
Yemen,2003-01-01,24,0,0,9,0,33
Yemen,2003-01-01,4,0,0,27,1,32
Yemen,2003-01-01,6,0,0,22,0,28
Yemen,2003-01-01,8,0,0,3,0,11
Yemen,2003-01-01,8,0,0,12,0,20
Yemen,2003-01-01,4,0,0,1,0,5
Yemen,2003-01-01,0,0,0,9,0,9
Yemen,2003-01-01,0,0,0,0,0,0
Yemen,2003-01-01,3,2,0,0,5,10
Yemen,2003-01-01,7,0,0,12,0,19
Yemen,2003-01-01,1,0,0,0,0,1
Yemen,2003-01-01,17,0,0,19,0,36
Yemen,2003-01-01,13,0,0,6,0,19
Yemen,2003-01-01,5,0,0,1,0,6
Yemen,2003-01-01,11,0,0,4,0,15
Yemen,2003-01-01,3,0,0,9,3,15
Yemen,2003-01-01,1,0,0,0,0,1
Yemen,2003-01-01,0,0,0,3,0,3
Yemen,2003-01-01,0,0,0,18,2,20
Yemen,2003-01-01,0,0,0,0,0,0
Yemen,2003-01-01,0,0,0,0,0,0
Yemen,2003-01-01,0,0,0,-4,0,-4
Yemen,2003-01-01,0,0,0,0,1,1
Yemen,2003-02-01,0,0,0,3,0,3
Yemen,2003-02-01,0,0,0,0,0,0
Yemen,2003-02-01,0,0,0,6,0,6
Yemen,2003-02-01,0,0,0,0,0,0
Yemen,2003-02-01,6,0,0,3,0,9
Yemen,2003-02-01,9,0,0,0,9,18
Yemen,2003-02-01,0,0,0,0,2,2
Yemen,2003-02-01,0,0,0,6,0,6
Yemen,2003-02-01,0,0,0,0,0,0
Yemen,2003-02-01,0,0,0,-1,0,-1
Yemen,2003-02-01,9,0,0,9,0,18
Yemen,2003-02-01,6,0,0,0,0,6
Yemen,2003-02-01,0,0,0,6,0,6
Yemen,2003-02-01,1,0,0,4,0,5
Yemen,2003-02-01,5,0,0,-1,0,4
Yemen,2003-02-01,0,2,0,0,0,2
Yemen,2003-02-01,0,0,0,3,0,3
Yemen,2003-02-01,6,0,0,0,4,10
Yemen,2003-02-01,-1,0,0,0,0,-1
Yemen,2003-02-01,12,0,0,0,0,12
Yemen,2003-02-01,6,0,0,0,0,6
Yemen,2003-02-01,7,0,-2,0,2,7
Yemen,2003-02-01,5,0,0,6,0,11
Yemen,2003-02-01,-3,0,0,0,0,-3
Yemen,2003-02-01,23,0,0,0,4,27
Yemen,2003-03-01,2,0,0,0,0,2
Yemen,2003-03-01,3,0,0,0,3,6
Yemen,2003-03-01,4,0,0,0,0,4
Yemen,2003-03-01,14,4,1,7,0,26
Yemen,2003-03-01,5,0,0,3,0,8
Yemen,2003-03-01,3,0,2,0,0,5
Yemen,2003-03-01,8,0,0,0,0,8
Yemen,2003-03-01,0,0,0,3,6,9
Yemen,2003-03-01,0,0,0,3,3,6
Yemen,2003-03-01,0,0,0,0,0,0
Yemen,2003-03-01,0,0,0,3,0,3
Yemen,2003-03-01,3,0,1,6,3,13
Yemen,2003-03-01,7,0,0,0,1,8
Yemen,2003-03-01,0,0,0,3,0,3
Yemen,2003-03-01,1,0,0,0,0,1
Yemen,2003-03-01,0,0,0,0,0,0
Yemen,2003-03-01,22,0,0,0,0,22
Yemen,2003-03-01,16,0,0,6,2,24
Yemen,2003-03-01,0,0,0,2,0,2
Yemen,2003-03-01,23,0,0,6,8,37
Yemen,2003-03-01,17,0,0,3,1,21
Yemen,2003-03-01,7,0,0,3,2,12
Yemen,2003-03-01,4,0,0,3,0,7
Yemen,2003-03-01,5,0,0,15,0,20
Yemen,2003-03-01,1,0,0,3,0,4
Yemen,2003-03-01,1,0,0,6,4,11
Yemen,2003-03-01,24,0,0,3,0,27
Yemen,2003-03-01,1,0,0,0,2,3
Yemen,2003-03-01,0,0,0,0,0,0
Yemen,2003-03-01,4,0,0,0,0,4
Yemen,2003-04-01,0,0,0,15,0,15
Yemen,2003-04-01,4,2,0,0,0,6
Yemen,2003-04-01,0,0,0,0,0,0
Yemen,2003-04-01,15,0,0,10,0,25
Yemen,2003-04-01,1,0,0,0,0,1
Yemen,2003-04-01,0,0,0,0,0,0
Yemen,2003-04-01,1,0,0,0,2,3
Yemen,2003-04-01,0,0,0,0,0,0
Yemen,2003-04-01,1,0,0,0,0,1
Yemen,2003-04-01,5,0,0,3,0,8
Yemen,2003-04-01,10,0,0,2,0,12
Yemen,2003-04-01,5,0,0,0,0,5
Yemen,2003-04-01,0,0,0,0,0,0
Yemen,2003-04-01,8,0,0,3,1,12
Yemen,2003-04-01,0,0,0,3,0,3
Yemen,2003-04-01,0,0,0,3,0,3
Yemen,2003-04-01,0,0,0,3,0,3
Yemen,2003-04-01,2,0,0,0,2,4
Yemen,2003-04-01,5,0,0,3,0,8
Yemen,2003-04-01,9,0,0,0,0,9
Yemen,2003-04-01,0,0,0,3,0,3
Yemen,2003-04-01,2,0,0,4,0,6
Yemen,2003-04-01,6,0,0,0,0,6
Yemen,2003-04-01,5,0,0,0,0,5
Yemen,2003-04-01,0,0,0,0,0,0
Yemen,2003-04-01,5,0,0,0,0,5
Yemen,2003-05-01,14,0,0,0,0,14
Yemen,2003-05-01,0,0,0,3,3,6
Yemen,2003-05-01,20,0,0,-2,0,18
Yemen,2003-05-01,0,0,0,0,0,0
Yemen,2003-05-01,2,0,0,0,0,2
Yemen,2003-05-01,0,0,0,0,0,0
Yemen,2003-05-01,0,0,2,0,0,2
Yemen,2003-05-01,0,0,0,3,0,3
Yemen,2003-05-01,8,0,0,10,1,19
Yemen,2003-05-01,0,0,0,0,0,0
Yemen,2003-05-01,6,0,0,0,0,6
Yemen,2003-05-01,10,0,0,9,6,25
Yemen,2003-05-01,1,0,0,0,1,2
Yemen,2003-05-01,9,0,0,21,0,30
Yemen,2003-05-01,30,0,0,21,0,51
Yemen,2003-05-01,12,0,0,12,0,24
Yemen,2003-05-01,6,0,0,9,6,21
Yemen,2003-05-01,6,0,0,12,15,33
Yemen,2003-05-01,3,0,0,0,6,9
Yemen,2003-05-01,19,0,0,6,0,25
Yemen,2003-05-01,0,0,0,0,0,0
Yemen,2003-05-01,0,0,0,0,0,0
Yemen,2003-05-01,4,0,0,3,1,8
Yemen,2003-05-01,6,0,0,0,0,6
Yemen,2003-05-01,2,0,0,0,0,2
Yemen,2003-05-01,6,0,0,48,0,54
Yemen,2003-05-01,0,0,0,0,0,0
Yemen,2003-05-01,3,0,0,-4,0,-1
Yemen,2003-05-01,6,0,0,3,0,9
Yemen,2003-06-01,3,0,0,3,0,6
Yemen,2003-06-01,13,0,0,0,0,13
Yemen,2003-06-01,6,0,0,0,2,8
Yemen,2003-06-01,5,0,0,3,0,8
Yemen,2003-06-01,0,0,0,9,0,9
Yemen,2003-06-01,8,0,0,0,0,8
Yemen,2003-06-01,0,0,0,0,0,0
Yemen,2003-06-01,2,0,0,0,0,2
Yemen,2003-06-01,5,0,0,0,0,5
Yemen,2003-06-01,0,0,0,0,0,0
Yemen,2003-06-01,0,0,0,0,2,2
Yemen,2003-06-01,3,0,0,3,1,7
Yemen,2003-06-01,1,0,0,0,0,1
Yemen,2003-06-01,0,0,0,3,0,3
Yemen,2003-06-01,0,0,0,0,0,0
Yemen,2003-06-01,0,0,0,0,0,0
Yemen,2003-06-01,0,0,0,3,0,3
Yemen,2003-06-01,2,0,0,-4,0,-2
Yemen,2003-06-01,13,0,0,12,0,25
Yemen,2003-06-01,3,0,0,15,0,18
Yemen,2003-06-01,20,0,0,4,0,24
Yemen,2003-06-01,2,0,0,0,0,2
Yemen,2003-06-01,0,0,0,0,0,0
Yemen,2003-06-01,29,0,0,7,6,42
Yemen,2003-06-01,30,0,0,10,4,44
Yemen,2003-06-01,12,0,0,0,2,14
Yemen,2003-06-01,8,0,0,0,0,8
Yemen,2003-06-01,0,0,0,-4,0,-4
Yemen,2003-07-01,3,0,0,3,0,6
Yemen,2003-07-01,1,0,0,0,0,1
Yemen,2003-07-01,2,0,0,9,0,11
Yemen,2003-07-01,0,0,0,0,0,0
Yemen,2003-07-01,0,0,0,0,0,0
Yemen,2003-07-01,0,0,0,0,0,0
Yemen,2003-07-01,18,0,0,0,0,18
Yemen,2003-07-01,0,0,0,1,0,1
Yemen,2003-07-01,9,0,0,0,0,9
Yemen,2003-07-01,3,0,0,0,2,5
Yemen,2003-07-01,1,0,0,6,0,7
Yemen,2003-07-01,0,0,0,0,0,0
Yemen,2003-07-01,1,0,0,0,0,1
Yemen,2003-07-01,0,0,0,0,0,0
Yemen,2003-07-01,0,0,0,0,0,0
Yemen,2003-07-01,2,0,0,0,0,2
Yemen,2003-07-01,3,0,2,16,1,22
Yemen,2003-07-01,3,0,0,0,2,5
Yemen,2003-07-01,-1,0,0,3,0,2
Yemen,2003-07-01,8,0,0,9,0,17
Yemen,2003-07-01,7,0,0,12,0,19
Yemen,2003-07-01,3,0,0,15,0,18
Yemen,2003-07-01,0,0,0,0,0,0
Yemen,2003-07-01,-2,0,0,3,0,1
Yemen,2003-07-01,2,0,0,0,0,2
Yemen,2003-07-01,12,0,0,-1,2,13
Yemen,2003-07-01,3,0,0,9,0,12
Yemen,2003-08-01,21,0,0,0,6,27
Yemen,2003-08-01,0,0,0,0,0,0
Yemen,2003-08-01,0,0,0,0,0,0
Yemen,2003-08-01,9,0,0,0,0,9
Yemen,2003-08-01,4,0,0,3,0,7
Yemen,2003-08-01,6,0,0,1,0,7
Yemen,2003-08-01,4,0,0,0,0,4
Yemen,2003-08-01,4,0,0,0,0,4
Yemen,2003-08-01,0,0,0,0,0,0
Yemen,2003-08-01,2,0,0,3,0,5
Yemen,2003-08-01,0,0,0,4,0,4
Yemen,2003-08-01,0,0,0,0,0,0
Yemen,2003-08-01,0,0,0,6,0,6
Yemen,2003-08-01,3,0,0,0,0,3
Yemen,2003-08-01,0,0,0,0,0,0
Yemen,2003-08-01,3,0,0,4,0,7
Yemen,2003-08-01,0,0,0,-6,0,-6
Yemen,2003-08-01,0,0,0,0,0,0
Yemen,2003-08-01,4,0,0,17,0,21
Yemen,2003-08-01,5,0,0,3,0,8
Yemen,2003-08-01,6,0,0,0,0,6
Yemen,2003-08-01,0,0,0,0,0,0
Yemen,2003-08-01,9,0,0,0,0,9
Yemen,2003-08-01,0,0,0,0,6,6
Yemen,2003-08-01,1,0,0,0,0,1
Yemen,2003-08-01,0,0,0,3,0,3
Yemen,2003-08-01,4,0,0,0,0,4
Yemen,2003-08-01,12,0,0,0,0,12
Yemen,2003-09-01,-2,0,0,0,0,-2
Yemen,2003-09-01,4,0,0,6,0,10
Yemen,2003-09-01,3,0,0,9,0,12
Yemen,2003-09-01,22,0,1,11,0,34
Yemen,2003-09-01,0,0,0,9,2,11
Yemen,2003-09-01,0,0,0,3,0,3
Yemen,2003-09-01,12,0,0,0,0,12
Yemen,2003-09-01,0,0,0,0,0,0
Yemen,2003-09-01,1,0,0,7,0,8
Yemen,2003-09-01,0,0,0,0,0,0
Yemen,2003-09-01,6,0,0,9,0,15
Yemen,2003-09-01,0,0,0,0,0,0
Yemen,2003-09-01,-1,0,0,0,2,1
Yemen,2003-09-01,6,0,0,0,1,7
Yemen,2003-09-01,0,0,0,0,0,0
Yemen,2003-09-01,0,0,0,3,0,3
Yemen,2003-09-01,0,0,0,6,0,6
Yemen,2003-09-01,4,0,0,0,0,4
Yemen,2003-09-01,0,0,0,9,0,9
Yemen,2003-09-01,6,0,0,3,0,9
Yemen,2003-09-01,0,0,0,0,0,0
Yemen,2003-09-01,9,0,0,0,0,9
Yemen,2003-09-01,0,0,0,3,0,3
Yemen,2003-09-01,0,0,0,0,0,0
Yemen,2003-09-01,5,0,0,3,0,8
Yemen,2003-09-01,-2,0,0,3,0,1
Yemen,2003-09-01,0,0,0,0,0,0
Yemen,2003-09-01,5,0,0,-4,0,1
Yemen,2003-09-01,0,0,0,0,0,0
Yemen,2003-10-01,0,0,0,0,0,0
Yemen,2003-10-01,-2,0,0,-2,0,-4
Yemen,2003-10-01,6,0,0,0,0,6
Yemen,2003-10-01,3,0,-1,6,0,8
Yemen,2003-10-01,3,0,0,0,0,3
Yemen,2003-10-01,-1,0,0,0,0,-1
Yemen,2003-10-01,3,0,0,18,0,21
Yemen,2003-10-01,14,0,0,-4,0,10
Yemen,2003-10-01,7,0,0,6,12,25
Yemen,2003-10-01,0,0,0,0,0,0
Yemen,2003-10-01,0,0,0,0,0,0
Yemen,2003-10-01,7,0,0,9,0,16
Yemen,2003-10-01,3,0,0,0,9,12
Yemen,2003-10-01,11,0,0,4,7,22
Yemen,2003-10-01,3,4,0,12,0,19
Yemen,2003-10-01,1,2,0,-2,0,1
Yemen,2003-10-01,5,0,-2,0,0,3
Yemen,2003-10-01,6,0,-2,3,2,9
Yemen,2003-10-01,0,0,0,-4,0,-4
Yemen,2003-10-01,0,0,0,3,0,3
Yemen,2003-10-01,4,0,0,3,0,7
Yemen,2003-10-01,4,0,0,1,2,7
Yemen,2003-10-01,0,0,0,6,2,8
Yemen,2003-10-01,0,0,0,4,0,4
Yemen,2003-10-01,0,0,0,0,0,0
Yemen,2003-10-01,12,0,0,12,0,24
Yemen,2003-10-01,6,0,0,6,0,12
Yemen,2003-10-01,10,0,0,6,0,16
Yemen,2003-10-01,4,0,0,9,0,13
Yemen,2003-10-01,0,0,0,0,0,0
Yemen,2003-11-01,3,0,0,0,0,3
Yemen,2003-11-01,0,0,0,0,0,0
Yemen,2003-11-01,0,0,0,0,0,0
Yemen,2003-11-01,0,0,0,0,0,0
Yemen,2003-11-01,3,0,0,0,0,3
Yemen,2003-11-01,0,0,0,12,0,12
Yemen,2003-11-01,0,0,0,0,0,0
Yemen,2003-11-01,6,0,0,9,4,19
Yemen,2003-11-01,3,0,0,6,3,12
Yemen,2003-11-01,1,0,0,0,0,1
Yemen,2003-11-01,3,0,-4,0,0,-1
Yemen,2003-11-01,6,0,0,0,0,6
Yemen,2003-11-01,3,0,0,9,3,15
Yemen,2003-11-01,0,0,0,0,0,0
Yemen,2003-11-01,3,0,0,6,3,12
Yemen,2003-11-01,5,0,-1,2,0,6
Yemen,2003-11-01,4,0,0,1,0,5
Yemen,2003-11-01,0,0,0,2,0,2
Yemen,2003-11-01,3,0,0,0,0,3
Yemen,2003-11-01,6,0,3,9,3,21
Yemen,2003-11-01,0,0,0,0,0,0
Yemen,2003-11-01,0,0,0,-4,0,-4
Yemen,2003-11-01,0,0,0,1,0,1
Yemen,2003-11-01,21,0,0,6,0,27
Yemen,2003-11-01,27,0,0,9,6,42
Yemen,2003-11-01,19,0,0,3,0,22
Yemen,2003-11-01,15,0,0,0,6,21
Yemen,2003-12-01,0,0,0,6,6,12
Yemen,2003-12-01,0,0,0,-2,0,-2
Yemen,2003-12-01,0,0,0,0,0,0
Yemen,2003-12-01,4,0,0,6,0,10
Yemen,2003-12-01,0,0,0,0,0,0
Yemen,2003-12-01,0,0,0,0,0,0
Yemen,2003-12-01,0,0,0,0,0,0
Yemen,2003-12-01,4,0,-1,-1,0,2
Yemen,2003-12-01,5,0,0,13,0,18
Yemen,2003-12-01,7,0,1,9,0,17
Yemen,2003-12-01,0,0,0,0,0,0
Yemen,2003-12-01,8,0,0,6,0,14
Yemen,2003-12-01,1,0,0,0,0,1
Yemen,2003-12-01,0,0,0,0,0,0
Yemen,2003-12-01,1,0,0,3,0,4
Yemen,2003-12-01,0,0,0,9,0,9
Yemen,2003-12-01,22,0,0,20,3,45
Yemen,2003-12-01,1,0,0,0,3,4
Yemen,2003-12-01,15,0,0,3,0,18
Yemen,2003-12-01,2,0,0,0,0,2
Yemen,2003-12-01,24,0,0,-2,1,23
Yemen,2003-12-01,17,0,0,0,0,17
Yemen,2003-12-01,3,0,0,0,0,3
Yemen,2003-12-01,0,0,0,3,0,3
Yemen,2003-12-01,3,0,0,22,0,25
Yemen,2003-12-01,0,0,0,0,0,0
Yemen,2003-12-01,0,0,0,0,0,0
Yemen,2003-12-01,13,0,0,3,0,16
Yemen,2003-12-01,0,0,0,0,0,0
Yemen,2003-12-01,0,0,0,3,0,3
Afghanistan,2006-11-01,79,0,-1,37,26,141
Afghanistan,2006-11-01,49,0,-2,2,20,69
Afghanistan,2006-11-01,45,0,0,11,3,59
Afghanistan,2006-11-01,11,0,0,9,5,25
Afghanistan,2006-11-01,23,4,0,9,2,38
Afghanistan,2006-11-01,25,2,-1,2,2,30
Afghanistan,2006-11-01,53,0,0,9,4,66
Afghanistan,2006-11-01,72,0,0,4,4,80
Afghanistan,2006-11-01,65,0,0,19,5,89
Afghanistan,2006-11-01,35,0,-2,-5,0,28
Afghanistan,2006-11-01,31,0,0,13,3,47
Afghanistan,2006-11-01,50,0,0,6,3,59
Afghanistan,2006-11-01,60,0,0,27,0,87
Afghanistan,2006-11-01,48,0,-2,5,2,53
Afghanistan,2006-11-01,25,0,0,3,1,29
Afghanistan,2006-11-01,12,0,-1,7,9,27
Afghanistan,2006-11-01,41,2,0,18,5,66
Afghanistan,2006-11-01,57,0,0,15,10,82
Afghanistan,2006-11-01,60,4,6,0,1,71
Afghanistan,2006-11-01,47,0,0,11,0,58
Afghanistan,2006-11-01,43,0,0,8,0,51
Afghanistan,2006-11-01,46,0,0,0,4,50
Afghanistan,2006-11-01,60,0,0,3,6,69
Afghanistan,2006-11-01,23,0,0,11,0,34
Afghanistan,2006-11-01,28,0,0,8,0,36
Afghanistan,2006-11-01,36,0,0,4,11,51
Afghanistan,2006-11-01,79,0,2,-9,29,101
Afghanistan,2006-11-01,189,0,0,2,15,206
Afghanistan,2006-11-01,95,0,0,25,14,134
Afghanistan,2006-11-01,36,2,-1,20,17,74
Albania,2006-11-01,16,0,0,0,3,19
Albania,2006-11-01,19,0,0,0,0,19
Albania,2006-11-01,5,4,-3,2,0,8
Albania,2006-11-01,4,0,-2,0,0,2
Albania,2006-11-01,0,0,0,0,0,0
Albania,2006-11-01,14,0,0,0,1,15
Albania,2006-11-01,1,0,-4,0,-2,-5
Albania,2006-11-01,4,0,0,9,0,13
Albania,2006-11-01,10,0,-4,3,0,9
Albania,2006-11-01,26,0,-2,0,4,28
Albania,2006-11-01,2,0,1,0,1,4
Albania,2006-11-01,0,0,0,0,0,0
Albania,2006-11-01,4,0,-2,0,0,2
Albania,2006-11-01,15,0,-3,0,1,13
Albania,2006-11-01,14,0,-1,0,0,13
Albania,2006-11-01,-1,0,0,0,0,-1
Albania,2006-11-01,9,0,0,3,1,13
Albania,2006-11-01,14,0,2,-4,0,12
Albania,2006-11-01,0,0,0,0,0,0
Albania,2006-11-01,15,0,0,6,0,21
Albania,2006-11-01,12,0,1,0,0,13
Albania,2006-11-01,3,0,0,0,0,3
Albania,2006-11-01,0,0,0,3,0,3
Albania,2006-11-01,4,0,0,0,0,4
Albania,2006-11-01,0,0,0,0,0,0
Albania,2006-11-01,0,0,0,0,0,0
Albania,2006-11-01,14,0,0,0,0,14
Albania,2006-11-01,6,0,0,0,2,8
Albania,2006-11-01,1,0,0,-4,9,6
Albania,2006-11-01,7,0,-1,0,0,6
Algeria,2006-11-01,5,0,0,9,0,14
Algeria,2006-11-01,6,0,0,12,0,18
Algeria,2006-11-01,0,0,0,0,0,0
Algeria,2006-11-01,0,0,0,0,0,0
Algeria,2006-11-01,0,0,0,9,0,9
Algeria,2006-11-01,5,0,0,0,0,5
Algeria,2006-11-01,5,0,0,3,0,8
Algeria,2006-11-01,-2,0,0,0,0,-2
Algeria,2006-11-01,-1,0,0,2,4,5
Algeria,2006-11-01,0,0,1,3,0,4
Algeria,2006-11-01,0,0,0,0,0,0
Algeria,2006-11-01,-1,0,0,0,0,-1
Algeria,2006-11-01,2,0,0,0,0,2
Algeria,2006-11-01,5,0,0,0,0,5
Algeria,2006-11-01,-3,0,0,0,0,-3
Algeria,2006-11-01,0,0,0,0,0,0
Algeria,2006-11-01,0,0,0,-2,0,-2
Algeria,2006-11-01,1,0,0,0,0,1
Algeria,2006-11-01,-4,0,0,0,0,-4
Algeria,2006-11-01,0,0,0,3,0,3
Algeria,2006-11-01,0,0,0,-2,0,-2
Algeria,2006-11-01,0,0,0,0,0,0
Algeria,2006-11-01,0,0,0,0,0,0
Algeria,2006-11-01,0,0,0,0,0,0
Algeria,2006-11-01,2,0,0,0,0,2
Algeria,2006-11-01,0,0,0,9,0,9
Algeria,2006-11-01,1,0,0,0,0,1
Algeria,2006-11-01,0,0,0,11,0,11
Algeria,2006-11-01,0,0,0,3,0,3
Bangladesh,2006-11-01,0,0,-1,0,0,-1
Bangladesh,2006-11-01,3,0,3,6,2,14
Bangladesh,2006-11-01,6,0,0,0,1,7
Bangladesh,2006-11-01,2,0,-2,0,0,0
Bangladesh,2006-11-01,11,0,-5,0,2,8
Bangladesh,2006-11-01,23,0,-2,3,0,24
Bangladesh,2006-11-01,6,0,0,-2,1,5
Bangladesh,2006-11-01,4,0,0,0,0,4
Bangladesh,2006-11-01,4,0,0,0,1,5
Bangladesh,2006-11-01,4,0,0,0,0,4
Bangladesh,2006-11-01,0,0,0,0,2,2
Bangladesh,2006-11-01,3,0,0,0,1,4
Bangladesh,2006-11-01,2,0,0,6,0,8
Bangladesh,2006-11-01,2,0,0,3,10,15
Bangladesh,2006-11-01,1,0,0,0,1,2
Bangladesh,2006-11-01,0,0,1,0,0,1
Bangladesh,2006-11-01,2,0,0,0,0,2
Bangladesh,2006-11-01,13,0,0,0,0,13
Bangladesh,2006-11-01,0,0,0,3,0,3
Bangladesh,2006-11-01,22,0,1,3,5,31
Bangladesh,2006-11-01,7,0,-4,0,2,5
Bangladesh,2006-11-01,8,0,0,-2,0,6
Bangladesh,2006-11-01,2,0,0,0,1,3
Bangladesh,2006-11-01,0,0,2,0,0,2
Bangladesh,2006-11-01,1,0,0,3,0,4
Bangladesh,2006-11-01,0,0,0,0,0,0
Bangladesh,2006-11-01,10,0,1,1,4,16
Bangladesh,2006-11-01,4,0,2,0,0,6
Bangladesh,2006-11-01,4,0,-1,-2,0,1
Bangladesh,2006-11-01,3,0,0,5,2,10
Cameroon,2006-11-01,0,0,0,0,0,0
Cameroon,2006-11-01,0,0,0,0,0,0
Cameroon,2006-11-01,0,0,0,0,0,0
Cameroon,2006-11-01,0,0,0,0,0,0
Cameroon,2006-11-01,0,0,0,0,0,0
Cameroon,2006-11-01,0,0,0,3,0,3
Cameroon,2006-11-01,0,0,0,0,0,0
Cameroon,2006-11-01,0,0,0,6,0,6
Cameroon,2006-11-01,0,0,0,0,0,0
Cameroon,2006-11-01,4,0,0,0,0,4
Cameroon,2006-11-01,0,0,0,0,0,0
Cameroon,2006-11-01,0,0,0,0,0,0
Cameroon,2006-11-01,0,0,0,0,0,0
Cameroon,2006-11-01,0,0,0,0,0,0
Cameroon,2006-11-01,0,0,0,0,0,0
Cameroon,2006-11-01,6,0,0,0,0,6
Cameroon,2006-11-01,0,0,0,3,0,3
Cameroon,2006-11-01,0,0,0,0,0,0
Cameroon,2006-11-01,0,0,0,0,0,0
Cameroon,2006-11-01,2,0,0,0,1,3
Cameroon,2006-11-01,0,0,0,0,0,0
Cameroon,2006-11-01,0,0,0,0,1,1
Cameroon,2006-11-01,0,0,0,0,0,0
China,2006-11-01,50,0,-2,16,4,68
China,2006-11-01,30,4,-1,38,14,85
China,2006-11-01,13,4,1,22,1,41
China,2006-11-01,22,0,0,6,1,29
China,2006-11-01,15,2,-2,7,14,36
China,2006-11-01,28,2,-2,11,2,41
China,2006-11-01,40,0,-1,19,1,59
China,2006-11-01,40,0,1,45,8,94
China,2006-11-01,39,2,0,23,1,65
China,2006-11-01,48,4,1,3,10,66
China,2006-11-01,10,0,-2,6,2,16
China,2006-11-01,18,2,1,3,0,24
China,2006-11-01,19,0,0,10,10,39
China,2006-11-01,18,0,-7,4,4,19
China,2006-11-01,44,0,0,-1,8,51
China,2006-11-01,100,0,-2,29,6,133
China,2006-11-01,52,0,0,13,10,75
China,2006-11-01,31,0,0,15,3,49
China,2006-11-01,19,0,0,21,14,54
China,2006-11-01,52,0,0,39,2,93
China,2006-11-01,36,0,1,60,2,99
China,2006-11-01,43,0,0,8,9,60
China,2006-11-01,20,0,-2,0,6,24
China,2006-11-01,4,8,0,3,3,18
China,2006-11-01,6,0,0,6,0,12
China,2006-11-01,18,0,1,-2,1,18
China,2006-11-01,33,0,0,7,6,46
China,2006-11-01,28,0,0,16,2,46
China,2006-11-01,57,0,-11,29,1,76
China,2006-11-01,22,0,0,7,0,29
Egypt,2006-11-01,47,0,0,26,3,76
Egypt,2006-11-01,19,0,0,-1,1,19
Egypt,2006-11-01,10,0,0,12,1,23
Egypt,2006-11-01,8,0,0,-2,3,9
Egypt,2006-11-01,11,0,0,-5,0,6
Egypt,2006-11-01,15,0,0,39,0,54
Egypt,2006-11-01,15,0,0,27,2,44
Egypt,2006-11-01,12,0,0,41,1,54
Egypt,2006-11-01,9,0,0,7,1,17
Egypt,2006-11-01,0,0,0,36,2,38
Egypt,2006-11-01,3,0,0,0,0,3
Egypt,2006-11-01,3,0,0,0,1,4
Egypt,2006-11-01,2,0,-1,10,3,14
Egypt,2006-11-01,36,0,0,-1,1,36
Egypt,2006-11-01,9,0,0,4,0,13
Egypt,2006-11-01,21,0,0,6,0,27
Egypt,2006-11-01,21,0,0,15,0,36
Egypt,2006-11-01,5,0,0,3,0,8
Egypt,2006-11-01,3,0,1,18,0,22
Egypt,2006-11-01,10,0,-1,12,0,21
Egypt,2006-11-01,1,0,0,0,0,1
Egypt,2006-11-01,10,0,0,-1,0,9
Egypt,2006-11-01,13,0,0,-4,0,9
Egypt,2006-11-01,6,0,0,-1,2,7
Egypt,2006-11-01,-3,0,0,-2,0,-5
Egypt,2006-11-01,2,0,0,0,0,2
Egypt,2006-11-01,12,0,1,3,0,16
Egypt,2006-11-01,18,0,-2,-3,3,16
Egypt,2006-11-01,3,0,0,1,0,4
Egypt,2006-11-01,15,0,0,-5,5,15
Eritrea,2006-11-01,12,0,0,0,0,12
Eritrea,2006-11-01,33,0,0,3,0,36
Eritrea,2006-11-01,33,0,0,0,0,33
Eritrea,2006-11-01,12,0,0,0,1,13
Eritrea,2006-11-01,18,0,0,0,0,18
Eritrea,2006-11-01,24,0,0,0,0,24
Eritrea,2006-11-01,2,0,0,0,0,2
Eritrea,2006-11-01,11,0,0,0,0,11
Eritrea,2006-11-01,0,0,0,3,0,3
Eritrea,2006-11-01,-1,0,0,0,0,-1
Eritrea,2006-11-01,7,0,0,3,0,10
Eritrea,2006-11-01,2,0,0,0,0,2
Eritrea,2006-11-01,11,0,0,6,0,17
Eritrea,2006-11-01,6,0,0,0,0,6
Eritrea,2006-11-01,3,0,0,3,0,6
Eritrea,2006-11-01,3,0,0,3,0,6
Eritrea,2006-11-01,4,0,0,0,0,4
Eritrea,2006-11-01,8,0,-1,3,0,10
Eritrea,2006-11-01,4,0,0,-2,1,3
Eritrea,2006-11-01,6,0,0,0,0,6
Eritrea,2006-11-01,10,0,0,0,0,10
Eritrea,2006-11-01,2,0,0,0,0,2
Eritrea,2006-11-01,3,0,0,6,0,9
Eritrea,2006-11-01,0,0,0,3,0,3
Eritrea,2006-11-01,2,0,0,0,2,4
Eritrea,2006-11-01,8,0,0,0,0,8
Eritrea,2006-11-01,16,0,0,3,0,19
Eritrea,2006-11-01,3,0,0,0,0,3
Eritrea,2006-11-01,7,0,0,0,0,7
Georgia,2006-11-01,0,0,0,0,0,0
Georgia,2006-11-01,2,0,0,4,0,6
Georgia,2006-11-01,3,0,0,12,1,16
Georgia,2006-11-01,0,0,0,0,0,0
Georgia,2006-11-01,2,0,0,3,0,5
Georgia,2006-11-01,0,0,0,0,0,0
Georgia,2006-11-01,-1,0,0,0,0,-1
Georgia,2006-11-01,5,0,0,-2,0,3
Georgia,2006-11-01,0,0,0,3,0,3
Georgia,2006-11-01,2,0,0,-4,0,-2
Georgia,2006-11-01,2,0,0,-2,0,0
Georgia,2006-11-01,0,0,0,0,0,0
Georgia,2006-11-01,7,0,0,0,0,7
Georgia,2006-11-01,4,0,0,4,0,8
Georgia,2006-11-01,4,0,0,0,1,5
Georgia,2006-11-01,-3,0,0,0,0,-3
Georgia,2006-11-01,2,0,-4,0,0,-2
Georgia,2006-11-01,0,0,0,0,1,1
Georgia,2006-11-01,0,0,0,0,1,1
Georgia,2006-11-01,0,0,0,0,0,0
Georgia,2006-11-01,3,0,0,-2,4,5
Georgia,2006-11-01,2,0,0,0,0,2
Georgia,2006-11-01,11,0,0,30,2,43
Georgia,2006-11-01,9,0,0,4,0,13
Georgia,2006-11-01,0,0,0,0,0,0
Georgia,2006-11-01,0,0,0,0,0,0
Georgia,2006-11-01,3,0,0,0,0,3
Georgia,2006-11-01,2,0,0,3,0,5
Georgia,2006-11-01,4,0,0,4,0,8
Georgia,2006-11-01,5,0,-1,0,1,5
India,2006-11-01,4,0,0,12,0,16
India,2006-11-01,8,0,0,6,0,14
India,2006-11-01,22,0,0,3,0,25
India,2006-11-01,14,0,0,3,1,18
India,2006-11-01,7,0,-2,0,2,7
India,2006-11-01,14,0,0,8,3,25
India,2006-11-01,21,0,-1,9,6,35
India,2006-11-01,14,0,0,1,1,16
India,2006-11-01,2,0,0,13,0,15
India,2006-11-01,28,0,-4,18,1,43
India,2006-11-01,6,0,0,1,1,8
India,2006-11-01,12,0,0,0,2,14
India,2006-11-01,6,0,0,-2,6,10
India,2006-11-01,-6,0,-1,-2,1,-8
India,2006-11-01,2,0,0,-4,1,-1
India,2006-11-01,16,0,0,0,4,20
India,2006-11-01,27,2,0,7,2,38
India,2006-11-01,14,2,0,3,3,22
India,2006-11-01,2,0,0,3,0,5
India,2006-11-01,17,0,0,0,0,17
India,2006-11-01,17,2,0,3,0,22
India,2006-11-01,23,0,-4,-4,3,18
India,2006-11-01,6,0,0,6,1,13
India,2006-11-01,6,2,0,6,1,15
India,2006-11-01,3,0,1,1,1,6
India,2006-11-01,14,0,1,9,0,24
India,2006-11-01,35,0,-1,-5,1,30
India,2006-11-01,16,0,0,-2,2,16
India,2006-11-01,1,0,0,-2,0,-1
India,2006-11-01,7,0,-2,10,3,18
Iran,2006-11-01,60,0,-2,15,9,82
Iran,2006-11-01,67,0,1,1,6,75
Iran,2006-11-01,42,0,0,1,0,43
Iran,2006-11-01,16,0,0,4,0,20
Iran,2006-11-01,24,0,3,17,2,46
Iran,2006-11-01,17,0,0,18,2,37
Iran,2006-11-01,12,0,-2,31,2,43
Iran,2006-11-01,32,0,-4,18,5,51
Iran,2006-11-01,38,0,0,9,0,47
Iran,2006-11-01,16,0,0,10,1,27
Iran,2006-11-01,31,0,-2,20,2,51
Iran,2006-11-01,22,0,-4,0,2,20
Iran,2006-11-01,51,0,-2,15,13,77
Iran,2006-11-01,63,6,-2,58,10,135
Iran,2006-11-01,-31,4,0,18,2,-7
Iran,2006-11-01,26,0,-1,4,2,31
Iran,2006-11-01,10,0,1,0,3,14
Iran,2006-11-01,26,4,0,19,3,52
Iran,2006-11-01,28,2,0,11,0,41
Iran,2006-11-01,17,0,0,13,4,34
Iran,2006-11-01,54,4,-3,15,0,70
Iran,2006-11-01,54,4,4,0,8,70
Iran,2006-11-01,28,0,1,9,1,39
Iran,2006-11-01,6,0,0,0,0,6
Iran,2006-11-01,15,0,0,7,4,26
Iran,2006-11-01,15,0,0,6,1,22
Iran,2006-11-01,0,0,0,12,2,14
Iran,2006-11-01,14,6,1,12,3,36
Iran,2006-11-01,31,6,1,16,6,60
Iran,2006-11-01,29,0,-2,12,6,45
Iraq,2006-11-01,109,0,-8,7,10,118
Iraq,2006-11-01,121,0,7,28,11,167
Iraq,2006-11-01,145,6,-1,12,27,189
Iraq,2006-11-01,79,0,-1,15,3,96
Iraq,2006-11-01,84,0,5,78,7,174
Iraq,2006-11-01,116,2,0,96,24,238
Iraq,2006-11-01,152,2,-1,70,12,235
Iraq,2006-11-01,185,0,-14,17,24,212
Iraq,2006-11-01,136,2,-36,16,25,143
Iraq,2006-11-01,125,0,-9,48,12,176
Iraq,2006-11-01,121,2,-12,12,14,137
Iraq,2006-11-01,146,2,-2,21,19,186
Iraq,2006-11-01,164,0,-12,53,19,224
Iraq,2006-11-01,152,6,-9,35,12,196
Iraq,2006-11-01,87,10,-8,72,25,186
Iraq,2006-11-01,146,0,2,105,9,262
Iraq,2006-11-01,116,0,-1,49,8,172
Iraq,2006-11-01,56,0,-4,44,14,110
Iraq,2006-11-01,66,0,3,10,15,94
Iraq,2006-11-01,69,0,-1,6,13,87
Iraq,2006-11-01,73,0,0,23,10,106
Iraq,2006-11-01,117,0,0,17,13,147
Iraq,2006-11-01,57,0,-2,10,18,83
Iraq,2006-11-01,24,0,-4,4,11,35
Iraq,2006-11-01,68,0,-1,9,5,81
Iraq,2006-11-01,60,2,0,3,5,70
Iraq,2006-11-01,119,10,3,5,9,146
Iraq,2006-11-01,173,8,2,14,7,204
Iraq,2006-11-01,138,0,0,5,7,150
Iraq,2006-11-01,151,0,1,16,23,191
Morocco,2006-11-01,-6,0,0,0,0,-6
Morocco,2006-11-01,1,0,0,1,1,3
Morocco,2006-11-01,0,0,0,3,0,3
Morocco,2006-11-01,0,0,0,0,0,0
Morocco,2006-11-01,1,0,0,0,0,1
Morocco,2006-11-01,2,0,0,7,0,9
Morocco,2006-11-01,2,0,0,7,1,10
Morocco,2006-11-01,0,0,0,0,3,3
Morocco,2006-11-01,15,0,0,0,1,16
Morocco,2006-11-01,29,0,0,0,0,29
Morocco,2006-11-01,0,0,0,0,0,0
Morocco,2006-11-01,0,0,0,0,0,0
Morocco,2006-11-01,0,0,0,6,0,6
Morocco,2006-11-01,2,0,0,0,0,2
Morocco,2006-11-01,0,0,0,-2,0,-2
Morocco,2006-11-01,6,0,0,28,4,38
Morocco,2006-11-01,2,0,0,27,0,29
Morocco,2006-11-01,0,0,0,0,0,0
Morocco,2006-11-01,0,0,0,0,0,0
Morocco,2006-11-01,-1,0,0,3,0,2
Morocco,2006-11-01,12,0,0,0,0,12
Morocco,2006-11-01,0,0,0,0,0,0
Morocco,2006-11-01,7,0,0,0,0,7
Morocco,2006-11-01,5,0,0,0,0,5
Morocco,2006-11-01,1,0,0,3,0,4
Morocco,2006-11-01,1,0,0,0,0,1
Morocco,2006-11-01,4,0,0,3,1,8
Morocco,2006-11-01,2,0,0,6,0,8
Morocco,2006-11-01,0,0,0,0,0,0
Morocco,2006-11-01,0,0,0,0,0,0
Nigeria,2006-11-01,28,0,-2,-4,0,22
Nigeria,2006-11-01,11,0,1,6,0,18
Nigeria,2006-11-01,5,0,-2,0,0,3
Nigeria,2006-11-01,0,0,-2,0,0,-2
Nigeria,2006-11-01,7,2,-2,0,7,14
Nigeria,2006-11-01,10,0,0,0,1,11
Nigeria,2006-11-01,8,0,0,14,0,22
Nigeria,2006-11-01,2,0,1,0,0,3
Nigeria,2006-11-01,15,0,2,0,0,17
Nigeria,2006-11-01,45,0,2,0,3,50
Nigeria,2006-11-01,7,0,0,6,1,14
Nigeria,2006-11-01,3,0,0,-2,0,1
Nigeria,2006-11-01,3,0,0,0,1,4
Nigeria,2006-11-01,8,0,0,2,0,10
Nigeria,2006-11-01,13,0,1,-1,4,17
Nigeria,2006-11-01,6,0,0,4,2,12
Nigeria,2006-11-01,10,0,0,0,1,11
Nigeria,2006-11-01,0,0,0,0,0,0
Nigeria,2006-11-01,6,0,1,-2,0,5
Nigeria,2006-11-01,26,0,0,9,0,35
Nigeria,2006-11-01,5,0,0,6,4,15
Nigeria,2006-11-01,18,0,0,33,6,57
Nigeria,2006-11-01,21,0,-2,3,0,22
Nigeria,2006-11-01,4,0,0,6,4,14
Nigeria,2006-11-01,2,0,0,0,0,2
Nigeria,2006-11-01,4,0,-2,15,5,22
Nigeria,2006-11-01,13,0,0,9,0,22
Nigeria,2006-11-01,3,0,0,-2,2,3
Nigeria,2006-11-01,14,0,2,6,2,24
Nigeria,2006-11-01,19,0,0,0,0,19
Pakistan,2006-11-01,26,0,1,-2,5,30
Pakistan,2006-11-01,13,0,0,3,6,22
Pakistan,2006-11-01,11,0,0,3,6,20
Pakistan,2006-11-01,60,0,0,39,7,106
Pakistan,2006-11-01,43,0,0,37,1,81
Pakistan,2006-11-01,27,0,0,27,5,59
Pakistan,2006-11-01,29,0,-2,-3,7,31
Pakistan,2006-11-01,58,0,0,24,0,82
Pakistan,2006-11-01,36,0,0,13,3,52
Pakistan,2006-11-01,8,0,0,6,0,14
Pakistan,2006-11-01,18,0,1,12,1,32
Pakistan,2006-11-01,20,0,0,3,2,25
Pakistan,2006-11-01,26,2,0,51,0,79
Pakistan,2006-11-01,9,0,-1,16,2,26
Pakistan,2006-11-01,20,0,0,5,11,36
Pakistan,2006-11-01,23,0,0,23,6,52
Pakistan,2006-11-01,40,0,0,20,2,62
Pakistan,2006-11-01,46,6,0,18,1,71
Pakistan,2006-11-01,44,0,-1,12,2,57
Pakistan,2006-11-01,18,0,0,19,0,37
Pakistan,2006-11-01,40,0,0,54,8,102
Pakistan,2006-11-01,8,0,0,21,6,35
Pakistan,2006-11-01,6,0,0,36,8,50
Pakistan,2006-11-01,10,0,0,9,1,20
Pakistan,2006-11-01,20,0,0,11,0,31
Pakistan,2006-11-01,27,0,0,29,16,72
Pakistan,2006-11-01,13,0,0,22,2,37
Pakistan,2006-11-01,50,0,0,9,1,60
Pakistan,2006-11-01,9,0,0,4,0,13
Pakistan,2006-11-01,11,0,0,6,2,19
Sierra Leone,2006-11-01,13,0,0,-2,0,11
Sierra Leone,2006-11-01,5,0,0,0,0,5
Sierra Leone,2006-11-01,2,0,0,0,0,2
Sierra Leone,2006-11-01,1,0,0,0,0,1
Sierra Leone,2006-11-01,0,0,0,0,0,0
Sierra Leone,2006-11-01,0,0,0,0,0,0
Sierra Leone,2006-11-01,0,0,0,0,0,0
Sierra Leone,2006-11-01,0,0,0,0,0,0
Sierra Leone,2006-11-01,0,0,0,0,0,0
Sierra Leone,2006-11-01,0,0,0,0,0,0
Sierra Leone,2006-11-01,12,0,0,0,0,12
Sierra Leone,2006-11-01,0,0,0,0,0,0
Sierra Leone,2006-11-01,0,0,0,0,0,0
Sierra Leone,2006-11-01,1,0,0,-2,4,3
Sierra Leone,2006-11-01,2,0,0,0,0,2
Sierra Leone,2006-11-01,3,0,0,0,0,3
Sierra Leone,2006-11-01,0,0,0,0,0,0
Sierra Leone,2006-11-01,1,0,0,0,0,1
Sierra Leone,2006-11-01,0,0,0,0,0,0
Somalia,2006-11-01,7,0,0,20,6,33
Somalia,2006-11-01,4,0,0,12,3,19
Somalia,2006-11-01,11,0,0,0,3,14
Somalia,2006-11-01,16,0,0,13,0,29
Somalia,2006-11-01,3,0,0,0,0,3
Somalia,2006-11-01,2,0,0,0,0,2
Somalia,2006-11-01,-2,0,0,0,0,-2
Somalia,2006-11-01,14,0,0,0,4,18
Somalia,2006-11-01,8,0,0,3,1,12
Somalia,2006-11-01,4,0,0,0,0,4
Somalia,2006-11-01,7,0,0,12,0,19
Somalia,2006-11-01,12,0,0,3,1,16
Somalia,2006-11-01,3,0,0,3,0,6
Somalia,2006-11-01,15,0,0,-4,1,12
Somalia,2006-11-01,37,2,0,12,0,51
Somalia,2006-11-01,26,0,0,0,0,26
Somalia,2006-11-01,10,0,0,3,0,13
Somalia,2006-11-01,11,0,1,21,0,33
Somalia,2006-11-01,7,0,0,3,1,11
Somalia,2006-11-01,3,0,0,-2,0,1
Somalia,2006-11-01,33,0,0,3,5,41
Somalia,2006-11-01,0,0,0,0,3,3
Somalia,2006-11-01,6,2,0,0,0,8
Somalia,2006-11-01,5,4,0,0,0,9
Somalia,2006-11-01,6,2,0,6,1,15
Somalia,2006-11-01,6,0,0,0,0,6
Somalia,2006-11-01,5,0,0,0,0,5
Somalia,2006-11-01,12,0,0,27,0,39
Somalia,2006-11-01,10,0,0,0,0,10
Somalia,2006-11-01,3,0,0,6,1,10
Syria,2006-11-01,24,0,0,6,3,33
Syria,2006-11-01,9,0,1,8,3,21
Syria,2006-11-01,7,0,0,3,0,10
Syria,2006-11-01,0,0,0,6,0,6
Syria,2006-11-01,6,0,-2,6,0,10
Syria,2006-11-01,10,0,-8,0,0,2
Syria,2006-11-01,15,0,-4,3,0,14
Syria,2006-11-01,7,0,-2,0,0,5
Syria,2006-11-01,27,2,-10,0,1,20
Syria,2006-11-01,15,2,-4,0,2,15
Syria,2006-11-01,3,0,-24,0,0,-21
Syria,2006-11-01,47,0,-28,-8,3,14
Syria,2006-11-01,31,0,-26,-8,5,2
Syria,2006-11-01,35,0,-21,21,4,39
Syria,2006-11-01,14,0,-12,6,0,8
Syria,2006-11-01,12,0,-3,0,0,9
Syria,2006-11-01,24,0,-4,0,7,27
Syria,2006-11-01,8,0,-4,0,5,9
Syria,2006-11-01,24,0,-22,6,10,18
Syria,2006-11-01,14,0,-2,6,4,22
Syria,2006-11-01,156,0,0,12,4,172
Syria,2006-11-01,52,8,-4,10,11,77
Syria,2006-11-01,54,0,-5,-3,20,66
Syria,2006-11-01,45,0,-9,15,2,53
Syria,2006-11-01,30,0,-2,15,6,49
Syria,2006-11-01,4,0,-2,13,2,17
Syria,2006-11-01,9,0,-4,10,8,23
Syria,2006-11-01,25,0,0,1,7,33
Syria,2006-11-01,14,0,1,27,3,45
Syria,2006-11-01,31,0,-2,1,1,31
Yemen,2006-11-01,0,0,0,18,2,20
Yemen,2006-11-01,6,0,0,15,0,21
Yemen,2006-11-01,0,0,0,6,0,6
Yemen,2006-11-01,0,0,0,9,0,9
Yemen,2006-11-01,8,0,0,18,2,28
Yemen,2006-11-01,4,0,0,0,0,4
Yemen,2006-11-01,12,0,0,0,0,12
Yemen,2006-11-01,3,0,0,0,1,4
Yemen,2006-11-01,9,0,0,0,0,9
Yemen,2006-11-01,0,0,0,0,0,0
Yemen,2006-11-01,6,0,0,0,0,6
Yemen,2006-11-01,0,0,0,0,0,0
Yemen,2006-11-01,0,0,0,9,0,9
Yemen,2006-11-01,0,2,0,9,0,11
Yemen,2006-11-01,-1,0,0,3,0,2
Yemen,2006-11-01,1,2,0,0,0,3
Yemen,2006-11-01,0,0,0,0,0,0
Yemen,2006-11-01,5,0,0,0,0,5
Yemen,2006-11-01,5,0,0,0,0,5
Yemen,2006-11-01,1,0,0,-4,0,-3
Yemen,2006-11-01,6,0,0,0,0,6
Yemen,2006-11-01,3,0,0,0,0,3
Yemen,2006-11-01,0,0,0,15,0,15
Yemen,2006-11-01,3,0,0,0,0,3
Yemen,2006-11-01,-1,0,0,30,4,33
Yemen,2006-11-01,0,0,0,0,0,0
Yemen,2006-11-01,0,0,0,0,0,0
Yemen,2006-11-01,0,0,0,0,0,0
Afghanistan,2006-05-01,13,0,0,6,2,21
Afghanistan,2006-05-01,19,0,0,21,1,41
Afghanistan,2006-05-01,17,2,0,-2,0,17
Afghanistan,2006-05-01,23,0,0,0,0,23
Afghanistan,2006-05-01,39,0,0,6,1,46
Afghanistan,2006-05-01,15,0,0,0,1,16
Afghanistan,2006-05-01,21,0,0,-5,2,18
Afghanistan,2006-05-01,12,2,0,29,0,43
Afghanistan,2006-05-01,14,0,0,22,2,38
Afghanistan,2006-05-01,14,0,0,49,1,64
Afghanistan,2006-05-01,16,0,0,19,4,39
Afghanistan,2006-05-01,30,2,0,52,13,97
Afghanistan,2006-05-01,39,0,0,13,4,56
Afghanistan,2006-05-01,46,0,0,4,0,50
Afghanistan,2006-05-01,44,0,0,9,0,53
Afghanistan,2006-05-01,50,0,0,9,9,68
Afghanistan,2006-05-01,112,0,0,-1,3,114
Afghanistan,2006-05-01,87,0,0,1,13,101
Afghanistan,2006-05-01,71,0,0,35,4,110
Afghanistan,2006-05-01,105,0,0,9,20,134
Afghanistan,2006-05-01,30,0,0,4,8,42
Afghanistan,2006-05-01,75,0,1,13,6,95
Afghanistan,2006-05-01,61,0,-2,9,10,78
Afghanistan,2006-05-01,70,0,0,35,10,115
Afghanistan,2006-05-01,46,0,0,6,0,52
Afghanistan,2006-05-01,16,0,0,21,4,41
Afghanistan,2006-05-01,11,0,0,-5,0,6
Afghanistan,2006-05-01,65,2,0,7,12,86
Afghanistan,2006-05-01,76,2,0,-4,5,79
Afghanistan,2006-05-01,32,0,0,4,8,44
Afghanistan,2006-05-01,28,0,0,-2,8,34
Albania,2006-05-01,2,0,0,0,0,2
Albania,2006-05-01,0,0,0,6,1,7
Albania,2006-05-01,6,0,0,0,0,6
Albania,2006-05-01,2,0,-4,0,1,-1
Albania,2006-05-01,6,0,0,0,1,7
Albania,2006-05-01,2,0,0,-4,3,1
Albania,2006-05-01,-3,0,0,0,0,-3
Albania,2006-05-01,9,0,0,-2,0,7
Albania,2006-05-01,5,0,0,1,2,8
Albania,2006-05-01,3,0,0,0,0,3
Albania,2006-05-01,4,0,0,0,0,4
Albania,2006-05-01,21,0,0,-5,9,25
Albania,2006-05-01,6,0,0,1,2,9
Albania,2006-05-01,0,0,0,0,0,0
Albania,2006-05-01,3,0,-2,0,0,1
Albania,2006-05-01,0,0,0,6,0,6
Albania,2006-05-01,4,0,0,15,0,19
Albania,2006-05-01,3,0,0,0,0,3
Albania,2006-05-01,2,0,0,-4,0,-2
Albania,2006-05-01,2,0,-1,2,1,4
Albania,2006-05-01,7,0,-1,0,0,6
Albania,2006-05-01,22,0,0,0,2,24
Albania,2006-05-01,37,0,0,2,4,43
Albania,2006-05-01,-1,0,-1,6,0,4
Albania,2006-05-01,0,0,0,0,0,0
Albania,2006-05-01,0,0,0,0,0,0
Albania,2006-05-01,0,0,0,0,0,0
Albania,2006-05-01,0,0,-2,0,2,0
Albania,2006-05-01,7,0,0,0,0,7
Algeria,2006-05-01,0,0,0,0,0,0
Algeria,2006-05-01,0,0,0,0,0,0
Algeria,2006-05-01,0,0,0,0,0,0
Algeria,2006-05-01,-1,0,0,0,0,-1
Algeria,2006-05-01,0,0,0,0,0,0
Algeria,2006-05-01,-1,0,0,6,0,5
Algeria,2006-05-01,2,0,0,0,0,2
Algeria,2006-05-01,22,0,0,-4,0,18
Algeria,2006-05-01,14,0,0,4,0,18
Algeria,2006-05-01,4,0,0,6,2,12
Algeria,2006-05-01,0,0,0,0,0,0
Algeria,2006-05-01,0,0,0,0,0,0
Algeria,2006-05-01,0,0,0,3,0,3
Algeria,2006-05-01,4,0,0,0,0,4
Algeria,2006-05-01,7,0,0,6,0,13
Algeria,2006-05-01,0,0,0,9,0,9
Algeria,2006-05-01,0,0,0,0,0,0
Algeria,2006-05-01,0,0,0,0,0,0
Algeria,2006-05-01,10,0,-2,3,0,11
Algeria,2006-05-01,20,0,-14,9,0,15
Algeria,2006-05-01,1,0,0,3,0,4
Algeria,2006-05-01,0,0,-2,-2,0,-4
Algeria,2006-05-01,-3,0,0,0,0,-3
Algeria,2006-05-01,6,0,0,0,0,6
Algeria,2006-05-01,0,0,0,6,0,6
Algeria,2006-05-01,0,0,0,0,0,0
Algeria,2006-05-01,2,0,0,3,1,6
Bangladesh,2006-05-01,0,0,0,6,0,6
Bangladesh,2006-05-01,0,0,0,0,0,0
Bangladesh,2006-05-01,11,0,0,0,1,12
Bangladesh,2006-05-01,6,0,0,0,0,6
Bangladesh,2006-05-01,1,0,0,0,0,1
Bangladesh,2006-05-01,0,0,0,0,0,0
Bangladesh,2006-05-01,0,0,0,0,0,0
Bangladesh,2006-05-01,5,0,0,0,0,5
Bangladesh,2006-05-01,0,0,0,0,0,0
Bangladesh,2006-05-01,0,0,0,0,0,0
Bangladesh,2006-05-01,4,0,0,0,1,5
Bangladesh,2006-05-01,3,0,0,-4,0,-1
Bangladesh,2006-05-01,1,0,0,0,0,1
Bangladesh,2006-05-01,2,0,0,12,0,14
Bangladesh,2006-05-01,22,0,0,3,6,31
Bangladesh,2006-05-01,2,0,0,0,0,2
Bangladesh,2006-05-01,2,0,0,0,0,2
Bangladesh,2006-05-01,6,0,0,3,1,10
Bangladesh,2006-05-01,2,0,0,0,0,2
Bangladesh,2006-05-01,0,0,0,0,0,0
Bangladesh,2006-05-01,0,0,0,0,0,0
Bangladesh,2006-05-01,2,0,0,0,0,2
Bangladesh,2006-05-01,6,0,0,15,0,21
Bangladesh,2006-05-01,2,0,-2,3,0,3
Bangladesh,2006-05-01,0,0,0,0,0,0
Bangladesh,2006-05-01,0,0,0,-4,0,-4
Bangladesh,2006-05-01,2,0,0,0,0,2
Bangladesh,2006-05-01,12,0,0,15,15,42
Bangladesh,2006-05-01,8,0,-2,18,2,26
Bangladesh,2006-05-01,1,0,0,13,0,14
Cameroon,2006-05-01,0,0,0,0,0,0
Cameroon,2006-05-01,0,0,0,0,1,1
Cameroon,2006-05-01,1,0,0,-2,0,-1
Cameroon,2006-05-01,0,0,0,0,0,0
Cameroon,2006-05-01,0,4,0,2,0,6
Cameroon,2006-05-01,0,0,0,0,0,0
Cameroon,2006-05-01,7,0,0,0,0,7
Cameroon,2006-05-01,-1,0,0,0,0,-1
Cameroon,2006-05-01,6,0,0,0,0,6
Cameroon,2006-05-01,4,0,0,3,0,7
Cameroon,2006-05-01,4,0,0,3,0,7
Cameroon,2006-05-01,0,0,0,0,0,0
Cameroon,2006-05-01,0,0,0,0,0,0
Cameroon,2006-05-01,1,0,0,0,0,1
Cameroon,2006-05-01,0,0,0,0,0,0
Cameroon,2006-05-01,0,0,0,0,0,0
Cameroon,2006-05-01,0,0,0,0,0,0
Cameroon,2006-05-01,1,0,0,3,0,4
Cameroon,2006-05-01,0,0,0,0,0,0
Cameroon,2006-05-01,0,0,0,0,0,0
Cameroon,2006-05-01,0,0,0,3,0,3
Cameroon,2006-05-01,0,0,0,0,0,0
Cameroon,2006-05-01,0,0,0,0,0,0
Cameroon,2006-05-01,0,0,0,0,1,1
Cameroon,2006-05-01,0,0,0,6,0,6
Cameroon,2006-05-01,0,0,0,0,0,0
China,2006-05-01,30,0,0,10,0,40
China,2006-05-01,18,0,0,14,0,32
China,2006-05-01,7,0,2,3,1,13
China,2006-05-01,16,0,-2,0,2,16
China,2006-05-01,-3,0,0,3,0,0
China,2006-05-01,10,0,0,12,1,23
China,2006-05-01,8,0,0,-2,0,6
China,2006-05-01,15,0,1,0,2,18
China,2006-05-01,25,0,0,1,3,29
China,2006-05-01,45,0,0,12,1,58
China,2006-05-01,43,0,-2,3,2,46
China,2006-05-01,62,0,0,16,5,83
China,2006-05-01,34,0,0,9,0,43
China,2006-05-01,6,0,0,-8,0,-2
China,2006-05-01,18,6,0,1,4,29
China,2006-05-01,50,0,0,4,2,56
China,2006-05-01,25,0,0,6,5,36
China,2006-05-01,17,0,2,25,4,48
China,2006-05-01,17,0,2,13,4,36
China,2006-05-01,16,0,0,13,3,32
China,2006-05-01,3,0,0,0,0,3
China,2006-05-01,19,4,-1,6,5,33
China,2006-05-01,40,0,0,21,2,63
China,2006-05-01,44,0,-4,15,3,58
China,2006-05-01,27,0,0,2,1,30
China,2006-05-01,9,0,0,14,0,23
China,2006-05-01,5,0,0,3,4,12
China,2006-05-01,3,2,0,1,0,6
China,2006-05-01,15,0,-5,-2,4,12
China,2006-05-01,77,0,-2,13,7,95
China,2006-05-01,6,2,0,7,4,19
Egypt,2006-05-01,5,0,4,0,0,9
Egypt,2006-05-01,5,0,0,0,0,5
Egypt,2006-05-01,0,0,0,0,1,1
Egypt,2006-05-01,12,0,0,6,0,18
Egypt,2006-05-01,2,0,0,0,0,2
Egypt,2006-05-01,0,0,0,3,0,3
Egypt,2006-05-01,0,0,0,0,0,0
Egypt,2006-05-01,5,0,0,0,0,5
Egypt,2006-05-01,32,0,1,25,10,68
Egypt,2006-05-01,4,0,0,4,0,8
Egypt,2006-05-01,6,0,0,9,0,15
Egypt,2006-05-01,24,0,0,25,0,49
Egypt,2006-05-01,-1,0,0,3,0,2
Egypt,2006-05-01,4,0,0,0,0,4
Egypt,2006-05-01,3,0,0,0,2,5
Egypt,2006-05-01,19,0,0,3,0,22
Egypt,2006-05-01,6,0,0,18,1,25
Egypt,2006-05-01,9,0,0,-2,0,7
Egypt,2006-05-01,34,2,0,12,0,48
Egypt,2006-05-01,3,0,0,12,6,21
Egypt,2006-05-01,9,0,1,9,2,21
Egypt,2006-05-01,35,0,0,6,1,42
Egypt,2006-05-01,15,0,0,0,3,18
Egypt,2006-05-01,6,0,0,0,0,6
Egypt,2006-05-01,4,0,0,0,0,4
Egypt,2006-05-01,0,0,0,3,1,4
Egypt,2006-05-01,5,0,0,-3,1,3
Egypt,2006-05-01,6,0,0,6,0,12
Egypt,2006-05-01,9,0,0,9,2,20
Egypt,2006-05-01,4,0,0,10,0,14
Egypt,2006-05-01,8,0,0,9,2,19
Eritrea,2006-05-01,0,2,0,0,0,2
Eritrea,2006-05-01,0,0,0,9,0,9
Eritrea,2006-05-01,0,0,0,6,1,7
Eritrea,2006-05-01,1,0,0,0,0,1
Eritrea,2006-05-01,0,0,0,0,0,0
Eritrea,2006-05-01,0,0,0,0,0,0
Eritrea,2006-05-01,0,0,0,0,0,0
Eritrea,2006-05-01,0,0,0,0,0,0
Eritrea,2006-05-01,0,0,0,0,0,0
Eritrea,2006-05-01,0,0,0,0,0,0
Eritrea,2006-05-01,10,0,0,9,1,20
Eritrea,2006-05-01,9,0,0,-1,3,11
Eritrea,2006-05-01,0,0,0,-1,0,-1
Eritrea,2006-05-01,0,0,0,4,0,4
Eritrea,2006-05-01,8,0,1,0,5,14
Eritrea,2006-05-01,2,0,0,-6,0,-4
Eritrea,2006-05-01,0,0,0,0,0,0
Eritrea,2006-05-01,0,0,0,0,0,0
Eritrea,2006-05-01,-3,0,0,3,0,0
Eritrea,2006-05-01,1,2,0,3,0,6
Eritrea,2006-05-01,-2,0,0,0,0,-2
Eritrea,2006-05-01,3,0,0,0,0,3
Eritrea,2006-05-01,0,0,0,0,0,0
Eritrea,2006-05-01,0,0,0,0,0,0
Eritrea,2006-05-01,1,0,0,0,1,2
Eritrea,2006-05-01,0,0,0,0,0,0
Eritrea,2006-05-01,0,0,0,0,0,0
Eritrea,2006-05-01,0,0,0,0,0,0
Georgia,2006-05-01,0,0,0,0,0,0
Georgia,2006-05-01,6,0,0,3,0,9
Georgia,2006-05-01,2,0,0,0,0,2
Georgia,2006-05-01,-2,0,0,0,0,-2
Georgia,2006-05-01,-9,0,0,6,0,-3
Georgia,2006-05-01,0,0,0,0,0,0
Georgia,2006-05-01,3,0,0,0,2,5
Georgia,2006-05-01,-3,0,-2,0,2,-3
Georgia,2006-05-01,3,0,0,0,0,3
Georgia,2006-05-01,1,0,0,0,0,1
Georgia,2006-05-01,0,0,0,0,0,0
Georgia,2006-05-01,2,0,0,0,0,2
Georgia,2006-05-01,-3,0,0,0,0,-3
Georgia,2006-05-01,0,0,0,0,0,0
Georgia,2006-05-01,0,0,0,0,0,0
Georgia,2006-05-01,3,0,0,0,1,4
Georgia,2006-05-01,7,0,0,9,2,18
Georgia,2006-05-01,4,0,0,12,2,18
Georgia,2006-05-01,2,0,0,3,0,5
Georgia,2006-05-01,1,0,0,0,0,1
Georgia,2006-05-01,-1,0,0,0,0,-1
Georgia,2006-05-01,-1,0,0,6,0,5
Georgia,2006-05-01,12,0,-2,6,0,16
Georgia,2006-05-01,0,0,0,0,0,0
Georgia,2006-05-01,-6,0,0,0,0,-6
Georgia,2006-05-01,3,0,0,0,0,3
Georgia,2006-05-01,0,0,0,0,0,0
Georgia,2006-05-01,6,0,-2,0,1,5
Georgia,2006-05-01,0,2,0,0,0,2
India,2006-05-01,3,0,0,-1,1,3
India,2006-05-01,12,0,0,3,1,16
India,2006-05-01,4,0,0,0,1,5
India,2006-05-01,9,0,-2,0,1,8
India,2006-05-01,-1,2,0,0,0,1
India,2006-05-01,3,0,0,0,4,7
India,2006-05-01,6,0,0,-4,0,2
India,2006-05-01,19,0,0,3,0,22
India,2006-05-01,5,0,0,0,0,5
India,2006-05-01,7,0,0,0,0,7
India,2006-05-01,27,0,-1,11,5,42
India,2006-05-01,11,0,0,-2,5,14
India,2006-05-01,2,0,0,0,0,2
India,2006-05-01,10,0,0,6,0,16
India,2006-05-01,0,0,0,10,0,10
India,2006-05-01,28,2,0,-3,0,27
India,2006-05-01,4,0,0,21,2,27
India,2006-05-01,9,2,0,3,9,23
India,2006-05-01,3,0,0,0,1,4
India,2006-05-01,1,0,0,0,0,1
India,2006-05-01,5,0,0,0,0,5
India,2006-05-01,9,0,0,6,1,16
India,2006-05-01,13,2,-2,9,10,32
India,2006-05-01,13,0,0,6,4,23
India,2006-05-01,8,0,-2,13,0,19
India,2006-05-01,9,0,-2,-4,0,3
India,2006-05-01,15,0,0,-2,1,14
India,2006-05-01,14,0,0,3,1,18
India,2006-05-01,14,2,1,4,5,26
India,2006-05-01,11,2,0,1,1,15
Iran,2006-05-01,26,2,0,0,0,28
Iran,2006-05-01,35,0,0,3,3,41
Iran,2006-05-01,27,0,0,2,4,33
Iran,2006-05-01,-3,0,1,6,1,5
Iran,2006-05-01,25,0,0,3,0,28
Iran,2006-05-01,0,0,0,9,0,9
Iran,2006-05-01,24,0,-4,-3,4,21
Iran,2006-05-01,25,0,0,0,3,28
Iran,2006-05-01,22,0,0,4,2,28
Iran,2006-05-01,42,0,0,6,2,50
Iran,2006-05-01,21,0,0,14,4,39
Iran,2006-05-01,36,2,1,27,7,73
Iran,2006-05-01,18,2,0,-1,2,21
Iran,2006-05-01,37,0,-2,6,4,45
Iran,2006-05-01,45,0,1,-2,8,52
Iran,2006-05-01,23,0,1,-2,6,28
Iran,2006-05-01,32,0,1,10,12,55
Iran,2006-05-01,19,0,0,0,2,21
Iran,2006-05-01,23,0,0,6,-1,28
Iran,2006-05-01,18,0,0,4,3,25
Iran,2006-05-01,20,0,0,0,2,22
Iran,2006-05-01,37,2,0,4,3,46
Iran,2006-05-01,51,2,-1,6,7,65
Iran,2006-05-01,57,0,0,4,5,66
Iran,2006-05-01,34,0,1,6,0,41
Iran,2006-05-01,33,4,1,11,4,53
Iran,2006-05-01,-4,4,0,6,3,9
Iran,2006-05-01,5,0,0,3,1,9
Iran,2006-05-01,52,0,0,-2,8,58
Iran,2006-05-01,34,0,0,24,14,72
Iran,2006-05-01,24,0,1,-2,3,26
Iraq,2006-05-01,49,0,-2,18,3,68
Iraq,2006-05-01,43,0,-2,22,4,67
Iraq,2006-05-01,31,0,-2,11,5,45
Iraq,2006-05-01,41,0,0,15,4,60
Iraq,2006-05-01,12,0,1,-4,0,9
Iraq,2006-05-01,48,0,0,7,7,62
Iraq,2006-05-01,51,0,1,21,4,77
Iraq,2006-05-01,76,0,0,5,11,92
Iraq,2006-05-01,52,0,-2,9,3,62
Iraq,2006-05-01,41,0,0,17,0,58
Iraq,2006-05-01,47,0,0,27,1,75
Iraq,2006-05-01,144,2,-2,43,7,194
Iraq,2006-05-01,47,0,1,3,0,51
Iraq,2006-05-01,20,0,-2,12,4,34
Iraq,2006-05-01,63,0,2,4,11,80
Iraq,2006-05-01,19,0,0,20,1,40
Iraq,2006-05-01,39,0,0,27,4,70
Iraq,2006-05-01,50,0,1,6,1,58
Iraq,2006-05-01,45,0,0,16,2,63
Iraq,2006-05-01,61,0,1,-1,12,73
Iraq,2006-05-01,8,0,0,3,1,12
Iraq,2006-05-01,74,0,1,73,11,159
Iraq,2006-05-01,119,0,2,43,18,182
Iraq,2006-05-01,59,0,-3,60,10,126
Iraq,2006-05-01,30,0,-1,33,14,76
Iraq,2006-05-01,43,0,3,9,0,55
Iraq,2006-05-01,45,0,0,5,4,54
Iraq,2006-05-01,51,0,0,19,3,73
Iraq,2006-05-01,96,0,0,29,16,141
Iraq,2006-05-01,45,0,0,2,11,58
Iraq,2006-05-01,54,0,0,18,4,76
Morocco,2006-05-01,0,0,0,0,0,0
Morocco,2006-05-01,4,0,0,0,0,4
Morocco,2006-05-01,1,0,0,6,0,7
Morocco,2006-05-01,7,0,0,6,0,13
Morocco,2006-05-01,0,0,0,0,0,0
Morocco,2006-05-01,0,0,0,0,0,0
Morocco,2006-05-01,0,0,0,0,0,0
Morocco,2006-05-01,0,0,0,0,0,0
Morocco,2006-05-01,0,0,0,0,0,0
Morocco,2006-05-01,2,0,0,0,0,2
Morocco,2006-05-01,0,0,0,0,0,0
Morocco,2006-05-01,4,0,0,3,0,7
Morocco,2006-05-01,1,0,0,15,0,16
Morocco,2006-05-01,4,0,0,0,0,4
Morocco,2006-05-01,7,0,0,0,0,7
Morocco,2006-05-01,1,0,0,6,0,7
Morocco,2006-05-01,0,0,0,6,2,8
Morocco,2006-05-01,4,0,0,0,0,4
Morocco,2006-05-01,3,0,0,18,2,23
Morocco,2006-05-01,0,0,0,3,0,3
Morocco,2006-05-01,0,0,0,1,0,1
Morocco,2006-05-01,3,0,0,0,0,3
Morocco,2006-05-01,25,0,0,5,0,30
Morocco,2006-05-01,4,0,0,12,0,16
Morocco,2006-05-01,0,0,0,-4,0,-4
Morocco,2006-05-01,2,0,1,11,0,14
Morocco,2006-05-01,0,0,0,0,0,0
Morocco,2006-05-01,6,0,0,0,0,6
Morocco,2006-05-01,0,0,0,0,0,0
Morocco,2006-05-01,0,0,0,6,0,6
Morocco,2006-05-01,0,0,0,6,0,6
Nigeria,2006-05-01,8,0,-1,3,1,11
Nigeria,2006-05-01,12,0,1,0,1,14
Nigeria,2006-05-01,9,0,0,0,1,10
Nigeria,2006-05-01,5,0,-2,-1,0,2
Nigeria,2006-05-01,19,0,0,0,3,22
Nigeria,2006-05-01,0,0,-2,0,0,-2
Nigeria,2006-05-01,4,0,0,0,0,4
Nigeria,2006-05-01,12,0,0,2,5,19
Nigeria,2006-05-01,16,0,1,6,4,27
Nigeria,2006-05-01,4,0,-1,3,0,6
Nigeria,2006-05-01,13,0,0,1,0,14
Nigeria,2006-05-01,18,0,-1,0,1,18
Nigeria,2006-05-01,1,0,0,0,2,3
Nigeria,2006-05-01,3,0,0,6,0,9
Nigeria,2006-05-01,12,0,0,0,4,16
Nigeria,2006-05-01,15,0,0,-2,-3,10
Nigeria,2006-05-01,10,0,0,-2,4,12
Nigeria,2006-05-01,8,0,0,5,2,15
Nigeria,2006-05-01,12,0,0,1,2,15
Nigeria,2006-05-01,5,0,0,4,1,10
Nigeria,2006-05-01,6,0,-2,3,0,7
Nigeria,2006-05-01,29,0,1,9,0,39
Nigeria,2006-05-01,45,0,-1,0,4,48
Nigeria,2006-05-01,20,6,2,30,5,63
Nigeria,2006-05-01,15,0,0,2,3,20
Nigeria,2006-05-01,5,0,0,12,5,22
Nigeria,2006-05-01,7,0,0,0,0,7
Nigeria,2006-05-01,0,0,0,3,0,3
Nigeria,2006-05-01,16,0,0,6,2,24
Nigeria,2006-05-01,8,0,0,3,1,12
Nigeria,2006-05-01,0,0,0,6,2,8
Pakistan,2006-05-01,3,0,0,9,0,12
Pakistan,2006-05-01,17,0,0,30,5,52
Pakistan,2006-05-01,3,0,0,0,2,5
Pakistan,2006-05-01,25,0,0,14,0,39
Pakistan,2006-05-01,9,0,0,10,0,19
Pakistan,2006-05-01,2,0,0,3,0,5
Pakistan,2006-05-01,3,0,0,-2,0,1
Pakistan,2006-05-01,3,0,0,25,0,28
Pakistan,2006-05-01,34,0,0,21,0,55
Pakistan,2006-05-01,7,0,0,15,2,24
Pakistan,2006-05-01,47,6,-2,12,7,70
Pakistan,2006-05-01,62,2,-2,11,6,79
Pakistan,2006-05-01,14,0,1,10,0,25
Pakistan,2006-05-01,14,0,0,10,0,24
Pakistan,2006-05-01,30,0,0,9,3,42
Pakistan,2006-05-01,12,0,0,-4,0,8
Pakistan,2006-05-01,25,0,-4,18,0,39
Pakistan,2006-05-01,26,0,1,-4,10,33
Pakistan,2006-05-01,59,0,0,11,14,84
Pakistan,2006-05-01,14,0,0,11,1,26
Pakistan,2006-05-01,23,0,0,0,17,40
Pakistan,2006-05-01,23,0,0,1,5,29
Pakistan,2006-05-01,32,0,0,3,4,39
Pakistan,2006-05-01,41,0,0,27,1,69
Pakistan,2006-05-01,13,0,0,27,8,48
Pakistan,2006-05-01,6,0,0,4,0,10
Pakistan,2006-05-01,11,0,0,1,0,12
Pakistan,2006-05-01,19,0,0,0,0,19
Pakistan,2006-05-01,26,0,0,6,2,34
Pakistan,2006-05-01,9,0,0,17,0,26
Pakistan,2006-05-01,5,0,0,9,1,15
Sierra Leone,2006-05-01,3,0,0,6,0,9
Sierra Leone,2006-05-01,2,0,0,-2,0,0
Sierra Leone,2006-05-01,0,0,0,0,0,0
Sierra Leone,2006-05-01,2,0,0,3,0,5
Sierra Leone,2006-05-01,0,0,0,0,0,0
Sierra Leone,2006-05-01,0,0,0,0,0,0
Sierra Leone,2006-05-01,6,0,0,3,0,9
Sierra Leone,2006-05-01,7,0,0,6,2,15
Sierra Leone,2006-05-01,-2,0,0,-2,0,-4
Sierra Leone,2006-05-01,0,0,0,3,0,3
Sierra Leone,2006-05-01,6,0,0,6,0,12
Sierra Leone,2006-05-01,0,0,0,0,0,0
Sierra Leone,2006-05-01,0,0,0,0,0,0
Sierra Leone,2006-05-01,0,0,-2,1,0,-1
Sierra Leone,2006-05-01,0,0,-3,9,0,6
Sierra Leone,2006-05-01,10,0,0,8,1,19
Sierra Leone,2006-05-01,3,0,0,6,0,9
Sierra Leone,2006-05-01,2,0,0,-2,5,5
Sierra Leone,2006-05-01,5,0,0,-2,0,3
Sierra Leone,2006-05-01,0,0,0,0,1,1
Sierra Leone,2006-05-01,0,0,1,3,0,4
Sierra Leone,2006-05-01,0,0,0,9,0,9
Sierra Leone,2006-05-01,-1,2,1,9,1,12
Sierra Leone,2006-05-01,-1,0,0,9,1,9
Sierra Leone,2006-05-01,0,0,0,0,0,0
Sierra Leone,2006-05-01,2,0,0,0,0,2
Sierra Leone,2006-05-01,-1,0,0,6,0,5
Sierra Leone,2006-05-01,1,0,0,6,0,7
Somalia,2006-05-01,7,0,0,0,0,7
Somalia,2006-05-01,10,0,0,3,0,13
Somalia,2006-05-01,12,2,0,12,0,26
Somalia,2006-05-01,1,0,0,0,0,1
Somalia,2006-05-01,7,0,0,-1,0,6
Somalia,2006-05-01,0,0,0,0,0,0
Somalia,2006-05-01,0,0,0,3,0,3
Somalia,2006-05-01,0,0,0,0,0,0
Somalia,2006-05-01,0,0,0,0,0,0
Somalia,2006-05-01,2,0,0,0,0,2
Somalia,2006-05-01,0,0,1,0,0,1
Somalia,2006-05-01,27,2,0,2,2,33
Somalia,2006-05-01,8,4,0,5,0,17
Somalia,2006-05-01,7,0,0,0,0,7
Somalia,2006-05-01,8,0,0,0,0,8
Somalia,2006-05-01,13,0,0,0,0,13
Somalia,2006-05-01,5,0,0,2,0,7
Somalia,2006-05-01,0,0,0,0,1,1
Somalia,2006-05-01,6,0,0,0,0,6
Somalia,2006-05-01,6,0,0,0,0,6
Somalia,2006-05-01,8,0,0,0,0,8
Somalia,2006-05-01,0,0,0,15,0,15
Somalia,2006-05-01,2,0,0,3,0,5
Somalia,2006-05-01,0,0,0,6,0,6
Somalia,2006-05-01,12,0,0,-2,1,11
Somalia,2006-05-01,1,0,0,0,1,2
Somalia,2006-05-01,0,0,0,5,0,5
Somalia,2006-05-01,6,0,0,0,0,6
Somalia,2006-05-01,1,0,0,0,0,1
Somalia,2006-05-01,-1,0,0,-4,0,-5
Somalia,2006-05-01,0,0,0,0,4,4
Syria,2006-05-01,6,0,0,3,0,9
Syria,2006-05-01,7,0,0,8,0,15
Syria,2006-05-01,4,0,0,-2,0,2
Syria,2006-05-01,14,0,-8,0,0,6
Syria,2006-05-01,3,0,0,0,0,3
Syria,2006-05-01,0,0,0,3,0,3
Syria,2006-05-01,0,0,0,0,0,0
Syria,2006-05-01,-1,0,0,6,3,8
Syria,2006-05-01,-5,0,0,12,0,7
Syria,2006-05-01,6,0,0,3,2,11
Syria,2006-05-01,12,0,0,14,2,28
Syria,2006-05-01,34,0,0,0,0,34
Syria,2006-05-01,2,0,0,19,1,22
Syria,2006-05-01,1,0,0,9,0,10
Syria,2006-05-01,-2,0,0,12,0,10
Syria,2006-05-01,3,0,0,7,5,15
Syria,2006-05-01,9,0,0,-1,0,8
Syria,2006-05-01,28,0,0,0,0,28
Syria,2006-05-01,22,0,0,0,12,34
Syria,2006-05-01,7,0,0,0,9,16
Syria,2006-05-01,9,0,0,7,0,16
Syria,2006-05-01,0,0,0,4,0,4
Syria,2006-05-01,0,0,0,9,0,9
Syria,2006-05-01,5,0,0,21,0,26
Syria,2006-05-01,4,0,0,3,0,7
Syria,2006-05-01,6,2,0,0,0,8
Syria,2006-05-01,26,0,0,0,0,26
Syria,2006-05-01,8,0,0,-4,0,4
Syria,2006-05-01,6,0,0,3,0,9
Syria,2006-05-01,6,0,0,0,0,6
Yemen,2006-05-01,0,0,0,0,0,0
Yemen,2006-05-01,3,0,0,6,0,9
Yemen,2006-05-01,3,0,0,3,0,6
Yemen,2006-05-01,0,0,0,3,0,3
Yemen,2006-05-01,0,0,0,0,0,0
Yemen,2006-05-01,3,0,0,0,0,3
Yemen,2006-05-01,0,0,0,6,0,6
Yemen,2006-05-01,0,0,0,-2,0,-2
Yemen,2006-05-01,0,0,0,0,0,0
Yemen,2006-05-01,0,0,0,0,0,0
Yemen,2006-05-01,6,0,0,7,0,13
Yemen,2006-05-01,0,0,0,0,0,0
Yemen,2006-05-01,3,0,0,0,0,3
Yemen,2006-05-01,4,0,0,0,0,4
Yemen,2006-05-01,0,0,0,0,0,0
Yemen,2006-05-01,2,0,0,0,0,2
Yemen,2006-05-01,0,0,0,0,0,0
Yemen,2006-05-01,0,0,0,0,0,0
Yemen,2006-05-01,0,0,0,0,0,0
Yemen,2006-05-01,0,0,0,0,0,0
Yemen,2006-05-01,0,0,0,0,2,2
Yemen,2006-05-01,0,0,0,0,0,0
Yemen,2006-05-01,0,0,0,0,0,0
Yemen,2006-05-01,1,0,0,0,0,1
Yemen,2006-05-01,0,0,0,0,0,0
Afghanistan,2007-02-01,87,0,0,47,6,140
Afghanistan,2007-02-01,79,0,1,30,3,113
Afghanistan,2007-02-01,87,0,0,39,22,148
Afghanistan,2007-02-01,30,0,1,15,3,49
Afghanistan,2007-02-01,57,2,1,63,10,133
Afghanistan,2007-02-01,85,2,-4,15,3,101
Afghanistan,2007-02-01,61,2,-1,7,14,83
Afghanistan,2007-02-01,123,0,-1,-5,1,118
Afghanistan,2007-02-01,29,0,0,1,5,35
Afghanistan,2007-02-01,46,0,0,1,0,47
Afghanistan,2007-02-01,64,0,0,10,6,80
Afghanistan,2007-02-01,94,4,-3,3,11,109
Afghanistan,2007-02-01,45,4,0,21,4,74
Afghanistan,2007-02-01,137,2,0,45,9,193
Afghanistan,2007-02-01,70,0,-1,24,6,99
Afghanistan,2007-02-01,73,2,0,40,4,119
Afghanistan,2007-02-01,91,2,-2,8,20,119
Afghanistan,2007-02-01,84,0,0,22,28,134
Afghanistan,2007-02-01,99,0,0,38,2,139
Afghanistan,2007-02-01,86,0,2,9,7,104
Afghanistan,2007-02-01,63,0,-27,9,3,48
Afghanistan,2007-02-01,62,2,-8,16,23,95
Afghanistan,2007-02-01,65,2,0,47,6,120
Afghanistan,2007-02-01,44,0,4,13,1,62
Afghanistan,2007-02-01,50,0,1,12,3,66
Afghanistan,2007-02-01,97,0,2,27,7,133
Afghanistan,2007-02-01,117,0,0,-6,9,120
Afghanistan,2007-02-01,69,0,-6,27,7,97
Albania,2007-02-01,31,0,-2,-2,0,27
Albania,2007-02-01,78,0,-5,14,5,92
Albania,2007-02-01,27,0,0,3,0,30
Albania,2007-02-01,3,0,1,12,1,17
Albania,2007-02-01,32,0,0,-1,6,37
Albania,2007-02-01,4,0,-2,6,0,8
Albania,2007-02-01,6,0,-1,12,0,17
Albania,2007-02-01,10,0,-1,3,0,12
Albania,2007-02-01,8,0,-7,0,2,3
Albania,2007-02-01,6,2,-7,6,8,15
Albania,2007-02-01,9,4,-2,12,10,33
Albania,2007-02-01,13,0,-4,12,9,30
Albania,2007-02-01,9,0,-2,9,4,20
Albania,2007-02-01,27,0,-10,6,4,27
Albania,2007-02-01,22,0,-8,4,4,22
Albania,2007-02-01,22,0,0,0,1,23
Albania,2007-02-01,0,0,0,3,0,3
Albania,2007-02-01,0,0,0,0,0,0
Albania,2007-02-01,37,0,0,-2,0,35
Albania,2007-02-01,9,0,-4,0,6,11
Albania,2007-02-01,11,0,0,0,2,13
Albania,2007-02-01,29,0,-1,0,0,28
Albania,2007-02-01,31,0,0,3,1,35
Albania,2007-02-01,12,0,-3,0,1,10
Albania,2007-02-01,0,0,-1,0,0,-1
Albania,2007-02-01,11,0,0,0,6,17
Albania,2007-02-01,5,0,0,9,1,15
Albania,2007-02-01,10,0,-1,3,4,16
Algeria,2007-02-01,8,0,0,6,0,14
Algeria,2007-02-01,5,0,0,0,0,5
Algeria,2007-02-01,0,0,0,0,0,0
Algeria,2007-02-01,0,0,0,0,0,0
Algeria,2007-02-01,11,0,0,0,0,11
Algeria,2007-02-01,-6,0,0,6,0,0
Algeria,2007-02-01,7,0,0,3,0,10
Algeria,2007-02-01,18,0,0,6,0,24
Algeria,2007-02-01,7,0,0,18,0,25
Algeria,2007-02-01,1,0,0,0,0,1
Algeria,2007-02-01,0,0,0,0,0,0
Algeria,2007-02-01,0,0,0,0,0,0
Algeria,2007-02-01,11,0,0,-2,0,9
Algeria,2007-02-01,0,0,0,0,0,0
Algeria,2007-02-01,0,0,0,0,0,0
Algeria,2007-02-01,0,0,0,0,0,0
Algeria,2007-02-01,25,0,0,-4,0,21
Algeria,2007-02-01,0,0,0,4,0,4
Algeria,2007-02-01,15,0,0,6,0,21
Algeria,2007-02-01,6,0,0,0,0,6
Algeria,2007-02-01,0,0,0,0,4,4
Algeria,2007-02-01,1,0,0,-5,0,-4
Algeria,2007-02-01,10,0,0,8,0,18
Algeria,2007-02-01,0,0,0,-10,0,-10
Algeria,2007-02-01,-3,0,0,6,0,3
Algeria,2007-02-01,5,0,0,1,0,6
Algeria,2007-02-01,1,0,0,0,2,3
Bangladesh,2007-02-01,2,0,0,0,4,6
Bangladesh,2007-02-01,3,0,0,0,0,3
Bangladesh,2007-02-01,2,0,0,4,0,6
Bangladesh,2007-02-01,14,0,-6,34,4,46
Bangladesh,2007-02-01,1,0,0,-2,0,-1
Bangladesh,2007-02-01,2,0,0,9,1,12
Bangladesh,2007-02-01,2,0,0,-8,0,-6
Bangladesh,2007-02-01,2,0,-4,5,2,5
Bangladesh,2007-02-01,6,0,-4,7,7,16
Bangladesh,2007-02-01,0,0,1,0,0,1
Bangladesh,2007-02-01,0,0,0,0,0,0
Bangladesh,2007-02-01,3,0,0,1,0,4
Bangladesh,2007-02-01,21,0,-3,9,-2,25
Bangladesh,2007-02-01,5,0,-2,0,0,3
Bangladesh,2007-02-01,0,0,0,-1,0,-1
Bangladesh,2007-02-01,5,0,-1,0,1,5
Bangladesh,2007-02-01,0,0,-4,-2,0,-6
Bangladesh,2007-02-01,18,0,0,0,0,18
Bangladesh,2007-02-01,22,0,0,30,4,56
Bangladesh,2007-02-01,21,0,0,3,1,25
Bangladesh,2007-02-01,12,0,0,0,0,12
Bangladesh,2007-02-01,2,0,-4,6,0,4
Bangladesh,2007-02-01,12,0,0,-2,0,10
Bangladesh,2007-02-01,0,0,0,6,0,6
Bangladesh,2007-02-01,13,0,-4,-2,0,7
Bangladesh,2007-02-01,4,0,0,7,0,11
Bangladesh,2007-02-01,2,0,0,-5,0,-3
Bangladesh,2007-02-01,0,0,-2,9,0,7
Cameroon,2007-02-01,0,0,0,0,0,0
Cameroon,2007-02-01,0,0,0,0,0,0
Cameroon,2007-02-01,0,0,0,0,0,0
Cameroon,2007-02-01,0,0,0,0,0,0
Cameroon,2007-02-01,0,0,0,0,0,0
Cameroon,2007-02-01,0,0,0,0,0,0
Cameroon,2007-02-01,0,0,0,6,0,6
Cameroon,2007-02-01,0,0,0,0,0,0
Cameroon,2007-02-01,5,0,0,0,2,7
Cameroon,2007-02-01,0,0,0,0,0,0
Cameroon,2007-02-01,0,0,0,0,0,0
Cameroon,2007-02-01,0,0,0,0,0,0
Cameroon,2007-02-01,0,0,0,0,0,0
Cameroon,2007-02-01,0,0,0,0,0,0
Cameroon,2007-02-01,0,0,0,0,0,0
Cameroon,2007-02-01,0,0,-2,0,0,-2
Cameroon,2007-02-01,0,0,0,0,1,1
China,2007-02-01,31,4,-2,14,3,50
China,2007-02-01,59,0,2,4,11,76
China,2007-02-01,12,2,0,4,6,24
China,2007-02-01,17,0,1,-2,3,19
China,2007-02-01,72,0,0,33,5,110
China,2007-02-01,36,0,0,17,3,56
China,2007-02-01,69,2,0,43,5,119
China,2007-02-01,56,0,0,26,4,86
China,2007-02-01,58,0,1,23,5,87
China,2007-02-01,8,12,0,10,6,36
China,2007-02-01,23,0,0,3,7,33
China,2007-02-01,47,0,-1,24,16,86
China,2007-02-01,50,0,1,15,7,73
China,2007-02-01,30,0,4,7,5,46
China,2007-02-01,56,2,0,28,10,96
China,2007-02-01,33,0,0,18,6,57
China,2007-02-01,35,0,0,8,10,53
China,2007-02-01,46,0,0,12,4,62
China,2007-02-01,34,4,-2,44,7,87
China,2007-02-01,65,0,0,43,13,121
China,2007-02-01,59,0,0,20,13,92
China,2007-02-01,33,4,-3,60,2,96
China,2007-02-01,77,0,6,33,13,129
China,2007-02-01,36,0,-7,22,2,53
China,2007-02-01,16,0,0,5,0,21
China,2007-02-01,48,2,-4,19,4,69
China,2007-02-01,111,0,-2,11,23,143
China,2007-02-01,134,0,0,34,18,186
Egypt,2007-02-01,72,2,0,14,18,106
Egypt,2007-02-01,142,4,0,5,12,163
Egypt,2007-02-01,35,0,0,21,0,56
Egypt,2007-02-01,19,0,0,-1,0,18
Egypt,2007-02-01,3,0,0,21,0,24
Egypt,2007-02-01,20,0,0,36,0,56
Egypt,2007-02-01,11,0,0,4,0,15
Egypt,2007-02-01,2,0,0,12,0,14
Egypt,2007-02-01,16,0,0,4,4,24
Egypt,2007-02-01,4,0,0,2,6,12
Egypt,2007-02-01,11,0,0,-2,1,10
Egypt,2007-02-01,14,0,-4,13,0,23
Egypt,2007-02-01,12,0,2,11,0,25
Egypt,2007-02-01,6,0,0,9,0,15
Egypt,2007-02-01,20,0,-8,56,0,68
Egypt,2007-02-01,27,0,-4,58,0,81
Egypt,2007-02-01,0,0,0,8,2,10
Egypt,2007-02-01,17,0,0,0,0,17
Egypt,2007-02-01,12,0,0,12,0,24
Egypt,2007-02-01,13,0,0,9,0,22
Egypt,2007-02-01,9,0,0,13,0,22
Egypt,2007-02-01,7,0,1,-4,18,22
Egypt,2007-02-01,-4,0,0,35,10,41
Egypt,2007-02-01,5,0,0,7,0,12
Egypt,2007-02-01,9,0,0,3,1,13
Egypt,2007-02-01,-3,0,0,6,1,4
Egypt,2007-02-01,8,0,0,6,0,14
Egypt,2007-02-01,10,0,0,18,3,31
Eritrea,2007-02-01,0,0,0,0,0,0
Eritrea,2007-02-01,1,0,0,-7,3,-3
Eritrea,2007-02-01,1,0,0,0,0,1
Eritrea,2007-02-01,0,0,0,6,0,6
Eritrea,2007-02-01,1,0,0,0,0,1
Eritrea,2007-02-01,0,0,0,6,0,6
Eritrea,2007-02-01,6,0,0,0,0,6
Eritrea,2007-02-01,0,0,0,0,0,0
Eritrea,2007-02-01,0,0,0,0,0,0
Eritrea,2007-02-01,2,0,0,0,0,2
Eritrea,2007-02-01,6,0,0,0,0,6
Eritrea,2007-02-01,4,0,0,0,0,4
Eritrea,2007-02-01,0,0,0,0,1,1
Eritrea,2007-02-01,0,0,0,0,0,0
Eritrea,2007-02-01,0,0,-2,0,0,-2
Eritrea,2007-02-01,-4,0,0,0,0,-4
Eritrea,2007-02-01,10,0,0,0,0,10
Eritrea,2007-02-01,2,0,0,7,0,9
Eritrea,2007-02-01,7,0,0,0,0,7
Eritrea,2007-02-01,1,0,0,0,2,3
Eritrea,2007-02-01,1,2,0,0,0,3
Eritrea,2007-02-01,2,0,0,0,0,2
Eritrea,2007-02-01,0,0,0,0,0,0
Eritrea,2007-02-01,0,0,0,18,0,18
Georgia,2007-02-01,4,0,0,0,0,4
Georgia,2007-02-01,0,0,-2,0,0,-2
Georgia,2007-02-01,0,0,0,0,0,0
Georgia,2007-02-01,0,0,0,0,0,0
Georgia,2007-02-01,2,0,0,6,2,10
Georgia,2007-02-01,0,0,0,0,0,0
Georgia,2007-02-01,1,0,-1,9,0,9
Georgia,2007-02-01,0,0,0,0,0,0
Georgia,2007-02-01,0,0,0,0,0,0
Georgia,2007-02-01,0,0,0,0,0,0
Georgia,2007-02-01,0,0,0,0,0,0
Georgia,2007-02-01,2,0,0,0,0,2
Georgia,2007-02-01,9,0,0,0,0,9
Georgia,2007-02-01,0,0,0,0,0,0
Georgia,2007-02-01,-3,0,0,0,0,-3
Georgia,2007-02-01,15,0,0,-4,0,11
Georgia,2007-02-01,3,0,0,0,0,3
Georgia,2007-02-01,0,0,0,0,0,0
Georgia,2007-02-01,-1,0,0,3,0,2
Georgia,2007-02-01,0,0,0,0,0,0
Georgia,2007-02-01,2,0,0,0,2,4
Georgia,2007-02-01,3,0,0,3,0,6
Georgia,2007-02-01,3,0,0,0,0,3
Georgia,2007-02-01,0,0,0,0,0,0
Georgia,2007-02-01,0,0,0,0,0,0
Georgia,2007-02-01,3,0,0,6,0,9
Georgia,2007-02-01,2,0,0,3,0,5
Georgia,2007-02-01,3,0,0,0,0,3
India,2007-02-01,24,0,0,6,1,31
India,2007-02-01,14,0,0,0,2,16
India,2007-02-01,24,0,0,-7,0,17
India,2007-02-01,6,0,0,0,2,8
India,2007-02-01,22,0,-3,9,2,30
India,2007-02-01,18,0,0,0,7,25
India,2007-02-01,25,0,0,9,12,46
India,2007-02-01,12,0,0,1,0,13
India,2007-02-01,17,0,0,6,0,23
India,2007-02-01,8,0,0,3,0,11
India,2007-02-01,3,0,0,0,4,7
India,2007-02-01,6,0,-1,-8,1,-2
India,2007-02-01,12,0,0,16,0,28
India,2007-02-01,19,0,1,1,3,24
India,2007-02-01,11,0,0,4,3,18
India,2007-02-01,25,0,0,11,8,44
India,2007-02-01,10,0,0,2,0,12
India,2007-02-01,32,0,-1,5,0,36
India,2007-02-01,19,0,0,-10,4,13
India,2007-02-01,14,0,0,-8,4,10
India,2007-02-01,6,0,-2,0,0,4
India,2007-02-01,14,0,0,3,3,20
India,2007-02-01,13,2,-2,-2,1,12
India,2007-02-01,6,0,-2,3,1,8
India,2007-02-01,23,0,0,-5,9,27
India,2007-02-01,7,0,0,11,1,19
India,2007-02-01,7,0,0,4,1,12
India,2007-02-01,10,0,0,6,0,16
Iran,2007-02-01,47,0,3,32,5,87
Iran,2007-02-01,94,0,0,36,6,136
Iran,2007-02-01,40,0,0,4,4,48
Iran,2007-02-01,33,0,-2,15,3,49
Iran,2007-02-01,24,0,1,4,1,30
Iran,2007-02-01,1,0,1,109,7,118
Iran,2007-02-01,49,0,0,73,7,129
Iran,2007-02-01,79,0,0,19,0,98
Iran,2007-02-01,47,0,-2,-2,0,43
Iran,2007-02-01,41,2,0,5,4,52
Iran,2007-02-01,28,0,0,14,8,50
Iran,2007-02-01,65,0,0,46,8,119
Iran,2007-02-01,98,0,2,14,2,116
Iran,2007-02-01,81,0,0,14,9,104
Iran,2007-02-01,61,0,0,27,5,93
Iran,2007-02-01,54,0,0,18,3,75
Iran,2007-02-01,44,0,0,13,3,60
Iran,2007-02-01,3,0,0,12,0,15
Iran,2007-02-01,57,2,2,44,3,108
Iran,2007-02-01,39,0,0,30,1,70
Iran,2007-02-01,38,0,0,19,1,58
Iran,2007-02-01,60,0,-2,23,4,85
Iran,2007-02-01,73,0,1,8,2,84
Iran,2007-02-01,28,0,0,18,8,54
Iran,2007-02-01,68,0,-3,10,64,139
Iran,2007-02-01,57,0,0,4,14,75
Iran,2007-02-01,97,0,-3,18,8,120
Iran,2007-02-01,42,0,0,18,7,67
Iraq,2007-02-01,142,4,0,45,12,203
Iraq,2007-02-01,187,0,-6,40,18,239
Iraq,2007-02-01,69,0,-11,36,5,99
Iraq,2007-02-01,88,8,-5,18,22,131
Iraq,2007-02-01,133,12,-4,52,49,242
Iraq,2007-02-01,210,6,-4,30,22,264
Iraq,2007-02-01,133,4,-8,101,15,245
Iraq,2007-02-01,225,2,-2,100,5,330
Iraq,2007-02-01,160,8,-8,20,9,189
Iraq,2007-02-01,50,4,-3,26,2,79
Iraq,2007-02-01,53,0,2,0,7,62
Iraq,2007-02-01,68,6,0,46,6,126
Iraq,2007-02-01,126,6,0,55,19,206
Iraq,2007-02-01,149,4,-4,65,13,227
Iraq,2007-02-01,105,10,3,55,20,193
Iraq,2007-02-01,134,0,-2,70,10,212
Iraq,2007-02-01,146,0,2,3,5,156
Iraq,2007-02-01,133,0,1,36,30,200
Iraq,2007-02-01,72,0,-2,10,9,89
Iraq,2007-02-01,97,2,0,21,13,133
Iraq,2007-02-01,30,4,0,47,14,95
Iraq,2007-02-01,111,0,6,57,32,206
Iraq,2007-02-01,142,10,-7,112,38,295
Iraq,2007-02-01,93,18,6,45,7,169
Iraq,2007-02-01,102,0,0,-3,7,106
Iraq,2007-02-01,99,12,2,18,10,141
Iraq,2007-02-01,90,28,-4,11,11,136
Iraq,2007-02-01,28,4,3,24,20,79
Morocco,2007-02-01,7,0,0,0,2,9
Morocco,2007-02-01,5,0,0,18,1,24
Morocco,2007-02-01,0,0,0,3,0,3
Morocco,2007-02-01,3,0,0,26,0,29
Morocco,2007-02-01,0,0,0,3,0,3
Morocco,2007-02-01,2,0,0,3,0,5
Morocco,2007-02-01,2,0,0,0,0,2
Morocco,2007-02-01,0,0,0,3,0,3
Morocco,2007-02-01,0,0,0,0,0,0
Morocco,2007-02-01,0,0,0,0,0,0
Morocco,2007-02-01,4,0,0,30,6,40
Morocco,2007-02-01,6,0,0,12,0,18
Morocco,2007-02-01,6,0,0,31,0,37
Morocco,2007-02-01,17,0,0,34,1,52
Morocco,2007-02-01,77,0,3,34,2,116
Morocco,2007-02-01,24,0,0,-2,0,22
Morocco,2007-02-01,-1,0,0,9,0,8
Morocco,2007-02-01,15,0,0,6,0,21
Morocco,2007-02-01,6,0,0,3,0,9
Morocco,2007-02-01,3,0,0,9,0,12
Morocco,2007-02-01,2,0,-2,9,0,9
Morocco,2007-02-01,19,0,0,6,0,25
Morocco,2007-02-01,2,0,0,0,0,2
Morocco,2007-02-01,0,0,0,3,0,3
Morocco,2007-02-01,2,0,0,0,0,2
Morocco,2007-02-01,11,0,0,0,0,11
Nigeria,2007-02-01,0,0,0,-6,0,-6
Nigeria,2007-02-01,7,0,0,9,2,18
Nigeria,2007-02-01,3,0,0,0,0,3
Nigeria,2007-02-01,19,0,0,30,2,51
Nigeria,2007-02-01,38,0,0,6,10,54
Nigeria,2007-02-01,7,0,0,0,0,7
Nigeria,2007-02-01,7,0,0,21,6,34
Nigeria,2007-02-01,4,0,0,6,2,12
Nigeria,2007-02-01,18,0,0,0,0,18
Nigeria,2007-02-01,0,0,0,0,0,0
Nigeria,2007-02-01,-5,0,0,0,0,-5
Nigeria,2007-02-01,-2,0,0,0,0,-2
Nigeria,2007-02-01,13,0,0,-4,0,9
Nigeria,2007-02-01,4,0,0,9,1,14
Nigeria,2007-02-01,0,0,0,-10,0,-10
Nigeria,2007-02-01,5,0,0,12,0,17
Nigeria,2007-02-01,4,0,0,-8,0,-4
Nigeria,2007-02-01,16,0,0,3,8,27
Nigeria,2007-02-01,11,0,0,7,1,19
Nigeria,2007-02-01,9,0,0,3,2,14
Nigeria,2007-02-01,19,0,1,-6,3,17
Nigeria,2007-02-01,4,0,0,0,0,4
Nigeria,2007-02-01,48,0,0,18,8,74
Nigeria,2007-02-01,6,0,0,0,0,6
Nigeria,2007-02-01,9,0,0,0,0,9
Nigeria,2007-02-01,10,0,0,0,2,12
Nigeria,2007-02-01,6,0,0,0,0,6
Nigeria,2007-02-01,11,0,0,9,0,20
Pakistan,2007-02-01,46,0,0,16,6,68
Pakistan,2007-02-01,73,0,0,49,0,122
Pakistan,2007-02-01,16,0,0,39,0,55
Pakistan,2007-02-01,56,0,0,48,3,107
Pakistan,2007-02-01,13,0,1,3,6,23
Pakistan,2007-02-01,-2,0,0,4,11,13
Pakistan,2007-02-01,23,0,0,3,4,30
Pakistan,2007-02-01,36,0,0,3,1,40
Pakistan,2007-02-01,33,4,-9,21,0,49
Pakistan,2007-02-01,22,0,0,3,2,27
Pakistan,2007-02-01,24,0,0,-6,1,19
Pakistan,2007-02-01,52,2,0,6,0,60
Pakistan,2007-02-01,17,0,-2,3,4,22
Pakistan,2007-02-01,47,0,0,12,5,64
Pakistan,2007-02-01,57,0,-2,15,5,75
Pakistan,2007-02-01,24,0,0,18,3,45
Pakistan,2007-02-01,13,0,0,18,19,50
Pakistan,2007-02-01,12,0,-4,3,3,14
Pakistan,2007-02-01,83,0,0,11,9,103
Pakistan,2007-02-01,32,0,0,12,10,54
Pakistan,2007-02-01,4,0,-4,14,3,17
Pakistan,2007-02-01,10,0,-2,10,3,21
Pakistan,2007-02-01,20,0,1,6,1,28
Pakistan,2007-02-01,14,0,0,15,3,32
Pakistan,2007-02-01,-1,0,0,3,3,5
Pakistan,2007-02-01,27,0,0,3,0,30
Pakistan,2007-02-01,63,2,-2,28,8,99
Pakistan,2007-02-01,44,2,2,58,10,116
Sierra Leone,2007-02-01,0,0,0,0,0,0
Sierra Leone,2007-02-01,2,0,0,0,0,2
Sierra Leone,2007-02-01,2,0,0,0,0,2
Sierra Leone,2007-02-01,0,0,0,0,0,0
Sierra Leone,2007-02-01,3,0,0,0,0,3
Sierra Leone,2007-02-01,3,0,0,0,0,3
Sierra Leone,2007-02-01,0,0,0,0,0,0
Sierra Leone,2007-02-01,12,2,0,0,0,14
Sierra Leone,2007-02-01,8,0,0,0,2,10
Sierra Leone,2007-02-01,12,0,0,0,1,13
Sierra Leone,2007-02-01,0,0,0,0,0,0
Sierra Leone,2007-02-01,4,0,0,0,0,4
Sierra Leone,2007-02-01,2,0,0,0,0,2
Sierra Leone,2007-02-01,0,0,0,0,0,0
Sierra Leone,2007-02-01,7,0,0,0,0,7
Sierra Leone,2007-02-01,0,0,0,0,0,0
Sierra Leone,2007-02-01,8,0,0,0,0,8
Sierra Leone,2007-02-01,0,0,0,0,0,0
Sierra Leone,2007-02-01,0,0,0,0,0,0
Sierra Leone,2007-02-01,-2,0,0,0,0,-2
Somalia,2007-02-01,6,0,0,2,0,8
Somalia,2007-02-01,7,0,0,26,1,34
Somalia,2007-02-01,4,0,0,12,0,16
Somalia,2007-02-01,9,0,0,6,0,15
Somalia,2007-02-01,3,0,1,22,0,26
Somalia,2007-02-01,5,0,-1,3,4,11
Somalia,2007-02-01,6,0,0,0,1,7
Somalia,2007-02-01,6,0,0,-14,0,-8
Somalia,2007-02-01,2,0,0,0,0,2
Somalia,2007-02-01,0,0,0,-2,0,-2
Somalia,2007-02-01,0,0,0,0,3,3
Somalia,2007-02-01,8,0,0,0,4,12
Somalia,2007-02-01,72,2,0,23,14,111
Somalia,2007-02-01,20,0,0,3,5,28
Somalia,2007-02-01,19,0,0,6,3,28
Somalia,2007-02-01,15,0,0,0,1,16
Somalia,2007-02-01,4,0,0,0,0,4
Somalia,2007-02-01,0,0,0,6,0,6
Somalia,2007-02-01,3,0,0,0,0,3
Somalia,2007-02-01,2,0,0,6,4,12
Somalia,2007-02-01,13,0,0,0,1,14
Somalia,2007-02-01,0,0,0,0,0,0
Somalia,2007-02-01,0,0,0,0,0,0
Somalia,2007-02-01,3,0,0,3,0,6
Somalia,2007-02-01,12,4,0,6,0,22
Somalia,2007-02-01,-1,0,0,0,0,-1
Somalia,2007-02-01,12,0,0,-2,4,14
Somalia,2007-02-01,6,0,0,0,1,7
Syria,2007-02-01,0,0,0,12,0,12
Syria,2007-02-01,32,0,0,2,0,34
Syria,2007-02-01,30,0,-2,2,6,36
Syria,2007-02-01,10,0,0,15,0,25
Syria,2007-02-01,17,0,-4,6,0,19
Syria,2007-02-01,40,0,0,7,0,47
Syria,2007-02-01,26,2,0,12,0,40
Syria,2007-02-01,9,0,0,18,8,35
Syria,2007-02-01,20,0,0,0,6,26
Syria,2007-02-01,11,0,0,12,1,24
Syria,2007-02-01,3,0,0,26,21,50
Syria,2007-02-01,7,0,0,18,2,27
Syria,2007-02-01,26,0,-2,17,21,62
Syria,2007-02-01,37,0,0,15,0,52
Syria,2007-02-01,37,0,0,44,3,84
Syria,2007-02-01,20,0,0,29,4,53
Syria,2007-02-01,29,0,1,30,0,60
Syria,2007-02-01,8,0,1,0,0,9
Syria,2007-02-01,19,0,0,6,2,27
Syria,2007-02-01,29,0,0,1,0,30
Syria,2007-02-01,9,0,0,2,0,11
Syria,2007-02-01,8,0,0,2,0,10
Syria,2007-02-01,29,0,0,12,0,41
Syria,2007-02-01,11,0,0,7,0,18
Syria,2007-02-01,6,0,0,0,0,6
Syria,2007-02-01,0,0,0,6,6,12
Syria,2007-02-01,8,0,-6,12,1,15
Syria,2007-02-01,22,0,0,12,6,40
Yemen,2007-02-01,24,0,0,0,0,24
Yemen,2007-02-01,1,0,0,3,0,4
Yemen,2007-02-01,0,0,0,0,4,4
Yemen,2007-02-01,1,0,0,0,7,8
Yemen,2007-02-01,35,0,5,-10,3,33
Yemen,2007-02-01,3,0,0,4,0,7
Yemen,2007-02-01,11,0,0,3,0,14
Yemen,2007-02-01,6,0,0,0,0,6
Yemen,2007-02-01,0,0,0,9,0,9
Yemen,2007-02-01,3,0,0,0,0,3
Yemen,2007-02-01,-1,0,0,0,0,-1
Yemen,2007-02-01,24,0,0,0,0,24
Yemen,2007-02-01,43,0,0,0,0,43
Yemen,2007-02-01,23,0,0,0,0,23
Yemen,2007-02-01,0,0,0,0,0,0
Yemen,2007-02-01,3,0,0,0,0,3
Yemen,2007-02-01,0,0,0,0,0,0
Yemen,2007-02-01,0,0,0,0,0,0
Yemen,2007-02-01,35,4,0,0,0,39
Yemen,2007-02-01,27,0,0,0,8,35
Yemen,2007-02-01,24,0,0,3,0,27
Yemen,2007-02-01,0,0,0,-4,0,-4
Yemen,2007-02-01,0,0,0,0,0,0
Yemen,2007-02-01,0,0,0,0,0,0
Yemen,2007-02-01,0,0,0,0,0,0
Yemen,2007-02-01,0,0,0,0,0,0
Yemen,2007-02-01,7,2,0,0,0,9
Yemen,2007-02-01,7,0,0,6,2,15
Afghanistan,2007-03-01,83,0,-4,39,6,124
Afghanistan,2007-03-01,28,0,-4,103,13,140
Afghanistan,2007-03-01,77,0,2,29,33,141
Afghanistan,2007-03-01,43,0,-2,-11,4,34
Afghanistan,2007-03-01,53,0,2,6,3,64
Afghanistan,2007-03-01,181,0,0,37,26,244
Afghanistan,2007-03-01,82,0,0,25,9,116
Afghanistan,2007-03-01,88,0,-4,43,6,133
Afghanistan,2007-03-01,120,0,-2,20,11,149
Afghanistan,2007-03-01,80,0,0,42,5,127
Afghanistan,2007-03-01,32,8,0,5,11,56
Afghanistan,2007-03-01,88,0,1,19,8,116
Afghanistan,2007-03-01,48,0,0,54,3,105
Afghanistan,2007-03-01,64,0,0,27,1,92
Afghanistan,2007-03-01,76,0,1,47,16,140
Afghanistan,2007-03-01,52,0,0,40,8,100
Afghanistan,2007-03-01,104,0,0,31,24,159
Afghanistan,2007-03-01,27,0,0,-10,13,30
Afghanistan,2007-03-01,78,0,-2,-48,10,38
Afghanistan,2007-03-01,169,0,0,9,9,187
Afghanistan,2007-03-01,156,0,0,12,18,186
Afghanistan,2007-03-01,131,0,0,-28,4,107
Afghanistan,2007-03-01,160,0,0,15,13,188
Afghanistan,2007-03-01,114,2,1,33,7,157
Afghanistan,2007-03-01,42,6,0,1,4,53
Afghanistan,2007-03-01,150,0,1,56,24,231
Afghanistan,2007-03-01,145,4,1,67,19,236
Afghanistan,2007-03-01,104,2,0,78,14,198
Afghanistan,2007-03-01,131,0,-4,53,3,183
Afghanistan,2007-03-01,105,0,-2,60,5,168
Afghanistan,2007-03-01,41,0,0,35,0,76
Albania,2007-03-01,5,0,-1,0,0,4
Albania,2007-03-01,5,0,-1,6,0,10
Albania,2007-03-01,14,0,-2,0,4,16
Albania,2007-03-01,48,0,0,20,1,69
Albania,2007-03-01,9,0,-4,35,1,41
Albania,2007-03-01,2,0,-6,15,0,11
Albania,2007-03-01,10,0,0,3,0,13
Albania,2007-03-01,12,0,-2,3,4,17
Albania,2007-03-01,14,0,-2,12,0,24
Albania,2007-03-01,11,0,-3,36,0,44
Albania,2007-03-01,39,0,-3,3,0,39
Albania,2007-03-01,44,0,0,10,2,56
Albania,2007-03-01,2,0,0,0,1,3
Albania,2007-03-01,7,0,0,0,2,9
Albania,2007-03-01,11,0,0,1,2,14
Albania,2007-03-01,8,0,-2,0,0,6
Albania,2007-03-01,21,0,0,0,0,21
Albania,2007-03-01,6,0,0,9,2,17
Albania,2007-03-01,29,0,0,0,1,30
Albania,2007-03-01,18,0,-2,3,0,19
Albania,2007-03-01,13,0,0,0,0,13
Albania,2007-03-01,28,0,0,3,1,32
Albania,2007-03-01,31,0,-4,28,1,56
Albania,2007-03-01,16,0,0,0,0,16
Albania,2007-03-01,44,0,0,6,0,50
Albania,2007-03-01,53,0,-10,7,0,50
Albania,2007-03-01,13,0,0,0,0,13
Albania,2007-03-01,28,0,0,3,3,34
Albania,2007-03-01,17,0,0,0,6,23
Albania,2007-03-01,17,0,-2,12,0,27
Albania,2007-03-01,5,0,-4,-2,2,1
Algeria,2007-03-01,0,0,0,18,0,18
Algeria,2007-03-01,0,0,0,0,0,0
Algeria,2007-03-01,2,0,0,24,0,26
Algeria,2007-03-01,10,0,0,6,3,19
Algeria,2007-03-01,9,0,0,18,0,27
Algeria,2007-03-01,22,0,0,6,0,28
Algeria,2007-03-01,0,0,0,3,0,3
Algeria,2007-03-01,0,0,0,3,0,3
Algeria,2007-03-01,0,0,0,6,0,6
Algeria,2007-03-01,-1,0,0,0,2,1
Algeria,2007-03-01,0,0,0,0,0,0
Algeria,2007-03-01,32,0,0,0,15,47
Algeria,2007-03-01,0,0,-1,0,0,-1
Algeria,2007-03-01,0,0,-4,0,0,-4
Algeria,2007-03-01,5,0,0,6,8,19
Algeria,2007-03-01,-8,0,0,0,0,-8
Algeria,2007-03-01,-4,0,0,0,0,-4
Algeria,2007-03-01,0,0,0,0,0,0
Algeria,2007-03-01,-2,0,0,-2,0,-4
Algeria,2007-03-01,2,0,-2,0,0,0
Algeria,2007-03-01,1,0,0,48,4,53
Algeria,2007-03-01,3,0,0,0,1,4
Algeria,2007-03-01,3,0,0,12,0,15
Algeria,2007-03-01,3,0,0,0,0,3
Algeria,2007-03-01,0,0,0,0,0,0
Algeria,2007-03-01,21,0,0,9,0,30
Algeria,2007-03-01,2,0,0,12,2,16
Algeria,2007-03-01,3,0,0,0,0,3
Algeria,2007-03-01,4,0,0,3,0,7
Algeria,2007-03-01,3,0,0,0,0,3
Algeria,2007-03-01,0,0,0,0,3,3
Bangladesh,2007-03-01,0,0,0,0,0,0
Bangladesh,2007-03-01,0,0,0,6,0,6
Bangladesh,2007-03-01,0,0,1,0,0,1
Bangladesh,2007-03-01,0,0,-4,0,0,-4
Bangladesh,2007-03-01,0,0,2,12,0,14
Bangladesh,2007-03-01,42,0,0,30,0,72
Bangladesh,2007-03-01,9,0,0,4,2,15
Bangladesh,2007-03-01,5,0,4,12,0,21
Bangladesh,2007-03-01,2,0,-5,9,0,6
Bangladesh,2007-03-01,3,0,0,18,0,21
Bangladesh,2007-03-01,0,0,0,4,0,4
Bangladesh,2007-03-01,4,0,0,0,0,4
Bangladesh,2007-03-01,9,0,0,0,1,10
Bangladesh,2007-03-01,1,0,0,6,0,7
Bangladesh,2007-03-01,10,0,0,9,0,19
Bangladesh,2007-03-01,9,0,-10,3,1,3
Bangladesh,2007-03-01,12,0,0,6,0,18
Bangladesh,2007-03-01,1,0,0,12,0,13
Bangladesh,2007-03-01,-1,0,0,0,0,-1
Bangladesh,2007-03-01,-2,0,0,-1,0,-3
Bangladesh,2007-03-01,15,0,0,27,0,42
Bangladesh,2007-03-01,9,0,-4,-2,0,3
Bangladesh,2007-03-01,0,0,0,0,0,0
Bangladesh,2007-03-01,16,0,0,4,0,20
Bangladesh,2007-03-01,6,0,0,0,0,6
Bangladesh,2007-03-01,1,0,-3,-1,5,2
Bangladesh,2007-03-01,2,0,0,3,0,5
Bangladesh,2007-03-01,9,0,0,6,1,16
Bangladesh,2007-03-01,4,0,0,12,3,19
Bangladesh,2007-03-01,20,0,0,21,0,41
Bangladesh,2007-03-01,15,0,0,15,0,30
Cameroon,2007-03-01,6,0,0,0,0,6
Cameroon,2007-03-01,0,0,0,3,0,3
Cameroon,2007-03-01,6,0,0,0,0,6
Cameroon,2007-03-01,0,0,0,9,0,9
Cameroon,2007-03-01,0,0,0,0,0,0
Cameroon,2007-03-01,0,0,0,0,0,0
Cameroon,2007-03-01,0,0,0,0,0,0
Cameroon,2007-03-01,2,0,0,3,0,5
Cameroon,2007-03-01,4,0,0,15,0,19
Cameroon,2007-03-01,0,0,0,0,0,0
Cameroon,2007-03-01,0,0,0,0,0,0
Cameroon,2007-03-01,0,0,0,0,0,0
Cameroon,2007-03-01,0,0,0,0,0,0
Cameroon,2007-03-01,0,0,0,0,0,0
Cameroon,2007-03-01,0,0,0,0,0,0
China,2007-03-01,38,0,-6,24,4,60
China,2007-03-01,17,2,0,2,5,26
China,2007-03-01,17,4,0,11,1,33
China,2007-03-01,5,0,0,-6,2,1
China,2007-03-01,84,0,0,5,2,91
China,2007-03-01,74,0,-1,33,5,111
China,2007-03-01,55,0,-10,30,3,78
China,2007-03-01,89,2,-4,31,24,142
China,2007-03-01,56,2,0,18,6,82
China,2007-03-01,94,0,-7,40,7,134
China,2007-03-01,9,0,0,18,0,27
China,2007-03-01,48,0,2,27,11,88
China,2007-03-01,29,0,3,29,6,67
China,2007-03-01,64,0,0,10,8,82
China,2007-03-01,11,0,-3,7,3,18
China,2007-03-01,-24,0,0,10,5,-9
China,2007-03-01,-24,0,0,21,1,-2
China,2007-03-01,6,0,-1,11,3,19
China,2007-03-01,53,0,0,13,3,69
China,2007-03-01,21,0,-4,55,5,77
China,2007-03-01,32,0,1,16,12,61
China,2007-03-01,-2,2,-2,7,6,11
China,2007-03-01,42,2,-5,42,5,86
China,2007-03-01,44,0,0,24,6,74
China,2007-03-01,3,0,0,4,0,7
China,2007-03-01,69,0,-1,26,6,100
China,2007-03-01,61,0,-1,3,6,69
China,2007-03-01,31,6,0,39,9,85
China,2007-03-01,57,4,3,43,8,115
China,2007-03-01,70,0,-8,25,4,91
China,2007-03-01,16,0,0,34,0,50
Egypt,2007-03-01,2,0,0,30,3,35
Egypt,2007-03-01,5,0,0,30,1,36
Egypt,2007-03-01,23,0,0,3,2,28
Egypt,2007-03-01,18,0,0,6,0,24
Egypt,2007-03-01,29,0,0,7,3,39
Egypt,2007-03-01,51,0,1,12,4,68
Egypt,2007-03-01,11,0,0,14,0,25
Egypt,2007-03-01,18,0,-2,6,2,24
Egypt,2007-03-01,5,0,0,24,0,29
Egypt,2007-03-01,26,0,0,-1,0,25
Egypt,2007-03-01,4,0,2,5,8,19
Egypt,2007-03-01,9,0,0,1,0,10
Egypt,2007-03-01,13,0,1,-2,1,13
Egypt,2007-03-01,-8,0,0,28,2,22
Egypt,2007-03-01,8,0,0,15,0,23
Egypt,2007-03-01,19,0,2,16,3,40
Egypt,2007-03-01,12,0,0,6,6,24
Egypt,2007-03-01,22,0,-2,0,4,24
Egypt,2007-03-01,19,0,-4,6,6,27
Egypt,2007-03-01,21,0,0,7,0,28
Egypt,2007-03-01,22,0,1,10,5,38
Egypt,2007-03-01,12,0,0,16,4,32
Egypt,2007-03-01,14,0,0,2,2,18
Egypt,2007-03-01,18,0,-2,20,1,37
Egypt,2007-03-01,35,4,0,-10,5,34
Egypt,2007-03-01,28,0,0,30,4,62
Egypt,2007-03-01,30,0,-4,-6,7,27
Egypt,2007-03-01,10,0,0,0,2,12
Egypt,2007-03-01,5,0,0,0,0,5
Egypt,2007-03-01,1,0,0,-5,0,-4
Egypt,2007-03-01,12,0,0,3,0,15
Eritrea,2007-03-01,0,0,0,9,0,9
Eritrea,2007-03-01,6,0,0,0,0,6
Eritrea,2007-03-01,16,0,0,13,0,29
Eritrea,2007-03-01,9,0,0,11,3,23
Eritrea,2007-03-01,47,0,0,5,10,62
Eritrea,2007-03-01,0,0,0,-2,2,0
Eritrea,2007-03-01,11,0,0,6,0,17
Eritrea,2007-03-01,6,0,-1,6,0,11
Eritrea,2007-03-01,14,0,0,4,0,18
Eritrea,2007-03-01,6,0,0,6,0,12
Eritrea,2007-03-01,4,0,0,0,0,4
Eritrea,2007-03-01,2,0,0,-2,0,0
Eritrea,2007-03-01,0,0,0,0,0,0
Eritrea,2007-03-01,4,0,0,-10,0,-6
Eritrea,2007-03-01,7,0,0,-9,0,-2
Eritrea,2007-03-01,0,0,0,-2,0,-2
Eritrea,2007-03-01,0,0,0,0,0,0
Eritrea,2007-03-01,4,0,0,9,0,13
Eritrea,2007-03-01,10,0,0,-8,0,2
Eritrea,2007-03-01,4,0,0,-4,0,0
Eritrea,2007-03-01,3,0,0,7,2,12
Eritrea,2007-03-01,3,0,0,9,0,12
Eritrea,2007-03-01,0,0,0,-8,0,-8
Eritrea,2007-03-01,9,0,0,0,0,9
Eritrea,2007-03-01,0,0,0,-2,0,-2
Eritrea,2007-03-01,0,0,0,-4,0,-4
Eritrea,2007-03-01,6,0,0,0,0,6
Eritrea,2007-03-01,-3,0,0,0,0,-3
Eritrea,2007-03-01,7,0,0,9,0,16
Eritrea,2007-03-01,0,0,0,-1,0,-1
Eritrea,2007-03-01,4,0,0,-5,0,-1
Georgia,2007-03-01,-3,0,0,0,0,-3
Georgia,2007-03-01,-1,0,0,0,0,-1
Georgia,2007-03-01,4,0,0,0,0,4
Georgia,2007-03-01,12,0,0,0,0,12
Georgia,2007-03-01,3,0,0,6,0,9
Georgia,2007-03-01,0,0,0,3,0,3
Georgia,2007-03-01,5,0,0,6,0,11
Georgia,2007-03-01,0,0,0,0,2,2
Georgia,2007-03-01,10,0,0,-2,0,8
Georgia,2007-03-01,0,0,0,0,0,0
Georgia,2007-03-01,-1,0,0,0,0,-1
Georgia,2007-03-01,10,0,0,3,0,13
Georgia,2007-03-01,-2,0,0,17,0,15
Georgia,2007-03-01,6,0,0,6,0,12
Georgia,2007-03-01,9,0,0,3,0,12
Georgia,2007-03-01,0,0,0,0,0,0
Georgia,2007-03-01,0,0,1,0,0,1
Georgia,2007-03-01,3,0,0,0,0,3
Georgia,2007-03-01,3,0,0,4,1,8
Georgia,2007-03-01,1,0,0,1,0,2
Georgia,2007-03-01,4,0,0,9,1,14
Georgia,2007-03-01,7,0,0,3,0,10
Georgia,2007-03-01,18,0,0,0,0,18
Georgia,2007-03-01,6,0,0,0,1,7
Georgia,2007-03-01,3,0,0,0,1,4
Georgia,2007-03-01,5,0,0,12,0,17
Georgia,2007-03-01,-1,0,0,3,1,3
Georgia,2007-03-01,5,0,0,12,2,19
Georgia,2007-03-01,3,0,0,9,0,12
Georgia,2007-03-01,0,0,0,0,1,1
India,2007-03-01,36,2,0,10,3,51
India,2007-03-01,3,0,0,6,3,12
India,2007-03-01,14,0,0,0,2,16
India,2007-03-01,2,0,0,3,0,5
India,2007-03-01,8,0,0,-4,3,7
India,2007-03-01,16,0,0,-1,2,17
India,2007-03-01,10,0,0,20,0,30
India,2007-03-01,9,0,-1,3,5,16
India,2007-03-01,26,0,0,27,2,55
India,2007-03-01,36,0,0,-2,4,38
India,2007-03-01,2,0,0,-2,1,1
India,2007-03-01,3,0,0,-5,0,-2
India,2007-03-01,11,0,0,3,2,16
India,2007-03-01,15,0,-1,12,4,30
India,2007-03-01,9,0,-1,3,0,11
India,2007-03-01,4,0,0,0,1,5
India,2007-03-01,6,2,0,6,0,14
India,2007-03-01,5,8,0,6,2,21
India,2007-03-01,13,0,0,-7,6,12
India,2007-03-01,6,0,0,1,0,7
India,2007-03-01,33,0,0,12,2,47
India,2007-03-01,24,4,0,20,3,51
India,2007-03-01,35,0,-8,6,4,37
India,2007-03-01,30,4,0,16,8,58
India,2007-03-01,6,0,-2,7,1,12
India,2007-03-01,17,4,-2,14,9,42
India,2007-03-01,17,2,-3,-6,7,17
India,2007-03-01,21,0,0,3,13,37
India,2007-03-01,20,0,0,4,4,28
India,2007-03-01,17,0,1,8,0,26
India,2007-03-01,3,0,0,0,0,3
Iran,2007-03-01,98,0,-1,30,12,139
Iran,2007-03-01,38,0,1,6,3,48
Iran,2007-03-01,23,0,0,3,1,27
Iran,2007-03-01,46,0,0,35,8,89
Iran,2007-03-01,53,0,0,-2,3,54
Iran,2007-03-01,51,0,0,34,9,94
Iran,2007-03-01,24,0,0,66,24,114
Iran,2007-03-01,26,0,-2,46,9,79
Iran,2007-03-01,109,4,0,21,7,141
Iran,2007-03-01,41,0,0,14,2,57
Iran,2007-03-01,40,0,0,23,8,71
Iran,2007-03-01,39,0,-4,37,2,74
Iran,2007-03-01,32,0,4,15,5,56
Iran,2007-03-01,79,0,-2,-3,14,88
Iran,2007-03-01,94,0,-2,10,13,115
Iran,2007-03-01,42,6,0,18,4,70
Iran,2007-03-01,18,4,0,-2,6,26
Iran,2007-03-01,33,0,1,6,2,42
Iran,2007-03-01,37,0,0,36,4,77
Iran,2007-03-01,34,0,4,27,2,67
Iran,2007-03-01,68,0,0,54,8,130
Iran,2007-03-01,36,0,-2,12,14,60
Iran,2007-03-01,57,0,-4,20,4,77
Iran,2007-03-01,49,0,4,35,7,95
Iran,2007-03-01,115,0,0,46,5,166
Iran,2007-03-01,137,0,2,32,6,177
Iran,2007-03-01,84,2,3,40,3,132
Iran,2007-03-01,197,0,2,63,11,273
Iran,2007-03-01,124,12,-5,63,19,213
Iran,2007-03-01,137,0,3,21,6,167
Iran,2007-03-01,28,0,-1,18,0,45
Iraq,2007-03-01,87,2,2,10,10,111
Iraq,2007-03-01,73,0,-2,18,2,91
Iraq,2007-03-01,60,0,-8,38,15,105
Iraq,2007-03-01,49,8,0,21,12,90
Iraq,2007-03-01,44,0,2,29,2,77
Iraq,2007-03-01,132,0,1,98,24,255
Iraq,2007-03-01,126,0,-10,90,15,221
Iraq,2007-03-01,59,0,0,42,12,113
Iraq,2007-03-01,53,4,-4,10,11,74
Iraq,2007-03-01,104,4,-4,9,10,123
Iraq,2007-03-01,88,0,-4,4,9,97
Iraq,2007-03-01,65,2,-2,30,10,105
Iraq,2007-03-01,110,4,-2,60,15,187
Iraq,2007-03-01,14,0,-2,55,10,77
Iraq,2007-03-01,104,0,-5,33,9,141
Iraq,2007-03-01,89,12,0,29,29,159
Iraq,2007-03-01,90,4,-2,82,31,205
Iraq,2007-03-01,94,2,1,47,46,190
Iraq,2007-03-01,118,2,1,66,60,247
Iraq,2007-03-01,200,2,-3,88,17,304
Iraq,2007-03-01,142,2,-7,29,4,170
Iraq,2007-03-01,167,0,-2,16,14,195
Iraq,2007-03-01,162,2,-1,93,20,276
Iraq,2007-03-01,109,2,2,66,15,194
Iraq,2007-03-01,82,2,2,97,13,196
Iraq,2007-03-01,116,0,-4,93,13,218
Iraq,2007-03-01,106,6,2,89,3,206
Iraq,2007-03-01,153,2,4,59,17,235
Iraq,2007-03-01,192,0,2,107,23,324
Iraq,2007-03-01,100,0,-8,27,3,122
Iraq,2007-03-01,64,0,-11,9,2,64
Morocco,2007-03-01,3,0,0,13,0,16
Morocco,2007-03-01,21,0,0,27,0,48
Morocco,2007-03-01,6,0,0,6,3,15
Morocco,2007-03-01,2,0,0,0,0,2
Morocco,2007-03-01,3,0,0,6,0,9
Morocco,2007-03-01,0,0,0,3,0,3
Morocco,2007-03-01,4,0,0,0,0,4
Morocco,2007-03-01,0,0,0,0,1,1
Morocco,2007-03-01,0,0,0,-2,0,-2
Morocco,2007-03-01,-2,0,0,0,0,-2
Morocco,2007-03-01,0,0,0,0,12,12
Morocco,2007-03-01,10,0,0,6,6,22
Morocco,2007-03-01,3,0,0,0,0,3
Morocco,2007-03-01,3,0,0,6,0,9
Morocco,2007-03-01,2,0,0,0,0,2
Morocco,2007-03-01,3,0,0,0,0,3
Morocco,2007-03-01,0,0,0,0,0,0
Morocco,2007-03-01,0,0,0,0,0,0
Morocco,2007-03-01,-2,0,0,6,0,4
Morocco,2007-03-01,3,0,0,0,6,9
Morocco,2007-03-01,-10,0,0,18,12,20
Morocco,2007-03-01,2,0,0,0,0,2
Morocco,2007-03-01,0,0,0,0,0,0
Morocco,2007-03-01,0,0,0,0,1,1
Morocco,2007-03-01,0,0,0,0,2,2
Morocco,2007-03-01,3,0,0,3,0,6
Morocco,2007-03-01,0,0,0,0,0,0
Morocco,2007-03-01,8,0,0,6,0,14
Morocco,2007-03-01,18,0,0,-4,2,16
Morocco,2007-03-01,0,0,0,0,0,0
Nigeria,2007-03-01,9,2,0,16,0,27
Nigeria,2007-03-01,16,0,0,4,2,22
Nigeria,2007-03-01,3,0,0,3,0,6
Nigeria,2007-03-01,0,0,0,6,0,6
Nigeria,2007-03-01,4,0,0,0,0,4
Nigeria,2007-03-01,39,0,0,10,10,59
Nigeria,2007-03-01,9,0,0,10,3,22
Nigeria,2007-03-01,15,0,-1,0,0,14
Nigeria,2007-03-01,0,0,0,6,1,7
Nigeria,2007-03-01,16,0,0,36,0,52
Nigeria,2007-03-01,5,0,0,0,0,5
Nigeria,2007-03-01,0,0,0,-4,0,-4
Nigeria,2007-03-01,-1,0,0,0,0,-1
Nigeria,2007-03-01,5,0,0,19,0,24
Nigeria,2007-03-01,17,0,0,9,0,26
Nigeria,2007-03-01,3,0,0,-4,2,1
Nigeria,2007-03-01,0,0,0,3,0,3
Nigeria,2007-03-01,1,0,0,0,0,1
Nigeria,2007-03-01,-2,0,0,-2,0,-4
Nigeria,2007-03-01,9,0,0,24,0,33
Nigeria,2007-03-01,8,0,0,-2,0,6
Nigeria,2007-03-01,11,0,-6,20,1,26
Nigeria,2007-03-01,3,0,0,3,0,6
Nigeria,2007-03-01,-3,0,0,-4,0,-7
Nigeria,2007-03-01,-2,0,0,0,4,2
Nigeria,2007-03-01,-1,0,0,24,2,25
Nigeria,2007-03-01,17,0,0,9,0,26
Nigeria,2007-03-01,18,0,-6,10,0,22
Nigeria,2007-03-01,1,0,0,0,0,1
Nigeria,2007-03-01,3,0,-1,1,0,3
Nigeria,2007-03-01,0,0,0,0,0,0
Pakistan,2007-03-01,26,0,0,16,1,43
Pakistan,2007-03-01,55,0,0,4,6,65
Pakistan,2007-03-01,34,0,1,11,5,51
Pakistan,2007-03-01,7,0,0,3,4,14
Pakistan,2007-03-01,4,0,0,19,7,30
Pakistan,2007-03-01,59,0,0,21,0,80
Pakistan,2007-03-01,9,0,0,51,3,63
Pakistan,2007-03-01,54,0,0,69,1,124
Pakistan,2007-03-01,34,0,-4,31,1,62
Pakistan,2007-03-01,48,0,-2,51,4,101
Pakistan,2007-03-01,34,0,0,12,0,46
Pakistan,2007-03-01,35,0,0,4,3,42
Pakistan,2007-03-01,54,0,1,13,16,84
Pakistan,2007-03-01,56,0,0,18,8,82
Pakistan,2007-03-01,36,0,1,35,18,90
Pakistan,2007-03-01,41,0,0,44,7,92
Pakistan,2007-03-01,30,0,0,16,3,49
Pakistan,2007-03-01,15,0,0,3,0,18
Pakistan,2007-03-01,18,0,0,21,4,43
Pakistan,2007-03-01,54,0,3,11,5,73
Pakistan,2007-03-01,19,0,0,2,8,29
Pakistan,2007-03-01,58,0,-2,36,10,102
Pakistan,2007-03-01,40,0,0,13,7,60
Pakistan,2007-03-01,51,0,0,54,1,106
Pakistan,2007-03-01,56,0,0,9,7,72
Pakistan,2007-03-01,35,0,-1,62,9,105
Pakistan,2007-03-01,133,0,-2,36,16,183
Pakistan,2007-03-01,56,0,-2,30,55,139
Pakistan,2007-03-01,63,0,1,45,14,123
Pakistan,2007-03-01,55,0,-1,21,3,78
Pakistan,2007-03-01,24,0,0,2,1,27
Sierra Leone,2007-03-01,0,0,0,0,0,0
Sierra Leone,2007-03-01,3,0,0,0,0,3
Sierra Leone,2007-03-01,0,0,0,0,0,0
Sierra Leone,2007-03-01,0,0,0,0,0,0
Sierra Leone,2007-03-01,0,0,0,0,0,0
Sierra Leone,2007-03-01,0,0,0,0,0,0
Sierra Leone,2007-03-01,9,0,0,3,1,13
Sierra Leone,2007-03-01,0,0,0,0,0,0
Sierra Leone,2007-03-01,0,0,0,0,0,0
Sierra Leone,2007-03-01,0,0,0,0,0,0
Sierra Leone,2007-03-01,0,0,0,3,4,7
Sierra Leone,2007-03-01,0,0,0,0,0,0
Sierra Leone,2007-03-01,0,0,0,0,0,0
Sierra Leone,2007-03-01,0,0,0,11,4,15
Sierra Leone,2007-03-01,0,0,0,0,0,0
Sierra Leone,2007-03-01,1,0,0,0,0,1
Somalia,2007-03-01,0,0,0,0,1,1
Somalia,2007-03-01,11,0,0,0,0,11
Somalia,2007-03-01,-1,0,0,0,0,-1
Somalia,2007-03-01,2,0,0,3,0,5
Somalia,2007-03-01,0,0,0,0,0,0
Somalia,2007-03-01,13,0,0,0,2,15
Somalia,2007-03-01,1,0,0,0,0,1
Somalia,2007-03-01,1,0,0,0,0,1
Somalia,2007-03-01,0,0,0,0,0,0
Somalia,2007-03-01,10,0,0,3,0,13
Somalia,2007-03-01,4,0,0,0,0,4
Somalia,2007-03-01,3,4,0,0,0,7
Somalia,2007-03-01,0,0,0,6,0,6
Somalia,2007-03-01,8,0,0,0,0,8
Somalia,2007-03-01,3,0,0,0,0,3
Somalia,2007-03-01,14,0,0,6,0,20
Somalia,2007-03-01,1,0,0,0,0,1
Somalia,2007-03-01,3,0,0,0,0,3
Somalia,2007-03-01,9,0,0,1,1,11
Somalia,2007-03-01,8,0,0,10,1,19
Somalia,2007-03-01,1,0,0,4,1,6
Somalia,2007-03-01,23,0,0,0,6,29
Somalia,2007-03-01,17,0,0,6,0,23
Somalia,2007-03-01,3,0,0,15,1,19
Somalia,2007-03-01,2,0,0,0,6,8
Somalia,2007-03-01,21,0,0,15,0,36
Somalia,2007-03-01,14,0,0,3,6,23
Somalia,2007-03-01,0,0,0,6,0,6
Somalia,2007-03-01,0,0,0,0,0,0
Somalia,2007-03-01,8,0,0,0,0,8
Somalia,2007-03-01,0,0,0,3,0,3
Syria,2007-03-01,9,0,0,-1,8,16
Syria,2007-03-01,11,0,0,3,0,14
Syria,2007-03-01,15,0,0,0,1,16
Syria,2007-03-01,6,0,0,0,0,6
Syria,2007-03-01,15,0,0,9,0,24
Syria,2007-03-01,22,0,-4,19,6,43
Syria,2007-03-01,32,0,1,21,4,58
Syria,2007-03-01,22,0,0,27,0,49
Syria,2007-03-01,16,0,0,33,8,57
Syria,2007-03-01,36,0,0,15,12,63
Syria,2007-03-01,2,0,0,0,0,2
Syria,2007-03-01,18,0,2,2,4,26
Syria,2007-03-01,10,0,0,9,0,19
Syria,2007-03-01,8,0,0,15,0,23
Syria,2007-03-01,4,0,0,6,10,20
Syria,2007-03-01,17,0,0,18,6,41
Syria,2007-03-01,17,0,0,3,2,22
Syria,2007-03-01,7,0,0,6,0,13
Syria,2007-03-01,4,0,0,12,3,19
Syria,2007-03-01,11,0,-2,6,4,19
Syria,2007-03-01,9,2,0,11,3,25
Syria,2007-03-01,28,0,0,30,9,67
Syria,2007-03-01,23,0,0,12,0,35
Syria,2007-03-01,40,0,0,-2,6,44
Syria,2007-03-01,36,0,0,3,3,42
Syria,2007-03-01,27,0,0,30,1,58
Syria,2007-03-01,34,0,-4,9,11,50
Syria,2007-03-01,22,0,0,9,-6,25
Syria,2007-03-01,31,0,0,30,6,67
Syria,2007-03-01,28,0,0,28,0,56
Syria,2007-03-01,-1,0,0,0,0,-1
Yemen,2007-03-01,11,0,0,0,0,11
Yemen,2007-03-01,1,0,0,0,0,1
Yemen,2007-03-01,0,0,0,0,0,0
Yemen,2007-03-01,24,0,0,0,1,25
Yemen,2007-03-01,0,0,0,0,0,0
Yemen,2007-03-01,4,0,1,6,0,11
Yemen,2007-03-01,0,0,0,0,0,0
Yemen,2007-03-01,2,0,1,0,3,6
Yemen,2007-03-01,1,0,0,-2,0,-1
Yemen,2007-03-01,0,0,0,0,0,0
Yemen,2007-03-01,0,0,0,0,0,0
Yemen,2007-03-01,12,0,0,0,0,12
Yemen,2007-03-01,0,0,0,0,0,0
Yemen,2007-03-01,-5,0,0,0,8,3
Yemen,2007-03-01,0,0,0,9,1,10
Yemen,2007-03-01,0,0,0,0,0,0
Yemen,2007-03-01,12,0,0,0,0,12
Yemen,2007-03-01,34,0,0,0,6,40
Yemen,2007-03-01,21,0,0,0,0,21
Yemen,2007-03-01,0,0,0,0,6,6
Yemen,2007-03-01,-6,0,0,0,2,-4
Yemen,2007-03-01,-1,0,0,3,0,2
Yemen,2007-03-01,4,0,0,3,0,7
Yemen,2007-03-01,5,0,0,0,3,8
Yemen,2007-03-01,8,0,0,5,1,14
Yemen,2007-03-01,7,0,0,6,0,13
Yemen,2007-03-01,23,0,0,3,2,28
Yemen,2007-03-01,9,0,0,3,6,18
Yemen,2007-03-01,2,0,0,32,6,40
Yemen,2007-03-01,2,0,0,12,0,14
Afghanistan,2007-01-01,32,0,0,6,4,42
Afghanistan,2007-01-01,21,0,-1,12,2,34
Afghanistan,2007-01-01,53,2,0,12,2,69
Afghanistan,2007-01-01,28,0,0,4,2,34
Afghanistan,2007-01-01,48,0,0,24,0,72
Afghanistan,2007-01-01,39,0,0,9,4,52
Afghanistan,2007-01-01,44,0,0,10,0,54
Afghanistan,2007-01-01,29,4,0,9,2,44
Afghanistan,2007-01-01,53,2,0,21,7,83
Afghanistan,2007-01-01,80,0,0,12,3,95
Afghanistan,2007-01-01,101,0,0,33,24,158
Afghanistan,2007-01-01,144,0,0,40,7,191
Afghanistan,2007-01-01,68,0,0,0,6,74
Afghanistan,2007-01-01,42,0,0,0,7,49
Afghanistan,2007-01-01,51,0,-1,-1,22,71
Afghanistan,2007-01-01,85,0,0,15,6,106
Afghanistan,2007-01-01,53,0,-4,21,45,115
Afghanistan,2007-01-01,64,0,0,14,3,81
Afghanistan,2007-01-01,95,0,0,8,3,106
Afghanistan,2007-01-01,32,0,0,25,13,70
Afghanistan,2007-01-01,26,0,0,24,11,61
Afghanistan,2007-01-01,27,4,4,24,12,71
Afghanistan,2007-01-01,29,0,0,6,8,43
Afghanistan,2007-01-01,76,0,-2,8,4,86
Afghanistan,2007-01-01,95,0,0,36,5,136
Afghanistan,2007-01-01,144,6,-6,36,12,192
Afghanistan,2007-01-01,55,0,-2,9,0,62
Afghanistan,2007-01-01,71,0,1,11,2,85
Afghanistan,2007-01-01,75,0,0,11,5,91
Afghanistan,2007-01-01,112,0,-1,12,4,127
Afghanistan,2007-01-01,130,0,0,43,12,185
Albania,2007-01-01,-3,0,0,0,0,-3
Albania,2007-01-01,8,0,0,0,0,8
Albania,2007-01-01,2,0,0,0,1,3
Albania,2007-01-01,2,0,-2,0,0,0
Albania,2007-01-01,6,0,1,3,0,10
Albania,2007-01-01,3,0,0,0,1,4
Albania,2007-01-01,-4,2,-2,0,0,-4
Albania,2007-01-01,17,0,0,0,0,17
Albania,2007-01-01,28,0,1,7,0,36
Albania,2007-01-01,21,0,0,3,-2,22
Albania,2007-01-01,4,0,0,0,2,6
Albania,2007-01-01,9,0,-1,-4,3,7
Albania,2007-01-01,-1,0,0,0,0,-1
Albania,2007-01-01,-3,0,0,0,2,-1
Albania,2007-01-01,6,0,-1,0,0,5
Albania,2007-01-01,2,0,0,0,0,2
Albania,2007-01-01,0,0,-4,0,0,-4
Albania,2007-01-01,20,0,-2,3,0,21
Albania,2007-01-01,21,0,-2,15,0,34
Albania,2007-01-01,0,0,0,0,0,0
Albania,2007-01-01,15,0,0,0,11,26
Albania,2007-01-01,35,0,-10,13,4,42
Albania,2007-01-01,4,0,-3,0,0,1
Albania,2007-01-01,3,0,-1,18,0,20
Albania,2007-01-01,16,0,-2,4,1,19
Albania,2007-01-01,19,0,0,7,10,36
Albania,2007-01-01,0,0,0,6,0,6
Albania,2007-01-01,0,0,0,0,0,0
Albania,2007-01-01,11,0,0,-3,5,13
Albania,2007-01-01,12,0,-1,3,1,15
Albania,2007-01-01,2,0,-2,3,2,5
Algeria,2007-01-01,0,0,0,0,0,0
Algeria,2007-01-01,23,0,0,0,0,23
Algeria,2007-01-01,0,0,0,0,0,0
Algeria,2007-01-01,0,0,0,0,0,0
Algeria,2007-01-01,0,0,0,0,0,0
Algeria,2007-01-01,0,0,0,0,0,0
Algeria,2007-01-01,6,0,0,3,0,9
Algeria,2007-01-01,0,0,0,3,2,5
Algeria,2007-01-01,11,0,0,7,0,18
Algeria,2007-01-01,33,0,0,3,0,36
Algeria,2007-01-01,0,0,0,3,0,3
Algeria,2007-01-01,-3,0,0,6,0,3
Algeria,2007-01-01,-2,0,0,0,0,-2
Algeria,2007-01-01,-2,0,0,12,1,11
Algeria,2007-01-01,6,0,0,-6,0,0
Algeria,2007-01-01,0,0,0,7,4,11
Algeria,2007-01-01,4,0,0,30,0,34
Algeria,2007-01-01,6,0,0,9,0,15
Algeria,2007-01-01,6,0,0,1,2,9
Algeria,2007-01-01,5,0,0,0,0,5
Algeria,2007-01-01,5,0,0,0,0,5
Algeria,2007-01-01,4,0,0,6,0,10
Algeria,2007-01-01,0,0,0,0,0,0
Algeria,2007-01-01,15,0,0,-2,0,13
Algeria,2007-01-01,0,0,0,3,0,3
Algeria,2007-01-01,4,0,0,0,0,4
Algeria,2007-01-01,5,0,0,3,0,8
Algeria,2007-01-01,7,0,0,6,0,13
Algeria,2007-01-01,9,0,0,4,0,13
Bangladesh,2007-01-01,0,0,0,0,0,0
Bangladesh,2007-01-01,1,0,0,0,0,1
Bangladesh,2007-01-01,7,0,-4,0,3,6
Bangladesh,2007-01-01,0,0,0,3,2,5
Bangladesh,2007-01-01,1,0,0,9,1,11
Bangladesh,2007-01-01,10,0,0,0,0,10
Bangladesh,2007-01-01,0,0,0,0,1,1
Bangladesh,2007-01-01,4,0,0,-12,0,-8
Bangladesh,2007-01-01,10,0,0,6,3,19
Bangladesh,2007-01-01,6,0,0,6,1,13
Bangladesh,2007-01-01,24,0,-6,15,2,35
Bangladesh,2007-01-01,31,0,-8,10,12,45
Bangladesh,2007-01-01,13,0,1,-1,8,21
Bangladesh,2007-01-01,13,0,0,2,2,17
Bangladesh,2007-01-01,15,0,-2,0,0,13
Bangladesh,2007-01-01,4,0,0,0,0,4
Bangladesh,2007-01-01,15,0,-2,0,0,13
Bangladesh,2007-01-01,3,0,-2,4,0,5
Bangladesh,2007-01-01,10,0,0,0,0,10
Bangladesh,2007-01-01,9,0,-2,1,0,8
Bangladesh,2007-01-01,4,0,-2,-1,0,1
Bangladesh,2007-01-01,2,0,-2,0,1,1
Bangladesh,2007-01-01,20,0,1,10,2,33
Bangladesh,2007-01-01,8,0,2,0,0,10
Bangladesh,2007-01-01,5,0,0,-2,0,3
Bangladesh,2007-01-01,35,0,0,4,0,39
Bangladesh,2007-01-01,20,0,0,3,2,25
Bangladesh,2007-01-01,17,0,0,1,0,18
Bangladesh,2007-01-01,3,0,-4,7,1,7
Bangladesh,2007-01-01,11,0,-2,3,0,12
Bangladesh,2007-01-01,1,0,-4,0,0,-3
Cameroon,2007-01-01,0,0,0,0,4,4
Cameroon,2007-01-01,0,0,0,0,0,0
Cameroon,2007-01-01,3,0,0,15,0,18
Cameroon,2007-01-01,0,0,0,-2,0,-2
Cameroon,2007-01-01,9,0,0,0,0,9
Cameroon,2007-01-01,9,0,0,0,0,9
Cameroon,2007-01-01,1,0,0,0,0,1
Cameroon,2007-01-01,-6,0,0,0,0,-6
Cameroon,2007-01-01,0,0,0,0,0,0
Cameroon,2007-01-01,0,0,0,0,0,0
Cameroon,2007-01-01,0,0,0,0,0,0
Cameroon,2007-01-01,0,0,0,0,0,0
Cameroon,2007-01-01,0,0,0,0,0,0
Cameroon,2007-01-01,0,0,0,0,0,0
China,2007-01-01,11,0,1,21,0,33
China,2007-01-01,31,2,-2,7,1,39
China,2007-01-01,34,0,0,5,4,43
China,2007-01-01,31,0,-1,5,0,35
China,2007-01-01,46,0,-7,51,16,106
China,2007-01-01,10,0,1,12,3,26
China,2007-01-01,17,0,0,-8,8,17
China,2007-01-01,8,6,0,-9,0,5
China,2007-01-01,34,6,-2,39,1,78
China,2007-01-01,57,0,0,40,12,109
China,2007-01-01,84,4,-1,4,1,92
China,2007-01-01,5,0,1,11,14,31
China,2007-01-01,71,0,0,4,1,76
China,2007-01-01,41,0,0,4,13,58
China,2007-01-01,22,0,0,12,2,36
China,2007-01-01,23,0,0,28,5,56
China,2007-01-01,18,0,0,21,5,44
China,2007-01-01,56,0,0,-12,4,48
China,2007-01-01,115,2,-1,30,9,155
China,2007-01-01,46,0,0,11,0,57
China,2007-01-01,41,0,-5,31,0,67
China,2007-01-01,61,0,-2,21,7,87
China,2007-01-01,79,2,-2,36,8,123
China,2007-01-01,81,0,-2,39,2,120
China,2007-01-01,52,0,2,100,9,163
China,2007-01-01,52,0,0,45,3,100
China,2007-01-01,54,0,-4,36,0,86
China,2007-01-01,4,4,0,-5,5,8
China,2007-01-01,36,0,0,8,11,55
China,2007-01-01,24,0,-2,8,10,40
China,2007-01-01,111,0,-8,38,4,145
Egypt,2007-01-01,26,0,0,-2,1,25
Egypt,2007-01-01,18,0,0,-12,0,6
Egypt,2007-01-01,22,0,0,0,4,26
Egypt,2007-01-01,63,0,0,-9,3,57
Egypt,2007-01-01,35,0,1,-13,1,24
Egypt,2007-01-01,15,0,0,0,0,15
Egypt,2007-01-01,24,0,1,0,0,25
Egypt,2007-01-01,28,0,0,9,4,41
Egypt,2007-01-01,5,0,0,6,1,12
Egypt,2007-01-01,11,0,2,24,0,37
Egypt,2007-01-01,-4,0,1,15,4,16
Egypt,2007-01-01,23,0,0,3,0,26
Egypt,2007-01-01,5,0,0,6,4,15
Egypt,2007-01-01,44,0,0,5,0,49
Egypt,2007-01-01,29,0,0,18,4,51
Egypt,2007-01-01,23,0,0,2,4,29
Egypt,2007-01-01,35,0,-8,3,1,31
Egypt,2007-01-01,26,0,-4,36,0,58
Egypt,2007-01-01,20,0,0,6,0,26
Egypt,2007-01-01,23,0,0,0,0,23
Egypt,2007-01-01,8,0,0,13,3,24
Egypt,2007-01-01,0,0,0,-1,0,-1
Egypt,2007-01-01,10,0,0,25,16,51
Egypt,2007-01-01,1,0,0,-4,0,-3
Egypt,2007-01-01,3,0,0,3,1,7
Egypt,2007-01-01,10,0,0,0,0,10
Egypt,2007-01-01,14,0,0,12,0,26
Egypt,2007-01-01,18,0,0,9,0,27
Egypt,2007-01-01,43,0,0,0,19,62
Egypt,2007-01-01,10,0,-4,8,10,24
Egypt,2007-01-01,28,0,1,15,6,50
Eritrea,2007-01-01,1,0,0,0,0,1
Eritrea,2007-01-01,0,0,0,0,0,0
Eritrea,2007-01-01,21,0,0,0,0,21
Eritrea,2007-01-01,0,0,0,0,0,0
Eritrea,2007-01-01,0,0,0,0,0,0
Eritrea,2007-01-01,0,0,0,0,0,0
Eritrea,2007-01-01,3,0,0,6,0,9
Eritrea,2007-01-01,0,0,0,0,0,0
Eritrea,2007-01-01,2,0,0,0,0,2
Eritrea,2007-01-01,12,0,0,0,7,19
Eritrea,2007-01-01,0,0,0,0,9,9
Eritrea,2007-01-01,48,0,0,3,0,51
Eritrea,2007-01-01,99,0,0,6,0,105
Eritrea,2007-01-01,0,0,0,0,0,0
Eritrea,2007-01-01,9,0,0,0,0,9
Eritrea,2007-01-01,8,0,0,0,0,8
Eritrea,2007-01-01,4,0,0,0,0,4
Eritrea,2007-01-01,14,0,0,0,0,14
Eritrea,2007-01-01,0,0,0,0,0,0
Eritrea,2007-01-01,0,0,0,0,0,0
Eritrea,2007-01-01,11,0,0,0,0,11
Eritrea,2007-01-01,12,0,0,0,0,12
Eritrea,2007-01-01,2,0,0,0,0,2
Eritrea,2007-01-01,2,0,0,0,0,2
Eritrea,2007-01-01,0,0,0,-2,0,-2
Eritrea,2007-01-01,-1,0,0,4,0,3
Eritrea,2007-01-01,5,0,0,8,0,13
Georgia,2007-01-01,4,0,0,0,0,4
Georgia,2007-01-01,0,0,0,0,0,0
Georgia,2007-01-01,3,0,0,0,0,3
Georgia,2007-01-01,0,0,0,0,0,0
Georgia,2007-01-01,9,0,0,0,0,9
Georgia,2007-01-01,0,0,0,0,0,0
Georgia,2007-01-01,0,0,0,0,0,0
Georgia,2007-01-01,9,0,0,4,0,13
Georgia,2007-01-01,0,0,0,0,2,2
Georgia,2007-01-01,0,0,0,0,0,0
Georgia,2007-01-01,0,0,0,0,0,0
Georgia,2007-01-01,0,0,0,0,0,0
Georgia,2007-01-01,0,0,0,0,0,0
Georgia,2007-01-01,0,0,0,0,0,0
Georgia,2007-01-01,3,0,0,0,0,3
Georgia,2007-01-01,2,0,0,0,0,2
Georgia,2007-01-01,2,0,0,6,0,8
Georgia,2007-01-01,0,0,0,3,0,3
Georgia,2007-01-01,1,0,0,0,0,1
Georgia,2007-01-01,8,0,0,-2,0,6
Georgia,2007-01-01,0,0,-4,0,1,-3
Georgia,2007-01-01,2,0,0,1,0,3
Georgia,2007-01-01,2,0,0,0,2,4
Georgia,2007-01-01,-2,0,0,6,0,4
Georgia,2007-01-01,-2,0,0,3,0,1
Georgia,2007-01-01,0,0,0,9,0,9
Georgia,2007-01-01,8,0,0,3,0,11
Georgia,2007-01-01,4,0,0,6,0,10
Georgia,2007-01-01,0,0,0,0,1,1
India,2007-01-01,2,0,-6,0,1,-3
India,2007-01-01,14,0,0,0,0,14
India,2007-01-01,15,0,0,9,0,24
India,2007-01-01,8,0,0,9,4,21
India,2007-01-01,68,0,-3,3,2,70
India,2007-01-01,52,0,0,6,8,66
India,2007-01-01,-2,0,-2,0,4,0
India,2007-01-01,2,0,-2,5,2,7
India,2007-01-01,18,0,0,0,1,19
India,2007-01-01,28,0,0,-3,1,26
India,2007-01-01,17,0,0,12,0,29
India,2007-01-01,26,0,-2,10,0,34
India,2007-01-01,42,0,0,0,4,46
India,2007-01-01,11,0,0,0,0,11
India,2007-01-01,16,0,-2,4,1,19
India,2007-01-01,12,0,-1,1,3,15
India,2007-01-01,9,0,0,0,4,13
India,2007-01-01,18,0,-4,3,0,17
India,2007-01-01,16,0,0,0,5,21
India,2007-01-01,20,0,0,-5,0,15
India,2007-01-01,4,0,0,-4,1,1
India,2007-01-01,38,0,0,-1,8,45
India,2007-01-01,14,0,0,1,0,15
India,2007-01-01,34,0,0,0,7,41
India,2007-01-01,42,0,1,25,3,71
India,2007-01-01,66,0,0,25,8,99
India,2007-01-01,52,0,0,2,4,58
India,2007-01-01,26,0,0,9,0,35
India,2007-01-01,26,0,2,10,4,42
India,2007-01-01,42,0,-1,15,0,56
India,2007-01-01,14,0,0,1,0,15
Iran,2007-01-01,16,0,0,0,0,16
Iran,2007-01-01,16,0,0,-2,0,14
Iran,2007-01-01,28,0,0,18,2,48
Iran,2007-01-01,25,0,0,0,-1,24
Iran,2007-01-01,25,0,0,6,5,36
Iran,2007-01-01,6,0,0,3,4,13
Iran,2007-01-01,33,0,3,22,0,58
Iran,2007-01-01,36,0,1,21,2,60
Iran,2007-01-01,21,0,0,9,0,30
Iran,2007-01-01,33,0,0,11,5,49
Iran,2007-01-01,165,0,0,114,6,285
Iran,2007-01-01,44,0,-6,36,14,88
Iran,2007-01-01,46,0,0,19,18,83
Iran,2007-01-01,80,0,0,19,10,109
Iran,2007-01-01,36,2,-2,17,2,55
Iran,2007-01-01,75,0,0,21,3,99
Iran,2007-01-01,29,0,1,9,4,43
Iran,2007-01-01,49,0,0,16,3,68
Iran,2007-01-01,43,4,2,15,2,66
Iran,2007-01-01,48,0,1,-2,5,52
Iran,2007-01-01,34,0,0,5,1,40
Iran,2007-01-01,50,2,0,1,7,60
Iran,2007-01-01,39,0,-4,5,0,40
Iran,2007-01-01,28,0,-7,12,3,36
Iran,2007-01-01,45,0,-2,8,10,61
Iran,2007-01-01,47,0,0,14,6,67
Iran,2007-01-01,101,0,0,3,3,107
Iran,2007-01-01,64,0,0,16,16,96
Iran,2007-01-01,28,0,0,15,9,52
Iran,2007-01-01,135,0,2,-3,21,155
Iran,2007-01-01,54,0,0,5,3,62
Iraq,2007-01-01,74,2,-1,10,6,91
Iraq,2007-01-01,55,0,1,20,12,88
Iraq,2007-01-01,118,0,4,73,5,200
Iraq,2007-01-01,136,6,-11,53,16,200
Iraq,2007-01-01,136,4,-17,56,15,194
Iraq,2007-01-01,93,0,-4,38,6,133
Iraq,2007-01-01,62,0,-1,52,5,118
Iraq,2007-01-01,105,2,6,50,8,171
Iraq,2007-01-01,113,2,-3,102,12,226
Iraq,2007-01-01,141,0,0,26,22,189
Iraq,2007-01-01,248,4,4,73,18,347
Iraq,2007-01-01,120,8,4,38,16,186
Iraq,2007-01-01,81,0,0,31,25,137
Iraq,2007-01-01,122,28,4,3,4,161
Iraq,2007-01-01,152,8,-2,31,5,194
Iraq,2007-01-01,173,4,4,74,9,264
Iraq,2007-01-01,125,4,-2,44,19,190
Iraq,2007-01-01,209,8,-5,29,27,268
Iraq,2007-01-01,125,0,0,26,9,160
Iraq,2007-01-01,96,0,-2,20,5,119
Iraq,2007-01-01,118,0,-5,9,19,141
Iraq,2007-01-01,155,0,0,31,20,206
Iraq,2007-01-01,143,0,0,9,4,156
Iraq,2007-01-01,222,0,0,55,11,288
Iraq,2007-01-01,115,0,0,20,8,143
Iraq,2007-01-01,120,0,3,33,8,164
Iraq,2007-01-01,86,2,0,14,18,120
Iraq,2007-01-01,154,0,1,17,20,192
Iraq,2007-01-01,148,2,0,21,16,187
Iraq,2007-01-01,147,2,1,25,21,196
Iraq,2007-01-01,142,0,-2,46,3,189
Morocco,2007-01-01,4,0,0,0,0,4
Morocco,2007-01-01,0,0,0,-2,0,-2
Morocco,2007-01-01,0,0,0,0,0,0
Morocco,2007-01-01,11,0,0,27,5,43
Morocco,2007-01-01,5,0,0,0,1,6
Morocco,2007-01-01,3,0,0,3,0,6
Morocco,2007-01-01,4,0,0,33,0,37
Morocco,2007-01-01,9,0,2,41,0,52
Morocco,2007-01-01,11,0,0,3,0,14
Morocco,2007-01-01,0,0,0,3,0,3
Morocco,2007-01-01,16,0,0,12,0,28
Morocco,2007-01-01,0,0,0,0,0,0
Morocco,2007-01-01,1,0,0,0,0,1
Morocco,2007-01-01,0,0,0,0,0,0
Morocco,2007-01-01,4,0,0,12,0,16
Morocco,2007-01-01,2,0,0,0,0,2
Morocco,2007-01-01,2,0,0,24,0,26
Morocco,2007-01-01,2,0,0,0,0,2
Morocco,2007-01-01,-1,0,0,0,0,-1
Morocco,2007-01-01,0,0,0,0,0,0
Morocco,2007-01-01,3,0,0,-1,0,2
Morocco,2007-01-01,6,0,0,12,0,18
Morocco,2007-01-01,1,0,0,0,0,1
Morocco,2007-01-01,0,0,0,0,2,2
Morocco,2007-01-01,7,0,0,0,0,7
Morocco,2007-01-01,0,0,0,0,0,0
Morocco,2007-01-01,0,0,0,0,0,0
Morocco,2007-01-01,0,0,0,15,0,15
Morocco,2007-01-01,3,0,0,0,0,3
Nigeria,2007-01-01,-1,0,0,-2,0,-3
Nigeria,2007-01-01,0,0,0,0,0,0
Nigeria,2007-01-01,6,0,-3,6,0,9
Nigeria,2007-01-01,0,0,0,3,0,3
Nigeria,2007-01-01,2,0,-8,5,0,-1
Nigeria,2007-01-01,10,0,0,9,0,19
Nigeria,2007-01-01,0,0,0,0,0,0
Nigeria,2007-01-01,-6,0,0,0,0,-6
Nigeria,2007-01-01,3,0,0,0,0,3
Nigeria,2007-01-01,6,0,0,23,0,29
Nigeria,2007-01-01,6,0,-2,0,7,11
Nigeria,2007-01-01,4,0,-2,6,4,12
Nigeria,2007-01-01,0,0,-2,-2,0,-4
Nigeria,2007-01-01,18,0,0,0,0,18
Nigeria,2007-01-01,10,0,0,0,0,10
Nigeria,2007-01-01,6,0,0,12,0,18
Nigeria,2007-01-01,1,0,0,12,0,13
Nigeria,2007-01-01,15,0,6,0,0,21
Nigeria,2007-01-01,15,0,-1,15,0,29
Nigeria,2007-01-01,0,0,0,0,0,0
Nigeria,2007-01-01,13,0,0,3,3,19
Nigeria,2007-01-01,9,0,0,18,0,27
Nigeria,2007-01-01,6,0,0,-3,0,3
Nigeria,2007-01-01,17,0,4,0,0,21
Nigeria,2007-01-01,19,0,0,24,2,45
Nigeria,2007-01-01,10,0,0,30,1,41
Nigeria,2007-01-01,11,0,0,12,0,23
Nigeria,2007-01-01,14,0,-2,15,3,30
Nigeria,2007-01-01,-9,0,0,0,3,-6
Nigeria,2007-01-01,9,0,0,0,0,9
Pakistan,2007-01-01,6,0,0,3,8,17
Pakistan,2007-01-01,20,0,0,24,1,45
Pakistan,2007-01-01,24,0,0,0,2,26
Pakistan,2007-01-01,52,0,0,6,2,60
Pakistan,2007-01-01,0,0,0,6,0,6
Pakistan,2007-01-01,23,0,0,0,5,28
Pakistan,2007-01-01,33,0,-3,9,7,46
Pakistan,2007-01-01,27,2,-1,15,10,53
Pakistan,2007-01-01,87,0,0,19,6,112
Pakistan,2007-01-01,39,0,0,6,0,45
Pakistan,2007-01-01,64,0,0,-3,6,67
Pakistan,2007-01-01,39,0,0,12,6,57
Pakistan,2007-01-01,13,0,0,-2,1,12
Pakistan,2007-01-01,18,0,-4,3,0,17
Pakistan,2007-01-01,24,0,0,4,5,33
Pakistan,2007-01-01,29,0,0,19,2,50
Pakistan,2007-01-01,32,0,0,75,2,109
Pakistan,2007-01-01,14,0,0,41,1,56
Pakistan,2007-01-01,7,0,0,4,0,11
Pakistan,2007-01-01,39,0,0,15,3,57
Pakistan,2007-01-01,22,0,0,4,0,26
Pakistan,2007-01-01,39,0,-4,8,0,43
Pakistan,2007-01-01,25,0,0,28,3,56
Pakistan,2007-01-01,38,0,-4,24,9,67
Pakistan,2007-01-01,34,0,0,10,1,45
Pakistan,2007-01-01,112,0,0,34,7,153
Pakistan,2007-01-01,11,0,0,41,3,55
Pakistan,2007-01-01,13,0,0,6,0,19
Pakistan,2007-01-01,58,6,-1,43,4,110
Pakistan,2007-01-01,50,0,-1,84,5,138
Pakistan,2007-01-01,54,0,0,43,19,116
Sierra Leone,2007-01-01,0,0,0,0,0,0
Sierra Leone,2007-01-01,0,0,0,3,0,3
Sierra Leone,2007-01-01,10,0,0,0,0,10
Sierra Leone,2007-01-01,0,2,0,3,0,5
Sierra Leone,2007-01-01,2,0,0,0,0,2
Sierra Leone,2007-01-01,12,0,0,0,0,12
Sierra Leone,2007-01-01,6,0,0,0,0,6
Sierra Leone,2007-01-01,0,0,0,0,1,1
Sierra Leone,2007-01-01,0,0,0,0,2,2
Sierra Leone,2007-01-01,0,0,0,2,0,2
Sierra Leone,2007-01-01,0,0,0,3,2,5
Sierra Leone,2007-01-01,0,0,0,0,5,5
Sierra Leone,2007-01-01,0,0,0,0,0,0
Sierra Leone,2007-01-01,0,0,0,0,0,0
Sierra Leone,2007-01-01,0,0,0,0,0,0
Sierra Leone,2007-01-01,0,0,0,0,0,0
Sierra Leone,2007-01-01,3,0,0,3,0,6
Sierra Leone,2007-01-01,2,0,0,0,0,2
Sierra Leone,2007-01-01,0,0,0,0,0,0
Sierra Leone,2007-01-01,0,0,0,0,0,0
Sierra Leone,2007-01-01,2,0,0,6,0,8
Somalia,2007-01-01,6,0,0,0,0,6
Somalia,2007-01-01,14,0,0,6,1,21
Somalia,2007-01-01,40,0,0,13,0,53
Somalia,2007-01-01,63,0,0,3,10,76
Somalia,2007-01-01,49,0,-2,2,4,53
Somalia,2007-01-01,23,0,0,3,0,26
Somalia,2007-01-01,18,0,0,0,0,18
Somalia,2007-01-01,29,0,0,-2,0,27
Somalia,2007-01-01,176,0,-8,26,5,199
Somalia,2007-01-01,146,0,2,1,26,175
Somalia,2007-01-01,84,0,4,15,3,106
Somalia,2007-01-01,17,0,0,6,2,25
Somalia,2007-01-01,39,0,0,18,2,59
Somalia,2007-01-01,14,0,0,0,3,17
Somalia,2007-01-01,18,0,0,9,4,31
Somalia,2007-01-01,18,0,0,9,0,27
Somalia,2007-01-01,-9,0,-2,24,0,13
Somalia,2007-01-01,1,0,0,9,0,10
Somalia,2007-01-01,19,0,0,3,4,26
Somalia,2007-01-01,4,0,0,3,0,7
Somalia,2007-01-01,2,0,0,0,0,2
Somalia,2007-01-01,11,0,0,-1,0,10
Somalia,2007-01-01,15,0,0,17,0,32
Somalia,2007-01-01,15,0,0,6,6,27
Somalia,2007-01-01,13,0,0,21,2,36
Somalia,2007-01-01,17,0,-2,6,0,21
Somalia,2007-01-01,4,0,-1,0,0,3
Somalia,2007-01-01,0,0,0,4,0,4
Somalia,2007-01-01,20,0,-2,3,0,21
Somalia,2007-01-01,10,0,0,-1,2,11
Somalia,2007-01-01,9,0,0,30,7,46
Syria,2007-01-01,9,0,-2,0,0,7
Syria,2007-01-01,-6,0,-2,0,0,-8
Syria,2007-01-01,15,0,0,9,5,29
Syria,2007-01-01,8,0,0,6,8,22
Syria,2007-01-01,24,0,1,16,0,41
Syria,2007-01-01,2,0,0,0,6,8
Syria,2007-01-01,0,0,-12,0,0,-12
Syria,2007-01-01,-16,2,0,12,2,0
Syria,2007-01-01,69,0,2,97,3,171
Syria,2007-01-01,33,0,0,24,4,61
Syria,2007-01-01,57,0,-1,4,2,62
Syria,2007-01-01,20,0,-2,21,0,39
Syria,2007-01-01,15,0,0,0,4,19
Syria,2007-01-01,33,0,0,-5,3,31
Syria,2007-01-01,18,0,1,0,6,25
Syria,2007-01-01,0,2,0,6,4,12
Syria,2007-01-01,20,0,-2,40,0,58
Syria,2007-01-01,16,0,0,15,4,35
Syria,2007-01-01,30,4,2,-8,2,30
Syria,2007-01-01,27,4,2,6,1,40
Syria,2007-01-01,2,0,0,9,0,11
Syria,2007-01-01,10,0,0,5,0,15
Syria,2007-01-01,57,0,-18,15,2,56
Syria,2007-01-01,19,0,2,-2,4,23
Syria,2007-01-01,24,0,0,7,10,41
Syria,2007-01-01,89,0,0,5,8,102
Syria,2007-01-01,29,0,0,7,0,36
Syria,2007-01-01,10,4,0,0,7,21
Syria,2007-01-01,1,0,0,11,3,15
Syria,2007-01-01,0,0,0,0,0,0
Syria,2007-01-01,20,0,0,3,0,23
Yemen,2007-01-01,3,0,0,6,0,9
Yemen,2007-01-01,5,0,0,0,0,5
Yemen,2007-01-01,0,0,0,0,0,0
Yemen,2007-01-01,0,0,0,0,0,0
Yemen,2007-01-01,0,0,0,3,0,3
Yemen,2007-01-01,0,0,0,0,0,0
Yemen,2007-01-01,3,0,0,0,0,3
Yemen,2007-01-01,7,0,0,9,2,18
Yemen,2007-01-01,19,0,0,6,0,25
Yemen,2007-01-01,8,0,0,0,0,8
Yemen,2007-01-01,5,0,0,0,0,5
Yemen,2007-01-01,0,0,0,0,0,0
Yemen,2007-01-01,5,0,0,0,0,5
Yemen,2007-01-01,0,0,0,0,0,0
Yemen,2007-01-01,3,0,0,0,0,3
Yemen,2007-01-01,6,0,0,6,0,12
Yemen,2007-01-01,0,0,0,-34,0,-34
Yemen,2007-01-01,8,0,0,-2,0,6
Yemen,2007-01-01,6,0,0,0,0,6
Yemen,2007-01-01,0,0,0,0,0,0
Yemen,2007-01-01,0,0,0,0,0,0
Yemen,2007-01-01,-1,0,0,-12,0,-13
Yemen,2007-01-01,3,0,0,6,0,9
Yemen,2007-01-01,23,0,0,-4,0,19
Yemen,2007-01-01,32,0,0,6,0,38
Yemen,2007-01-01,2,0,0,6,0,8
Yemen,2007-01-01,8,0,0,0,5,13
Afghanistan,2012-08-01,140,0,0,57,13,210
Afghanistan,2012-08-01,83,0,2,37,10,132
Afghanistan,2012-08-01,165,2,-4,13,3,179
Afghanistan,2012-08-01,184,0,0,24,3,211
Afghanistan,2012-08-01,255,2,-1,18,36,310
Afghanistan,2012-08-01,144,2,-2,34,21,199
Afghanistan,2012-08-01,253,0,-20,43,20,296
Afghanistan,2012-08-01,270,0,-11,18,50,327
Afghanistan,2012-08-01,272,4,0,15,53,344
Afghanistan,2012-08-01,358,2,0,30,56,446
Afghanistan,2012-08-01,288,0,0,32,42,362
Afghanistan,2012-08-01,154,0,-2,31,24,207
Afghanistan,2012-08-01,262,0,-13,49,28,326
Afghanistan,2012-08-01,356,0,0,67,35,458
Afghanistan,2012-08-01,97,0,0,-1,9,105
Afghanistan,2012-08-01,410,0,-8,19,40,461
Afghanistan,2012-08-01,477,2,-6,22,24,519
Afghanistan,2012-08-01,370,4,-8,5,38,409
Afghanistan,2012-08-01,390,2,-3,14,65,468
Afghanistan,2012-08-01,284,0,0,-3,4,285
Afghanistan,2012-08-01,249,0,-18,-4,4,231
Afghanistan,2012-08-01,266,4,3,63,19,355
Afghanistan,2012-08-01,308,4,4,98,11,425
Afghanistan,2012-08-01,250,0,4,49,16,319
Afghanistan,2012-08-01,86,0,1,15,0,102
Afghanistan,2012-08-01,290,2,-1,3,9,303
Afghanistan,2012-08-01,407,0,-2,94,30,529
Afghanistan,2012-08-01,353,2,-4,79,20,450
Afghanistan,2012-08-01,159,0,-8,19,5,175
Afghanistan,2012-08-01,408,0,-6,130,36,568
Afghanistan,2012-08-01,278,0,1,44,32,355
Albania,2012-08-01,5,0,0,8,0,13
Albania,2012-08-01,2,0,0,-6,0,-4
Albania,2012-08-01,12,0,0,6,4,22
Albania,2012-08-01,6,0,0,3,0,9
Albania,2012-08-01,4,0,0,0,0,4
Albania,2012-08-01,1,0,0,9,0,10
Albania,2012-08-01,-1,0,0,0,0,-1
Albania,2012-08-01,4,0,0,0,0,4
Albania,2012-08-01,0,0,0,0,0,0
Albania,2012-08-01,4,0,0,0,1,5
Albania,2012-08-01,0,0,0,0,0,0
Albania,2012-08-01,13,0,0,0,0,13
Albania,2012-08-01,10,0,0,3,0,13
Albania,2012-08-01,5,0,0,6,1,12
Albania,2012-08-01,8,0,0,0,1,9
Albania,2012-08-01,0,0,0,0,0,0
Albania,2012-08-01,1,0,0,0,0,1
Albania,2012-08-01,3,0,0,9,0,12
Albania,2012-08-01,6,0,-8,0,0,-2
Albania,2012-08-01,21,4,-3,0,0,22
Albania,2012-08-01,2,0,0,0,0,2
Albania,2012-08-01,-4,0,0,0,0,-4
Albania,2012-08-01,0,0,0,0,0,0
Albania,2012-08-01,8,0,1,6,0,15
Albania,2012-08-01,6,0,0,6,2,14
Albania,2012-08-01,1,0,0,0,0,1
Albania,2012-08-01,0,0,0,6,0,6
Albania,2012-08-01,4,0,0,0,0,4
Algeria,2012-08-01,8,0,0,3,0,11
Algeria,2012-08-01,3,0,0,0,0,3
Algeria,2012-08-01,7,0,-2,0,0,5
Algeria,2012-08-01,12,0,0,0,2,14
Algeria,2012-08-01,11,0,0,9,0,20
Algeria,2012-08-01,17,0,0,3,2,22
Algeria,2012-08-01,3,0,0,0,1,4
Algeria,2012-08-01,9,0,0,1,3,13
Algeria,2012-08-01,9,0,0,3,1,13
Algeria,2012-08-01,18,0,-6,3,3,18
Algeria,2012-08-01,17,0,0,0,5,22
Algeria,2012-08-01,19,0,0,0,5,24
Algeria,2012-08-01,38,0,-6,0,0,32
Algeria,2012-08-01,6,0,0,0,1,7
Algeria,2012-08-01,-1,0,0,0,2,1
Algeria,2012-08-01,28,0,-18,0,2,12
Algeria,2012-08-01,33,0,-16,4,1,22
Algeria,2012-08-01,104,0,-14,13,0,103
Algeria,2012-08-01,80,0,-10,-2,-4,64
Algeria,2012-08-01,34,0,-22,3,1,16
Algeria,2012-08-01,3,0,-4,0,1,0
Algeria,2012-08-01,2,0,0,3,0,5
Algeria,2012-08-01,7,0,0,0,0,7
Algeria,2012-08-01,13,0,-4,0,4,13
Algeria,2012-08-01,0,0,-4,0,0,-4
Algeria,2012-08-01,36,12,-2,21,1,68
Algeria,2012-08-01,1,0,-3,25,0,23
Algeria,2012-08-01,33,2,-2,13,2,48
Algeria,2012-08-01,8,0,0,4,0,12
Algeria,2012-08-01,3,0,1,0,0,4
Algeria,2012-08-01,6,0,0,6,0,12
Bangladesh,2012-08-01,80,0,0,25,7,112
Bangladesh,2012-08-01,16,0,0,6,3,25
Bangladesh,2012-08-01,66,0,-1,15,4,84
Bangladesh,2012-08-01,25,0,0,12,6,43
Bangladesh,2012-08-01,20,0,0,24,7,51
Bangladesh,2012-08-01,47,0,0,33,2,82
Bangladesh,2012-08-01,45,0,-2,6,2,51
Bangladesh,2012-08-01,65,0,0,16,6,87
Bangladesh,2012-08-01,36,6,-1,13,4,58
Bangladesh,2012-08-01,7,0,-1,9,0,15
Bangladesh,2012-08-01,53,0,-2,5,6,62
Bangladesh,2012-08-01,73,0,0,17,4,94
Bangladesh,2012-08-01,82,0,-1,34,1,116
Bangladesh,2012-08-01,35,2,1,10,8,56
Bangladesh,2012-08-01,16,2,0,-4,5,19
Bangladesh,2012-08-01,84,0,0,-1,13,96
Bangladesh,2012-08-01,94,2,0,46,8,150
Bangladesh,2012-08-01,24,0,1,18,1,44
Bangladesh,2012-08-01,80,0,0,5,6,91
Bangladesh,2012-08-01,46,0,0,0,10,56
Bangladesh,2012-08-01,46,0,3,15,4,68
Bangladesh,2012-08-01,36,0,1,27,4,68
Bangladesh,2012-08-01,50,0,-4,14,7,67
Bangladesh,2012-08-01,37,0,0,18,3,58
Bangladesh,2012-08-01,14,0,0,12,4,30
Bangladesh,2012-08-01,7,0,-2,6,2,13
Bangladesh,2012-08-01,44,0,0,11,0,55
Bangladesh,2012-08-01,23,0,0,22,2,47
Bangladesh,2012-08-01,9,0,0,0,0,9
Bangladesh,2012-08-01,21,0,-4,22,9,48
Bangladesh,2012-08-01,17,0,-4,42,6,61
Cameroon,2012-08-01,0,0,0,0,0,0
Cameroon,2012-08-01,0,0,0,2,0,2
Cameroon,2012-08-01,0,0,0,0,0,0
Cameroon,2012-08-01,1,0,0,0,0,1
Cameroon,2012-08-01,0,0,0,0,1,1
Cameroon,2012-08-01,0,0,0,0,0,0
Cameroon,2012-08-01,3,0,0,0,0,3
Cameroon,2012-08-01,-1,0,0,3,0,2
Cameroon,2012-08-01,0,0,0,0,0,0
Cameroon,2012-08-01,3,0,-1,0,0,2
Cameroon,2012-08-01,0,0,0,0,0,0
Cameroon,2012-08-01,4,0,0,15,0,19
Cameroon,2012-08-01,1,0,0,12,1,14
Cameroon,2012-08-01,0,0,0,0,0,0
Cameroon,2012-08-01,1,0,0,9,1,11
Cameroon,2012-08-01,2,0,0,0,0,2
Cameroon,2012-08-01,0,0,0,0,0,0
Cameroon,2012-08-01,3,0,0,6,0,9
Cameroon,2012-08-01,6,0,2,4,0,12
Cameroon,2012-08-01,0,0,0,0,0,0
Cameroon,2012-08-01,0,0,0,0,0,0
Cameroon,2012-08-01,17,0,0,3,3,23
Cameroon,2012-08-01,3,0,0,0,0,3
Cameroon,2012-08-01,3,0,0,6,0,9
Cameroon,2012-08-01,3,0,0,9,0,12
Cameroon,2012-08-01,0,0,0,-6,0,-6
Cameroon,2012-08-01,1,0,-2,0,0,-1
Cameroon,2012-08-01,9,0,0,3,0,12
China,2012-08-01,172,0,17,119,8,316
China,2012-08-01,92,2,1,53,6,154
China,2012-08-01,145,12,-9,74,20,242
China,2012-08-01,113,0,-4,31,15,155
China,2012-08-01,139,0,-4,61,16,212
China,2012-08-01,240,2,-10,175,25,432
China,2012-08-01,190,0,-2,92,24,304
China,2012-08-01,200,2,-2,61,18,279
China,2012-08-01,163,4,-2,53,17,235
China,2012-08-01,142,4,-9,55,11,203
China,2012-08-01,102,0,1,-10,21,114
China,2012-08-01,73,0,1,20,3,97
China,2012-08-01,209,2,-6,108,34,347
China,2012-08-01,166,0,-10,74,32,262
China,2012-08-01,34,0,-4,36,8,74
China,2012-08-01,231,0,-2,104,40,373
China,2012-08-01,176,0,-1,99,33,307
China,2012-08-01,90,0,2,40,13,145
China,2012-08-01,112,0,0,19,17,148
China,2012-08-01,144,0,3,57,13,217
China,2012-08-01,166,0,1,37,18,222
China,2012-08-01,150,2,-10,69,25,236
China,2012-08-01,221,0,-2,94,29,342
China,2012-08-01,198,6,-3,62,31,294
China,2012-08-01,5,0,0,3,3,11
China,2012-08-01,90,8,3,22,8,131
China,2012-08-01,187,0,-1,76,23,285
China,2012-08-01,144,6,-10,41,11,192
China,2012-08-01,32,4,2,-2,9,45
China,2012-08-01,159,10,-5,69,19,252
China,2012-08-01,65,0,-2,42,22,127
Egypt,2012-08-01,119,0,0,40,11,170
Egypt,2012-08-01,28,0,-4,16,2,42
Egypt,2012-08-01,69,0,3,21,8,101
Egypt,2012-08-01,49,0,-4,47,8,100
Egypt,2012-08-01,307,2,1,21,13,344
Egypt,2012-08-01,624,0,0,74,70,768
Egypt,2012-08-01,273,0,1,64,30,368
Egypt,2012-08-01,346,0,-1,31,30,406
Egypt,2012-08-01,241,0,-1,34,27,301
Egypt,2012-08-01,78,0,0,39,14,131
Egypt,2012-08-01,36,0,0,30,13,79
Egypt,2012-08-01,190,0,-27,32,9,204
Egypt,2012-08-01,193,0,-12,53,11,245
Egypt,2012-08-01,178,4,-8,39,15,228
Egypt,2012-08-01,46,0,1,18,3,68
Egypt,2012-08-01,158,0,-4,44,13,211
Egypt,2012-08-01,91,0,-5,51,5,142
Egypt,2012-08-01,64,0,-2,26,7,95
Egypt,2012-08-01,99,0,-4,18,17,130
Egypt,2012-08-01,97,0,0,18,12,127
Egypt,2012-08-01,97,0,-2,20,20,135
Egypt,2012-08-01,101,4,-4,5,11,117
Egypt,2012-08-01,82,12,-2,71,20,183
Egypt,2012-08-01,88,0,0,26,12,126
Egypt,2012-08-01,0,0,2,13,0,15
Egypt,2012-08-01,195,2,-4,38,9,240
Egypt,2012-08-01,96,0,-6,2,24,116
Egypt,2012-08-01,88,10,0,-16,3,85
Egypt,2012-08-01,25,0,1,12,3,41
Egypt,2012-08-01,99,0,-13,-4,19,101
Egypt,2012-08-01,131,0,3,31,9,174
Eritrea,2012-08-01,2,0,0,3,0,5
Eritrea,2012-08-01,11,0,0,12,0,23
Eritrea,2012-08-01,0,0,0,3,0,3
Eritrea,2012-08-01,0,0,0,0,0,0
Eritrea,2012-08-01,0,0,0,0,0,0
Eritrea,2012-08-01,0,0,0,6,0,6
Eritrea,2012-08-01,0,0,0,3,2,5
Eritrea,2012-08-01,4,0,-4,0,1,1
Eritrea,2012-08-01,2,0,-4,0,0,-2
Eritrea,2012-08-01,0,0,0,0,0,0
Eritrea,2012-08-01,1,0,0,-1,0,0
Eritrea,2012-08-01,3,0,0,6,0,9
Eritrea,2012-08-01,2,0,0,6,5,13
Eritrea,2012-08-01,5,0,0,0,0,5
Eritrea,2012-08-01,1,0,0,0,0,1
Eritrea,2012-08-01,1,0,0,0,0,1
Eritrea,2012-08-01,0,0,0,-1,0,-1
Eritrea,2012-08-01,43,0,0,0,0,43
Eritrea,2012-08-01,8,0,0,0,2,10
Eritrea,2012-08-01,7,0,0,0,0,7
Eritrea,2012-08-01,8,0,0,0,4,12
Eritrea,2012-08-01,8,0,0,0,0,8
Eritrea,2012-08-01,4,0,0,0,1,5
Eritrea,2012-08-01,6,0,0,1,1,8
Eritrea,2012-08-01,3,0,0,-12,0,-9
Eritrea,2012-08-01,3,0,0,0,0,3
Eritrea,2012-08-01,15,0,0,79,0,94
Eritrea,2012-08-01,0,0,0,0,2,2
Georgia,2012-08-01,1,0,0,3,0,4
Georgia,2012-08-01,0,0,0,0,0,0
Georgia,2012-08-01,0,0,0,0,0,0
Georgia,2012-08-01,2,0,0,0,0,2
Georgia,2012-08-01,2,0,0,0,0,2
Georgia,2012-08-01,1,0,0,0,0,1
Georgia,2012-08-01,0,0,0,0,0,0
Georgia,2012-08-01,-1,0,0,0,0,-1
Georgia,2012-08-01,0,0,0,-2,0,-2
Georgia,2012-08-01,1,0,0,0,0,1
Georgia,2012-08-01,0,0,0,0,0,0
Georgia,2012-08-01,1,0,-2,0,0,-1
Georgia,2012-08-01,0,0,0,0,0,0
Georgia,2012-08-01,2,0,0,1,0,3
Georgia,2012-08-01,0,0,0,0,0,0
Georgia,2012-08-01,0,0,0,0,0,0
Georgia,2012-08-01,4,0,0,0,0,4
Georgia,2012-08-01,0,0,1,0,0,1
Georgia,2012-08-01,0,0,0,0,0,0
Georgia,2012-08-01,2,0,0,0,0,2
Georgia,2012-08-01,2,0,0,0,0,2
Georgia,2012-08-01,0,0,0,0,0,0
Georgia,2012-08-01,-1,0,0,0,0,-1
Georgia,2012-08-01,2,0,0,0,0,2
Georgia,2012-08-01,4,0,0,0,0,4
Georgia,2012-08-01,0,0,0,0,0,0
India,2012-08-01,72,0,0,23,12,107
India,2012-08-01,28,0,-2,16,7,49
India,2012-08-01,76,2,-1,17,6,100
India,2012-08-01,56,2,-2,4,2,62
India,2012-08-01,294,2,0,65,34,395
India,2012-08-01,181,0,-2,9,13,201
India,2012-08-01,147,2,1,36,3,189
India,2012-08-01,139,4,-11,34,14,180
India,2012-08-01,129,2,-1,51,21,202
India,2012-08-01,115,2,-1,17,9,142
India,2012-08-01,56,10,0,13,3,82
India,2012-08-01,81,4,-3,17,1,100
India,2012-08-01,69,8,0,19,8,104
India,2012-08-01,103,6,2,31,9,151
India,2012-08-01,31,2,0,5,1,39
India,2012-08-01,94,6,-2,20,9,127
India,2012-08-01,104,2,-5,66,23,190
India,2012-08-01,49,0,1,18,5,73
India,2012-08-01,54,0,-1,21,7,81
India,2012-08-01,34,2,-7,16,11,56
India,2012-08-01,98,2,-5,52,21,168
India,2012-08-01,72,2,-20,28,25,107
India,2012-08-01,73,4,-11,33,15,114
India,2012-08-01,123,0,-4,26,15,160
India,2012-08-01,-1,0,-2,-2,3,-2
India,2012-08-01,88,0,-1,31,7,125
India,2012-08-01,104,4,-9,22,7,128
India,2012-08-01,57,0,-10,34,26,107
India,2012-08-01,22,0,-1,14,2,37
India,2012-08-01,126,0,-6,47,16,183
India,2012-08-01,104,0,-8,38,10,144
Iran,2012-08-01,196,6,13,48,28,291
Iran,2012-08-01,77,0,4,26,8,115
Iran,2012-08-01,139,2,1,19,15,176
Iran,2012-08-01,202,0,0,141,35,378
Iran,2012-08-01,202,0,4,133,35,374
Iran,2012-08-01,238,6,-3,113,26,380
Iran,2012-08-01,307,16,-7,141,22,479
Iran,2012-08-01,214,14,-2,96,8,330
Iran,2012-08-01,180,2,-5,48,17,242
Iran,2012-08-01,101,0,-1,15,8,123
Iran,2012-08-01,68,0,-1,23,4,94
Iran,2012-08-01,123,0,-2,43,8,172
Iran,2012-08-01,185,6,2,54,15,262
Iran,2012-08-01,281,4,2,55,29,371
Iran,2012-08-01,103,0,0,30,14,147
Iran,2012-08-01,225,12,1,37,13,288
Iran,2012-08-01,152,6,-2,20,29,205
Iran,2012-08-01,146,0,1,50,19,216
Iran,2012-08-01,89,0,-1,38,14,140
Iran,2012-08-01,107,0,0,46,11,164
Iran,2012-08-01,140,0,0,36,12,188
Iran,2012-08-01,91,4,4,25,7,131
Iran,2012-08-01,133,0,4,82,23,242
Iran,2012-08-01,125,2,0,47,7,181
Iran,2012-08-01,30,0,-2,6,0,34
Iran,2012-08-01,144,2,5,35,6,192
Iran,2012-08-01,198,0,-1,55,11,263
Iran,2012-08-01,103,0,1,74,6,184
Iran,2012-08-01,51,0,0,12,3,66
Iran,2012-08-01,274,6,3,15,30,328
Iran,2012-08-01,132,0,2,2,13,149
Iraq,2012-08-01,162,4,0,16,8,190
Iraq,2012-08-01,54,0,1,-4,3,54
Iraq,2012-08-01,89,0,0,-18,5,76
Iraq,2012-08-01,39,0,0,5,1,45
Iraq,2012-08-01,221,0,-10,-2,2,211
Iraq,2012-08-01,176,0,0,27,6,209
Iraq,2012-08-01,100,2,0,31,16,149
Iraq,2012-08-01,58,0,2,32,17,109
Iraq,2012-08-01,137,10,10,47,4,208
Iraq,2012-08-01,70,12,3,8,6,99
Iraq,2012-08-01,54,0,0,33,3,90
Iraq,2012-08-01,30,0,0,34,14,78
Iraq,2012-08-01,150,0,0,33,5,188
Iraq,2012-08-01,123,0,2,34,19,178
Iraq,2012-08-01,54,0,4,10,5,73
Iraq,2012-08-01,125,0,-4,67,15,203
Iraq,2012-08-01,96,0,0,27,7,130
Iraq,2012-08-01,79,2,0,34,7,122
Iraq,2012-08-01,52,8,1,42,5,108
Iraq,2012-08-01,47,0,0,12,17,76
Iraq,2012-08-01,173,2,0,30,6,211
Iraq,2012-08-01,153,2,0,61,7,223
Iraq,2012-08-01,224,0,1,105,10,340
Iraq,2012-08-01,128,2,-2,13,22,163
Iraq,2012-08-01,1,0,0,0,4,5
Iraq,2012-08-01,66,2,-1,12,10,89
Iraq,2012-08-01,82,2,-27,13,14,84
Iraq,2012-08-01,66,2,-5,24,11,98
Iraq,2012-08-01,5,0,-2,-5,5,3
Iraq,2012-08-01,113,0,-4,87,16,212
Iraq,2012-08-01,149,2,3,59,13,226
Morocco,2012-08-01,5,0,0,11,0,16
Morocco,2012-08-01,6,0,0,42,5,53
Morocco,2012-08-01,25,0,0,3,8,36
Morocco,2012-08-01,0,0,0,-2,0,-2
Morocco,2012-08-01,2,0,0,-2,2,2
Morocco,2012-08-01,6,0,0,0,0,6
Morocco,2012-08-01,8,0,-2,0,0,6
Morocco,2012-08-01,2,0,0,0,0,2
Morocco,2012-08-01,1,4,0,9,2,16
Morocco,2012-08-01,0,0,0,3,0,3
Morocco,2012-08-01,34,0,0,0,0,34
Morocco,2012-08-01,29,0,0,6,0,35
Morocco,2012-08-01,10,0,0,6,0,16
Morocco,2012-08-01,16,0,0,3,4,23
Morocco,2012-08-01,4,0,0,3,0,7
Morocco,2012-08-01,12,0,0,-4,4,12
Morocco,2012-08-01,7,0,0,0,4,11
Morocco,2012-08-01,11,0,0,3,0,14
Morocco,2012-08-01,33,0,0,-10,0,23
Morocco,2012-08-01,0,0,1,40,0,41
Morocco,2012-08-01,1,0,0,19,0,20
Morocco,2012-08-01,24,0,0,6,0,30
Morocco,2012-08-01,12,0,0,3,0,15
Morocco,2012-08-01,18,0,0,8,8,34
Morocco,2012-08-01,0,0,-2,0,0,-2
Morocco,2012-08-01,33,0,-2,22,2,55
Morocco,2012-08-01,7,0,0,0,0,7
Morocco,2012-08-01,11,0,0,11,1,23
Morocco,2012-08-01,0,0,0,0,3,3
Morocco,2012-08-01,17,0,0,3,1,21
Morocco,2012-08-01,9,0,0,12,3,24
Nigeria,2012-08-01,15,0,0,14,2,31
Nigeria,2012-08-01,4,0,0,25,0,29
Nigeria,2012-08-01,25,0,-1,5,2,31
Nigeria,2012-08-01,62,0,0,68,3,133
Nigeria,2012-08-01,22,0,-4,3,4,25
Nigeria,2012-08-01,7,0,0,12,1,20
Nigeria,2012-08-01,20,0,1,3,0,24
Nigeria,2012-08-01,28,0,-2,-1,6,31
Nigeria,2012-08-01,32,0,-1,-9,3,25
Nigeria,2012-08-01,20,0,1,6,0,27
Nigeria,2012-08-01,0,0,0,4,0,4
Nigeria,2012-08-01,12,0,0,3,3,18
Nigeria,2012-08-01,19,2,1,16,2,40
Nigeria,2012-08-01,37,0,0,25,2,64
Nigeria,2012-08-01,8,0,0,15,2,25
Nigeria,2012-08-01,1,0,1,-10,5,-3
Nigeria,2012-08-01,11,0,0,2,2,15
Nigeria,2012-08-01,36,0,0,15,2,53
Nigeria,2012-08-01,36,0,1,4,1,42
Nigeria,2012-08-01,33,0,0,27,0,60
Nigeria,2012-08-01,19,0,2,42,2,65
Nigeria,2012-08-01,49,0,0,15,6,70
Nigeria,2012-08-01,50,2,0,23,3,78
Nigeria,2012-08-01,74,0,0,6,10,90
Nigeria,2012-08-01,6,0,0,0,0,6
Nigeria,2012-08-01,43,0,4,16,4,67
Nigeria,2012-08-01,36,0,2,0,1,39
Nigeria,2012-08-01,48,0,-2,10,13,69
Nigeria,2012-08-01,2,0,0,3,0,5
Nigeria,2012-08-01,48,0,-5,-2,4,45
Nigeria,2012-08-01,43,0,-2,8,1,50
Pakistan,2012-08-01,102,0,0,-4,11,109
Pakistan,2012-08-01,56,0,0,44,0,100
Pakistan,2012-08-01,171,0,0,120,6,297
Pakistan,2012-08-01,178,0,0,97,4,279
Pakistan,2012-08-01,150,2,-1,46,22,219
Pakistan,2012-08-01,166,0,0,23,6,195
Pakistan,2012-08-01,104,0,-4,29,20,149
Pakistan,2012-08-01,185,0,-4,82,7,270
Pakistan,2012-08-01,76,2,-4,10,16,100
Pakistan,2012-08-01,45,0,2,5,7,59
Pakistan,2012-08-01,72,0,-1,1,2,74
Pakistan,2012-08-01,36,0,0,44,15,95
Pakistan,2012-08-01,140,0,-4,40,9,185
Pakistan,2012-08-01,244,0,-2,38,32,312
Pakistan,2012-08-01,118,0,0,31,39,188
Pakistan,2012-08-01,254,6,-6,34,15,303
Pakistan,2012-08-01,143,0,0,5,7,155
Pakistan,2012-08-01,52,0,3,10,29,94
Pakistan,2012-08-01,178,0,0,2,21,201
Pakistan,2012-08-01,71,0,0,29,13,113
Pakistan,2012-08-01,61,2,0,28,14,105
Pakistan,2012-08-01,38,0,0,13,12,63
Pakistan,2012-08-01,85,0,0,38,9,132
Pakistan,2012-08-01,140,0,-2,34,12,184
Pakistan,2012-08-01,41,0,-4,9,0,46
Pakistan,2012-08-01,123,2,0,40,6,171
Pakistan,2012-08-01,144,0,1,65,6,216
Pakistan,2012-08-01,76,0,0,18,1,95
Pakistan,2012-08-01,125,8,9,44,9,195
Pakistan,2012-08-01,200,2,3,71,9,285
Pakistan,2012-08-01,106,0,4,54,14,178
Sierra Leone,2012-08-01,-4,0,0,9,1,6
Sierra Leone,2012-08-01,0,0,0,0,0,0
Sierra Leone,2012-08-01,8,0,0,0,0,8
Sierra Leone,2012-08-01,0,0,0,0,0,0
Sierra Leone,2012-08-01,9,0,0,0,0,9
Sierra Leone,2012-08-01,0,0,0,3,1,4
Sierra Leone,2012-08-01,2,0,0,6,0,8
Sierra Leone,2012-08-01,2,0,0,9,0,11
Sierra Leone,2012-08-01,11,0,0,0,0,11
Sierra Leone,2012-08-01,3,0,0,0,0,3
Sierra Leone,2012-08-01,4,0,0,3,0,7
Sierra Leone,2012-08-01,3,0,0,3,0,6
Sierra Leone,2012-08-01,0,0,0,0,0,0
Sierra Leone,2012-08-01,0,0,0,0,0,0
Sierra Leone,2012-08-01,0,0,0,0,0,0
Sierra Leone,2012-08-01,2,0,0,0,0,2
Sierra Leone,2012-08-01,1,0,0,0,0,1
Sierra Leone,2012-08-01,9,0,0,9,0,18
Sierra Leone,2012-08-01,3,0,0,0,0,3
Sierra Leone,2012-08-01,3,0,0,0,0,3
Sierra Leone,2012-08-01,2,0,0,0,0,2
Sierra Leone,2012-08-01,0,0,0,-1,0,-1
Sierra Leone,2012-08-01,3,0,0,3,0,6
Sierra Leone,2012-08-01,7,0,0,3,0,10
Sierra Leone,2012-08-01,0,0,0,0,2,2
Sierra Leone,2012-08-01,3,0,0,0,0,3
Sierra Leone,2012-08-01,23,2,0,0,1,26
Sierra Leone,2012-08-01,5,0,0,0,0,5
Sierra Leone,2012-08-01,8,0,0,0,0,8
Sierra Leone,2012-08-01,1,0,0,3,0,4
Somalia,2012-08-01,106,0,-5,44,31,176
Somalia,2012-08-01,44,0,-10,15,7,56
Somalia,2012-08-01,94,0,-5,17,17,123
Somalia,2012-08-01,103,0,0,15,20,138
Somalia,2012-08-01,121,0,0,24,5,150
Somalia,2012-08-01,86,0,-2,18,5,107
Somalia,2012-08-01,63,0,-9,34,3,91
Somalia,2012-08-01,113,4,-5,53,6,171
Somalia,2012-08-01,75,0,-4,49,12,132
Somalia,2012-08-01,27,0,0,9,17,53
Somalia,2012-08-01,42,0,-1,0,7,48
Somalia,2012-08-01,85,0,0,52,7,144
Somalia,2012-08-01,141,0,0,97,10,248
Somalia,2012-08-01,192,4,1,58,23,278
Somalia,2012-08-01,75,0,-2,25,7,105
Somalia,2012-08-01,117,0,-2,59,9,183
Somalia,2012-08-01,71,0,-1,46,5,121
Somalia,2012-08-01,28,0,0,5,4,37
Somalia,2012-08-01,51,0,0,12,11,74
Somalia,2012-08-01,50,0,0,27,16,93
Somalia,2012-08-01,160,0,0,32,6,198
Somalia,2012-08-01,136,2,-2,17,2,155
Somalia,2012-08-01,106,4,2,33,8,153
Somalia,2012-08-01,85,2,0,-1,16,102
Somalia,2012-08-01,69,0,-1,16,5,89
Somalia,2012-08-01,229,2,-6,26,17,268
Somalia,2012-08-01,252,0,-2,64,37,351
Somalia,2012-08-01,63,0,1,15,5,84
Somalia,2012-08-01,142,0,1,53,16,212
Somalia,2012-08-01,64,0,-6,36,2,96
Syria,2012-08-01,388,2,-11,17,22,418
Syria,2012-08-01,258,0,-38,30,26,276
Syria,2012-08-01,522,22,-27,16,14,547
Syria,2012-08-01,171,4,-9,42,1,209
Syria,2012-08-01,297,0,0,73,16,386
Syria,2012-08-01,595,2,-14,71,39,693
Syria,2012-08-01,501,0,-4,89,26,612
Syria,2012-08-01,302,0,-7,56,31,382
Syria,2012-08-01,276,8,-13,98,19,388
Syria,2012-08-01,209,2,-18,39,17,249
Syria,2012-08-01,340,2,-10,52,21,405
Syria,2012-08-01,265,0,-10,78,25,358
Syria,2012-08-01,504,2,-7,41,9,549
Syria,2012-08-01,543,8,-5,159,28,733
Syria,2012-08-01,187,0,-1,56,20,262
Syria,2012-08-01,475,4,-8,212,51,734
Syria,2012-08-01,377,2,-24,100,53,508
Syria,2012-08-01,229,0,-8,37,16,274
Syria,2012-08-01,107,0,-22,12,11,108
Syria,2012-08-01,326,4,-20,32,29,371
Syria,2012-08-01,571,0,-38,90,27,650
Syria,2012-08-01,535,6,-1,21,39,600
Syria,2012-08-01,447,4,-5,41,16,503
Syria,2012-08-01,556,4,-9,57,15,623
Syria,2012-08-01,45,0,-6,23,1,63
Syria,2012-08-01,307,10,-5,25,18,355
Syria,2012-08-01,287,32,-8,24,2,337
Syria,2012-08-01,293,8,-5,92,48,436
Syria,2012-08-01,132,4,0,22,33,191
Syria,2012-08-01,395,24,6,53,41,519
Syria,2012-08-01,293,12,4,28,28,365
Yemen,2012-08-01,56,0,0,22,0,78
Yemen,2012-08-01,3,0,0,3,1,7
Yemen,2012-08-01,13,0,0,1,1,15
Yemen,2012-08-01,26,0,0,9,8,43
Yemen,2012-08-01,105,0,0,6,15,126
Yemen,2012-08-01,17,0,0,10,5,32
Yemen,2012-08-01,27,0,0,2,3,32
Yemen,2012-08-01,14,0,0,-1,5,18
Yemen,2012-08-01,5,0,0,-1,0,4
Yemen,2012-08-01,32,2,0,3,1,38
Yemen,2012-08-01,6,2,0,15,2,25
Yemen,2012-08-01,38,0,0,10,2,50
Yemen,2012-08-01,7,0,0,32,0,39
Yemen,2012-08-01,24,0,0,4,8,36
Yemen,2012-08-01,22,0,0,30,0,52
Yemen,2012-08-01,34,0,0,8,0,42
Yemen,2012-08-01,-1,0,0,12,3,14
Yemen,2012-08-01,55,0,0,3,3,61
Yemen,2012-08-01,26,0,-2,27,23,74
Yemen,2012-08-01,16,0,2,-2,4,20
Yemen,2012-08-01,0,0,0,18,3,21
Yemen,2012-08-01,20,0,0,6,0,26
Yemen,2012-08-01,47,0,0,15,4,66
Yemen,2012-08-01,7,0,0,12,0,19
Yemen,2012-08-01,18,0,0,0,0,18
Yemen,2012-08-01,15,0,0,0,0,15
Yemen,2012-08-01,14,0,0,2,1,17
Yemen,2012-08-01,0,0,1,6,0,7
Yemen,2012-08-01,36,0,1,45,0,82
Yemen,2012-08-01,43,0,0,10,0,53
Afghanistan,2007-04-01,64,2,0,-4,18,80
Afghanistan,2007-04-01,71,2,0,14,11,98
Afghanistan,2007-04-01,74,0,1,31,12,118
Afghanistan,2007-04-01,76,0,0,38,21,135
Afghanistan,2007-04-01,71,0,1,45,16,133
Afghanistan,2007-04-01,79,0,0,29,2,110
Afghanistan,2007-04-01,66,2,0,32,1,101
Afghanistan,2007-04-01,91,2,0,40,12,145
Afghanistan,2007-04-01,130,0,1,44,21,196
Afghanistan,2007-04-01,166,0,-1,6,18,189
Afghanistan,2007-04-01,128,0,1,21,7,157
Afghanistan,2007-04-01,382,4,0,23,38,447
Afghanistan,2007-04-01,89,0,-6,21,4,108
Afghanistan,2007-04-01,69,0,0,23,17,109
Afghanistan,2007-04-01,49,0,1,33,5,88
Afghanistan,2007-04-01,104,0,1,46,12,163
Afghanistan,2007-04-01,81,0,-1,59,17,156
Afghanistan,2007-04-01,72,0,1,26,8,107
Afghanistan,2007-04-01,140,0,0,48,25,213
Afghanistan,2007-04-01,82,0,2,20,9,113
Afghanistan,2007-04-01,59,0,0,26,5,90
Afghanistan,2007-04-01,60,4,0,7,0,71
Afghanistan,2007-04-01,59,0,-1,55,3,116
Afghanistan,2007-04-01,122,0,-1,124,19,264
Afghanistan,2007-04-01,109,0,-1,66,9,183
Afghanistan,2007-04-01,19,0,0,23,2,44
Afghanistan,2007-04-01,65,0,1,26,3,95
Afghanistan,2007-04-01,151,0,0,-13,25,163
Afghanistan,2007-04-01,134,0,0,-19,22,137
Afghanistan,2007-04-01,110,2,0,-8,1,105
Albania,2007-04-01,9,0,-2,3,3,13
Albania,2007-04-01,14,0,-12,-4,10,8
Albania,2007-04-01,11,0,-4,1,2,10
Albania,2007-04-01,4,0,0,0,5,9
Albania,2007-04-01,10,0,-3,6,7,20
Albania,2007-04-01,4,0,0,0,6,10
Albania,2007-04-01,6,0,0,3,1,10
Albania,2007-04-01,3,0,0,0,0,3
Albania,2007-04-01,0,0,0,0,0,0
Albania,2007-04-01,12,0,1,18,4,35
Albania,2007-04-01,5,0,0,12,0,17
Albania,2007-04-01,-5,0,0,15,0,10
Albania,2007-04-01,19,0,-1,17,0,35
Albania,2007-04-01,8,0,0,-7,0,1
Albania,2007-04-01,0,0,2,14,0,16
Albania,2007-04-01,66,0,-2,42,2,108
Albania,2007-04-01,28,0,0,21,10,59
Albania,2007-04-01,6,0,-1,3,2,10
Albania,2007-04-01,2,0,-10,0,1,-7
Albania,2007-04-01,21,0,-1,12,0,32
Albania,2007-04-01,0,0,0,0,2,2
Albania,2007-04-01,0,0,0,0,0,0
Albania,2007-04-01,-4,0,0,1,0,-3
Albania,2007-04-01,27,0,-7,2,8,30
Albania,2007-04-01,2,0,-5,-2,0,-5
Albania,2007-04-01,3,0,0,18,2,23
Albania,2007-04-01,10,0,0,3,6,19
Albania,2007-04-01,18,6,0,0,1,25
Albania,2007-04-01,30,0,0,0,0,30
Albania,2007-04-01,9,0,-3,0,0,6
Algeria,2007-04-01,0,0,0,0,0,0
Algeria,2007-04-01,6,0,-2,0,0,4
Algeria,2007-04-01,0,0,0,4,0,4
Algeria,2007-04-01,-2,0,0,0,0,-2
Algeria,2007-04-01,7,0,-4,12,0,15
Algeria,2007-04-01,11,4,-2,21,0,34
Algeria,2007-04-01,8,0,0,0,0,8
Algeria,2007-04-01,5,0,0,0,1,6
Algeria,2007-04-01,10,0,0,0,3,13
Algeria,2007-04-01,36,0,0,0,6,42
Algeria,2007-04-01,20,2,0,-8,17,31
Algeria,2007-04-01,10,0,0,12,4,26
Algeria,2007-04-01,7,0,0,0,6,13
Algeria,2007-04-01,10,0,0,12,26,48
Algeria,2007-04-01,-1,0,0,3,15,17
Algeria,2007-04-01,2,0,0,12,2,16
Algeria,2007-04-01,16,0,0,0,1,17
Algeria,2007-04-01,5,0,0,1,0,6
Algeria,2007-04-01,4,0,0,0,0,4
Algeria,2007-04-01,0,0,0,0,0,0
Algeria,2007-04-01,1,0,0,0,0,1
Algeria,2007-04-01,0,0,0,0,0,0
Algeria,2007-04-01,1,0,0,6,0,7
Algeria,2007-04-01,0,0,0,0,0,0
Algeria,2007-04-01,6,0,0,0,0,6
Algeria,2007-04-01,8,0,0,15,0,23
Algeria,2007-04-01,6,0,0,0,0,6
Algeria,2007-04-01,0,0,0,0,0,0
Algeria,2007-04-01,0,0,0,0,0,0
Bangladesh,2007-04-01,33,0,0,23,3,59
Bangladesh,2007-04-01,15,0,0,1,1,17
Bangladesh,2007-04-01,8,0,0,6,0,14
Bangladesh,2007-04-01,6,0,0,6,1,13
Bangladesh,2007-04-01,9,0,-5,6,0,10
Bangladesh,2007-04-01,2,0,0,0,0,2
Bangladesh,2007-04-01,0,0,0,-1,0,-1
Bangladesh,2007-04-01,6,0,0,6,0,12
Bangladesh,2007-04-01,5,0,0,26,0,31
Bangladesh,2007-04-01,10,0,0,6,0,16
Bangladesh,2007-04-01,47,0,0,23,0,70
Bangladesh,2007-04-01,49,0,1,24,0,74
Bangladesh,2007-04-01,15,0,0,2,0,17
Bangladesh,2007-04-01,5,0,0,0,1,6
Bangladesh,2007-04-01,4,0,-2,6,2,10
Bangladesh,2007-04-01,12,2,0,10,0,24
Bangladesh,2007-04-01,17,0,0,6,0,23
Bangladesh,2007-04-01,34,0,0,41,0,75
Bangladesh,2007-04-01,26,0,0,4,0,30
Bangladesh,2007-04-01,-2,0,4,6,1,9
Bangladesh,2007-04-01,14,0,0,15,0,29
Bangladesh,2007-04-01,27,0,0,21,0,48
Bangladesh,2007-04-01,3,0,0,4,2,9
Bangladesh,2007-04-01,-1,0,0,6,1,6
Bangladesh,2007-04-01,19,0,2,9,0,30
Bangladesh,2007-04-01,7,0,0,12,1,20
Bangladesh,2007-04-01,13,0,0,15,0,28
Bangladesh,2007-04-01,0,0,0,6,0,6
Bangladesh,2007-04-01,20,0,0,16,4,40
Bangladesh,2007-04-01,7,0,0,4,1,12
Cameroon,2007-04-01,0,0,1,0,0,1
Cameroon,2007-04-01,0,0,0,0,0,0
Cameroon,2007-04-01,13,0,0,0,0,13
Cameroon,2007-04-01,16,0,0,0,0,16
Cameroon,2007-04-01,0,0,0,4,0,4
Cameroon,2007-04-01,0,0,0,0,0,0
Cameroon,2007-04-01,0,0,0,0,0,0
Cameroon,2007-04-01,1,0,0,7,0,8
Cameroon,2007-04-01,-1,0,0,6,0,5
Cameroon,2007-04-01,0,0,0,0,0,0
Cameroon,2007-04-01,0,0,0,0,0,0
Cameroon,2007-04-01,4,0,0,0,0,4
Cameroon,2007-04-01,0,2,0,0,0,2
Cameroon,2007-04-01,0,0,0,0,0,0
Cameroon,2007-04-01,0,0,0,0,0,0
Cameroon,2007-04-01,1,0,0,0,0,1
Cameroon,2007-04-01,0,0,0,0,0,0
Cameroon,2007-04-01,4,0,0,0,0,4
Cameroon,2007-04-01,0,0,0,0,0,0
Cameroon,2007-04-01,9,0,0,3,0,12
Cameroon,2007-04-01,0,0,0,0,0,0
Cameroon,2007-04-01,0,0,0,0,0,0
China,2007-04-01,19,0,0,31,3,53
China,2007-04-01,58,8,-1,74,14,153
China,2007-04-01,57,0,1,47,13,118
China,2007-04-01,41,2,1,54,18,116
China,2007-04-01,48,0,0,19,12,79
China,2007-04-01,66,2,0,50,2,120
China,2007-04-01,30,0,-2,31,8,67
China,2007-04-01,35,0,1,11,9,56
China,2007-04-01,42,0,1,18,3,64
China,2007-04-01,70,0,-6,15,5,84
China,2007-04-01,66,0,0,23,3,92
China,2007-04-01,99,0,-3,71,22,189
China,2007-04-01,42,0,-6,33,6,75
China,2007-04-01,19,0,-1,18,0,36
China,2007-04-01,57,0,0,6,1,64
China,2007-04-01,7,2,0,31,7,47
China,2007-04-01,104,2,0,28,14,148
China,2007-04-01,51,0,-6,49,4,98
China,2007-04-01,51,0,-7,78,6,128
China,2007-04-01,54,0,-1,20,6,79
China,2007-04-01,49,0,0,25,6,80
China,2007-04-01,36,0,0,1,4,41
China,2007-04-01,29,0,-4,-3,4,26
China,2007-04-01,93,0,-1,18,17,127
China,2007-04-01,156,0,1,25,9,191
China,2007-04-01,54,0,2,15,15,86
China,2007-04-01,87,4,-1,24,3,117
China,2007-04-01,42,0,1,8,6,57
China,2007-04-01,55,0,1,-20,11,47
China,2007-04-01,95,0,-1,13,13,120
Egypt,2007-04-01,9,0,0,0,0,9
Egypt,2007-04-01,20,0,0,3,1,24
Egypt,2007-04-01,6,0,0,36,0,42
Egypt,2007-04-01,9,0,0,6,0,15
Egypt,2007-04-01,4,0,0,0,3,7
Egypt,2007-04-01,17,0,0,-23,0,-6
Egypt,2007-04-01,46,0,0,-9,0,37
Egypt,2007-04-01,15,0,0,5,6,26
Egypt,2007-04-01,20,0,0,-11,1,10
Egypt,2007-04-01,17,0,-1,8,0,24
Egypt,2007-04-01,9,0,0,19,2,30
Egypt,2007-04-01,27,0,0,12,0,39
Egypt,2007-04-01,9,0,0,6,0,15
Egypt,2007-04-01,9,0,0,-9,0,0
Egypt,2007-04-01,27,0,0,6,0,33
Egypt,2007-04-01,25,2,0,4,1,32
Egypt,2007-04-01,7,0,0,42,2,51
Egypt,2007-04-01,5,0,-1,13,0,17
Egypt,2007-04-01,11,0,0,17,0,28
Egypt,2007-04-01,19,0,0,0,0,19
Egypt,2007-04-01,21,0,0,21,4,46
Egypt,2007-04-01,27,0,0,3,6,36
Egypt,2007-04-01,15,0,-2,3,0,16
Egypt,2007-04-01,32,0,1,6,3,42
Egypt,2007-04-01,50,0,0,3,0,53
Egypt,2007-04-01,50,0,0,17,6,73
Egypt,2007-04-01,34,0,0,14,5,53
Egypt,2007-04-01,1,0,0,0,0,1
Egypt,2007-04-01,7,0,0,11,1,19
Egypt,2007-04-01,48,0,0,6,0,54
Eritrea,2007-04-01,6,0,0,-2,0,4
Eritrea,2007-04-01,-15,0,0,0,0,-15
Eritrea,2007-04-01,-12,0,0,0,0,-12
Eritrea,2007-04-01,4,0,0,-5,0,-1
Eritrea,2007-04-01,9,0,0,8,1,18
Eritrea,2007-04-01,3,0,0,0,0,3
Eritrea,2007-04-01,9,0,0,-2,0,7
Eritrea,2007-04-01,3,0,0,0,0,3
Eritrea,2007-04-01,0,0,0,6,0,6
Eritrea,2007-04-01,-17,0,0,3,2,-12
Eritrea,2007-04-01,2,0,0,0,0,2
Eritrea,2007-04-01,14,0,0,6,0,20
Eritrea,2007-04-01,6,0,0,-2,0,4
Eritrea,2007-04-01,2,0,0,0,0,2
Eritrea,2007-04-01,3,0,0,0,0,3
Eritrea,2007-04-01,10,0,0,-2,0,8
Eritrea,2007-04-01,-3,0,0,0,0,-3
Eritrea,2007-04-01,33,0,0,3,0,36
Eritrea,2007-04-01,0,0,0,0,0,0
Eritrea,2007-04-01,2,0,0,0,0,2
Eritrea,2007-04-01,3,0,0,0,0,3
Eritrea,2007-04-01,34,0,0,-7,0,27
Eritrea,2007-04-01,24,0,-3,-6,0,15
Eritrea,2007-04-01,15,0,0,5,2,22
Eritrea,2007-04-01,58,0,0,6,22,86
Eritrea,2007-04-01,13,0,0,3,0,16
Eritrea,2007-04-01,4,0,0,3,0,7
Eritrea,2007-04-01,16,0,0,0,2,18
Eritrea,2007-04-01,6,0,0,0,0,6
Eritrea,2007-04-01,4,0,0,0,0,4
Georgia,2007-04-01,5,0,0,-4,2,3
Georgia,2007-04-01,-1,0,0,3,0,2
Georgia,2007-04-01,22,0,0,1,4,27
Georgia,2007-04-01,21,0,3,12,2,38
Georgia,2007-04-01,1,0,-1,-1,0,-1
Georgia,2007-04-01,4,0,0,6,0,10
Georgia,2007-04-01,0,0,0,0,0,0
Georgia,2007-04-01,4,0,0,0,0,4
Georgia,2007-04-01,0,0,0,6,0,6
Georgia,2007-04-01,2,0,0,3,0,5
Georgia,2007-04-01,4,0,0,3,0,7
Georgia,2007-04-01,2,0,0,0,1,3
Georgia,2007-04-01,6,0,0,-2,0,4
Georgia,2007-04-01,0,0,0,0,2,2
Georgia,2007-04-01,5,0,0,3,0,8
Georgia,2007-04-01,1,0,0,0,2,3
Georgia,2007-04-01,9,0,0,-1,0,8
Georgia,2007-04-01,19,0,0,1,6,26
Georgia,2007-04-01,26,0,0,3,3,32
Georgia,2007-04-01,3,0,0,0,0,3
Georgia,2007-04-01,13,0,0,0,0,13
Georgia,2007-04-01,-3,0,0,0,0,-3
Georgia,2007-04-01,2,0,0,0,1,3
Georgia,2007-04-01,6,0,0,0,0,6
Georgia,2007-04-01,3,0,0,2,1,6
Georgia,2007-04-01,2,0,0,0,1,3
Georgia,2007-04-01,4,0,0,2,0,6
Georgia,2007-04-01,1,0,0,0,0,1
Georgia,2007-04-01,13,0,0,3,0,16
Georgia,2007-04-01,6,0,0,-2,0,4
India,2007-04-01,20,0,-2,13,3,34
India,2007-04-01,30,0,0,6,2,38
India,2007-04-01,18,0,0,12,3,33
India,2007-04-01,36,0,-3,15,13,61
India,2007-04-01,4,0,1,5,2,12
India,2007-04-01,19,0,0,13,3,35
India,2007-04-01,18,0,0,9,2,29
India,2007-04-01,22,0,-2,-1,1,20
India,2007-04-01,14,0,-1,2,4,19
India,2007-04-01,7,0,1,-8,0,0
India,2007-04-01,14,0,0,15,10,39
India,2007-04-01,34,0,0,13,11,58
India,2007-04-01,9,0,-3,3,1,10
India,2007-04-01,4,0,0,6,0,10
India,2007-04-01,2,0,-4,6,0,4
India,2007-04-01,41,0,-4,3,4,44
India,2007-04-01,33,0,0,9,3,45
India,2007-04-01,23,0,1,7,6,37
India,2007-04-01,28,0,-2,11,6,43
India,2007-04-01,50,0,0,2,1,53
India,2007-04-01,39,0,0,9,0,48
India,2007-04-01,35,0,-3,-2,1,31
India,2007-04-01,25,0,-1,8,5,37
India,2007-04-01,38,0,0,39,0,77
India,2007-04-01,42,2,0,10,0,54
India,2007-04-01,16,0,1,13,4,34
India,2007-04-01,13,0,2,12,1,28
India,2007-04-01,21,0,-4,1,6,24
India,2007-04-01,8,0,0,-3,1,6
India,2007-04-01,32,0,-1,9,6,46
Iran,2007-04-01,26,0,2,49,8,85
Iran,2007-04-01,96,2,0,44,8,150
Iran,2007-04-01,138,2,5,52,9,206
Iran,2007-04-01,154,0,1,46,4,205
Iran,2007-04-01,107,2,-1,24,14,146
Iran,2007-04-01,93,0,-3,-25,11,76
Iran,2007-04-01,80,0,0,33,4,117
Iran,2007-04-01,107,0,4,22,8,141
Iran,2007-04-01,107,0,3,61,13,184
Iran,2007-04-01,96,2,-1,22,18,137
Iran,2007-04-01,104,0,-2,54,6,162
Iran,2007-04-01,65,0,0,46,24,135
Iran,2007-04-01,62,0,-2,-1,3,62
Iran,2007-04-01,91,0,0,-18,5,78
Iran,2007-04-01,66,0,1,17,36,120
Iran,2007-04-01,52,1,1,48,15,117
Iran,2007-04-01,70,0,0,51,1,122
Iran,2007-04-01,88,6,0,40,5,139
Iran,2007-04-01,112,0,5,3,10,130
Iran,2007-04-01,34,0,0,7,3,44
Iran,2007-04-01,30,0,0,8,0,38
Iran,2007-04-01,36,0,0,3,1,40
Iran,2007-04-01,71,2,-9,37,91,192
Iran,2007-04-01,66,0,-2,26,96,186
Iran,2007-04-01,25,4,0,14,11,54
Iran,2007-04-01,44,0,0,18,4,66
Iran,2007-04-01,56,0,1,29,7,93
Iran,2007-04-01,20,0,0,12,5,37
Iran,2007-04-01,51,0,0,29,10,90
Iran,2007-04-01,69,0,0,21,3,93
Iraq,2007-04-01,90,0,-13,50,6,133
Iraq,2007-04-01,124,0,-5,123,31,273
Iraq,2007-04-01,150,0,0,33,10,193
Iraq,2007-04-01,106,0,2,30,4,142
Iraq,2007-04-01,165,4,5,13,11,198
Iraq,2007-04-01,226,0,1,78,8,313
Iraq,2007-04-01,150,0,-2,11,18,177
Iraq,2007-04-01,145,2,-6,32,22,195
Iraq,2007-04-01,161,2,0,21,14,198
Iraq,2007-04-01,143,0,-1,19,14,175
Iraq,2007-04-01,238,0,-1,42,10,289
Iraq,2007-04-01,429,0,-13,16,54,486
Iraq,2007-04-01,227,0,4,26,33,290
Iraq,2007-04-01,119,0,0,24,10,153
Iraq,2007-04-01,138,0,1,-7,12,144
Iraq,2007-04-01,177,8,-6,18,16,213
Iraq,2007-04-01,159,20,-10,71,28,268
Iraq,2007-04-01,105,0,5,37,12,159
Iraq,2007-04-01,175,2,-4,50,6,229
Iraq,2007-04-01,109,0,2,44,13,168
Iraq,2007-04-01,111,0,0,33,13,157
Iraq,2007-04-01,123,2,2,23,23,173
Iraq,2007-04-01,144,2,-5,53,14,208
Iraq,2007-04-01,114,4,3,50,13,184
Iraq,2007-04-01,160,4,3,69,29,265
Iraq,2007-04-01,161,0,12,70,18,261
Iraq,2007-04-01,156,2,1,72,39,270
Iraq,2007-04-01,193,0,1,30,23,247
Iraq,2007-04-01,92,0,1,20,16,129
Iraq,2007-04-01,240,2,4,124,10,380
Morocco,2007-04-01,-2,0,0,0,2,0
Morocco,2007-04-01,4,0,1,0,0,5
Morocco,2007-04-01,2,0,0,12,1,15
Morocco,2007-04-01,0,0,0,0,0,0
Morocco,2007-04-01,9,0,0,2,0,11
Morocco,2007-04-01,0,0,0,-2,0,-2
Morocco,2007-04-01,0,0,0,-1,0,-1
Morocco,2007-04-01,2,0,0,0,0,2
Morocco,2007-04-01,2,0,0,0,0,2
Morocco,2007-04-01,3,0,0,0,0,3
Morocco,2007-04-01,18,0,0,15,6,39
Morocco,2007-04-01,25,0,0,6,0,31
Morocco,2007-04-01,7,0,0,0,0,7
Morocco,2007-04-01,1,0,0,6,3,10
Morocco,2007-04-01,1,0,0,6,0,7
Morocco,2007-04-01,6,0,0,0,0,6
Morocco,2007-04-01,4,0,0,22,2,28
Morocco,2007-04-01,3,0,0,9,0,12
Morocco,2007-04-01,-3,0,0,0,0,-3
Morocco,2007-04-01,3,0,0,6,0,9
Morocco,2007-04-01,-15,0,0,0,0,-15
Morocco,2007-04-01,0,0,0,3,0,3
Morocco,2007-04-01,16,0,0,9,0,25
Morocco,2007-04-01,1,0,0,0,0,1
Morocco,2007-04-01,0,0,0,0,0,0
Morocco,2007-04-01,0,0,0,0,1,1
Morocco,2007-04-01,3,0,0,0,3,6
Morocco,2007-04-01,0,0,0,0,0,0
Morocco,2007-04-01,0,0,0,0,0,0
Morocco,2007-04-01,7,0,0,3,0,10
Nigeria,2007-04-01,-1,0,0,7,0,6
Nigeria,2007-04-01,12,0,0,-2,4,14
Nigeria,2007-04-01,3,0,0,30,0,33
Nigeria,2007-04-01,8,0,-2,22,0,28
Nigeria,2007-04-01,13,0,0,18,6,37
Nigeria,2007-04-01,3,0,0,0,0,3
Nigeria,2007-04-01,0,0,0,6,0,6
Nigeria,2007-04-01,15,0,0,0,0,15
Nigeria,2007-04-01,21,0,0,1,0,22
Nigeria,2007-04-01,9,0,0,3,2,14
Nigeria,2007-04-01,9,0,-2,3,4,14
Nigeria,2007-04-01,14,0,0,20,0,34
Nigeria,2007-04-01,4,0,-2,12,0,14
Nigeria,2007-04-01,18,0,-2,9,6,31
Nigeria,2007-04-01,1,0,0,6,0,7
Nigeria,2007-04-01,50,0,0,27,2,79
Nigeria,2007-04-01,24,0,-2,3,3,28
Nigeria,2007-04-01,33,0,2,6,0,41
Nigeria,2007-04-01,0,0,1,0,2,3
Nigeria,2007-04-01,8,2,-4,5,0,11
Nigeria,2007-04-01,16,0,-2,0,1,15
Nigeria,2007-04-01,16,0,-9,7,1,15
Nigeria,2007-04-01,83,0,0,-10,4,77
Nigeria,2007-04-01,57,0,0,46,2,105
Nigeria,2007-04-01,18,0,8,21,2,49
Nigeria,2007-04-01,11,0,-4,34,2,43
Nigeria,2007-04-01,16,0,-1,4,1,20
Nigeria,2007-04-01,15,0,0,0,6,21
Nigeria,2007-04-01,1,0,0,3,6,10
Nigeria,2007-04-01,4,0,0,6,4,14
Pakistan,2007-04-01,53,0,0,13,2,68
Pakistan,2007-04-01,24,2,1,6,4,37
Pakistan,2007-04-01,74,0,0,26,11,111
Pakistan,2007-04-01,45,0,0,-8,0,37
Pakistan,2007-04-01,60,0,0,27,9,96
Pakistan,2007-04-01,44,2,0,23,1,70
Pakistan,2007-04-01,10,0,0,12,0,22
Pakistan,2007-04-01,3,0,0,6,1,10
Pakistan,2007-04-01,15,0,0,0,1,16
Pakistan,2007-04-01,37,0,0,-6,4,35
Pakistan,2007-04-01,2,0,0,7,0,9
Pakistan,2007-04-01,28,0,0,6,3,37
Pakistan,2007-04-01,20,2,0,0,3,25
Pakistan,2007-04-01,12,0,-2,-5,3,8
Pakistan,2007-04-01,30,0,0,32,0,62
Pakistan,2007-04-01,54,0,0,9,10,73
Pakistan,2007-04-01,57,0,0,13,0,70
Pakistan,2007-04-01,20,0,0,17,4,41
Pakistan,2007-04-01,60,0,0,15,5,80
Pakistan,2007-04-01,14,0,0,3,1,18
Pakistan,2007-04-01,35,0,0,16,3,54
Pakistan,2007-04-01,39,0,0,18,2,59
Pakistan,2007-04-01,23,0,0,0,5,28
Pakistan,2007-04-01,97,0,0,6,1,104
Pakistan,2007-04-01,63,0,0,18,3,84
Pakistan,2007-04-01,56,0,0,19,0,75
Pakistan,2007-04-01,56,0,-4,6,10,68
Pakistan,2007-04-01,65,0,0,9,2,76
Pakistan,2007-04-01,42,0,-1,1,15,57
Pakistan,2007-04-01,108,0,-2,85,8,199
Sierra Leone,2007-04-01,4,0,0,0,0,4
Sierra Leone,2007-04-01,0,0,0,0,0,0
Sierra Leone,2007-04-01,0,0,0,6,0,6
Sierra Leone,2007-04-01,3,0,0,3,2,8
Sierra Leone,2007-04-01,0,0,0,0,0,0
Sierra Leone,2007-04-01,-1,0,0,0,0,-1
Sierra Leone,2007-04-01,0,0,0,0,0,0
Sierra Leone,2007-04-01,0,0,0,0,0,0
Sierra Leone,2007-04-01,2,0,0,0,0,2
Sierra Leone,2007-04-01,2,0,0,6,0,8
Sierra Leone,2007-04-01,0,0,0,0,0,0
Sierra Leone,2007-04-01,1,0,0,0,0,1
Sierra Leone,2007-04-01,3,0,0,0,0,3
Sierra Leone,2007-04-01,3,0,0,0,0,3
Sierra Leone,2007-04-01,0,0,0,0,0,0
Sierra Leone,2007-04-01,1,0,0,0,0,1
Sierra Leone,2007-04-01,0,0,0,0,0,0
Sierra Leone,2007-04-01,2,0,0,0,7,9
Sierra Leone,2007-04-01,0,0,0,3,4,7
Sierra Leone,2007-04-01,2,0,0,0,0,2
Sierra Leone,2007-04-01,0,0,0,9,0,9
Sierra Leone,2007-04-01,1,0,0,3,0,4
Sierra Leone,2007-04-01,-4,0,0,9,0,5
Sierra Leone,2007-04-01,0,0,0,6,0,6
Sierra Leone,2007-04-01,0,0,0,0,0,0
Sierra Leone,2007-04-01,0,0,0,0,0,0
Sierra Leone,2007-04-01,-2,0,0,6,4,8
Sierra Leone,2007-04-01,0,0,0,0,0,0
Somalia,2007-04-01,3,0,0,9,0,12
Somalia,2007-04-01,5,0,0,5,0,10
Somalia,2007-04-01,18,0,0,16,0,34
Somalia,2007-04-01,3,0,0,32,0,35
Somalia,2007-04-01,12,0,0,9,0,21
Somalia,2007-04-01,7,0,0,28,0,35
Somalia,2007-04-01,0,0,0,-14,0,-14
Somalia,2007-04-01,4,0,0,15,4,23
Somalia,2007-04-01,18,0,1,-2,2,19
Somalia,2007-04-01,20,0,0,28,0,48
Somalia,2007-04-01,-1,0,0,16,2,17
Somalia,2007-04-01,14,0,0,0,0,14
Somalia,2007-04-01,4,0,0,3,0,7
Somalia,2007-04-01,9,0,0,3,0,12
Somalia,2007-04-01,5,0,0,6,0,11
Somalia,2007-04-01,20,0,0,12,3,35
Somalia,2007-04-01,16,0,0,0,0,16
Somalia,2007-04-01,7,0,0,3,0,10
Somalia,2007-04-01,3,0,0,18,0,21
Somalia,2007-04-01,7,0,0,0,0,7
Somalia,2007-04-01,3,0,0,36,0,39
Somalia,2007-04-01,3,0,0,26,2,31
Somalia,2007-04-01,39,0,0,0,0,39
Somalia,2007-04-01,24,2,0,21,2,49
Somalia,2007-04-01,46,0,0,29,0,75
Somalia,2007-04-01,17,0,0,29,0,46
Somalia,2007-04-01,6,0,0,0,0,6
Somalia,2007-04-01,0,0,0,6,3,9
Somalia,2007-04-01,32,0,0,-26,0,6
Somalia,2007-04-01,2,0,-2,-8,2,-6
Syria,2007-04-01,41,0,-4,9,0,46
Syria,2007-04-01,23,0,0,9,0,32
Syria,2007-04-01,33,0,-4,7,2,38
Syria,2007-04-01,28,0,1,9,0,38
Syria,2007-04-01,10,0,0,-22,0,-12
Syria,2007-04-01,20,0,-4,0,0,16
Syria,2007-04-01,6,0,0,-1,0,5
Syria,2007-04-01,17,0,-14,4,0,7
Syria,2007-04-01,15,0,-4,0,0,11
Syria,2007-04-01,-8,0,0,3,0,-5
Syria,2007-04-01,4,0,0,-2,5,7
Syria,2007-04-01,-2,0,0,3,1,2
Syria,2007-04-01,12,0,0,1,0,13
Syria,2007-04-01,-3,0,0,6,6,9
Syria,2007-04-01,6,0,0,0,0,6
Syria,2007-04-01,13,0,0,0,4,17
Syria,2007-04-01,0,6,0,9,0,15
Syria,2007-04-01,11,6,0,15,6,38
Syria,2007-04-01,21,0,-4,4,12,33
Syria,2007-04-01,23,0,-1,0,3,25
Syria,2007-04-01,8,0,0,0,1,9
Syria,2007-04-01,16,0,0,3,0,19
Syria,2007-04-01,17,0,-2,13,0,28
Syria,2007-04-01,12,0,0,13,1,26
Syria,2007-04-01,26,0,-2,33,6,63
Syria,2007-04-01,26,0,-1,9,4,38
Syria,2007-04-01,31,0,0,15,2,48
Syria,2007-04-01,8,0,0,12,6,26
Syria,2007-04-01,4,0,0,9,0,13
Syria,2007-04-01,9,0,0,0,0,9
Yemen,2007-04-01,13,0,0,1,0,14
Yemen,2007-04-01,2,0,0,6,0,8
Yemen,2007-04-01,0,0,0,6,0,6
Yemen,2007-04-01,12,0,0,3,6,21
Yemen,2007-04-01,2,0,0,6,0,8
Yemen,2007-04-01,4,0,0,0,0,4
Yemen,2007-04-01,8,0,0,0,4,12
Yemen,2007-04-01,9,0,0,0,2,11
Yemen,2007-04-01,4,0,2,21,4,31
Yemen,2007-04-01,19,0,2,21,1,43
Yemen,2007-04-01,12,0,0,0,0,12
Yemen,2007-04-01,10,0,0,0,0,10
Yemen,2007-04-01,3,0,0,0,0,3
Yemen,2007-04-01,3,0,0,0,3,6
Yemen,2007-04-01,4,0,0,13,0,17
Yemen,2007-04-01,1,0,0,6,2,9
Yemen,2007-04-01,0,0,0,0,1,1
Yemen,2007-04-01,0,0,0,0,0,0
Yemen,2007-04-01,0,0,0,0,0,0
Yemen,2007-04-01,0,0,0,0,0,0
Yemen,2007-04-01,3,0,0,3,0,6
Yemen,2007-04-01,0,0,0,0,0,0
Yemen,2007-04-01,1,0,0,12,0,13
Yemen,2007-04-01,4,0,0,-2,0,2
Yemen,2007-04-01,7,0,0,0,1,8
Yemen,2007-04-01,-1,0,0,0,0,-1
Yemen,2007-04-01,9,0,0,0,1,10
Afghanistan,2007-10-01,46,0,0,18,0,64
Afghanistan,2007-10-01,114,0,0,15,20,149
Afghanistan,2007-10-01,89,2,1,-5,16,103
Afghanistan,2007-10-01,62,0,0,22,10,94
Afghanistan,2007-10-01,60,0,0,7,13,80
Afghanistan,2007-10-01,165,0,0,11,18,194
Afghanistan,2007-10-01,277,0,0,30,14,321
Afghanistan,2007-10-01,240,2,2,9,22,275
Afghanistan,2007-10-01,270,0,1,35,38,344
Afghanistan,2007-10-01,159,0,-4,16,15,186
Afghanistan,2007-10-01,93,0,0,17,5,115
Afghanistan,2007-10-01,170,0,2,14,8,194
Afghanistan,2007-10-01,72,0,0,21,4,97
Afghanistan,2007-10-01,46,0,0,-10,3,39
Afghanistan,2007-10-01,52,2,-2,9,10,71
Afghanistan,2007-10-01,37,0,0,10,5,52
Afghanistan,2007-10-01,141,0,0,8,4,153
Afghanistan,2007-10-01,91,6,0,12,6,115
Afghanistan,2007-10-01,151,4,0,-3,13,165
Afghanistan,2007-10-01,71,0,0,6,7,84
Afghanistan,2007-10-01,115,4,0,4,5,128
Afghanistan,2007-10-01,122,6,0,13,4,145
Afghanistan,2007-10-01,140,6,0,55,7,208
Afghanistan,2007-10-01,178,2,0,56,9,245
Afghanistan,2007-10-01,140,0,1,119,16,276
Afghanistan,2007-10-01,77,2,0,18,3,100
Afghanistan,2007-10-01,146,2,0,61,8,217
Afghanistan,2007-10-01,117,6,0,27,4,154
Afghanistan,2007-10-01,41,2,0,33,20,96
Afghanistan,2007-10-01,80,0,-3,24,2,103
Afghanistan,2007-10-01,180,0,-1,15,11,205
Albania,2007-10-01,0,0,1,0,0,1
Albania,2007-10-01,28,0,0,9,1,38
Albania,2007-10-01,8,0,0,-1,0,7
Albania,2007-10-01,24,0,-2,12,1,35
Albania,2007-10-01,12,0,-1,0,0,11
Albania,2007-10-01,10,0,0,0,0,10
Albania,2007-10-01,12,0,0,0,1,13
Albania,2007-10-01,6,0,0,6,0,12
Albania,2007-10-01,6,0,0,5,4,15
Albania,2007-10-01,10,0,-1,1,4,14
Albania,2007-10-01,3,0,-2,0,2,3
Albania,2007-10-01,13,0,-5,0,0,8
Albania,2007-10-01,6,0,0,0,0,6
Albania,2007-10-01,37,0,-4,-2,1,32
Albania,2007-10-01,65,0,-3,2,0,64
Albania,2007-10-01,44,0,0,13,15,72
Albania,2007-10-01,16,0,-4,18,6,36
Albania,2007-10-01,19,0,-1,0,0,18
Albania,2007-10-01,22,0,-2,36,5,61
Albania,2007-10-01,17,0,0,0,1,18
Albania,2007-10-01,2,0,-3,0,0,-1
Albania,2007-10-01,10,0,-9,3,0,4
Albania,2007-10-01,6,0,-2,0,0,4
Albania,2007-10-01,14,0,-2,6,2,20
Albania,2007-10-01,6,0,-1,3,0,8
Albania,2007-10-01,4,0,0,0,0,4
Albania,2007-10-01,2,0,0,0,0,2
Albania,2007-10-01,3,0,0,12,0,15
Albania,2007-10-01,6,0,0,3,1,10
Albania,2007-10-01,1,0,0,9,0,10
Albania,2007-10-01,1,0,0,5,0,6
Algeria,2007-10-01,0,0,0,0,0,0
Algeria,2007-10-01,5,0,0,6,0,11
Algeria,2007-10-01,27,0,0,3,0,30
Algeria,2007-10-01,0,0,0,6,0,6
Algeria,2007-10-01,3,0,0,0,0,3
Algeria,2007-10-01,7,0,0,0,1,8
Algeria,2007-10-01,13,0,-6,6,5,18
Algeria,2007-10-01,-2,0,0,9,0,7
Algeria,2007-10-01,0,0,0,0,0,0
Algeria,2007-10-01,23,0,0,24,0,47
Algeria,2007-10-01,8,0,0,6,0,14
Algeria,2007-10-01,16,0,0,0,0,16
Algeria,2007-10-01,4,0,0,0,0,4
Algeria,2007-10-01,10,0,0,3,0,13
Algeria,2007-10-01,0,0,0,18,1,19
Algeria,2007-10-01,4,0,0,6,0,10
Algeria,2007-10-01,3,0,0,7,0,10
Algeria,2007-10-01,3,0,0,3,0,6
Algeria,2007-10-01,0,0,0,0,3,3
Algeria,2007-10-01,0,0,0,0,0,0
Algeria,2007-10-01,0,0,0,-2,0,-2
Algeria,2007-10-01,1,0,0,0,0,1
Algeria,2007-10-01,8,0,0,26,0,34
Algeria,2007-10-01,0,0,0,0,0,0
Algeria,2007-10-01,0,0,0,3,0,3
Algeria,2007-10-01,1,0,0,15,0,16
Algeria,2007-10-01,6,0,0,6,0,12
Algeria,2007-10-01,-1,0,1,27,0,27
Algeria,2007-10-01,0,0,0,0,0,0
Algeria,2007-10-01,3,0,0,12,0,15
Bangladesh,2007-10-01,4,0,0,30,0,34
Bangladesh,2007-10-01,4,0,0,12,4,20
Bangladesh,2007-10-01,12,0,0,1,0,13
Bangladesh,2007-10-01,-4,0,0,17,6,19
Bangladesh,2007-10-01,9,0,0,6,1,16
Bangladesh,2007-10-01,7,0,0,-1,0,6
Bangladesh,2007-10-01,11,0,-2,11,1,21
Bangladesh,2007-10-01,0,0,-1,57,0,56
Bangladesh,2007-10-01,9,0,1,14,1,25
Bangladesh,2007-10-01,10,0,0,0,0,10
Bangladesh,2007-10-01,11,0,0,6,0,17
Bangladesh,2007-10-01,12,0,0,12,0,24
Bangladesh,2007-10-01,1,0,0,0,1,2
Bangladesh,2007-10-01,0,0,0,0,3,3
Bangladesh,2007-10-01,13,2,0,0,0,15
Bangladesh,2007-10-01,0,0,0,6,0,6
Bangladesh,2007-10-01,17,2,0,0,2,21
Bangladesh,2007-10-01,7,0,0,6,6,19
Bangladesh,2007-10-01,12,0,0,4,0,16
Bangladesh,2007-10-01,4,0,0,3,0,7
Bangladesh,2007-10-01,4,0,0,-1,0,3
Bangladesh,2007-10-01,1,0,-2,9,0,8
Bangladesh,2007-10-01,-3,0,0,9,0,6
Bangladesh,2007-10-01,1,0,0,-1,1,1
Bangladesh,2007-10-01,0,0,0,-2,0,-2
Bangladesh,2007-10-01,6,0,0,18,18,42
Bangladesh,2007-10-01,3,0,0,0,0,3
Bangladesh,2007-10-01,1,0,0,3,6,10
Bangladesh,2007-10-01,11,0,0,24,4,39
Bangladesh,2007-10-01,8,0,0,66,4,78
Bangladesh,2007-10-01,16,0,0,3,0,19
Cameroon,2007-10-01,1,0,0,6,0,7
Cameroon,2007-10-01,6,0,0,3,1,10
Cameroon,2007-10-01,6,0,0,0,0,6
Cameroon,2007-10-01,8,0,0,16,4,28
Cameroon,2007-10-01,0,0,0,0,0,0
Cameroon,2007-10-01,0,0,0,0,0,0
Cameroon,2007-10-01,0,0,0,0,0,0
Cameroon,2007-10-01,4,0,0,0,0,4
Cameroon,2007-10-01,0,0,0,3,2,5
Cameroon,2007-10-01,0,0,0,0,0,0
Cameroon,2007-10-01,0,0,0,6,0,6
Cameroon,2007-10-01,0,0,0,0,0,0
Cameroon,2007-10-01,0,0,0,3,0,3
Cameroon,2007-10-01,0,0,0,0,0,0
Cameroon,2007-10-01,0,0,0,0,0,0
Cameroon,2007-10-01,3,0,0,0,2,5
Cameroon,2007-10-01,3,0,0,0,0,3
Cameroon,2007-10-01,0,0,0,0,1,1
Cameroon,2007-10-01,0,0,0,0,0,0
Cameroon,2007-10-01,0,0,0,0,0,0
Cameroon,2007-10-01,0,0,0,0,0,0
Cameroon,2007-10-01,0,0,0,0,0,0
Cameroon,2007-10-01,2,0,0,0,0,2
Cameroon,2007-10-01,2,0,0,0,0,2
Cameroon,2007-10-01,0,0,0,0,0,0
China,2007-10-01,25,0,0,10,3,38
China,2007-10-01,130,2,-10,15,28,165
China,2007-10-01,86,0,2,52,8,148
China,2007-10-01,97,0,1,16,18,132
China,2007-10-01,92,0,1,22,6,121
China,2007-10-01,81,0,-1,9,6,95
China,2007-10-01,59,0,0,-4,3,58
China,2007-10-01,86,0,0,5,15,106
China,2007-10-01,46,0,0,5,12,63
China,2007-10-01,74,0,0,48,1,123
China,2007-10-01,60,2,-8,26,3,83
China,2007-10-01,84,2,-1,9,8,102
China,2007-10-01,17,0,0,21,1,39
China,2007-10-01,37,0,-4,19,4,56
China,2007-10-01,39,0,2,33,14,88
China,2007-10-01,15,8,0,10,1,34
China,2007-10-01,66,2,2,23,9,102
China,2007-10-01,71,0,-3,35,10,113
China,2007-10-01,97,0,-5,3,14,109
China,2007-10-01,36,0,0,3,7,46
China,2007-10-01,49,0,-1,13,9,70
China,2007-10-01,52,8,-4,33,14,103
China,2007-10-01,72,0,-1,14,5,90
China,2007-10-01,99,0,-1,27,7,132
China,2007-10-01,11,0,-6,6,0,11
China,2007-10-01,21,4,0,1,0,26
China,2007-10-01,26,0,1,16,15,58
China,2007-10-01,33,0,-5,16,3,47
China,2007-10-01,48,0,7,18,30,103
China,2007-10-01,44,0,3,34,10,91
China,2007-10-01,86,4,-1,16,4,109
Egypt,2007-10-01,0,0,0,3,0,3
Egypt,2007-10-01,3,0,0,24,2,29
Egypt,2007-10-01,32,0,4,10,5,51
Egypt,2007-10-01,17,0,0,6,0,23
Egypt,2007-10-01,5,0,0,4,2,11
Egypt,2007-10-01,11,0,0,24,4,39
Egypt,2007-10-01,19,0,0,15,0,34
Egypt,2007-10-01,39,0,0,18,1,58
Egypt,2007-10-01,7,0,0,11,2,20
Egypt,2007-10-01,11,0,0,57,0,68
Egypt,2007-10-01,37,0,0,18,2,57
Egypt,2007-10-01,19,0,0,-7,2,14
Egypt,2007-10-01,-4,0,0,0,2,-2
Egypt,2007-10-01,18,0,0,-2,2,18
Egypt,2007-10-01,39,0,0,18,1,58
Egypt,2007-10-01,10,0,0,24,0,34
Egypt,2007-10-01,9,0,0,22,2,33
Egypt,2007-10-01,83,0,0,31,2,116
Egypt,2007-10-01,64,0,0,9,0,73
Egypt,2007-10-01,20,0,-8,6,2,20
Egypt,2007-10-01,10,0,0,-1,0,9
Egypt,2007-10-01,29,0,0,6,2,37
Egypt,2007-10-01,25,0,0,-11,2,16
Egypt,2007-10-01,16,0,0,-10,4,10
Egypt,2007-10-01,-1,0,1,3,0,3
Egypt,2007-10-01,11,0,0,6,0,17
Egypt,2007-10-01,5,0,0,6,2,13
Egypt,2007-10-01,0,0,-2,3,2,3
Egypt,2007-10-01,6,0,0,18,1,25
Egypt,2007-10-01,21,0,1,19,2,43
Egypt,2007-10-01,2,0,0,79,11,92
Eritrea,2007-10-01,-2,0,0,0,0,-2
Eritrea,2007-10-01,9,0,0,3,0,12
Eritrea,2007-10-01,12,0,0,0,0,12
Eritrea,2007-10-01,3,0,0,0,0,3
Eritrea,2007-10-01,0,0,0,0,0,0
Eritrea,2007-10-01,0,0,0,0,0,0
Eritrea,2007-10-01,2,0,0,0,0,2
Eritrea,2007-10-01,0,0,0,0,0,0
Eritrea,2007-10-01,4,0,0,7,0,11
Eritrea,2007-10-01,3,6,0,-4,1,6
Eritrea,2007-10-01,16,0,0,0,0,16
Eritrea,2007-10-01,23,0,0,0,0,23
Eritrea,2007-10-01,5,0,0,6,0,11
Eritrea,2007-10-01,0,0,0,0,0,0
Eritrea,2007-10-01,7,0,0,4,4,15
Eritrea,2007-10-01,6,0,0,0,0,6
Eritrea,2007-10-01,22,0,0,3,0,25
Eritrea,2007-10-01,13,0,0,0,0,13
Eritrea,2007-10-01,6,0,0,0,0,6
Eritrea,2007-10-01,0,0,0,0,0,0
Eritrea,2007-10-01,2,0,0,0,0,2
Eritrea,2007-10-01,0,0,0,0,0,0
Eritrea,2007-10-01,2,0,0,0,0,2
Eritrea,2007-10-01,8,0,0,5,0,13
Eritrea,2007-10-01,-3,0,0,0,0,-3
Eritrea,2007-10-01,0,0,0,0,0,0
Eritrea,2007-10-01,1,0,0,-4,0,-3
Eritrea,2007-10-01,-4,0,0,0,0,-4
Georgia,2007-10-01,7,0,0,0,0,7
Georgia,2007-10-01,4,0,0,9,2,15
Georgia,2007-10-01,4,0,0,12,0,16
Georgia,2007-10-01,-2,0,1,6,0,5
Georgia,2007-10-01,0,0,0,3,0,3
Georgia,2007-10-01,1,0,0,0,0,1
Georgia,2007-10-01,0,0,0,0,0,0
Georgia,2007-10-01,4,0,0,-3,3,4
Georgia,2007-10-01,5,0,0,12,1,18
Georgia,2007-10-01,0,0,0,4,0,4
Georgia,2007-10-01,10,0,0,-4,0,6
Georgia,2007-10-01,8,0,0,-2,0,6
Georgia,2007-10-01,9,0,0,0,1,10
Georgia,2007-10-01,0,0,0,6,0,6
Georgia,2007-10-01,1,0,-2,3,2,4
Georgia,2007-10-01,3,0,0,6,2,11
Georgia,2007-10-01,22,0,0,12,4,38
Georgia,2007-10-01,28,0,0,1,0,29
Georgia,2007-10-01,11,0,0,3,2,16
Georgia,2007-10-01,6,0,0,18,0,24
Georgia,2007-10-01,8,2,0,9,6,25
Georgia,2007-10-01,3,4,1,9,0,17
Georgia,2007-10-01,14,0,1,7,1,23
Georgia,2007-10-01,25,0,0,0,7,32
Georgia,2007-10-01,0,0,0,3,1,4
Georgia,2007-10-01,4,0,0,0,0,4
Georgia,2007-10-01,0,0,1,17,1,19
Georgia,2007-10-01,2,0,0,1,0,3
Georgia,2007-10-01,8,0,0,3,0,11
Georgia,2007-10-01,7,0,0,3,1,11
Georgia,2007-10-01,7,0,0,3,2,12
India,2007-10-01,0,0,1,-2,0,-1
India,2007-10-01,50,0,1,27,13,91
India,2007-10-01,40,8,0,9,4,61
India,2007-10-01,49,0,-4,-1,7,51
India,2007-10-01,30,0,0,4,-4,30
India,2007-10-01,11,0,0,-2,1,10
India,2007-10-01,16,0,0,1,0,17
India,2007-10-01,52,4,1,4,3,64
India,2007-10-01,21,0,-4,1,0,18
India,2007-10-01,5,0,-1,1,2,7
India,2007-10-01,29,0,-2,6,3,36
India,2007-10-01,22,0,0,2,4,28
India,2007-10-01,16,0,0,10,1,27
India,2007-10-01,19,2,0,0,0,21
India,2007-10-01,17,0,0,0,0,17
India,2007-10-01,6,0,0,0,2,8
India,2007-10-01,35,0,-1,7,4,45
India,2007-10-01,29,0,-3,25,4,55
India,2007-10-01,61,0,-2,27,6,92
India,2007-10-01,38,0,0,10,6,54
India,2007-10-01,8,0,0,-5,1,4
India,2007-10-01,38,0,0,4,11,53
India,2007-10-01,19,0,0,9,4,32
India,2007-10-01,25,0,-1,10,6,40
India,2007-10-01,6,0,0,0,1,7
India,2007-10-01,6,0,0,-1,0,5
India,2007-10-01,32,0,-4,6,10,44
India,2007-10-01,33,0,0,0,4,37
India,2007-10-01,43,0,0,16,0,59
India,2007-10-01,45,0,-3,27,12,81
India,2007-10-01,31,0,-4,-5,7,29
Iran,2007-10-01,20,0,0,12,2,34
Iran,2007-10-01,106,2,3,46,12,169
Iran,2007-10-01,61,2,0,0,4,67
Iran,2007-10-01,61,0,-3,4,5,67
Iran,2007-10-01,95,0,0,9,13,117
Iran,2007-10-01,52,0,0,4,6,62
Iran,2007-10-01,63,0,0,33,6,102
Iran,2007-10-01,56,0,1,19,14,90
Iran,2007-10-01,51,0,0,26,1,78
Iran,2007-10-01,28,2,8,21,11,70
Iran,2007-10-01,73,0,4,43,3,123
Iran,2007-10-01,83,0,3,40,2,128
Iran,2007-10-01,69,0,1,9,6,85
Iran,2007-10-01,27,0,0,-4,8,31
Iran,2007-10-01,49,4,1,22,9,85
Iran,2007-10-01,18,0,-2,-4,0,12
Iran,2007-10-01,78,0,-2,15,4,95
Iran,2007-10-01,53,0,2,61,4,120
Iran,2007-10-01,45,0,1,27,3,76
Iran,2007-10-01,54,0,-12,9,3,54
Iran,2007-10-01,81,0,-2,15,9,103
Iran,2007-10-01,95,0,-4,39,2,132
Iran,2007-10-01,130,2,0,25,7,164
Iran,2007-10-01,72,0,-16,-1,4,59
Iran,2007-10-01,17,0,1,6,0,24
Iran,2007-10-01,103,0,0,0,6,109
Iran,2007-10-01,88,0,1,-2,10,97
Iran,2007-10-01,69,0,0,12,7,88
Iran,2007-10-01,25,4,0,9,11,49
Iran,2007-10-01,29,0,-7,25,9,56
Iran,2007-10-01,85,0,0,19,15,119
Iraq,2007-10-01,9,0,0,7,18,34
Iraq,2007-10-01,363,12,-7,50,29,447
Iraq,2007-10-01,173,0,6,25,5,209
Iraq,2007-10-01,265,0,4,63,19,351
Iraq,2007-10-01,113,0,0,10,3,126
Iraq,2007-10-01,96,2,-2,18,7,121
Iraq,2007-10-01,48,0,-1,28,15,90
Iraq,2007-10-01,212,0,2,27,12,253
Iraq,2007-10-01,281,0,1,64,20,366
Iraq,2007-10-01,231,0,-10,49,12,282
Iraq,2007-10-01,281,0,-3,14,9,301
Iraq,2007-10-01,163,0,5,21,13,202
Iraq,2007-10-01,101,0,2,17,12,132
Iraq,2007-10-01,168,2,0,23,5,198
Iraq,2007-10-01,188,0,-1,37,3,227
Iraq,2007-10-01,110,0,-1,-29,1,81
Iraq,2007-10-01,406,2,1,49,19,477
Iraq,2007-10-01,181,4,3,47,17,252
Iraq,2007-10-01,128,6,2,30,9,175
Iraq,2007-10-01,95,0,1,30,9,135
Iraq,2007-10-01,405,0,0,42,26,473
Iraq,2007-10-01,486,6,4,73,29,598
Iraq,2007-10-01,295,6,4,46,19,370
Iraq,2007-10-01,288,8,-7,46,22,357
Iraq,2007-10-01,219,0,-8,55,9,275
Iraq,2007-10-01,110,8,-8,20,5,135
Iraq,2007-10-01,152,0,2,34,25,213
Iraq,2007-10-01,304,0,0,31,42,377
Iraq,2007-10-01,216,0,-6,54,27,291
Iraq,2007-10-01,152,4,2,46,16,220
Iraq,2007-10-01,244,8,3,85,26,366
Morocco,2007-10-01,0,0,0,6,0,6
Morocco,2007-10-01,0,0,0,1,2,3
Morocco,2007-10-01,2,0,0,0,0,2
Morocco,2007-10-01,0,0,0,0,0,0
Morocco,2007-10-01,4,0,0,9,0,13
Morocco,2007-10-01,0,0,0,3,2,5
Morocco,2007-10-01,4,0,0,0,0,4
Morocco,2007-10-01,5,0,0,0,0,5
Morocco,2007-10-01,2,0,0,12,0,14
Morocco,2007-10-01,9,0,0,-2,1,8
Morocco,2007-10-01,9,0,0,6,2,17
Morocco,2007-10-01,0,0,0,-4,0,-4
Morocco,2007-10-01,3,0,0,0,0,3
Morocco,2007-10-01,5,0,0,0,0,5
Morocco,2007-10-01,28,0,0,18,0,46
Morocco,2007-10-01,12,0,2,6,0,20
Morocco,2007-10-01,9,0,0,6,2,17
Morocco,2007-10-01,17,2,0,4,2,25
Morocco,2007-10-01,5,0,0,6,6,17
Morocco,2007-10-01,4,0,0,3,3,10
Morocco,2007-10-01,6,0,0,3,4,13
Morocco,2007-10-01,13,0,0,15,0,28
Morocco,2007-10-01,4,0,0,9,3,16
Morocco,2007-10-01,1,0,0,12,0,13
Morocco,2007-10-01,-2,0,0,3,0,1
Morocco,2007-10-01,1,0,0,6,0,7
Morocco,2007-10-01,0,0,0,0,0,0
Morocco,2007-10-01,2,0,0,0,0,2
Morocco,2007-10-01,6,0,0,24,0,30
Morocco,2007-10-01,2,0,0,-1,0,1
Morocco,2007-10-01,18,0,0,90,1,109
Nigeria,2007-10-01,2,0,0,0,3,5
Nigeria,2007-10-01,63,2,0,19,2,86
Nigeria,2007-10-01,21,0,-6,6,2,23
Nigeria,2007-10-01,26,0,-2,0,3,27
Nigeria,2007-10-01,6,0,2,12,1,21
Nigeria,2007-10-01,3,4,0,0,0,7
Nigeria,2007-10-01,10,0,0,3,0,13
Nigeria,2007-10-01,24,0,0,8,2,34
Nigeria,2007-10-01,6,0,0,-4,1,3
Nigeria,2007-10-01,1,0,0,0,1,2
Nigeria,2007-10-01,5,0,2,12,0,19
Nigeria,2007-10-01,1,0,0,4,0,5
Nigeria,2007-10-01,0,0,0,17,0,17
Nigeria,2007-10-01,0,0,0,0,0,0
Nigeria,2007-10-01,7,0,0,3,-2,8
Nigeria,2007-10-01,20,0,-10,17,0,27
Nigeria,2007-10-01,5,0,-4,-1,1,1
Nigeria,2007-10-01,9,0,0,15,0,24
Nigeria,2007-10-01,0,0,0,16,2,18
Nigeria,2007-10-01,4,2,0,0,2,8
Nigeria,2007-10-01,2,0,0,0,0,2
Nigeria,2007-10-01,15,0,-2,9,0,22
Nigeria,2007-10-01,15,0,0,0,0,15
Nigeria,2007-10-01,7,0,-8,15,0,14
Nigeria,2007-10-01,2,2,-2,6,0,8
Nigeria,2007-10-01,18,0,0,0,0,18
Nigeria,2007-10-01,0,0,0,0,0,0
Nigeria,2007-10-01,3,0,0,0,1,4
Nigeria,2007-10-01,2,0,0,8,0,10
Nigeria,2007-10-01,18,0,0,0,0,18
Nigeria,2007-10-01,0,0,0,6,1,7
Pakistan,2007-10-01,8,0,0,9,0,17
Pakistan,2007-10-01,71,4,-7,12,3,83
Pakistan,2007-10-01,93,0,-4,23,4,116
Pakistan,2007-10-01,58,0,-5,20,2,75
Pakistan,2007-10-01,52,0,-1,28,20,99
Pakistan,2007-10-01,31,0,0,8,6,45
Pakistan,2007-10-01,40,0,-2,0,9,47
Pakistan,2007-10-01,34,0,0,5,3,42
Pakistan,2007-10-01,36,0,0,1,3,40
Pakistan,2007-10-01,19,0,-4,1,1,17
Pakistan,2007-10-01,80,0,0,23,3,106
Pakistan,2007-10-01,31,0,0,24,4,59
Pakistan,2007-10-01,17,0,0,7,9,33
Pakistan,2007-10-01,32,0,0,7,2,41
Pakistan,2007-10-01,36,0,0,12,3,51
Pakistan,2007-10-01,22,0,0,-8,6,20
Pakistan,2007-10-01,20,0,0,15,6,41
Pakistan,2007-10-01,66,0,-8,30,20,108
Pakistan,2007-10-01,74,0,-1,21,13,107
Pakistan,2007-10-01,27,0,0,8,2,37
Pakistan,2007-10-01,35,0,0,-6,6,35
Pakistan,2007-10-01,24,2,0,15,0,41
Pakistan,2007-10-01,33,0,0,9,0,42
Pakistan,2007-10-01,24,0,0,31,3,58
Pakistan,2007-10-01,48,0,0,8,5,61
Pakistan,2007-10-01,21,0,0,21,2,44
Pakistan,2007-10-01,11,0,0,33,5,49
Pakistan,2007-10-01,12,0,0,0,0,12
Pakistan,2007-10-01,38,0,0,5,11,54
Pakistan,2007-10-01,43,0,0,30,15,88
Pakistan,2007-10-01,34,0,0,48,0,82
Sierra Leone,2007-10-01,6,0,0,0,0,6
Sierra Leone,2007-10-01,-1,0,0,0,0,-1
Sierra Leone,2007-10-01,0,0,0,0,0,0
Sierra Leone,2007-10-01,0,0,0,0,0,0
Sierra Leone,2007-10-01,0,0,0,0,0,0
Sierra Leone,2007-10-01,0,0,0,0,0,0
Sierra Leone,2007-10-01,0,0,0,0,0,0
Sierra Leone,2007-10-01,14,0,0,33,0,47
Sierra Leone,2007-10-01,9,0,0,3,0,12
Sierra Leone,2007-10-01,4,0,-6,6,5,9
Sierra Leone,2007-10-01,0,0,0,0,0,0
Sierra Leone,2007-10-01,3,0,0,0,0,3
Sierra Leone,2007-10-01,0,0,0,0,0,0
Sierra Leone,2007-10-01,3,0,0,0,0,3
Sierra Leone,2007-10-01,-2,0,0,3,0,1
Sierra Leone,2007-10-01,6,0,0,15,0,21
Sierra Leone,2007-10-01,0,0,0,-11,0,-11
Sierra Leone,2007-10-01,7,0,1,3,0,11
Sierra Leone,2007-10-01,1,0,0,0,0,1
Sierra Leone,2007-10-01,1,0,0,0,0,1
Sierra Leone,2007-10-01,4,0,0,0,0,4
Sierra Leone,2007-10-01,0,0,0,0,0,0
Sierra Leone,2007-10-01,0,0,0,0,0,0
Sierra Leone,2007-10-01,4,0,0,0,0,4
Sierra Leone,2007-10-01,0,0,0,-2,0,-2
Somalia,2007-10-01,0,0,0,0,0,0
Somalia,2007-10-01,36,0,0,3,0,39
Somalia,2007-10-01,15,0,0,0,0,15
Somalia,2007-10-01,11,0,0,6,4,21
Somalia,2007-10-01,40,0,0,0,0,40
Somalia,2007-10-01,9,0,0,0,0,9
Somalia,2007-10-01,6,0,0,3,2,11
Somalia,2007-10-01,0,0,0,3,0,3
Somalia,2007-10-01,6,0,0,11,4,21
Somalia,2007-10-01,6,0,-8,0,2,0
Somalia,2007-10-01,2,4,1,-6,0,1
Somalia,2007-10-01,0,0,0,0,0,0
Somalia,2007-10-01,1,0,0,-2,0,-1
Somalia,2007-10-01,8,0,-4,18,0,22
Somalia,2007-10-01,3,0,-4,0,0,-1
Somalia,2007-10-01,38,0,0,0,0,38
Somalia,2007-10-01,6,0,0,0,0,6
Somalia,2007-10-01,3,0,-2,-4,0,-3
Somalia,2007-10-01,5,0,-2,0,0,3
Somalia,2007-10-01,11,0,0,0,0,11
Somalia,2007-10-01,15,0,0,12,0,27
Somalia,2007-10-01,9,0,0,-2,0,7
Somalia,2007-10-01,-2,0,0,0,1,-1
Somalia,2007-10-01,0,0,0,0,0,0
Somalia,2007-10-01,3,6,0,0,2,11
Somalia,2007-10-01,0,0,0,0,0,0
Somalia,2007-10-01,15,0,0,0,0,15
Somalia,2007-10-01,20,0,-22,21,1,20
Somalia,2007-10-01,6,2,-2,-2,0,4
Somalia,2007-10-01,46,0,0,2,3,51
Syria,2007-10-01,10,0,0,0,0,10
Syria,2007-10-01,26,0,3,81,2,112
Syria,2007-10-01,33,0,3,19,3,58
Syria,2007-10-01,37,0,0,6,6,49
Syria,2007-10-01,43,0,-2,4,1,46
Syria,2007-10-01,9,0,0,3,0,12
Syria,2007-10-01,7,0,0,18,0,25
Syria,2007-10-01,11,0,0,10,2,23
Syria,2007-10-01,16,0,0,15,1,32
Syria,2007-10-01,8,0,0,12,0,20
Syria,2007-10-01,50,0,0,15,0,65
Syria,2007-10-01,40,0,0,24,0,64
Syria,2007-10-01,25,0,1,5,0,31
Syria,2007-10-01,73,0,3,10,5,91
Syria,2007-10-01,15,0,0,1,4,20
Syria,2007-10-01,34,0,0,36,0,70
Syria,2007-10-01,51,0,0,18,5,74
Syria,2007-10-01,45,6,-2,37,8,94
Syria,2007-10-01,47,0,-2,13,0,58
Syria,2007-10-01,10,0,0,14,6,30
Syria,2007-10-01,21,0,-2,15,7,41
Syria,2007-10-01,35,0,0,24,14,73
Syria,2007-10-01,7,0,0,10,0,17
Syria,2007-10-01,15,0,0,37,1,53
Syria,2007-10-01,11,0,-22,6,0,-5
Syria,2007-10-01,11,0,1,12,0,24
Syria,2007-10-01,3,0,0,18,0,21
Syria,2007-10-01,56,0,0,0,2,58
Syria,2007-10-01,44,0,0,3,2,49
Syria,2007-10-01,14,0,0,6,4,24
Syria,2007-10-01,50,0,0,7,0,57
Yemen,2007-10-01,6,0,0,3,0,9
Yemen,2007-10-01,3,0,0,3,0,6
Yemen,2007-10-01,3,0,0,3,0,6
Yemen,2007-10-01,0,0,0,0,0,0
Yemen,2007-10-01,6,0,0,0,0,6
Yemen,2007-10-01,0,0,0,0,1,1
Yemen,2007-10-01,0,0,0,-2,1,-1
Yemen,2007-10-01,5,0,0,0,2,7
Yemen,2007-10-01,-2,0,0,0,0,-2
Yemen,2007-10-01,-1,0,0,0,0,-1
Yemen,2007-10-01,0,0,0,0,0,0
Yemen,2007-10-01,3,0,0,-3,0,0
Yemen,2007-10-01,0,0,0,0,0,0
Yemen,2007-10-01,4,0,0,0,0,4
Yemen,2007-10-01,0,0,0,0,0,0
Yemen,2007-10-01,12,0,0,0,0,12
Yemen,2007-10-01,0,0,0,6,0,6
Yemen,2007-10-01,0,0,0,0,0,0
Yemen,2007-10-01,0,0,0,0,0,0
Yemen,2007-10-01,5,0,0,0,0,5
Yemen,2007-10-01,2,0,0,0,0,2
Yemen,2007-10-01,0,0,0,0,0,0
Yemen,2007-10-01,-4,0,0,6,0,2
Yemen,2007-10-01,0,0,0,-2,0,-2
Yemen,2007-10-01,0,0,0,0,0,0
Yemen,2007-10-01,0,2,0,-1,1,2
Yemen,2007-10-01,-4,0,0,32,0,28
Yemen,2007-10-01,2,0,0,9,0,11
Afghanistan,2007-11-01,169,6,4,22,9,210
Afghanistan,2007-11-01,101,6,2,13,1,123
Afghanistan,2007-11-01,95,0,0,28,2,125
Afghanistan,2007-11-01,83,4,-2,2,3,90
Afghanistan,2007-11-01,50,0,0,42,1,93
Afghanistan,2007-11-01,171,0,8,60,25,264
Afghanistan,2007-11-01,32,0,-1,2,4,37
Afghanistan,2007-11-01,93,0,0,39,1,133
Afghanistan,2007-11-01,114,0,0,42,19,175
Afghanistan,2007-11-01,123,0,0,7,26,156
Afghanistan,2007-11-01,136,0,0,-2,16,150
Afghanistan,2007-11-01,134,0,0,12,10,156
Afghanistan,2007-11-01,156,0,-5,86,12,249
Afghanistan,2007-11-01,96,4,1,23,2,126
Afghanistan,2007-11-01,81,0,0,12,0,93
Afghanistan,2007-11-01,74,0,0,41,10,125
Afghanistan,2007-11-01,152,0,0,5,26,183
Afghanistan,2007-11-01,98,6,0,15,14,133
Afghanistan,2007-11-01,42,0,0,17,6,65
Afghanistan,2007-11-01,29,0,-1,12,3,43
Afghanistan,2007-11-01,98,0,0,27,0,125
Afghanistan,2007-11-01,81,0,0,18,2,101
Afghanistan,2007-11-01,74,0,0,6,11,91
Afghanistan,2007-11-01,37,0,0,8,1,46
Afghanistan,2007-11-01,63,0,0,-4,4,63
Afghanistan,2007-11-01,78,0,0,-2,2,78
Afghanistan,2007-11-01,35,0,2,0,2,39
Afghanistan,2007-11-01,35,2,0,17,0,54
Afghanistan,2007-11-01,170,0,3,-6,11,178
Afghanistan,2007-11-01,60,0,1,2,10,73
Albania,2007-11-01,25,0,0,9,0,34
Albania,2007-11-01,7,0,0,17,0,24
Albania,2007-11-01,2,0,0,-2,0,0
Albania,2007-11-01,3,0,-3,9,2,11
Albania,2007-11-01,20,0,-4,3,1,20
Albania,2007-11-01,19,0,0,-2,0,17
Albania,2007-11-01,59,0,0,26,2,87
Albania,2007-11-01,62,0,0,12,0,74
Albania,2007-11-01,25,0,-7,0,0,18
Albania,2007-11-01,2,0,-1,0,0,1
Albania,2007-11-01,6,0,0,0,0,6
Albania,2007-11-01,2,0,0,7,2,11
Albania,2007-11-01,18,0,0,2,1,21
Albania,2007-11-01,13,0,-11,-2,6,6
Albania,2007-11-01,14,0,-11,0,12,15
Albania,2007-11-01,4,0,0,6,3,13
Albania,2007-11-01,25,0,-12,0,13,26
Albania,2007-11-01,26,0,-15,4,25,40
Albania,2007-11-01,31,0,-9,6,9,37
Albania,2007-11-01,64,0,-11,0,0,53
Albania,2007-11-01,43,0,-7,9,3,48
Albania,2007-11-01,26,0,-9,6,0,23
Albania,2007-11-01,0,0,-1,0,0,-1
Albania,2007-11-01,8,0,-1,0,0,7
Albania,2007-11-01,1,0,0,0,2,3
Albania,2007-11-01,19,0,-3,0,0,16
Albania,2007-11-01,17,0,-8,6,0,15
Albania,2007-11-01,42,0,-6,0,1,37
Albania,2007-11-01,21,0,-2,1,0,20
Albania,2007-11-01,6,0,-2,7,0,11
Algeria,2007-11-01,8,0,0,6,0,14
Algeria,2007-11-01,3,0,0,6,2,11
Algeria,2007-11-01,2,0,0,42,3,47
Algeria,2007-11-01,0,0,0,9,4,13
Algeria,2007-11-01,46,0,1,3,3,53
Algeria,2007-11-01,88,0,0,15,3,106
Algeria,2007-11-01,0,0,0,-6,2,-4
Algeria,2007-11-01,8,0,0,0,2,10
Algeria,2007-11-01,0,0,0,0,0,0
Algeria,2007-11-01,0,0,0,0,0,0
Algeria,2007-11-01,-3,0,0,9,0,6
Algeria,2007-11-01,-1,0,0,18,0,17
Algeria,2007-11-01,5,0,0,23,0,28
Algeria,2007-11-01,3,0,0,3,2,8
Algeria,2007-11-01,12,0,0,0,0,12
Algeria,2007-11-01,0,0,0,0,4,4
Algeria,2007-11-01,0,0,0,0,0,0
Algeria,2007-11-01,0,0,0,-3,1,-2
Algeria,2007-11-01,4,0,0,7,0,11
Algeria,2007-11-01,1,0,0,3,0,4
Algeria,2007-11-01,0,0,0,6,0,6
Algeria,2007-11-01,0,0,0,0,0,0
Algeria,2007-11-01,0,0,0,0,0,0
Algeria,2007-11-01,4,0,0,0,0,4
Algeria,2007-11-01,6,0,0,16,0,22
Algeria,2007-11-01,5,0,1,13,4,23
Algeria,2007-11-01,0,0,1,6,4,11
Algeria,2007-11-01,6,0,0,6,0,12
Algeria,2007-11-01,7,0,0,12,2,21
Algeria,2007-11-01,21,0,2,39,1,63
Bangladesh,2007-11-01,12,0,1,3,0,16
Bangladesh,2007-11-01,2,0,0,-2,1,1
Bangladesh,2007-11-01,12,0,0,3,0,15
Bangladesh,2007-11-01,5,0,2,9,2,18
Bangladesh,2007-11-01,0,0,0,45,0,45
Bangladesh,2007-11-01,2,0,0,12,0,14
Bangladesh,2007-11-01,0,0,0,0,0,0
Bangladesh,2007-11-01,8,0,0,6,4,18
Bangladesh,2007-11-01,0,0,0,15,0,15
Bangladesh,2007-11-01,2,0,0,0,0,2
Bangladesh,2007-11-01,1,0,1,-3,1,0
Bangladesh,2007-11-01,8,0,0,3,0,11
Bangladesh,2007-11-01,23,0,0,-2,0,21
Bangladesh,2007-11-01,-2,0,0,3,0,1
Bangladesh,2007-11-01,0,0,0,6,0,6
Bangladesh,2007-11-01,26,4,0,3,1,34
Bangladesh,2007-11-01,6,0,0,0,0,6
Bangladesh,2007-11-01,16,4,0,6,2,28
Bangladesh,2007-11-01,15,2,0,1,0,18
Bangladesh,2007-11-01,13,0,0,9,0,22
Bangladesh,2007-11-01,38,0,1,38,17,94
Bangladesh,2007-11-01,28,2,0,-2,10,38
Bangladesh,2007-11-01,23,2,0,20,4,49
Bangladesh,2007-11-01,26,0,0,4,6,36
Bangladesh,2007-11-01,23,0,0,46,3,72
Bangladesh,2007-11-01,31,0,-2,17,7,53
Bangladesh,2007-11-01,18,0,0,-3,12,27
Bangladesh,2007-11-01,14,0,4,12,4,34
Bangladesh,2007-11-01,7,0,3,9,2,21
Bangladesh,2007-11-01,0,0,0,0,1,1
Cameroon,2007-11-01,0,0,0,0,0,0
Cameroon,2007-11-01,0,0,0,0,0,0
Cameroon,2007-11-01,-2,0,0,0,0,-2
Cameroon,2007-11-01,0,0,0,0,0,0
Cameroon,2007-11-01,2,0,0,0,0,2
Cameroon,2007-11-01,0,0,0,6,0,6
Cameroon,2007-11-01,0,0,0,12,0,12
Cameroon,2007-11-01,-1,0,0,0,3,2
Cameroon,2007-11-01,2,0,-2,0,0,0
Cameroon,2007-11-01,0,0,0,0,0,0
Cameroon,2007-11-01,0,0,0,0,0,0
Cameroon,2007-11-01,1,0,0,0,0,1
Cameroon,2007-11-01,2,0,0,0,0,2
Cameroon,2007-11-01,2,0,0,0,0,2
Cameroon,2007-11-01,0,0,0,3,1,4
Cameroon,2007-11-01,3,0,0,0,0,3
Cameroon,2007-11-01,0,0,0,0,0,0
Cameroon,2007-11-01,0,0,0,3,0,3
Cameroon,2007-11-01,0,0,0,9,0,9
Cameroon,2007-11-01,2,0,0,0,0,2
China,2007-11-01,84,2,-7,25,3,107
China,2007-11-01,58,0,2,30,6,96
China,2007-11-01,19,2,2,19,6,48
China,2007-11-01,35,0,-2,11,4,48
China,2007-11-01,13,0,-11,56,5,63
China,2007-11-01,41,0,2,62,7,112
China,2007-11-01,10,2,1,4,2,19
China,2007-11-01,46,2,0,25,10,83
China,2007-11-01,81,0,-1,35,22,137
China,2007-11-01,21,0,0,24,9,54
China,2007-11-01,39,0,-5,9,4,47
China,2007-11-01,16,6,0,13,7,42
China,2007-11-01,78,2,3,43,7,133
China,2007-11-01,76,0,0,91,12,179
China,2007-11-01,14,0,-1,4,3,20
China,2007-11-01,59,0,0,34,2,95
China,2007-11-01,44,0,-2,1,2,45
China,2007-11-01,55,0,4,35,6,100
China,2007-11-01,92,2,-1,50,3,146
China,2007-11-01,100,0,3,41,6,150
China,2007-11-01,58,0,1,3,4,66
China,2007-11-01,62,0,0,36,10,108
China,2007-11-01,-12,0,-2,5,4,-5
China,2007-11-01,49,0,0,6,2,57
China,2007-11-01,27,0,0,50,9,86
China,2007-11-01,72,0,-4,29,14,111
China,2007-11-01,68,0,0,20,7,95
China,2007-11-01,63,0,1,33,9,106
China,2007-11-01,81,0,1,22,8,112
China,2007-11-01,87,2,-9,34,17,131
Egypt,2007-11-01,37,0,0,39,1,77
Egypt,2007-11-01,30,0,0,36,0,66
Egypt,2007-11-01,9,0,0,16,0,25
Egypt,2007-11-01,10,8,0,3,2,23
Egypt,2007-11-01,14,2,-1,30,6,51
Egypt,2007-11-01,-2,0,0,25,0,23
Egypt,2007-11-01,9,0,0,-2,1,8
Egypt,2007-11-01,8,0,0,0,0,8
Egypt,2007-11-01,8,0,0,16,0,24
Egypt,2007-11-01,14,0,0,-8,0,6
Egypt,2007-11-01,17,0,0,9,0,26
Egypt,2007-11-01,65,0,0,1,10,76
Egypt,2007-11-01,4,0,0,-7,6,3
Egypt,2007-11-01,13,0,-1,-2,1,11
Egypt,2007-11-01,3,0,0,0,0,3
Egypt,2007-11-01,11,0,-1,18,0,28
Egypt,2007-11-01,10,0,-2,0,0,8
Egypt,2007-11-01,14,0,-2,9,3,24
Egypt,2007-11-01,11,0,0,3,0,14
Egypt,2007-11-01,5,0,0,3,1,9
Egypt,2007-11-01,8,0,0,-4,0,4
Egypt,2007-11-01,16,0,-8,24,2,34
Egypt,2007-11-01,8,0,0,0,2,10
Egypt,2007-11-01,2,0,0,3,0,5
Egypt,2007-11-01,6,0,0,0,0,6
Egypt,2007-11-01,9,0,-2,0,0,7
Egypt,2007-11-01,16,0,0,21,0,37
Egypt,2007-11-01,17,0,0,4,0,21
Egypt,2007-11-01,10,0,0,6,0,16
Egypt,2007-11-01,-9,0,0,21,1,13
Eritrea,2007-11-01,14,0,0,12,0,26
Eritrea,2007-11-01,14,0,0,6,0,20
Eritrea,2007-11-01,2,0,0,0,0,2
Eritrea,2007-11-01,6,0,0,0,0,6
Eritrea,2007-11-01,6,0,0,0,0,6
Eritrea,2007-11-01,8,0,0,3,0,11
Eritrea,2007-11-01,4,0,0,-4,0,0
Eritrea,2007-11-01,1,0,0,0,0,1
Eritrea,2007-11-01,6,0,0,3,0,9
Eritrea,2007-11-01,0,0,0,3,0,3
Eritrea,2007-11-01,2,0,0,0,0,2
Eritrea,2007-11-01,0,0,0,0,0,0
Eritrea,2007-11-01,0,0,0,3,0,3
Eritrea,2007-11-01,7,0,0,6,0,13
Eritrea,2007-11-01,2,0,0,0,0,2
Eritrea,2007-11-01,6,0,0,0,0,6
Eritrea,2007-11-01,1,0,0,0,0,1
Eritrea,2007-11-01,0,0,0,0,0,0
Eritrea,2007-11-01,6,0,0,0,0,6
Eritrea,2007-11-01,0,0,0,6,0,6
Eritrea,2007-11-01,0,0,0,0,0,0
Eritrea,2007-11-01,0,0,0,0,0,0
Eritrea,2007-11-01,-1,0,0,0,0,-1
Eritrea,2007-11-01,0,0,0,0,0,0
Eritrea,2007-11-01,0,0,0,0,0,0
Eritrea,2007-11-01,15,0,0,0,0,15
Eritrea,2007-11-01,0,0,0,0,0,0
Georgia,2007-11-01,10,0,0,10,2,22
Georgia,2007-11-01,19,0,0,7,6,32
Georgia,2007-11-01,7,0,0,0,6,13
Georgia,2007-11-01,4,0,0,0,2,6
Georgia,2007-11-01,8,0,0,0,1,9
Georgia,2007-11-01,12,0,1,-4,3,12
Georgia,2007-11-01,6,0,0,0,0,6
Georgia,2007-11-01,13,0,2,6,0,21
Georgia,2007-11-01,24,0,2,18,4,48
Georgia,2007-11-01,6,0,0,-2,0,4
Georgia,2007-11-01,0,0,0,0,0,0
Georgia,2007-11-01,5,0,0,2,5,12
Georgia,2007-11-01,9,0,0,3,1,13
Georgia,2007-11-01,5,0,1,6,2,14
Georgia,2007-11-01,3,0,0,3,0,6
Georgia,2007-11-01,-5,0,1,0,3,-1
Georgia,2007-11-01,-1,0,0,1,0,0
Georgia,2007-11-01,6,0,1,6,0,13
Georgia,2007-11-01,5,0,-8,3,0,0
Georgia,2007-11-01,4,0,0,-2,2,4
Georgia,2007-11-01,6,0,0,9,2,17
Georgia,2007-11-01,3,0,0,0,1,4
Georgia,2007-11-01,0,0,0,3,1,4
Georgia,2007-11-01,0,0,0,3,0,3
Georgia,2007-11-01,9,0,0,3,0,12
Georgia,2007-11-01,6,0,0,3,1,10
Georgia,2007-11-01,9,0,0,-2,3,10
Georgia,2007-11-01,2,0,0,12,1,15
Georgia,2007-11-01,4,0,0,21,0,25
Georgia,2007-11-01,5,0,0,3,0,8
India,2007-11-01,17,0,0,9,3,29
India,2007-11-01,35,0,0,9,2,46
India,2007-11-01,43,4,0,-4,3,46
India,2007-11-01,8,0,0,-3,1,6
India,2007-11-01,41,0,-4,16,6,59
India,2007-11-01,31,0,3,9,9,52
India,2007-11-01,2,0,0,15,0,17
India,2007-11-01,-1,2,1,2,3,7
India,2007-11-01,20,0,1,10,1,32
India,2007-11-01,0,0,0,-1,4,3
India,2007-11-01,8,0,0,6,1,15
India,2007-11-01,7,2,0,0,7,16
India,2007-11-01,21,0,-4,9,3,29
India,2007-11-01,28,0,0,7,0,35
India,2007-11-01,20,0,0,12,0,32
India,2007-11-01,45,0,0,1,1,47
India,2007-11-01,7,0,-1,9,2,17
India,2007-11-01,14,0,-4,0,1,11
India,2007-11-01,18,2,-4,8,10,34
India,2007-11-01,22,0,-4,-3,4,19
India,2007-11-01,42,2,0,5,2,51
India,2007-11-01,66,0,-3,3,1,67
India,2007-11-01,29,0,0,6,4,39
India,2007-11-01,18,0,-3,0,0,15
India,2007-11-01,6,0,1,28,5,40
India,2007-11-01,2,0,0,3,0,5
India,2007-11-01,34,0,-2,-3,0,29
India,2007-11-01,17,0,-3,6,3,23
India,2007-11-01,24,0,0,-3,7,28
India,2007-11-01,31,0,0,14,4,49
Iran,2007-11-01,70,2,0,10,14,96
Iran,2007-11-01,75,0,0,10,1,86
Iran,2007-11-01,24,0,0,6,7,37
Iran,2007-11-01,37,8,-4,15,6,62
Iran,2007-11-01,36,0,-4,-2,3,33
Iran,2007-11-01,66,6,3,5,12,92
Iran,2007-11-01,56,0,1,38,4,99
Iran,2007-11-01,44,0,0,-11,0,33
Iran,2007-11-01,67,0,0,51,3,121
Iran,2007-11-01,62,0,1,3,1,67
Iran,2007-11-01,45,0,-2,0,4,47
Iran,2007-11-01,76,0,0,18,9,103
Iran,2007-11-01,77,0,0,14,8,99
Iran,2007-11-01,33,0,0,15,4,52
Iran,2007-11-01,17,0,2,-7,0,12
Iran,2007-11-01,44,0,0,2,1,47
Iran,2007-11-01,30,0,0,16,3,49
Iran,2007-11-01,30,0,0,0,6,36
Iran,2007-11-01,47,0,1,6,7,61
Iran,2007-11-01,40,0,1,15,0,56
Iran,2007-11-01,12,0,2,9,0,23
Iran,2007-11-01,40,0,-2,9,4,51
Iran,2007-11-01,48,0,0,17,6,71
Iran,2007-11-01,25,0,-4,-11,12,22
Iran,2007-11-01,20,0,0,-1,4,23
Iran,2007-11-01,53,0,0,9,3,65
Iran,2007-11-01,53,0,0,13,10,76
Iran,2007-11-01,39,0,-4,1,0,36
Iran,2007-11-01,29,0,3,9,5,46
Iran,2007-11-01,29,0,1,15,3,48
Iraq,2007-11-01,213,0,-2,48,11,270
Iraq,2007-11-01,155,0,5,18,4,182
Iraq,2007-11-01,75,0,1,7,6,89
Iraq,2007-11-01,103,0,0,-50,23,76
Iraq,2007-11-01,165,0,0,37,13,215
Iraq,2007-11-01,154,2,-2,90,23,267
Iraq,2007-11-01,51,2,0,11,7,71
Iraq,2007-11-01,97,0,-3,67,9,170
Iraq,2007-11-01,113,0,-5,41,4,153
Iraq,2007-11-01,97,0,-2,16,13,124
Iraq,2007-11-01,97,0,2,49,20,168
Iraq,2007-11-01,60,0,0,51,16,127
Iraq,2007-11-01,170,8,4,6,9,197
Iraq,2007-11-01,143,4,7,38,16,208
Iraq,2007-11-01,74,0,-2,-2,12,82
Iraq,2007-11-01,106,0,8,100,5,219
Iraq,2007-11-01,88,0,-3,49,13,147
Iraq,2007-11-01,85,0,0,-4,18,99
Iraq,2007-11-01,89,0,2,51,5,147
Iraq,2007-11-01,78,0,0,27,7,112
Iraq,2007-11-01,94,0,0,20,11,125
Iraq,2007-11-01,66,2,2,8,6,84
Iraq,2007-11-01,73,2,-6,67,14,150
Iraq,2007-11-01,54,0,-13,36,4,81
Iraq,2007-11-01,54,0,0,3,10,67
Iraq,2007-11-01,82,2,-2,27,6,115
Iraq,2007-11-01,84,0,0,4,4,92
Iraq,2007-11-01,27,0,1,11,3,42
Iraq,2007-11-01,117,2,3,33,5,160
Iraq,2007-11-01,68,0,1,10,14,93
Morocco,2007-11-01,0,0,0,21,3,24
Morocco,2007-11-01,12,0,1,24,7,44
Morocco,2007-11-01,-3,0,1,9,1,8
Morocco,2007-11-01,3,0,0,12,0,15
Morocco,2007-11-01,5,0,0,15,0,20
Morocco,2007-11-01,20,0,1,12,5,38
Morocco,2007-11-01,0,0,0,0,0,0
Morocco,2007-11-01,10,0,0,9,0,19
Morocco,2007-11-01,29,0,0,2,1,32
Morocco,2007-11-01,7,2,0,0,1,10
Morocco,2007-11-01,2,0,0,0,0,2
Morocco,2007-11-01,0,0,0,0,0,0
Morocco,2007-11-01,0,0,0,9,0,9
Morocco,2007-11-01,0,0,0,6,0,6
Morocco,2007-11-01,0,0,0,0,0,0
Morocco,2007-11-01,20,0,0,39,0,59
Morocco,2007-11-01,0,0,0,0,1,1
Morocco,2007-11-01,0,0,0,0,0,0
Morocco,2007-11-01,0,0,0,6,0,6
Morocco,2007-11-01,10,0,0,0,0,10
Morocco,2007-11-01,0,0,0,6,10,16
Morocco,2007-11-01,0,0,0,0,5,5
Morocco,2007-11-01,11,0,0,0,0,11
Morocco,2007-11-01,2,0,0,3,0,5
Morocco,2007-11-01,0,0,0,0,0,0
Morocco,2007-11-01,-2,0,0,3,2,3
Morocco,2007-11-01,0,0,0,6,0,6
Morocco,2007-11-01,0,0,0,0,0,0
Morocco,2007-11-01,7,0,0,0,0,7
Morocco,2007-11-01,4,0,0,0,0,4
Nigeria,2007-11-01,4,0,0,6,0,10
Nigeria,2007-11-01,8,0,0,9,0,17
Nigeria,2007-11-01,7,0,0,6,0,13
Nigeria,2007-11-01,4,0,0,9,2,15
Nigeria,2007-11-01,-3,0,1,6,0,4
Nigeria,2007-11-01,1,0,1,3,1,6
Nigeria,2007-11-01,2,0,2,8,0,12
Nigeria,2007-11-01,11,0,0,0,0,11
Nigeria,2007-11-01,22,0,0,-2,1,21
Nigeria,2007-11-01,0,0,0,0,2,2
Nigeria,2007-11-01,3,0,0,0,0,3
Nigeria,2007-11-01,6,0,0,2,0,8
Nigeria,2007-11-01,22,0,0,0,0,22
Nigeria,2007-11-01,14,0,0,-3,0,11
Nigeria,2007-11-01,3,0,0,0,0,3
Nigeria,2007-11-01,19,0,0,0,0,19
Nigeria,2007-11-01,8,0,2,1,4,15
Nigeria,2007-11-01,6,0,0,12,0,18
Nigeria,2007-11-01,19,0,4,3,4,30
Nigeria,2007-11-01,13,0,1,6,1,21
Nigeria,2007-11-01,12,0,1,12,1,26
Nigeria,2007-11-01,8,0,0,3,16,27
Nigeria,2007-11-01,18,0,0,3,8,29
Nigeria,2007-11-01,2,0,0,0,1,3
Nigeria,2007-11-01,3,0,0,6,0,9
Nigeria,2007-11-01,7,0,0,0,2,9
Nigeria,2007-11-01,9,0,0,3,1,13
Nigeria,2007-11-01,5,0,0,0,2,7
Nigeria,2007-11-01,6,0,0,0,1,7
Nigeria,2007-11-01,16,0,0,0,0,16
Pakistan,2007-11-01,67,0,-2,21,7,93
Pakistan,2007-11-01,47,0,0,3,12,62
Pakistan,2007-11-01,174,0,-1,107,3,283
Pakistan,2007-11-01,130,0,5,98,20,253
Pakistan,2007-11-01,159,0,3,90,28,280
Pakistan,2007-11-01,171,0,-3,47,15,230
Pakistan,2007-11-01,57,0,4,28,12,101
Pakistan,2007-11-01,77,2,-3,59,11,146
Pakistan,2007-11-01,68,0,0,75,9,152
Pakistan,2007-11-01,86,0,-2,57,22,163
Pakistan,2007-11-01,106,0,-10,31,10,137
Pakistan,2007-11-01,126,0,-4,86,20,228
Pakistan,2007-11-01,85,8,-5,60,-1,147
Pakistan,2007-11-01,76,2,-9,94,6,169
Pakistan,2007-11-01,20,0,-6,36,13,63
Pakistan,2007-11-01,53,0,-6,62,14,123
Pakistan,2007-11-01,67,0,-5,45,3,110
Pakistan,2007-11-01,99,0,-3,9,9,114
Pakistan,2007-11-01,138,0,-5,34,13,180
Pakistan,2007-11-01,94,0,-8,34,11,131
Pakistan,2007-11-01,117,0,-8,43,33,185
Pakistan,2007-11-01,95,0,-6,79,9,177
Pakistan,2007-11-01,111,2,-12,100,6,207
Pakistan,2007-11-01,45,2,-2,16,20,81
Pakistan,2007-11-01,50,0,0,30,11,91
Pakistan,2007-11-01,67,0,-2,35,4,104
Pakistan,2007-11-01,111,0,-7,71,8,183
Pakistan,2007-11-01,79,2,-6,61,1,137
Pakistan,2007-11-01,153,0,-17,101,18,255
Pakistan,2007-11-01,49,0,-6,41,5,89
Sierra Leone,2007-11-01,2,0,0,-1,5,6
Sierra Leone,2007-11-01,0,0,0,0,0,0
Sierra Leone,2007-11-01,0,0,0,0,0,0
Sierra Leone,2007-11-01,0,0,0,3,0,3
Sierra Leone,2007-11-01,0,0,0,6,0,6
Sierra Leone,2007-11-01,0,0,0,0,0,0
Sierra Leone,2007-11-01,8,0,4,0,0,12
Sierra Leone,2007-11-01,0,0,0,6,0,6
Sierra Leone,2007-11-01,10,0,2,18,0,30
Sierra Leone,2007-11-01,10,0,0,1,0,11
Sierra Leone,2007-11-01,0,0,0,0,0,0
Sierra Leone,2007-11-01,0,0,0,3,0,3
Sierra Leone,2007-11-01,0,0,0,0,0,0
Sierra Leone,2007-11-01,2,0,0,9,0,11
Sierra Leone,2007-11-01,0,0,0,6,0,6
Sierra Leone,2007-11-01,17,0,0,3,4,24
Sierra Leone,2007-11-01,-2,0,0,0,0,-2
Sierra Leone,2007-11-01,0,0,0,0,0,0
Sierra Leone,2007-11-01,0,0,0,-2,0,-2
Sierra Leone,2007-11-01,0,0,0,0,0,0
Sierra Leone,2007-11-01,0,0,-2,0,0,-2
Somalia,2007-11-01,59,0,0,36,5,100
Somalia,2007-11-01,66,0,0,21,0,87
Somalia,2007-11-01,21,0,0,3,14,38
Somalia,2007-11-01,6,0,0,5,5,16
Somalia,2007-11-01,20,0,1,15,1,37
Somalia,2007-11-01,27,0,0,-5,1,23
Somalia,2007-11-01,6,0,-2,-8,0,-4
Somalia,2007-11-01,6,0,0,18,0,24
Somalia,2007-11-01,12,0,0,0,0,12
Somalia,2007-11-01,0,0,-2,-2,0,-4
Somalia,2007-11-01,5,0,0,0,0,5
Somalia,2007-11-01,4,0,0,3,0,7
Somalia,2007-11-01,18,0,0,-3,0,15
Somalia,2007-11-01,10,0,0,5,2,17
Somalia,2007-11-01,10,0,0,1,0,11
Somalia,2007-11-01,27,0,0,3,0,30
Somalia,2007-11-01,10,0,0,-1,6,15
Somalia,2007-11-01,20,0,0,-4,0,16
Somalia,2007-11-01,19,0,0,0,0,19
Somalia,2007-11-01,10,0,0,9,0,19
Somalia,2007-11-01,7,0,0,0,0,7
Somalia,2007-11-01,11,0,0,12,2,25
Somalia,2007-11-01,15,0,0,1,0,16
Somalia,2007-11-01,0,0,0,0,0,0
Somalia,2007-11-01,14,0,0,0,0,14
Somalia,2007-11-01,5,0,0,0,0,5
Somalia,2007-11-01,14,0,0,30,0,44
Somalia,2007-11-01,48,0,0,36,0,84
Somalia,2007-11-01,16,0,-2,9,2,25
Somalia,2007-11-01,3,0,0,3,0,6
Syria,2007-11-01,9,0,0,6,0,15
Syria,2007-11-01,6,0,0,0,0,6
Syria,2007-11-01,12,0,0,12,3,27
Syria,2007-11-01,31,0,0,15,0,46
Syria,2007-11-01,-4,0,-14,3,1,-14
Syria,2007-11-01,11,0,-5,27,0,33
Syria,2007-11-01,6,0,0,0,0,6
Syria,2007-11-01,4,0,-2,3,0,5
Syria,2007-11-01,2,0,-2,-9,0,-9
Syria,2007-11-01,2,0,0,0,0,2
Syria,2007-11-01,19,0,2,3,1,25
Syria,2007-11-01,45,0,0,6,4,55
Syria,2007-11-01,40,0,0,-5,3,38
Syria,2007-11-01,14,0,2,15,0,31
Syria,2007-11-01,0,0,0,0,0,0
Syria,2007-11-01,4,0,0,13,2,19
Syria,2007-11-01,2,0,0,0,0,2
Syria,2007-11-01,15,0,-4,-2,0,9
Syria,2007-11-01,28,0,0,4,6,38
Syria,2007-11-01,24,0,-10,-1,2,15
Syria,2007-11-01,25,0,0,4,0,29
Syria,2007-11-01,21,0,-7,-15,2,1
Syria,2007-11-01,73,0,-19,-9,2,47
Syria,2007-11-01,54,0,-9,6,14,65
Syria,2007-11-01,51,0,-12,6,10,55
Syria,2007-11-01,18,0,1,0,1,20
Syria,2007-11-01,25,0,0,-7,1,19
Syria,2007-11-01,7,0,-4,-1,1,3
Syria,2007-11-01,-4,0,-2,2,0,-4
Syria,2007-11-01,9,2,0,0,2,13
Yemen,2007-11-01,24,0,0,6,0,30
Yemen,2007-11-01,5,0,0,0,0,5
Yemen,2007-11-01,4,0,0,0,2,6
Yemen,2007-11-01,0,0,0,-6,0,-6
Yemen,2007-11-01,3,2,0,-4,0,1
Yemen,2007-11-01,0,0,0,0,0,0
Yemen,2007-11-01,0,0,0,3,0,3
Yemen,2007-11-01,14,0,0,18,0,32
Yemen,2007-11-01,5,0,0,12,1,18
Yemen,2007-11-01,3,0,0,0,2,5
Yemen,2007-11-01,0,0,0,-4,0,-4
Yemen,2007-11-01,5,0,0,6,1,12
Yemen,2007-11-01,10,0,0,12,0,22
Yemen,2007-11-01,0,0,0,0,0,0
Yemen,2007-11-01,0,0,0,12,0,12
Yemen,2007-11-01,15,0,2,11,0,28
Yemen,2007-11-01,0,0,0,3,0,3
Yemen,2007-11-01,0,0,0,0,0,0
Yemen,2007-11-01,0,0,0,0,0,0
Yemen,2007-11-01,2,0,0,0,0,2
Yemen,2007-11-01,0,0,0,0,0,0
Yemen,2007-11-01,0,0,0,0,0,0
Yemen,2007-11-01,-1,0,0,0,0,-1
Yemen,2007-11-01,-3,0,0,0,0,-3
Yemen,2007-11-01,2,0,0,0,0,2
Yemen,2007-11-01,0,0,0,0,0,0
Yemen,2007-11-01,5,0,0,0,0,5
Yemen,2007-11-01,0,0,0,3,0,3
Afghanistan,2007-05-01,143,0,-1,33,3,178
Afghanistan,2007-05-01,93,6,0,8,6,113
Afghanistan,2007-05-01,93,0,0,-9,13,97
Afghanistan,2007-05-01,49,0,0,6,7,62
Afghanistan,2007-05-01,104,0,1,7,31,143
Afghanistan,2007-05-01,84,0,-1,6,23,112
Afghanistan,2007-05-01,82,0,0,22,4,108
Afghanistan,2007-05-01,181,0,0,24,12,217
Afghanistan,2007-05-01,136,0,0,16,2,154
Afghanistan,2007-05-01,98,0,-2,35,9,140
Afghanistan,2007-05-01,113,0,3,12,6,134
Afghanistan,2007-05-01,46,0,0,10,9,65
Afghanistan,2007-05-01,349,0,0,46,27,422
Afghanistan,2007-05-01,317,0,0,43,13,373
Afghanistan,2007-05-01,252,0,0,43,37,332
Afghanistan,2007-05-01,258,0,-4,7,31,292
Afghanistan,2007-05-01,135,0,-3,20,35,187
Afghanistan,2007-05-01,88,2,0,33,27,150
Afghanistan,2007-05-01,76,0,-2,51,16,141
Afghanistan,2007-05-01,65,0,0,78,14,157
Afghanistan,2007-05-01,104,0,0,38,11,153
Afghanistan,2007-05-01,107,0,0,8,3,118
Afghanistan,2007-05-01,112,0,1,59,20,192
Afghanistan,2007-05-01,61,4,0,29,0,94
Afghanistan,2007-05-01,67,0,0,20,9,96
Afghanistan,2007-05-01,59,0,0,6,6,71
Afghanistan,2007-05-01,89,2,0,-2,6,95
Afghanistan,2007-05-01,124,0,0,8,13,145
Afghanistan,2007-05-01,76,0,0,43,31,150
Afghanistan,2007-05-01,62,0,0,24,2,88
Afghanistan,2007-05-01,100,0,-4,31,23,150
Albania,2007-05-01,4,0,-6,0,0,-2
Albania,2007-05-01,-2,0,0,30,2,30
Albania,2007-05-01,5,0,0,6,0,11
Albania,2007-05-01,4,0,0,0,0,4
Albania,2007-05-01,8,0,-2,-2,2,6
Albania,2007-05-01,3,0,0,-4,0,-1
Albania,2007-05-01,24,0,0,6,2,32
Albania,2007-05-01,32,0,0,17,1,50
Albania,2007-05-01,28,0,0,18,0,46
Albania,2007-05-01,13,0,-2,3,2,16
Albania,2007-05-01,32,0,-4,7,4,39
Albania,2007-05-01,8,0,0,0,1,9
Albania,2007-05-01,25,0,0,0,0,25
Albania,2007-05-01,43,0,-2,-1,0,40
Albania,2007-05-01,5,0,2,24,13,44
Albania,2007-05-01,3,0,0,12,0,15
Albania,2007-05-01,18,0,0,7,1,26
Albania,2007-05-01,2,0,0,9,0,11
Albania,2007-05-01,11,0,0,3,0,14
Albania,2007-05-01,5,0,0,6,0,11
Albania,2007-05-01,15,0,0,16,2,33
Albania,2007-05-01,5,0,-6,0,1,0
Albania,2007-05-01,11,0,0,18,11,40
Albania,2007-05-01,10,0,-2,0,0,8
Albania,2007-05-01,3,0,0,0,1,4
Albania,2007-05-01,3,0,0,0,0,3
Albania,2007-05-01,5,0,0,0,0,5
Albania,2007-05-01,4,0,0,0,0,4
Albania,2007-05-01,8,0,0,9,0,17
Albania,2007-05-01,10,0,0,0,-4,6
Albania,2007-05-01,25,0,-2,0,0,23
Algeria,2007-05-01,1,0,0,0,0,1
Algeria,2007-05-01,3,0,0,0,0,3
Algeria,2007-05-01,2,0,0,0,0,2
Algeria,2007-05-01,0,0,0,3,0,3
Algeria,2007-05-01,0,0,0,0,0,0
Algeria,2007-05-01,6,0,0,3,2,11
Algeria,2007-05-01,0,0,0,12,0,12
Algeria,2007-05-01,9,0,-8,15,0,16
Algeria,2007-05-01,6,0,0,-4,3,5
Algeria,2007-05-01,3,0,0,3,0,6
Algeria,2007-05-01,14,0,0,24,0,38
Algeria,2007-05-01,13,0,0,7,0,20
Algeria,2007-05-01,2,0,0,12,6,20
Algeria,2007-05-01,1,0,0,-4,14,11
Algeria,2007-05-01,-7,0,0,0,0,-7
Algeria,2007-05-01,7,0,0,0,3,10
Algeria,2007-05-01,0,0,1,1,3,5
Algeria,2007-05-01,7,0,0,18,3,28
Algeria,2007-05-01,0,0,0,0,1,1
Algeria,2007-05-01,2,0,0,0,0,2
Algeria,2007-05-01,25,0,0,0,0,25
Algeria,2007-05-01,19,0,3,3,0,25
Algeria,2007-05-01,12,0,0,12,0,24
Algeria,2007-05-01,15,0,-2,3,0,16
Algeria,2007-05-01,5,0,0,3,0,8
Algeria,2007-05-01,4,0,0,0,0,4
Algeria,2007-05-01,3,0,0,0,0,3
Algeria,2007-05-01,4,0,0,3,0,7
Algeria,2007-05-01,4,0,0,0,0,4
Algeria,2007-05-01,0,0,0,6,1,7
Algeria,2007-05-01,2,0,0,0,0,2
Bangladesh,2007-05-01,15,0,0,6,0,21
Bangladesh,2007-05-01,3,0,0,6,0,9
Bangladesh,2007-05-01,3,0,0,0,2,5
Bangladesh,2007-05-01,5,0,0,4,0,9
Bangladesh,2007-05-01,9,0,0,0,0,9
Bangladesh,2007-05-01,9,2,0,0,1,12
Bangladesh,2007-05-01,2,0,-2,3,0,3
Bangladesh,2007-05-01,18,0,2,5,2,27
Bangladesh,2007-05-01,1,0,-1,3,1,4
Bangladesh,2007-05-01,14,0,-2,3,2,17
Bangladesh,2007-05-01,11,0,0,3,0,14
Bangladesh,2007-05-01,2,0,0,6,0,8
Bangladesh,2007-05-01,2,0,0,16,1,19
Bangladesh,2007-05-01,6,0,0,24,0,30
Bangladesh,2007-05-01,0,0,0,3,0,3
Bangladesh,2007-05-01,0,0,-2,7,0,5
Bangladesh,2007-05-01,5,0,0,6,0,11
Bangladesh,2007-05-01,0,0,0,9,0,9
Bangladesh,2007-05-01,3,0,0,-1,0,2
Bangladesh,2007-05-01,0,0,0,3,0,3
Bangladesh,2007-05-01,9,0,0,12,0,21
Bangladesh,2007-05-01,19,0,0,0,1,20
Bangladesh,2007-05-01,10,0,2,6,5,23
Bangladesh,2007-05-01,0,0,0,6,0,6
Bangladesh,2007-05-01,3,0,0,3,1,7
Bangladesh,2007-05-01,7,0,0,0,0,7
Bangladesh,2007-05-01,11,0,-6,0,0,5
Bangladesh,2007-05-01,4,0,0,9,0,13
Bangladesh,2007-05-01,12,0,-4,15,1,24
Bangladesh,2007-05-01,8,0,0,6,2,16
Bangladesh,2007-05-01,-1,0,0,3,0,2
Cameroon,2007-05-01,1,0,0,0,0,1
Cameroon,2007-05-01,-1,0,0,0,0,-1
Cameroon,2007-05-01,-1,0,0,0,0,-1
Cameroon,2007-05-01,0,0,0,0,0,0
Cameroon,2007-05-01,0,0,0,-2,0,-2
Cameroon,2007-05-01,15,0,0,3,1,19
Cameroon,2007-05-01,0,0,0,0,0,0
Cameroon,2007-05-01,6,0,0,0,1,7
Cameroon,2007-05-01,0,0,0,0,0,0
Cameroon,2007-05-01,0,0,0,3,0,3
Cameroon,2007-05-01,0,0,0,0,0,0
Cameroon,2007-05-01,-2,0,0,0,0,-2
Cameroon,2007-05-01,0,0,0,0,0,0
Cameroon,2007-05-01,2,0,0,0,0,2
Cameroon,2007-05-01,1,0,0,0,0,1
Cameroon,2007-05-01,0,0,0,0,0,0
Cameroon,2007-05-01,0,0,0,3,1,4
Cameroon,2007-05-01,0,0,0,3,1,4
Cameroon,2007-05-01,12,0,0,3,0,15
Cameroon,2007-05-01,3,0,0,0,0,3
Cameroon,2007-05-01,0,0,0,12,12,24
Cameroon,2007-05-01,2,0,0,0,0,2
Cameroon,2007-05-01,1,0,0,6,0,7
Cameroon,2007-05-01,1,0,0,0,0,1
Cameroon,2007-05-01,2,0,0,0,0,2
Cameroon,2007-05-01,1,0,0,0,0,1
Cameroon,2007-05-01,0,0,0,0,0,0
Cameroon,2007-05-01,15,0,0,-1,0,14
China,2007-05-01,72,0,0,37,15,124
China,2007-05-01,41,0,0,26,6,73
China,2007-05-01,69,0,-1,55,1,124
China,2007-05-01,36,0,0,19,2,57
China,2007-05-01,40,0,0,3,0,43
China,2007-05-01,-6,0,0,-1,1,-6
China,2007-05-01,39,0,2,9,2,52
China,2007-05-01,42,0,-1,39,3,83
China,2007-05-01,15,0,0,27,2,44
China,2007-05-01,12,0,2,18,6,38
China,2007-05-01,48,0,1,9,4,62
China,2007-05-01,51,0,-4,21,1,69
China,2007-05-01,41,2,-4,17,0,56
China,2007-05-01,35,0,-2,16,9,58
China,2007-05-01,47,0,-2,-17,8,36
China,2007-05-01,55,0,-4,23,6,80
China,2007-05-01,65,0,0,45,9,119
China,2007-05-01,43,0,-2,26,2,69
China,2007-05-01,17,0,0,4,2,23
China,2007-05-01,67,0,0,4,4,75
China,2007-05-01,36,0,1,0,8,45
China,2007-05-01,40,6,3,48,5,102
China,2007-05-01,75,0,0,28,8,111
China,2007-05-01,91,2,-2,62,6,159
China,2007-05-01,68,0,0,49,6,123
China,2007-05-01,27,0,0,13,4,44
China,2007-05-01,51,0,0,5,4,60
China,2007-05-01,23,0,1,8,17,49
China,2007-05-01,62,0,3,67,5,137
China,2007-05-01,53,0,1,43,10,107
China,2007-05-01,94,0,-2,35,7,134
Egypt,2007-05-01,69,0,0,12,4,85
Egypt,2007-05-01,47,0,0,31,3,81
Egypt,2007-05-01,31,0,0,3,0,34
Egypt,2007-05-01,86,0,0,2,4,92
Egypt,2007-05-01,50,0,0,1,2,53
Egypt,2007-05-01,6,0,0,0,0,6
Egypt,2007-05-01,8,0,0,3,0,11
Egypt,2007-05-01,16,0,-2,17,4,35
Egypt,2007-05-01,28,0,0,28,0,56
Egypt,2007-05-01,1,0,0,6,0,7
Egypt,2007-05-01,6,0,0,0,0,6
Egypt,2007-05-01,0,8,0,0,0,8
Egypt,2007-05-01,18,0,-2,9,2,27
Egypt,2007-05-01,41,0,-4,6,6,49
Egypt,2007-05-01,72,0,-4,3,3,74
Egypt,2007-05-01,105,0,-3,8,2,112
Egypt,2007-05-01,56,0,-2,10,0,64
Egypt,2007-05-01,22,2,0,6,0,30
Egypt,2007-05-01,45,0,0,2,0,47
Egypt,2007-05-01,19,0,2,3,0,24
Egypt,2007-05-01,47,0,4,28,0,79
Egypt,2007-05-01,33,0,0,3,1,37
Egypt,2007-05-01,21,0,0,9,1,31
Egypt,2007-05-01,21,0,0,8,4,33
Egypt,2007-05-01,6,0,0,-6,4,4
Egypt,2007-05-01,62,0,0,-4,9,67
Egypt,2007-05-01,24,0,0,-2,7,29
Egypt,2007-05-01,10,0,0,4,0,14
Egypt,2007-05-01,14,0,0,18,2,34
Egypt,2007-05-01,-3,0,-2,5,0,0
Egypt,2007-05-01,8,0,-2,36,0,42
Eritrea,2007-05-01,-1,0,0,0,0,-1
Eritrea,2007-05-01,14,0,0,-4,0,10
Eritrea,2007-05-01,-1,0,0,12,0,11
Eritrea,2007-05-01,2,0,0,0,0,2
Eritrea,2007-05-01,0,0,0,0,0,0
Eritrea,2007-05-01,0,0,0,0,0,0
Eritrea,2007-05-01,0,0,0,0,0,0
Eritrea,2007-05-01,8,2,0,0,0,10
Eritrea,2007-05-01,0,0,-2,-4,0,-6
Eritrea,2007-05-01,5,0,-2,-1,3,5
Eritrea,2007-05-01,4,0,0,0,0,4
Eritrea,2007-05-01,1,0,0,3,0,4
Eritrea,2007-05-01,0,0,0,3,0,3
Eritrea,2007-05-01,0,0,0,0,0,0
Eritrea,2007-05-01,0,0,0,0,0,0
Eritrea,2007-05-01,21,0,0,0,0,21
Eritrea,2007-05-01,-1,0,0,24,0,23
Eritrea,2007-05-01,3,0,0,0,2,5
Eritrea,2007-05-01,0,0,0,0,0,0
Eritrea,2007-05-01,0,0,0,0,0,0
Eritrea,2007-05-01,2,0,0,0,3,5
Eritrea,2007-05-01,15,0,0,3,0,18
Eritrea,2007-05-01,2,0,0,3,0,5
Eritrea,2007-05-01,0,0,0,0,0,0
Georgia,2007-05-01,7,0,0,1,4,12
Georgia,2007-05-01,7,0,0,3,1,11
Georgia,2007-05-01,5,0,0,0,0,5
Georgia,2007-05-01,0,0,0,-2,0,-2
Georgia,2007-05-01,6,0,0,-2,0,4
Georgia,2007-05-01,0,0,0,0,0,0
Georgia,2007-05-01,3,0,0,0,0,3
Georgia,2007-05-01,-1,0,-2,0,3,0
Georgia,2007-05-01,0,0,0,0,0,0
Georgia,2007-05-01,2,0,0,10,0,12
Georgia,2007-05-01,27,0,0,0,0,27
Georgia,2007-05-01,1,0,0,0,2,3
Georgia,2007-05-01,0,0,0,0,0,0
Georgia,2007-05-01,9,0,0,6,0,15
Georgia,2007-05-01,2,0,0,9,0,11
Georgia,2007-05-01,4,0,0,6,0,10
Georgia,2007-05-01,12,0,0,6,0,18
Georgia,2007-05-01,12,0,0,0,0,12
Georgia,2007-05-01,2,0,0,0,0,2
Georgia,2007-05-01,6,0,0,-2,0,4
Georgia,2007-05-01,9,0,0,0,0,9
Georgia,2007-05-01,7,0,0,4,0,11
Georgia,2007-05-01,6,0,0,3,0,9
Georgia,2007-05-01,4,0,0,6,0,10
Georgia,2007-05-01,4,0,0,0,0,4
Georgia,2007-05-01,0,0,0,0,0,0
Georgia,2007-05-01,0,0,0,0,0,0
Georgia,2007-05-01,3,0,0,0,0,3
Georgia,2007-05-01,5,0,0,0,1,6
Georgia,2007-05-01,9,0,0,0,0,9
Georgia,2007-05-01,7,0,0,15,0,22
India,2007-05-01,16,0,0,9,18,43
India,2007-05-01,18,0,0,0,2,20
India,2007-05-01,48,0,0,6,12,66
India,2007-05-01,62,0,0,9,0,71
India,2007-05-01,20,0,0,3,1,24
India,2007-05-01,6,0,1,6,0,13
India,2007-05-01,41,0,0,5,2,48
India,2007-05-01,46,0,0,17,3,66
India,2007-05-01,14,2,-1,6,1,22
India,2007-05-01,8,0,0,4,1,13
India,2007-05-01,4,2,0,3,8,17
India,2007-05-01,7,2,0,6,2,17
India,2007-05-01,18,0,0,-2,2,18
India,2007-05-01,46,0,0,-2,3,47
India,2007-05-01,30,0,-2,2,8,38
India,2007-05-01,34,0,-1,33,3,69
India,2007-05-01,30,0,0,2,4,36
India,2007-05-01,23,0,1,11,3,38
India,2007-05-01,16,0,0,3,7,26
India,2007-05-01,9,0,0,5,4,18
India,2007-05-01,8,0,0,3,6,17
India,2007-05-01,15,0,0,20,2,37
India,2007-05-01,34,0,1,17,5,57
India,2007-05-01,21,0,2,27,6,56
India,2007-05-01,19,4,-2,-2,5,24
India,2007-05-01,12,0,0,0,0,12
India,2007-05-01,12,0,0,-6,1,7
India,2007-05-01,37,0,-2,6,7,48
India,2007-05-01,30,0,2,12,6,50
India,2007-05-01,15,0,1,-2,1,15
India,2007-05-01,31,0,-1,1,0,31
Iran,2007-05-01,33,0,0,-1,18,50
Iran,2007-05-01,59,4,2,19,0,84
Iran,2007-05-01,46,0,0,22,7,75
Iran,2007-05-01,97,4,-2,56,6,161
Iran,2007-05-01,46,0,0,29,5,80
Iran,2007-05-01,51,0,0,4,1,56
Iran,2007-05-01,43,0,0,37,9,89
Iran,2007-05-01,45,0,2,14,3,64
Iran,2007-05-01,47,0,0,5,11,63
Iran,2007-05-01,63,0,-2,22,11,94
Iran,2007-05-01,40,0,-3,12,4,53
Iran,2007-05-01,55,0,0,6,6,67
Iran,2007-05-01,58,2,0,24,3,87
Iran,2007-05-01,65,0,-2,40,2,105
Iran,2007-05-01,40,0,-2,10,0,48
Iran,2007-05-01,38,0,0,4,1,43
Iran,2007-05-01,24,0,-3,29,0,50
Iran,2007-05-01,44,0,1,12,2,59
Iran,2007-05-01,108,2,2,15,15,142
Iran,2007-05-01,17,0,0,13,0,30
Iran,2007-05-01,53,0,0,23,7,83
Iran,2007-05-01,20,0,-3,5,0,22
Iran,2007-05-01,86,0,1,21,9,117
Iran,2007-05-01,73,0,0,11,5,89
Iran,2007-05-01,93,0,2,33,0,128
Iran,2007-05-01,37,0,7,32,5,81
Iran,2007-05-01,56,0,0,11,0,67
Iran,2007-05-01,49,0,0,21,9,79
Iran,2007-05-01,36,0,-1,56,4,95
Iran,2007-05-01,54,0,0,-2,4,56
Iran,2007-05-01,80,0,2,52,1,135
Iraq,2007-05-01,320,2,-14,58,18,384
Iraq,2007-05-01,259,2,-29,45,18,295
Iraq,2007-05-01,235,4,5,36,17,297
Iraq,2007-05-01,187,6,2,24,11,230
Iraq,2007-05-01,130,2,1,20,6,159
Iraq,2007-05-01,54,2,-17,18,14,71
Iraq,2007-05-01,106,8,0,37,9,160
Iraq,2007-05-01,144,4,-11,38,12,187
Iraq,2007-05-01,174,0,-9,65,21,251
Iraq,2007-05-01,192,0,-32,58,17,235
Iraq,2007-05-01,163,0,-16,27,18,192
Iraq,2007-05-01,103,0,-13,36,4,130
Iraq,2007-05-01,183,0,-9,22,4,200
Iraq,2007-05-01,120,0,-8,55,12,179
Iraq,2007-05-01,139,0,-12,25,13,165
Iraq,2007-05-01,234,0,-4,24,20,274
Iraq,2007-05-01,173,4,-7,4,28,202
Iraq,2007-05-01,142,12,-5,14,20,183
Iraq,2007-05-01,83,2,-8,3,3,83
Iraq,2007-05-01,42,6,-10,21,5,64
Iraq,2007-05-01,254,0,-2,73,15,340
Iraq,2007-05-01,221,6,1,64,29,321
Iraq,2007-05-01,189,10,-2,83,47,327
Iraq,2007-05-01,146,2,-6,26,10,178
Iraq,2007-05-01,169,4,18,44,66,301
Iraq,2007-05-01,129,0,9,32,22,192
Iraq,2007-05-01,72,2,0,13,34,121
Iraq,2007-05-01,100,0,0,56,53,209
Iraq,2007-05-01,139,2,-6,41,17,193
Iraq,2007-05-01,145,2,-1,48,4,198
Iraq,2007-05-01,74,6,-2,55,7,140
Morocco,2007-05-01,10,0,0,2,0,12
Morocco,2007-05-01,8,0,0,9,1,18
Morocco,2007-05-01,20,0,0,3,0,23
Morocco,2007-05-01,3,0,0,7,0,10
Morocco,2007-05-01,0,0,0,3,0,3
Morocco,2007-05-01,6,0,0,0,0,6
Morocco,2007-05-01,2,0,0,0,0,2
Morocco,2007-05-01,8,0,0,-4,7,11
Morocco,2007-05-01,10,0,0,2,3,15
Morocco,2007-05-01,7,0,0,3,0,10
Morocco,2007-05-01,15,0,0,33,5,53
Morocco,2007-05-01,0,0,0,3,0,3
Morocco,2007-05-01,0,0,0,0,0,0
Morocco,2007-05-01,0,0,0,0,0,0
Morocco,2007-05-01,3,0,0,1,0,4
Morocco,2007-05-01,1,0,0,9,1,11
Morocco,2007-05-01,4,0,0,6,0,10
Morocco,2007-05-01,3,0,0,6,0,9
Morocco,2007-05-01,5,0,0,0,0,5
Morocco,2007-05-01,4,0,0,6,0,10
Morocco,2007-05-01,20,0,0,9,2,31
Morocco,2007-05-01,16,0,0,6,0,22
Morocco,2007-05-01,1,0,0,3,0,4
Morocco,2007-05-01,1,0,0,9,6,16
Morocco,2007-05-01,8,0,0,12,0,20
Morocco,2007-05-01,0,0,0,6,0,6
Morocco,2007-05-01,0,0,0,-2,0,-2
Morocco,2007-05-01,0,0,0,33,2,35
Morocco,2007-05-01,0,0,0,27,0,27
Morocco,2007-05-01,3,0,0,4,0,7
Morocco,2007-05-01,-8,0,0,6,0,-2
Nigeria,2007-05-01,21,0,0,15,8,44
Nigeria,2007-05-01,20,0,0,11,4,35
Nigeria,2007-05-01,5,0,-4,16,1,18
Nigeria,2007-05-01,8,0,-2,12,0,18
Nigeria,2007-05-01,4,0,0,9,1,14
Nigeria,2007-05-01,4,0,0,9,1,14
Nigeria,2007-05-01,15,0,-8,8,2,17
Nigeria,2007-05-01,5,0,0,3,3,11
Nigeria,2007-05-01,8,0,0,3,4,15
Nigeria,2007-05-01,6,0,0,-2,0,4
Nigeria,2007-05-01,0,0,0,33,0,33
Nigeria,2007-05-01,3,2,0,0,0,5
Nigeria,2007-05-01,6,0,0,-12,0,-6
Nigeria,2007-05-01,33,0,0,19,6,58
Nigeria,2007-05-01,1,0,-2,1,4,4
Nigeria,2007-05-01,18,0,0,-12,2,8
Nigeria,2007-05-01,11,0,1,0,2,14
Nigeria,2007-05-01,4,0,-2,-2,0,0
Nigeria,2007-05-01,0,2,0,0,0,2
Nigeria,2007-05-01,1,0,0,3,0,4
Nigeria,2007-05-01,12,0,-8,4,0,8
Nigeria,2007-05-01,2,0,-2,5,2,7
Nigeria,2007-05-01,7,0,0,9,4,20
Nigeria,2007-05-01,8,0,0,13,2,23
Nigeria,2007-05-01,9,0,0,9,1,19
Nigeria,2007-05-01,8,0,0,-4,0,4
Nigeria,2007-05-01,3,0,0,0,0,3
Nigeria,2007-05-01,25,0,0,12,7,44
Nigeria,2007-05-01,-2,0,0,-2,1,-3
Nigeria,2007-05-01,9,0,0,4,1,14
Nigeria,2007-05-01,0,0,0,0,0,0
Pakistan,2007-05-01,74,0,0,55,14,143
Pakistan,2007-05-01,19,2,0,30,5,56
Pakistan,2007-05-01,30,0,0,15,0,45
Pakistan,2007-05-01,30,0,-2,15,0,43
Pakistan,2007-05-01,20,0,0,-4,5,21
Pakistan,2007-05-01,8,0,0,8,0,16
Pakistan,2007-05-01,41,0,0,3,4,48
Pakistan,2007-05-01,70,0,0,72,0,142
Pakistan,2007-05-01,41,0,0,47,2,90
Pakistan,2007-05-01,33,0,0,13,10,56
Pakistan,2007-05-01,25,2,0,66,0,93
Pakistan,2007-05-01,23,0,0,15,3,41
Pakistan,2007-05-01,184,0,0,48,10,242
Pakistan,2007-05-01,173,0,0,11,12,196
Pakistan,2007-05-01,93,0,0,44,2,139
Pakistan,2007-05-01,69,0,0,58,13,140
Pakistan,2007-05-01,80,0,-1,5,12,96
Pakistan,2007-05-01,59,0,0,13,16,88
Pakistan,2007-05-01,127,0,0,9,9,145
Pakistan,2007-05-01,24,0,1,6,3,34
Pakistan,2007-05-01,46,0,0,6,0,52
Pakistan,2007-05-01,132,0,1,33,20,186
Pakistan,2007-05-01,123,0,-1,13,19,154
Pakistan,2007-05-01,31,0,-1,14,7,51
Pakistan,2007-05-01,29,0,0,13,0,42
Pakistan,2007-05-01,21,0,-2,42,3,64
Pakistan,2007-05-01,1,0,0,10,1,12
Pakistan,2007-05-01,35,0,0,23,2,60
Pakistan,2007-05-01,40,0,-2,39,3,80
Pakistan,2007-05-01,48,0,-2,1,2,49
Pakistan,2007-05-01,70,0,0,11,7,88
Sierra Leone,2007-05-01,3,0,0,3,0,6
Sierra Leone,2007-05-01,0,0,0,3,0,3
Sierra Leone,2007-05-01,0,0,0,21,0,21
Sierra Leone,2007-05-01,2,0,0,3,0,5
Sierra Leone,2007-05-01,6,0,0,3,0,9
Sierra Leone,2007-05-01,2,0,0,6,0,8
Sierra Leone,2007-05-01,0,0,0,6,0,6
Sierra Leone,2007-05-01,0,0,0,0,0,0
Sierra Leone,2007-05-01,2,0,0,0,0,2
Sierra Leone,2007-05-01,1,0,0,0,0,1
Sierra Leone,2007-05-01,0,0,0,0,0,0
Sierra Leone,2007-05-01,0,12,0,0,0,12
Sierra Leone,2007-05-01,0,0,0,0,0,0
Sierra Leone,2007-05-01,0,0,0,3,0,3
Sierra Leone,2007-05-01,0,0,0,0,0,0
Sierra Leone,2007-05-01,0,0,0,21,22,43
Sierra Leone,2007-05-01,0,0,0,0,0,0
Sierra Leone,2007-05-01,0,0,0,0,0,0
Sierra Leone,2007-05-01,10,0,0,0,0,10
Sierra Leone,2007-05-01,0,0,0,0,0,0
Sierra Leone,2007-05-01,0,0,0,0,0,0
Sierra Leone,2007-05-01,2,0,-6,-4,2,-6
Sierra Leone,2007-05-01,6,0,0,9,0,15
Sierra Leone,2007-05-01,7,0,0,9,0,16
Somalia,2007-05-01,19,0,0,0,0,19
Somalia,2007-05-01,30,0,0,-2,0,28
Somalia,2007-05-01,19,0,0,12,0,31
Somalia,2007-05-01,4,0,0,2,0,6
Somalia,2007-05-01,0,0,0,6,0,6
Somalia,2007-05-01,8,0,0,6,2,16
Somalia,2007-05-01,4,0,0,12,0,16
Somalia,2007-05-01,15,0,0,0,1,16
Somalia,2007-05-01,6,0,0,0,1,7
Somalia,2007-05-01,4,0,0,0,2,6
Somalia,2007-05-01,15,0,0,0,3,18
Somalia,2007-05-01,-2,0,0,0,0,-2
Somalia,2007-05-01,2,0,0,1,0,3
Somalia,2007-05-01,0,0,0,7,0,7
Somalia,2007-05-01,27,0,0,18,0,45
Somalia,2007-05-01,86,0,0,36,19,141
Somalia,2007-05-01,5,0,0,20,0,25
Somalia,2007-05-01,4,0,0,18,5,27
Somalia,2007-05-01,20,0,0,-2,12,30
Somalia,2007-05-01,14,0,-2,1,0,13
Somalia,2007-05-01,15,0,0,0,0,15
Somalia,2007-05-01,14,0,0,21,0,35
Somalia,2007-05-01,4,0,0,10,1,15
Somalia,2007-05-01,7,0,0,0,0,7
Somalia,2007-05-01,8,0,0,6,0,14
Somalia,2007-05-01,3,0,0,9,0,12
Somalia,2007-05-01,4,0,0,36,0,40
Somalia,2007-05-01,4,0,0,3,0,7
Somalia,2007-05-01,1,0,0,0,0,1
Somalia,2007-05-01,15,2,0,21,6,44
Somalia,2007-05-01,5,2,0,9,0,16
Syria,2007-05-01,17,0,0,3,0,20
Syria,2007-05-01,26,0,0,0,0,26
Syria,2007-05-01,26,0,0,23,0,49
Syria,2007-05-01,42,0,2,7,2,53
Syria,2007-05-01,21,0,1,15,0,37
Syria,2007-05-01,19,0,-6,-6,0,7
Syria,2007-05-01,21,0,0,5,0,26
Syria,2007-05-01,10,2,1,0,12,25
Syria,2007-05-01,11,2,0,4,3,20
Syria,2007-05-01,22,0,0,2,1,25
Syria,2007-05-01,16,0,0,-4,2,14
Syria,2007-05-01,24,0,-2,-2,4,24
Syria,2007-05-01,0,0,0,27,0,27
Syria,2007-05-01,15,0,0,20,3,38
Syria,2007-05-01,22,0,-10,12,1,25
Syria,2007-05-01,33,0,0,9,0,42
Syria,2007-05-01,15,0,0,3,0,18
Syria,2007-05-01,10,0,0,15,0,25
Syria,2007-05-01,2,0,0,6,0,8
Syria,2007-05-01,71,0,-2,30,7,106
Syria,2007-05-01,112,0,0,15,29,156
Syria,2007-05-01,51,0,1,5,6,63
Syria,2007-05-01,56,4,0,33,2,95
Syria,2007-05-01,64,2,0,39,0,105
Syria,2007-05-01,35,0,0,3,6,44
Syria,2007-05-01,23,0,7,9,0,39
Syria,2007-05-01,27,0,3,2,2,34
Syria,2007-05-01,18,0,1,27,0,46
Syria,2007-05-01,30,0,0,8,3,41
Syria,2007-05-01,27,0,-2,38,8,71
Syria,2007-05-01,67,0,-9,44,8,110
Yemen,2007-05-01,2,0,0,0,0,2
Yemen,2007-05-01,5,0,0,3,0,8
Yemen,2007-05-01,12,0,0,3,0,15
Yemen,2007-05-01,1,0,0,0,3,4
Yemen,2007-05-01,21,0,0,9,0,30
Yemen,2007-05-01,0,0,0,0,0,0
Yemen,2007-05-01,0,0,0,0,0,0
Yemen,2007-05-01,0,0,0,12,0,12
Yemen,2007-05-01,5,0,0,6,0,11
Yemen,2007-05-01,7,0,0,11,2,20
Yemen,2007-05-01,11,0,0,9,0,20
Yemen,2007-05-01,0,0,0,3,0,3
Yemen,2007-05-01,0,0,0,-6,0,-6
Yemen,2007-05-01,0,0,0,0,0,0
Yemen,2007-05-01,1,0,0,0,0,1
Yemen,2007-05-01,0,0,0,3,0,3
Yemen,2007-05-01,39,0,0,-1,0,38
Yemen,2007-05-01,25,0,0,12,0,37
Yemen,2007-05-01,13,0,0,0,0,13
Yemen,2007-05-01,3,0,0,0,0,3
Yemen,2007-05-01,3,0,2,11,0,16
Yemen,2007-05-01,8,0,0,0,0,8
Yemen,2007-05-01,0,0,0,0,0,0
Yemen,2007-05-01,6,0,0,0,0,6
Yemen,2007-05-01,1,0,0,0,0,1
Yemen,2007-05-01,0,0,0,-4,0,-4
Yemen,2007-05-01,1,0,0,-6,0,-5
Yemen,2007-05-01,3,0,0,3,0,6
Yemen,2007-05-01,16,0,0,54,2,72
Afghanistan,2012-09-01,237,0,0,42,16,295
Afghanistan,2012-09-01,247,0,0,24,16,287
Afghanistan,2012-09-01,199,0,0,26,77,302
Afghanistan,2012-09-01,40,0,0,-2,6,44
Afghanistan,2012-09-01,238,0,0,96,28,362
Afghanistan,2012-09-01,119,0,0,69,11,199
Afghanistan,2012-09-01,260,0,1,42,4,307
Afghanistan,2012-09-01,85,0,0,13,15,113
Afghanistan,2012-09-01,134,4,0,20,19,177
Afghanistan,2012-09-01,273,4,3,47,39,366
Afghanistan,2012-09-01,315,6,1,42,30,394
Afghanistan,2012-09-01,496,2,4,84,57,643
Afghanistan,2012-09-01,256,2,2,90,32,382
Afghanistan,2012-09-01,377,4,2,98,58,539
Afghanistan,2012-09-01,484,2,6,8,51,551
Afghanistan,2012-09-01,418,0,1,40,27,486
Afghanistan,2012-09-01,338,4,4,33,53,432
Afghanistan,2012-09-01,427,0,3,86,74,590
Afghanistan,2012-09-01,223,4,1,59,46,333
Afghanistan,2012-09-01,170,2,7,41,39,259
Afghanistan,2012-09-01,140,0,5,44,11,200
Afghanistan,2012-09-01,114,0,0,25,19,158
Afghanistan,2012-09-01,105,0,1,-5,15,116
Afghanistan,2012-09-01,123,0,3,53,18,197
Afghanistan,2012-09-01,202,2,1,34,30,269
Afghanistan,2012-09-01,146,0,-1,57,24,226
Afghanistan,2012-09-01,122,0,1,34,9,166
Afghanistan,2012-09-01,167,2,6,23,11,209
Afghanistan,2012-09-01,108,0,1,94,8,211
Afghanistan,2012-09-01,253,0,2,62,21,338
Albania,2012-09-01,0,0,0,0,0,0
Albania,2012-09-01,0,0,0,3,0,3
Albania,2012-09-01,13,0,0,0,0,13
Albania,2012-09-01,1,0,0,0,0,1
Albania,2012-09-01,2,0,-1,3,0,4
Albania,2012-09-01,0,0,0,0,0,0
Albania,2012-09-01,23,0,2,3,6,34
Albania,2012-09-01,0,0,0,0,0,0
Albania,2012-09-01,40,0,-1,6,0,45
Albania,2012-09-01,14,0,-1,3,0,16
Albania,2012-09-01,1,0,0,0,0,1
Albania,2012-09-01,-1,0,0,-4,0,-5
Albania,2012-09-01,5,0,0,0,0,5
Albania,2012-09-01,0,0,0,0,0,0
Albania,2012-09-01,0,0,0,0,0,0
Albania,2012-09-01,1,0,0,3,0,4
Albania,2012-09-01,0,0,0,0,0,0
Albania,2012-09-01,-2,0,0,12,0,10
Albania,2012-09-01,2,0,0,9,0,11
Albania,2012-09-01,0,0,-2,0,0,-2
Albania,2012-09-01,0,0,0,6,1,7
Albania,2012-09-01,0,0,0,0,0,0
Albania,2012-09-01,0,0,0,3,0,3
Albania,2012-09-01,0,0,0,-2,2,0
Albania,2012-09-01,1,0,0,0,1,2
Albania,2012-09-01,-5,0,0,0,0,-5
Albania,2012-09-01,-5,0,0,10,2,7
Albania,2012-09-01,0,0,0,0,0,0
Albania,2012-09-01,0,0,0,0,0,0
Algeria,2012-09-01,24,0,-6,0,2,20
Algeria,2012-09-01,14,0,0,39,4,57
Algeria,2012-09-01,50,0,-22,3,1,32
Algeria,2012-09-01,9,0,-4,6,0,11
Algeria,2012-09-01,6,0,0,9,0,15
Algeria,2012-09-01,7,0,0,0,0,7
Algeria,2012-09-01,2,0,0,0,0,2
Algeria,2012-09-01,1,0,0,0,0,1
Algeria,2012-09-01,30,0,-28,18,0,20
Algeria,2012-09-01,37,0,-18,9,0,28
Algeria,2012-09-01,0,0,0,-6,2,-4
Algeria,2012-09-01,13,0,-6,3,5,15
Algeria,2012-09-01,3,0,-4,0,0,-1
Algeria,2012-09-01,12,0,0,0,0,12
Algeria,2012-09-01,7,0,0,0,4,11
Algeria,2012-09-01,17,0,0,15,1,33
Algeria,2012-09-01,25,0,0,18,5,48
Algeria,2012-09-01,33,0,0,21,3,57
Algeria,2012-09-01,12,0,0,6,3,21
Algeria,2012-09-01,21,0,0,12,4,37
Algeria,2012-09-01,11,0,0,-2,1,10
Algeria,2012-09-01,0,0,0,0,0,0
Algeria,2012-09-01,6,0,0,7,0,13
Algeria,2012-09-01,4,0,-4,1,0,1
Algeria,2012-09-01,8,0,0,0,4,12
Algeria,2012-09-01,-1,0,0,0,0,-1
Algeria,2012-09-01,10,0,0,7,0,17
Algeria,2012-09-01,25,0,-2,1,1,25
Algeria,2012-09-01,1,0,0,1,5,7
Algeria,2012-09-01,0,0,0,6,0,6
Bangladesh,2012-09-01,24,0,-2,22,0,44
Bangladesh,2012-09-01,59,0,-5,42,5,101
Bangladesh,2012-09-01,16,0,0,2,6,24
Bangladesh,2012-09-01,3,0,0,0,0,3
Bangladesh,2012-09-01,20,0,0,29,5,54
Bangladesh,2012-09-01,31,0,-1,9,0,39
Bangladesh,2012-09-01,18,0,0,7,1,26
Bangladesh,2012-09-01,31,0,0,9,3,43
Bangladesh,2012-09-01,43,0,-2,18,1,60
Bangladesh,2012-09-01,21,0,0,7,5,33
Bangladesh,2012-09-01,95,0,-2,13,1,107
Bangladesh,2012-09-01,43,0,-3,29,5,74
Bangladesh,2012-09-01,38,0,0,11,19,68
Bangladesh,2012-09-01,27,0,-2,12,86,123
Bangladesh,2012-09-01,19,0,0,6,9,34
Bangladesh,2012-09-01,25,0,0,12,9,46
Bangladesh,2012-09-01,16,0,-2,6,8,28
Bangladesh,2012-09-01,57,0,1,51,39,148
Bangladesh,2012-09-01,37,0,0,7,29,73
Bangladesh,2012-09-01,6,0,0,34,8,48
Bangladesh,2012-09-01,26,0,0,8,8,42
Bangladesh,2012-09-01,36,0,0,28,9,73
Bangladesh,2012-09-01,27,0,1,21,15,64
Bangladesh,2012-09-01,24,0,0,18,7,49
Bangladesh,2012-09-01,28,0,0,11,8,47
Bangladesh,2012-09-01,23,0,2,12,3,40
Bangladesh,2012-09-01,10,0,1,0,2,13
Bangladesh,2012-09-01,29,0,-6,3,3,29
Bangladesh,2012-09-01,29,0,-6,9,9,41
Bangladesh,2012-09-01,57,0,0,33,47,137
Cameroon,2012-09-01,5,0,0,0,0,5
Cameroon,2012-09-01,0,0,0,0,0,0
Cameroon,2012-09-01,17,0,0,0,0,17
Cameroon,2012-09-01,0,0,0,0,0,0
Cameroon,2012-09-01,0,0,0,0,0,0
Cameroon,2012-09-01,0,0,0,0,0,0
Cameroon,2012-09-01,0,0,0,6,0,6
Cameroon,2012-09-01,2,0,0,18,1,21
Cameroon,2012-09-01,4,0,0,-4,0,0
Cameroon,2012-09-01,0,0,0,0,0,0
Cameroon,2012-09-01,0,0,0,6,0,6
Cameroon,2012-09-01,0,0,0,0,0,0
Cameroon,2012-09-01,0,0,0,0,0,0
Cameroon,2012-09-01,0,0,0,0,0,0
Cameroon,2012-09-01,0,0,0,-2,0,-2
Cameroon,2012-09-01,2,0,0,0,0,2
Cameroon,2012-09-01,3,0,0,0,0,3
Cameroon,2012-09-01,0,0,0,0,0,0
Cameroon,2012-09-01,-1,0,0,3,0,2
Cameroon,2012-09-01,0,0,0,9,0,9
Cameroon,2012-09-01,0,0,0,9,0,9
Cameroon,2012-09-01,0,0,0,3,0,3
Cameroon,2012-09-01,0,0,0,0,0,0
Cameroon,2012-09-01,0,0,0,0,0,0
Cameroon,2012-09-01,3,0,0,0,2,5
Cameroon,2012-09-01,1,0,0,0,0,1
Cameroon,2012-09-01,0,0,0,0,0,0
China,2012-09-01,95,2,3,55,7,162
China,2012-09-01,98,2,-1,44,4,147
China,2012-09-01,116,2,-7,29,10,150
China,2012-09-01,62,4,0,8,1,75
China,2012-09-01,246,6,-8,37,16,297
China,2012-09-01,159,12,3,45,34,253
China,2012-09-01,126,8,-9,37,11,173
China,2012-09-01,101,2,-2,4,19,124
China,2012-09-01,128,2,0,16,13,159
China,2012-09-01,133,0,0,95,25,253
China,2012-09-01,139,6,5,25,22,197
China,2012-09-01,162,0,-2,35,38,233
China,2012-09-01,94,6,0,46,24,170
China,2012-09-01,172,0,4,57,25,258
China,2012-09-01,94,0,1,16,10,121
China,2012-09-01,112,0,-2,24,21,155
China,2012-09-01,247,10,1,112,39,409
China,2012-09-01,237,4,1,7,49,298
China,2012-09-01,91,4,-4,40,9,140
China,2012-09-01,166,8,-5,64,23,256
China,2012-09-01,164,2,-19,59,28,234
China,2012-09-01,63,0,2,7,12,84
China,2012-09-01,96,0,-2,5,7,106
China,2012-09-01,188,12,-4,76,29,301
China,2012-09-01,162,4,-7,79,22,260
China,2012-09-01,300,6,0,87,46,439
China,2012-09-01,183,4,2,53,23,265
China,2012-09-01,272,2,2,74,15,365
China,2012-09-01,149,4,2,27,13,195
China,2012-09-01,59,0,-3,37,15,108
Egypt,2012-09-01,84,0,-1,68,10,161
Egypt,2012-09-01,66,0,-1,32,5,102
Egypt,2012-09-01,-4,4,0,59,15,74
Egypt,2012-09-01,30,2,2,12,5,51
Egypt,2012-09-01,119,0,1,19,0,139
Egypt,2012-09-01,80,0,0,30,10,120
Egypt,2012-09-01,26,0,-8,1,9,28
Egypt,2012-09-01,99,0,-3,35,3,134
Egypt,2012-09-01,96,2,0,56,3,157
Egypt,2012-09-01,54,0,-4,38,5,93
Egypt,2012-09-01,60,0,-2,0,23,81
Egypt,2012-09-01,200,4,-1,26,64,293
Egypt,2012-09-01,236,0,-2,61,98,393
Egypt,2012-09-01,330,4,1,94,108,537
Egypt,2012-09-01,389,0,7,105,129,630
Egypt,2012-09-01,362,2,8,66,69,507
Egypt,2012-09-01,206,0,0,117,64,387
Egypt,2012-09-01,380,0,-2,148,96,622
Egypt,2012-09-01,114,0,-1,95,35,243
Egypt,2012-09-01,162,0,-3,42,20,221
Egypt,2012-09-01,261,0,-1,66,41,367
Egypt,2012-09-01,144,0,-2,75,30,247
Egypt,2012-09-01,180,0,0,33,32,245
Egypt,2012-09-01,153,0,4,107,19,283
Egypt,2012-09-01,192,0,-2,36,10,236
Egypt,2012-09-01,147,0,6,41,35,229
Egypt,2012-09-01,83,0,-3,119,14,213
Egypt,2012-09-01,55,0,2,76,13,146
Egypt,2012-09-01,82,0,0,29,23,134
Egypt,2012-09-01,41,0,-4,19,17,73
Eritrea,2012-09-01,6,0,0,3,0,9
Eritrea,2012-09-01,11,0,0,3,0,14
Eritrea,2012-09-01,8,0,0,0,0,8
Eritrea,2012-09-01,19,0,0,22,0,41
Eritrea,2012-09-01,34,4,0,-5,0,33
Eritrea,2012-09-01,6,0,0,9,1,16
Eritrea,2012-09-01,0,0,0,-2,0,-2
Eritrea,2012-09-01,3,2,0,0,0,5
Eritrea,2012-09-01,5,0,0,4,0,9
Eritrea,2012-09-01,-1,0,0,0,0,-1
Eritrea,2012-09-01,0,0,0,1,0,1
Eritrea,2012-09-01,6,0,0,6,2,14
Eritrea,2012-09-01,5,0,0,0,0,5
Eritrea,2012-09-01,0,0,0,0,0,0
Eritrea,2012-09-01,0,0,0,0,0,0
Eritrea,2012-09-01,10,0,0,-2,0,8
Eritrea,2012-09-01,2,0,0,1,0,3
Eritrea,2012-09-01,1,0,2,3,0,6
Eritrea,2012-09-01,5,0,0,0,0,5
Eritrea,2012-09-01,3,0,0,0,0,3
Eritrea,2012-09-01,5,0,0,21,0,26
Eritrea,2012-09-01,3,0,0,0,0,3
Eritrea,2012-09-01,3,0,0,12,0,15
Eritrea,2012-09-01,0,0,0,0,0,0
Georgia,2012-09-01,0,0,0,0,0,0
Georgia,2012-09-01,0,0,0,0,0,0
Georgia,2012-09-01,0,0,0,0,0,0
Georgia,2012-09-01,0,0,1,0,0,1
Georgia,2012-09-01,0,0,0,0,0,0
Georgia,2012-09-01,0,0,0,0,0,0
Georgia,2012-09-01,0,0,0,0,0,0
Georgia,2012-09-01,0,0,0,0,0,0
Georgia,2012-09-01,2,0,0,0,0,2
Georgia,2012-09-01,2,0,0,0,0,2
Georgia,2012-09-01,0,0,0,0,0,0
Georgia,2012-09-01,0,0,0,0,0,0
Georgia,2012-09-01,0,0,0,0,0,0
Georgia,2012-09-01,2,0,0,2,0,4
Georgia,2012-09-01,0,0,0,0,0,0
Georgia,2012-09-01,0,0,0,0,0,0
Georgia,2012-09-01,7,0,0,0,0,7
Georgia,2012-09-01,6,0,0,0,0,6
Georgia,2012-09-01,0,0,0,0,0,0
Georgia,2012-09-01,3,0,0,3,1,7
Georgia,2012-09-01,2,0,0,15,0,17
Georgia,2012-09-01,0,0,1,0,0,1
Georgia,2012-09-01,0,0,0,-2,0,-2
Georgia,2012-09-01,5,0,0,0,0,5
Georgia,2012-09-01,-5,0,0,0,0,-5
Georgia,2012-09-01,0,0,0,9,0,9
India,2012-09-01,46,0,0,39,8,93
India,2012-09-01,74,0,-6,7,12,87
India,2012-09-01,81,2,-5,22,21,121
India,2012-09-01,30,0,-2,2,2,32
India,2012-09-01,88,2,-1,41,3,133
India,2012-09-01,88,2,-1,51,21,161
India,2012-09-01,62,0,-12,4,7,61
India,2012-09-01,69,0,1,22,15,107
India,2012-09-01,66,0,1,8,5,80
India,2012-09-01,81,0,0,9,7,97
India,2012-09-01,68,2,-1,7,6,82
India,2012-09-01,88,2,2,5,16,113
India,2012-09-01,81,0,-2,32,9,120
India,2012-09-01,77,0,-7,29,14,113
India,2012-09-01,41,2,-13,28,10,68
India,2012-09-01,67,0,-6,23,7,91
India,2012-09-01,77,0,-2,37,20,132
India,2012-09-01,116,0,0,27,24,167
India,2012-09-01,51,0,-11,27,17,84
India,2012-09-01,74,0,-11,54,19,136
India,2012-09-01,31,4,-20,39,21,75
India,2012-09-01,32,2,-12,10,11,43
India,2012-09-01,55,0,-10,22,17,84
India,2012-09-01,64,2,-4,62,15,139
India,2012-09-01,82,2,-10,37,12,123
India,2012-09-01,52,0,-2,42,22,114
India,2012-09-01,97,0,-2,31,5,131
India,2012-09-01,59,0,0,14,9,82
India,2012-09-01,50,2,0,23,11,86
India,2012-09-01,42,2,-2,13,11,66
Iran,2012-09-01,91,0,0,27,5,123
Iran,2012-09-01,118,0,2,43,10,173
Iran,2012-09-01,98,0,0,15,12,125
Iran,2012-09-01,42,0,0,-4,0,38
Iran,2012-09-01,162,2,1,51,8,224
Iran,2012-09-01,99,0,-2,16,7,120
Iran,2012-09-01,121,0,-5,82,19,217
Iran,2012-09-01,45,0,-3,13,15,70
Iran,2012-09-01,95,2,0,26,17,140
Iran,2012-09-01,122,0,-4,29,6,153
Iran,2012-09-01,217,0,2,33,5,257
Iran,2012-09-01,143,0,3,31,16,193
Iran,2012-09-01,99,0,3,37,34,173
Iran,2012-09-01,160,2,3,9,31,205
Iran,2012-09-01,48,0,3,15,25,91
Iran,2012-09-01,178,2,2,35,18,235
Iran,2012-09-01,156,2,0,25,39,222
Iran,2012-09-01,145,0,-4,0,20,161
Iran,2012-09-01,181,0,-7,70,16,260
Iran,2012-09-01,126,0,-2,51,17,192
Iran,2012-09-01,154,0,0,32,26,212
Iran,2012-09-01,127,0,1,49,12,189
Iran,2012-09-01,176,0,0,91,15,282
Iran,2012-09-01,225,6,-3,158,27,413
Iran,2012-09-01,297,2,2,117,44,462
Iran,2012-09-01,430,2,-9,161,71,655
Iran,2012-09-01,420,6,2,150,56,634
Iran,2012-09-01,323,0,-1,61,32,415
Iran,2012-09-01,155,0,11,100,22,288
Iran,2012-09-01,244,0,-1,60,91,394
Iraq,2012-09-01,92,0,4,22,8,126
Iraq,2012-09-01,97,0,0,41,9,147
Iraq,2012-09-01,139,0,2,31,12,184
Iraq,2012-09-01,12,0,0,-1,3,14
Iraq,2012-09-01,133,8,2,64,11,218
Iraq,2012-09-01,180,0,-2,47,9,234
Iraq,2012-09-01,331,0,-1,39,19,388
Iraq,2012-09-01,131,0,0,4,7,142
Iraq,2012-09-01,163,0,0,100,9,272
Iraq,2012-09-01,215,0,4,127,18,364
Iraq,2012-09-01,255,0,-2,119,44,416
Iraq,2012-09-01,215,0,-1,21,21,256
Iraq,2012-09-01,170,0,2,12,28,212
Iraq,2012-09-01,203,6,2,32,46,289
Iraq,2012-09-01,87,0,3,12,42,144
Iraq,2012-09-01,88,4,0,21,20,133
Iraq,2012-09-01,253,2,0,26,37,318
Iraq,2012-09-01,70,0,0,14,13,97
Iraq,2012-09-01,107,0,2,18,26,153
Iraq,2012-09-01,112,2,-3,34,14,159
Iraq,2012-09-01,117,6,0,30,94,247
Iraq,2012-09-01,60,0,0,37,43,140
Iraq,2012-09-01,62,0,-2,22,4,86
Iraq,2012-09-01,68,2,0,23,11,104
Iraq,2012-09-01,106,4,0,12,15,137
Iraq,2012-09-01,79,8,0,20,13,120
Iraq,2012-09-01,107,8,0,1,18,134
Iraq,2012-09-01,203,38,-2,33,14,286
Iraq,2012-09-01,81,0,3,12,11,107
Iraq,2012-09-01,83,0,-6,3,2,82
Morocco,2012-09-01,10,0,0,12,2,24
Morocco,2012-09-01,0,0,0,21,0,21
Morocco,2012-09-01,664,4,-5,109,50,822
Morocco,2012-09-01,5,0,2,-2,0,5
Morocco,2012-09-01,19,0,0,37,0,56
Morocco,2012-09-01,7,0,0,3,7,17
Morocco,2012-09-01,4,0,0,3,4,11
Morocco,2012-09-01,2,0,0,0,0,2
Morocco,2012-09-01,6,0,0,0,2,8
Morocco,2012-09-01,1,6,0,12,0,19
Morocco,2012-09-01,0,0,0,6,2,8
Morocco,2012-09-01,19,0,0,21,15,55
Morocco,2012-09-01,167,0,-2,107,92,364
Morocco,2012-09-01,39,0,1,33,38,111
Morocco,2012-09-01,27,0,0,33,10,70
Morocco,2012-09-01,15,0,0,0,0,15
Morocco,2012-09-01,12,0,0,6,4,22
Morocco,2012-09-01,11,0,0,9,5,25
Morocco,2012-09-01,6,0,0,15,0,21
Morocco,2012-09-01,10,0,0,6,0,16
Morocco,2012-09-01,2,0,0,0,3,5
Morocco,2012-09-01,4,0,0,0,0,4
Morocco,2012-09-01,-1,2,0,3,0,4
Morocco,2012-09-01,7,0,0,9,3,19
Morocco,2012-09-01,6,0,0,22,5,33
Morocco,2012-09-01,12,0,0,0,0,12
Morocco,2012-09-01,0,0,0,3,0,3
Morocco,2012-09-01,3,0,0,3,0,6
Morocco,2012-09-01,3,0,0,-3,0,0
Morocco,2012-09-01,-1,0,0,0,0,-1
Nigeria,2012-09-01,28,0,0,3,3,34
Nigeria,2012-09-01,39,0,-6,-4,1,30
Nigeria,2012-09-01,16,0,1,20,2,39
Nigeria,2012-09-01,3,0,0,0,0,3
Nigeria,2012-09-01,31,4,0,24,5,64
Nigeria,2012-09-01,21,0,1,10,9,41
Nigeria,2012-09-01,38,0,3,21,4,66
Nigeria,2012-09-01,13,0,-2,13,0,24
Nigeria,2012-09-01,9,0,0,-6,0,3
Nigeria,2012-09-01,6,0,0,19,1,26
Nigeria,2012-09-01,30,0,0,1,4,35
Nigeria,2012-09-01,23,0,0,4,4,31
Nigeria,2012-09-01,22,0,1,16,2,41
Nigeria,2012-09-01,52,0,2,47,35,136
Nigeria,2012-09-01,41,0,0,15,10,66
Nigeria,2012-09-01,61,2,-2,21,2,84
Nigeria,2012-09-01,41,0,1,40,1,83
Nigeria,2012-09-01,31,2,-4,3,5,37
Nigeria,2012-09-01,38,0,0,19,8,65
Nigeria,2012-09-01,61,0,0,10,5,76
Nigeria,2012-09-01,29,0,-2,16,18,61
Nigeria,2012-09-01,37,0,0,-3,10,44
Nigeria,2012-09-01,28,0,1,7,15,51
Nigeria,2012-09-01,22,0,0,8,7,37
Nigeria,2012-09-01,24,2,1,15,4,46
Nigeria,2012-09-01,39,0,0,32,8,79
Nigeria,2012-09-01,53,0,-3,37,9,96
Nigeria,2012-09-01,7,0,4,35,0,46
Nigeria,2012-09-01,7,0,0,24,3,34
Nigeria,2012-09-01,20,0,0,6,9,35
Pakistan,2012-09-01,46,0,0,11,7,64
Pakistan,2012-09-01,82,0,0,68,6,156
Pakistan,2012-09-01,79,0,0,54,18,151
Pakistan,2012-09-01,38,0,0,21,1,60
Pakistan,2012-09-01,107,0,-2,28,19,152
Pakistan,2012-09-01,123,2,0,37,10,172
Pakistan,2012-09-01,146,6,1,14,16,183
Pakistan,2012-09-01,91,4,0,2,4,101
Pakistan,2012-09-01,54,0,-2,31,5,88
Pakistan,2012-09-01,53,0,0,11,6,70
Pakistan,2012-09-01,177,10,-2,50,13,248
Pakistan,2012-09-01,81,8,0,17,5,111
Pakistan,2012-09-01,163,0,1,53,16,233
Pakistan,2012-09-01,100,6,0,82,37,225
Pakistan,2012-09-01,96,0,0,38,20,154
Pakistan,2012-09-01,117,0,1,28,18,164
Pakistan,2012-09-01,120,0,3,45,39,207
Pakistan,2012-09-01,116,0,2,83,18,219
Pakistan,2012-09-01,145,0,-1,75,21,240
Pakistan,2012-09-01,118,0,-13,102,43,250
Pakistan,2012-09-01,102,0,1,97,41,241
Pakistan,2012-09-01,58,0,0,75,42,175
Pakistan,2012-09-01,79,10,2,85,44,220
Pakistan,2012-09-01,167,0,2,86,57,312
Pakistan,2012-09-01,167,0,1,46,23,237
Pakistan,2012-09-01,159,0,-4,33,11,199
Pakistan,2012-09-01,111,0,0,75,35,221
Pakistan,2012-09-01,135,2,0,49,6,192
Pakistan,2012-09-01,99,0,0,25,7,131
Pakistan,2012-09-01,52,0,0,20,12,84
Sierra Leone,2012-09-01,0,0,0,3,0,3
Sierra Leone,2012-09-01,6,0,0,0,0,6
Sierra Leone,2012-09-01,2,0,0,0,0,2
Sierra Leone,2012-09-01,2,0,0,0,0,2
Sierra Leone,2012-09-01,15,0,0,6,4,25
Sierra Leone,2012-09-01,3,4,0,18,5,30
Sierra Leone,2012-09-01,0,0,0,0,1,1
Sierra Leone,2012-09-01,3,0,0,0,0,3
Sierra Leone,2012-09-01,15,0,0,0,0,15
Sierra Leone,2012-09-01,0,0,0,0,0,0
Sierra Leone,2012-09-01,4,0,0,12,0,16
Sierra Leone,2012-09-01,4,0,0,1,0,5
Sierra Leone,2012-09-01,7,0,2,9,2,20
Sierra Leone,2012-09-01,3,0,0,0,1,4
Sierra Leone,2012-09-01,0,0,0,0,0,0
Sierra Leone,2012-09-01,0,0,0,0,0,0
Sierra Leone,2012-09-01,5,2,0,9,7,23
Sierra Leone,2012-09-01,4,0,0,0,3,7
Sierra Leone,2012-09-01,-11,0,0,0,0,-11
Sierra Leone,2012-09-01,2,0,0,9,0,11
Sierra Leone,2012-09-01,-9,0,0,0,0,-9
Sierra Leone,2012-09-01,0,0,0,0,0,0
Sierra Leone,2012-09-01,0,0,0,0,0,0
Sierra Leone,2012-09-01,0,0,0,0,0,0
Sierra Leone,2012-09-01,0,0,0,0,1,1
Sierra Leone,2012-09-01,2,0,0,9,0,11
Sierra Leone,2012-09-01,0,2,0,12,1,15
Sierra Leone,2012-09-01,0,0,0,0,0,0
Sierra Leone,2012-09-01,0,0,0,0,0,0
Sierra Leone,2012-09-01,0,0,0,0,0,0
Somalia,2012-09-01,29,0,0,9,1,39
Somalia,2012-09-01,73,0,-2,25,0,96
Somalia,2012-09-01,79,0,-4,13,11,99
Somalia,2012-09-01,25,2,0,12,2,41
Somalia,2012-09-01,85,0,-2,27,9,119
Somalia,2012-09-01,99,0,-2,40,12,149
Somalia,2012-09-01,155,0,-2,68,10,231
Somalia,2012-09-01,47,0,-1,8,6,60
Somalia,2012-09-01,53,0,0,26,3,82
Somalia,2012-09-01,73,2,2,55,17,149
Somalia,2012-09-01,99,0,2,25,17,143
Somalia,2012-09-01,120,0,0,5,14,139
Somalia,2012-09-01,60,0,0,29,11,100
Somalia,2012-09-01,107,0,1,47,14,169
Somalia,2012-09-01,61,0,0,7,19,87
Somalia,2012-09-01,38,0,0,18,5,61
Somalia,2012-09-01,102,0,-2,47,13,160
Somalia,2012-09-01,102,2,0,18,10,132
Somalia,2012-09-01,66,0,3,25,4,98
Somalia,2012-09-01,48,0,0,41,10,99
Somalia,2012-09-01,101,0,1,27,9,138
Somalia,2012-09-01,33,0,-4,35,1,65
Somalia,2012-09-01,29,0,2,26,13,70
Somalia,2012-09-01,111,4,-4,27,6,144
Somalia,2012-09-01,78,0,0,27,11,116
Somalia,2012-09-01,63,0,0,30,2,95
Somalia,2012-09-01,72,0,-7,13,9,87
Somalia,2012-09-01,78,0,-1,59,2,138
Somalia,2012-09-01,62,2,0,24,10,98
Somalia,2012-09-01,60,0,0,7,13,80
Syria,2012-09-01,221,28,1,45,27,322
Syria,2012-09-01,164,0,2,76,21,263
Syria,2012-09-01,547,2,0,50,50,649
Syria,2012-09-01,44,2,0,-7,5,44
Syria,2012-09-01,341,6,-5,44,57,443
Syria,2012-09-01,272,4,-8,11,33,312
Syria,2012-09-01,688,10,-1,180,70,947
Syria,2012-09-01,232,4,1,82,17,336
Syria,2012-09-01,162,0,-10,15,35,202
Syria,2012-09-01,269,0,-1,71,19,358
Syria,2012-09-01,261,14,0,55,34,364
Syria,2012-09-01,190,2,0,1,23,216
Syria,2012-09-01,236,16,-4,13,34,295
Syria,2012-09-01,201,16,-2,53,19,287
Syria,2012-09-01,94,0,-2,7,4,103
Syria,2012-09-01,201,4,-2,-1,12,214
Syria,2012-09-01,294,0,-9,24,41,350
Syria,2012-09-01,341,2,-7,24,61,421
Syria,2012-09-01,196,0,6,75,24,301
Syria,2012-09-01,309,0,-4,26,23,354
Syria,2012-09-01,853,6,-18,250,165,1256
Syria,2012-09-01,196,0,-3,14,4,211
Syria,2012-09-01,116,0,-1,11,7,133
Syria,2012-09-01,290,20,2,29,34,375
Syria,2012-09-01,427,0,-9,26,67,511
Syria,2012-09-01,292,0,-1,54,52,397
Syria,2012-09-01,415,36,-11,-12,30,458
Syria,2012-09-01,213,24,-6,21,20,272
Syria,2012-09-01,117,0,1,1,12,131
Syria,2012-09-01,127,0,-3,12,27,163
Yemen,2012-09-01,16,0,0,9,0,25
Yemen,2012-09-01,25,0,0,21,0,46
Yemen,2012-09-01,48,0,0,11,2,61
Yemen,2012-09-01,11,0,-3,0,0,8
Yemen,2012-09-01,60,4,-2,9,2,73
Yemen,2012-09-01,26,0,-2,10,1,35
Yemen,2012-09-01,11,0,1,12,10,34
Yemen,2012-09-01,51,0,0,6,5,62
Yemen,2012-09-01,22,0,-2,6,0,26
Yemen,2012-09-01,209,0,-2,6,1,214
Yemen,2012-09-01,170,0,1,54,18,243
Yemen,2012-09-01,61,0,1,55,16,133
Yemen,2012-09-01,139,0,6,45,79,269
Yemen,2012-09-01,274,0,-2,42,105,419
Yemen,2012-09-01,256,0,2,39,44,341
Yemen,2012-09-01,138,0,0,24,35,197
Yemen,2012-09-01,140,0,0,22,31,193
Yemen,2012-09-01,151,0,1,18,19,189
Yemen,2012-09-01,54,0,0,23,13,90
Yemen,2012-09-01,21,0,0,27,3,51
Yemen,2012-09-01,46,0,0,17,4,67
Yemen,2012-09-01,100,0,-2,7,3,108
Yemen,2012-09-01,6,0,0,0,2,8
Yemen,2012-09-01,36,0,2,40,4,82
Yemen,2012-09-01,67,4,3,2,7,83
Yemen,2012-09-01,43,0,0,17,6,66
Yemen,2012-09-01,13,0,0,6,1,20
Yemen,2012-09-01,23,0,0,3,4,30
Yemen,2012-09-01,6,0,0,-5,19,20
Yemen,2012-09-01,19,0,-2,3,4,24
Afghanistan,2010-09-01,501,0,-5,41,49,586
Afghanistan,2010-09-01,461,14,1,63,27,566
Afghanistan,2010-09-01,269,2,1,8,87,367
Afghanistan,2010-09-01,198,2,0,31,7,238
Afghanistan,2010-09-01,233,0,14,20,30,297
Afghanistan,2010-09-01,292,0,-8,2,29,315
Afghanistan,2010-09-01,310,0,-17,17,50,360
Afghanistan,2010-09-01,535,4,-3,25,41,602
Afghanistan,2010-09-01,495,0,2,128,126,751
Afghanistan,2010-09-01,436,12,-1,47,116,610
Afghanistan,2010-09-01,307,0,-5,31,75,408
Afghanistan,2010-09-01,203,0,3,24,36,266
Afghanistan,2010-09-01,167,2,0,19,23,211
Afghanistan,2010-09-01,142,0,-1,62,23,226
Afghanistan,2010-09-01,367,10,0,87,27,491
Afghanistan,2010-09-01,246,12,1,64,18,341
Afghanistan,2010-09-01,167,4,1,16,7,195
Afghanistan,2010-09-01,244,4,0,41,15,304
Afghanistan,2010-09-01,245,0,-1,20,21,285
Afghanistan,2010-09-01,418,8,-2,-11,45,458
Afghanistan,2010-09-01,323,0,1,92,56,472
Afghanistan,2010-09-01,428,0,4,84,23,539
Afghanistan,2010-09-01,329,2,-2,133,18,480
Afghanistan,2010-09-01,214,0,-4,121,23,354
Afghanistan,2010-09-01,222,4,-2,58,11,293
Afghanistan,2010-09-01,305,6,-4,63,20,390
Afghanistan,2010-09-01,599,2,7,92,48,748
Afghanistan,2010-09-01,490,0,-2,37,43,568
Afghanistan,2010-09-01,383,0,-2,46,24,451
Afghanistan,2010-09-01,336,2,-4,68,20,422
Albania,2010-09-01,6,0,0,-2,0,4
Albania,2010-09-01,-1,0,0,9,0,8
Albania,2010-09-01,10,0,0,3,0,13
Albania,2010-09-01,-2,0,0,3,0,1
Albania,2010-09-01,8,0,0,0,0,8
Albania,2010-09-01,8,0,0,0,0,8
Albania,2010-09-01,13,0,0,0,4,17
Albania,2010-09-01,20,0,0,0,0,20
Albania,2010-09-01,5,0,-1,0,0,4
Albania,2010-09-01,16,0,-2,0,0,14
Albania,2010-09-01,11,0,-1,27,3,40
Albania,2010-09-01,8,0,0,15,2,25
Albania,2010-09-01,4,0,-4,-1,0,-1
Albania,2010-09-01,-2,0,0,0,0,-2
Albania,2010-09-01,2,0,0,0,1,3
Albania,2010-09-01,-15,0,0,3,0,-12
Albania,2010-09-01,2,0,0,3,0,5
Albania,2010-09-01,16,0,0,6,1,23
Albania,2010-09-01,1,0,0,0,0,1
Albania,2010-09-01,0,4,0,0,0,4
Albania,2010-09-01,8,0,0,-2,0,6
Albania,2010-09-01,10,0,1,-2,0,9
Albania,2010-09-01,5,0,0,3,2,10
Albania,2010-09-01,0,0,-2,2,1,1
Albania,2010-09-01,0,0,-3,3,0,0
Albania,2010-09-01,14,0,-3,0,2,13
Albania,2010-09-01,12,0,-11,0,0,1
Albania,2010-09-01,0,0,0,0,0,0
Albania,2010-09-01,7,0,0,0,0,7
Albania,2010-09-01,2,0,0,0,1,3
Algeria,2010-09-01,5,0,0,3,0,8
Algeria,2010-09-01,7,0,0,-2,0,5
Algeria,2010-09-01,3,0,0,0,0,3
Algeria,2010-09-01,1,0,0,21,0,22
Algeria,2010-09-01,0,0,0,12,1,13
Algeria,2010-09-01,4,0,0,0,0,4
Algeria,2010-09-01,11,2,0,1,0,14
Algeria,2010-09-01,-3,0,0,3,0,0
Algeria,2010-09-01,5,2,0,3,0,10
Algeria,2010-09-01,6,0,0,6,0,12
Algeria,2010-09-01,12,0,0,0,0,12
Algeria,2010-09-01,10,0,0,6,0,16
Algeria,2010-09-01,3,0,0,9,0,12
Algeria,2010-09-01,9,0,-4,12,1,18
Algeria,2010-09-01,2,0,0,23,0,25
Algeria,2010-09-01,9,0,0,12,3,24
Algeria,2010-09-01,40,0,0,27,2,69
Algeria,2010-09-01,54,0,0,9,19,82
Algeria,2010-09-01,23,0,0,4,6,33
Algeria,2010-09-01,1,0,0,-2,6,5
Algeria,2010-09-01,6,0,0,12,3,21
Algeria,2010-09-01,17,0,0,21,0,38
Algeria,2010-09-01,7,0,0,6,0,13
Algeria,2010-09-01,5,0,0,2,0,7
Algeria,2010-09-01,1,0,0,6,7,14
Algeria,2010-09-01,2,0,0,6,0,8
Algeria,2010-09-01,12,6,0,6,0,24
Algeria,2010-09-01,18,0,0,3,0,21
Algeria,2010-09-01,21,0,4,22,15,62
Algeria,2010-09-01,33,0,0,2,6,41
Bangladesh,2010-09-01,5,0,0,27,0,32
Bangladesh,2010-09-01,3,0,0,6,0,9
Bangladesh,2010-09-01,24,0,-2,6,0,28
Bangladesh,2010-09-01,4,0,0,1,0,5
Bangladesh,2010-09-01,24,0,1,1,1,27
Bangladesh,2010-09-01,8,0,0,22,0,30
Bangladesh,2010-09-01,8,4,0,27,0,39
Bangladesh,2010-09-01,16,2,0,1,2,21
Bangladesh,2010-09-01,26,2,-2,16,2,44
Bangladesh,2010-09-01,7,0,0,12,2,21
Bangladesh,2010-09-01,0,0,0,0,0,0
Bangladesh,2010-09-01,18,0,0,0,2,20
Bangladesh,2010-09-01,8,0,0,1,2,11
Bangladesh,2010-09-01,10,0,0,3,2,15
Bangladesh,2010-09-01,32,0,-6,16,4,46
Bangladesh,2010-09-01,10,0,0,-6,0,4
Bangladesh,2010-09-01,0,0,0,-5,0,-5
Bangladesh,2010-09-01,10,2,0,0,1,13
Bangladesh,2010-09-01,13,0,0,-2,1,12
Bangladesh,2010-09-01,2,0,0,30,1,33
Bangladesh,2010-09-01,6,0,2,13,4,25
Bangladesh,2010-09-01,19,0,0,-11,4,12
Bangladesh,2010-09-01,14,0,0,3,1,18
Bangladesh,2010-09-01,3,0,0,3,2,8
Bangladesh,2010-09-01,28,0,-2,8,4,38
Bangladesh,2010-09-01,36,0,0,13,0,49
Bangladesh,2010-09-01,20,0,0,25,8,53
Bangladesh,2010-09-01,27,0,3,2,3,35
Bangladesh,2010-09-01,51,0,0,11,0,62
Bangladesh,2010-09-01,20,0,0,-2,0,18
Cameroon,2010-09-01,3,0,0,0,0,3
Cameroon,2010-09-01,0,0,0,0,0,0
Cameroon,2010-09-01,0,0,0,0,0,0
Cameroon,2010-09-01,-2,0,0,0,0,-2
Cameroon,2010-09-01,6,0,0,0,0,6
Cameroon,2010-09-01,2,0,0,0,0,2
Cameroon,2010-09-01,6,0,0,0,2,8
Cameroon,2010-09-01,3,0,0,0,0,3
Cameroon,2010-09-01,6,0,0,3,0,9
Cameroon,2010-09-01,0,0,0,-1,0,-1
Cameroon,2010-09-01,0,0,0,0,0,0
Cameroon,2010-09-01,0,0,0,0,0,0
Cameroon,2010-09-01,0,0,0,-1,0,-1
Cameroon,2010-09-01,0,0,0,0,0,0
Cameroon,2010-09-01,0,0,0,0,0,0
Cameroon,2010-09-01,3,0,0,0,0,3
Cameroon,2010-09-01,2,0,0,0,0,2
Cameroon,2010-09-01,0,0,0,0,0,0
Cameroon,2010-09-01,4,0,0,17,0,21
Cameroon,2010-09-01,0,0,0,12,0,12
Cameroon,2010-09-01,0,0,0,0,0,0
Cameroon,2010-09-01,1,0,0,4,0,5
Cameroon,2010-09-01,3,0,0,0,0,3
Cameroon,2010-09-01,0,0,0,3,0,3
Cameroon,2010-09-01,4,0,0,0,0,4
Cameroon,2010-09-01,0,0,0,0,0,0
Cameroon,2010-09-01,0,0,0,0,0,0
Cameroon,2010-09-01,2,0,0,0,0,2
Cameroon,2010-09-01,18,0,-2,6,0,22
Cameroon,2010-09-01,6,0,0,0,0,6
China,2010-09-01,161,6,-4,42,11,216
China,2010-09-01,167,0,-3,8,19,191
China,2010-09-01,181,4,-13,25,8,205
China,2010-09-01,45,0,-15,9,2,41
China,2010-09-01,60,4,0,7,6,77
China,2010-09-01,88,4,-8,18,17,119
China,2010-09-01,125,4,-13,7,28,151
China,2010-09-01,170,0,-13,52,28,237
China,2010-09-01,88,2,-2,59,13,160
China,2010-09-01,110,6,-3,41,33,187
China,2010-09-01,54,0,-2,19,5,76
China,2010-09-01,43,8,-19,17,5,54
China,2010-09-01,153,8,1,-7,17,172
China,2010-09-01,78,6,-1,-15,5,73
China,2010-09-01,170,8,-9,97,8,274
China,2010-09-01,116,0,-8,6,22,136
China,2010-09-01,221,0,2,-4,17,236
China,2010-09-01,67,0,3,-2,15,83
China,2010-09-01,95,0,-2,53,11,157
China,2010-09-01,117,2,-5,24,9,147
China,2010-09-01,171,8,0,73,20,272
China,2010-09-01,201,2,-7,100,23,319
China,2010-09-01,168,0,-2,41,25,232
China,2010-09-01,138,2,-12,40,18,186
China,2010-09-01,74,0,-5,29,19,117
China,2010-09-01,62,6,-7,30,6,97
China,2010-09-01,158,0,-2,38,14,208
China,2010-09-01,175,4,1,32,14,226
China,2010-09-01,151,2,-7,50,11,207
China,2010-09-01,186,8,-18,28,12,216
Egypt,2010-09-01,55,4,0,7,10,76
Egypt,2010-09-01,26,0,0,29,9,64
Egypt,2010-09-01,53,0,0,3,11,67
Egypt,2010-09-01,23,2,2,0,5,32
Egypt,2010-09-01,85,0,1,55,7,148
Egypt,2010-09-01,105,0,1,25,20,151
Egypt,2010-09-01,45,0,5,6,30,86
Egypt,2010-09-01,63,0,-2,14,9,84
Egypt,2010-09-01,44,2,0,43,15,104
Egypt,2010-09-01,11,0,0,0,8,19
Egypt,2010-09-01,31,0,1,4,3,39
Egypt,2010-09-01,57,0,0,22,7,86
Egypt,2010-09-01,53,2,0,21,8,84
Egypt,2010-09-01,19,0,0,12,4,35
Egypt,2010-09-01,49,0,-1,70,3,121
Egypt,2010-09-01,78,0,1,13,11,103
Egypt,2010-09-01,76,4,-2,31,9,118
Egypt,2010-09-01,24,0,0,3,-4,23
Egypt,2010-09-01,32,0,0,5,3,40
Egypt,2010-09-01,46,2,0,-22,0,26
Egypt,2010-09-01,76,0,0,7,2,85
Egypt,2010-09-01,9,0,-2,8,3,18
Egypt,2010-09-01,0,0,-1,15,-2,12
Egypt,2010-09-01,46,0,0,-1,3,48
Egypt,2010-09-01,27,0,-2,7,3,35
Egypt,2010-09-01,51,0,-2,15,4,68
Egypt,2010-09-01,16,0,0,26,10,52
Egypt,2010-09-01,91,0,0,18,7,116
Egypt,2010-09-01,43,0,0,17,4,64
Egypt,2010-09-01,29,0,3,10,7,49
Eritrea,2010-09-01,3,0,0,3,0,6
Eritrea,2010-09-01,0,0,0,0,0,0
Eritrea,2010-09-01,3,0,0,0,0,3
Eritrea,2010-09-01,3,0,0,0,0,3
Eritrea,2010-09-01,0,0,0,3,0,3
Eritrea,2010-09-01,-3,0,0,-8,0,-11
Eritrea,2010-09-01,-2,0,0,-6,1,-7
Eritrea,2010-09-01,-1,0,0,0,0,-1
Eritrea,2010-09-01,6,0,0,2,0,8
Eritrea,2010-09-01,3,0,0,0,0,3
Eritrea,2010-09-01,2,0,1,3,0,6
Eritrea,2010-09-01,3,0,1,-2,0,2
Eritrea,2010-09-01,2,0,0,0,0,2
Eritrea,2010-09-01,27,0,0,0,0,27
Eritrea,2010-09-01,15,0,-1,0,0,14
Eritrea,2010-09-01,11,0,0,0,0,11
Eritrea,2010-09-01,0,0,0,0,0,0
Eritrea,2010-09-01,0,0,0,0,0,0
Eritrea,2010-09-01,11,0,1,1,0,13
Eritrea,2010-09-01,29,0,0,0,3,32
Eritrea,2010-09-01,32,0,0,0,8,40
Eritrea,2010-09-01,4,0,0,0,0,4
Eritrea,2010-09-01,4,0,0,0,0,4
Eritrea,2010-09-01,11,0,0,0,0,11
Eritrea,2010-09-01,0,0,0,12,0,12
Eritrea,2010-09-01,12,0,0,0,0,12
Eritrea,2010-09-01,0,0,0,0,0,0
Eritrea,2010-09-01,10,0,0,0,0,10
Eritrea,2010-09-01,2,0,0,-2,0,0
Georgia,2010-09-01,68,0,0,28,14,110
Georgia,2010-09-01,53,0,1,20,1,75
Georgia,2010-09-01,16,4,0,36,4,60
Georgia,2010-09-01,20,0,0,31,3,54
Georgia,2010-09-01,9,0,-2,6,1,14
Georgia,2010-09-01,22,4,-2,2,0,26
Georgia,2010-09-01,27,0,0,-4,5,28
Georgia,2010-09-01,60,4,0,17,3,84
Georgia,2010-09-01,57,4,1,8,1,71
Georgia,2010-09-01,33,0,0,5,0,38
Georgia,2010-09-01,13,0,0,-4,0,9
Georgia,2010-09-01,5,0,0,3,1,9
Georgia,2010-09-01,20,0,2,8,6,36
Georgia,2010-09-01,40,0,0,1,1,42
Georgia,2010-09-01,40,0,-1,39,6,84
Georgia,2010-09-01,44,4,0,12,10,70
Georgia,2010-09-01,37,4,-5,14,6,56
Georgia,2010-09-01,13,0,0,2,2,17
Georgia,2010-09-01,9,2,1,9,0,21
Georgia,2010-09-01,60,4,0,29,3,96
Georgia,2010-09-01,72,0,-2,25,6,101
Georgia,2010-09-01,25,0,0,46,0,71
Georgia,2010-09-01,38,2,1,34,3,78
Georgia,2010-09-01,47,4,-4,9,5,61
Georgia,2010-09-01,12,0,-2,3,3,16
Georgia,2010-09-01,35,0,-6,2,1,32
Georgia,2010-09-01,33,0,1,-1,6,39
Georgia,2010-09-01,34,2,1,-3,4,38
Georgia,2010-09-01,33,0,-10,44,11,78
Georgia,2010-09-01,27,0,-1,10,11,47
India,2010-09-01,70,0,3,20,11,104
India,2010-09-01,96,2,0,17,6,121
India,2010-09-01,112,2,-2,7,5,124
India,2010-09-01,41,0,-3,13,3,54
India,2010-09-01,75,0,-1,18,1,93
India,2010-09-01,95,0,-2,-3,16,106
India,2010-09-01,78,4,-9,2,21,96
India,2010-09-01,109,2,0,47,19,177
India,2010-09-01,41,0,-5,54,10,100
India,2010-09-01,80,0,0,49,30,159
India,2010-09-01,53,0,-4,16,24,89
India,2010-09-01,77,0,-1,37,16,129
India,2010-09-01,109,4,2,9,33,157
India,2010-09-01,56,2,-3,19,12,86
India,2010-09-01,84,0,-1,15,16,114
India,2010-09-01,75,0,-2,18,11,102
India,2010-09-01,57,0,-4,42,13,108
India,2010-09-01,62,0,2,43,14,121
India,2010-09-01,88,6,2,61,22,179
India,2010-09-01,61,4,-4,30,21,112
India,2010-09-01,73,10,0,20,10,113
India,2010-09-01,93,0,1,39,13,146
India,2010-09-01,106,2,2,30,14,154
India,2010-09-01,89,4,1,70,8,172
India,2010-09-01,26,2,-3,20,6,51
India,2010-09-01,51,2,0,29,11,93
India,2010-09-01,88,0,-1,11,1,99
India,2010-09-01,109,2,-4,8,5,120
India,2010-09-01,68,4,0,42,7,121
India,2010-09-01,97,2,-8,11,8,110
Iran,2010-09-01,108,4,2,44,22,180
Iran,2010-09-01,89,0,-1,97,5,190
Iran,2010-09-01,97,0,0,66,14,177
Iran,2010-09-01,114,0,0,36,4,154
Iran,2010-09-01,89,0,0,36,10,135
Iran,2010-09-01,101,0,0,34,27,162
Iran,2010-09-01,108,2,-2,68,22,198
Iran,2010-09-01,92,0,3,79,19,193
Iran,2010-09-01,103,0,-8,22,32,149
Iran,2010-09-01,87,0,-1,-8,17,95
Iran,2010-09-01,57,0,-9,0,10,58
Iran,2010-09-01,65,0,0,10,11,86
Iran,2010-09-01,183,0,-11,55,22,249
Iran,2010-09-01,186,0,-9,46,29,252
Iran,2010-09-01,111,2,-1,115,14,241
Iran,2010-09-01,103,2,-4,77,14,192
Iran,2010-09-01,55,2,0,20,15,92
Iran,2010-09-01,31,0,0,38,3,72
Iran,2010-09-01,129,0,2,53,71,255
Iran,2010-09-01,78,0,0,54,23,155
Iran,2010-09-01,125,0,0,55,25,205
Iran,2010-09-01,243,0,1,96,31,371
Iran,2010-09-01,185,0,3,155,51,394
Iran,2010-09-01,130,0,0,103,23,256
Iran,2010-09-01,117,0,2,42,15,176
Iran,2010-09-01,78,2,0,39,10,129
Iran,2010-09-01,103,1,0,59,9,172
Iran,2010-09-01,155,4,0,157,20,336
Iran,2010-09-01,109,2,2,129,10,252
Iran,2010-09-01,91,14,0,91,8,204
Iraq,2010-09-01,605,12,-3,89,65,768
Iraq,2010-09-01,318,4,-3,24,20,363
Iraq,2010-09-01,197,0,1,29,20,247
Iraq,2010-09-01,127,0,0,19,29,175
Iraq,2010-09-01,171,0,6,28,17,222
Iraq,2010-09-01,175,0,1,48,22,246
Iraq,2010-09-01,217,0,-10,44,22,273
Iraq,2010-09-01,186,0,1,50,18,255
Iraq,2010-09-01,189,0,4,131,38,362
Iraq,2010-09-01,218,2,1,68,33,322
Iraq,2010-09-01,131,0,-1,29,10,169
Iraq,2010-09-01,110,0,0,34,10,154
Iraq,2010-09-01,105,0,0,92,10,207
Iraq,2010-09-01,165,0,0,39,11,215
Iraq,2010-09-01,163,0,2,16,34,215
Iraq,2010-09-01,175,0,0,14,17,206
Iraq,2010-09-01,119,0,-4,46,11,172
Iraq,2010-09-01,60,0,0,58,4,122
Iraq,2010-09-01,148,0,-1,163,38,348
Iraq,2010-09-01,73,2,-1,44,22,140
Iraq,2010-09-01,111,0,-1,29,17,156
Iraq,2010-09-01,228,2,-2,70,19,317
Iraq,2010-09-01,170,2,1,23,10,206
Iraq,2010-09-01,164,0,3,10,8,185
Iraq,2010-09-01,92,2,2,16,11,123
Iraq,2010-09-01,144,16,0,29,21,210
Iraq,2010-09-01,197,2,3,41,20,263
Iraq,2010-09-01,148,0,1,32,18,199
Iraq,2010-09-01,161,0,-9,41,11,204
Iraq,2010-09-01,172,2,-3,53,21,245
Morocco,2010-09-01,1,0,0,9,0,10
Morocco,2010-09-01,13,0,0,30,5,48
Morocco,2010-09-01,3,0,0,6,0,9
Morocco,2010-09-01,1,0,0,-2,0,-1
Morocco,2010-09-01,0,0,0,0,0,0
Morocco,2010-09-01,0,0,0,0,0,0
Morocco,2010-09-01,4,0,0,0,1,5
Morocco,2010-09-01,20,0,-1,0,0,19
Morocco,2010-09-01,0,0,0,3,0,3
Morocco,2010-09-01,12,0,0,0,0,12
Morocco,2010-09-01,4,0,0,0,0,4
Morocco,2010-09-01,6,0,0,0,0,6
Morocco,2010-09-01,1,0,0,0,0,1
Morocco,2010-09-01,1,0,1,9,0,11
Morocco,2010-09-01,3,0,0,3,0,6
Morocco,2010-09-01,20,0,0,2,1,23
Morocco,2010-09-01,0,0,3,3,0,6
Morocco,2010-09-01,0,0,0,0,0,0
Morocco,2010-09-01,6,0,2,0,0,8
Morocco,2010-09-01,0,0,0,12,0,12
Morocco,2010-09-01,9,2,0,9,1,21
Morocco,2010-09-01,11,0,0,4,10,25
Morocco,2010-09-01,-3,0,0,3,0,0
Morocco,2010-09-01,9,0,0,-2,0,7
Morocco,2010-09-01,6,0,0,-1,0,5
Morocco,2010-09-01,-3,0,0,24,0,21
Morocco,2010-09-01,7,0,0,9,2,18
Morocco,2010-09-01,-1,0,0,1,0,0
Morocco,2010-09-01,6,0,-1,12,6,23
Morocco,2010-09-01,8,0,0,6,0,14
Nigeria,2010-09-01,36,0,0,38,3,77
Nigeria,2010-09-01,16,0,0,21,5,42
Nigeria,2010-09-01,21,0,0,27,4,52
Nigeria,2010-09-01,23,0,0,11,4,38
Nigeria,2010-09-01,16,0,0,8,3,27
Nigeria,2010-09-01,4,0,0,39,2,45
Nigeria,2010-09-01,12,0,-4,1,0,9
Nigeria,2010-09-01,55,0,1,21,3,80
Nigeria,2010-09-01,36,2,-4,21,8,63
Nigeria,2010-09-01,73,0,-3,17,7,94
Nigeria,2010-09-01,12,0,1,3,4,20
Nigeria,2010-09-01,46,0,0,0,8,54
Nigeria,2010-09-01,67,4,1,28,25,125
Nigeria,2010-09-01,24,0,0,23,9,56
Nigeria,2010-09-01,20,0,1,15,4,40
Nigeria,2010-09-01,111,0,0,4,2,117
Nigeria,2010-09-01,7,0,-6,7,2,10
Nigeria,2010-09-01,27,0,0,3,0,30
Nigeria,2010-09-01,56,0,3,19,10,88
Nigeria,2010-09-01,25,0,-2,7,8,38
Nigeria,2010-09-01,30,0,2,12,2,46
Nigeria,2010-09-01,27,0,0,55,9,91
Nigeria,2010-09-01,13,0,-3,63,7,80
Nigeria,2010-09-01,13,2,-2,13,4,30
Nigeria,2010-09-01,4,0,1,5,4,14
Nigeria,2010-09-01,7,0,-1,8,0,14
Nigeria,2010-09-01,38,0,0,12,1,51
Nigeria,2010-09-01,13,0,0,38,2,53
Nigeria,2010-09-01,29,0,0,20,0,49
Nigeria,2010-09-01,49,0,0,6,9,64
Pakistan,2010-09-01,170,16,0,67,11,264
Pakistan,2010-09-01,184,4,-1,25,13,225
Pakistan,2010-09-01,181,6,0,8,23,218
Pakistan,2010-09-01,75,14,-2,9,8,104
Pakistan,2010-09-01,91,4,0,3,14,112
Pakistan,2010-09-01,57,2,-3,13,18,87
Pakistan,2010-09-01,110,24,0,6,23,163
Pakistan,2010-09-01,165,14,-2,8,36,221
Pakistan,2010-09-01,119,8,0,23,32,182
Pakistan,2010-09-01,138,16,0,32,40,226
Pakistan,2010-09-01,113,6,-6,21,23,157
Pakistan,2010-09-01,91,0,0,16,20,127
Pakistan,2010-09-01,110,18,-3,8,14,147
Pakistan,2010-09-01,89,6,-2,17,9,119
Pakistan,2010-09-01,232,6,-1,80,24,341
Pakistan,2010-09-01,132,2,2,37,11,184
Pakistan,2010-09-01,102,10,2,27,10,151
Pakistan,2010-09-01,116,10,0,21,10,157
Pakistan,2010-09-01,137,18,0,30,21,206
Pakistan,2010-09-01,126,28,1,30,7,192
Pakistan,2010-09-01,108,16,1,51,7,183
Pakistan,2010-09-01,197,2,1,16,3,219
Pakistan,2010-09-01,108,4,0,119,10,241
Pakistan,2010-09-01,130,2,-9,69,15,207
Pakistan,2010-09-01,109,2,-4,1,7,115
Pakistan,2010-09-01,131,0,-10,35,14,170
Pakistan,2010-09-01,393,0,-1,40,24,456
Pakistan,2010-09-01,322,0,10,88,28,448
Pakistan,2010-09-01,369,0,1,51,29,450
Pakistan,2010-09-01,311,0,0,73,32,416
Sierra Leone,2010-09-01,5,0,0,0,0,5
Sierra Leone,2010-09-01,0,0,0,12,0,12
Sierra Leone,2010-09-01,8,0,0,0,0,8
Sierra Leone,2010-09-01,0,0,0,0,0,0
Sierra Leone,2010-09-01,0,0,0,0,0,0
Sierra Leone,2010-09-01,2,0,0,-2,1,1
Sierra Leone,2010-09-01,-3,0,-2,6,0,1
Sierra Leone,2010-09-01,-1,2,0,-2,0,-1
Sierra Leone,2010-09-01,0,0,0,0,0,0
Sierra Leone,2010-09-01,0,0,0,0,0,0
Sierra Leone,2010-09-01,5,0,0,-2,0,3
Sierra Leone,2010-09-01,-4,0,2,0,0,-2
Sierra Leone,2010-09-01,3,0,0,0,0,3
Sierra Leone,2010-09-01,10,0,0,0,5,15
Sierra Leone,2010-09-01,22,0,0,6,3,31
Sierra Leone,2010-09-01,-10,0,0,0,0,-10
Sierra Leone,2010-09-01,4,0,0,0,0,4
Sierra Leone,2010-09-01,-6,0,-6,0,0,-12
Sierra Leone,2010-09-01,0,0,0,6,0,6
Sierra Leone,2010-09-01,11,0,0,0,0,11
Sierra Leone,2010-09-01,-2,0,0,0,0,-2
Sierra Leone,2010-09-01,3,0,0,3,0,6
Sierra Leone,2010-09-01,0,0,0,-4,0,-4
Sierra Leone,2010-09-01,0,0,0,0,0,0
Sierra Leone,2010-09-01,0,0,-4,-10,1,-13
Sierra Leone,2010-09-01,14,0,-6,-6,0,2
Sierra Leone,2010-09-01,29,0,-4,6,-1,30
Sierra Leone,2010-09-01,11,0,-2,-2,-2,5
Somalia,2010-09-01,58,0,0,12,2,72
Somalia,2010-09-01,32,0,0,6,0,38
Somalia,2010-09-01,29,0,1,27,0,57
Somalia,2010-09-01,29,0,0,-1,0,28
Somalia,2010-09-01,26,0,0,0,0,26
Somalia,2010-09-01,11,0,0,12,5,28
Somalia,2010-09-01,23,0,0,55,7,85
Somalia,2010-09-01,25,0,0,35,6,66
Somalia,2010-09-01,92,0,0,-9,11,94
Somalia,2010-09-01,59,0,0,28,12,99
Somalia,2010-09-01,17,0,0,9,3,29
Somalia,2010-09-01,10,0,0,-2,3,11
Somalia,2010-09-01,31,0,0,3,2,36
Somalia,2010-09-01,51,0,0,-1,0,50
Somalia,2010-09-01,32,0,-2,21,0,51
Somalia,2010-09-01,33,0,0,13,1,47
Somalia,2010-09-01,40,0,-2,7,3,48
Somalia,2010-09-01,0,0,0,42,6,48
Somalia,2010-09-01,45,0,0,49,1,95
Somalia,2010-09-01,9,0,-4,24,6,35
Somalia,2010-09-01,31,0,-22,9,7,25
Somalia,2010-09-01,35,0,-4,56,14,101
Somalia,2010-09-01,45,2,-10,43,2,82
Somalia,2010-09-01,21,0,-18,45,0,48
Somalia,2010-09-01,38,0,-8,23,4,57
Somalia,2010-09-01,14,0,0,16,4,34
Somalia,2010-09-01,79,0,0,12,6,97
Somalia,2010-09-01,64,0,0,42,13,119
Somalia,2010-09-01,66,0,-2,40,4,108
Somalia,2010-09-01,21,0,1,17,5,44
Syria,2010-09-01,19,0,0,-2,0,17
Syria,2010-09-01,9,0,1,33,0,43
Syria,2010-09-01,9,0,0,-6,0,3
Syria,2010-09-01,10,0,0,7,0,17
Syria,2010-09-01,5,0,0,6,2,13
Syria,2010-09-01,45,0,1,3,0,49
Syria,2010-09-01,3,0,-2,13,3,17
Syria,2010-09-01,33,0,0,6,2,41
Syria,2010-09-01,12,0,0,4,3,19
Syria,2010-09-01,3,0,0,-3,0,0
Syria,2010-09-01,0,0,0,2,14,16
Syria,2010-09-01,15,0,0,-7,28,36
Syria,2010-09-01,18,0,0,20,11,49
Syria,2010-09-01,20,0,-1,-2,5,22
Syria,2010-09-01,27,0,0,7,0,34
Syria,2010-09-01,31,6,0,24,2,63
Syria,2010-09-01,8,0,0,37,1,46
Syria,2010-09-01,17,0,0,30,0,47
Syria,2010-09-01,17,0,0,9,2,28
Syria,2010-09-01,28,0,1,5,1,35
Syria,2010-09-01,33,0,0,22,5,60
Syria,2010-09-01,34,0,0,56,9,99
Syria,2010-09-01,14,0,0,31,6,51
Syria,2010-09-01,23,0,-2,18,5,44
Syria,2010-09-01,4,0,0,0,0,4
Syria,2010-09-01,11,0,0,3,0,14
Syria,2010-09-01,15,0,0,21,0,36
Syria,2010-09-01,17,0,0,3,6,26
Syria,2010-09-01,56,0,-1,12,0,67
Syria,2010-09-01,9,0,1,6,2,18
Yemen,2010-09-01,52,0,0,14,2,68
Yemen,2010-09-01,29,0,0,13,0,42
Yemen,2010-09-01,3,0,0,0,0,3
Yemen,2010-09-01,12,0,0,3,2,17
Yemen,2010-09-01,18,0,0,3,2,23
Yemen,2010-09-01,33,0,0,1,0,34
Yemen,2010-09-01,0,0,0,6,0,6
Yemen,2010-09-01,11,0,0,16,0,27
Yemen,2010-09-01,50,0,0,16,1,67
Yemen,2010-09-01,10,0,0,0,0,10
Yemen,2010-09-01,9,0,0,0,0,9
Yemen,2010-09-01,13,0,0,3,4,20
Yemen,2010-09-01,25,0,0,20,6,51
Yemen,2010-09-01,3,0,0,9,3,15
Yemen,2010-09-01,24,0,0,6,5,35
Yemen,2010-09-01,22,0,0,-5,4,21
Yemen,2010-09-01,15,0,0,0,3,18
Yemen,2010-09-01,7,0,0,3,0,10
Yemen,2010-09-01,4,0,0,26,0,30
Yemen,2010-09-01,41,0,0,16,0,57
Yemen,2010-09-01,35,0,-4,15,4,50
Yemen,2010-09-01,51,0,0,-3,2,50
Yemen,2010-09-01,23,0,0,3,1,27
Yemen,2010-09-01,45,0,0,9,6,60
Yemen,2010-09-01,12,0,0,0,13,25
Yemen,2010-09-01,15,0,0,6,5,26
Yemen,2010-09-01,9,0,0,12,6,27
Yemen,2010-09-01,26,0,0,0,1,27
Yemen,2010-09-01,36,0,0,7,10,53
Yemen,2010-09-01,17,0,0,0,2,19
Afghanistan,2009-08-01,263,2,0,50,26,341
Afghanistan,2009-08-01,284,4,0,50,27,365
Afghanistan,2009-08-01,291,12,-2,53,25,379
Afghanistan,2009-08-01,236,4,2,42,5,289
Afghanistan,2009-08-01,292,0,0,59,21,372
Afghanistan,2009-08-01,430,0,2,8,30,470
Afghanistan,2009-08-01,585,4,1,28,37,655
Afghanistan,2009-08-01,193,12,2,50,3,260
Afghanistan,2009-08-01,263,0,2,40,32,337
Afghanistan,2009-08-01,261,0,-2,72,37,368
Afghanistan,2009-08-01,295,6,2,66,38,407
Afghanistan,2009-08-01,264,2,-3,66,26,355
Afghanistan,2009-08-01,321,2,1,42,5,371
Afghanistan,2009-08-01,185,2,-2,59,8,252
Afghanistan,2009-08-01,195,0,-4,26,25,242
Afghanistan,2009-08-01,191,0,1,38,35,265
Afghanistan,2009-08-01,271,6,-1,28,24,328
Afghanistan,2009-08-01,308,0,-2,140,51,497
Afghanistan,2009-08-01,260,6,1,85,46,398
Afghanistan,2009-08-01,426,0,6,40,38,510
Afghanistan,2009-08-01,496,4,7,26,32,565
Afghanistan,2009-08-01,226,0,-3,34,33,290
Afghanistan,2009-08-01,251,2,-2,41,18,310
Afghanistan,2009-08-01,410,4,5,48,24,491
Afghanistan,2009-08-01,449,2,2,38,36,527
Afghanistan,2009-08-01,345,0,1,2,47,395
Afghanistan,2009-08-01,143,0,2,23,11,179
Afghanistan,2009-08-01,220,0,3,27,13,263
Afghanistan,2009-08-01,138,2,-4,8,12,156
Afghanistan,2009-08-01,140,0,-6,25,30,189
Afghanistan,2009-08-01,280,0,1,0,63,344
Albania,2009-08-01,5,0,0,3,1,9
Albania,2009-08-01,0,0,0,0,0,0
Albania,2009-08-01,5,0,0,2,7,14
Albania,2009-08-01,0,0,0,3,2,5
Albania,2009-08-01,0,0,-2,0,0,-2
Albania,2009-08-01,0,0,0,0,0,0
Albania,2009-08-01,4,0,0,3,0,7
Albania,2009-08-01,2,0,0,0,4,6
Albania,2009-08-01,0,0,0,-2,4,2
Albania,2009-08-01,4,0,-2,-2,0,0
Albania,2009-08-01,4,0,0,10,0,14
Albania,2009-08-01,5,0,-3,1,0,3
Albania,2009-08-01,33,0,0,0,6,39
Albania,2009-08-01,10,0,0,0,0,10
Albania,2009-08-01,9,0,0,0,0,9
Albania,2009-08-01,6,0,0,0,0,6
Albania,2009-08-01,12,0,0,6,3,21
Albania,2009-08-01,13,0,-2,6,10,27
Albania,2009-08-01,22,0,-2,0,3,23
Albania,2009-08-01,2,0,0,3,2,7
Albania,2009-08-01,0,0,0,6,0,6
Albania,2009-08-01,0,0,0,0,0,0
Albania,2009-08-01,1,0,0,0,2,3
Albania,2009-08-01,0,0,0,6,0,6
Albania,2009-08-01,102,0,-2,24,36,160
Albania,2009-08-01,20,0,0,9,6,35
Albania,2009-08-01,13,0,-1,6,3,21
Albania,2009-08-01,7,0,-2,12,0,17
Albania,2009-08-01,0,0,-1,9,8,16
Albania,2009-08-01,3,0,0,6,0,9
Albania,2009-08-01,0,0,0,-1,0,-1
Algeria,2009-08-01,6,0,0,3,6,15
Algeria,2009-08-01,32,0,0,3,6,41
Algeria,2009-08-01,7,0,0,5,0,12
Algeria,2009-08-01,15,0,0,3,2,20
Algeria,2009-08-01,2,0,0,6,1,9
Algeria,2009-08-01,0,0,0,0,0,0
Algeria,2009-08-01,13,0,0,3,0,16
Algeria,2009-08-01,0,0,0,0,0,0
Algeria,2009-08-01,2,0,0,-2,0,0
Algeria,2009-08-01,3,0,0,9,0,12
Algeria,2009-08-01,3,0,0,0,0,3
Algeria,2009-08-01,8,0,0,-3,0,5
Algeria,2009-08-01,20,0,0,-6,0,14
Algeria,2009-08-01,12,0,0,6,0,18
Algeria,2009-08-01,9,0,0,1,0,10
Algeria,2009-08-01,6,0,0,3,0,9
Algeria,2009-08-01,0,0,0,0,0,0
Algeria,2009-08-01,16,0,0,26,3,45
Algeria,2009-08-01,19,0,1,3,3,26
Algeria,2009-08-01,4,0,0,-2,3,5
Algeria,2009-08-01,9,0,0,9,0,18
Algeria,2009-08-01,3,0,0,0,0,3
Algeria,2009-08-01,9,0,0,0,0,9
Algeria,2009-08-01,10,0,0,3,0,13
Algeria,2009-08-01,3,0,0,0,0,3
Algeria,2009-08-01,21,0,0,4,0,25
Algeria,2009-08-01,4,0,0,6,0,10
Algeria,2009-08-01,10,0,0,6,3,19
Algeria,2009-08-01,0,0,0,15,0,15
Algeria,2009-08-01,3,0,0,6,0,9
Algeria,2009-08-01,25,0,0,3,0,28
Bangladesh,2009-08-01,10,0,1,15,0,26
Bangladesh,2009-08-01,11,0,0,2,0,13
Bangladesh,2009-08-01,4,0,0,0,0,4
Bangladesh,2009-08-01,14,0,1,12,5,32
Bangladesh,2009-08-01,15,0,0,40,6,61
Bangladesh,2009-08-01,13,0,0,3,0,16
Bangladesh,2009-08-01,-1,0,0,1,0,0
Bangladesh,2009-08-01,13,0,0,8,1,22
Bangladesh,2009-08-01,7,0,0,7,1,15
Bangladesh,2009-08-01,3,0,0,6,0,9
Bangladesh,2009-08-01,13,0,0,0,2,15
Bangladesh,2009-08-01,13,0,0,66,3,82
Bangladesh,2009-08-01,20,0,1,63,2,86
Bangladesh,2009-08-01,-1,0,0,4,0,3
Bangladesh,2009-08-01,11,0,0,3,0,14
Bangladesh,2009-08-01,-4,0,0,13,2,11
Bangladesh,2009-08-01,14,0,1,21,0,36
Bangladesh,2009-08-01,11,0,0,3,0,14
Bangladesh,2009-08-01,16,0,0,6,0,22
Bangladesh,2009-08-01,0,0,0,10,4,14
Bangladesh,2009-08-01,12,0,0,0,2,14
Bangladesh,2009-08-01,16,2,0,6,0,24
Bangladesh,2009-08-01,3,0,0,3,3,9
Bangladesh,2009-08-01,17,0,0,0,2,19
Bangladesh,2009-08-01,14,0,-4,14,2,26
Bangladesh,2009-08-01,4,0,0,14,0,18
Bangladesh,2009-08-01,-2,0,0,6,0,4
Bangladesh,2009-08-01,11,0,0,13,0,24
Bangladesh,2009-08-01,7,0,0,7,3,17
Bangladesh,2009-08-01,11,2,0,0,0,13
Bangladesh,2009-08-01,12,0,0,2,0,14
Cameroon,2009-08-01,6,0,0,6,0,12
Cameroon,2009-08-01,2,0,0,0,0,2
Cameroon,2009-08-01,4,0,1,0,0,5
Cameroon,2009-08-01,2,0,0,0,0,2
Cameroon,2009-08-01,5,0,0,0,0,5
Cameroon,2009-08-01,6,0,0,1,0,7
Cameroon,2009-08-01,1,0,0,0,0,1
Cameroon,2009-08-01,0,0,0,0,0,0
Cameroon,2009-08-01,0,0,0,0,0,0
Cameroon,2009-08-01,0,0,0,0,0,0
Cameroon,2009-08-01,3,0,0,0,0,3
Cameroon,2009-08-01,0,0,0,3,0,3
Cameroon,2009-08-01,0,0,0,6,2,8
Cameroon,2009-08-01,0,0,0,0,0,0
Cameroon,2009-08-01,0,0,0,0,0,0
Cameroon,2009-08-01,0,0,0,0,0,0
Cameroon,2009-08-01,8,0,0,9,0,17
Cameroon,2009-08-01,2,0,0,0,0,2
Cameroon,2009-08-01,0,0,0,0,0,0
Cameroon,2009-08-01,0,0,0,0,0,0
Cameroon,2009-08-01,6,0,0,0,0,6
Cameroon,2009-08-01,0,0,0,0,0,0
Cameroon,2009-08-01,-1,0,0,0,0,-1
Cameroon,2009-08-01,0,0,0,0,0,0
Cameroon,2009-08-01,-1,0,0,3,0,2
Cameroon,2009-08-01,0,0,0,0,0,0
Cameroon,2009-08-01,2,0,0,3,0,5
Cameroon,2009-08-01,3,0,0,0,0,3
Cameroon,2009-08-01,3,0,0,0,0,3
Cameroon,2009-08-01,1,0,0,0,0,1
China,2009-08-01,40,2,-2,32,8,80
China,2009-08-01,100,0,0,41,22,163
China,2009-08-01,106,2,0,121,28,257
China,2009-08-01,198,4,-1,207,60,468
China,2009-08-01,188,2,1,156,21,368
China,2009-08-01,124,6,0,81,11,222
China,2009-08-01,92,4,-4,47,12,151
China,2009-08-01,75,6,-4,41,15,133
China,2009-08-01,139,6,-2,31,19,193
China,2009-08-01,111,2,4,40,11,168
China,2009-08-01,134,4,1,140,22,301
China,2009-08-01,107,0,-2,84,9,198
China,2009-08-01,90,6,2,71,27,196
China,2009-08-01,83,2,-3,28,18,128
China,2009-08-01,26,0,-1,12,9,46
China,2009-08-01,40,12,-1,10,26,87
China,2009-08-01,121,4,-15,16,26,152
China,2009-08-01,133,0,-17,48,17,181
China,2009-08-01,95,0,-13,57,7,146
China,2009-08-01,113,2,2,72,7,196
China,2009-08-01,147,0,-3,27,13,184
China,2009-08-01,77,6,0,10,10,103
China,2009-08-01,84,4,1,32,19,140
China,2009-08-01,145,0,2,71,16,234
China,2009-08-01,130,0,-2,69,16,213
China,2009-08-01,161,0,-2,53,24,236
China,2009-08-01,68,0,0,43,9,120
China,2009-08-01,70,0,-1,27,21,117
China,2009-08-01,51,0,1,10,10,72
China,2009-08-01,88,0,-11,53,10,140
China,2009-08-01,117,6,-10,53,11,177
Egypt,2009-08-01,11,0,0,7,0,18
Egypt,2009-08-01,11,0,0,15,2,28
Egypt,2009-08-01,20,0,0,4,1,25
Egypt,2009-08-01,46,0,0,22,2,70
Egypt,2009-08-01,33,0,0,18,9,60
Egypt,2009-08-01,3,0,0,19,0,22
Egypt,2009-08-01,13,0,0,30,1,44
Egypt,2009-08-01,15,0,0,-2,6,19
Egypt,2009-08-01,18,0,0,3,0,21
Egypt,2009-08-01,35,0,0,5,0,40
Egypt,2009-08-01,17,0,0,25,0,42
Egypt,2009-08-01,16,0,0,18,0,34
Egypt,2009-08-01,11,0,1,1,0,13
Egypt,2009-08-01,138,0,1,8,13,160
Egypt,2009-08-01,335,0,2,2,26,365
Egypt,2009-08-01,37,0,0,6,6,49
Egypt,2009-08-01,74,0,3,3,3,83
Egypt,2009-08-01,29,2,0,16,4,51
Egypt,2009-08-01,38,0,0,10,0,48
Egypt,2009-08-01,9,0,2,1,4,16
Egypt,2009-08-01,23,0,0,12,0,35
Egypt,2009-08-01,5,0,0,9,2,16
Egypt,2009-08-01,25,0,0,-3,5,27
Egypt,2009-08-01,39,0,0,1,3,43
Egypt,2009-08-01,77,6,0,7,2,92
Egypt,2009-08-01,27,0,0,5,2,34
Egypt,2009-08-01,1,4,0,-2,1,4
Egypt,2009-08-01,20,0,0,15,1,36
Egypt,2009-08-01,36,0,0,3,0,39
Egypt,2009-08-01,8,0,0,1,2,11
Egypt,2009-08-01,7,0,0,17,1,25
Eritrea,2009-08-01,6,0,0,15,1,22
Eritrea,2009-08-01,0,0,0,-2,0,-2
Eritrea,2009-08-01,0,0,0,0,1,1
Eritrea,2009-08-01,3,0,0,0,0,3
Eritrea,2009-08-01,7,0,0,0,0,7
Eritrea,2009-08-01,27,0,0,6,0,33
Eritrea,2009-08-01,22,0,0,0,0,22
Eritrea,2009-08-01,24,0,0,6,0,30
Eritrea,2009-08-01,23,0,0,3,0,26
Eritrea,2009-08-01,12,0,0,0,0,12
Eritrea,2009-08-01,0,0,0,0,0,0
Eritrea,2009-08-01,3,0,0,0,0,3
Eritrea,2009-08-01,0,0,0,0,0,0
Eritrea,2009-08-01,0,0,0,0,0,0
Eritrea,2009-08-01,2,0,0,0,0,2
Eritrea,2009-08-01,8,0,0,0,0,8
Eritrea,2009-08-01,10,0,0,3,0,13
Eritrea,2009-08-01,0,0,0,0,0,0
Eritrea,2009-08-01,8,0,0,0,0,8
Eritrea,2009-08-01,7,0,0,1,0,8
Eritrea,2009-08-01,2,0,0,9,0,11
Eritrea,2009-08-01,2,0,0,-2,4,4
Eritrea,2009-08-01,1,0,0,7,0,8
Eritrea,2009-08-01,3,0,0,1,0,4
Eritrea,2009-08-01,3,0,0,0,0,3
Eritrea,2009-08-01,9,0,0,0,0,9
Eritrea,2009-08-01,0,0,0,0,0,0
Eritrea,2009-08-01,0,0,0,0,0,0
Eritrea,2009-08-01,4,0,0,0,0,4
Georgia,2009-08-01,-2,2,0,9,0,9
Georgia,2009-08-01,13,0,0,3,0,16
Georgia,2009-08-01,32,0,0,18,2,52
Georgia,2009-08-01,19,0,0,17,0,36
Georgia,2009-08-01,40,0,0,20,2,62
Georgia,2009-08-01,43,0,0,12,3,58
Georgia,2009-08-01,52,0,1,11,4,68
Georgia,2009-08-01,30,0,0,0,1,31
Georgia,2009-08-01,23,0,0,-1,2,24
Georgia,2009-08-01,4,0,0,-2,0,2
Georgia,2009-08-01,22,2,1,19,2,46
Georgia,2009-08-01,34,4,0,44,7,89
Georgia,2009-08-01,31,0,-1,40,5,75
Georgia,2009-08-01,24,0,0,21,3,48
Georgia,2009-08-01,5,0,0,3,4,12
Georgia,2009-08-01,7,0,0,0,0,7
Georgia,2009-08-01,31,0,1,60,3,95
Georgia,2009-08-01,42,0,0,49,9,100
Georgia,2009-08-01,30,0,-8,3,3,28
Georgia,2009-08-01,35,0,0,25,2,62
Georgia,2009-08-01,42,2,-4,42,6,88
Georgia,2009-08-01,18,0,2,39,4,63
Georgia,2009-08-01,3,0,0,12,0,15
Georgia,2009-08-01,21,0,0,17,3,41
Georgia,2009-08-01,11,0,0,-3,2,10
Georgia,2009-08-01,23,0,0,18,0,41
Georgia,2009-08-01,14,0,0,-1,0,13
Georgia,2009-08-01,13,0,0,29,2,44
Georgia,2009-08-01,17,0,1,-2,4,20
Georgia,2009-08-01,52,0,0,9,10,71
Georgia,2009-08-01,89,0,1,6,14,110
India,2009-08-01,37,0,0,3,13,53
India,2009-08-01,46,0,0,26,10,82
India,2009-08-01,51,0,-1,25,9,84
India,2009-08-01,56,2,0,4,2,64
India,2009-08-01,42,2,-1,6,1,50
India,2009-08-01,72,0,-3,9,4,82
India,2009-08-01,54,2,1,34,7,98
India,2009-08-01,35,8,-3,11,8,59
India,2009-08-01,45,0,0,-8,11,48
India,2009-08-01,25,6,0,-9,5,27
India,2009-08-01,64,0,0,46,9,119
India,2009-08-01,70,0,-2,34,6,108
India,2009-08-01,79,0,-1,7,5,90
India,2009-08-01,65,0,-1,14,4,82
India,2009-08-01,63,0,0,6,8,77
India,2009-08-01,41,0,-1,15,10,65
India,2009-08-01,37,2,0,13,6,58
India,2009-08-01,79,2,-7,6,4,84
India,2009-08-01,73,2,-2,29,5,107
India,2009-08-01,50,2,0,29,6,87
India,2009-08-01,77,0,-1,41,9,126
India,2009-08-01,42,0,0,11,7,60
India,2009-08-01,33,0,1,-1,9,42
India,2009-08-01,50,8,-3,-4,11,62
India,2009-08-01,48,0,-2,0,11,57
India,2009-08-01,54,2,1,18,15,90
India,2009-08-01,28,0,0,0,4,32
India,2009-08-01,56,2,-4,12,-1,65
India,2009-08-01,32,2,0,1,7,42
India,2009-08-01,55,0,4,1,4,64
India,2009-08-01,83,2,-1,18,17,119
Iran,2009-08-01,101,4,-1,208,8,320
Iran,2009-08-01,71,0,-2,308,9,386
Iran,2009-08-01,153,0,0,204,14,371
Iran,2009-08-01,162,0,2,121,19,304
Iran,2009-08-01,51,2,1,132,10,196
Iran,2009-08-01,63,0,-1,52,7,121
Iran,2009-08-01,48,0,-2,83,22,151
Iran,2009-08-01,11,0,2,3,1,17
Iran,2009-08-01,45,0,1,21,5,72
Iran,2009-08-01,39,0,4,45,10,98
Iran,2009-08-01,47,0,3,68,5,123
Iran,2009-08-01,39,0,-1,54,20,112
Iran,2009-08-01,69,0,1,50,10,130
Iran,2009-08-01,63,0,2,97,11,173
Iran,2009-08-01,88,0,1,119,10,218
Iran,2009-08-01,44,2,2,59,13,120
Iran,2009-08-01,51,0,3,20,1,75
Iran,2009-08-01,92,0,0,41,25,158
Iran,2009-08-01,150,0,0,34,28,212
Iran,2009-08-01,106,0,0,39,9,154
Iran,2009-08-01,75,0,0,22,4,101
Iran,2009-08-01,42,0,-2,15,3,58
Iran,2009-08-01,87,0,0,13,15,115
Iran,2009-08-01,100,0,2,47,16,165
Iran,2009-08-01,64,2,0,63,21,150
Iran,2009-08-01,75,0,-2,63,11,147
Iran,2009-08-01,24,0,1,18,1,44
Iran,2009-08-01,19,0,6,29,8,62
Iran,2009-08-01,73,0,0,24,1,98
Iran,2009-08-01,81,0,-1,16,4,100
Iran,2009-08-01,80,0,-4,2,8,86
Iraq,2009-08-01,97,0,1,110,9,217
Iraq,2009-08-01,113,0,0,83,7,203
Iraq,2009-08-01,181,0,2,51,10,244
Iraq,2009-08-01,160,2,1,65,2,230
Iraq,2009-08-01,125,0,-2,70,7,200
Iraq,2009-08-01,109,0,1,37,14,161
Iraq,2009-08-01,101,2,3,36,68,210
Iraq,2009-08-01,69,2,-2,20,10,99
Iraq,2009-08-01,96,2,-2,70,3,169
Iraq,2009-08-01,141,4,0,37,23,205
Iraq,2009-08-01,177,2,0,21,2,202
Iraq,2009-08-01,98,6,0,43,19,166
Iraq,2009-08-01,84,0,1,27,23,135
Iraq,2009-08-01,108,0,3,59,10,180
Iraq,2009-08-01,60,0,0,12,8,80
Iraq,2009-08-01,66,0,2,-2,1,67
Iraq,2009-08-01,110,0,0,9,14,133
Iraq,2009-08-01,42,0,0,24,6,72
Iraq,2009-08-01,145,0,-10,19,3,157
Iraq,2009-08-01,98,6,2,44,11,161
Iraq,2009-08-01,140,0,6,25,4,175
Iraq,2009-08-01,87,0,0,58,12,157
Iraq,2009-08-01,25,0,2,29,16,72
Iraq,2009-08-01,120,4,2,94,21,241
Iraq,2009-08-01,57,0,0,33,4,94
Iraq,2009-08-01,55,0,9,26,12,102
Iraq,2009-08-01,25,0,0,2,0,27
Iraq,2009-08-01,82,0,0,30,9,121
Iraq,2009-08-01,60,0,0,-16,10,54
Iraq,2009-08-01,19,0,0,8,21,48
Iraq,2009-08-01,94,2,0,16,7,119
Morocco,2009-08-01,12,0,1,3,0,16
Morocco,2009-08-01,7,0,0,33,0,40
Morocco,2009-08-01,1,0,0,66,0,67
Morocco,2009-08-01,0,0,-10,41,2,33
Morocco,2009-08-01,11,0,0,18,0,29
Morocco,2009-08-01,5,0,0,0,0,5
Morocco,2009-08-01,2,0,1,1,0,4
Morocco,2009-08-01,0,0,0,9,0,9
Morocco,2009-08-01,-5,0,0,12,0,7
Morocco,2009-08-01,3,2,0,59,2,66
Morocco,2009-08-01,0,0,0,9,1,10
Morocco,2009-08-01,5,0,0,3,1,9
Morocco,2009-08-01,2,0,0,21,0,23
Morocco,2009-08-01,2,0,0,-2,0,0
Morocco,2009-08-01,5,0,0,3,0,8
Morocco,2009-08-01,0,0,0,16,0,16
Morocco,2009-08-01,-1,0,0,3,0,2
Morocco,2009-08-01,6,0,0,0,1,7
Morocco,2009-08-01,1,0,0,0,3,4
Morocco,2009-08-01,2,0,0,3,1,6
Morocco,2009-08-01,3,0,0,13,1,17
Morocco,2009-08-01,0,0,0,-2,0,-2
Morocco,2009-08-01,0,0,0,9,0,9
Morocco,2009-08-01,0,0,0,3,1,4
Morocco,2009-08-01,-1,0,0,15,1,15
Morocco,2009-08-01,-1,0,0,18,0,17
Morocco,2009-08-01,0,0,0,9,0,9
Morocco,2009-08-01,-2,0,0,9,0,7
Morocco,2009-08-01,0,0,0,0,0,0
Morocco,2009-08-01,3,0,0,3,0,6
Morocco,2009-08-01,-3,0,0,24,1,22
Nigeria,2009-08-01,4,0,2,9,1,16
Nigeria,2009-08-01,21,0,0,15,-1,35
Nigeria,2009-08-01,34,0,-1,22,4,59
Nigeria,2009-08-01,36,0,-4,26,7,65
Nigeria,2009-08-01,37,0,0,24,1,62
Nigeria,2009-08-01,11,0,3,52,2,68
Nigeria,2009-08-01,16,0,0,6,0,22
Nigeria,2009-08-01,5,0,0,10,2,17
Nigeria,2009-08-01,11,0,-2,1,0,10
Nigeria,2009-08-01,5,0,0,6,4,15
Nigeria,2009-08-01,21,0,0,23,5,49
Nigeria,2009-08-01,24,0,-1,1,4,28
Nigeria,2009-08-01,31,0,0,13,15,59
Nigeria,2009-08-01,28,0,0,-11,7,24
Nigeria,2009-08-01,12,0,0,9,2,23
Nigeria,2009-08-01,35,0,-2,12,0,45
Nigeria,2009-08-01,30,0,0,34,2,66
Nigeria,2009-08-01,17,0,0,28,4,49
Nigeria,2009-08-01,20,0,1,8,4,33
Nigeria,2009-08-01,21,0,0,29,-2,48
Nigeria,2009-08-01,26,0,0,9,0,35
Nigeria,2009-08-01,24,2,0,-2,0,24
Nigeria,2009-08-01,11,0,0,11,1,23
Nigeria,2009-08-01,22,0,0,4,1,27
Nigeria,2009-08-01,7,2,0,6,14,29
Nigeria,2009-08-01,11,0,0,3,2,16
Nigeria,2009-08-01,1,0,0,-2,0,-1
Nigeria,2009-08-01,29,0,-1,20,2,50
Nigeria,2009-08-01,9,0,2,18,2,31
Nigeria,2009-08-01,26,0,1,6,0,33
Nigeria,2009-08-01,16,0,0,3,0,19
Pakistan,2009-08-01,99,0,0,46,9,154
Pakistan,2009-08-01,75,0,0,47,17,139
Pakistan,2009-08-01,107,0,-10,222,32,351
Pakistan,2009-08-01,110,0,-3,107,3,217
Pakistan,2009-08-01,147,0,-6,72,11,224
Pakistan,2009-08-01,105,0,1,76,12,194
Pakistan,2009-08-01,183,0,1,80,9,273
Pakistan,2009-08-01,218,0,1,6,10,235
Pakistan,2009-08-01,222,0,-1,50,18,289
Pakistan,2009-08-01,188,2,0,69,23,282
Pakistan,2009-08-01,96,0,0,8,12,116
Pakistan,2009-08-01,332,0,0,58,10,400
Pakistan,2009-08-01,82,0,-4,32,3,113
Pakistan,2009-08-01,91,0,9,47,6,153
Pakistan,2009-08-01,82,0,1,35,21,139
Pakistan,2009-08-01,55,0,2,12,13,82
Pakistan,2009-08-01,80,0,-2,22,7,107
Pakistan,2009-08-01,128,2,-2,58,14,200
Pakistan,2009-08-01,109,2,2,22,6,141
Pakistan,2009-08-01,106,0,1,24,7,138
Pakistan,2009-08-01,103,2,0,4,12,121
Pakistan,2009-08-01,41,0,0,17,4,62
Pakistan,2009-08-01,64,2,0,27,9,102
Pakistan,2009-08-01,134,4,0,67,12,217
Pakistan,2009-08-01,127,6,-5,68,6,202
Pakistan,2009-08-01,141,0,1,39,8,189
Pakistan,2009-08-01,25,0,-1,6,2,32
Pakistan,2009-08-01,134,2,-1,23,14,172
Pakistan,2009-08-01,73,2,0,26,5,106
Pakistan,2009-08-01,57,0,-1,11,24,91
Pakistan,2009-08-01,130,2,-2,25,16,171
Sierra Leone,2009-08-01,2,0,0,0,0,2
Sierra Leone,2009-08-01,0,0,0,0,0,0
Sierra Leone,2009-08-01,0,0,0,0,0,0
Sierra Leone,2009-08-01,0,0,0,-2,4,2
Sierra Leone,2009-08-01,2,0,0,3,2,7
Sierra Leone,2009-08-01,2,0,0,3,0,5
Sierra Leone,2009-08-01,0,0,0,2,0,2
Sierra Leone,2009-08-01,2,0,0,9,0,11
Sierra Leone,2009-08-01,2,0,0,0,1,3
Sierra Leone,2009-08-01,7,0,0,1,0,8
Sierra Leone,2009-08-01,11,0,0,-2,0,9
Sierra Leone,2009-08-01,11,0,0,0,0,11
Sierra Leone,2009-08-01,0,0,0,0,2,2
Sierra Leone,2009-08-01,0,0,0,0,0,0
Sierra Leone,2009-08-01,3,0,-2,0,1,2
Sierra Leone,2009-08-01,0,2,0,3,0,5
Sierra Leone,2009-08-01,-1,2,0,-4,0,-3
Sierra Leone,2009-08-01,3,2,-2,9,1,13
Sierra Leone,2009-08-01,3,0,0,-2,0,1
Sierra Leone,2009-08-01,3,0,0,-2,0,1
Sierra Leone,2009-08-01,0,0,0,0,0,0
Sierra Leone,2009-08-01,5,0,-4,3,2,6
Sierra Leone,2009-08-01,3,0,0,6,0,9
Sierra Leone,2009-08-01,1,0,0,0,0,1
Sierra Leone,2009-08-01,8,0,0,0,0,8
Sierra Leone,2009-08-01,0,0,0,0,0,0
Sierra Leone,2009-08-01,0,0,0,0,0,0
Sierra Leone,2009-08-01,0,0,0,0,0,0
Sierra Leone,2009-08-01,2,0,0,6,0,8
Sierra Leone,2009-08-01,1,0,0,0,0,1
Somalia,2009-08-01,30,0,0,9,5,44
Somalia,2009-08-01,14,0,0,4,3,21
Somalia,2009-08-01,140,0,-2,14,2,154
Somalia,2009-08-01,135,4,-4,75,9,219
Somalia,2009-08-01,61,0,0,40,3,104
Somalia,2009-08-01,164,0,2,20,8,194
Somalia,2009-08-01,75,4,0,21,15,115
Somalia,2009-08-01,7,0,0,31,0,38
Somalia,2009-08-01,9,0,0,11,0,20
Somalia,2009-08-01,30,2,0,-42,0,-10
Somalia,2009-08-01,46,0,0,12,4,62
Somalia,2009-08-01,74,2,0,56,6,138
Somalia,2009-08-01,49,0,0,80,9,138
Somalia,2009-08-01,44,0,1,51,0,96
Somalia,2009-08-01,37,0,0,-2,0,35
Somalia,2009-08-01,28,0,0,25,0,53
Somalia,2009-08-01,52,2,0,12,7,73
Somalia,2009-08-01,86,0,0,15,0,101
Somalia,2009-08-01,76,0,0,34,4,114
Somalia,2009-08-01,40,0,0,13,0,53
Somalia,2009-08-01,37,0,0,17,0,54
Somalia,2009-08-01,23,0,0,3,0,26
Somalia,2009-08-01,36,0,0,17,28,81
Somalia,2009-08-01,22,0,-1,20,8,49
Somalia,2009-08-01,16,0,0,29,2,47
Somalia,2009-08-01,39,0,0,18,0,57
Somalia,2009-08-01,39,0,-2,0,0,37
Somalia,2009-08-01,19,0,0,21,3,43
Somalia,2009-08-01,28,0,0,0,6,34
Somalia,2009-08-01,4,0,0,27,1,32
Somalia,2009-08-01,14,2,0,11,6,33
Syria,2009-08-01,1,0,2,16,0,19
Syria,2009-08-01,9,0,1,3,0,13
Syria,2009-08-01,-22,0,-3,12,1,-12
Syria,2009-08-01,22,0,0,3,0,25
Syria,2009-08-01,-2,0,0,8,8,14
Syria,2009-08-01,17,0,0,6,0,23
Syria,2009-08-01,4,0,0,3,0,7
Syria,2009-08-01,13,0,0,6,1,20
Syria,2009-08-01,44,0,0,-4,0,40
Syria,2009-08-01,12,0,0,-8,0,4
Syria,2009-08-01,21,0,0,-10,3,14
Syria,2009-08-01,29,0,0,6,5,40
Syria,2009-08-01,37,0,0,9,0,46
Syria,2009-08-01,22,0,0,0,5,27
Syria,2009-08-01,171,0,0,3,7,181
Syria,2009-08-01,53,0,0,0,0,53
Syria,2009-08-01,21,0,0,-9,3,15
Syria,2009-08-01,8,0,1,6,0,15
Syria,2009-08-01,33,0,0,11,0,44
Syria,2009-08-01,14,0,1,15,3,33
Syria,2009-08-01,0,0,1,-1,0,0
Syria,2009-08-01,6,0,1,12,0,19
Syria,2009-08-01,7,0,0,-6,0,1
Syria,2009-08-01,4,0,0,12,0,16
Syria,2009-08-01,24,0,1,6,3,34
Syria,2009-08-01,75,0,1,28,3,107
Syria,2009-08-01,4,0,0,0,0,4
Syria,2009-08-01,22,0,0,0,1,23
Syria,2009-08-01,51,0,0,0,2,53
Syria,2009-08-01,33,0,0,-3,3,33
Syria,2009-08-01,12,0,0,27,1,40
Yemen,2009-08-01,0,0,0,1,0,1
Yemen,2009-08-01,0,0,0,-1,3,2
Yemen,2009-08-01,22,0,0,8,0,30
Yemen,2009-08-01,22,2,0,12,0,36
Yemen,2009-08-01,0,0,0,0,0,0
Yemen,2009-08-01,22,0,0,0,0,22
Yemen,2009-08-01,16,0,0,37,1,54
Yemen,2009-08-01,-2,0,0,15,0,13
Yemen,2009-08-01,1,0,0,-2,0,-1
Yemen,2009-08-01,12,0,0,9,0,21
Yemen,2009-08-01,38,0,0,19,1,58
Yemen,2009-08-01,29,0,0,12,0,41
Yemen,2009-08-01,6,0,0,-3,2,5
Yemen,2009-08-01,14,0,0,11,2,27
Yemen,2009-08-01,14,0,0,-5,2,11
Yemen,2009-08-01,9,0,0,0,1,10
Yemen,2009-08-01,37,0,0,9,0,46
Yemen,2009-08-01,16,0,0,-1,2,17
Yemen,2009-08-01,18,0,0,43,7,68
Yemen,2009-08-01,9,0,0,2,0,11
Yemen,2009-08-01,13,0,0,-1,17,29
Yemen,2009-08-01,-4,0,0,-3,24,17
Yemen,2009-08-01,25,0,0,-5,9,29
Yemen,2009-08-01,31,0,0,-14,0,17
Yemen,2009-08-01,19,0,0,5,0,24
Yemen,2009-08-01,40,0,0,-2,2,40
Yemen,2009-08-01,65,0,0,2,5,72
Yemen,2009-08-01,58,0,0,9,22,89
Yemen,2009-08-01,6,0,0,0,14,20
Yemen,2009-08-01,16,0,0,2,12,30
Yemen,2009-08-01,26,0,0,1,0,27
Afghanistan,2007-07-01,124,0,0,26,7,157
Afghanistan,2007-07-01,235,2,0,16,16,269
Afghanistan,2007-07-01,162,0,1,43,10,216
Afghanistan,2007-07-01,321,0,0,94,27,442
Afghanistan,2007-07-01,125,6,0,61,14,206
Afghanistan,2007-07-01,89,0,0,10,19,118
Afghanistan,2007-07-01,105,0,0,13,38,156
Afghanistan,2007-07-01,100,0,0,19,23,142
Afghanistan,2007-07-01,131,0,0,13,7,151
Afghanistan,2007-07-01,100,0,0,11,14,125
Afghanistan,2007-07-01,120,2,-2,4,9,133
Afghanistan,2007-07-01,104,0,0,15,21,140
Afghanistan,2007-07-01,113,2,-2,54,10,177
Afghanistan,2007-07-01,170,0,-3,24,47,238
Afghanistan,2007-07-01,196,0,0,-4,30,222
Afghanistan,2007-07-01,121,0,0,12,6,139
Afghanistan,2007-07-01,129,0,-8,-4,19,136
Afghanistan,2007-07-01,103,0,0,8,28,139
Afghanistan,2007-07-01,77,2,-3,18,4,98
Afghanistan,2007-07-01,112,6,0,92,32,242
Afghanistan,2007-07-01,150,0,1,18,3,172
Afghanistan,2007-07-01,107,0,0,-3,0,104
Afghanistan,2007-07-01,169,0,0,24,3,196
Afghanistan,2007-07-01,205,0,1,31,20,257
Afghanistan,2007-07-01,247,0,1,10,9,267
Afghanistan,2007-07-01,199,0,-1,36,4,238
Afghanistan,2007-07-01,125,0,2,30,11,168
Afghanistan,2007-07-01,88,0,1,18,10,117
Afghanistan,2007-07-01,100,0,-2,-6,14,106
Afghanistan,2007-07-01,221,0,-3,67,12,297
Afghanistan,2007-07-01,102,4,1,94,17,218
Albania,2007-07-01,2,0,0,0,0,2
Albania,2007-07-01,26,0,0,0,3,29
Albania,2007-07-01,27,0,0,1,4,32
Albania,2007-07-01,23,0,-1,-2,1,21
Albania,2007-07-01,0,0,0,-1,4,3
Albania,2007-07-01,10,0,-1,0,1,10
Albania,2007-07-01,2,0,-1,9,0,10
Albania,2007-07-01,17,0,-4,6,0,19
Albania,2007-07-01,35,0,-5,22,2,54
Albania,2007-07-01,5,0,-5,6,3,9
Albania,2007-07-01,27,0,-2,0,0,25
Albania,2007-07-01,41,0,0,0,2,43
Albania,2007-07-01,9,0,-1,6,3,17
Albania,2007-07-01,23,0,-1,0,4,26
Albania,2007-07-01,2,0,0,0,4,6
Albania,2007-07-01,10,0,-3,3,0,10
Albania,2007-07-01,33,0,-5,7,0,35
Albania,2007-07-01,23,0,-4,18,0,37
Albania,2007-07-01,20,0,-1,3,0,22
Albania,2007-07-01,41,0,-15,-3,0,23
Albania,2007-07-01,15,0,0,0,-6,9
Albania,2007-07-01,2,0,0,0,0,2
Albania,2007-07-01,0,0,0,0,0,0
Albania,2007-07-01,14,0,-4,0,0,10
Albania,2007-07-01,5,0,-3,0,2,4
Albania,2007-07-01,8,0,0,0,1,9
Albania,2007-07-01,8,0,-2,-2,0,4
Albania,2007-07-01,8,0,1,3,0,12
Albania,2007-07-01,0,0,0,0,0,0
Albania,2007-07-01,7,0,-3,0,0,4
Albania,2007-07-01,1,0,0,16,8,25
Algeria,2007-07-01,5,0,0,6,0,11
Algeria,2007-07-01,5,0,0,12,1,18
Algeria,2007-07-01,3,0,-1,6,0,8
Algeria,2007-07-01,2,0,0,0,0,2
Algeria,2007-07-01,22,0,0,8,1,31
Algeria,2007-07-01,0,0,0,6,0,6
Algeria,2007-07-01,2,0,0,0,0,2
Algeria,2007-07-01,4,0,0,-1,0,3
Algeria,2007-07-01,7,0,0,6,0,13
Algeria,2007-07-01,11,0,0,3,3,17
Algeria,2007-07-01,17,0,-1,0,0,16
Algeria,2007-07-01,6,0,0,0,0,6
Algeria,2007-07-01,12,0,0,24,1,37
Algeria,2007-07-01,0,0,0,0,0,0
Algeria,2007-07-01,0,0,0,0,0,0
Algeria,2007-07-01,2,2,0,0,0,4
Algeria,2007-07-01,2,0,0,0,3,5
Algeria,2007-07-01,2,0,0,0,0,2
Algeria,2007-07-01,15,0,0,1,0,16
Algeria,2007-07-01,0,0,0,0,0,0
Algeria,2007-07-01,0,0,0,0,0,0
Algeria,2007-07-01,0,0,0,0,0,0
Algeria,2007-07-01,15,0,0,0,3,18
Algeria,2007-07-01,12,0,0,0,6,18
Algeria,2007-07-01,0,0,0,0,3,3
Algeria,2007-07-01,0,0,0,6,0,6
Algeria,2007-07-01,3,0,0,6,0,9
Algeria,2007-07-01,1,0,0,0,0,1
Algeria,2007-07-01,6,0,0,0,0,6
Algeria,2007-07-01,8,0,0,9,3,20
Algeria,2007-07-01,4,0,0,0,1,5
Bangladesh,2007-07-01,10,0,-2,-4,0,4
Bangladesh,2007-07-01,3,0,0,0,1,4
Bangladesh,2007-07-01,9,0,0,12,0,21
Bangladesh,2007-07-01,-1,4,0,31,3,37
Bangladesh,2007-07-01,2,0,0,23,0,25
Bangladesh,2007-07-01,1,0,0,1,0,2
Bangladesh,2007-07-01,2,0,0,3,0,5
Bangladesh,2007-07-01,0,0,0,0,2,2
Bangladesh,2007-07-01,0,0,0,0,0,0
Bangladesh,2007-07-01,7,4,0,3,0,14
Bangladesh,2007-07-01,2,0,0,12,0,14
Bangladesh,2007-07-01,11,0,0,3,0,14
Bangladesh,2007-07-01,3,0,0,0,0,3
Bangladesh,2007-07-01,9,0,0,6,1,16
Bangladesh,2007-07-01,6,0,-4,6,3,11
Bangladesh,2007-07-01,21,0,0,18,1,40
Bangladesh,2007-07-01,10,0,-4,12,2,20
Bangladesh,2007-07-01,4,0,0,-4,0,0
Bangladesh,2007-07-01,5,0,2,-1,2,8
Bangladesh,2007-07-01,6,0,0,0,0,6
Bangladesh,2007-07-01,2,0,0,7,9,18
Bangladesh,2007-07-01,8,0,0,24,1,33
Bangladesh,2007-07-01,4,0,0,0,0,4
Bangladesh,2007-07-01,4,0,0,0,0,4
Bangladesh,2007-07-01,9,0,2,15,0,26
Bangladesh,2007-07-01,18,0,0,21,6,45
Bangladesh,2007-07-01,5,0,0,18,0,23
Bangladesh,2007-07-01,-3,0,0,9,0,6
Bangladesh,2007-07-01,3,0,0,12,0,15
Bangladesh,2007-07-01,1,0,0,23,0,24
Bangladesh,2007-07-01,4,0,0,-2,1,3
Cameroon,2007-07-01,0,2,0,0,0,2
Cameroon,2007-07-01,7,0,0,6,0,13
Cameroon,2007-07-01,0,0,0,0,0,0
Cameroon,2007-07-01,0,0,0,0,0,0
Cameroon,2007-07-01,0,0,0,0,0,0
Cameroon,2007-07-01,0,0,0,0,0,0
Cameroon,2007-07-01,0,0,0,0,0,0
Cameroon,2007-07-01,1,0,0,0,0,1
Cameroon,2007-07-01,0,0,0,0,0,0
Cameroon,2007-07-01,0,0,0,3,0,3
Cameroon,2007-07-01,0,0,0,0,0,0
Cameroon,2007-07-01,24,0,0,0,0,24
Cameroon,2007-07-01,0,0,0,-2,0,-2
Cameroon,2007-07-01,0,0,0,0,0,0
Cameroon,2007-07-01,0,0,0,0,1,1
Cameroon,2007-07-01,0,0,0,0,0,0
Cameroon,2007-07-01,2,0,0,0,0,2
Cameroon,2007-07-01,1,0,0,0,1,2
Cameroon,2007-07-01,0,0,0,0,0,0
China,2007-07-01,51,4,0,7,3,65
China,2007-07-01,34,2,0,30,2,68
China,2007-07-01,114,0,-3,42,26,179
China,2007-07-01,37,0,-4,29,8,70
China,2007-07-01,124,0,0,51,11,186
China,2007-07-01,63,0,-1,54,18,134
China,2007-07-01,21,0,0,16,6,43
China,2007-07-01,117,0,0,15,3,135
China,2007-07-01,152,0,2,38,5,197
China,2007-07-01,113,2,0,24,8,147
China,2007-07-01,96,0,-4,3,21,116
China,2007-07-01,135,0,0,57,6,198
China,2007-07-01,66,0,0,20,10,96
China,2007-07-01,27,0,0,12,0,39
China,2007-07-01,29,0,-2,3,7,37
China,2007-07-01,40,0,6,-9,3,40
China,2007-07-01,27,2,0,35,13,77
China,2007-07-01,12,2,1,24,8,47
China,2007-07-01,214,0,0,16,54,284
China,2007-07-01,123,0,0,24,25,172
China,2007-07-01,48,0,0,6,9,63
China,2007-07-01,23,0,0,6,9,38
China,2007-07-01,33,0,0,0,12,45
China,2007-07-01,256,0,1,5,7,269
China,2007-07-01,54,0,0,23,3,80
China,2007-07-01,83,0,1,27,10,121
China,2007-07-01,91,12,-8,18,41,154
China,2007-07-01,31,0,0,6,5,42
China,2007-07-01,4,0,-4,1,0,1
China,2007-07-01,38,0,-8,2,5,37
China,2007-07-01,49,4,-1,22,5,79
Egypt,2007-07-01,22,0,0,-14,1,9
Egypt,2007-07-01,52,4,0,19,1,76
Egypt,2007-07-01,24,0,0,3,0,27
Egypt,2007-07-01,7,0,0,5,0,12
Egypt,2007-07-01,22,0,0,11,0,33
Egypt,2007-07-01,9,0,0,16,1,26
Egypt,2007-07-01,7,0,0,-6,0,1
Egypt,2007-07-01,15,0,0,-13,0,2
Egypt,2007-07-01,23,0,0,-13,0,10
Egypt,2007-07-01,42,0,0,20,7,69
Egypt,2007-07-01,27,0,0,18,0,45
Egypt,2007-07-01,8,0,0,16,0,24
Egypt,2007-07-01,8,0,0,9,1,18
Egypt,2007-07-01,1,0,0,9,1,11
Egypt,2007-07-01,9,0,0,9,0,18
Egypt,2007-07-01,4,0,0,6,8,18
Egypt,2007-07-01,29,0,0,5,2,36
Egypt,2007-07-01,2,0,0,12,6,20
Egypt,2007-07-01,27,0,2,4,5,38
Egypt,2007-07-01,5,0,0,7,0,12
Egypt,2007-07-01,-1,0,0,-4,1,-4
Egypt,2007-07-01,25,0,0,10,6,41
Egypt,2007-07-01,30,0,0,4,0,34
Egypt,2007-07-01,4,4,0,1,0,9
Egypt,2007-07-01,12,0,0,0,0,12
Egypt,2007-07-01,30,0,0,-2,4,32
Egypt,2007-07-01,24,0,-2,0,1,23
Egypt,2007-07-01,39,0,2,6,2,49
Egypt,2007-07-01,3,0,0,0,0,3
Egypt,2007-07-01,77,6,-1,16,10,108
Egypt,2007-07-01,9,0,0,3,1,13
Eritrea,2007-07-01,8,0,0,0,0,8
Eritrea,2007-07-01,6,0,0,12,1,19
Eritrea,2007-07-01,0,0,0,0,1,1
Eritrea,2007-07-01,3,0,0,6,0,9
Eritrea,2007-07-01,3,0,0,-2,0,1
Eritrea,2007-07-01,0,0,0,0,0,0
Eritrea,2007-07-01,0,0,0,15,0,15
Eritrea,2007-07-01,1,0,0,6,0,7
Eritrea,2007-07-01,2,0,0,18,0,20
Eritrea,2007-07-01,6,0,0,12,0,18
Eritrea,2007-07-01,0,0,0,3,0,3
Eritrea,2007-07-01,2,0,0,0,2,4
Eritrea,2007-07-01,3,0,0,0,0,3
Eritrea,2007-07-01,5,0,0,3,2,10
Eritrea,2007-07-01,3,0,0,0,0,3
Eritrea,2007-07-01,14,0,0,0,0,14
Eritrea,2007-07-01,0,0,0,0,0,0
Eritrea,2007-07-01,0,0,0,0,0,0
Eritrea,2007-07-01,2,0,0,0,0,2
Eritrea,2007-07-01,0,0,0,3,0,3
Eritrea,2007-07-01,-8,0,0,0,0,-8
Eritrea,2007-07-01,2,0,0,0,0,2
Eritrea,2007-07-01,4,0,0,0,0,4
Eritrea,2007-07-01,12,0,0,-2,0,10
Eritrea,2007-07-01,11,0,0,0,0,11
Eritrea,2007-07-01,1,0,0,0,0,1
Georgia,2007-07-01,1,0,0,3,0,4
Georgia,2007-07-01,8,0,0,12,0,20
Georgia,2007-07-01,12,0,0,15,0,27
Georgia,2007-07-01,0,0,0,0,0,0
Georgia,2007-07-01,6,0,0,0,0,6
Georgia,2007-07-01,5,0,0,3,0,8
Georgia,2007-07-01,1,0,0,3,1,5
Georgia,2007-07-01,0,0,0,0,0,0
Georgia,2007-07-01,1,0,0,0,0,1
Georgia,2007-07-01,1,0,0,1,1,3
Georgia,2007-07-01,11,0,0,-4,0,7
Georgia,2007-07-01,3,0,0,6,0,9
Georgia,2007-07-01,4,0,0,3,0,7
Georgia,2007-07-01,17,0,0,0,1,18
Georgia,2007-07-01,6,2,0,3,0,11
Georgia,2007-07-01,27,0,0,3,1,31
Georgia,2007-07-01,6,0,0,6,1,13
Georgia,2007-07-01,1,0,0,6,0,7
Georgia,2007-07-01,0,0,0,1,0,1
Georgia,2007-07-01,2,0,0,8,0,10
Georgia,2007-07-01,4,0,0,1,2,7
Georgia,2007-07-01,2,0,0,3,0,5
Georgia,2007-07-01,1,0,0,6,2,9
Georgia,2007-07-01,2,0,0,3,6,11
Georgia,2007-07-01,1,0,0,-1,0,0
Georgia,2007-07-01,0,0,0,0,0,0
Georgia,2007-07-01,0,0,0,0,0,0
Georgia,2007-07-01,0,0,0,1,3,4
Georgia,2007-07-01,3,0,0,-2,2,3
India,2007-07-01,26,0,0,8,5,39
India,2007-07-01,26,0,0,3,4,33
India,2007-07-01,29,0,1,29,7,66
India,2007-07-01,18,0,0,32,3,53
India,2007-07-01,18,0,0,18,2,38
India,2007-07-01,37,0,0,16,2,55
India,2007-07-01,41,0,1,15,3,60
India,2007-07-01,10,0,1,-2,1,10
India,2007-07-01,29,2,1,22,2,56
India,2007-07-01,19,0,0,13,3,35
India,2007-07-01,15,0,1,27,9,52
India,2007-07-01,16,2,0,11,2,31
India,2007-07-01,24,0,0,53,6,83
India,2007-07-01,12,0,0,26,12,50
India,2007-07-01,14,0,0,26,3,43
India,2007-07-01,15,0,0,23,5,43
India,2007-07-01,20,0,0,16,3,39
India,2007-07-01,2,0,0,3,0,5
India,2007-07-01,25,2,0,2,6,35
India,2007-07-01,11,0,1,22,9,43
India,2007-07-01,23,0,0,3,0,26
India,2007-07-01,29,0,0,9,0,38
India,2007-07-01,3,0,0,9,2,14
India,2007-07-01,22,0,2,7,1,32
India,2007-07-01,19,0,-2,9,4,30
India,2007-07-01,52,0,0,30,15,97
India,2007-07-01,58,4,0,33,8,103
India,2007-07-01,16,2,-2,30,3,49
India,2007-07-01,16,0,1,9,0,26
India,2007-07-01,31,0,0,9,2,42
India,2007-07-01,18,0,1,14,2,35
Iran,2007-07-01,43,2,0,3,4,52
Iran,2007-07-01,60,0,-2,10,0,68
Iran,2007-07-01,31,0,-2,27,5,61
Iran,2007-07-01,26,0,1,40,2,69
Iran,2007-07-01,29,0,1,12,0,42
Iran,2007-07-01,41,0,0,6,15,62
Iran,2007-07-01,70,0,0,37,27,134
Iran,2007-07-01,66,0,0,15,3,84
Iran,2007-07-01,42,0,0,13,0,55
Iran,2007-07-01,29,2,0,35,13,79
Iran,2007-07-01,33,0,0,15,4,52
Iran,2007-07-01,29,0,0,12,0,41
Iran,2007-07-01,54,0,0,6,0,60
Iran,2007-07-01,23,0,0,4,1,28
Iran,2007-07-01,26,0,0,6,6,38
Iran,2007-07-01,38,2,0,37,4,81
Iran,2007-07-01,84,0,0,34,35,153
Iran,2007-07-01,22,0,0,4,12,38
Iran,2007-07-01,29,0,0,27,0,56
Iran,2007-07-01,21,0,1,13,3,38
Iran,2007-07-01,30,0,0,9,3,42
Iran,2007-07-01,36,0,0,20,1,57
Iran,2007-07-01,35,0,0,18,5,58
Iran,2007-07-01,34,0,-4,57,4,91
Iran,2007-07-01,32,0,0,9,13,54
Iran,2007-07-01,-4,0,1,13,6,16
Iran,2007-07-01,31,0,0,18,9,58
Iran,2007-07-01,7,0,0,6,0,13
Iran,2007-07-01,19,0,0,6,2,27
Iran,2007-07-01,36,0,0,42,2,80
Iran,2007-07-01,31,0,3,24,4,62
Iraq,2007-07-01,48,0,-2,29,20,95
Iraq,2007-07-01,173,4,0,111,17,305
Iraq,2007-07-01,158,4,-4,150,49,357
Iraq,2007-07-01,77,0,4,68,18,167
Iraq,2007-07-01,139,4,1,58,12,214
Iraq,2007-07-01,138,0,-2,112,9,257
Iraq,2007-07-01,67,4,-4,84,9,160
Iraq,2007-07-01,137,0,-2,49,11,195
Iraq,2007-07-01,201,2,-5,135,27,360
Iraq,2007-07-01,205,8,-10,56,21,280
Iraq,2007-07-01,204,0,-5,111,15,325
Iraq,2007-07-01,253,8,5,85,31,382
Iraq,2007-07-01,207,0,-3,85,19,308
Iraq,2007-07-01,77,4,-1,37,13,130
Iraq,2007-07-01,147,0,0,26,17,190
Iraq,2007-07-01,131,2,-3,24,24,178
Iraq,2007-07-01,195,0,-12,62,13,258
Iraq,2007-07-01,119,4,0,57,9,189
Iraq,2007-07-01,257,0,-2,53,17,325
Iraq,2007-07-01,188,0,-5,32,11,226
Iraq,2007-07-01,171,40,3,32,6,252
Iraq,2007-07-01,133,0,4,49,7,193
Iraq,2007-07-01,39,0,8,0,1,48
Iraq,2007-07-01,136,4,7,69,35,251
Iraq,2007-07-01,81,0,-1,63,5,148
Iraq,2007-07-01,280,12,1,-7,44,330
Iraq,2007-07-01,124,2,5,6,3,140
Iraq,2007-07-01,21,0,0,6,8,35
Iraq,2007-07-01,39,4,-2,14,5,60
Iraq,2007-07-01,143,2,-3,32,9,183
Iraq,2007-07-01,173,4,-2,6,13,194
Morocco,2007-07-01,0,0,0,0,0,0
Morocco,2007-07-01,21,0,-2,21,6,46
Morocco,2007-07-01,7,0,0,2,2,11
Morocco,2007-07-01,8,0,0,0,3,11
Morocco,2007-07-01,16,0,0,24,0,40
Morocco,2007-07-01,9,0,0,15,0,24
Morocco,2007-07-01,0,2,0,0,0,2
Morocco,2007-07-01,0,0,0,0,0,0
Morocco,2007-07-01,0,0,0,-2,0,-2
Morocco,2007-07-01,10,0,0,0,0,10
Morocco,2007-07-01,6,0,-2,6,2,12
Morocco,2007-07-01,3,0,0,3,0,6
Morocco,2007-07-01,5,0,0,15,0,20
Morocco,2007-07-01,11,0,0,4,0,15
Morocco,2007-07-01,24,0,0,0,0,24
Morocco,2007-07-01,0,0,0,0,0,0
Morocco,2007-07-01,0,0,1,-2,0,-1
Morocco,2007-07-01,10,0,0,9,1,20
Morocco,2007-07-01,0,0,0,12,0,12
Morocco,2007-07-01,2,0,0,0,0,2
Morocco,2007-07-01,6,0,0,45,0,51
Morocco,2007-07-01,5,0,0,30,0,35
Morocco,2007-07-01,2,0,0,0,0,2
Morocco,2007-07-01,4,0,0,6,0,10
Morocco,2007-07-01,13,0,0,8,0,21
Morocco,2007-07-01,0,0,0,9,0,9
Morocco,2007-07-01,6,0,0,0,0,6
Morocco,2007-07-01,3,0,0,0,0,3
Morocco,2007-07-01,0,0,0,0,0,0
Morocco,2007-07-01,0,0,0,12,0,12
Morocco,2007-07-01,0,0,0,6,0,6
Nigeria,2007-07-01,2,0,1,0,0,3
Nigeria,2007-07-01,10,0,0,3,0,13
Nigeria,2007-07-01,6,0,0,-4,4,6
Nigeria,2007-07-01,10,0,0,9,0,19
Nigeria,2007-07-01,1,0,0,27,0,28
Nigeria,2007-07-01,15,0,0,7,2,24
Nigeria,2007-07-01,8,0,0,2,0,10
Nigeria,2007-07-01,0,0,0,8,0,8
Nigeria,2007-07-01,6,0,0,18,1,25
Nigeria,2007-07-01,9,0,0,12,0,21
Nigeria,2007-07-01,10,0,0,9,0,19
Nigeria,2007-07-01,3,6,-4,6,0,11
Nigeria,2007-07-01,4,4,-2,21,0,27
Nigeria,2007-07-01,5,0,0,12,0,17
Nigeria,2007-07-01,1,0,1,3,0,5
Nigeria,2007-07-01,5,0,-1,0,5,9
Nigeria,2007-07-01,8,0,0,1,3,12
Nigeria,2007-07-01,0,0,0,0,0,0
Nigeria,2007-07-01,7,0,0,6,0,13
Nigeria,2007-07-01,24,0,0,9,8,41
Nigeria,2007-07-01,12,0,-2,0,0,10
Nigeria,2007-07-01,8,0,0,-2,0,6
Nigeria,2007-07-01,0,0,0,6,0,6
Nigeria,2007-07-01,33,0,0,21,0,54
Nigeria,2007-07-01,19,0,0,9,7,35
Nigeria,2007-07-01,2,0,0,13,0,15
Nigeria,2007-07-01,6,0,0,-2,0,4
Nigeria,2007-07-01,5,0,0,0,0,5
Nigeria,2007-07-01,7,0,0,3,0,10
Nigeria,2007-07-01,10,0,0,0,0,10
Nigeria,2007-07-01,6,0,0,-8,0,-2
Pakistan,2007-07-01,15,0,0,15,0,30
Pakistan,2007-07-01,26,0,-3,28,0,51
Pakistan,2007-07-01,37,0,1,16,2,56
Pakistan,2007-07-01,28,10,0,16,1,55
Pakistan,2007-07-01,109,0,0,51,6,166
Pakistan,2007-07-01,57,0,0,21,3,81
Pakistan,2007-07-01,63,0,3,-13,4,57
Pakistan,2007-07-01,20,0,4,3,2,29
Pakistan,2007-07-01,71,0,2,29,14,116
Pakistan,2007-07-01,165,0,0,2,23,190
Pakistan,2007-07-01,62,0,1,45,15,123
Pakistan,2007-07-01,52,0,0,9,1,62
Pakistan,2007-07-01,62,0,0,41,9,112
Pakistan,2007-07-01,73,0,0,18,12,103
Pakistan,2007-07-01,45,0,0,5,1,51
Pakistan,2007-07-01,36,0,0,21,0,57
Pakistan,2007-07-01,64,0,0,1,2,67
Pakistan,2007-07-01,7,0,0,9,3,19
Pakistan,2007-07-01,77,0,2,24,8,111
Pakistan,2007-07-01,26,0,0,18,0,44
Pakistan,2007-07-01,67,0,-2,18,1,84
Pakistan,2007-07-01,26,0,-1,29,1,55
Pakistan,2007-07-01,30,0,0,6,10,46
Pakistan,2007-07-01,16,0,0,30,0,46
Pakistan,2007-07-01,55,0,1,12,0,68
Pakistan,2007-07-01,30,0,2,14,0,46
Pakistan,2007-07-01,62,0,0,27,11,100
Pakistan,2007-07-01,66,0,0,9,6,81
Pakistan,2007-07-01,23,0,0,-2,0,21
Pakistan,2007-07-01,17,0,0,0,0,17
Pakistan,2007-07-01,26,0,0,12,6,44
Sierra Leone,2007-07-01,2,0,0,6,0,8
Sierra Leone,2007-07-01,6,0,0,9,3,18
Sierra Leone,2007-07-01,3,0,0,-3,0,0
Sierra Leone,2007-07-01,0,0,0,0,0,0
Sierra Leone,2007-07-01,3,0,0,0,0,3
Sierra Leone,2007-07-01,0,0,0,0,0,0
Sierra Leone,2007-07-01,17,0,0,0,0,17
Sierra Leone,2007-07-01,0,0,0,6,0,6
Sierra Leone,2007-07-01,3,0,0,0,0,3
Sierra Leone,2007-07-01,0,0,0,3,0,3
Sierra Leone,2007-07-01,26,0,0,6,0,32
Sierra Leone,2007-07-01,0,0,0,9,0,9
Sierra Leone,2007-07-01,0,0,0,6,0,6
Sierra Leone,2007-07-01,0,0,0,-3,0,-3
Sierra Leone,2007-07-01,0,0,0,0,0,0
Sierra Leone,2007-07-01,0,0,0,0,0,0
Sierra Leone,2007-07-01,0,0,0,9,0,9
Sierra Leone,2007-07-01,10,0,0,3,0,13
Sierra Leone,2007-07-01,1,0,0,3,0,4
Sierra Leone,2007-07-01,0,0,0,0,0,0
Sierra Leone,2007-07-01,4,0,0,0,0,4
Sierra Leone,2007-07-01,0,2,0,0,0,2
Sierra Leone,2007-07-01,0,0,0,0,0,0
Sierra Leone,2007-07-01,0,0,0,6,1,7
Sierra Leone,2007-07-01,0,2,0,0,0,2
Sierra Leone,2007-07-01,0,0,0,0,0,0
Sierra Leone,2007-07-01,0,0,0,0,0,0
Sierra Leone,2007-07-01,15,2,0,21,3,41
Sierra Leone,2007-07-01,3,0,0,9,0,12
Somalia,2007-07-01,0,0,0,0,0,0
Somalia,2007-07-01,-1,0,0,0,0,-1
Somalia,2007-07-01,21,14,0,0,0,35
Somalia,2007-07-01,7,0,0,24,0,31
Somalia,2007-07-01,0,0,0,0,0,0
Somalia,2007-07-01,0,0,2,0,0,2
Somalia,2007-07-01,2,0,0,6,0,8
Somalia,2007-07-01,1,0,0,0,0,1
Somalia,2007-07-01,2,0,0,27,0,29
Somalia,2007-07-01,28,0,0,10,0,38
Somalia,2007-07-01,7,0,0,3,0,10
Somalia,2007-07-01,17,0,0,7,0,24
Somalia,2007-07-01,10,0,0,0,0,10
Somalia,2007-07-01,3,0,0,0,0,3
Somalia,2007-07-01,3,0,0,0,0,3
Somalia,2007-07-01,3,0,0,0,0,3
Somalia,2007-07-01,-1,0,0,0,0,-1
Somalia,2007-07-01,1,0,0,0,0,1
Somalia,2007-07-01,9,0,0,0,0,9
Somalia,2007-07-01,29,0,0,30,2,61
Somalia,2007-07-01,3,0,0,12,0,15
Somalia,2007-07-01,3,0,0,15,1,19
Somalia,2007-07-01,0,0,0,6,1,7
Somalia,2007-07-01,10,0,0,0,0,10
Somalia,2007-07-01,11,0,0,13,0,24
Somalia,2007-07-01,21,0,0,6,0,27
Somalia,2007-07-01,53,0,0,0,0,53
Somalia,2007-07-01,5,0,0,0,0,5
Somalia,2007-07-01,0,0,0,0,0,0
Somalia,2007-07-01,16,0,0,3,0,19
Somalia,2007-07-01,5,0,0,0,0,5
Syria,2007-07-01,2,0,0,9,0,11
Syria,2007-07-01,53,0,0,4,0,57
Syria,2007-07-01,6,0,0,3,0,9
Syria,2007-07-01,8,0,0,-5,0,3
Syria,2007-07-01,15,0,0,0,9,24
Syria,2007-07-01,8,0,-8,8,0,8
Syria,2007-07-01,25,0,0,3,9,37
Syria,2007-07-01,8,0,-2,0,0,6
Syria,2007-07-01,81,0,2,3,1,87
Syria,2007-07-01,42,0,-3,3,0,42
Syria,2007-07-01,61,0,0,1,4,66
Syria,2007-07-01,42,0,-2,3,2,45
Syria,2007-07-01,61,0,0,9,2,72
Syria,2007-07-01,43,0,0,3,0,46
Syria,2007-07-01,23,0,0,33,2,58
Syria,2007-07-01,9,6,0,8,0,23
Syria,2007-07-01,18,4,0,-1,2,23
Syria,2007-07-01,17,0,0,3,0,20
Syria,2007-07-01,26,0,0,12,0,38
Syria,2007-07-01,25,2,0,0,0,27
Syria,2007-07-01,8,0,0,3,0,11
Syria,2007-07-01,-2,0,3,3,0,4
Syria,2007-07-01,6,0,0,0,0,6
Syria,2007-07-01,19,0,0,0,0,19
Syria,2007-07-01,9,0,0,15,0,24
Syria,2007-07-01,3,2,1,15,5,26
Syria,2007-07-01,10,0,0,0,2,12
Syria,2007-07-01,20,0,-4,0,16,32
Syria,2007-07-01,27,4,0,0,4,35
Syria,2007-07-01,49,0,-2,3,0,50
Syria,2007-07-01,21,0,0,0,0,21
Yemen,2007-07-01,6,0,0,0,5,11
Yemen,2007-07-01,21,0,0,3,24,48
Yemen,2007-07-01,23,0,0,1,15,39
Yemen,2007-07-01,1,0,0,6,3,10
Yemen,2007-07-01,-3,0,2,18,0,17
Yemen,2007-07-01,5,0,0,3,2,10
Yemen,2007-07-01,3,0,0,6,1,10
Yemen,2007-07-01,0,0,0,0,0,0
Yemen,2007-07-01,2,0,0,0,0,2
Yemen,2007-07-01,7,0,0,1,0,8
Yemen,2007-07-01,6,0,0,0,0,6
Yemen,2007-07-01,3,0,0,0,0,3
Yemen,2007-07-01,0,0,0,0,0,0
Yemen,2007-07-01,0,0,0,9,0,9
Yemen,2007-07-01,2,0,0,0,0,2
Yemen,2007-07-01,0,0,0,0,0,0
Yemen,2007-07-01,3,0,0,0,0,3
Yemen,2007-07-01,10,0,0,2,0,12
Yemen,2007-07-01,0,0,0,0,0,0
Yemen,2007-07-01,-4,0,0,0,0,-4
Yemen,2007-07-01,8,0,0,-2,0,6
Yemen,2007-07-01,5,0,0,0,2,7
Yemen,2007-07-01,0,0,0,0,0,0
Yemen,2007-07-01,0,0,0,0,0,0
Yemen,2007-07-01,2,0,0,0,0,2
Yemen,2007-07-01,0,0,0,0,0,0
Afghanistan,2007-06-01,93,2,0,23,0,118
Afghanistan,2007-06-01,51,0,0,18,5,74
Afghanistan,2007-06-01,37,0,0,9,4,50
Afghanistan,2007-06-01,129,0,0,110,10,249
Afghanistan,2007-06-01,176,0,0,138,6,320
Afghanistan,2007-06-01,116,0,-1,19,10,144
Afghanistan,2007-06-01,72,0,-4,45,14,127
Afghanistan,2007-06-01,47,0,1,17,5,70
Afghanistan,2007-06-01,57,0,0,46,0,103
Afghanistan,2007-06-01,84,0,0,15,6,105
Afghanistan,2007-06-01,78,0,0,17,5,100
Afghanistan,2007-06-01,126,4,0,54,14,198
Afghanistan,2007-06-01,152,2,-1,51,4,208
Afghanistan,2007-06-01,133,0,0,32,13,178
Afghanistan,2007-06-01,87,0,0,7,5,99
Afghanistan,2007-06-01,67,0,-2,7,11,83
Afghanistan,2007-06-01,91,0,0,-2,6,95
Afghanistan,2007-06-01,44,0,-2,38,4,84
Afghanistan,2007-06-01,164,0,0,20,20,204
Afghanistan,2007-06-01,172,0,0,59,17,248
Afghanistan,2007-06-01,150,2,0,4,5,161
Afghanistan,2007-06-01,134,0,-2,51,11,194
Afghanistan,2007-06-01,203,0,-4,19,31,249
Afghanistan,2007-06-01,84,0,-2,9,2,93
Afghanistan,2007-06-01,138,0,0,1,8,147
Afghanistan,2007-06-01,124,0,1,19,2,146
Afghanistan,2007-06-01,106,0,-2,20,4,128
Afghanistan,2007-06-01,52,0,-2,23,10,83
Afghanistan,2007-06-01,110,2,0,49,6,167
Afghanistan,2007-06-01,176,0,0,6,13,195
Albania,2007-06-01,22,0,-2,15,0,35
Albania,2007-06-01,3,0,1,6,1,11
Albania,2007-06-01,2,0,0,0,0,2
Albania,2007-06-01,2,0,0,0,1,3
Albania,2007-06-01,18,0,-7,4,6,21
Albania,2007-06-01,5,0,0,1,0,6
Albania,2007-06-01,7,0,0,6,5,18
Albania,2007-06-01,24,0,-1,6,1,30
Albania,2007-06-01,17,0,0,8,0,25
Albania,2007-06-01,5,0,-1,-2,3,5
Albania,2007-06-01,13,0,-3,1,5,16
Albania,2007-06-01,11,0,-3,1,8,17
Albania,2007-06-01,24,0,0,-1,0,23
Albania,2007-06-01,0,0,0,3,1,4
Albania,2007-06-01,4,0,0,0,0,4
Albania,2007-06-01,0,0,0,0,0,0
Albania,2007-06-01,12,0,0,30,0,42
Albania,2007-06-01,28,0,-7,5,0,26
Albania,2007-06-01,9,0,0,10,3,22
Albania,2007-06-01,17,0,0,30,7,54
Albania,2007-06-01,28,0,0,33,7,68
Albania,2007-06-01,13,0,0,11,0,24
Albania,2007-06-01,0,0,0,0,0,0
Albania,2007-06-01,3,0,-2,0,0,1
Albania,2007-06-01,17,0,-2,-2,0,13
Albania,2007-06-01,4,0,0,6,0,10
Albania,2007-06-01,3,0,-7,3,0,-1
Albania,2007-06-01,14,4,0,6,0,24
Albania,2007-06-01,7,0,-2,0,0,5
Albania,2007-06-01,10,0,-8,2,4,8
Algeria,2007-06-01,20,0,-2,0,0,18
Algeria,2007-06-01,6,0,-2,0,1,5
Algeria,2007-06-01,-2,0,0,0,3,1
Algeria,2007-06-01,0,0,0,0,0,0
Algeria,2007-06-01,4,0,0,0,0,4
Algeria,2007-06-01,2,0,-1,-2,0,-1
Algeria,2007-06-01,7,0,0,7,0,14
Algeria,2007-06-01,12,0,0,18,0,30
Algeria,2007-06-01,0,0,0,0,1,1
Algeria,2007-06-01,1,0,0,0,0,1
Algeria,2007-06-01,0,0,0,6,0,6
Algeria,2007-06-01,0,0,0,0,0,0
Algeria,2007-06-01,1,0,0,12,0,13
Algeria,2007-06-01,2,0,0,0,6,8
Algeria,2007-06-01,0,0,0,0,1,1
Algeria,2007-06-01,0,0,0,0,0,0
Algeria,2007-06-01,1,0,0,3,0,4
Algeria,2007-06-01,0,0,3,8,0,11
Algeria,2007-06-01,5,0,-2,0,3,6
Algeria,2007-06-01,3,0,-5,9,0,7
Algeria,2007-06-01,3,0,0,-4,0,-1
Algeria,2007-06-01,2,0,0,0,0,2
Algeria,2007-06-01,3,0,0,0,0,3
Algeria,2007-06-01,0,0,0,0,0,0
Algeria,2007-06-01,0,0,0,3,0,3
Algeria,2007-06-01,14,0,0,3,10,27
Algeria,2007-06-01,14,0,0,18,0,32
Algeria,2007-06-01,6,0,0,3,0,9
Algeria,2007-06-01,4,0,0,0,0,4
Algeria,2007-06-01,0,0,0,10,0,10
Bangladesh,2007-06-01,0,0,0,9,0,9
Bangladesh,2007-06-01,14,0,0,39,0,53
Bangladesh,2007-06-01,3,0,-4,-2,0,-3
Bangladesh,2007-06-01,0,0,-2,9,0,7
Bangladesh,2007-06-01,7,0,-2,0,0,5
Bangladesh,2007-06-01,1,0,0,3,0,4
Bangladesh,2007-06-01,8,0,-4,19,0,23
Bangladesh,2007-06-01,2,0,0,15,2,19
Bangladesh,2007-06-01,-1,0,0,2,0,1
Bangladesh,2007-06-01,2,0,0,6,0,8
Bangladesh,2007-06-01,-5,0,-2,6,2,1
Bangladesh,2007-06-01,7,0,0,7,3,17
Bangladesh,2007-06-01,17,0,0,9,1,27
Bangladesh,2007-06-01,9,0,-2,12,0,19
Bangladesh,2007-06-01,2,0,0,16,0,18
Bangladesh,2007-06-01,5,0,0,9,0,14
Bangladesh,2007-06-01,6,0,0,4,2,12
Bangladesh,2007-06-01,11,0,0,0,0,11
Bangladesh,2007-06-01,0,0,1,-2,0,-1
Bangladesh,2007-06-01,28,0,0,10,1,39
Bangladesh,2007-06-01,3,0,0,15,0,18
Bangladesh,2007-06-01,1,0,0,6,0,7
Bangladesh,2007-06-01,4,0,0,9,3,16
Bangladesh,2007-06-01,4,0,0,6,0,10
Bangladesh,2007-06-01,-2,0,-1,12,0,9
Bangladesh,2007-06-01,8,0,-6,9,0,11
Bangladesh,2007-06-01,26,0,-3,-2,0,21
Bangladesh,2007-06-01,16,0,0,7,1,24
Bangladesh,2007-06-01,5,0,0,3,0,8
Bangladesh,2007-06-01,1,0,-16,0,0,-15
Cameroon,2007-06-01,0,0,0,0,0,0
Cameroon,2007-06-01,1,0,0,4,0,5
Cameroon,2007-06-01,9,0,0,12,0,21
Cameroon,2007-06-01,5,0,0,0,0,5
Cameroon,2007-06-01,2,0,0,0,1,3
Cameroon,2007-06-01,0,0,0,0,0,0
Cameroon,2007-06-01,0,0,0,0,0,0
Cameroon,2007-06-01,3,0,0,0,0,3
Cameroon,2007-06-01,0,0,0,0,0,0
Cameroon,2007-06-01,1,0,0,0,0,1
Cameroon,2007-06-01,4,0,0,0,0,4
Cameroon,2007-06-01,0,0,0,6,0,6
Cameroon,2007-06-01,1,0,0,0,0,1
Cameroon,2007-06-01,0,0,0,0,0,0
Cameroon,2007-06-01,0,0,0,0,0,0
Cameroon,2007-06-01,0,0,0,0,0,0
Cameroon,2007-06-01,0,0,0,0,0,0
Cameroon,2007-06-01,3,0,0,0,0,3
Cameroon,2007-06-01,-2,0,0,0,0,-2
Cameroon,2007-06-01,2,0,0,0,0,2
Cameroon,2007-06-01,0,0,0,0,0,0
Cameroon,2007-06-01,0,0,0,9,0,9
Cameroon,2007-06-01,0,0,0,6,0,6
China,2007-06-01,42,0,0,24,7,73
China,2007-06-01,31,2,0,15,3,51
China,2007-06-01,46,4,0,29,16,95
China,2007-06-01,79,4,2,73,8,166
China,2007-06-01,40,8,-1,-1,6,52
China,2007-06-01,86,2,-1,24,3,114
China,2007-06-01,53,4,-13,0,3,47
China,2007-06-01,85,2,-3,28,6,118
China,2007-06-01,12,0,-1,40,3,54
China,2007-06-01,12,0,-1,-2,2,11
China,2007-06-01,62,0,0,37,7,106
China,2007-06-01,58,0,1,26,8,93
China,2007-06-01,51,0,-6,25,10,80
China,2007-06-01,93,0,0,46,1,140
China,2007-06-01,26,0,1,20,3,50
China,2007-06-01,28,0,0,-2,2,28
China,2007-06-01,18,0,1,9,3,31
China,2007-06-01,41,0,-3,2,4,44
China,2007-06-01,54,4,2,37,9,106
China,2007-06-01,26,0,0,29,7,62
China,2007-06-01,61,0,-1,22,5,87
China,2007-06-01,43,6,1,45,7,102
China,2007-06-01,51,8,0,3,4,66
China,2007-06-01,30,8,0,40,10,88
China,2007-06-01,67,8,-2,29,7,109
China,2007-06-01,28,4,-6,5,5,36
China,2007-06-01,47,0,2,28,8,85
China,2007-06-01,63,0,-5,27,7,92
China,2007-06-01,69,0,0,16,4,89
China,2007-06-01,35,4,0,48,5,92
Egypt,2007-06-01,19,0,0,3,3,25
Egypt,2007-06-01,3,0,0,-1,2,4
Egypt,2007-06-01,18,0,0,9,0,27
Egypt,2007-06-01,32,0,0,35,1,68
Egypt,2007-06-01,35,0,0,-4,0,31
Egypt,2007-06-01,7,0,0,31,0,38
Egypt,2007-06-01,21,0,0,18,11,50
Egypt,2007-06-01,53,0,3,27,1,84
Egypt,2007-06-01,48,0,0,26,3,77
Egypt,2007-06-01,59,0,0,2,7,68
Egypt,2007-06-01,66,0,1,15,9,91
Egypt,2007-06-01,57,0,0,6,12,75
Egypt,2007-06-01,127,0,-1,5,16,147
Egypt,2007-06-01,120,2,0,9,8,139
Egypt,2007-06-01,80,4,0,29,10,123
Egypt,2007-06-01,32,0,-1,2,6,39
Egypt,2007-06-01,21,0,0,4,0,25
Egypt,2007-06-01,51,0,0,0,1,52
Egypt,2007-06-01,48,0,0,0,0,48
Egypt,2007-06-01,24,0,0,0,3,27
Egypt,2007-06-01,41,0,0,20,4,65
Egypt,2007-06-01,15,0,3,6,2,26
Egypt,2007-06-01,50,0,0,-6,2,46
Egypt,2007-06-01,70,0,0,6,0,76
Egypt,2007-06-01,57,2,0,-10,0,49
Egypt,2007-06-01,30,2,0,-47,1,-14
Egypt,2007-06-01,22,0,1,6,15,44
Egypt,2007-06-01,44,0,0,15,10,69
Egypt,2007-06-01,27,0,0,16,4,47
Egypt,2007-06-01,42,0,0,27,0,69
Eritrea,2007-06-01,2,0,0,0,0,2
Eritrea,2007-06-01,3,0,0,0,0,3
Eritrea,2007-06-01,5,0,0,0,0,5
Eritrea,2007-06-01,0,0,0,0,0,0
Eritrea,2007-06-01,0,0,0,0,0,0
Eritrea,2007-06-01,0,0,0,0,0,0
Eritrea,2007-06-01,0,0,0,9,0,9
Eritrea,2007-06-01,0,0,0,0,0,0
Eritrea,2007-06-01,0,0,0,0,0,0
Eritrea,2007-06-01,4,0,0,3,0,7
Eritrea,2007-06-01,0,0,0,0,0,0
Eritrea,2007-06-01,4,0,0,6,1,11
Eritrea,2007-06-01,0,0,0,0,0,0
Eritrea,2007-06-01,0,0,0,0,0,0
Eritrea,2007-06-01,0,0,0,0,2,2
Eritrea,2007-06-01,0,0,0,0,0,0
Eritrea,2007-06-01,0,0,0,0,0,0
Eritrea,2007-06-01,0,0,0,0,0,0
Eritrea,2007-06-01,0,0,0,0,0,0
Eritrea,2007-06-01,0,0,0,0,1,1
Eritrea,2007-06-01,0,0,0,0,0,0
Eritrea,2007-06-01,0,0,0,0,0,0
Eritrea,2007-06-01,0,0,0,6,0,6
Eritrea,2007-06-01,0,0,0,3,0,3
Eritrea,2007-06-01,17,0,0,18,3,38
Eritrea,2007-06-01,2,0,0,0,0,2
Eritrea,2007-06-01,8,0,0,0,0,8
Georgia,2007-06-01,8,0,0,2,3,13
Georgia,2007-06-01,4,0,0,3,0,7
Georgia,2007-06-01,0,0,0,0,0,0
Georgia,2007-06-01,3,2,0,0,0,5
Georgia,2007-06-01,12,0,0,0,0,12
Georgia,2007-06-01,3,0,0,12,4,19
Georgia,2007-06-01,2,0,0,6,0,8
Georgia,2007-06-01,15,0,0,0,2,17
Georgia,2007-06-01,4,0,0,0,0,4
Georgia,2007-06-01,0,0,0,0,2,2
Georgia,2007-06-01,12,0,0,0,0,12
Georgia,2007-06-01,10,0,0,-5,1,6
Georgia,2007-06-01,2,0,-2,7,0,7
Georgia,2007-06-01,6,0,0,1,0,7
Georgia,2007-06-01,4,0,0,-2,0,2
Georgia,2007-06-01,0,0,0,0,0,0
Georgia,2007-06-01,2,0,0,0,0,2
Georgia,2007-06-01,8,2,0,0,0,10
Georgia,2007-06-01,3,0,0,-2,0,1
Georgia,2007-06-01,2,0,0,0,4,6
Georgia,2007-06-01,13,0,0,6,0,19
Georgia,2007-06-01,4,0,0,-1,0,3
Georgia,2007-06-01,0,0,0,0,0,0
Georgia,2007-06-01,0,0,0,0,0,0
Georgia,2007-06-01,-2,0,0,0,1,-1
Georgia,2007-06-01,7,0,0,15,0,22
Georgia,2007-06-01,9,0,0,21,2,32
Georgia,2007-06-01,6,0,0,3,1,10
Georgia,2007-06-01,5,0,0,0,1,6
Georgia,2007-06-01,3,0,0,0,0,3
India,2007-06-01,22,0,-2,11,11,42
India,2007-06-01,16,0,0,7,5,28
India,2007-06-01,14,0,0,0,0,14
India,2007-06-01,14,0,0,9,0,23
India,2007-06-01,17,0,0,-2,3,18
India,2007-06-01,12,0,-2,12,4,26
India,2007-06-01,19,0,0,14,1,34
India,2007-06-01,23,0,1,27,3,54
India,2007-06-01,24,0,-2,3,4,29
India,2007-06-01,17,0,1,6,1,25
India,2007-06-01,17,4,0,4,2,27
India,2007-06-01,20,0,0,14,3,37
India,2007-06-01,60,0,0,12,0,72
India,2007-06-01,56,2,2,13,4,77
India,2007-06-01,18,0,1,13,2,34
India,2007-06-01,7,0,2,11,1,21
India,2007-06-01,16,0,0,0,8,24
India,2007-06-01,54,4,0,1,3,62
India,2007-06-01,16,4,-1,3,0,22
India,2007-06-01,46,0,4,14,9,73
India,2007-06-01,25,4,-1,1,4,33
India,2007-06-01,34,2,2,13,8,59
India,2007-06-01,39,0,0,-2,4,41
India,2007-06-01,11,0,-3,2,0,10
India,2007-06-01,21,0,0,1,6,28
India,2007-06-01,20,6,-2,15,14,53
India,2007-06-01,42,0,0,19,5,66
India,2007-06-01,11,6,-8,12,2,23
India,2007-06-01,10,0,0,1,3,14
India,2007-06-01,15,0,0,1,2,18
Iran,2007-06-01,46,0,2,2,4,54
Iran,2007-06-01,88,0,0,39,5,132
Iran,2007-06-01,51,0,1,38,1,91
Iran,2007-06-01,95,0,0,35,3,133
Iran,2007-06-01,89,0,0,95,11,195
Iran,2007-06-01,96,0,0,67,6,169
Iran,2007-06-01,66,0,0,21,3,90
Iran,2007-06-01,35,0,0,25,1,61
Iran,2007-06-01,55,0,2,-2,6,61
Iran,2007-06-01,62,0,0,33,10,105
Iran,2007-06-01,85,0,0,5,6,96
Iran,2007-06-01,89,0,1,25,0,115
Iran,2007-06-01,44,0,1,27,61,133
Iran,2007-06-01,61,2,0,30,6,99
Iran,2007-06-01,62,0,0,23,9,94
Iran,2007-06-01,43,0,2,12,0,57
Iran,2007-06-01,50,0,2,14,3,69
Iran,2007-06-01,86,0,0,15,10,111
Iran,2007-06-01,108,0,1,23,8,140
Iran,2007-06-01,61,0,-2,31,5,95
Iran,2007-06-01,82,0,4,45,3,134
Iran,2007-06-01,46,0,3,13,6,68
Iran,2007-06-01,29,0,0,29,4,62
Iran,2007-06-01,39,0,0,45,1,85
Iran,2007-06-01,67,0,-8,-6,5,58
Iran,2007-06-01,68,0,-3,15,1,81
Iran,2007-06-01,52,0,-1,20,6,77
Iran,2007-06-01,44,0,-3,6,6,53
Iran,2007-06-01,55,0,0,0,4,59
Iran,2007-06-01,59,0,0,12,9,80
Iraq,2007-06-01,115,0,-2,15,13,141
Iraq,2007-06-01,128,0,-1,13,10,150
Iraq,2007-06-01,136,0,0,16,4,156
Iraq,2007-06-01,225,0,3,65,18,311
Iraq,2007-06-01,127,4,1,150,19,301
Iraq,2007-06-01,229,4,-1,96,9,337
Iraq,2007-06-01,155,0,4,80,3,242
Iraq,2007-06-01,228,0,0,54,26,308
Iraq,2007-06-01,180,0,-9,71,23,265
Iraq,2007-06-01,206,0,0,34,28,268
Iraq,2007-06-01,242,2,-13,43,29,303
Iraq,2007-06-01,213,2,-3,41,24,277
Iraq,2007-06-01,188,0,-4,91,18,293
Iraq,2007-06-01,233,0,8,129,16,386
Iraq,2007-06-01,127,0,-4,31,26,180
Iraq,2007-06-01,89,0,-2,23,12,122
Iraq,2007-06-01,77,0,-6,12,15,98
Iraq,2007-06-01,194,0,-1,29,11,233
Iraq,2007-06-01,165,2,3,30,7,207
Iraq,2007-06-01,217,0,-4,27,17,257
Iraq,2007-06-01,124,0,-4,28,20,168
Iraq,2007-06-01,149,0,-8,13,3,157
Iraq,2007-06-01,79,0,-18,12,9,82
Iraq,2007-06-01,145,0,-6,136,12,287
Iraq,2007-06-01,105,0,-6,30,4,133
Iraq,2007-06-01,253,0,-9,14,14,272
Iraq,2007-06-01,222,2,-23,39,26,266
Iraq,2007-06-01,141,0,-6,10,36,181
Iraq,2007-06-01,210,0,-1,47,12,268
Iraq,2007-06-01,88,2,0,21,21,132
Morocco,2007-06-01,6,2,0,2,0,10
Morocco,2007-06-01,-4,0,0,-4,0,-8
Morocco,2007-06-01,4,0,0,0,0,4
Morocco,2007-06-01,63,0,0,6,0,69
Morocco,2007-06-01,27,0,0,0,0,27
Morocco,2007-06-01,-4,0,-2,0,8,2
Morocco,2007-06-01,-1,0,0,3,0,2
Morocco,2007-06-01,12,0,0,21,0,33
Morocco,2007-06-01,-2,0,0,12,0,10
Morocco,2007-06-01,0,0,0,3,0,3
Morocco,2007-06-01,0,0,0,5,0,5
Morocco,2007-06-01,2,0,0,9,0,11
Morocco,2007-06-01,22,0,0,0,0,22
Morocco,2007-06-01,4,0,0,-2,0,2
Morocco,2007-06-01,2,0,0,0,0,2
Morocco,2007-06-01,0,0,0,0,0,0
Morocco,2007-06-01,0,0,0,0,0,0
Morocco,2007-06-01,0,0,0,0,2,2
Morocco,2007-06-01,5,0,0,0,0,5
Morocco,2007-06-01,2,0,0,0,0,2
Morocco,2007-06-01,1,0,0,9,0,10
Morocco,2007-06-01,0,0,0,3,1,4
Morocco,2007-06-01,3,0,0,0,1,4
Morocco,2007-06-01,3,0,0,0,1,4
Morocco,2007-06-01,3,0,0,0,1,4
Morocco,2007-06-01,8,0,0,18,6,32
Morocco,2007-06-01,5,0,0,12,0,17
Morocco,2007-06-01,9,0,0,6,0,15
Morocco,2007-06-01,13,0,0,12,3,28
Morocco,2007-06-01,5,0,0,0,0,5
Nigeria,2007-06-01,12,0,0,0,2,14
Nigeria,2007-06-01,17,0,0,-4,0,13
Nigeria,2007-06-01,19,0,0,10,3,32
Nigeria,2007-06-01,12,0,2,106,3,123
Nigeria,2007-06-01,7,0,0,30,0,37
Nigeria,2007-06-01,3,0,2,13,0,18
Nigeria,2007-06-01,6,0,0,9,0,15
Nigeria,2007-06-01,17,0,-2,6,0,21
Nigeria,2007-06-01,16,0,0,9,2,27
Nigeria,2007-06-01,11,0,0,3,1,15
Nigeria,2007-06-01,10,0,1,4,1,16
Nigeria,2007-06-01,9,6,-2,1,0,14
Nigeria,2007-06-01,14,0,0,8,2,24
Nigeria,2007-06-01,9,0,0,7,2,18
Nigeria,2007-06-01,7,0,0,9,4,20
Nigeria,2007-06-01,2,0,0,13,0,15
Nigeria,2007-06-01,2,0,0,15,-1,16
Nigeria,2007-06-01,22,0,0,12,3,37
Nigeria,2007-06-01,19,0,-4,6,2,23
Nigeria,2007-06-01,24,0,0,11,4,39
Nigeria,2007-06-01,5,0,0,3,0,8
Nigeria,2007-06-01,0,0,0,0,3,3
Nigeria,2007-06-01,0,0,0,0,0,0
Nigeria,2007-06-01,1,0,0,0,0,1
Nigeria,2007-06-01,4,0,0,0,0,4
Nigeria,2007-06-01,0,0,0,3,0,3
Nigeria,2007-06-01,6,0,0,3,0,9
Nigeria,2007-06-01,13,0,0,9,1,23
Nigeria,2007-06-01,1,0,0,0,0,1
Nigeria,2007-06-01,3,0,0,0,0,3
Pakistan,2007-06-01,23,0,3,5,3,34
Pakistan,2007-06-01,36,0,0,12,1,49
Pakistan,2007-06-01,74,0,0,6,3,83
Pakistan,2007-06-01,109,0,0,15,10,134
Pakistan,2007-06-01,63,0,0,44,2,109
Pakistan,2007-06-01,47,4,0,31,3,85
Pakistan,2007-06-01,45,2,0,52,19,118
Pakistan,2007-06-01,18,2,1,25,2,48
Pakistan,2007-06-01,18,0,2,15,1,36
Pakistan,2007-06-01,5,0,-2,6,0,9
Pakistan,2007-06-01,53,0,0,14,3,70
Pakistan,2007-06-01,148,0,-2,19,13,178
Pakistan,2007-06-01,63,0,-8,9,6,70
Pakistan,2007-06-01,62,0,0,72,7,141
Pakistan,2007-06-01,80,0,0,12,1,93
Pakistan,2007-06-01,87,0,0,12,12,111
Pakistan,2007-06-01,90,0,0,4,25,119
Pakistan,2007-06-01,49,0,-1,12,18,78
Pakistan,2007-06-01,17,0,-1,3,1,20
Pakistan,2007-06-01,17,0,0,21,48,86
Pakistan,2007-06-01,39,0,2,18,48,107
Pakistan,2007-06-01,66,0,-4,29,5,96
Pakistan,2007-06-01,97,0,0,20,9,126
Pakistan,2007-06-01,54,0,0,6,12,72
Pakistan,2007-06-01,70,0,0,20,14,104
Pakistan,2007-06-01,24,0,1,5,0,30
Pakistan,2007-06-01,25,0,0,15,3,43
Pakistan,2007-06-01,47,0,0,9,2,58
Pakistan,2007-06-01,16,0,0,5,3,24
Pakistan,2007-06-01,22,0,-2,-8,0,12
Sierra Leone,2007-06-01,2,0,0,3,0,5
Sierra Leone,2007-06-01,0,0,0,3,0,3
Sierra Leone,2007-06-01,12,0,0,21,0,33
Sierra Leone,2007-06-01,42,0,4,67,5,118
Sierra Leone,2007-06-01,6,0,0,3,1,10
Sierra Leone,2007-06-01,0,0,0,0,0,0
Sierra Leone,2007-06-01,9,0,0,0,0,9
Sierra Leone,2007-06-01,2,0,0,12,2,16
Sierra Leone,2007-06-01,0,0,0,0,0,0
Sierra Leone,2007-06-01,4,0,0,0,0,4
Sierra Leone,2007-06-01,2,0,0,3,0,5
Sierra Leone,2007-06-01,0,0,0,3,0,3
Sierra Leone,2007-06-01,1,0,0,0,0,1
Sierra Leone,2007-06-01,0,0,0,-2,1,-1
Sierra Leone,2007-06-01,0,0,0,0,6,6
Sierra Leone,2007-06-01,0,0,0,0,0,0
Sierra Leone,2007-06-01,4,0,0,0,1,5
Sierra Leone,2007-06-01,12,0,0,15,3,30
Sierra Leone,2007-06-01,4,0,0,12,1,17
Sierra Leone,2007-06-01,4,0,-2,6,0,8
Sierra Leone,2007-06-01,0,0,0,-2,0,-2
Sierra Leone,2007-06-01,13,0,0,21,0,34
Sierra Leone,2007-06-01,3,0,0,9,0,12
Sierra Leone,2007-06-01,0,0,0,0,0,0
Sierra Leone,2007-06-01,0,0,0,0,0,0
Sierra Leone,2007-06-01,3,0,0,3,1,7
Somalia,2007-06-01,6,0,0,0,0,6
Somalia,2007-06-01,3,0,0,0,0,3
Somalia,2007-06-01,62,0,0,6,6,74
Somalia,2007-06-01,3,0,0,9,3,15
Somalia,2007-06-01,0,0,0,4,1,5
Somalia,2007-06-01,19,0,0,0,0,19
Somalia,2007-06-01,14,0,0,1,0,15
Somalia,2007-06-01,5,0,0,6,0,11
Somalia,2007-06-01,3,0,0,6,0,9
Somalia,2007-06-01,6,0,0,3,0,9
Somalia,2007-06-01,20,0,0,0,1,21
Somalia,2007-06-01,5,2,0,6,0,13
Somalia,2007-06-01,22,0,0,-2,4,24
Somalia,2007-06-01,35,0,0,21,3,59
Somalia,2007-06-01,8,0,0,0,1,9
Somalia,2007-06-01,16,0,0,4,3,23
Somalia,2007-06-01,13,0,0,3,0,16
Somalia,2007-06-01,-1,0,-2,0,2,-1
Somalia,2007-06-01,26,0,-1,3,0,28
Somalia,2007-06-01,45,0,-1,6,0,50
Somalia,2007-06-01,9,0,0,7,0,16
Somalia,2007-06-01,5,0,0,0,0,5
Somalia,2007-06-01,15,0,0,0,0,15
Somalia,2007-06-01,3,0,0,0,0,3
Somalia,2007-06-01,16,0,0,12,6,34
Somalia,2007-06-01,1,0,0,0,0,1
Somalia,2007-06-01,8,0,0,12,0,20
Somalia,2007-06-01,7,0,0,0,0,7
Somalia,2007-06-01,0,0,0,0,0,0
Syria,2007-06-01,26,0,0,0,0,26
Syria,2007-06-01,25,0,-1,3,1,28
Syria,2007-06-01,34,0,0,0,0,34
Syria,2007-06-01,38,0,0,6,0,44
Syria,2007-06-01,18,0,0,7,4,29
Syria,2007-06-01,37,0,0,11,0,48
Syria,2007-06-01,60,0,-2,13,21,92
Syria,2007-06-01,89,0,0,87,3,179
Syria,2007-06-01,20,0,0,18,3,41
Syria,2007-06-01,19,0,0,9,0,28
Syria,2007-06-01,21,0,0,6,0,27
Syria,2007-06-01,32,0,0,0,3,35
Syria,2007-06-01,99,0,0,26,3,128
Syria,2007-06-01,72,0,-6,44,3,113
Syria,2007-06-01,64,0,-3,24,3,88
Syria,2007-06-01,25,0,-2,0,14,37
Syria,2007-06-01,7,0,0,-4,2,5
Syria,2007-06-01,33,0,0,21,5,59
Syria,2007-06-01,23,2,1,-6,0,20
Syria,2007-06-01,64,0,-15,11,0,60
Syria,2007-06-01,60,0,-2,24,8,90
Syria,2007-06-01,40,0,0,5,0,45
Syria,2007-06-01,11,0,-8,12,0,15
Syria,2007-06-01,37,2,0,0,1,40
Syria,2007-06-01,4,0,0,0,4,8
Syria,2007-06-01,29,0,-10,6,0,25
Syria,2007-06-01,21,0,0,3,1,25
Syria,2007-06-01,6,0,0,0,0,6
Syria,2007-06-01,19,0,-3,30,0,46
Syria,2007-06-01,12,0,2,10,2,26
Yemen,2007-06-01,14,0,3,12,0,29
Yemen,2007-06-01,3,0,1,9,0,13
Yemen,2007-06-01,13,0,1,24,0,38
Yemen,2007-06-01,21,0,0,36,0,57
Yemen,2007-06-01,58,0,0,27,2,87
Yemen,2007-06-01,29,0,0,6,0,35
Yemen,2007-06-01,6,0,0,3,0,9
Yemen,2007-06-01,22,0,0,21,0,43
Yemen,2007-06-01,17,0,0,0,0,17
Yemen,2007-06-01,3,0,0,0,0,3
Yemen,2007-06-01,2,0,0,3,0,5
Yemen,2007-06-01,0,0,0,6,0,6
Yemen,2007-06-01,45,0,0,9,0,54
Yemen,2007-06-01,2,0,0,0,0,2
Yemen,2007-06-01,2,0,0,-2,0,0
Yemen,2007-06-01,1,0,0,0,0,1
Yemen,2007-06-01,4,0,0,0,0,4
Yemen,2007-06-01,7,0,0,6,0,13
Yemen,2007-06-01,-1,0,0,12,2,13
Yemen,2007-06-01,6,0,0,9,0,15
Yemen,2007-06-01,15,0,0,-1,0,14
Yemen,2007-06-01,12,0,0,0,0,12
Yemen,2007-06-01,6,0,0,6,0,12
Yemen,2007-06-01,30,0,0,0,0,30
Yemen,2007-06-01,0,0,0,0,2,2
Yemen,2007-06-01,0,0,0,0,0,0
Yemen,2007-06-01,12,0,0,0,2,14
Yemen,2007-06-01,2,0,0,0,2,4
Afghanistan,2007-12-01,60,0,1,14,2,77
Afghanistan,2007-12-01,92,6,-6,2,12,106
Afghanistan,2007-12-01,116,0,0,33,10,159
Afghanistan,2007-12-01,126,0,1,47,21,195
Afghanistan,2007-12-01,56,0,0,37,6,99
Afghanistan,2007-12-01,51,2,-4,33,4,86
Afghanistan,2007-12-01,63,0,2,46,4,115
Afghanistan,2007-12-01,61,2,0,12,0,75
Afghanistan,2007-12-01,58,0,0,10,6,74
Afghanistan,2007-12-01,78,0,1,25,2,106
Afghanistan,2007-12-01,46,2,0,18,8,74
Afghanistan,2007-12-01,138,0,0,10,24,172
Afghanistan,2007-12-01,82,0,1,14,7,104
Afghanistan,2007-12-01,46,2,-4,28,9,81
Afghanistan,2007-12-01,28,2,0,3,8,41
Afghanistan,2007-12-01,35,4,0,8,16,63
Afghanistan,2007-12-01,76,2,0,59,6,143
Afghanistan,2007-12-01,94,0,0,42,18,154
Afghanistan,2007-12-01,94,0,0,76,18,188
Afghanistan,2007-12-01,133,0,1,46,2,182
Afghanistan,2007-12-01,92,0,0,29,5,126
Afghanistan,2007-12-01,99,0,0,25,5,129
Afghanistan,2007-12-01,67,0,0,11,30,108
Afghanistan,2007-12-01,59,2,0,10,30,101
Afghanistan,2007-12-01,53,0,0,72,2,127
Afghanistan,2007-12-01,94,0,-4,25,2,117
Afghanistan,2007-12-01,45,0,0,39,13,97
Afghanistan,2007-12-01,42,0,0,8,2,52
Afghanistan,2007-12-01,26,0,0,4,0,30
Afghanistan,2007-12-01,94,0,0,10,18,122
Afghanistan,2007-12-01,52,0,0,10,1,63
Albania,2007-12-01,11,0,-13,6,0,4
Albania,2007-12-01,24,0,-1,0,0,23
Albania,2007-12-01,-1,0,-1,0,0,-2
Albania,2007-12-01,14,0,-6,6,0,14
Albania,2007-12-01,16,0,-5,6,5,22
Albania,2007-12-01,16,0,-1,0,1,16
Albania,2007-12-01,25,0,-13,9,1,22
Albania,2007-12-01,8,0,-4,0,0,4
Albania,2007-12-01,13,6,-1,12,0,30
Albania,2007-12-01,27,0,-11,12,2,30
Albania,2007-12-01,10,0,-4,0,8,14
Albania,2007-12-01,10,0,-5,13,1,19
Albania,2007-12-01,15,0,-2,0,0,13
Albania,2007-12-01,-6,0,-2,0,1,-7
Albania,2007-12-01,11,0,0,0,2,13
Albania,2007-12-01,11,0,-5,0,4,10
Albania,2007-12-01,4,0,0,21,5,30
Albania,2007-12-01,6,0,-3,3,0,6
Albania,2007-12-01,19,0,-10,0,0,9
Albania,2007-12-01,19,0,-8,21,0,32
Albania,2007-12-01,10,0,-1,0,6,15
Albania,2007-12-01,8,0,0,-1,1,8
Albania,2007-12-01,1,0,-1,0,3,3
Albania,2007-12-01,7,0,0,-1,1,7
Albania,2007-12-01,-3,0,0,3,0,0
Albania,2007-12-01,6,0,-3,9,0,12
Albania,2007-12-01,5,0,-4,0,0,1
Albania,2007-12-01,-1,0,0,0,1,0
Albania,2007-12-01,3,0,-6,-2,0,-5
Albania,2007-12-01,0,0,0,6,1,7
Albania,2007-12-01,3,0,0,0,0,3
Algeria,2007-12-01,6,0,0,19,0,25
Algeria,2007-12-01,2,0,-4,9,0,7
Algeria,2007-12-01,6,0,0,4,2,12
Algeria,2007-12-01,13,0,0,-2,4,15
Algeria,2007-12-01,22,0,0,17,9,48
Algeria,2007-12-01,46,0,1,17,0,64
Algeria,2007-12-01,5,0,0,21,0,26
Algeria,2007-12-01,2,0,0,5,0,7
Algeria,2007-12-01,11,0,0,6,0,17
Algeria,2007-12-01,2,0,0,0,0,2
Algeria,2007-12-01,71,0,-2,9,13,91
Algeria,2007-12-01,1,0,0,11,0,12
Algeria,2007-12-01,24,0,0,-4,0,20
Algeria,2007-12-01,2,0,0,3,0,5
Algeria,2007-12-01,9,0,0,6,0,15
Algeria,2007-12-01,0,0,0,12,2,14
Algeria,2007-12-01,0,0,0,3,0,3
Algeria,2007-12-01,14,0,0,0,0,14
Algeria,2007-12-01,7,0,0,4,0,11
Algeria,2007-12-01,12,0,0,12,0,24
Algeria,2007-12-01,3,0,0,0,0,3
Algeria,2007-12-01,3,0,0,3,0,6
Algeria,2007-12-01,12,0,0,-1,0,11
Algeria,2007-12-01,0,0,0,-2,0,-2
Algeria,2007-12-01,2,0,0,-6,0,-4
Algeria,2007-12-01,4,0,0,8,0,12
Algeria,2007-12-01,0,0,0,-2,0,-2
Algeria,2007-12-01,6,0,0,6,8,20
Algeria,2007-12-01,6,0,0,3,2,11
Algeria,2007-12-01,10,0,0,-8,0,2
Algeria,2007-12-01,12,0,0,0,0,12
Bangladesh,2007-12-01,5,0,0,-1,0,4
Bangladesh,2007-12-01,2,0,0,0,0,2
Bangladesh,2007-12-01,1,0,0,9,2,12
Bangladesh,2007-12-01,18,4,0,3,5,30
Bangladesh,2007-12-01,4,4,-4,-2,5,7
Bangladesh,2007-12-01,9,0,0,6,0,15
Bangladesh,2007-12-01,2,0,-2,3,0,3
Bangladesh,2007-12-01,6,0,1,-3,0,4
Bangladesh,2007-12-01,2,0,0,7,0,9
Bangladesh,2007-12-01,12,0,0,0,11,23
Bangladesh,2007-12-01,-3,0,0,3,4,4
Bangladesh,2007-12-01,4,0,0,-10,2,-4
Bangladesh,2007-12-01,0,0,0,0,0,0
Bangladesh,2007-12-01,13,0,0,-1,0,12
Bangladesh,2007-12-01,2,0,0,0,0,2
Bangladesh,2007-12-01,1,0,0,0,2,3
Bangladesh,2007-12-01,1,0,0,0,2,3
Bangladesh,2007-12-01,14,0,0,0,0,14
Bangladesh,2007-12-01,-11,0,0,3,0,-8
Bangladesh,2007-12-01,14,0,0,12,0,26
Bangladesh,2007-12-01,17,0,0,20,0,37
Bangladesh,2007-12-01,12,0,0,24,2,38
Bangladesh,2007-12-01,2,0,0,0,0,2
Bangladesh,2007-12-01,1,0,0,-4,0,-3
Bangladesh,2007-12-01,-16,0,0,13,1,-2
Bangladesh,2007-12-01,10,0,2,-4,0,8
Bangladesh,2007-12-01,22,0,0,22,0,44
Bangladesh,2007-12-01,2,0,0,0,0,2
Bangladesh,2007-12-01,0,0,0,16,0,16
Bangladesh,2007-12-01,29,2,0,0,0,31
Bangladesh,2007-12-01,3,0,0,0,0,3
Cameroon,2007-12-01,0,0,0,0,0,0
Cameroon,2007-12-01,6,0,0,3,0,9
Cameroon,2007-12-01,0,0,0,9,0,9
Cameroon,2007-12-01,0,0,0,9,0,9
Cameroon,2007-12-01,0,0,0,0,0,0
Cameroon,2007-12-01,0,0,0,0,0,0
Cameroon,2007-12-01,3,0,0,-4,0,-1
Cameroon,2007-12-01,3,0,0,6,0,9
Cameroon,2007-12-01,0,0,0,0,0,0
Cameroon,2007-12-01,2,0,0,0,1,3
Cameroon,2007-12-01,0,0,0,0,0,0
Cameroon,2007-12-01,0,0,0,0,0,0
Cameroon,2007-12-01,0,0,0,0,0,0
Cameroon,2007-12-01,2,0,0,0,0,2
Cameroon,2007-12-01,0,0,0,0,0,0
Cameroon,2007-12-01,0,0,0,0,0,0
China,2007-12-01,31,2,0,42,1,76
China,2007-12-01,15,2,4,24,2,47
China,2007-12-01,102,0,1,15,4,122
China,2007-12-01,82,0,-2,76,8,164
China,2007-12-01,62,0,-4,45,19,122
China,2007-12-01,52,2,-9,59,13,117
China,2007-12-01,76,2,-3,19,12,106
China,2007-12-01,38,0,0,21,5,64
China,2007-12-01,52,0,0,10,11,73
China,2007-12-01,48,0,0,31,7,86
China,2007-12-01,23,0,0,17,7,47
China,2007-12-01,79,2,3,14,6,104
China,2007-12-01,62,0,0,19,4,85
China,2007-12-01,28,0,0,7,8,43
China,2007-12-01,41,0,-1,26,1,67
China,2007-12-01,30,0,0,13,20,63
China,2007-12-01,91,0,-1,23,5,118
China,2007-12-01,95,0,0,10,7,112
China,2007-12-01,79,4,0,22,6,111
China,2007-12-01,56,2,0,9,3,70
China,2007-12-01,56,0,-1,15,10,80
China,2007-12-01,50,0,-1,31,4,84
China,2007-12-01,28,0,0,6,7,41
China,2007-12-01,34,0,1,21,6,62
China,2007-12-01,53,0,0,17,7,77
China,2007-12-01,40,0,0,12,16,68
China,2007-12-01,28,0,0,29,1,58
China,2007-12-01,3,0,0,6,0,9
China,2007-12-01,1,0,0,6,0,7
China,2007-12-01,3,0,0,-4,0,-1
China,2007-12-01,6,0,0,-2,0,4
Egypt,2007-12-01,-4,0,0,15,2,13
Egypt,2007-12-01,35,0,0,11,0,46
Egypt,2007-12-01,39,0,3,6,0,48
Egypt,2007-12-01,19,0,3,6,5,33
Egypt,2007-12-01,46,4,0,81,8,139
Egypt,2007-12-01,9,0,0,30,0,39
Egypt,2007-12-01,24,0,0,6,0,30
Egypt,2007-12-01,2,0,0,-4,0,-2
Egypt,2007-12-01,3,0,0,3,2,8
Egypt,2007-12-01,7,0,0,9,5,21
Egypt,2007-12-01,19,0,0,14,1,34
Egypt,2007-12-01,3,0,0,13,0,16
Egypt,2007-12-01,3,0,0,10,1,14
Egypt,2007-12-01,18,0,0,12,2,32
Egypt,2007-12-01,2,0,0,0,0,2
Egypt,2007-12-01,9,0,0,8,5,22
Egypt,2007-12-01,18,0,9,6,8,41
Egypt,2007-12-01,22,0,1,-2,0,21
Egypt,2007-12-01,32,0,0,15,2,49
Egypt,2007-12-01,10,0,0,7,3,20
Egypt,2007-12-01,14,0,0,12,1,27
Egypt,2007-12-01,17,0,0,3,0,20
Egypt,2007-12-01,26,0,0,-2,0,24
Egypt,2007-12-01,34,0,0,0,5,39
Egypt,2007-12-01,13,0,0,1,0,14
Egypt,2007-12-01,47,0,0,13,5,65
Egypt,2007-12-01,40,0,0,2,8,50
Egypt,2007-12-01,13,0,0,6,0,19
Egypt,2007-12-01,4,0,0,-4,0,0
Egypt,2007-12-01,0,0,0,6,0,6
Egypt,2007-12-01,40,0,1,3,2,46
Eritrea,2007-12-01,4,0,0,0,0,4
Eritrea,2007-12-01,1,0,0,0,0,1
Eritrea,2007-12-01,-1,2,0,1,0,2
Eritrea,2007-12-01,0,0,0,0,0,0
Eritrea,2007-12-01,20,0,0,6,2,28
Eritrea,2007-12-01,14,0,0,10,0,24
Eritrea,2007-12-01,6,0,0,3,3,12
Eritrea,2007-12-01,0,0,0,0,0,0
Eritrea,2007-12-01,13,0,0,0,0,13
Eritrea,2007-12-01,11,0,0,17,0,28
Eritrea,2007-12-01,0,0,0,0,0,0
Eritrea,2007-12-01,2,0,0,-2,0,0
Eritrea,2007-12-01,3,0,0,0,0,3
Eritrea,2007-12-01,0,0,0,0,2,2
Eritrea,2007-12-01,6,0,0,0,0,6
Eritrea,2007-12-01,0,0,0,0,1,1
Eritrea,2007-12-01,0,0,0,3,0,3
Eritrea,2007-12-01,2,0,0,6,0,8
Eritrea,2007-12-01,9,0,0,0,0,9
Eritrea,2007-12-01,3,0,0,0,0,3
Eritrea,2007-12-01,18,0,0,0,12,30
Eritrea,2007-12-01,0,0,0,0,6,6
Eritrea,2007-12-01,0,0,0,0,0,0
Georgia,2007-12-01,8,0,0,-2,1,7
Georgia,2007-12-01,2,0,0,0,0,2
Georgia,2007-12-01,-3,0,0,0,1,-2
Georgia,2007-12-01,-3,0,0,7,0,4
Georgia,2007-12-01,18,0,1,-2,0,17
Georgia,2007-12-01,2,0,0,3,0,5
Georgia,2007-12-01,5,0,0,12,1,18
Georgia,2007-12-01,3,0,0,20,0,23
Georgia,2007-12-01,1,0,-2,-2,0,-3
Georgia,2007-12-01,4,0,0,3,0,7
Georgia,2007-12-01,4,0,1,15,0,20
Georgia,2007-12-01,20,0,0,19,2,41
Georgia,2007-12-01,9,0,0,0,0,9
Georgia,2007-12-01,5,0,0,6,0,11
Georgia,2007-12-01,0,0,0,0,0,0
Georgia,2007-12-01,10,0,0,-2,0,8
Georgia,2007-12-01,8,0,0,0,1,9
Georgia,2007-12-01,4,0,0,0,0,4
Georgia,2007-12-01,4,0,0,0,0,4
Georgia,2007-12-01,0,0,0,10,0,10
Georgia,2007-12-01,0,0,0,0,0,0
Georgia,2007-12-01,12,0,0,10,0,22
Georgia,2007-12-01,0,0,0,0,0,0
Georgia,2007-12-01,14,0,0,9,2,25
Georgia,2007-12-01,1,0,2,3,0,6
Georgia,2007-12-01,18,0,0,6,2,26
Georgia,2007-12-01,0,0,0,6,0,6
Georgia,2007-12-01,0,0,0,0,0,0
Georgia,2007-12-01,-1,0,0,0,0,-1
India,2007-12-01,15,0,-2,10,5,28
India,2007-12-01,22,0,-4,18,0,36
India,2007-12-01,24,0,1,-1,3,27
India,2007-12-01,18,0,1,6,7,32
India,2007-12-01,30,0,0,0,3,33
India,2007-12-01,19,0,-1,1,0,19
India,2007-12-01,27,0,0,7,4,38
India,2007-12-01,12,0,0,8,2,22
India,2007-12-01,22,2,0,3,2,29
India,2007-12-01,31,0,0,19,8,58
India,2007-12-01,27,0,2,23,12,64
India,2007-12-01,34,0,0,4,2,40
India,2007-12-01,28,0,0,3,3,34
India,2007-12-01,35,0,0,12,21,68
India,2007-12-01,32,0,0,14,5,51
India,2007-12-01,11,0,1,22,2,36
India,2007-12-01,15,0,1,3,3,22
India,2007-12-01,21,0,0,-5,2,18
India,2007-12-01,46,0,0,20,1,67
India,2007-12-01,11,0,0,-2,1,10
India,2007-12-01,27,4,-2,6,5,40
India,2007-12-01,23,0,0,0,3,26
India,2007-12-01,24,0,0,7,5,36
India,2007-12-01,30,0,1,3,2,36
India,2007-12-01,25,0,0,9,2,36
India,2007-12-01,25,0,0,9,8,42
India,2007-12-01,32,4,2,11,9,58
India,2007-12-01,20,0,0,0,0,20
India,2007-12-01,9,0,-4,0,0,5
India,2007-12-01,6,0,0,0,2,8
India,2007-12-01,2,0,0,0,1,3
Iran,2007-12-01,54,2,1,25,0,82
Iran,2007-12-01,31,2,-10,50,5,78
Iran,2007-12-01,33,0,-16,-4,2,15
Iran,2007-12-01,143,0,-4,23,11,173
Iran,2007-12-01,66,0,5,8,15,94
Iran,2007-12-01,63,2,-11,4,4,62
Iran,2007-12-01,31,0,1,-4,8,36
Iran,2007-12-01,38,0,-2,6,0,42
Iran,2007-12-01,41,0,-4,4,2,43
Iran,2007-12-01,26,0,0,25,4,55
Iran,2007-12-01,43,4,0,22,2,71
Iran,2007-12-01,46,0,0,14,0,60
Iran,2007-12-01,54,0,-2,13,4,69
Iran,2007-12-01,40,0,3,9,1,53
Iran,2007-12-01,42,2,0,-4,1,41
Iran,2007-12-01,34,0,0,22,0,56
Iran,2007-12-01,23,0,0,0,2,25
Iran,2007-12-01,89,0,-1,17,16,121
Iran,2007-12-01,72,0,0,3,0,75
Iran,2007-12-01,24,0,0,22,2,48
Iran,2007-12-01,7,0,0,16,2,25
Iran,2007-12-01,18,0,0,2,2,22
Iran,2007-12-01,39,0,5,15,2,61
Iran,2007-12-01,-2,0,0,9,18,25
Iran,2007-12-01,41,0,0,37,7,85
Iran,2007-12-01,25,0,0,30,0,55
Iran,2007-12-01,51,0,0,0,6,57
Iran,2007-12-01,23,0,0,10,2,35
Iran,2007-12-01,7,0,0,0,0,7
Iran,2007-12-01,11,0,0,3,0,14
Iran,2007-12-01,23,0,0,4,0,27
Iraq,2007-12-01,173,0,1,11,5,190
Iraq,2007-12-01,142,0,1,2,4,149
Iraq,2007-12-01,133,0,-1,12,8,152
Iraq,2007-12-01,187,0,-1,68,16,270
Iraq,2007-12-01,121,0,1,8,22,152
Iraq,2007-12-01,92,4,-1,29,14,138
Iraq,2007-12-01,57,0,-6,51,24,126
Iraq,2007-12-01,40,0,0,39,6,85
Iraq,2007-12-01,103,0,0,17,8,128
Iraq,2007-12-01,61,0,1,31,6,99
Iraq,2007-12-01,72,20,-1,21,14,126
Iraq,2007-12-01,113,0,0,15,23,151
Iraq,2007-12-01,112,2,6,44,3,167
Iraq,2007-12-01,50,6,1,25,11,93
Iraq,2007-12-01,49,10,0,7,3,69
Iraq,2007-12-01,289,8,0,-32,17,282
Iraq,2007-12-01,205,2,-2,26,5,236
Iraq,2007-12-01,177,2,-2,61,14,252
Iraq,2007-12-01,245,0,3,39,31,318
Iraq,2007-12-01,197,2,0,43,41,283
Iraq,2007-12-01,72,4,-2,16,8,98
Iraq,2007-12-01,84,0,1,-4,4,85
Iraq,2007-12-01,96,2,0,-3,0,95
Iraq,2007-12-01,110,0,0,-6,1,105
Iraq,2007-12-01,162,0,0,13,35,210
Iraq,2007-12-01,204,0,0,38,13,255
Iraq,2007-12-01,74,2,0,11,14,101
Iraq,2007-12-01,70,0,0,14,2,86
Iraq,2007-12-01,51,0,-2,9,5,63
Iraq,2007-12-01,28,0,2,3,2,35
Iraq,2007-12-01,35,0,-6,6,2,37
Morocco,2007-12-01,0,0,0,0,0,0
Morocco,2007-12-01,0,0,0,0,0,0
Morocco,2007-12-01,9,0,0,3,0,12
Morocco,2007-12-01,1,0,0,0,0,1
Morocco,2007-12-01,15,0,0,15,0,30
Morocco,2007-12-01,7,0,0,3,0,10
Morocco,2007-12-01,8,0,0,0,0,8
Morocco,2007-12-01,1,0,0,8,0,9
Morocco,2007-12-01,3,0,0,3,0,6
Morocco,2007-12-01,22,0,0,45,0,67
Morocco,2007-12-01,32,0,0,18,4,54
Morocco,2007-12-01,12,0,0,3,0,15
Morocco,2007-12-01,7,0,0,0,0,7
Morocco,2007-12-01,0,0,0,12,0,12
Morocco,2007-12-01,0,0,0,0,0,0
Morocco,2007-12-01,0,0,0,3,0,3
Morocco,2007-12-01,0,0,0,9,0,9
Morocco,2007-12-01,8,0,0,1,0,9
Morocco,2007-12-01,6,0,0,0,0,6
Morocco,2007-12-01,1,0,0,3,0,4
Morocco,2007-12-01,1,0,0,-2,0,-1
Morocco,2007-12-01,2,0,0,0,0,2
Morocco,2007-12-01,-3,0,0,0,0,-3
Morocco,2007-12-01,0,0,0,0,0,0
Morocco,2007-12-01,1,0,0,0,0,1
Morocco,2007-12-01,1,0,0,0,0,1
Morocco,2007-12-01,12,0,0,0,0,12
Nigeria,2007-12-01,-1,0,0,6,0,5
Nigeria,2007-12-01,3,2,0,0,0,5
Nigeria,2007-12-01,34,0,0,1,0,35
Nigeria,2007-12-01,12,0,1,3,0,16
Nigeria,2007-12-01,13,0,-8,12,1,18
Nigeria,2007-12-01,22,0,-1,10,0,31
Nigeria,2007-12-01,-2,0,0,3,0,1
Nigeria,2007-12-01,-1,0,0,9,0,8
Nigeria,2007-12-01,2,0,0,0,0,2
Nigeria,2007-12-01,4,0,0,6,2,12
Nigeria,2007-12-01,0,0,0,3,2,5
Nigeria,2007-12-01,8,0,0,2,0,10
Nigeria,2007-12-01,13,0,0,-2,0,11
Nigeria,2007-12-01,22,0,0,0,0,22
Nigeria,2007-12-01,12,0,0,-2,0,10
Nigeria,2007-12-01,0,0,0,-2,0,-2
Nigeria,2007-12-01,5,0,0,6,0,11
Nigeria,2007-12-01,8,0,0,12,6,26
Nigeria,2007-12-01,-5,0,0,9,0,4
Nigeria,2007-12-01,5,0,0,3,2,10
Nigeria,2007-12-01,9,0,0,1,1,11
Nigeria,2007-12-01,10,0,0,1,0,11
Nigeria,2007-12-01,-1,0,0,0,0,-1
Nigeria,2007-12-01,7,0,0,5,1,13
Nigeria,2007-12-01,0,0,0,0,0,0
Nigeria,2007-12-01,0,0,0,0,0,0
Nigeria,2007-12-01,0,0,0,0,0,0
Nigeria,2007-12-01,0,0,0,0,0,0
Nigeria,2007-12-01,0,0,0,6,0,6
Nigeria,2007-12-01,0,0,2,0,0,2
Pakistan,2007-12-01,29,0,-4,0,5,30
Pakistan,2007-12-01,33,0,0,0,8,41
Pakistan,2007-12-01,52,0,0,63,7,122
Pakistan,2007-12-01,33,0,0,11,5,49
Pakistan,2007-12-01,29,2,-4,29,7,63
Pakistan,2007-12-01,36,0,1,25,3,65
Pakistan,2007-12-01,37,0,0,21,6,64
Pakistan,2007-12-01,20,0,0,-3,0,17
Pakistan,2007-12-01,42,0,0,9,23,74
Pakistan,2007-12-01,82,0,0,5,6,93
Pakistan,2007-12-01,100,2,1,74,6,183
Pakistan,2007-12-01,93,0,0,52,12,157
Pakistan,2007-12-01,36,0,1,19,1,57
Pakistan,2007-12-01,71,0,1,24,4,100
Pakistan,2007-12-01,42,2,1,14,12,71
Pakistan,2007-12-01,23,0,1,22,1,47
Pakistan,2007-12-01,30,0,0,24,11,65
Pakistan,2007-12-01,62,0,1,16,17,96
Pakistan,2007-12-01,59,2,0,25,6,92
Pakistan,2007-12-01,26,0,0,61,1,88
Pakistan,2007-12-01,64,0,0,22,17,103
Pakistan,2007-12-01,10,0,0,6,18,34
Pakistan,2007-12-01,95,0,0,1,6,102
Pakistan,2007-12-01,40,2,0,27,3,72
Pakistan,2007-12-01,24,0,0,27,8,59
Pakistan,2007-12-01,30,0,2,2,3,37
Pakistan,2007-12-01,141,0,-5,10,30,176
Pakistan,2007-12-01,116,0,2,9,22,149
Pakistan,2007-12-01,56,0,-4,0,16,68
Pakistan,2007-12-01,17,0,5,3,3,28
Pakistan,2007-12-01,18,0,0,6,4,28
Sierra Leone,2007-12-01,0,0,0,0,0,0
Sierra Leone,2007-12-01,0,0,0,0,0,0
Sierra Leone,2007-12-01,0,0,0,0,0,0
Sierra Leone,2007-12-01,6,2,0,0,0,8
Sierra Leone,2007-12-01,0,0,0,0,0,0
Sierra Leone,2007-12-01,0,0,0,1,0,1
Sierra Leone,2007-12-01,2,0,0,6,0,8
Sierra Leone,2007-12-01,0,0,0,0,0,0
Sierra Leone,2007-12-01,0,0,0,6,0,6
Sierra Leone,2007-12-01,0,0,0,0,0,0
Sierra Leone,2007-12-01,1,0,0,3,0,4
Sierra Leone,2007-12-01,-3,0,0,0,0,-3
Sierra Leone,2007-12-01,4,0,0,0,0,4
Sierra Leone,2007-12-01,0,0,0,0,0,0
Sierra Leone,2007-12-01,0,0,0,0,0,0
Sierra Leone,2007-12-01,0,0,0,0,3,3
Sierra Leone,2007-12-01,0,0,0,0,2,2
Sierra Leone,2007-12-01,0,0,0,0,0,0
Sierra Leone,2007-12-01,0,0,0,0,0,0
Sierra Leone,2007-12-01,0,0,0,0,0,0
Sierra Leone,2007-12-01,0,0,0,0,0,0
Somalia,2007-12-01,14,0,0,0,0,14
Somalia,2007-12-01,6,0,0,0,0,6
Somalia,2007-12-01,4,2,-4,-5,0,-3
Somalia,2007-12-01,25,2,-18,-9,2,2
Somalia,2007-12-01,76,0,-16,0,3,63
Somalia,2007-12-01,20,2,-4,0,0,18
Somalia,2007-12-01,72,0,-8,12,2,78
Somalia,2007-12-01,59,0,0,3,1,63
Somalia,2007-12-01,12,0,0,0,0,12
Somalia,2007-12-01,11,0,0,16,6,33
Somalia,2007-12-01,40,0,-4,29,0,65
Somalia,2007-12-01,35,0,0,-19,0,16
Somalia,2007-12-01,15,0,0,0,0,15
Somalia,2007-12-01,11,0,-1,9,0,19
Somalia,2007-12-01,6,0,0,6,0,12
Somalia,2007-12-01,4,0,0,0,1,5
Somalia,2007-12-01,17,0,-4,0,9,22
Somalia,2007-12-01,30,0,0,9,9,48
Somalia,2007-12-01,14,0,0,6,9,29
Somalia,2007-12-01,11,2,0,0,4,17
Somalia,2007-12-01,14,0,0,1,4,19
Somalia,2007-12-01,4,0,0,0,0,4
Somalia,2007-12-01,24,0,0,0,0,24
Somalia,2007-12-01,1,0,0,-16,0,-15
Somalia,2007-12-01,9,0,0,24,6,39
Somalia,2007-12-01,3,0,0,-4,0,-1
Somalia,2007-12-01,0,0,0,6,0,6
Somalia,2007-12-01,5,0,0,0,0,5
Syria,2007-12-01,-2,0,0,15,0,13
Syria,2007-12-01,3,0,-4,6,4,9
Syria,2007-12-01,18,0,1,-8,3,14
Syria,2007-12-01,76,0,-11,10,0,75
Syria,2007-12-01,51,18,0,46,6,121
Syria,2007-12-01,35,0,-2,19,3,55
Syria,2007-12-01,14,0,-9,9,0,14
Syria,2007-12-01,11,0,-4,-4,0,3
Syria,2007-12-01,7,0,0,3,2,12
Syria,2007-12-01,2,0,-2,6,0,6
Syria,2007-12-01,33,0,0,2,0,35
Syria,2007-12-01,71,0,-10,3,36,100
Syria,2007-12-01,29,0,-2,13,7,47
Syria,2007-12-01,27,0,1,3,0,31
Syria,2007-12-01,7,0,-8,0,0,-1
Syria,2007-12-01,28,0,-4,3,0,27
Syria,2007-12-01,0,0,-8,-3,0,-11
Syria,2007-12-01,20,0,-4,4,11,31
Syria,2007-12-01,2,0,0,3,0,5
Syria,2007-12-01,6,0,0,0,0,6
Syria,2007-12-01,7,0,0,0,0,7
Syria,2007-12-01,6,0,4,0,0,10
Syria,2007-12-01,16,0,0,0,0,16
Syria,2007-12-01,26,0,0,21,2,49
Syria,2007-12-01,6,0,0,7,1,14
Syria,2007-12-01,3,0,0,1,0,4
Syria,2007-12-01,0,0,0,0,0,0
Syria,2007-12-01,1,0,-2,0,0,-1
Syria,2007-12-01,51,0,0,0,0,51
Syria,2007-12-01,26,0,0,10,0,36
Syria,2007-12-01,-1,0,0,4,0,3
Yemen,2007-12-01,5,0,0,0,0,5
Yemen,2007-12-01,4,0,0,0,0,4
Yemen,2007-12-01,12,0,0,0,0,12
Yemen,2007-12-01,2,0,0,6,2,10
Yemen,2007-12-01,11,0,0,17,0,28
Yemen,2007-12-01,5,0,0,3,0,8
Yemen,2007-12-01,8,0,0,0,0,8
Yemen,2007-12-01,4,0,0,3,0,7
Yemen,2007-12-01,0,0,0,0,0,0
Yemen,2007-12-01,1,0,0,9,0,10
Yemen,2007-12-01,0,0,0,6,0,6
Yemen,2007-12-01,9,0,0,3,0,12
Yemen,2007-12-01,1,0,0,0,0,1
Yemen,2007-12-01,-1,0,0,0,0,-1
Yemen,2007-12-01,10,0,0,2,0,12
Yemen,2007-12-01,13,0,0,7,6,26
Yemen,2007-12-01,0,0,0,1,0,1
Yemen,2007-12-01,16,0,0,12,0,28
Yemen,2007-12-01,11,0,0,3,0,14
Yemen,2007-12-01,-2,0,0,19,2,19
Yemen,2007-12-01,18,0,0,1,0,19
Yemen,2007-12-01,6,0,0,12,2,20
Yemen,2007-12-01,1,0,0,0,0,1
Yemen,2007-12-01,0,0,0,3,0,3
Yemen,2007-12-01,-2,0,0,3,0,1
Yemen,2007-12-01,0,0,0,3,0,3
Yemen,2007-12-01,0,0,0,18,0,18
Yemen,2007-12-01,9,0,0,0,0,9
Afghanistan,2009-09-01,303,0,4,18,23,348
Afghanistan,2009-09-01,232,4,8,61,20,325
Afghanistan,2009-09-01,302,0,-11,83,25,399
Afghanistan,2009-09-01,653,2,-16,48,44,731
Afghanistan,2009-09-01,401,0,-10,1,72,464
Afghanistan,2009-09-01,335,0,0,26,38,399
Afghanistan,2009-09-01,308,0,1,48,56,413
Afghanistan,2009-09-01,379,2,-1,-5,34,409
Afghanistan,2009-09-01,447,2,-3,31,36,513
Afghanistan,2009-09-01,377,4,-1,58,20,458
Afghanistan,2009-09-01,428,10,-3,185,39,659
Afghanistan,2009-09-01,235,4,3,56,20,318
Afghanistan,2009-09-01,336,4,1,11,80,432
Afghanistan,2009-09-01,461,6,4,93,25,589
Afghanistan,2009-09-01,346,0,-6,55,14,409
Afghanistan,2009-09-01,535,2,-1,39,28,603
Afghanistan,2009-09-01,397,0,0,45,49,491
Afghanistan,2009-09-01,439,0,2,53,49,543
Afghanistan,2009-09-01,286,0,2,35,34,357
Afghanistan,2009-09-01,299,2,0,78,23,402
Afghanistan,2009-09-01,321,12,1,84,18,436
Afghanistan,2009-09-01,412,12,2,124,30,580
Afghanistan,2009-09-01,375,0,-6,39,21,429
Afghanistan,2009-09-01,410,0,1,170,42,623
Afghanistan,2009-09-01,417,2,-1,134,23,575
Afghanistan,2009-09-01,315,0,1,115,68,499
Afghanistan,2009-09-01,257,8,1,75,44,385
Afghanistan,2009-09-01,415,4,1,33,60,513
Afghanistan,2009-09-01,543,6,-4,103,37,685
Afghanistan,2009-09-01,458,0,-6,124,15,591
Albania,2009-09-01,7,0,1,0,0,8
Albania,2009-09-01,8,0,0,17,12,37
Albania,2009-09-01,21,0,0,6,6,33
Albania,2009-09-01,27,0,0,13,0,40
Albania,2009-09-01,4,0,0,6,1,11
Albania,2009-09-01,4,0,0,6,2,12
Albania,2009-09-01,-2,0,0,6,5,9
Albania,2009-09-01,14,0,0,15,4,33
Albania,2009-09-01,5,0,0,6,1,12
Albania,2009-09-01,4,0,0,1,1,6
Albania,2009-09-01,-2,0,0,3,8,9
Albania,2009-09-01,9,0,0,0,1,10
Albania,2009-09-01,0,0,0,0,1,1
Albania,2009-09-01,8,0,0,0,4,12
Albania,2009-09-01,-2,0,0,0,0,-2
Albania,2009-09-01,11,0,0,0,1,12
Albania,2009-09-01,13,0,0,0,6,19
Albania,2009-09-01,4,0,0,0,0,4
Albania,2009-09-01,0,0,0,0,0,0
Albania,2009-09-01,6,0,0,0,0,6
Albania,2009-09-01,6,0,0,0,0,6
Albania,2009-09-01,7,0,1,4,1,13
Albania,2009-09-01,23,0,-2,49,28,98
Albania,2009-09-01,0,0,-2,6,0,4
Albania,2009-09-01,1,0,0,0,0,1
Albania,2009-09-01,3,0,-6,0,0,-3
Albania,2009-09-01,-3,0,0,0,2,-1
Albania,2009-09-01,0,0,0,3,6,9
Albania,2009-09-01,0,0,0,0,0,0
Albania,2009-09-01,8,0,0,-3,0,5
Algeria,2009-09-01,14,0,0,11,0,25
Algeria,2009-09-01,13,0,0,7,0,20
Algeria,2009-09-01,11,0,0,0,6,17
Algeria,2009-09-01,2,0,0,0,0,2
Algeria,2009-09-01,3,0,0,6,2,11
Algeria,2009-09-01,4,0,0,-6,0,-2
Algeria,2009-09-01,7,0,0,0,0,7
Algeria,2009-09-01,6,0,0,3,0,9
Algeria,2009-09-01,-3,0,0,-3,0,-6
Algeria,2009-09-01,0,0,0,8,0,8
Algeria,2009-09-01,3,0,0,4,0,7
Algeria,2009-09-01,0,0,0,-4,0,-4
Algeria,2009-09-01,0,0,0,-2,0,-2
Algeria,2009-09-01,0,0,0,30,1,31
Algeria,2009-09-01,13,0,0,15,0,28
Algeria,2009-09-01,11,0,0,6,1,18
Algeria,2009-09-01,6,0,0,-2,0,4
Algeria,2009-09-01,8,0,0,0,0,8
Algeria,2009-09-01,2,0,0,0,0,2
Algeria,2009-09-01,2,0,0,0,0,2
Algeria,2009-09-01,8,0,2,18,1,29
Algeria,2009-09-01,0,0,0,8,0,8
Algeria,2009-09-01,0,0,0,0,0,0
Algeria,2009-09-01,2,0,0,3,0,5
Algeria,2009-09-01,7,0,0,0,0,7
Algeria,2009-09-01,1,0,0,3,2,6
Algeria,2009-09-01,0,0,0,0,0,0
Algeria,2009-09-01,0,0,0,-3,0,-3
Algeria,2009-09-01,4,0,0,-3,0,1
Algeria,2009-09-01,0,0,0,0,0,0
Bangladesh,2009-09-01,17,0,2,7,2,28
Bangladesh,2009-09-01,21,0,0,5,3,29
Bangladesh,2009-09-01,17,2,0,7,0,26
Bangladesh,2009-09-01,5,0,-1,-4,0,0
Bangladesh,2009-09-01,10,0,1,1,2,14
Bangladesh,2009-09-01,8,0,0,-1,4,11
Bangladesh,2009-09-01,19,0,0,11,0,30
Bangladesh,2009-09-01,25,0,0,0,1,26
Bangladesh,2009-09-01,16,0,0,-16,1,1
Bangladesh,2009-09-01,23,0,0,9,4,36
Bangladesh,2009-09-01,6,0,0,3,3,12
Bangladesh,2009-09-01,10,0,0,1,2,13
Bangladesh,2009-09-01,18,0,1,3,0,22
Bangladesh,2009-09-01,27,0,0,3,1,31
Bangladesh,2009-09-01,7,0,0,12,3,22
Bangladesh,2009-09-01,30,0,0,15,2,47
Bangladesh,2009-09-01,8,0,0,-2,0,6
Bangladesh,2009-09-01,3,0,0,10,0,13
Bangladesh,2009-09-01,5,0,0,6,0,11
Bangladesh,2009-09-01,5,0,0,0,4,9
Bangladesh,2009-09-01,5,2,0,4,0,11
Bangladesh,2009-09-01,-1,0,0,3,0,2
Bangladesh,2009-09-01,8,0,0,12,4,24
Bangladesh,2009-09-01,14,0,0,21,0,35
Bangladesh,2009-09-01,16,0,0,12,3,31
Bangladesh,2009-09-01,-5,0,0,9,2,6
Bangladesh,2009-09-01,5,2,0,1,0,8
Bangladesh,2009-09-01,19,0,0,6,1,26
Bangladesh,2009-09-01,4,0,0,3,1,8
Bangladesh,2009-09-01,8,0,-6,3,7,12
Cameroon,2009-09-01,3,0,0,0,0,3
Cameroon,2009-09-01,2,0,0,0,0,2
Cameroon,2009-09-01,6,0,0,0,0,6
Cameroon,2009-09-01,2,0,0,0,0,2
Cameroon,2009-09-01,0,0,0,-2,0,-2
Cameroon,2009-09-01,0,0,0,0,0,0
Cameroon,2009-09-01,0,0,0,0,0,0
Cameroon,2009-09-01,0,0,0,-2,0,-2
Cameroon,2009-09-01,2,0,0,-2,0,0
Cameroon,2009-09-01,0,0,0,0,0,0
Cameroon,2009-09-01,0,0,0,0,0,0
Cameroon,2009-09-01,3,0,0,0,0,3
Cameroon,2009-09-01,0,0,0,0,0,0
Cameroon,2009-09-01,0,0,0,0,0,0
Cameroon,2009-09-01,4,0,0,0,0,4
Cameroon,2009-09-01,10,0,0,0,0,10
Cameroon,2009-09-01,0,0,0,0,0,0
Cameroon,2009-09-01,1,0,0,0,0,1
Cameroon,2009-09-01,2,0,0,0,0,2
Cameroon,2009-09-01,3,0,0,-2,0,1
Cameroon,2009-09-01,1,0,0,-1,2,2
Cameroon,2009-09-01,0,0,0,-3,1,-2
Cameroon,2009-09-01,0,0,0,4,0,4
Cameroon,2009-09-01,1,0,0,0,0,1
Cameroon,2009-09-01,0,0,0,0,0,0
Cameroon,2009-09-01,0,0,0,3,0,3
Cameroon,2009-09-01,0,0,0,0,0,0
Cameroon,2009-09-01,-2,0,0,0,0,-2
Cameroon,2009-09-01,0,0,0,-2,0,-2
China,2009-09-01,133,4,4,64,38,243
China,2009-09-01,126,2,-6,89,18,229
China,2009-09-01,196,2,-9,83,51,323
China,2009-09-01,192,2,-29,83,45,293
China,2009-09-01,88,0,1,58,20,167
China,2009-09-01,103,2,-8,26,25,148
China,2009-09-01,206,0,1,94,8,309
China,2009-09-01,162,4,-1,57,15,237
China,2009-09-01,114,0,-11,125,25,253
China,2009-09-01,65,2,-1,49,15,130
China,2009-09-01,66,0,2,86,43,197
China,2009-09-01,68,0,1,33,20,122
China,2009-09-01,80,0,0,33,18,131
China,2009-09-01,74,0,-1,41,11,125
China,2009-09-01,49,0,-12,19,16,72
China,2009-09-01,150,2,-1,24,11,186
China,2009-09-01,177,0,2,74,34,287
China,2009-09-01,133,2,3,45,14,197
China,2009-09-01,98,0,-3,5,9,109
China,2009-09-01,80,0,2,-6,2,78
China,2009-09-01,146,0,0,26,13,185
China,2009-09-01,191,2,-3,46,11,247
China,2009-09-01,235,10,-11,127,27,388
China,2009-09-01,98,2,-1,47,18,164
China,2009-09-01,111,0,8,109,36,264
China,2009-09-01,75,4,0,27,15,121
China,2009-09-01,53,0,-6,30,15,92
China,2009-09-01,108,6,-10,31,8,143
China,2009-09-01,118,2,-2,31,8,157
China,2009-09-01,92,2,-2,43,11,146
Egypt,2009-09-01,20,0,0,23,0,43
Egypt,2009-09-01,36,0,2,12,0,50
Egypt,2009-09-01,14,0,2,13,2,31
Egypt,2009-09-01,3,0,0,9,5,17
Egypt,2009-09-01,15,0,2,-4,2,15
Egypt,2009-09-01,-4,0,0,21,0,17
Egypt,2009-09-01,13,0,0,15,0,28
Egypt,2009-09-01,25,0,0,22,2,49
Egypt,2009-09-01,52,0,1,10,2,65
Egypt,2009-09-01,47,0,-2,2,10,57
Egypt,2009-09-01,29,0,0,9,1,39
Egypt,2009-09-01,45,0,0,6,3,54
Egypt,2009-09-01,7,0,-1,12,0,18
Egypt,2009-09-01,61,0,0,15,0,76
Egypt,2009-09-01,30,0,0,12,0,42
Egypt,2009-09-01,42,0,-2,36,8,84
Egypt,2009-09-01,9,0,0,30,3,42
Egypt,2009-09-01,40,0,-6,-2,0,32
Egypt,2009-09-01,29,0,0,18,4,51
Egypt,2009-09-01,14,0,0,9,1,24
Egypt,2009-09-01,4,0,-4,2,2,4
Egypt,2009-09-01,35,4,-2,4,6,47
Egypt,2009-09-01,69,0,1,30,3,103
Egypt,2009-09-01,34,0,-2,18,4,54
Egypt,2009-09-01,18,0,0,3,6,27
Egypt,2009-09-01,61,0,0,-19,4,46
Egypt,2009-09-01,29,0,0,19,3,51
Egypt,2009-09-01,37,0,0,32,5,74
Egypt,2009-09-01,44,0,0,5,5,54
Egypt,2009-09-01,67,0,1,-19,11,60
Eritrea,2009-09-01,12,0,0,3,0,15
Eritrea,2009-09-01,0,0,0,0,0,0
Eritrea,2009-09-01,3,0,0,6,0,9
Eritrea,2009-09-01,8,0,0,2,0,10
Eritrea,2009-09-01,0,0,0,0,0,0
Eritrea,2009-09-01,2,0,0,-5,0,-3
Eritrea,2009-09-01,3,0,0,7,0,10
Eritrea,2009-09-01,-2,0,0,6,0,4
Eritrea,2009-09-01,20,0,0,0,0,20
Eritrea,2009-09-01,14,0,0,-2,0,12
Eritrea,2009-09-01,0,0,0,0,0,0
Eritrea,2009-09-01,0,0,0,6,0,6
Eritrea,2009-09-01,-10,0,0,3,0,-7
Eritrea,2009-09-01,-11,0,0,9,0,-2
Eritrea,2009-09-01,-4,0,1,0,0,-3
Eritrea,2009-09-01,4,0,0,3,0,7
Eritrea,2009-09-01,3,0,0,0,0,3
Eritrea,2009-09-01,0,0,0,-1,0,-1
Eritrea,2009-09-01,2,0,0,10,3,15
Eritrea,2009-09-01,14,0,0,0,0,14
Eritrea,2009-09-01,33,0,0,3,0,36
Eritrea,2009-09-01,3,0,0,4,0,7
Eritrea,2009-09-01,15,0,0,0,0,15
Eritrea,2009-09-01,3,0,0,9,0,12
Eritrea,2009-09-01,2,0,0,0,0,2
Eritrea,2009-09-01,0,0,0,0,0,0
Eritrea,2009-09-01,2,0,0,0,0,2
Eritrea,2009-09-01,5,0,0,6,0,11
Eritrea,2009-09-01,-2,0,0,15,0,13
Eritrea,2009-09-01,6,0,0,3,0,9
Georgia,2009-09-01,38,6,0,10,13,67
Georgia,2009-09-01,30,0,-2,17,4,49
Georgia,2009-09-01,17,0,-1,33,3,52
Georgia,2009-09-01,35,2,-4,11,3,47
Georgia,2009-09-01,20,0,0,16,1,37
Georgia,2009-09-01,24,0,0,3,0,27
Georgia,2009-09-01,47,0,0,5,1,53
Georgia,2009-09-01,21,0,0,15,7,43
Georgia,2009-09-01,18,0,2,12,4,36
Georgia,2009-09-01,18,0,5,6,1,30
Georgia,2009-09-01,31,0,0,36,6,73
Georgia,2009-09-01,32,2,0,0,6,40
Georgia,2009-09-01,17,0,0,0,2,19
Georgia,2009-09-01,19,0,0,13,3,35
Georgia,2009-09-01,22,0,0,12,3,37
Georgia,2009-09-01,39,2,2,20,4,67
Georgia,2009-09-01,38,0,-2,28,1,65
Georgia,2009-09-01,33,0,-4,15,4,48
Georgia,2009-09-01,14,0,0,8,1,23
Georgia,2009-09-01,5,0,0,3,0,8
Georgia,2009-09-01,15,2,3,21,5,46
Georgia,2009-09-01,24,0,0,-4,7,27
Georgia,2009-09-01,18,2,-1,17,5,41
Georgia,2009-09-01,25,0,-2,7,5,35
Georgia,2009-09-01,23,2,0,5,5,35
Georgia,2009-09-01,15,0,2,-2,3,18
Georgia,2009-09-01,12,0,0,1,0,13
Georgia,2009-09-01,14,0,1,3,2,20
Georgia,2009-09-01,20,0,0,46,6,72
Georgia,2009-09-01,47,0,-8,10,7,56
India,2009-09-01,51,0,-15,19,8,63
India,2009-09-01,60,2,-6,18,12,86
India,2009-09-01,56,0,-6,10,11,71
India,2009-09-01,49,0,-4,15,5,65
India,2009-09-01,31,0,0,16,4,51
India,2009-09-01,50,2,-1,21,7,79
India,2009-09-01,24,0,-3,8,14,43
India,2009-09-01,57,0,-2,18,17,90
India,2009-09-01,46,0,0,18,11,75
India,2009-09-01,28,0,0,-2,16,42
India,2009-09-01,49,0,0,7,7,63
India,2009-09-01,57,0,-3,6,10,70
India,2009-09-01,57,0,0,18,4,79
India,2009-09-01,67,0,-4,5,8,76
India,2009-09-01,37,0,-2,-9,6,32
India,2009-09-01,71,0,-3,12,12,92
India,2009-09-01,53,0,2,3,3,61
India,2009-09-01,67,0,-4,25,6,94
India,2009-09-01,69,0,1,3,3,76
India,2009-09-01,61,0,-17,19,8,71
India,2009-09-01,36,0,-3,1,1,35
India,2009-09-01,56,8,0,1,0,65
India,2009-09-01,86,0,-2,18,4,106
India,2009-09-01,73,0,0,7,7,87
India,2009-09-01,65,2,1,23,11,102
India,2009-09-01,61,0,0,3,8,72
India,2009-09-01,45,0,-1,7,4,55
India,2009-09-01,48,2,-3,19,3,69
India,2009-09-01,74,0,-1,7,13,93
India,2009-09-01,62,2,0,7,8,79
Iran,2009-09-01,102,0,-8,18,6,118
Iran,2009-09-01,71,0,5,59,7,142
Iran,2009-09-01,118,0,0,54,13,185
Iran,2009-09-01,14,0,0,10,4,28
Iran,2009-09-01,28,0,-4,34,5,63
Iran,2009-09-01,45,0,-4,18,2,61
Iran,2009-09-01,73,0,1,28,2,104
Iran,2009-09-01,147,0,-2,31,4,180
Iran,2009-09-01,106,0,0,31,4,141
Iran,2009-09-01,91,2,2,19,10,124
Iran,2009-09-01,82,0,-22,7,2,69
Iran,2009-09-01,72,8,1,25,31,137
Iran,2009-09-01,65,0,1,-3,8,71
Iran,2009-09-01,73,0,3,72,13,161
Iran,2009-09-01,62,0,0,24,3,89
Iran,2009-09-01,102,0,3,26,2,133
Iran,2009-09-01,268,0,0,64,14,346
Iran,2009-09-01,286,0,0,47,26,359
Iran,2009-09-01,162,0,1,17,4,184
Iran,2009-09-01,185,0,4,21,9,219
Iran,2009-09-01,117,0,-1,12,10,138
Iran,2009-09-01,121,0,1,56,10,188
Iran,2009-09-01,169,2,-6,181,50,396
Iran,2009-09-01,204,0,4,87,32,327
Iran,2009-09-01,184,6,4,19,19,232
Iran,2009-09-01,80,2,4,-2,12,96
Iran,2009-09-01,164,0,1,20,7,192
Iran,2009-09-01,185,0,2,28,6,221
Iran,2009-09-01,137,0,-3,46,10,190
Iran,2009-09-01,127,0,-2,31,9,165
Iraq,2009-09-01,82,2,0,24,8,116
Iraq,2009-09-01,91,2,-9,1,14,99
Iraq,2009-09-01,184,0,-3,19,5,205
Iraq,2009-09-01,85,0,1,41,12,139
Iraq,2009-09-01,33,0,0,13,2,48
Iraq,2009-09-01,45,2,0,12,3,62
Iraq,2009-09-01,105,0,0,37,18,160
Iraq,2009-09-01,138,4,-4,20,3,161
Iraq,2009-09-01,107,0,0,-4,11,114
Iraq,2009-09-01,228,0,-2,61,24,311
Iraq,2009-09-01,193,0,-1,50,16,258
Iraq,2009-09-01,121,0,0,13,15,149
Iraq,2009-09-01,77,2,0,17,22,118
Iraq,2009-09-01,121,0,0,20,16,157
Iraq,2009-09-01,103,0,1,18,34,156
Iraq,2009-09-01,120,0,0,27,27,174
Iraq,2009-09-01,132,0,0,1,13,146
Iraq,2009-09-01,75,2,0,41,5,123
Iraq,2009-09-01,70,0,-2,37,13,118
Iraq,2009-09-01,98,0,0,28,16,142
Iraq,2009-09-01,133,0,9,75,14,231
Iraq,2009-09-01,89,0,0,12,16,117
Iraq,2009-09-01,146,2,-2,74,7,227
Iraq,2009-09-01,136,0,2,37,20,195
Iraq,2009-09-01,146,0,6,48,9,209
Iraq,2009-09-01,87,0,3,11,7,108
Iraq,2009-09-01,71,0,4,-4,15,86
Iraq,2009-09-01,103,0,0,-4,3,102
Iraq,2009-09-01,90,0,0,38,7,135
Iraq,2009-09-01,52,0,-7,20,-2,63
Morocco,2009-09-01,10,0,0,1,1,12
Morocco,2009-09-01,3,0,0,12,1,16
Morocco,2009-09-01,9,0,-4,6,4,15
Morocco,2009-09-01,5,0,-8,0,7,4
Morocco,2009-09-01,2,0,0,0,12,14
Morocco,2009-09-01,2,0,0,3,0,5
Morocco,2009-09-01,5,0,0,-4,0,1
Morocco,2009-09-01,7,0,0,0,3,10
Morocco,2009-09-01,2,0,0,15,6,23
Morocco,2009-09-01,4,0,0,15,3,22
Morocco,2009-09-01,0,0,0,48,1,49
Morocco,2009-09-01,2,0,0,-2,0,0
Morocco,2009-09-01,0,0,0,-2,0,-2
Morocco,2009-09-01,0,0,0,7,0,7
Morocco,2009-09-01,0,0,0,3,0,3
Morocco,2009-09-01,1,0,0,0,0,1
Morocco,2009-09-01,1,0,0,0,0,1
Morocco,2009-09-01,3,0,0,1,1,5
Morocco,2009-09-01,0,0,0,0,0,0
Morocco,2009-09-01,3,0,0,1,0,4
Morocco,2009-09-01,1,0,0,24,0,25
Morocco,2009-09-01,2,0,-2,30,0,30
Morocco,2009-09-01,-7,0,-2,12,3,6
Morocco,2009-09-01,5,0,0,11,0,16
Morocco,2009-09-01,12,0,0,0,0,12
Morocco,2009-09-01,5,2,0,0,1,8
Morocco,2009-09-01,0,0,0,0,0,0
Morocco,2009-09-01,9,0,0,10,3,22
Morocco,2009-09-01,8,0,0,15,0,23
Morocco,2009-09-01,-1,0,0,0,0,-1
Nigeria,2009-09-01,16,0,0,9,4,29
Nigeria,2009-09-01,34,0,0,-1,9,42
Nigeria,2009-09-01,16,0,0,19,12,47
Nigeria,2009-09-01,6,0,0,22,5,33
Nigeria,2009-09-01,12,0,0,0,2,14
Nigeria,2009-09-01,16,0,3,4,1,24
Nigeria,2009-09-01,15,0,1,1,1,18
Nigeria,2009-09-01,20,0,0,0,2,22
Nigeria,2009-09-01,15,0,0,16,1,32
Nigeria,2009-09-01,18,0,0,11,0,29
Nigeria,2009-09-01,1,2,0,8,0,11
Nigeria,2009-09-01,2,0,0,3,2,7
Nigeria,2009-09-01,14,0,1,5,1,21
Nigeria,2009-09-01,25,0,0,25,0,50
Nigeria,2009-09-01,7,0,0,0,0,7
Nigeria,2009-09-01,6,0,-1,-4,2,3
Nigeria,2009-09-01,32,1,0,-1,0,32
Nigeria,2009-09-01,15,0,1,-2,0,14
Nigeria,2009-09-01,4,0,0,3,2,9
Nigeria,2009-09-01,8,0,0,3,3,14
Nigeria,2009-09-01,23,0,-1,33,0,55
Nigeria,2009-09-01,24,0,0,88,0,112
Nigeria,2009-09-01,36,2,0,6,3,47
Nigeria,2009-09-01,7,0,0,17,0,24
Nigeria,2009-09-01,10,0,0,26,0,36
Nigeria,2009-09-01,11,0,0,24,1,36
Nigeria,2009-09-01,13,0,0,9,8,30
Nigeria,2009-09-01,14,0,0,9,1,24
Nigeria,2009-09-01,59,0,0,7,24,90
Nigeria,2009-09-01,19,0,0,8,7,34
Pakistan,2009-09-01,55,2,-4,50,15,118
Pakistan,2009-09-01,101,0,0,21,13,135
Pakistan,2009-09-01,55,10,-2,31,8,102
Pakistan,2009-09-01,54,0,2,30,6,92
Pakistan,2009-09-01,82,0,1,3,1,87
Pakistan,2009-09-01,78,0,0,29,7,114
Pakistan,2009-09-01,74,0,-2,90,7,169
Pakistan,2009-09-01,248,0,-3,51,12,308
Pakistan,2009-09-01,154,0,0,21,5,180
Pakistan,2009-09-01,87,2,-2,62,10,159
Pakistan,2009-09-01,110,0,0,112,10,232
Pakistan,2009-09-01,148,0,1,33,23,205
Pakistan,2009-09-01,61,0,0,27,8,96
Pakistan,2009-09-01,118,0,0,71,1,190
Pakistan,2009-09-01,77,2,0,36,5,120
Pakistan,2009-09-01,110,0,1,33,10,154
Pakistan,2009-09-01,82,2,-1,5,12,100
Pakistan,2009-09-01,137,0,-4,12,15,160
Pakistan,2009-09-01,58,2,0,24,18,102
Pakistan,2009-09-01,85,0,6,75,8,174
Pakistan,2009-09-01,99,0,2,93,5,199
Pakistan,2009-09-01,92,6,1,42,10,151
Pakistan,2009-09-01,171,2,4,24,3,204
Pakistan,2009-09-01,130,2,3,50,2,187
Pakistan,2009-09-01,148,4,4,40,7,203
Pakistan,2009-09-01,43,0,0,30,7,80
Pakistan,2009-09-01,20,2,1,29,4,56
Pakistan,2009-09-01,149,0,3,34,15,201
Pakistan,2009-09-01,108,0,-3,25,8,138
Pakistan,2009-09-01,142,2,2,31,7,184
Sierra Leone,2009-09-01,5,0,0,3,1,9
Sierra Leone,2009-09-01,1,0,0,0,0,1
Sierra Leone,2009-09-01,0,0,0,0,0,0
Sierra Leone,2009-09-01,0,0,0,0,0,0
Sierra Leone,2009-09-01,0,0,0,6,0,6
Sierra Leone,2009-09-01,2,0,0,6,0,8
Sierra Leone,2009-09-01,0,0,0,-2,0,-2
Sierra Leone,2009-09-01,0,0,0,0,0,0
Sierra Leone,2009-09-01,46,0,0,6,0,52
Sierra Leone,2009-09-01,3,0,0,-2,1,2
Sierra Leone,2009-09-01,6,2,0,-3,1,6
Sierra Leone,2009-09-01,0,0,0,0,0,0
Sierra Leone,2009-09-01,0,0,0,0,0,0
Sierra Leone,2009-09-01,1,0,0,0,0,1
Sierra Leone,2009-09-01,-3,0,0,8,0,5
Sierra Leone,2009-09-01,4,0,0,0,0,4
Sierra Leone,2009-09-01,3,0,0,-4,1,0
Sierra Leone,2009-09-01,2,0,0,0,0,2
Sierra Leone,2009-09-01,0,0,0,0,0,0
Sierra Leone,2009-09-01,0,0,0,0,0,0
Sierra Leone,2009-09-01,-1,0,0,0,0,-1
Sierra Leone,2009-09-01,4,0,0,0,0,4
Sierra Leone,2009-09-01,9,0,0,0,1,10
Sierra Leone,2009-09-01,4,0,0,0,0,4
Sierra Leone,2009-09-01,1,0,0,3,0,4
Sierra Leone,2009-09-01,0,0,0,0,0,0
Sierra Leone,2009-09-01,0,0,0,0,0,0
Sierra Leone,2009-09-01,3,0,0,0,0,3
Sierra Leone,2009-09-01,7,0,0,0,0,7
Sierra Leone,2009-09-01,1,0,0,0,3,4
Somalia,2009-09-01,21,0,0,3,0,24
Somalia,2009-09-01,24,0,-4,19,0,39
Somalia,2009-09-01,7,0,0,2,2,11
Somalia,2009-09-01,18,0,1,8,2,29
Somalia,2009-09-01,7,0,0,3,1,11
Somalia,2009-09-01,5,0,0,7,6,18
Somalia,2009-09-01,16,0,0,15,0,31
Somalia,2009-09-01,36,0,0,23,0,59
Somalia,2009-09-01,54,0,0,-8,7,53
Somalia,2009-09-01,27,0,0,6,4,37
Somalia,2009-09-01,19,2,1,21,10,53
Somalia,2009-09-01,7,0,0,12,0,19
Somalia,2009-09-01,17,0,2,0,0,19
Somalia,2009-09-01,59,0,0,4,2,65
Somalia,2009-09-01,109,0,2,15,5,131
Somalia,2009-09-01,57,2,0,31,17,107
Somalia,2009-09-01,67,2,0,12,38,119
Somalia,2009-09-01,82,0,0,16,7,105
Somalia,2009-09-01,16,0,0,9,9,34
Somalia,2009-09-01,25,0,0,0,3,28
Somalia,2009-09-01,98,0,0,16,3,117
Somalia,2009-09-01,53,0,0,25,7,85
Somalia,2009-09-01,60,0,0,27,1,88
Somalia,2009-09-01,24,0,0,31,0,55
Somalia,2009-09-01,-2,0,0,6,0,4
Somalia,2009-09-01,31,0,0,27,0,58
Somalia,2009-09-01,15,0,0,18,0,33
Somalia,2009-09-01,43,0,0,10,7,60
Somalia,2009-09-01,34,0,0,30,3,67
Somalia,2009-09-01,51,0,-1,19,5,74
Syria,2009-09-01,12,0,0,3,0,15
Syria,2009-09-01,23,0,0,6,0,29
Syria,2009-09-01,34,2,0,6,0,42
Syria,2009-09-01,23,0,0,-5,4,22
Syria,2009-09-01,18,0,0,0,0,18
Syria,2009-09-01,42,2,0,34,3,81
Syria,2009-09-01,21,0,0,17,6,44
Syria,2009-09-01,54,0,-9,0,4,49
Syria,2009-09-01,25,0,-1,2,3,29
Syria,2009-09-01,28,0,0,3,2,33
Syria,2009-09-01,13,0,-1,0,0,12
Syria,2009-09-01,3,0,0,15,0,18
Syria,2009-09-01,0,0,0,6,1,7
Syria,2009-09-01,11,0,-6,25,1,31
Syria,2009-09-01,34,0,0,-14,0,20
Syria,2009-09-01,35,0,-6,13,1,43
Syria,2009-09-01,9,0,0,13,0,22
Syria,2009-09-01,34,0,0,27,9,70
Syria,2009-09-01,6,0,0,6,1,13
Syria,2009-09-01,2,0,0,1,2,5
Syria,2009-09-01,5,0,0,0,0,5
Syria,2009-09-01,5,0,0,9,2,16
Syria,2009-09-01,4,0,0,9,1,14
Syria,2009-09-01,22,0,0,3,4,29
Syria,2009-09-01,37,0,0,9,1,47
Syria,2009-09-01,16,0,0,15,2,33
Syria,2009-09-01,17,0,1,0,2,20
Syria,2009-09-01,22,0,0,3,2,27
Syria,2009-09-01,24,0,0,6,4,34
Syria,2009-09-01,23,0,1,6,1,31
Yemen,2009-09-01,15,2,0,0,10,27
Yemen,2009-09-01,55,14,0,22,9,100
Yemen,2009-09-01,14,0,0,4,0,18
Yemen,2009-09-01,47,2,0,0,1,50
Yemen,2009-09-01,9,0,0,3,0,12
Yemen,2009-09-01,7,0,0,7,0,14
Yemen,2009-09-01,49,0,0,-3,0,46
Yemen,2009-09-01,49,0,0,6,0,55
Yemen,2009-09-01,6,0,0,0,0,6
Yemen,2009-09-01,14,0,1,9,6,30
Yemen,2009-09-01,28,0,0,1,1,30
Yemen,2009-09-01,5,0,0,-1,0,4
Yemen,2009-09-01,2,0,0,13,0,15
Yemen,2009-09-01,16,0,0,10,0,26
Yemen,2009-09-01,32,0,0,4,0,36
Yemen,2009-09-01,6,0,0,0,1,7
Yemen,2009-09-01,77,0,0,-2,0,75
Yemen,2009-09-01,110,0,0,3,2,115
Yemen,2009-09-01,35,0,0,0,3,38
Yemen,2009-09-01,25,0,0,0,0,25
Yemen,2009-09-01,90,0,0,0,0,90
Yemen,2009-09-01,19,2,0,3,1,25
Yemen,2009-09-01,3,0,0,0,18,21
Yemen,2009-09-01,21,0,0,0,11,32
Yemen,2009-09-01,11,0,0,2,0,13
Yemen,2009-09-01,40,0,0,13,0,53
Yemen,2009-09-01,18,2,0,13,2,35
Yemen,2009-09-01,27,0,0,12,1,40
Yemen,2009-09-01,29,0,0,-3,1,27
Yemen,2009-09-01,37,0,0,19,8,64
Afghanistan,2010-08-01,218,0,-2,40,27,283
Afghanistan,2010-08-01,233,0,2,49,23,307
Afghanistan,2010-08-01,320,0,5,84,49,458
Afghanistan,2010-08-01,284,10,0,63,27,384
Afghanistan,2010-08-01,227,2,1,39,11,280
Afghanistan,2010-08-01,281,4,1,41,19,346
Afghanistan,2010-08-01,213,6,-1,13,17,248
Afghanistan,2010-08-01,255,8,1,36,24,324
Afghanistan,2010-08-01,327,8,0,96,18,449
Afghanistan,2010-08-01,345,12,0,120,42,519
Afghanistan,2010-08-01,259,18,0,71,11,359
Afghanistan,2010-08-01,354,12,2,164,56,588
Afghanistan,2010-08-01,236,0,-1,51,8,294
Afghanistan,2010-08-01,30,0,0,19,4,53
Afghanistan,2010-08-01,118,0,1,5,15,139
Afghanistan,2010-08-01,156,0,-22,26,18,178
Afghanistan,2010-08-01,235,4,-3,93,47,376
Afghanistan,2010-08-01,246,2,-2,36,14,296
Afghanistan,2010-08-01,179,0,0,4,7,190
Afghanistan,2010-08-01,135,0,0,15,3,153
Afghanistan,2010-08-01,277,4,1,99,86,467
Afghanistan,2010-08-01,207,4,2,77,38,328
Afghanistan,2010-08-01,334,6,1,69,48,458
Afghanistan,2010-08-01,320,6,1,47,29,403
Afghanistan,2010-08-01,405,2,1,62,40,510
Afghanistan,2010-08-01,321,4,2,82,40,449
Afghanistan,2010-08-01,244,0,-13,82,11,324
Afghanistan,2010-08-01,284,0,-3,47,16,344
Afghanistan,2010-08-01,256,0,1,47,13,317
Afghanistan,2010-08-01,323,0,-2,53,12,386
Afghanistan,2010-08-01,455,0,-1,27,8,489
Albania,2010-08-01,2,0,0,0,1,3
Albania,2010-08-01,3,0,0,-3,0,0
Albania,2010-08-01,9,0,-3,22,0,28
Albania,2010-08-01,1,0,-2,8,0,7
Albania,2010-08-01,11,0,0,4,0,15
Albania,2010-08-01,2,0,0,0,0,2
Albania,2010-08-01,0,0,0,9,0,9
Albania,2010-08-01,0,0,0,0,0,0
Albania,2010-08-01,5,0,0,6,0,11
Albania,2010-08-01,-7,0,0,10,0,3
Albania,2010-08-01,3,0,-3,6,0,6
Albania,2010-08-01,0,0,-2,0,0,-2
Albania,2010-08-01,3,0,0,0,0,3
Albania,2010-08-01,0,0,0,0,0,0
Albania,2010-08-01,0,0,0,0,0,0
Albania,2010-08-01,3,0,0,-4,0,-1
Albania,2010-08-01,3,0,0,0,0,3
Albania,2010-08-01,4,0,0,12,8,24
Albania,2010-08-01,6,0,-1,3,0,8
Albania,2010-08-01,2,0,0,0,0,2
Albania,2010-08-01,10,0,-1,7,0,16
Albania,2010-08-01,0,0,0,0,0,0
Albania,2010-08-01,17,0,0,13,0,30
Albania,2010-08-01,23,0,0,21,2,46
Albania,2010-08-01,21,0,-2,12,2,33
Albania,2010-08-01,5,0,0,3,1,9
Albania,2010-08-01,11,0,0,3,0,14
Albania,2010-08-01,-1,0,0,3,3,5
Albania,2010-08-01,0,0,0,-2,6,4
Albania,2010-08-01,8,0,0,12,0,20
Algeria,2010-08-01,3,0,0,0,0,3
Algeria,2010-08-01,10,0,0,9,0,19
Algeria,2010-08-01,2,0,0,0,0,2
Algeria,2010-08-01,5,0,0,0,0,5
Algeria,2010-08-01,2,0,0,0,0,2
Algeria,2010-08-01,9,0,0,9,1,19
Algeria,2010-08-01,0,0,0,3,0,3
Algeria,2010-08-01,5,0,0,18,6,29
Algeria,2010-08-01,7,0,0,0,2,9
Algeria,2010-08-01,1,0,0,0,0,1
Algeria,2010-08-01,4,0,0,3,0,7
Algeria,2010-08-01,12,0,0,3,0,15
Algeria,2010-08-01,18,0,0,0,0,18
Algeria,2010-08-01,0,0,0,0,0,0
Algeria,2010-08-01,2,0,0,0,0,2
Algeria,2010-08-01,16,0,0,34,1,51
Algeria,2010-08-01,5,0,0,-4,3,4
Algeria,2010-08-01,8,0,-2,-1,6,11
Algeria,2010-08-01,5,0,0,0,0,5
Algeria,2010-08-01,-1,0,0,3,0,2
Algeria,2010-08-01,14,0,-1,3,0,16
Algeria,2010-08-01,4,0,0,0,0,4
Algeria,2010-08-01,22,0,0,27,2,51
Algeria,2010-08-01,4,0,-1,0,0,3
Algeria,2010-08-01,26,0,0,3,19,48
Algeria,2010-08-01,17,0,0,6,0,23
Algeria,2010-08-01,4,0,0,0,0,4
Algeria,2010-08-01,9,0,0,6,0,15
Algeria,2010-08-01,6,0,0,0,0,6
Algeria,2010-08-01,0,0,0,0,0,0
Algeria,2010-08-01,44,0,0,3,0,47
Bangladesh,2010-08-01,5,2,1,6,0,14
Bangladesh,2010-08-01,4,0,0,12,2,18
Bangladesh,2010-08-01,22,2,0,16,3,43
Bangladesh,2010-08-01,26,0,0,30,0,56
Bangladesh,2010-08-01,23,0,-4,16,4,39
Bangladesh,2010-08-01,4,0,0,1,2,7
Bangladesh,2010-08-01,3,2,-1,18,1,23
Bangladesh,2010-08-01,9,0,0,-2,0,7
Bangladesh,2010-08-01,36,0,0,45,5,86
Bangladesh,2010-08-01,13,0,0,55,1,69
Bangladesh,2010-08-01,22,0,-6,7,0,23
Bangladesh,2010-08-01,8,0,0,14,0,22
Bangladesh,2010-08-01,2,0,0,15,1,18
Bangladesh,2010-08-01,1,0,0,0,0,1
Bangladesh,2010-08-01,12,0,0,3,0,15
Bangladesh,2010-08-01,12,0,0,3,2,17
Bangladesh,2010-08-01,14,2,0,7,6,29
Bangladesh,2010-08-01,29,2,0,25,4,60
Bangladesh,2010-08-01,16,0,0,40,1,57
Bangladesh,2010-08-01,-2,0,0,3,1,2
Bangladesh,2010-08-01,34,0,4,23,1,62
Bangladesh,2010-08-01,16,0,0,15,0,31
Bangladesh,2010-08-01,33,0,0,19,2,54
Bangladesh,2010-08-01,19,0,0,9,1,29
Bangladesh,2010-08-01,16,0,0,21,3,40
Bangladesh,2010-08-01,39,0,0,60,7,106
Bangladesh,2010-08-01,37,0,0,25,2,64
Bangladesh,2010-08-01,6,0,0,3,2,11
Bangladesh,2010-08-01,10,2,1,37,2,52
Bangladesh,2010-08-01,1,0,0,13,3,17
Bangladesh,2010-08-01,5,0,0,9,2,16
Cameroon,2010-08-01,0,0,0,0,0,0
Cameroon,2010-08-01,2,0,0,9,3,14
Cameroon,2010-08-01,0,0,0,3,0,3
Cameroon,2010-08-01,0,0,0,0,0,0
Cameroon,2010-08-01,2,0,0,6,0,8
Cameroon,2010-08-01,0,0,0,3,0,3
Cameroon,2010-08-01,5,0,0,3,0,8
Cameroon,2010-08-01,0,0,0,0,0,0
Cameroon,2010-08-01,0,0,0,0,0,0
Cameroon,2010-08-01,5,0,0,0,0,5
Cameroon,2010-08-01,5,2,0,-4,0,3
Cameroon,2010-08-01,1,0,0,0,0,1
Cameroon,2010-08-01,0,0,0,0,1,1
Cameroon,2010-08-01,0,0,0,3,1,4
Cameroon,2010-08-01,0,0,0,0,1,1
Cameroon,2010-08-01,0,0,0,0,0,0
Cameroon,2010-08-01,6,0,0,6,0,12
Cameroon,2010-08-01,0,0,0,0,0,0
Cameroon,2010-08-01,3,0,0,3,0,6
Cameroon,2010-08-01,0,0,0,3,1,4
Cameroon,2010-08-01,3,0,0,-5,0,-2
Cameroon,2010-08-01,5,0,0,0,0,5
Cameroon,2010-08-01,6,0,0,0,0,6
Cameroon,2010-08-01,5,0,0,0,0,5
Cameroon,2010-08-01,5,0,0,0,0,5
Cameroon,2010-08-01,0,0,0,0,0,0
Cameroon,2010-08-01,0,0,0,0,0,0
Cameroon,2010-08-01,0,0,0,3,0,3
China,2010-08-01,60,0,-1,49,12,120
China,2010-08-01,70,0,3,23,29,125
China,2010-08-01,142,0,-2,79,15,234
China,2010-08-01,136,2,-11,63,28,218
China,2010-08-01,124,0,-4,38,13,171
China,2010-08-01,165,0,-3,45,9,216
China,2010-08-01,58,4,0,25,9,96
China,2010-08-01,53,0,-1,97,8,157
China,2010-08-01,135,6,8,203,16,368
China,2010-08-01,159,2,-5,221,32,409
China,2010-08-01,158,2,-4,58,24,238
China,2010-08-01,125,4,-11,27,14,159
China,2010-08-01,95,0,-6,47,15,151
China,2010-08-01,12,0,0,6,0,18
China,2010-08-01,89,2,4,32,8,135
China,2010-08-01,164,0,1,31,13,209
China,2010-08-01,176,6,2,37,21,242
China,2010-08-01,180,2,0,59,23,264
China,2010-08-01,172,0,-5,44,15,226
China,2010-08-01,91,2,1,37,11,142
China,2010-08-01,89,2,0,71,13,175
China,2010-08-01,39,0,2,30,15,86
China,2010-08-01,252,0,-5,140,43,430
China,2010-08-01,230,0,-6,91,43,358
China,2010-08-01,255,4,-11,126,23,397
China,2010-08-01,166,0,4,34,16,220
China,2010-08-01,225,6,-5,62,19,307
China,2010-08-01,121,4,0,54,7,186
China,2010-08-01,99,6,0,51,5,161
China,2010-08-01,169,2,1,89,25,286
China,2010-08-01,182,6,3,36,24,251
Egypt,2010-08-01,86,0,0,3,2,91
Egypt,2010-08-01,227,0,0,7,16,250
Egypt,2010-08-01,73,0,0,34,0,107
Egypt,2010-08-01,239,0,2,18,15,274
Egypt,2010-08-01,63,0,0,7,3,73
Egypt,2010-08-01,43,0,1,4,4,52
Egypt,2010-08-01,33,0,0,6,4,43
Egypt,2010-08-01,37,0,0,6,0,43
Egypt,2010-08-01,62,0,0,16,5,83
Egypt,2010-08-01,50,0,1,31,3,85
Egypt,2010-08-01,40,0,2,3,1,46
Egypt,2010-08-01,25,0,-1,24,1,49
Egypt,2010-08-01,41,0,0,12,0,53
Egypt,2010-08-01,7,0,0,0,2,9
Egypt,2010-08-01,57,0,0,11,0,68
Egypt,2010-08-01,9,0,0,15,5,29
Egypt,2010-08-01,24,0,0,48,2,74
Egypt,2010-08-01,77,0,1,13,1,92
Egypt,2010-08-01,28,0,0,10,5,43
Egypt,2010-08-01,2,0,0,9,0,11
Egypt,2010-08-01,-14,0,-2,21,1,6
Egypt,2010-08-01,12,0,0,9,2,23
Egypt,2010-08-01,37,0,0,8,3,48
Egypt,2010-08-01,43,0,0,22,5,70
Egypt,2010-08-01,26,2,0,19,2,49
Egypt,2010-08-01,25,0,0,2,13,40
Egypt,2010-08-01,3,0,0,14,4,21
Egypt,2010-08-01,16,0,0,108,2,126
Egypt,2010-08-01,26,0,-1,-4,0,21
Egypt,2010-08-01,30,0,1,22,1,54
Egypt,2010-08-01,37,0,0,1,3,41
Eritrea,2010-08-01,5,0,0,0,5,10
Eritrea,2010-08-01,2,0,0,-2,1,1
Eritrea,2010-08-01,-2,0,0,0,0,-2
Eritrea,2010-08-01,0,0,0,6,0,6
Eritrea,2010-08-01,14,0,0,0,0,14
Eritrea,2010-08-01,1,0,0,-4,0,-3
Eritrea,2010-08-01,1,0,0,0,2,3
Eritrea,2010-08-01,2,0,0,-4,0,-2
Eritrea,2010-08-01,0,0,0,0,0,0
Eritrea,2010-08-01,20,0,0,-4,0,16
Eritrea,2010-08-01,11,0,0,0,1,12
Eritrea,2010-08-01,-1,0,-2,0,1,-2
Eritrea,2010-08-01,6,0,0,9,0,15
Eritrea,2010-08-01,51,0,0,0,2,53
Eritrea,2010-08-01,63,0,0,-2,4,65
Eritrea,2010-08-01,21,0,0,0,0,21
Eritrea,2010-08-01,2,2,0,2,1,7
Eritrea,2010-08-01,3,0,2,27,2,34
Eritrea,2010-08-01,2,0,0,0,0,2
Eritrea,2010-08-01,7,0,0,0,0,7
Eritrea,2010-08-01,6,0,0,0,0,6
Eritrea,2010-08-01,0,0,0,3,0,3
Eritrea,2010-08-01,3,0,0,0,0,3
Eritrea,2010-08-01,15,0,2,17,5,39
Eritrea,2010-08-01,-2,0,0,0,0,-2
Eritrea,2010-08-01,0,0,0,3,0,3
Eritrea,2010-08-01,-4,4,0,0,0,0
Eritrea,2010-08-01,2,0,0,45,0,47
Eritrea,2010-08-01,0,0,0,0,0,0
Eritrea,2010-08-01,16,0,0,-2,0,14
Eritrea,2010-08-01,0,0,0,12,0,12
Georgia,2010-08-01,9,0,1,0,2,12
Georgia,2010-08-01,21,4,0,3,0,28
Georgia,2010-08-01,37,18,0,9,4,68
Georgia,2010-08-01,56,0,-4,42,9,103
Georgia,2010-08-01,37,2,-2,29,1,67
Georgia,2010-08-01,31,2,0,45,14,92
Georgia,2010-08-01,11,0,0,6,11,28
Georgia,2010-08-01,19,0,0,-1,4,22
Georgia,2010-08-01,42,0,-6,16,6,58
Georgia,2010-08-01,45,0,0,30,15,90
Georgia,2010-08-01,53,0,1,18,4,76
Georgia,2010-08-01,41,0,-2,29,2,70
Georgia,2010-08-01,6,0,0,2,5,13
Georgia,2010-08-01,13,0,1,2,0,16
Georgia,2010-08-01,29,0,-1,37,4,69
Georgia,2010-08-01,71,0,4,9,4,88
Georgia,2010-08-01,51,0,1,13,5,70
Georgia,2010-08-01,59,0,1,28,3,91
Georgia,2010-08-01,29,0,0,19,3,51
Georgia,2010-08-01,12,0,0,0,1,13
Georgia,2010-08-01,11,0,0,0,2,13
Georgia,2010-08-01,41,0,1,0,3,45
Georgia,2010-08-01,108,0,0,20,8,136
Georgia,2010-08-01,64,2,-2,24,9,97
Georgia,2010-08-01,13,0,0,25,1,39
Georgia,2010-08-01,3,0,0,9,3,15
Georgia,2010-08-01,24,0,0,-4,1,21
Georgia,2010-08-01,12,4,0,16,0,32
Georgia,2010-08-01,47,0,0,12,5,64
Georgia,2010-08-01,52,2,1,9,8,72
India,2010-08-01,100,0,-1,37,13,149
India,2010-08-01,88,0,-1,22,34,143
India,2010-08-01,112,0,-3,29,11,149
India,2010-08-01,146,0,2,54,48,250
India,2010-08-01,117,2,2,31,25,177
India,2010-08-01,97,12,-3,45,20,171
India,2010-08-01,85,8,-1,48,4,144
India,2010-08-01,94,4,-5,122,16,231
India,2010-08-01,76,6,-8,25,4,103
India,2010-08-01,137,8,-7,30,13,181
India,2010-08-01,77,4,-3,14,6,98
India,2010-08-01,107,2,-4,18,11,134
India,2010-08-01,43,2,-6,14,5,58
India,2010-08-01,5,0,0,0,0,5
India,2010-08-01,58,0,0,9,3,70
India,2010-08-01,50,0,0,4,9,63
India,2010-08-01,79,2,-2,11,7,97
India,2010-08-01,148,0,-1,29,9,185
India,2010-08-01,82,8,1,31,7,129
India,2010-08-01,65,8,-2,23,7,101
India,2010-08-01,70,2,-3,46,14,129
India,2010-08-01,50,2,0,12,16,80
India,2010-08-01,65,0,-1,38,9,111
India,2010-08-01,91,0,0,1,8,100
India,2010-08-01,148,2,-1,29,23,201
India,2010-08-01,51,2,-2,35,7,93
India,2010-08-01,53,2,0,18,3,76
India,2010-08-01,61,2,2,16,7,88
India,2010-08-01,64,0,1,30,19,114
India,2010-08-01,79,0,0,46,4,129
India,2010-08-01,110,6,0,-4,10,122
Iran,2010-08-01,119,0,-4,35,17,167
Iran,2010-08-01,93,0,3,102,14,212
Iran,2010-08-01,141,0,0,162,17,320
Iran,2010-08-01,141,2,3,76,43,265
Iran,2010-08-01,106,0,0,17,8,131
Iran,2010-08-01,63,0,-4,19,10,88
Iran,2010-08-01,67,0,0,28,26,121
Iran,2010-08-01,74,0,-2,67,14,153
Iran,2010-08-01,67,2,1,13,13,96
Iran,2010-08-01,86,0,4,24,8,122
Iran,2010-08-01,80,0,2,43,2,127
Iran,2010-08-01,60,0,3,80,9,152
Iran,2010-08-01,49,0,0,46,8,103
Iran,2010-08-01,23,0,-2,3,0,24
Iran,2010-08-01,77,4,-6,22,5,102
Iran,2010-08-01,98,0,-15,43,53,179
Iran,2010-08-01,117,2,1,51,16,187
Iran,2010-08-01,121,2,0,35,11,169
Iran,2010-08-01,89,0,0,41,14,144
Iran,2010-08-01,41,0,0,13,3,57
Iran,2010-08-01,61,0,-1,34,4,98
Iran,2010-08-01,74,2,-4,15,2,89
Iran,2010-08-01,95,0,0,36,17,148
Iran,2010-08-01,122,10,0,38,16,186
Iran,2010-08-01,99,2,-2,35,24,158
Iran,2010-08-01,87,2,-2,90,11,188
Iran,2010-08-01,82,4,0,161,1,248
Iran,2010-08-01,97,0,1,142,3,243
Iran,2010-08-01,89,0,0,9,4,102
Iran,2010-08-01,43,0,0,14,12,69
Iran,2010-08-01,130,2,3,20,17,172
Iraq,2010-08-01,162,0,0,40,9,211
Iraq,2010-08-01,123,0,4,35,9,171
Iraq,2010-08-01,94,2,-1,50,10,155
Iraq,2010-08-01,70,8,-2,8,3,87
Iraq,2010-08-01,109,0,1,29,16,155
Iraq,2010-08-01,186,0,-3,24,9,216
Iraq,2010-08-01,68,0,0,-1,9,76
Iraq,2010-08-01,70,2,1,36,2,111
Iraq,2010-08-01,133,0,1,22,17,173
Iraq,2010-08-01,127,0,-2,7,14,146
Iraq,2010-08-01,190,0,-3,19,18,224
Iraq,2010-08-01,130,0,0,43,6,179
Iraq,2010-08-01,87,0,0,35,13,135
Iraq,2010-08-01,5,0,0,0,0,5
Iraq,2010-08-01,69,0,0,20,5,94
Iraq,2010-08-01,158,0,-4,26,15,195
Iraq,2010-08-01,147,12,-4,50,18,223
Iraq,2010-08-01,202,0,1,23,9,235
Iraq,2010-08-01,304,2,0,31,23,360
Iraq,2010-08-01,123,0,1,17,11,152
Iraq,2010-08-01,192,0,1,29,27,249
Iraq,2010-08-01,219,14,0,53,37,323
Iraq,2010-08-01,219,4,0,19,16,258
Iraq,2010-08-01,190,0,-2,1,10,199
Iraq,2010-08-01,258,0,3,54,13,328
Iraq,2010-08-01,235,2,0,30,25,292
Iraq,2010-08-01,135,0,4,67,12,218
Iraq,2010-08-01,107,0,2,63,13,185
Iraq,2010-08-01,151,0,-2,6,23,178
Iraq,2010-08-01,258,0,4,21,28,311
Iraq,2010-08-01,665,0,3,46,50,764
Morocco,2010-08-01,8,0,0,0,0,8
Morocco,2010-08-01,2,0,-2,-2,0,-2
Morocco,2010-08-01,3,0,-2,1,0,2
Morocco,2010-08-01,4,0,0,6,0,10
Morocco,2010-08-01,7,0,0,-4,0,3
Morocco,2010-08-01,10,0,2,0,0,12
Morocco,2010-08-01,0,0,0,0,0,0
Morocco,2010-08-01,0,0,0,0,0,0
Morocco,2010-08-01,7,0,0,9,0,16
Morocco,2010-08-01,4,0,0,0,2,6
Morocco,2010-08-01,0,0,0,0,0,0
Morocco,2010-08-01,24,0,2,3,6,35
Morocco,2010-08-01,4,0,0,6,0,10
Morocco,2010-08-01,7,0,0,0,2,9
Morocco,2010-08-01,3,0,0,0,0,3
Morocco,2010-08-01,3,0,0,0,1,4
Morocco,2010-08-01,14,0,0,12,8,34
Morocco,2010-08-01,12,0,-1,6,1,18
Morocco,2010-08-01,7,0,0,-4,0,3
Morocco,2010-08-01,9,0,0,0,3,12
Morocco,2010-08-01,0,0,0,0,0,0
Morocco,2010-08-01,23,0,0,42,3,68
Morocco,2010-08-01,9,0,0,24,0,33
Morocco,2010-08-01,9,0,0,3,0,12
Morocco,2010-08-01,3,0,0,3,0,6
Morocco,2010-08-01,3,0,0,0,0,3
Morocco,2010-08-01,-1,0,0,0,0,-1
Morocco,2010-08-01,0,0,-1,36,3,38
Morocco,2010-08-01,13,0,0,23,2,38
Morocco,2010-08-01,16,0,0,27,3,46
Nigeria,2010-08-01,7,0,2,7,6,22
Nigeria,2010-08-01,14,0,-2,20,7,39
Nigeria,2010-08-01,41,2,1,19,6,69
Nigeria,2010-08-01,20,0,-1,13,2,34
Nigeria,2010-08-01,21,4,0,10,1,36
Nigeria,2010-08-01,36,0,-4,17,0,49
Nigeria,2010-08-01,6,0,-4,6,0,8
Nigeria,2010-08-01,26,0,0,13,2,41
Nigeria,2010-08-01,30,2,0,6,5,43
Nigeria,2010-08-01,18,0,0,6,7,31
Nigeria,2010-08-01,34,0,0,21,6,61
Nigeria,2010-08-01,43,0,-1,2,6,50
Nigeria,2010-08-01,10,0,0,16,2,28
Nigeria,2010-08-01,5,0,0,-2,0,3
Nigeria,2010-08-01,27,2,-4,12,2,39
Nigeria,2010-08-01,45,0,-2,8,4,55
Nigeria,2010-08-01,9,0,0,57,3,69
Nigeria,2010-08-01,32,0,0,21,5,58
Nigeria,2010-08-01,55,0,1,8,2,66
Nigeria,2010-08-01,17,0,-3,-6,0,8
Nigeria,2010-08-01,29,0,-3,12,5,43
Nigeria,2010-08-01,17,2,0,6,8,33
Nigeria,2010-08-01,13,0,1,11,3,28
Nigeria,2010-08-01,30,0,0,49,0,79
Nigeria,2010-08-01,21,0,-2,4,4,27
Nigeria,2010-08-01,33,0,0,10,0,43
Nigeria,2010-08-01,21,0,0,18,2,41
Nigeria,2010-08-01,25,0,-1,22,0,46
Nigeria,2010-08-01,56,0,0,19,3,78
Nigeria,2010-08-01,39,0,0,14,4,57
Nigeria,2010-08-01,28,0,0,28,2,58
Pakistan,2010-08-01,132,0,0,58,12,202
Pakistan,2010-08-01,171,4,-3,49,57,278
Pakistan,2010-08-01,218,6,4,24,28,280
Pakistan,2010-08-01,226,0,1,116,23,366
Pakistan,2010-08-01,169,10,0,93,12,284
Pakistan,2010-08-01,180,10,-1,51,9,249
Pakistan,2010-08-01,232,54,-2,38,17,339
Pakistan,2010-08-01,220,22,2,33,9,286
Pakistan,2010-08-01,180,12,0,44,11,247
Pakistan,2010-08-01,182,10,0,68,16,276
Pakistan,2010-08-01,197,42,-1,77,16,331
Pakistan,2010-08-01,198,34,0,63,13,308
Pakistan,2010-08-01,167,18,0,4,9,198
Pakistan,2010-08-01,26,8,0,6,2,42
Pakistan,2010-08-01,83,26,2,23,6,140
Pakistan,2010-08-01,86,20,-2,-6,5,103
Pakistan,2010-08-01,98,26,6,27,19,176
Pakistan,2010-08-01,168,42,-2,5,14,227
Pakistan,2010-08-01,240,62,0,36,12,350
Pakistan,2010-08-01,108,44,-3,15,5,169
Pakistan,2010-08-01,128,16,1,14,6,165
Pakistan,2010-08-01,128,16,0,33,11,188
Pakistan,2010-08-01,128,28,1,13,5,175
Pakistan,2010-08-01,137,34,-3,5,10,183
Pakistan,2010-08-01,162,20,-2,19,34,233
Pakistan,2010-08-01,212,14,-3,80,29,332
Pakistan,2010-08-01,139,14,5,22,17,197
Pakistan,2010-08-01,121,4,3,54,46,228
Pakistan,2010-08-01,90,16,0,51,25,182
Pakistan,2010-08-01,138,18,0,20,28,204
Pakistan,2010-08-01,249,20,3,14,27,313
Sierra Leone,2010-08-01,0,2,0,9,0,11
Sierra Leone,2010-08-01,17,0,-2,12,2,29
Sierra Leone,2010-08-01,34,0,0,13,2,49
Sierra Leone,2010-08-01,60,0,0,1,6,67
Sierra Leone,2010-08-01,112,8,0,64,12,196
Sierra Leone,2010-08-01,46,4,0,14,11,75
Sierra Leone,2010-08-01,6,0,0,-3,1,4
Sierra Leone,2010-08-01,13,0,0,0,0,13
Sierra Leone,2010-08-01,63,2,5,-6,7,71
Sierra Leone,2010-08-01,42,0,7,8,8,65
Sierra Leone,2010-08-01,29,0,0,20,6,55
Sierra Leone,2010-08-01,19,0,0,24,9,52
Sierra Leone,2010-08-01,5,0,1,10,2,18
Sierra Leone,2010-08-01,0,0,0,3,1,4
Sierra Leone,2010-08-01,1,0,0,0,0,1
Sierra Leone,2010-08-01,8,0,0,0,1,9
Sierra Leone,2010-08-01,14,0,0,-1,1,14
Sierra Leone,2010-08-01,7,0,-16,6,0,-3
Sierra Leone,2010-08-01,7,0,0,13,0,20
Sierra Leone,2010-08-01,6,0,0,-5,2,3
Sierra Leone,2010-08-01,0,0,-4,-2,1,-5
Sierra Leone,2010-08-01,1,0,0,0,0,1
Sierra Leone,2010-08-01,3,0,0,6,1,10
Sierra Leone,2010-08-01,11,0,0,0,0,11
Sierra Leone,2010-08-01,15,0,0,3,0,18
Sierra Leone,2010-08-01,0,0,0,0,0,0
Sierra Leone,2010-08-01,0,0,0,0,0,0
Sierra Leone,2010-08-01,0,0,0,3,0,3
Sierra Leone,2010-08-01,4,0,0,3,0,7
Sierra Leone,2010-08-01,2,0,0,3,0,5
Somalia,2010-08-01,16,2,0,3,1,22
Somalia,2010-08-01,65,0,0,1,0,66
Somalia,2010-08-01,41,0,0,12,1,54
Somalia,2010-08-01,60,2,0,24,0,86
Somalia,2010-08-01,72,22,0,134,2,230
Somalia,2010-08-01,81,14,0,73,0,168
Somalia,2010-08-01,22,0,0,0,12,34
Somalia,2010-08-01,17,6,0,-16,2,9
Somalia,2010-08-01,50,2,0,48,2,102
Somalia,2010-08-01,30,6,0,48,3,87
Somalia,2010-08-01,33,6,0,3,0,42
Somalia,2010-08-01,19,0,0,17,0,36
Somalia,2010-08-01,29,0,0,-9,0,20
Somalia,2010-08-01,3,0,0,6,0,9
Somalia,2010-08-01,45,0,0,12,0,57
Somalia,2010-08-01,42,0,0,9,7,58
Somalia,2010-08-01,19,4,0,36,7,66
Somalia,2010-08-01,11,0,0,24,9,44
Somalia,2010-08-01,9,0,0,9,4,22
Somalia,2010-08-01,9,2,0,4,0,15
Somalia,2010-08-01,3,0,0,1,0,4
Somalia,2010-08-01,3,0,0,31,0,34
Somalia,2010-08-01,3,0,0,14,8,25
Somalia,2010-08-01,45,0,0,4,23,72
Somalia,2010-08-01,62,0,1,13,5,81
Somalia,2010-08-01,37,0,0,21,10,68
Somalia,2010-08-01,68,2,-1,27,5,101
Somalia,2010-08-01,67,0,3,12,0,82
Somalia,2010-08-01,17,0,0,1,1,19
Somalia,2010-08-01,39,0,0,11,6,56
Somalia,2010-08-01,19,0,0,4,5,28
Syria,2010-08-01,23,0,0,18,6,47
Syria,2010-08-01,22,0,0,15,1,38
Syria,2010-08-01,81,0,0,12,5,98
Syria,2010-08-01,49,0,0,16,0,65
Syria,2010-08-01,22,0,0,13,1,36
Syria,2010-08-01,16,0,0,18,1,35
Syria,2010-08-01,6,4,0,1,0,11
Syria,2010-08-01,20,4,0,3,0,27
Syria,2010-08-01,14,0,0,4,7,25
Syria,2010-08-01,14,4,0,6,2,26
Syria,2010-08-01,6,0,0,0,0,6
Syria,2010-08-01,14,0,0,6,0,20
Syria,2010-08-01,0,0,0,-1,0,-1
Syria,2010-08-01,0,0,0,0,0,0
Syria,2010-08-01,15,0,0,1,5,21
Syria,2010-08-01,15,0,0,8,0,23
Syria,2010-08-01,5,0,0,6,2,13
Syria,2010-08-01,29,0,0,-2,0,27
Syria,2010-08-01,29,0,0,0,-2,27
Syria,2010-08-01,19,0,0,-2,0,17
Syria,2010-08-01,14,0,0,6,0,20
Syria,2010-08-01,15,0,0,4,1,20
Syria,2010-08-01,28,0,0,3,0,31
Syria,2010-08-01,18,0,0,9,6,33
Syria,2010-08-01,63,0,0,10,4,77
Syria,2010-08-01,32,0,0,8,2,42
Syria,2010-08-01,19,0,0,21,0,40
Syria,2010-08-01,9,0,0,3,0,12
Syria,2010-08-01,7,0,1,-4,4,8
Syria,2010-08-01,34,0,0,20,4,58
Syria,2010-08-01,7,0,0,0,2,9
Yemen,2010-08-01,26,0,0,-2,0,24
Yemen,2010-08-01,7,0,0,0,0,7
Yemen,2010-08-01,32,0,-1,7,24,62
Yemen,2010-08-01,13,0,0,0,2,15
Yemen,2010-08-01,20,0,0,6,0,26
Yemen,2010-08-01,34,0,0,18,4,56
Yemen,2010-08-01,17,0,0,24,3,44
Yemen,2010-08-01,5,0,0,-2,0,3
Yemen,2010-08-01,16,0,0,-2,6,20
Yemen,2010-08-01,18,0,0,10,0,28
Yemen,2010-08-01,12,0,0,0,4,16
Yemen,2010-08-01,15,0,0,1,0,16
Yemen,2010-08-01,3,0,0,-2,0,1
Yemen,2010-08-01,0,0,0,0,0,0
Yemen,2010-08-01,7,0,0,0,2,9
Yemen,2010-08-01,5,0,0,-3,2,4
Yemen,2010-08-01,15,0,0,2,0,17
Yemen,2010-08-01,3,0,0,18,7,28
Yemen,2010-08-01,12,0,0,6,1,19
Yemen,2010-08-01,15,0,0,1,0,16
Yemen,2010-08-01,70,0,0,1,0,71
Yemen,2010-08-01,53,0,0,0,0,53
Yemen,2010-08-01,19,0,0,3,0,22
Yemen,2010-08-01,30,0,0,46,0,76
Yemen,2010-08-01,67,0,1,20,14,102
Yemen,2010-08-01,58,0,0,2,9,69
Yemen,2010-08-01,61,0,0,24,8,93
Yemen,2010-08-01,31,2,0,3,0,36
Yemen,2010-08-01,18,0,0,3,0,21
Yemen,2010-08-01,33,0,0,31,4,68
Yemen,2010-08-01,49,0,0,57,2,108
