"country","year_month","state_based_conflict","one_sided_violence","non_state_conflict","deaths_civilians","type_of_violence_category"
"Afghanistan",2009-01-01,33,0,0,33,5
"Afghanistan",2009-02-01,53,3,0,56,5
"Afghanistan",2009-03-01,41,10,0,51,5
"Afghanistan",2009-04-01,50,5,0,55,5
"Afghanistan",2009-05-01,150,16,0,166,5
"Afghanistan",2009-06-01,71,3,0,74,5
"Afghanistan",2009-07-01,82,5,0,87,5
"Afghanistan",2009-08-01,117,47,0,164,5
"Afghanistan",2009-09-01,197,17,0,214,5
"Afghanistan",2009-10-01,37,10,0,47,5
"Afghanistan",2009-11-01,62,15,0,77,5
"Afghanistan",2009-12-01,54,21,0,75,5
"Afghanistan",2010-01-01,35,17,0,52,5
"Afghanistan",2010-02-01,87,3,0,90,5
"Afghanistan",2010-03-01,86,2,19,107,7
"Afghanistan",2010-04-01,77,10,0,87,5
"Afghanistan",2010-05-01,54,17,0,71,5
"Afghanistan",2010-06-01,98,52,0,150,7
"Afghanistan",2010-07-01,133,25,0,158,7
"Afghanistan",2010-08-01,130,15,0,145,5
"Afghanistan",2010-09-01,59,8,0,67,5
"Afghanistan",2010-10-01,98,4,0,102,5
"Afghanistan",2010-11-01,56,1,0,57,5
"Afghanistan",2010-12-01,75,10,0,85,5
"Afghanistan",2011-01-01,87,14,0,101,5
"Afghanistan",2011-02-01,45,1,0,46,5
"Afghanistan",2011-03-01,71,1,0,72,5
"Afghanistan",2011-04-01,31,1,0,32,7
"Afghanistan",2011-05-01,52,2,0,54,7
"Afghanistan",2011-06-01,100,11,0,111,7
"Afghanistan",2011-07-01,120,3,0,123,5
"Afghanistan",2011-08-01,87,10,0,97,5
"Afghanistan",2011-09-01,98,11,0,109,7
"Afghanistan",2011-10-01,64,7,0,71,5
"Afghanistan",2011-11-01,61,2,0,63,5
"Afghanistan",2011-12-01,69,64,0,133,5
"Afghanistan",2012-01-01,57,0,0,57,5
"Afghanistan",2012-02-01,29,2,0,31,5
"Afghanistan",2012-03-01,48,0,0,48,1
"Afghanistan",2012-04-01,44,0,0,44,1
"Afghanistan",2012-05-01,89,1,0,90,7
"Afghanistan",2012-06-01,102,30,0,132,5
"Afghanistan",2012-07-01,93,10,0,103,5
"Afghanistan",2012-08-01,94,3,0,97,5
"Afghanistan",2012-09-01,82,5,0,87,5
"Afghanistan",2012-10-01,90,7,0,97,5
"Afghanistan",2012-11-01,76,5,0,81,5
"Afghanistan",2012-12-01,35,0,0,35,5
"Afghanistan",2013-01-01,21,2,0,23,5
"Afghanistan",2013-02-01,40,0,0,40,1
"Afghanistan",2013-03-01,50,2,0,52,5
"Afghanistan",2013-04-01,96,9,0,105,7
"Afghanistan",2013-05-01,66,4,0,70,5
"Afghanistan",2013-06-01,103,3,0,106,5
"Afghanistan",2013-07-01,91,3,0,94,7
"Afghanistan",2013-08-01,111,5,0,116,5
"Afghanistan",2013-09-01,67,2,0,69,5
"Afghanistan",2013-10-01,65,10,0,75,5
"Afghanistan",2013-11-01,48,19,0,67,5
"Afghanistan",2013-12-01,43,4,0,47,5
"Afghanistan",2014-01-01,51,3,0,54,7
"Afghanistan",2014-02-01,24,2,0,26,7
"Afghanistan",2014-03-01,40,45,0,85,5
"Afghanistan",2014-04-01,39,13,0,52,5
"Afghanistan",2014-05-01,61,1,0,62,5
"Afghanistan",2014-06-01,63,14,0,77,5
"Afghanistan",2014-07-01,102,8,0,110,5
"Afghanistan",2014-08-01,37,17,0,54,5
"Afghanistan",2014-09-01,48,4,0,52,7
"Afghanistan",2014-10-01,39,9,0,48,5
"Afghanistan",2014-11-01,29,69,0,98,5
"Afghanistan",2014-12-01,71,28,0,99,5
"Afghanistan",2015-01-01,55,5,0,60,7
"Afghanistan",2015-02-01,20,9,0,29,7
"Afghanistan",2015-03-01,76,21,0,97,7
"Afghanistan",2015-04-01,64,14,0,78,7
"Afghanistan",2015-05-01,53,23,0,76,7
"Afghanistan",2015-06-01,82,10,0,92,7
"Afghanistan",2015-07-01,81,11,5,97,7
"Afghanistan",2015-08-01,65,6,0,71,7
"Afghanistan",2015-09-01,30,25,21,76,7
"Afghanistan",2015-10-01,65,8,0,73,7
"Afghanistan",2015-11-01,5,17,0,22,7
"Afghanistan",2015-12-01,52,2,0,54,7
"Afghanistan",2016-01-01,29,19,0,48,7
"Afghanistan",2016-02-01,40,9,0,49,7
"Afghanistan",2016-03-01,24,13,0,37,7
"Afghanistan",2016-04-01,74,6,0,80,7
"Afghanistan",2016-05-01,70,25,0,95,7
"Afghanistan",2016-06-01,48,30,0,78,7
"Afghanistan",2016-07-01,26,92,0,118,5
"Afghanistan",2016-08-01,79,9,0,88,5
"Afghanistan",2016-09-01,67,7,0,74,5
"Afghanistan",2016-10-01,39,65,0,104,7
"Afghanistan",2016-11-01,72,34,0,106,5
"Afghanistan",2016-12-01,24,19,0,43,5
"Afghanistan",2017-01-01,23,13,0,36,7
"Afghanistan",2017-02-01,56,15,0,71,7
"Afghanistan",2017-03-01,47,15,0,62,7
"Afghanistan",2017-04-01,39,4,3,46,7
"Afghanistan",2017-05-01,94,5,0,99,7
"Afghanistan",2017-06-01,36,9,2,47,7
"Afghanistan",2017-07-01,116,15,0,131,7
"Afghanistan",2017-08-01,110,65,0,175,7
"Afghanistan",2017-09-01,38,21,0,59,7
"Afghanistan",2017-10-01,39,69,0,108,7
"Afghanistan",2017-11-01,45,2,0,47,7
"Afghanistan",2017-12-01,26,60,0,86,7
"Afghanistan",2018-01-01,73,6,0,79,7
"Afghanistan",2018-02-01,22,14,0,36,5
"Afghanistan",2018-03-01,66,38,0,104,7
"Afghanistan",2018-04-01,91,98,0,189,5
"Afghanistan",2018-05-01,70,18,0,88,7
"Afghanistan",2018-06-01,32,16,0,48,7
"Afghanistan",2018-07-01,92,32,15,139,7
"Afghanistan",2018-08-01,44,85,0,129,7
"Afghanistan",2018-09-01,94,100,0,194,7
"Afghanistan",2018-10-01,167,58,1,226,7
"Afghanistan",2018-11-01,109,67,0,176,7
"Afghanistan",2018-12-01,130,1,0,131,7
"Afghanistan",2019-01-01,38,18,0,56,7
"Afghanistan",2019-02-01,51,12,0,63,7
"Afghanistan",2019-03-01,122,7,0,129,5
"Afghanistan",2019-04-01,49,9,0,58,7
"Afghanistan",2019-05-01,207,21,1,229,7
"Afghanistan",2019-06-01,43,19,0,62,5
"Afghanistan",2019-07-01,249,37,0,286,7
"Afghanistan",2019-08-01,67,116,5,188,7
"Afghanistan",2019-09-01,311,20,0,331,5
"Afghanistan",2019-10-01,66,91,0,157,5
"Afghanistan",2019-11-01,91,6,0,97,7
"Afghanistan",2019-12-01,73,16,0,89,5
"Afghanistan",2020-01-01,82,14,0,96,5
"Afghanistan",2020-02-01,48,18,0,66,5
"Afghanistan",2020-03-01,87,57,0,144,5
"Afghanistan",2020-04-01,62,20,0,82,5
"Afghanistan",2020-05-01,99,71,0,170,5
"Afghanistan",2020-06-01,95,21,0,116,5
"Afghanistan",2020-07-01,102,18,0,120,5
"Afghanistan",2020-08-01,162,12,0,174,5
"Afghanistan",2020-09-01,120,19,0,139,5
"Afghanistan",2020-10-01,196,51,0,247,5
"Afghanistan",2020-11-01,141,22,0,163,7
"Afghanistan",2020-12-01,65,19,0,84,5
"Afghanistan",2021-01-01,73,29,2,104,7
"Afghanistan",2021-02-01,24,8,0,32,5
"Afghanistan",2021-03-01,104,28,0,132,5
"Afghanistan",2021-04-01,96,22,0,118,5
"Afghanistan",2021-05-01,123,124,0,247,7
"Afghanistan",2021-06-01,173,76,0,249,5
"Afghanistan",2021-07-01,188,47,0,235,5
"Afghanistan",2021-08-01,211,33,0,244,5
"Afghanistan",2021-09-01,9,48,0,57,5
"Afghanistan",2021-10-01,29,147,0,176,5
"Afghanistan",2021-11-01,9,13,0,22,5
"Afghanistan",2021-12-01,2,11,0,13,5
"Afghanistan",2022-01-01,1,14,0,15,5
"Afghanistan",2022-02-01,0,3,0,3,5
"Afghanistan",2022-03-01,1,7,0,8,5
"Afghanistan",2022-04-01,48,241,0,289,5
"Afghanistan",2022-05-01,4,71,0,75,5
"Afghanistan",2022-06-01,3,66,0,69,5
"Afghanistan",2022-07-01,0,12,0,12,5
"Afghanistan",2022-08-01,3,38,0,41,5
"Afghanistan",2022-09-01,17,113,0,130,5
"Afghanistan",2022-10-01,0,14,0,14,5
"Afghanistan",2022-11-01,0,30,0,30,5
"Afghanistan",2022-12-01,5,10,0,15,5
"Afghanistan",2023-01-01,10,3,0,13,5
"Afghanistan",2023-02-01,1,9,0,10,5
"Afghanistan",2023-03-01,6,5,0,11,5
"Afghanistan",2023-04-01,2,5,0,7,5
"Afghanistan",2023-05-01,0,6,0,6,5
"Afghanistan",2023-06-01,1,1,0,2,5
"Afghanistan",2023-07-01,0,5,0,5,7
"Afghanistan",2023-08-01,1,1,0,2,5
"Afghanistan",2023-09-01,4,3,0,7,5
"Afghanistan",2023-10-01,0,30,0,30,5
"Afghanistan",2023-11-01,0,9,0,9,5
"Afghanistan",2023-12-01,0,8,0,8,5
"Afghanistan",2024-01-01,3,13,0,16,7
"Afghanistan",2024-02-01,0,0,0,0,5
"Afghanistan",2024-03-01,16,1,0,17,5
"Afghanistan",2024-04-01,0,8,0,8,5
"Bangladesh",2009-01-01,0,0,1,1,2
"Bangladesh",2009-02-01,0,0,0,0,2
"Bangladesh",2009-03-01,0,0,0,0,2
"Bangladesh",2009-10-01,0,0,0,0,1
"Bangladesh",2009-11-01,0,1,0,1,4
"Bangladesh",2010-02-01,0,1,0,1,6
"Bangladesh",2010-05-01,0,0,0,0,3
"Bangladesh",2010-10-01,0,0,0,0,2
"Bangladesh",2010-11-01,0,0,0,0,2
"Bangladesh",2012-12-01,0,0,0,0,2
"Bangladesh",2013-01-01,0,0,0,0,2
"Bangladesh",2013-02-01,0,1,0,1,6
"Bangladesh",2013-03-01,0,7,1,8,6
"Bangladesh",2013-04-01,0,0,0,0,2
"Bangladesh",2013-07-01,0,0,0,0,2
"Bangladesh",2013-10-01,0,0,0,0,2
"Bangladesh",2013-11-01,0,0,0,0,2
"Bangladesh",2013-12-01,0,2,0,2,6
"Bangladesh",2014-01-01,0,0,0,0,2
"Bangladesh",2015-01-01,0,0,0,0,2
"Bangladesh",2015-09-01,0,3,0,3,4
"Bangladesh",2015-10-01,0,2,0,2,4
"Bangladesh",2015-11-01,0,2,0,2,5
"Bangladesh",2016-01-01,0,1,0,1,4
"Bangladesh",2016-02-01,0,1,0,1,4
"Bangladesh",2016-03-01,0,2,0,2,4
"Bangladesh",2016-04-01,0,2,0,2,4
"Bangladesh",2016-05-01,0,2,0,2,4
"Bangladesh",2016-06-01,0,3,0,3,4
"Bangladesh",2016-07-01,0,21,0,21,5
"Bangladesh",2016-08-01,0,0,0,0,1
"Bangladesh",2016-09-01,0,0,0,0,1
"Bangladesh",2016-10-01,0,0,0,0,1
"Bangladesh",2016-12-01,0,0,0,0,1
"Bangladesh",2017-01-01,0,0,0,0,1
"Bangladesh",2017-02-01,0,0,0,0,1
"Bangladesh",2017-03-01,5,0,0,5,1
"Bangladesh",2017-04-01,0,0,0,0,1
"Bangladesh",2017-05-01,0,0,0,0,1
"Bangladesh",2017-06-01,0,0,0,0,1
"Bangladesh",2017-08-01,0,1,0,1,5
"Bangladesh",2017-09-01,2,0,0,2,1
"Bangladesh",2017-12-01,0,0,0,0,1
"Bangladesh",2018-06-01,0,2,0,2,4
"Bangladesh",2018-07-01,0,1,0,1,4
"Bangladesh",2018-10-01,0,0,0,0,1
"Bangladesh",2018-12-01,0,0,0,0,2
"Bangladesh",2019-02-01,0,0,0,0,4
"Bangladesh",2019-04-01,0,0,0,0,1
"Bangladesh",2019-11-01,0,0,0,0,1
"Bangladesh",2020-03-01,1,0,0,1,1
"Bangladesh",2020-04-01,0,1,0,1,4
"Bangladesh",2020-07-01,0,1,0,1,4
"Bangladesh",2020-10-01,1,0,0,1,1
"Bangladesh",2020-12-01,0,0,0,0,1
"Bangladesh",2021-01-01,0,0,0,0,2
"Bangladesh",2021-08-01,0,0,0,0,2
"Bangladesh",2021-09-01,0,1,0,1,4
"Bangladesh",2022-02-01,0,0,0,0,1
"Bangladesh",2022-08-01,0,2,0,2,4
"Bangladesh",2022-09-01,1,2,0,3,5
"Bangladesh",2022-10-01,1,2,0,3,5
"Bangladesh",2022-12-01,0,1,0,1,4
"Bangladesh",2023-01-01,0,1,1,2,7
"Bangladesh",2023-02-01,0,0,0,0,2
"Bangladesh",2023-03-01,1,0,0,1,1
"Bangladesh",2023-04-01,0,1,0,1,6
"Bangladesh",2023-05-01,2,0,0,2,1
"Bangladesh",2023-06-01,0,1,0,1,7
"Bangladesh",2023-07-01,0,3,0,3,6
"Bangladesh",2023-08-01,0,2,0,2,6
"Bangladesh",2023-09-01,0,0,2,2,2
"Bangladesh",2023-10-01,0,0,0,0,3
"Bangladesh",2023-12-01,0,4,1,5,6
"Bangladesh",2024-01-01,0,3,1,4,6
"Bangladesh",2024-02-01,2,1,0,3,7
"Bangladesh",2024-03-01,0,2,0,2,6
"Bangladesh",2024-04-01,0,2,0,2,5
"Cameroon",2013-12-01,0,1,0,1,4
"Cameroon",2014-05-01,0,0,0,0,1
"Cameroon",2014-06-01,0,0,0,0,1
"Cameroon",2014-07-01,0,0,0,0,1
"Cameroon",2014-08-01,0,3,0,3,5
"Cameroon",2014-09-01,0,23,0,23,5
"Cameroon",2014-10-01,8,34,0,42,5
"Cameroon",2014-11-01,0,7,0,7,4
"Cameroon",2014-12-01,0,6,0,6,5
"Cameroon",2015-01-01,0,54,0,54,5
"Cameroon",2015-02-01,0,130,0,130,5
"Cameroon",2015-03-01,0,10,0,10,5
"Cameroon",2015-04-01,0,16,0,16,4
"Cameroon",2015-05-01,0,0,0,0,1
"Cameroon",2015-06-01,0,0,0,0,1
"Cameroon",2015-07-01,0,49,0,49,5
"Cameroon",2015-08-01,0,30,0,30,5
"Cameroon",2015-09-01,2,7,0,9,5
"Cameroon",2015-10-01,0,19,0,19,5
"Cameroon",2015-11-01,0,15,0,15,5
"Cameroon",2015-12-01,0,8,0,8,5
"Cameroon",2016-01-01,0,69,0,69,5
"Cameroon",2016-02-01,3,67,0,70,5
"Cameroon",2016-03-01,1,8,0,9,5
"Cameroon",2016-04-01,0,9,0,9,5
"Cameroon",2016-05-01,0,11,0,11,5
"Cameroon",2016-06-01,0,35,0,35,5
"Cameroon",2016-07-01,0,23,0,23,5
"Cameroon",2016-08-01,0,3,0,3,5
"Cameroon",2016-09-01,0,5,0,5,5
"Cameroon",2016-10-01,0,6,0,6,5
"Cameroon",2016-11-01,0,16,0,16,5
"Cameroon",2016-12-01,0,6,1,7,6
"Cameroon",2017-01-01,0,23,0,23,5
"Cameroon",2017-02-01,0,5,0,5,7
"Cameroon",2017-03-01,0,1,0,1,7
"Cameroon",2017-04-01,3,7,0,10,7
"Cameroon",2017-05-01,0,5,0,5,7
"Cameroon",2017-06-01,2,22,0,24,7
"Cameroon",2017-07-01,0,22,0,22,7
"Cameroon",2017-08-01,0,35,0,35,7
"Cameroon",2017-09-01,0,16,0,16,5
"Cameroon",2017-10-01,0,24,0,24,5
"Cameroon",2017-11-01,0,7,0,7,7
"Cameroon",2017-12-01,0,24,0,24,7
"Cameroon",2018-01-01,0,20,0,20,5
"Cameroon",2018-02-01,5,23,0,28,5
"Cameroon",2018-03-01,1,5,0,6,5
"Cameroon",2018-04-01,0,15,0,15,5
"Cameroon",2018-05-01,5,3,0,8,5
"Cameroon",2018-06-01,4,8,0,12,7
"Cameroon",2018-07-01,15,27,0,42,5
"Cameroon",2018-08-01,3,6,0,9,5
"Cameroon",2018-09-01,7,43,0,50,5
"Cameroon",2018-10-01,6,10,0,16,5
"Cameroon",2018-11-01,0,10,0,10,5
"Cameroon",2018-12-01,2,17,0,19,5
"Cameroon",2019-01-01,0,11,0,11,7
"Cameroon",2019-02-01,0,23,0,23,5
"Cameroon",2019-03-01,4,25,0,29,5
"Cameroon",2019-04-01,10,26,0,36,7
"Cameroon",2019-05-01,5,9,0,14,5
"Cameroon",2019-06-01,11,1,0,12,5
"Cameroon",2019-07-01,1,6,0,7,7
"Cameroon",2019-08-01,4,7,0,11,5
"Cameroon",2019-09-01,1,3,0,4,5
"Cameroon",2019-10-01,0,1,0,1,7
"Cameroon",2019-11-01,2,4,0,6,5
"Cameroon",2019-12-01,6,5,0,11,5
"Cameroon",2020-01-01,1,40,0,41,5
"Cameroon",2020-02-01,8,38,0,46,5
"Cameroon",2020-03-01,9,22,0,31,5
"Cameroon",2020-04-01,20,27,0,47,5
"Cameroon",2020-05-01,12,19,0,31,5
"Cameroon",2020-06-01,10,16,0,26,5
"Cameroon",2020-07-01,10,26,0,36,7
"Cameroon",2020-08-01,8,39,0,47,5
"Cameroon",2020-09-01,5,30,0,35,5
"Cameroon",2020-10-01,0,19,0,19,5
"Cameroon",2020-11-01,1,18,0,19,7
"Cameroon",2020-12-01,2,29,0,31,5
"Cameroon",2021-01-01,8,37,0,45,7
"Cameroon",2021-02-01,2,8,0,10,7
"Cameroon",2021-03-01,7,12,0,19,5
"Cameroon",2021-04-01,11,6,0,17,7
"Cameroon",2021-05-01,7,14,0,21,5
"Cameroon",2021-06-01,15,5,0,20,7
"Cameroon",2021-07-01,2,5,0,7,5
"Cameroon",2021-08-01,3,14,0,17,5
"Cameroon",2021-09-01,14,9,0,23,5
"Cameroon",2021-10-01,4,9,0,13,5
"Cameroon",2021-11-01,4,11,0,15,5
"Cameroon",2021-12-01,0,15,0,15,5
"Cameroon",2022-01-01,3,7,0,10,5
"Cameroon",2022-02-01,0,11,0,11,5
"Cameroon",2022-03-01,0,13,0,13,5
"Cameroon",2022-04-01,9,18,0,27,5
"Cameroon",2022-05-01,13,14,0,27,5
"Cameroon",2022-06-01,6,71,0,77,5
"Cameroon",2022-07-01,3,23,0,26,5
"Cameroon",2022-08-01,1,12,1,14,7
"Cameroon",2022-09-01,3,16,0,19,5
"Cameroon",2022-10-01,2,12,0,14,5
"Cameroon",2022-11-01,0,4,0,4,5
"Cameroon",2022-12-01,0,7,0,7,5
"Cameroon",2023-01-01,1,19,0,20,5
"Cameroon",2023-02-01,1,18,0,19,7
"Cameroon",2023-03-01,1,14,0,15,5
"Cameroon",2023-04-01,0,11,0,11,7
"Cameroon",2023-05-01,9,8,0,17,7
"Cameroon",2023-06-01,11,14,0,25,7
"Cameroon",2023-07-01,7,33,0,40,7
"Cameroon",2023-08-01,1,30,0,31,7
"Cameroon",2023-09-01,3,20,0,23,7
"Cameroon",2023-10-01,2,3,0,5,7
"Cameroon",2023-11-01,0,59,0,59,7
"Cameroon",2023-12-01,0,34,0,34,5
"Cameroon",2024-01-01,0,23,0,23,7
"Cameroon",2024-02-01,9,5,0,14,5
"Cameroon",2024-03-01,2,3,0,5,5
"Cameroon",2024-04-01,9,34,0,43,5
"DR Congo (Zaire)",2009-01-01,0,451,0,451,7
"DR Congo (Zaire)",2009-02-01,0,344,0,344,5
"DR Congo (Zaire)",2009-03-01,2,178,0,180,5
"DR Congo (Zaire)",2009-04-01,7,328,0,335,7
"DR Congo (Zaire)",2009-05-01,8,185,0,193,5
"DR Congo (Zaire)",2009-06-01,4,68,0,72,5
"DR Congo (Zaire)",2009-07-01,2,109,0,111,5
"DR Congo (Zaire)",2009-08-01,0,243,0,243,5
"DR Congo (Zaire)",2009-09-01,0,101,0,101,5
"DR Congo (Zaire)",2009-10-01,0,40,0,40,5
"DR Congo (Zaire)",2009-11-01,0,16,0,16,5
"DR Congo (Zaire)",2009-12-01,1,174,0,175,5
"DR Congo (Zaire)",2010-01-01,0,21,0,21,5
"DR Congo (Zaire)",2010-02-01,1,87,0,88,5
"DR Congo (Zaire)",2010-03-01,1,46,0,47,5
"DR Congo (Zaire)",2010-04-01,1,81,0,82,5
"DR Congo (Zaire)",2010-05-01,3,3,0,6,5
"DR Congo (Zaire)",2010-06-01,5,47,0,52,5
"DR Congo (Zaire)",2010-07-01,0,12,0,12,5
"DR Congo (Zaire)",2010-08-01,0,8,0,8,5
"DR Congo (Zaire)",2010-09-01,0,6,0,6,5
"DR Congo (Zaire)",2010-11-01,0,28,0,28,5
"DR Congo (Zaire)",2011-01-01,8,32,0,40,5
"DR Congo (Zaire)",2011-02-01,0,19,0,19,5
"DR Congo (Zaire)",2011-03-01,0,6,0,6,5
"DR Congo (Zaire)",2011-04-01,0,10,0,10,5
"DR Congo (Zaire)",2011-05-01,7,13,0,20,5
"DR Congo (Zaire)",2011-06-01,2,18,0,20,7
"DR Congo (Zaire)",2011-07-01,0,6,0,6,5
"DR Congo (Zaire)",2011-08-01,0,13,0,13,7
"DR Congo (Zaire)",2011-09-01,0,1,0,1,7
"DR Congo (Zaire)",2011-10-01,5,10,0,15,5
"DR Congo (Zaire)",2011-11-01,0,17,0,17,7
"DR Congo (Zaire)",2011-12-01,0,7,3,10,7
"DR Congo (Zaire)",2012-01-01,0,40,0,40,7
"DR Congo (Zaire)",2012-02-01,0,17,0,17,5
"DR Congo (Zaire)",2012-03-01,0,15,0,15,5
"DR Congo (Zaire)",2012-04-01,0,4,0,4,7
"DR Congo (Zaire)",2012-05-01,0,97,5,102,7
"DR Congo (Zaire)",2012-06-01,2,6,0,8,7
"DR Congo (Zaire)",2012-07-01,4,16,0,20,5
"DR Congo (Zaire)",2012-08-01,0,19,0,19,7
"DR Congo (Zaire)",2012-09-01,3,2,0,5,5
"DR Congo (Zaire)",2012-10-01,1,5,0,6,7
"DR Congo (Zaire)",2012-11-01,10,10,0,20,5
"DR Congo (Zaire)",2012-12-01,0,1,0,1,5
"DR Congo (Zaire)",2013-01-01,0,5,0,5,5
"DR Congo (Zaire)",2013-02-01,10,10,6,26,7
"DR Congo (Zaire)",2013-03-01,2,0,0,2,7
"DR Congo (Zaire)",2013-04-01,0,11,4,15,6
"DR Congo (Zaire)",2013-05-01,2,16,0,18,5
"DR Congo (Zaire)",2013-06-01,0,18,0,18,5
"DR Congo (Zaire)",2013-07-01,4,12,0,16,5
"DR Congo (Zaire)",2013-08-01,6,0,9,15,3
"DR Congo (Zaire)",2013-09-01,0,20,5,25,7
"DR Congo (Zaire)",2013-10-01,0,39,4,43,7
"DR Congo (Zaire)",2013-11-01,1,26,0,27,5
"DR Congo (Zaire)",2013-12-01,1,52,0,53,5
"DR Congo (Zaire)",2014-01-01,0,2,0,2,5
"DR Congo (Zaire)",2014-02-01,1,0,0,1,1
"DR Congo (Zaire)",2014-03-01,2,1,0,3,5
"DR Congo (Zaire)",2014-04-01,2,8,0,10,7
"DR Congo (Zaire)",2014-05-01,28,1,0,29,5
"DR Congo (Zaire)",2014-06-01,0,15,37,52,7
"DR Congo (Zaire)",2014-07-01,0,7,0,7,5
"DR Congo (Zaire)",2014-08-01,0,8,0,8,5
"DR Congo (Zaire)",2014-09-01,0,9,0,9,5
"DR Congo (Zaire)",2014-10-01,3,124,0,127,5
"DR Congo (Zaire)",2014-11-01,0,142,0,142,5
"DR Congo (Zaire)",2014-12-01,0,93,0,93,5
"DR Congo (Zaire)",2015-01-01,1,13,0,14,5
"DR Congo (Zaire)",2015-02-01,2,87,0,89,5
"DR Congo (Zaire)",2015-03-01,1,27,0,28,5
"DR Congo (Zaire)",2015-04-01,0,60,0,60,5
"DR Congo (Zaire)",2015-05-01,1,60,0,61,5
"DR Congo (Zaire)",2015-06-01,5,6,0,11,5
"DR Congo (Zaire)",2015-07-01,0,17,0,17,4
"DR Congo (Zaire)",2015-08-01,0,1,0,1,5
"DR Congo (Zaire)",2015-09-01,5,12,0,17,5
"DR Congo (Zaire)",2015-10-01,0,14,0,14,5
"DR Congo (Zaire)",2015-11-01,3,28,0,31,5
"DR Congo (Zaire)",2015-12-01,4,10,0,14,5
"DR Congo (Zaire)",2016-01-01,0,27,0,27,7
"DR Congo (Zaire)",2016-02-01,0,22,6,28,7
"DR Congo (Zaire)",2016-03-01,0,2,3,5,7
"DR Congo (Zaire)",2016-04-01,0,0,1,1,3
"DR Congo (Zaire)",2016-05-01,6,38,0,44,5
"DR Congo (Zaire)",2016-06-01,2,0,0,2,1
"DR Congo (Zaire)",2016-07-01,6,29,0,35,7
"DR Congo (Zaire)",2016-08-01,17,88,0,105,7
"DR Congo (Zaire)",2016-09-01,0,69,0,69,7
"DR Congo (Zaire)",2016-10-01,27,85,3,115,7
"DR Congo (Zaire)",2016-11-01,1,40,0,41,7
"DR Congo (Zaire)",2016-12-01,1,98,0,99,7
"DR Congo (Zaire)",2017-01-01,8,20,26,54,7
"DR Congo (Zaire)",2017-02-01,10,75,2,87,7
"DR Congo (Zaire)",2017-03-01,9,125,0,134,7
"DR Congo (Zaire)",2017-04-01,31,236,0,267,7
"DR Congo (Zaire)",2017-05-01,5,452,7,464,7
"DR Congo (Zaire)",2017-06-01,14,76,0,90,7
"DR Congo (Zaire)",2017-07-01,8,39,7,54,7
"DR Congo (Zaire)",2017-08-01,14,18,5,37,7
"DR Congo (Zaire)",2017-09-01,8,28,0,36,5
"DR Congo (Zaire)",2017-10-01,25,59,15,99,7
"DR Congo (Zaire)",2017-11-01,4,40,9,53,7
"DR Congo (Zaire)",2017-12-01,1,36,14,51,7
"DR Congo (Zaire)",2018-01-01,8,29,27,64,7
"DR Congo (Zaire)",2018-02-01,31,39,22,92,7
"DR Congo (Zaire)",2018-03-01,10,42,38,90,7
"DR Congo (Zaire)",2018-04-01,0,28,2,30,7
"DR Congo (Zaire)",2018-05-01,2,52,0,54,7
"DR Congo (Zaire)",2018-06-01,2,25,0,27,7
"DR Congo (Zaire)",2018-07-01,7,37,13,57,7
"DR Congo (Zaire)",2018-08-01,9,31,0,40,7
"DR Congo (Zaire)",2018-09-01,33,17,1,51,7
"DR Congo (Zaire)",2018-10-01,14,33,13,60,7
"DR Congo (Zaire)",2018-11-01,6,50,6,62,7
"DR Congo (Zaire)",2018-12-01,8,59,18,85,7
"DR Congo (Zaire)",2019-01-01,7,52,8,67,7
"DR Congo (Zaire)",2019-02-01,2,32,7,41,7
"DR Congo (Zaire)",2019-03-01,10,6,2,18,7
"DR Congo (Zaire)",2019-04-01,1,42,10,53,7
"DR Congo (Zaire)",2019-05-01,7,92,19,118,7
"DR Congo (Zaire)",2019-06-01,14,48,5,67,7
"DR Congo (Zaire)",2019-07-01,2,71,18,91,7
"DR Congo (Zaire)",2019-08-01,2,52,3,57,7
"DR Congo (Zaire)",2019-09-01,0,59,0,59,7
"DR Congo (Zaire)",2019-10-01,5,15,6,26,7
"DR Congo (Zaire)",2019-11-01,6,167,11,184,7
"DR Congo (Zaire)",2019-12-01,2,180,0,182,7
"DR Congo (Zaire)",2020-01-01,31,144,7,182,7
"DR Congo (Zaire)",2020-02-01,9,172,20,201,7
"DR Congo (Zaire)",2020-03-01,2,62,11,75,7
"DR Congo (Zaire)",2020-04-01,18,192,8,218,7
"DR Congo (Zaire)",2020-05-01,14,183,3,200,7
"DR Congo (Zaire)",2020-06-01,29,151,12,192,7
"DR Congo (Zaire)",2020-07-01,16,226,5,247,7
"DR Congo (Zaire)",2020-08-01,21,164,0,185,7
"DR Congo (Zaire)",2020-09-01,19,132,8,159,7
"DR Congo (Zaire)",2020-10-01,10,174,0,184,7
"DR Congo (Zaire)",2020-11-01,11,70,2,83,7
"DR Congo (Zaire)",2020-12-01,15,135,2,152,7
"DR Congo (Zaire)",2021-01-01,9,83,0,92,7
"DR Congo (Zaire)",2021-02-01,18,129,1,148,7
"DR Congo (Zaire)",2021-03-01,4,179,0,183,7
"DR Congo (Zaire)",2021-04-01,9,148,7,164,7
"DR Congo (Zaire)",2021-05-01,17,180,0,197,7
"DR Congo (Zaire)",2021-06-01,20,118,0,138,5
"DR Congo (Zaire)",2021-07-01,12,168,0,180,7
"DR Congo (Zaire)",2021-08-01,15,107,0,122,7
"DR Congo (Zaire)",2021-09-01,30,139,1,170,7
"DR Congo (Zaire)",2021-10-01,19,129,5,153,7
"DR Congo (Zaire)",2021-11-01,15,369,12,396,7
"DR Congo (Zaire)",2021-12-01,12,346,10,368,7
"DR Congo (Zaire)",2022-01-01,16,260,30,306,7
"DR Congo (Zaire)",2022-02-01,25,334,0,359,7
"DR Congo (Zaire)",2022-03-01,7,291,0,298,7
"DR Congo (Zaire)",2022-04-01,18,219,0,237,7
"DR Congo (Zaire)",2022-05-01,24,351,0,375,7
"DR Congo (Zaire)",2022-06-01,26,288,1,315,7
"DR Congo (Zaire)",2022-07-01,7,138,3,148,7
"DR Congo (Zaire)",2022-08-01,19,270,0,289,7
"DR Congo (Zaire)",2022-09-01,4,151,4,159,7
"DR Congo (Zaire)",2022-10-01,29,145,3,177,7
"DR Congo (Zaire)",2022-11-01,38,338,19,395,7
"DR Congo (Zaire)",2022-12-01,3,243,0,246,7
"DR Congo (Zaire)",2023-01-01,15,281,9,305,7
"DR Congo (Zaire)",2023-02-01,19,173,0,192,7
"DR Congo (Zaire)",2023-03-01,18,387,20,425,7
"DR Congo (Zaire)",2023-04-01,7,390,23,420,7
"DR Congo (Zaire)",2023-05-01,3,146,13,162,7
"DR Congo (Zaire)",2023-06-01,5,209,5,219,7
"DR Congo (Zaire)",2023-07-01,3,106,13,122,7
"DR Congo (Zaire)",2023-08-01,66,183,14,263,7
"DR Congo (Zaire)",2023-09-01,9,92,1,102,7
"DR Congo (Zaire)",2023-10-01,1,60,47,108,7
"DR Congo (Zaire)",2023-11-01,6,129,0,135,7
"DR Congo (Zaire)",2023-12-01,10,60,1,71,7
"DR Congo (Zaire)",2024-01-01,59,111,0,170,7
"DR Congo (Zaire)",2024-02-01,30,128,0,158,7
"DR Congo (Zaire)",2024-03-01,23,95,1,119,7
"DR Congo (Zaire)",2024-04-01,16,153,2,171,7
"Egypt",2009-03-01,0,0,0,0,2
"Egypt",2009-04-01,0,0,0,0,2
"Egypt",2010-01-01,0,0,0,0,1
"Egypt",2011-03-01,0,0,0,0,2
"Egypt",2011-05-01,0,0,0,0,2
"Egypt",2011-08-01,0,0,0,0,2
"Egypt",2012-02-01,0,0,0,0,2
"Egypt",2012-11-01,0,0,0,0,2
"Egypt",2013-04-01,0,0,0,0,2
"Egypt",2013-06-01,0,0,1,1,2
"Egypt",2013-07-01,0,5,0,5,6
"Egypt",2013-08-01,0,0,0,0,2
"Egypt",2013-09-01,0,0,0,0,2
"Egypt",2013-10-01,0,0,0,0,2
"Egypt",2013-11-01,0,0,2,2,2
"Egypt",2013-12-01,0,0,0,0,2
"Egypt",2014-01-01,0,0,1,1,2
"Egypt",2014-02-01,0,0,0,0,2
"Egypt",2014-03-01,0,0,0,0,1
"Egypt",2014-04-01,0,0,0,0,3
"Egypt",2014-05-01,1,0,0,1,3
"Egypt",2014-06-01,0,0,0,0,2
"Egypt",2014-07-01,0,0,0,0,1
"Egypt",2014-08-01,0,0,0,0,3
"Egypt",2014-09-01,0,0,0,0,1
"Egypt",2014-10-01,0,0,0,0,1
"Egypt",2014-11-01,0,0,0,0,1
"Egypt",2014-12-01,0,0,0,0,1
"Egypt",2015-01-01,0,0,0,0,1
"Egypt",2015-02-01,0,0,0,0,1
"Egypt",2015-03-01,1,0,0,1,1
"Egypt",2015-04-01,3,0,0,3,1
"Egypt",2015-05-01,1,0,0,1,1
"Egypt",2015-06-01,0,0,0,0,1
"Egypt",2015-07-01,3,0,0,3,1
"Egypt",2015-08-01,0,0,0,0,1
"Egypt",2015-09-01,0,0,0,0,1
"Egypt",2015-10-01,0,224,0,224,5
"Egypt",2015-11-01,1,0,0,1,1
"Egypt",2016-01-01,0,0,0,0,1
"Egypt",2016-02-01,0,0,0,0,5
"Egypt",2016-03-01,0,0,0,0,1
"Egypt",2016-04-01,1,0,0,1,1
"Egypt",2016-05-01,0,0,0,0,1
"Egypt",2016-06-01,0,1,0,1,4
"Egypt",2016-07-01,0,0,0,0,3
"Egypt",2016-08-01,0,0,0,0,1
"Egypt",2016-09-01,1,0,0,1,1
"Egypt",2016-10-01,0,0,0,0,1
"Egypt",2016-11-01,0,2,0,2,5
"Egypt",2016-12-01,0,28,0,28,5
"Egypt",2017-01-01,1,1,0,2,5
"Egypt",2017-02-01,0,7,0,7,5
"Egypt",2017-03-01,0,0,0,0,1
"Egypt",2017-04-01,0,41,0,41,5
"Egypt",2017-05-01,0,33,0,33,5
"Egypt",2017-06-01,0,0,0,0,5
"Egypt",2017-07-01,0,3,0,3,5
"Egypt",2017-08-01,0,0,0,0,1
"Egypt",2017-09-01,0,0,0,0,1
"Egypt",2017-10-01,3,0,0,3,1
"Egypt",2017-11-01,8,311,0,319,5
"Egypt",2017-12-01,8,0,0,8,1
"Egypt",2018-01-01,1,0,0,1,5
"Egypt",2018-02-01,0,0,0,0,1
"Egypt",2018-03-01,0,2,0,2,5
"Egypt",2018-04-01,0,0,0,0,1
"Egypt",2018-05-01,0,0,0,0,1
"Egypt",2018-06-01,0,0,0,0,1
"Egypt",2018-07-01,0,0,0,0,1
"Egypt",2018-08-01,0,1,0,1,5
"Egypt",2018-09-01,0,0,0,0,1
"Egypt",2018-10-01,6,0,0,6,1
"Egypt",2018-11-01,0,7,0,7,5
"Egypt",2018-12-01,0,2,0,2,5
"Egypt",2019-01-01,2,1,0,3,5
"Egypt",2019-02-01,0,0,0,0,1
"Egypt",2019-03-01,5,10,0,15,5
"Egypt",2019-04-01,3,0,0,3,1
"Egypt",2019-05-01,4,0,0,4,1
"Egypt",2019-06-01,8,4,0,12,5
"Egypt",2019-07-01,2,6,0,8,5
"Egypt",2019-08-01,2,2,0,4,5
"Egypt",2019-09-01,3,0,0,3,1
"Egypt",2019-10-01,18,0,0,18,1
"Egypt",2019-11-01,1,0,0,1,1
"Egypt",2019-12-01,0,0,0,0,1
"Egypt",2020-01-01,6,6,0,12,5
"Egypt",2020-02-01,0,0,0,0,1
"Egypt",2020-03-01,2,2,0,4,5
"Egypt",2020-04-01,0,0,0,0,1
"Egypt",2020-05-01,1,5,0,6,5
"Egypt",2020-06-01,0,0,0,0,1
"Egypt",2020-07-01,5,0,0,5,1
"Egypt",2020-08-01,3,4,0,7,5
"Egypt",2020-09-01,1,1,0,2,5
"Egypt",2020-10-01,25,1,0,26,5
"Egypt",2020-11-01,0,1,0,1,5
"Egypt",2020-12-01,0,0,0,0,1
"Egypt",2021-01-01,6,1,0,7,5
"Egypt",2021-02-01,1,0,0,1,1
"Egypt",2021-03-01,6,1,0,7,5
"Egypt",2021-04-01,2,7,0,9,5
"Egypt",2021-05-01,0,0,0,0,1
"Egypt",2021-06-01,0,2,0,2,5
"Egypt",2021-07-01,0,0,0,0,1
"Egypt",2021-08-01,0,0,0,0,1
"Egypt",2021-09-01,0,0,0,0,1
"Egypt",2021-11-01,0,0,0,0,1
"Egypt",2021-12-01,0,1,0,1,5
"Egypt",2022-01-01,0,0,0,0,1
"Egypt",2022-02-01,3,0,0,3,1
"Egypt",2022-03-01,0,0,0,0,1
"Egypt",2022-04-01,0,4,0,4,5
"Egypt",2022-05-01,0,1,0,1,5
"Egypt",2022-06-01,1,0,0,1,1
"Egypt",2022-07-01,1,0,0,1,1
"Egypt",2022-08-01,3,0,0,3,1
"Egypt",2022-09-01,0,0,0,0,1
"Egypt",2022-10-01,0,0,0,0,1
"Egypt",2022-11-01,0,0,0,0,1
"Egypt",2022-12-01,0,0,0,0,1
"Egypt",2023-02-01,0,0,0,0,1
"Egypt",2023-05-01,1,0,0,1,1
"Egypt",2023-07-01,0,2,0,2,5
"Egypt",2023-08-01,0,0,0,0,2
"Egypt",2023-09-01,0,0,0,0,1
"Egypt",2023-10-01,0,3,0,3,4
"Egypt",2024-01-01,0,0,0,0,1
"Eritrea",2022-01-01,0,0,0,0,1
"Eritrea",2022-05-01,0,0,0,0,1
"Eritrea",2023-07-01,0,1,0,1,4
"Georgia",2010-01-01,0,0,0,0,1
"Georgia",2010-06-01,0,0,0,0,1
"Georgia",2011-04-01,0,0,0,0,1
"Georgia",2023-11-01,0,1,0,1,4
"India",2009-01-01,0,35,0,35,5
"India",2009-02-01,0,14,0,14,5
"India",2009-03-01,0,27,0,27,7
"India",2009-04-01,5,25,0,30,7
"India",2009-05-01,2,19,2,23,7
"India",2009-06-01,2,33,9,44,7
"India",2009-07-01,1,25,4,30,7
"India",2009-08-01,1,32,0,33,7
"India",2009-09-01,1,39,0,40,5
"India",2009-10-01,0,46,0,46,7
"India",2009-11-01,1,39,0,40,5
"India",2009-12-01,0,40,0,40,7
"India",2010-01-01,7,29,0,36,5
"India",2010-02-01,1,47,0,48,5
"India",2010-03-01,4,29,0,33,7
"India",2010-04-01,1,25,0,26,5
"India",2010-05-01,24,176,0,200,5
"India",2010-06-01,3,35,0,38,5
"India",2010-07-01,3,36,0,39,5
"India",2010-08-01,6,28,0,34,7
"India",2010-09-01,1,31,0,32,5
"India",2010-10-01,6,18,0,24,5
"India",2010-11-01,9,65,0,74,5
"India",2010-12-01,0,31,0,31,5
"India",2011-01-01,0,14,0,14,5
"India",2011-02-01,0,12,0,12,7
"India",2011-03-01,1,11,0,12,7
"India",2011-04-01,4,26,0,30,5
"India",2011-05-01,1,14,0,15,5
"India",2011-06-01,2,17,0,19,5
"India",2011-07-01,2,66,0,68,5
"India",2011-08-01,2,15,0,17,5
"India",2011-09-01,0,12,0,12,5
"India",2011-10-01,2,15,0,17,5
"India",2011-11-01,0,8,0,8,5
"India",2011-12-01,1,18,0,19,7
"India",2012-01-01,3,15,0,18,7
"India",2012-02-01,1,7,0,8,7
"India",2012-03-01,1,9,0,10,7
"India",2012-04-01,5,17,0,22,7
"India",2012-05-01,4,10,1,15,7
"India",2012-06-01,13,18,2,33,7
"India",2012-07-01,1,11,5,17,7
"India",2012-08-01,1,9,4,14,7
"India",2012-09-01,1,14,1,16,7
"India",2012-10-01,5,6,1,12,7
"India",2012-11-01,3,18,1,22,7
"India",2012-12-01,2,8,0,10,7
"India",2013-01-01,4,16,0,20,7
"India",2013-02-01,0,28,0,28,7
"India",2013-03-01,2,15,0,17,5
"India",2013-04-01,2,8,0,10,7
"India",2013-05-01,8,33,0,41,5
"India",2013-06-01,1,9,0,10,5
"India",2013-07-01,0,11,0,11,7
"India",2013-08-01,0,3,0,3,7
"India",2013-09-01,4,7,0,11,7
"India",2013-10-01,1,18,0,19,7
"India",2013-11-01,1,9,0,10,7
"India",2013-12-01,4,14,0,18,7
"India",2014-01-01,5,19,0,24,5
"India",2014-02-01,1,5,0,6,5
"India",2014-03-01,1,5,0,6,5
"India",2014-04-01,15,16,0,31,5
"India",2014-05-01,0,35,0,35,5
"India",2014-06-01,0,9,0,9,5
"India",2014-07-01,1,19,0,20,5
"India",2014-08-01,3,6,0,9,5
"India",2014-09-01,2,6,0,8,5
"India",2014-10-01,11,10,0,21,7
"India",2014-11-01,6,5,0,11,5
"India",2014-12-01,3,77,0,80,5
"India",2015-01-01,1,7,0,8,5
"India",2015-02-01,0,5,0,5,5
"India",2015-03-01,1,4,0,5,5
"India",2015-04-01,0,3,0,3,5
"India",2015-05-01,0,18,0,18,5
"India",2015-06-01,2,7,0,9,5
"India",2015-07-01,6,9,0,15,5
"India",2015-08-01,17,7,0,24,5
"India",2015-09-01,1,5,0,6,5
"India",2015-10-01,3,8,0,11,5
"India",2015-11-01,3,2,0,5,5
"India",2015-12-01,0,4,0,4,5
"India",2016-01-01,0,9,0,9,5
"India",2016-02-01,1,12,0,13,5
"India",2016-03-01,5,16,0,21,5
"India",2016-04-01,0,11,0,11,5
"India",2016-05-01,0,14,0,14,5
"India",2016-06-01,1,2,0,3,5
"India",2016-07-01,0,10,0,10,5
"India",2016-08-01,1,5,0,6,5
"India",2016-09-01,1,6,0,7,5
"India",2016-10-01,6,9,0,15,5
"India",2016-11-01,8,5,0,13,5
"India",2016-12-01,4,11,0,15,5
"India",2017-01-01,4,14,0,18,5
"India",2017-02-01,4,6,0,10,5
"India",2017-03-01,3,11,0,14,7
"India",2017-04-01,4,14,0,18,7
"India",2017-05-01,11,5,0,16,5
"India",2017-06-01,2,5,0,7,7
"India",2017-07-01,4,13,0,17,7
"India",2017-08-01,2,8,0,10,5
"India",2017-09-01,6,7,0,13,5
"India",2017-10-01,3,19,0,22,5
"India",2017-11-01,1,9,0,10,5
"India",2017-12-01,7,12,0,19,5
"India",2018-01-01,9,5,0,14,5
"India",2018-02-01,4,7,0,11,5
"India",2018-03-01,11,16,0,27,5
"India",2018-04-01,6,13,0,19,5
"India",2018-05-01,12,19,1,32,7
"India",2018-06-01,1,6,0,7,5
"India",2018-07-01,0,4,0,4,5
"India",2018-08-01,2,13,0,15,5
"India",2018-09-01,2,7,0,9,5
"India",2018-10-01,9,6,0,15,5
"India",2018-11-01,8,11,0,19,5
"India",2018-12-01,1,3,0,4,5
"India",2019-01-01,0,12,0,12,5
"India",2019-02-01,9,5,0,14,5
"India",2019-03-01,3,16,0,19,5
"India",2019-04-01,2,7,0,9,5
"India",2019-05-01,3,21,0,24,5
"India",2019-06-01,3,12,0,15,5
"India",2019-07-01,1,5,0,6,5
"India",2019-08-01,1,12,0,13,5
"India",2019-09-01,0,6,0,6,5
"India",2019-10-01,5,18,0,23,5
"India",2019-11-01,0,9,0,9,5
"India",2019-12-01,6,3,0,9,5
"India",2020-01-01,1,5,0,6,5
"India",2020-02-01,2,9,2,13,7
"India",2020-03-01,2,5,0,7,5
"India",2020-04-01,5,15,0,20,5
"India",2020-05-01,2,3,0,5,5
"India",2020-06-01,1,3,0,4,5
"India",2020-07-01,10,8,0,18,5
"India",2020-08-01,5,3,0,8,5
"India",2020-09-01,2,16,0,18,5
"India",2020-10-01,0,9,0,9,5
"India",2020-11-01,7,7,0,14,5
"India",2020-12-01,0,8,0,8,5
"India",2021-01-01,1,9,0,10,5
"India",2021-02-01,0,4,0,4,5
"India",2021-03-01,2,2,0,4,5
"India",2021-04-01,0,3,0,3,5
"India",2021-05-01,0,4,0,4,5
"India",2021-06-01,7,3,0,10,5
"India",2021-07-01,1,6,0,7,5
"India",2021-08-01,5,2,0,7,5
"India",2021-09-01,0,4,0,4,5
"India",2021-10-01,1,11,0,12,5
"India",2021-11-01,2,9,0,11,5
"India",2021-12-01,9,5,0,14,5
"India",2022-01-01,1,7,0,8,5
"India",2022-02-01,1,4,0,5,5
"India",2022-03-01,3,3,0,6,5
"India",2022-04-01,1,6,0,7,5
"India",2022-05-01,3,12,0,15,5
"India",2022-06-01,0,10,0,10,5
"India",2022-07-01,0,0,0,0,1
"India",2022-08-01,1,9,0,10,5
"India",2022-09-01,0,4,0,4,5
"India",2022-10-01,0,8,0,8,5
"India",2022-11-01,1,5,0,6,5
"India",2022-12-01,0,2,0,2,5
"India",2023-01-01,0,8,0,8,5
"India",2023-02-01,2,6,0,8,5
"India",2023-03-01,3,6,1,10,7
"India",2023-04-01,1,1,0,2,5
"India",2023-05-01,2,5,1,8,7
"India",2023-06-01,1,4,1,6,7
"India",2023-07-01,0,12,3,15,7
"India",2023-08-01,0,10,1,11,7
"India",2023-09-01,1,6,1,8,7
"India",2023-10-01,0,2,0,2,5
"India",2023-11-01,3,15,0,18,7
"India",2023-12-01,0,4,0,4,7
"India",2024-01-01,1,8,0,9,7
"India",2024-02-01,1,8,1,10,7
"India",2024-03-01,0,9,0,9,5
"India",2024-04-01,1,6,0,7,7
"Iran",2009-01-01,0,0,0,0,1
"Iran",2009-02-01,0,1,0,1,5
"Iran",2009-04-01,0,0,0,0,1
"Iran",2009-05-01,0,25,0,25,5
"Iran",2009-06-01,0,47,0,47,5
"Iran",2009-07-01,0,1,0,1,5
"Iran",2009-10-01,0,0,0,0,1
"Iran",2009-11-01,0,1,0,1,4
"Iran",2010-01-01,0,5,0,5,5
"Iran",2010-04-01,0,0,0,0,1
"Iran",2010-05-01,0,0,0,0,1
"Iran",2010-07-01,26,0,0,26,1
"Iran",2010-08-01,0,0,0,0,1
"Iran",2010-09-01,0,0,0,0,1
"Iran",2010-12-01,0,0,0,0,1
"Iran",2011-05-01,0,0,0,0,1
"Iran",2011-07-01,2,0,0,2,1
"Iran",2011-08-01,0,0,0,0,1
"Iran",2011-09-01,0,0,0,0,1
"Iran",2011-12-01,0,0,0,0,1
"Iran",2012-02-01,0,0,0,0,1
"Iran",2012-04-01,0,0,0,0,1
"Iran",2012-05-01,0,0,0,0,1
"Iran",2012-06-01,0,0,0,0,1
"Iran",2013-08-01,0,0,0,0,1
"Iran",2013-10-01,0,0,0,0,1
"Iran",2014-06-01,0,0,0,0,1
"Iran",2014-10-01,0,0,0,0,1
"Iran",2015-04-01,0,0,0,0,1
"Iran",2015-07-01,0,0,0,0,1
"Iran",2015-08-01,0,0,0,0,1
"Iran",2015-09-01,0,0,0,0,1
"Iran",2016-05-01,1,0,0,1,1
"Iran",2016-06-01,0,0,0,0,1
"Iran",2016-07-01,0,0,0,0,1
"Iran",2016-08-01,0,0,0,0,1
"Iran",2016-09-01,0,0,0,0,1
"Iran",2016-10-01,0,0,0,0,1
"Iran",2017-01-01,0,0,0,0,1
"Iran",2017-04-01,0,0,0,0,1
"Iran",2017-05-01,0,0,0,0,1
"Iran",2017-06-01,18,0,0,18,1
"Iran",2017-07-01,0,0,0,0,1
"Iran",2017-08-01,0,0,0,0,1
"Iran",2017-09-01,0,0,0,0,1
"Iran",2017-11-01,0,0,0,0,1
"Iran",2017-12-01,0,0,0,0,1
"Iran",2018-01-01,0,0,0,0,1
"Iran",2018-03-01,0,0,0,0,1
"Iran",2018-04-01,0,0,0,0,1
"Iran",2018-06-01,0,1,0,1,5
"Iran",2018-07-01,0,0,0,0,1
"Iran",2018-08-01,0,0,0,0,1
"Iran",2018-09-01,0,0,0,0,1
"Iran",2018-10-01,1,0,0,1,1
"Iran",2019-02-01,0,0,0,0,1
"Iran",2019-05-01,0,0,0,0,1
"Iran",2019-06-01,0,0,0,0,1
"Iran",2019-07-01,0,0,0,0,1
"Iran",2019-08-01,2,0,0,2,1
"Iran",2019-09-01,0,1,0,1,4
"Iran",2019-10-01,0,0,0,0,1
"Iran",2019-11-01,0,249,0,249,4
"Iran",2020-01-01,176,0,0,176,1
"Iran",2020-03-01,0,0,0,0,1
"Iran",2020-05-01,0,23,0,23,5
"Iran",2020-06-01,0,1,0,1,5
"Iran",2020-07-01,0,0,0,0,1
"Iran",2020-08-01,1,0,0,1,1
"Iran",2020-09-01,1,1,0,2,5
"Iran",2020-10-01,0,0,0,0,5
"Iran",2020-11-01,0,2,0,2,5
"Iran",2021-02-01,0,12,0,12,5
"Iran",2021-03-01,0,1,0,1,5
"Iran",2021-05-01,0,1,0,1,5
"Iran",2021-06-01,0,1,0,1,5
"Iran",2021-07-01,0,9,0,9,5
"Iran",2021-08-01,0,1,0,1,4
"Iran",2021-09-01,0,1,0,1,5
"Iran",2021-12-01,0,0,0,0,1
"Iran",2022-05-01,0,1,0,1,4
"Iran",2022-09-01,0,310,0,310,5
"Iran",2022-10-01,20,7,0,27,5
"Iran",2022-11-01,0,24,0,24,4
"Iran",2022-12-01,0,1,0,1,4
"Iran",2023-05-01,0,0,0,0,1
"Iran",2023-06-01,0,0,0,0,1
"Iran",2023-07-01,0,0,0,0,1
"Iran",2023-08-01,4,0,0,4,1
"Iran",2023-09-01,0,0,0,0,1
"Iran",2023-12-01,0,0,0,0,1
"Iran",2024-01-01,4,84,0,88,5
"Iran",2024-02-01,0,0,0,0,1
"Iran",2024-03-01,1,0,0,1,1
"Iran",2024-04-01,0,0,0,0,1
"Iraq",2009-01-01,0,70,0,70,5
"Iraq",2009-02-01,5,62,0,67,5
"Iraq",2009-03-01,8,34,0,42,5
"Iraq",2009-04-01,5,165,0,170,5
"Iraq",2009-05-01,17,20,0,37,5
"Iraq",2009-06-01,3,98,0,101,5
"Iraq",2009-07-01,1,31,0,32,5
"Iraq",2009-08-01,3,74,0,77,5
"Iraq",2009-09-01,8,36,0,44,5
"Iraq",2009-10-01,4,35,0,39,5
"Iraq",2009-11-01,1,12,0,13,5
"Iraq",2009-12-01,1,14,0,15,5
"Iraq",2010-01-01,19,2,0,21,5
"Iraq",2010-02-01,9,130,0,139,5
"Iraq",2010-03-01,8,69,0,77,5
"Iraq",2010-04-01,10,71,0,81,5
"Iraq",2010-05-01,7,45,0,52,5
"Iraq",2010-06-01,13,15,0,28,5
"Iraq",2010-07-01,12,57,0,69,5
"Iraq",2010-08-01,10,6,0,16,5
"Iraq",2010-09-01,3,4,0,7,5
"Iraq",2010-10-01,25,75,0,100,5
"Iraq",2010-11-01,3,27,0,30,5
"Iraq",2010-12-01,15,17,0,32,5
"Iraq",2011-01-01,9,108,0,117,5
"Iraq",2011-02-01,6,74,0,80,5
"Iraq",2011-03-01,12,1,0,13,5
"Iraq",2011-04-01,4,10,0,14,5
"Iraq",2011-05-01,0,17,0,17,5
"Iraq",2011-06-01,3,21,0,24,5
"Iraq",2011-07-01,5,6,0,11,5
"Iraq",2011-08-01,34,7,0,41,5
"Iraq",2011-09-01,9,26,0,35,5
"Iraq",2011-10-01,5,0,0,5,1
"Iraq",2011-11-01,7,5,0,12,5
"Iraq",2011-12-01,10,29,0,39,5
"Iraq",2012-01-01,8,170,0,178,5
"Iraq",2012-02-01,16,32,0,48,5
"Iraq",2012-03-01,2,17,0,19,5
"Iraq",2012-04-01,3,16,0,19,5
"Iraq",2012-05-01,3,13,0,16,5
"Iraq",2012-06-01,1,96,0,97,5
"Iraq",2012-07-01,13,107,0,120,5
"Iraq",2012-08-01,1,89,0,90,5
"Iraq",2012-09-01,1,62,0,63,5
"Iraq",2012-10-01,1,42,0,43,5
"Iraq",2012-11-01,8,74,0,82,5
"Iraq",2012-12-01,2,47,0,49,5
"Iraq",2013-01-01,2,50,0,52,5
"Iraq",2013-02-01,0,0,0,0,7
"Iraq",2013-03-01,2,18,0,20,5
"Iraq",2013-04-01,3,4,0,7,5
"Iraq",2013-05-01,3,63,0,66,5
"Iraq",2013-06-01,4,133,0,137,7
"Iraq",2013-07-01,4,196,0,200,5
"Iraq",2013-08-01,12,176,0,188,5
"Iraq",2013-09-01,11,254,0,265,5
"Iraq",2013-10-01,13,182,0,195,5
"Iraq",2013-11-01,6,86,0,92,5
"Iraq",2013-12-01,5,189,0,194,7
"Iraq",2014-01-01,67,111,0,178,5
"Iraq",2014-02-01,8,24,0,32,5
"Iraq",2014-03-01,14,47,0,61,5
"Iraq",2014-04-01,8,5,0,13,5
"Iraq",2014-05-01,8,74,0,82,5
"Iraq",2014-06-01,79,1194,0,1273,7
"Iraq",2014-07-01,127,75,0,202,7
"Iraq",2014-08-01,47,345,0,392,5
"Iraq",2014-09-01,106,57,0,163,5
"Iraq",2014-10-01,64,128,0,192,5
"Iraq",2014-11-01,71,79,0,150,5
"Iraq",2014-12-01,18,67,0,85,5
"Iraq",2015-01-01,21,83,0,104,5
"Iraq",2015-02-01,72,87,0,159,5
"Iraq",2015-03-01,18,59,0,77,5
"Iraq",2015-04-01,71,160,0,231,5
"Iraq",2015-05-01,39,82,0,121,5
"Iraq",2015-06-01,62,63,0,125,5
"Iraq",2015-07-01,188,95,0,283,5
"Iraq",2015-08-01,80,86,0,166,5
"Iraq",2015-09-01,125,13,0,138,5
"Iraq",2015-10-01,31,86,0,117,7
"Iraq",2015-11-01,51,41,0,92,5
"Iraq",2015-12-01,65,18,0,83,5
"Iraq",2016-01-01,79,67,0,146,5
"Iraq",2016-02-01,131,118,0,249,5
"Iraq",2016-03-01,362,111,0,473,5
"Iraq",2016-04-01,223,45,0,268,5
"Iraq",2016-05-01,183,165,0,348,5
"Iraq",2016-06-01,137,52,0,189,5
"Iraq",2016-07-01,48,333,0,381,5
"Iraq",2016-08-01,109,68,0,177,5
"Iraq",2016-09-01,38,56,0,94,5
"Iraq",2016-10-01,154,626,0,780,5
"Iraq",2016-11-01,293,414,0,707,5
"Iraq",2016-12-01,302,40,0,342,5
"Iraq",2017-01-01,464,98,0,562,5
"Iraq",2017-02-01,215,133,0,348,5
"Iraq",2017-03-01,911,70,0,981,5
"Iraq",2017-04-01,788,244,0,1032,5
"Iraq",2017-05-01,555,101,0,656,5
"Iraq",2017-06-01,515,216,0,731,5
"Iraq",2017-07-01,102,75,0,177,5
"Iraq",2017-08-01,69,12,0,81,5
"Iraq",2017-09-01,30,0,0,30,1
"Iraq",2017-10-01,50,11,0,61,5
"Iraq",2017-11-01,45,12,0,57,5
"Iraq",2017-12-01,1,0,0,1,1
"Iraq",2018-01-01,0,39,0,39,5
"Iraq",2018-02-01,0,0,0,0,1
"Iraq",2018-03-01,2,14,0,16,5
"Iraq",2018-04-01,2,2,0,4,5
"Iraq",2018-05-01,20,21,0,41,5
"Iraq",2018-06-01,1,35,0,36,5
"Iraq",2018-07-01,0,12,0,12,5
"Iraq",2018-08-01,4,5,0,9,5
"Iraq",2018-09-01,0,13,0,13,5
"Iraq",2018-10-01,0,16,0,16,5
"Iraq",2018-11-01,3,7,0,10,5
"Iraq",2018-12-01,7,2,0,9,5
"Iraq",2019-01-01,2,2,0,4,5
"Iraq",2019-02-01,0,7,0,7,5
"Iraq",2019-03-01,2,2,0,4,5
"Iraq",2019-04-01,0,0,0,0,1
"Iraq",2019-05-01,3,9,0,12,5
"Iraq",2019-06-01,1,4,0,5,5
"Iraq",2019-07-01,1,7,0,8,5
"Iraq",2019-08-01,2,6,0,8,5
"Iraq",2019-09-01,4,13,0,17,5
"Iraq",2019-10-01,0,28,0,28,5
"Iraq",2019-11-01,0,54,0,54,5
"Iraq",2019-12-01,0,31,0,31,5
"Iraq",2020-01-01,1,10,0,11,5
"Iraq",2020-02-01,3,13,0,16,5
"Iraq",2020-03-01,2,0,0,2,1
"Iraq",2020-04-01,5,2,0,7,5
"Iraq",2020-05-01,1,2,0,3,5
"Iraq",2020-06-01,4,6,0,10,5
"Iraq",2020-07-01,6,0,0,6,5
"Iraq",2020-08-01,2,5,0,7,5
"Iraq",2020-09-01,1,0,0,1,1
"Iraq",2020-10-01,0,8,0,8,5
"Iraq",2020-11-01,8,1,0,9,5
"Iraq",2020-12-01,3,9,0,12,5
"Iraq",2021-01-01,1,32,0,33,5
"Iraq",2021-02-01,0,5,0,5,5
"Iraq",2021-03-01,0,10,0,10,5
"Iraq",2021-04-01,1,4,0,5,5
"Iraq",2021-05-01,0,2,0,2,5
"Iraq",2021-06-01,8,8,0,16,5
"Iraq",2021-07-01,11,51,0,62,5
"Iraq",2021-08-01,11,3,0,14,5
"Iraq",2021-09-01,16,1,0,17,5
"Iraq",2021-10-01,16,5,0,21,5
"Iraq",2021-11-01,1,3,0,4,5
"Iraq",2021-12-01,2,29,0,31,5
"Iraq",2022-01-01,0,0,0,0,1
"Iraq",2022-02-01,2,0,0,2,1
"Iraq",2022-03-01,0,0,0,0,1
"Iraq",2022-04-01,1,0,0,1,1
"Iraq",2022-05-01,11,3,0,14,5
"Iraq",2022-06-01,2,0,0,2,1
"Iraq",2022-07-01,14,0,0,14,1
"Iraq",2022-08-01,2,0,0,2,1
"Iraq",2022-09-01,3,0,0,3,1
"Iraq",2022-10-01,0,0,0,0,1
"Iraq",2022-11-01,0,0,0,0,1
"Iraq",2022-12-01,2,10,0,12,5
"Iraq",2023-01-01,0,0,0,0,1
"Iraq",2023-02-01,0,10,0,10,5
"Iraq",2023-03-01,9,8,0,17,5
"Iraq",2023-04-01,0,0,0,0,1
"Iraq",2023-05-01,0,0,0,0,1
"Iraq",2023-06-01,0,0,0,0,1
"Iraq",2023-07-01,0,0,0,0,1
"Iraq",2023-08-01,3,0,0,3,1
"Iraq",2023-09-01,3,0,0,3,1
"Iraq",2023-10-01,0,0,0,0,1
"Iraq",2023-11-01,0,0,0,0,5
"Iraq",2023-12-01,2,0,0,2,1
"Iraq",2024-01-01,4,0,0,4,1
"Iraq",2024-02-01,2,0,0,2,1
"Iraq",2024-03-01,2,0,1,3,3
"Iraq",2024-04-01,4,1,0,5,5
"Israel",2009-01-01,273,3,0,276,5
"Israel",2009-02-01,0,0,0,0,1
"Israel",2009-03-01,0,0,0,0,1
"Israel",2009-04-01,0,0,0,0,1
"Israel",2009-05-01,1,0,0,1,1
"Israel",2009-06-01,0,0,0,0,1
"Israel",2009-08-01,0,0,0,0,3
"Israel",2009-09-01,0,1,0,1,5
"Israel",2009-10-01,0,1,0,1,5
"Israel",2009-12-01,0,0,0,0,1
"Israel",2010-01-01,0,0,0,0,1
"Israel",2010-02-01,0,1,0,1,5
"Israel",2010-03-01,0,0,0,0,1
"Israel",2010-04-01,0,2,0,2,5
"Israel",2010-05-01,0,3,0,3,5
"Israel",2010-06-01,0,0,0,0,1
"Israel",2010-07-01,0,0,0,0,1
"Israel",2010-08-01,0,4,0,4,5
"Israel",2010-09-01,3,0,0,3,1
"Israel",2010-10-01,0,0,0,0,1
"Israel",2010-12-01,0,0,0,0,1
"Israel",2011-01-01,0,0,0,0,1
"Israel",2011-02-01,0,0,0,0,1
"Israel",2011-03-01,4,0,0,4,1
"Israel",2011-04-01,4,0,0,4,1
"Israel",2011-05-01,0,0,0,0,1
"Israel",2011-08-01,2,0,0,2,1
"Israel",2011-09-01,0,0,0,0,1
"Israel",2011-10-01,0,0,0,0,1
"Israel",2011-11-01,0,0,0,0,1
"Israel",2011-12-01,2,0,0,2,1
"Israel",2012-01-01,0,0,0,0,1
"Israel",2012-03-01,0,1,0,1,5
"Israel",2012-06-01,1,0,0,1,1
"Israel",2012-07-01,0,0,0,0,1
"Israel",2012-08-01,0,0,0,0,1
"Israel",2012-09-01,0,0,0,0,1
"Israel",2012-10-01,0,0,0,0,1
"Israel",2012-11-01,55,0,0,55,1
"Israel",2013-04-01,0,0,0,0,1
"Israel",2013-09-01,0,0,0,0,1
"Israel",2013-10-01,0,0,0,0,1
"Israel",2013-11-01,0,0,0,0,1
"Israel",2013-12-01,1,0,0,1,1
"Israel",2014-01-01,1,0,0,1,1
"Israel",2014-02-01,0,0,0,0,1
"Israel",2014-03-01,0,1,0,1,5
"Israel",2014-04-01,0,0,0,0,1
"Israel",2014-06-01,1,0,0,1,5
"Israel",2014-07-01,979,1,0,980,5
"Israel",2014-08-01,380,0,0,380,1
"Israel",2014-09-01,0,0,0,0,1
"Israel",2014-11-01,0,1,0,1,5
"Israel",2014-12-01,0,0,0,0,1
"Israel",2015-02-01,0,0,0,0,1
"Israel",2015-06-01,0,0,0,0,1
"Israel",2015-07-01,0,0,0,0,1
"Israel",2015-10-01,2,2,0,4,5
"Israel",2015-11-01,0,2,0,2,5
"Israel",2015-12-01,0,0,0,0,1
"Israel",2016-01-01,0,0,0,0,1
"Israel",2016-03-01,2,0,0,2,1
"Israel",2016-05-01,1,2,0,3,5
"Israel",2016-06-01,0,1,0,1,4
"Israel",2016-07-01,0,1,0,1,5
"Israel",2017-08-01,0,0,0,0,1
"Israel",2017-10-01,0,0,0,0,4
"Israel",2017-12-01,0,0,0,0,1
"Israel",2018-01-01,0,3,0,3,5
"Israel",2018-02-01,0,1,0,1,5
"Israel",2018-03-01,1,2,0,3,5
"Israel",2018-04-01,0,0,0,0,1
"Israel",2018-05-01,0,0,0,0,1
"Israel",2018-06-01,0,1,0,1,4
"Israel",2018-07-01,3,0,0,3,1
"Israel",2018-08-01,2,0,0,2,1
"Israel",2018-11-01,1,0,0,1,1
"Israel",2018-12-01,0,3,0,3,5
"Israel",2019-01-01,0,0,0,0,1
"Israel",2019-03-01,1,2,0,3,5
"Israel",2019-04-01,0,1,0,1,4
"Israel",2019-05-01,17,0,0,17,1
"Israel",2019-08-01,0,0,0,0,1
"Israel",2019-11-01,16,0,0,16,1
"Israel",2019-12-01,0,0,0,0,1
"Israel",2020-02-01,0,0,0,0,1
"Israel",2020-05-01,0,1,0,1,4
"Israel",2021-04-01,0,1,0,1,4
"Israel",2021-05-01,148,1,0,149,5
"Israel",2021-06-01,0,0,0,0,1
"Israel",2021-07-01,0,1,0,1,4
"Israel",2021-08-01,1,2,0,3,5
"Israel",2021-09-01,0,0,0,0,1
"Israel",2021-11-01,0,0,0,0,1
"Israel",2021-12-01,0,1,0,1,5
"Israel",2022-01-01,0,0,0,0,1
"Israel",2022-02-01,0,0,0,0,1
"Israel",2022-03-01,0,0,0,0,1
"Israel",2022-04-01,1,1,0,2,5
"Israel",2022-05-01,1,0,0,1,1
"Israel",2022-06-01,0,0,0,0,1
"Israel",2022-07-01,0,0,0,0,1
"Israel",2022-08-01,10,0,0,10,1
"Israel",2022-09-01,1,0,0,1,1
"Israel",2022-10-01,3,1,0,4,5
"Israel",2022-11-01,1,0,0,1,1
"Israel",2022-12-01,1,0,0,1,1
"Israel",2023-01-01,2,1,0,3,5
"Israel",2023-02-01,6,2,0,8,5
"Israel",2023-03-01,0,0,0,0,1
"Israel",2023-04-01,0,1,0,1,5
"Israel",2023-05-01,12,1,0,13,5
"Israel",2023-06-01,2,4,0,6,5
"Israel",2023-07-01,0,0,0,0,5
"Israel",2023-08-01,2,4,1,7,7
"Israel",2023-09-01,2,0,0,2,1
"Israel",2023-10-01,1203,10,0,1213,5
"Israel",2023-11-01,673,7,0,680,7
"Israel",2023-12-01,925,35,0,960,5
"Israel",2024-01-01,540,0,0,540,1
"Israel",2024-02-01,533,3,0,536,7
"Israel",2024-03-01,611,65,0,676,5
"Israel",2024-04-01,379,6,0,385,5
"Pakistan",2009-01-01,16,30,0,46,7
"Pakistan",2009-02-01,7,12,0,19,5
"Pakistan",2009-03-01,3,2,0,5,7
"Pakistan",2009-04-01,16,37,0,53,7
"Pakistan",2009-05-01,27,15,0,42,5
"Pakistan",2009-06-01,39,20,0,59,7
"Pakistan",2009-07-01,2,3,0,5,7
"Pakistan",2009-08-01,13,12,0,25,7
"Pakistan",2009-09-01,1,2,0,3,7
"Pakistan",2009-10-01,63,22,0,85,7
"Pakistan",2009-11-01,8,3,0,11,7
"Pakistan",2009-12-01,16,82,0,98,7
"Pakistan",2010-01-01,18,114,0,132,7
"Pakistan",2010-02-01,27,66,2,95,7
"Pakistan",2010-03-01,66,25,3,94,7
"Pakistan",2010-04-01,6,104,0,110,7
"Pakistan",2010-05-01,18,102,0,120,5
"Pakistan",2010-06-01,1,6,2,9,7
"Pakistan",2010-07-01,6,60,0,66,7
"Pakistan",2010-08-01,31,44,0,75,7
"Pakistan",2010-09-01,23,123,0,146,7
"Pakistan",2010-10-01,2,24,0,26,7
"Pakistan",2010-11-01,11,9,35,55,7
"Pakistan",2010-12-01,3,69,0,72,7
"Pakistan",2011-01-01,38,0,0,38,3
"Pakistan",2011-02-01,11,8,0,19,7
"Pakistan",2011-03-01,24,0,0,24,7
"Pakistan",2011-04-01,10,56,2,68,7
"Pakistan",2011-05-01,5,15,0,20,7
"Pakistan",2011-06-01,5,5,0,10,7
"Pakistan",2011-07-01,6,21,0,27,7
"Pakistan",2011-08-01,7,61,6,74,7
"Pakistan",2011-09-01,8,77,0,85,7
"Pakistan",2011-10-01,3,4,0,7,7
"Pakistan",2011-11-01,6,2,0,8,7
"Pakistan",2011-12-01,7,15,0,22,7
"Pakistan",2012-01-01,4,10,3,17,7
"Pakistan",2012-02-01,5,83,1,89,7
"Pakistan",2012-03-01,41,10,2,53,7
"Pakistan",2012-04-01,0,13,0,13,7
"Pakistan",2012-05-01,41,6,0,47,7
"Pakistan",2012-06-01,1,6,0,7,7
"Pakistan",2012-07-01,4,7,0,11,7
"Pakistan",2012-08-01,1,51,1,53,7
"Pakistan",2012-09-01,1,40,0,41,7
"Pakistan",2012-10-01,2,5,1,8,7
"Pakistan",2012-11-01,7,40,0,47,7
"Pakistan",2012-12-01,18,12,0,30,7
"Pakistan",2013-01-01,4,102,0,106,7
"Pakistan",2013-02-01,11,140,0,151,7
"Pakistan",2013-03-01,8,69,0,77,7
"Pakistan",2013-04-01,1,70,0,71,5
"Pakistan",2013-05-01,8,105,0,113,7
"Pakistan",2013-06-01,22,78,0,100,5
"Pakistan",2013-07-01,5,72,0,77,7
"Pakistan",2013-08-01,13,18,0,31,5
"Pakistan",2013-09-01,11,88,0,99,5
"Pakistan",2013-10-01,10,16,0,26,5
"Pakistan",2013-11-01,0,2,0,2,5
"Pakistan",2013-12-01,5,5,0,10,5
"Pakistan",2014-01-01,20,42,0,62,5
"Pakistan",2014-02-01,5,11,0,16,5
"Pakistan",2014-03-01,11,1,0,12,5
"Pakistan",2014-04-01,2,49,1,52,7
"Pakistan",2014-05-01,0,11,0,11,7
"Pakistan",2014-06-01,4,33,0,37,7
"Pakistan",2014-07-01,3,0,0,3,1
"Pakistan",2014-08-01,3,0,0,3,3
"Pakistan",2014-09-01,9,3,0,12,7
"Pakistan",2014-10-01,5,1,0,6,7
"Pakistan",2014-11-01,57,4,0,61,5
"Pakistan",2014-12-01,0,148,0,148,7
"Pakistan",2015-01-01,11,72,0,83,7
"Pakistan",2015-02-01,1,26,0,27,7
"Pakistan",2015-03-01,1,21,0,22,5
"Pakistan",2015-04-01,1,0,0,1,1
"Pakistan",2015-05-01,1,71,0,72,5
"Pakistan",2015-06-01,2,0,0,2,3
"Pakistan",2015-07-01,4,0,0,4,5
"Pakistan",2015-08-01,27,2,0,29,5
"Pakistan",2015-09-01,6,0,0,6,1
"Pakistan",2015-10-01,3,24,0,27,5
"Pakistan",2015-11-01,0,1,0,1,5
"Pakistan",2015-12-01,26,25,0,51,5
"Pakistan",2016-01-01,5,21,0,26,5
"Pakistan",2016-02-01,8,0,0,8,1
"Pakistan",2016-03-01,20,92,0,112,5
"Pakistan",2016-04-01,0,0,0,0,1
"Pakistan",2016-05-01,0,2,0,2,5
"Pakistan",2016-06-01,0,1,0,1,5
"Pakistan",2016-07-01,1,2,0,3,5
"Pakistan",2016-08-01,2,77,0,79,5
"Pakistan",2016-09-01,11,37,0,48,5
"Pakistan",2016-10-01,22,4,0,26,5
"Pakistan",2016-11-01,25,53,0,78,5
"Pakistan",2016-12-01,1,0,0,1,5
"Pakistan",2017-01-01,0,25,0,25,5
"Pakistan",2017-02-01,19,89,0,108,5
"Pakistan",2017-03-01,1,26,0,27,5
"Pakistan",2017-04-01,3,15,0,18,7
"Pakistan",2017-05-01,27,12,0,39,5
"Pakistan",2017-06-01,10,75,0,85,5
"Pakistan",2017-07-01,29,0,0,29,5
"Pakistan",2017-08-01,12,0,0,12,5
"Pakistan",2017-09-01,13,0,0,13,5
"Pakistan",2017-10-01,30,1,0,31,5
"Pakistan",2017-11-01,8,0,0,8,5
"Pakistan",2017-12-01,29,1,0,30,5
"Pakistan",2018-01-01,5,1,0,6,5
"Pakistan",2018-02-01,6,0,0,6,5
"Pakistan",2018-03-01,11,0,0,11,1
"Pakistan",2018-04-01,1,6,0,7,5
"Pakistan",2018-05-01,6,1,0,7,5
"Pakistan",2018-06-01,4,5,0,9,5
"Pakistan",2018-07-01,26,178,0,204,5
"Pakistan",2018-08-01,2,1,0,3,5
"Pakistan",2018-09-01,2,0,0,2,1
"Pakistan",2018-10-01,0,0,0,0,5
"Pakistan",2018-11-01,3,38,0,41,5
"Pakistan",2018-12-01,1,0,0,1,1
"Pakistan",2019-01-01,13,0,0,13,1
"Pakistan",2019-02-01,6,1,0,7,5
"Pakistan",2019-03-01,2,2,0,4,5
"Pakistan",2019-04-01,3,23,0,26,5
"Pakistan",2019-05-01,9,0,0,9,1
"Pakistan",2019-06-01,0,0,0,0,1
"Pakistan",2019-07-01,9,0,0,9,1
"Pakistan",2019-08-01,8,0,0,8,3
"Pakistan",2019-09-01,3,0,0,3,5
"Pakistan",2019-10-01,9,0,0,9,1
"Pakistan",2019-11-01,1,0,0,1,1
"Pakistan",2019-12-01,0,0,0,0,1
"Pakistan",2020-01-01,0,2,0,2,5
"Pakistan",2020-02-01,16,0,0,16,1
"Pakistan",2020-03-01,0,0,0,0,5
"Pakistan",2020-04-01,4,0,0,4,1
"Pakistan",2020-05-01,5,0,0,5,1
"Pakistan",2020-06-01,8,0,0,8,5
"Pakistan",2020-07-01,0,0,0,0,5
"Pakistan",2020-08-01,2,0,0,2,1
"Pakistan",2020-09-01,2,0,0,2,5
"Pakistan",2020-10-01,0,8,0,8,5
"Pakistan",2020-11-01,11,0,0,11,1
"Pakistan",2020-12-01,1,3,0,4,5
"Pakistan",2021-01-01,0,11,0,11,5
"Pakistan",2021-02-01,4,5,0,9,5
"Pakistan",2021-03-01,4,0,0,4,1
"Pakistan",2021-04-01,4,0,0,4,7
"Pakistan",2021-05-01,0,0,0,0,1
"Pakistan",2021-06-01,4,0,0,4,5
"Pakistan",2021-07-01,11,2,0,13,5
"Pakistan",2021-08-01,0,3,0,3,5
"Pakistan",2021-09-01,0,1,0,1,5
"Pakistan",2021-10-01,0,0,0,0,5
"Pakistan",2021-11-01,0,0,0,0,1
"Pakistan",2021-12-01,0,0,0,0,1
"Pakistan",2022-01-01,4,0,0,4,1
"Pakistan",2022-02-01,0,0,0,0,1
"Pakistan",2022-03-01,3,63,0,66,5
"Pakistan",2022-04-01,2,2,0,4,5
"Pakistan",2022-05-01,3,2,0,5,5
"Pakistan",2022-06-01,0,0,0,0,1
"Pakistan",2022-07-01,3,0,0,3,5
"Pakistan",2022-08-01,2,0,0,2,1
"Pakistan",2022-09-01,0,1,0,1,5
"Pakistan",2022-10-01,1,0,0,1,5
"Pakistan",2022-11-01,3,0,0,3,1
"Pakistan",2022-12-01,4,0,0,4,5
"Pakistan",2023-01-01,3,2,0,5,5
"Pakistan",2023-02-01,2,2,0,4,7
"Pakistan",2023-03-01,5,13,0,18,5
"Pakistan",2023-04-01,3,1,0,4,5
"Pakistan",2023-05-01,1,2,0,3,7
"Pakistan",2023-06-01,3,2,0,5,5
"Pakistan",2023-07-01,2,63,0,65,5
"Pakistan",2023-08-01,2,13,0,15,7
"Pakistan",2023-09-01,1,4,0,5,5
"Pakistan",2023-10-01,6,11,0,17,7
"Pakistan",2023-11-01,12,22,3,37,7
"Pakistan",2023-12-01,0,15,0,15,7
"Pakistan",2024-01-01,11,16,0,27,7
"Pakistan",2024-02-01,4,10,0,14,7
"Pakistan",2024-03-01,2,15,0,17,5
"Pakistan",2024-04-01,5,33,0,38,7
"Sierra Leone",2021-04-01,0,1,0,1,4
"Sierra Leone",2023-11-01,1,0,0,1,1
"Somalia",2009-01-01,53,5,0,58,7
"Somalia",2009-02-01,48,1,0,49,5
"Somalia",2009-03-01,10,0,1,11,7
"Somalia",2009-04-01,10,3,0,13,5
"Somalia",2009-05-01,63,0,2,65,7
"Somalia",2009-06-01,21,0,4,25,7
"Somalia",2009-07-01,87,1,0,88,7
"Somalia",2009-08-01,44,2,2,48,7
"Somalia",2009-09-01,33,2,0,35,7
"Somalia",2009-10-01,42,5,28,75,7
"Somalia",2009-11-01,21,2,0,23,7
"Somalia",2009-12-01,87,1,0,88,7
"Somalia",2010-01-01,12,0,0,12,7
"Somalia",2010-02-01,51,0,0,51,3
"Somalia",2010-03-01,17,2,0,19,7
"Somalia",2010-04-01,46,2,0,48,7
"Somalia",2010-05-01,7,0,0,7,5
"Somalia",2010-06-01,13,0,0,13,3
"Somalia",2010-07-01,68,0,0,68,3
"Somalia",2010-08-01,66,2,0,68,7
"Somalia",2010-09-01,24,5,0,29,7
"Somalia",2010-10-01,18,6,0,24,7
"Somalia",2010-11-01,3,0,0,3,3
"Somalia",2010-12-01,27,0,0,27,3
"Somalia",2011-01-01,18,2,0,20,7
"Somalia",2011-02-01,55,14,0,69,7
"Somalia",2011-03-01,81,2,0,83,5
"Somalia",2011-04-01,10,2,0,12,7
"Somalia",2011-05-01,5,4,0,9,7
"Somalia",2011-06-01,6,4,0,10,5
"Somalia",2011-07-01,0,3,0,3,7
"Somalia",2011-08-01,1,0,1,2,3
"Somalia",2011-09-01,6,7,0,13,7
"Somalia",2011-10-01,5,2,0,7,5
"Somalia",2011-11-01,21,16,0,37,7
"Somalia",2011-12-01,84,7,0,91,7
"Somalia",2012-01-01,29,13,0,42,7
"Somalia",2012-02-01,22,12,1,35,7
"Somalia",2012-03-01,36,12,1,49,7
"Somalia",2012-04-01,19,8,0,27,7
"Somalia",2012-05-01,30,2,0,32,7
"Somalia",2012-06-01,1,5,0,6,7
"Somalia",2012-07-01,7,4,0,11,5
"Somalia",2012-08-01,10,8,0,18,5
"Somalia",2012-09-01,6,4,0,10,5
"Somalia",2012-10-01,8,7,0,15,5
"Somalia",2012-11-01,5,10,0,15,7
"Somalia",2012-12-01,9,23,0,32,7
"Somalia",2013-01-01,7,6,0,13,5
"Somalia",2013-02-01,5,13,0,18,5
"Somalia",2013-03-01,7,6,0,13,5
"Somalia",2013-04-01,31,10,0,41,5
"Somalia",2013-05-01,7,8,0,15,5
"Somalia",2013-06-01,11,8,0,19,5
"Somalia",2013-07-01,20,6,0,26,5
"Somalia",2013-08-01,13,7,0,20,5
"Somalia",2013-09-01,2,30,0,32,5
"Somalia",2013-10-01,7,6,0,13,5
"Somalia",2013-11-01,13,3,0,16,5
"Somalia",2013-12-01,8,11,0,19,5
"Somalia",2014-01-01,8,11,0,19,5
"Somalia",2014-02-01,18,4,0,22,5
"Somalia",2014-03-01,7,15,0,22,5
"Somalia",2014-04-01,4,3,0,7,5
"Somalia",2014-05-01,9,5,0,14,5
"Somalia",2014-06-01,6,8,0,14,5
"Somalia",2014-07-01,11,11,0,22,5
"Somalia",2014-08-01,4,16,0,20,7
"Somalia",2014-09-01,12,1,0,13,5
"Somalia",2014-10-01,3,4,0,7,5
"Somalia",2014-11-01,5,10,0,15,5
"Somalia",2014-12-01,6,32,0,38,5
"Somalia",2015-01-01,4,6,0,10,5
"Somalia",2015-02-01,10,3,0,13,5
"Somalia",2015-03-01,7,4,0,11,5
"Somalia",2015-04-01,17,1,0,18,5
"Somalia",2015-05-01,7,6,0,13,7
"Somalia",2015-06-01,3,3,0,6,5
"Somalia",2015-07-01,32,11,0,43,5
"Somalia",2015-08-01,12,0,0,12,1
"Somalia",2015-09-01,5,2,0,7,5
"Somalia",2015-10-01,3,1,0,4,5
"Somalia",2015-11-01,6,8,0,14,5
"Somalia",2015-12-01,16,1,0,17,5
"Somalia",2016-01-01,17,29,0,46,5
"Somalia",2016-02-01,70,3,0,73,5
"Somalia",2016-03-01,9,9,0,18,5
"Somalia",2016-04-01,20,5,0,25,5
"Somalia",2016-05-01,2,7,0,9,5
"Somalia",2016-06-01,31,6,0,37,5
"Somalia",2016-07-01,8,2,0,10,5
"Somalia",2016-08-01,10,2,0,12,5
"Somalia",2016-09-01,3,5,0,8,5
"Somalia",2016-10-01,3,11,0,14,5
"Somalia",2016-11-01,12,0,0,12,1
"Somalia",2016-12-01,44,10,0,54,5
"Somalia",2017-01-01,4,5,0,9,5
"Somalia",2017-02-01,3,6,0,9,5
"Somalia",2017-03-01,5,3,0,8,5
"Somalia",2017-04-01,30,5,0,35,7
"Somalia",2017-05-01,4,13,0,17,5
"Somalia",2017-06-01,31,2,0,33,5
"Somalia",2017-07-01,10,4,0,14,5
"Somalia",2017-08-01,11,8,0,19,7
"Somalia",2017-09-01,10,22,0,32,5
"Somalia",2017-10-01,37,14,0,51,5
"Somalia",2017-11-01,0,4,0,4,5
"Somalia",2017-12-01,5,8,0,13,7
"Somalia",2018-01-01,1,1,0,2,7
"Somalia",2018-02-01,15,6,0,21,5
"Somalia",2018-03-01,10,7,0,17,5
"Somalia",2018-04-01,18,3,0,21,5
"Somalia",2018-05-01,12,9,0,21,7
"Somalia",2018-06-01,1,6,0,7,5
"Somalia",2018-07-01,19,8,0,27,5
"Somalia",2018-08-01,5,10,0,15,5
"Somalia",2018-09-01,5,9,0,14,7
"Somalia",2018-10-01,21,19,0,40,7
"Somalia",2018-11-01,52,19,0,71,7
"Somalia",2018-12-01,4,3,2,9,7
"Somalia",2019-01-01,1,3,0,4,7
"Somalia",2019-02-01,31,24,0,55,7
"Somalia",2019-03-01,9,15,0,24,7
"Somalia",2019-04-01,0,3,0,3,5
"Somalia",2019-05-01,6,7,0,13,7
"Somalia",2019-06-01,1,2,0,3,7
"Somalia",2019-07-01,34,17,0,51,7
"Somalia",2019-08-01,3,1,0,4,7
"Somalia",2019-09-01,9,2,0,11,7
"Somalia",2019-10-01,8,9,0,17,7
"Somalia",2019-11-01,0,2,0,2,7
"Somalia",2019-12-01,85,3,0,88,7
"Somalia",2020-01-01,8,18,0,26,7
"Somalia",2020-02-01,21,1,0,22,5
"Somalia",2020-03-01,8,7,0,15,7
"Somalia",2020-04-01,13,10,20,43,7
"Somalia",2020-05-01,6,19,0,25,7
"Somalia",2020-06-01,13,6,0,19,7
"Somalia",2020-07-01,10,1,0,11,7
"Somalia",2020-08-01,15,7,0,22,7
"Somalia",2020-09-01,13,19,0,32,5
"Somalia",2020-10-01,14,1,0,15,5
"Somalia",2020-11-01,18,1,0,19,5
"Somalia",2020-12-01,17,0,0,17,1
"Somalia",2021-01-01,29,4,0,33,5
"Somalia",2021-02-01,7,5,0,12,5
"Somalia",2021-03-01,10,15,0,25,5
"Somalia",2021-04-01,37,1,0,38,7
"Somalia",2021-05-01,8,1,0,9,5
"Somalia",2021-06-01,19,33,0,52,5
"Somalia",2021-07-01,14,0,0,14,1
"Somalia",2021-08-01,13,11,0,24,5
"Somalia",2021-09-01,8,1,0,9,5
"Somalia",2021-10-01,1,7,0,8,5
"Somalia",2021-11-01,9,10,0,19,5
"Somalia",2021-12-01,12,3,0,15,5
"Somalia",2022-01-01,6,8,0,14,7
"Somalia",2022-02-01,25,2,0,27,5
"Somalia",2022-03-01,9,0,0,9,1
"Somalia",2022-04-01,8,2,0,10,5
"Somalia",2022-05-01,5,1,0,6,5
"Somalia",2022-06-01,4,0,0,4,1
"Somalia",2022-07-01,10,7,0,17,5
"Somalia",2022-08-01,6,8,0,14,5
"Somalia",2022-09-01,6,39,0,45,7
"Somalia",2022-10-01,24,1,0,25,5
"Somalia",2022-11-01,0,0,0,0,1
"Somalia",2022-12-01,0,3,0,3,5
"Somalia",2023-01-01,15,1,0,16,5
"Somalia",2023-02-01,11,3,6,20,7
"Somalia",2023-03-01,2,1,0,3,7
"Somalia",2023-04-01,0,0,0,0,1
"Somalia",2023-05-01,0,5,0,5,5
"Somalia",2023-06-01,27,10,0,37,7
"Somalia",2023-07-01,8,9,0,17,7
"Somalia",2023-08-01,0,6,4,10,7
"Somalia",2023-09-01,11,0,0,11,1
"Somalia",2023-10-01,2,6,0,8,7
"Somalia",2023-11-01,0,0,0,0,1
"Somalia",2023-12-01,1,0,0,1,1
"Somalia",2024-01-01,1,7,0,8,7
"Somalia",2024-02-01,7,22,0,29,7
"Somalia",2024-03-01,21,6,0,27,5
"Somalia",2024-04-01,0,7,0,7,7
"Syria",2011-03-01,0,92,0,92,4
"Syria",2011-04-01,0,405,0,405,4
"Syria",2011-05-01,0,283,0,283,4
"Syria",2011-06-01,0,303,0,303,4
"Syria",2011-07-01,0,285,0,285,7
"Syria",2011-08-01,0,349,0,349,5
"Syria",2011-09-01,10,195,0,205,5
"Syria",2011-10-01,43,195,0,238,5
"Syria",2011-11-01,83,236,0,319,5
"Syria",2011-12-01,126,464,0,590,5
"Syria",2012-01-01,251,158,0,409,5
"Syria",2012-02-01,964,160,0,1124,5
"Syria",2012-03-01,606,126,0,732,5
"Syria",2012-04-01,1101,14,0,1115,5
"Syria",2012-05-01,616,159,0,775,5
"Syria",2012-06-01,1548,109,0,1657,5
"Syria",2012-07-01,2512,186,0,2698,5
"Syria",2012-08-01,3660,359,0,4019,5
"Syria",2012-09-01,2832,561,0,3393,7
"Syria",2012-10-01,2442,296,0,2738,7
"Syria",2012-11-01,1804,311,0,2115,7
"Syria",2012-12-01,1821,417,17,2255,7
"Syria",2013-01-01,2541,223,8,2772,7
"Syria",2013-02-01,2339,280,0,2619,7
"Syria",2013-03-01,2004,305,0,2309,5
"Syria",2013-04-01,1730,279,6,2015,7
"Syria",2013-05-01,1300,409,0,1709,7
"Syria",2013-06-01,1150,287,0,1437,7
"Syria",2013-07-01,1349,181,11,1541,7
"Syria",2013-08-01,2366,254,6,2626,7
"Syria",2013-09-01,1024,154,6,1184,7
"Syria",2013-10-01,1337,129,4,1470,7
"Syria",2013-11-01,1204,149,2,1355,7
"Syria",2013-12-01,1749,307,0,2056,7
"Syria",2014-01-01,1409,153,207,1769,7
"Syria",2014-02-01,1701,217,126,2044,7
"Syria",2014-03-01,1000,167,37,1204,7
"Syria",2014-04-01,1604,115,13,1732,7
"Syria",2014-05-01,1338,70,103,1511,7
"Syria",2014-06-01,1467,60,62,1589,7
"Syria",2014-07-01,1125,90,77,1292,7
"Syria",2014-08-01,1257,109,19,1385,7
"Syria",2014-09-01,1571,138,32,1741,7
"Syria",2014-10-01,905,90,9,1004,7
"Syria",2014-11-01,888,97,17,1002,7
"Syria",2014-12-01,816,100,13,929,7
"Syria",2015-01-01,718,60,18,796,7
"Syria",2015-02-01,794,117,28,939,7
"Syria",2015-03-01,764,207,40,1011,7
"Syria",2015-04-01,1064,96,22,1182,7
"Syria",2015-05-01,1416,237,74,1727,7
"Syria",2015-06-01,1266,417,76,1759,7
"Syria",2015-07-01,1155,48,7,1210,7
"Syria",2015-08-01,1315,112,27,1454,7
"Syria",2015-09-01,893,106,41,1040,7
"Syria",2015-10-01,1134,109,20,1263,7
"Syria",2015-11-01,1072,105,54,1231,7
"Syria",2015-12-01,1313,95,62,1470,7
"Syria",2016-01-01,1269,40,33,1342,7
"Syria",2016-02-01,941,32,77,1050,7
"Syria",2016-03-01,411,55,50,516,7
"Syria",2016-04-01,598,135,60,793,7
"Syria",2016-05-01,610,316,89,1015,7
"Syria",2016-06-01,1107,76,146,1329,7
"Syria",2016-07-01,1280,108,375,1763,7
"Syria",2016-08-01,1273,36,119,1428,7
"Syria",2016-09-01,1228,80,57,1365,7
"Syria",2016-10-01,807,13,137,957,7
"Syria",2016-11-01,1112,28,107,1247,7
"Syria",2016-12-01,801,55,89,945,7
"Syria",2017-01-01,629,63,142,834,7
"Syria",2017-02-01,721,52,213,986,7
"Syria",2017-03-01,765,99,481,1345,7
"Syria",2017-04-01,718,31,343,1092,7
"Syria",2017-05-01,444,112,559,1115,7
"Syria",2017-06-01,337,49,710,1096,7
"Syria",2017-07-01,372,32,652,1056,7
"Syria",2017-08-01,296,22,692,1010,7
"Syria",2017-09-01,755,67,447,1269,7
"Syria",2017-10-01,618,96,588,1302,7
"Syria",2017-11-01,798,6,170,974,7
"Syria",2017-12-01,394,24,119,537,7
"Syria",2018-01-01,491,10,127,628,7
"Syria",2018-02-01,840,13,185,1038,7
"Syria",2018-03-01,1557,13,172,1742,7
"Syria",2018-04-01,265,9,25,299,7
"Syria",2018-05-01,145,17,70,232,7
"Syria",2018-06-01,283,11,96,390,7
"Syria",2018-07-01,196,7,98,301,7
"Syria",2018-08-01,108,8,37,153,7
"Syria",2018-09-01,45,12,11,68,7
"Syria",2018-10-01,27,49,185,261,7
"Syria",2018-11-01,35,13,337,385,7
"Syria",2018-12-01,8,13,114,135,7
"Syria",2019-01-01,35,3,165,203,7
"Syria",2019-02-01,92,3,56,151,7
"Syria",2019-03-01,112,10,148,270,7
"Syria",2019-04-01,141,8,60,209,7
"Syria",2019-05-01,350,14,15,379,7
"Syria",2019-06-01,224,12,13,249,7
"Syria",2019-07-01,363,15,9,387,7
"Syria",2019-08-01,204,3,3,210,7
"Syria",2019-09-01,16,4,25,45,7
"Syria",2019-10-01,34,29,90,153,7
"Syria",2019-11-01,109,11,41,161,7
"Syria",2019-12-01,159,2,26,187,7
"Syria",2020-01-01,204,18,4,226,7
"Syria",2020-02-01,202,1,17,220,7
"Syria",2020-03-01,56,9,10,75,7
"Syria",2020-04-01,6,16,1,23,7
"Syria",2020-05-01,3,13,2,18,7
"Syria",2020-06-01,6,10,11,27,7
"Syria",2020-07-01,7,20,12,39,7
"Syria",2020-08-01,8,0,0,8,3
"Syria",2020-09-01,11,6,3,20,7
"Syria",2020-10-01,17,0,3,20,3
"Syria",2020-11-01,20,3,3,26,7
"Syria",2020-12-01,5,3,5,13,7
"Syria",2021-01-01,8,7,8,23,7
"Syria",2021-02-01,8,6,1,15,7
"Syria",2021-03-01,27,19,6,52,7
"Syria",2021-04-01,12,2,3,17,7
"Syria",2021-05-01,8,8,2,18,7
"Syria",2021-06-01,39,10,2,51,7
"Syria",2021-07-01,60,9,4,73,7
"Syria",2021-08-01,26,7,11,44,7
"Syria",2021-09-01,15,2,5,22,7
"Syria",2021-10-01,19,1,2,22,7
"Syria",2021-11-01,16,5,5,26,7
"Syria",2021-12-01,17,11,16,44,7
"Syria",2022-01-01,47,4,7,58,7
"Syria",2022-02-01,14,3,23,40,7
"Syria",2022-03-01,1,3,3,7,7
"Syria",2022-04-01,4,13,1,18,7
"Syria",2022-05-01,4,9,0,13,7
"Syria",2022-06-01,3,12,5,20,7
"Syria",2022-07-01,8,4,6,18,7
"Syria",2022-08-01,26,6,5,37,7
"Syria",2022-09-01,8,4,5,17,7
"Syria",2022-10-01,8,7,4,19,7
"Syria",2022-11-01,15,7,4,26,7
"Syria",2022-12-01,4,14,2,20,7
"Syria",2023-01-01,7,3,2,12,7
"Syria",2023-02-01,83,1,2,86,7
"Syria",2023-03-01,14,12,0,26,7
"Syria",2023-04-01,9,14,0,23,7
"Syria",2023-05-01,5,8,4,17,7
"Syria",2023-06-01,24,4,2,30,7
"Syria",2023-07-01,20,1,5,26,7
"Syria",2023-08-01,16,6,9,31,7
"Syria",2023-09-01,17,2,7,26,7
"Syria",2023-10-01,124,3,7,134,7
"Syria",2023-11-01,27,9,5,41,7
"Syria",2023-12-01,21,5,0,26,7
"Syria",2024-01-01,13,0,0,13,3
"Syria",2024-02-01,43,11,5,59,7
"Syria",2024-03-01,49,13,4,66,7
"Syria",2024-04-01,15,5,6,26,7
"Turkey",2009-03-01,0,0,0,0,1
"Turkey",2009-04-01,0,0,0,0,1
"Turkey",2009-05-01,0,0,0,0,1
"Turkey",2009-06-01,1,0,0,1,1
"Turkey",2009-07-01,4,0,0,4,1
"Turkey",2009-08-01,0,0,0,0,1
"Turkey",2009-09-01,2,0,0,2,1
"Turkey",2009-10-01,2,0,0,2,1
"Turkey",2009-12-01,0,0,0,0,1
"Turkey",2010-01-01,1,0,0,1,1
"Turkey",2010-03-01,1,0,0,1,1
"Turkey",2010-04-01,0,0,0,0,1
"Turkey",2010-05-01,0,0,0,0,1
"Turkey",2010-06-01,5,0,0,5,1
"Turkey",2010-07-01,0,0,0,0,1
"Turkey",2010-08-01,0,0,0,0,1
"Turkey",2010-09-01,0,0,0,0,1
"Turkey",2010-10-01,0,0,0,0,1
"Turkey",2010-12-01,0,0,0,0,1
"Turkey",2011-03-01,0,0,0,0,1
"Turkey",2011-04-01,0,0,0,0,1
"Turkey",2011-05-01,0,0,0,0,1
"Turkey",2011-06-01,0,0,0,0,1
"Turkey",2011-07-01,0,0,0,0,1
"Turkey",2011-08-01,0,0,0,0,1
"Turkey",2011-09-01,13,0,0,13,1
"Turkey",2011-10-01,3,0,0,3,1
"Turkey",2011-11-01,1,0,0,1,1
"Turkey",2011-12-01,36,0,0,36,1
"Turkey",2012-02-01,0,0,0,0,1
"Turkey",2012-03-01,0,0,0,0,1
"Turkey",2012-04-01,0,0,0,0,1
"Turkey",2012-05-01,1,0,0,1,1
"Turkey",2012-06-01,0,0,0,0,1
"Turkey",2012-07-01,0,0,0,0,1
"Turkey",2012-08-01,9,0,0,9,1
"Turkey",2012-09-01,1,1,0,2,5
"Turkey",2012-10-01,6,0,0,6,1
"Turkey",2012-11-01,0,0,0,0,1
"Turkey",2012-12-01,3,0,0,3,1
"Turkey",2013-01-01,0,0,0,0,1
"Turkey",2013-03-01,0,0,0,0,1
"Turkey",2013-07-01,0,0,1,1,2
"Turkey",2013-08-01,0,0,1,1,2
"Turkey",2013-10-01,0,0,1,1,2
"Turkey",2014-01-01,0,0,0,0,1
"Turkey",2014-05-01,0,0,0,0,1
"Turkey",2014-08-01,0,0,0,0,1
"Turkey",2014-09-01,0,0,0,0,1
"Turkey",2014-10-01,0,0,0,0,1
"Turkey",2015-03-01,0,0,0,0,1
"Turkey",2015-04-01,0,0,0,0,1
"Turkey",2015-06-01,0,0,0,0,4
"Turkey",2015-07-01,1,34,0,35,5
"Turkey",2015-08-01,8,2,0,10,5
"Turkey",2015-09-01,11,0,0,11,1
"Turkey",2015-10-01,2,104,0,106,5
"Turkey",2015-11-01,3,0,0,3,1
"Turkey",2015-12-01,8,2,0,10,5
"Turkey",2016-01-01,25,2,0,27,5
"Turkey",2016-02-01,0,0,0,0,1
"Turkey",2016-03-01,39,0,0,39,1
"Turkey",2016-04-01,5,1,0,6,5
"Turkey",2016-05-01,16,0,0,16,1
"Turkey",2016-06-01,11,0,0,11,5
"Turkey",2016-07-01,185,0,0,185,1
"Turkey",2016-08-01,2,66,0,68,5
"Turkey",2016-09-01,0,0,0,0,1
"Turkey",2016-10-01,12,0,0,12,1
"Turkey",2016-11-01,12,0,0,12,1
"Turkey",2016-12-01,7,0,0,7,1
"Turkey",2017-01-01,1,39,0,40,5
"Turkey",2017-02-01,1,0,0,1,1
"Turkey",2017-03-01,0,0,0,0,1
"Turkey",2017-04-01,2,0,0,2,1
"Turkey",2017-05-01,0,0,0,0,1
"Turkey",2017-06-01,1,0,0,1,1
"Turkey",2017-07-01,1,4,0,5,5
"Turkey",2017-08-01,0,4,0,4,5
"Turkey",2017-09-01,0,0,0,0,1
"Turkey",2017-10-01,0,0,0,0,1
"Turkey",2017-11-01,0,0,0,0,1
"Turkey",2017-12-01,0,0,0,0,1
"Turkey",2018-01-01,0,0,0,0,1
"Turkey",2018-02-01,0,0,2,2,3
"Turkey",2018-03-01,1,0,0,1,1
"Turkey",2018-04-01,0,0,0,0,1
"Turkey",2018-05-01,0,0,0,0,1
"Turkey",2018-06-01,0,0,0,0,1
"Turkey",2018-07-01,2,0,0,2,1
"Turkey",2018-08-01,1,0,0,1,1
"Turkey",2018-09-01,0,0,0,0,1
"Turkey",2018-10-01,0,0,0,0,1
"Turkey",2018-11-01,0,0,0,0,1
"Turkey",2018-12-01,0,0,0,0,1
"Turkey",2019-01-01,0,0,0,0,1
"Turkey",2019-03-01,0,0,0,0,1
"Turkey",2019-04-01,0,0,0,0,1
"Turkey",2019-05-01,0,0,0,0,1
"Turkey",2019-06-01,0,0,0,0,1
"Turkey",2019-07-01,2,2,0,4,5
"Turkey",2019-08-01,1,0,0,1,1
"Turkey",2019-09-01,1,7,0,8,5
"Turkey",2019-10-01,0,0,19,19,3
"Turkey",2019-11-01,0,0,0,0,3
"Turkey",2019-12-01,0,0,0,0,1
"Turkey",2020-02-01,0,0,0,0,1
"Turkey",2020-03-01,0,0,0,0,1
"Turkey",2020-04-01,2,5,0,7,5
"Turkey",2020-05-01,2,0,0,2,1
"Turkey",2020-06-01,0,6,0,6,5
"Turkey",2020-07-01,0,0,0,0,1
"Turkey",2020-08-01,0,0,0,0,1
"Turkey",2020-09-01,0,0,0,0,1
"Turkey",2020-10-01,0,0,0,0,1
"Turkey",2020-11-01,0,0,0,0,1
"Turkey",2021-01-01,0,0,0,0,1
"Turkey",2021-03-01,0,0,0,0,1
"Turkey",2021-04-01,0,0,0,0,1
"Turkey",2021-05-01,1,0,0,1,1
"Turkey",2021-06-01,0,0,0,0,1
"Turkey",2021-07-01,0,0,0,0,1
"Turkey",2021-08-01,0,0,0,0,1
"Turkey",2021-09-01,0,0,0,0,1
"Turkey",2021-10-01,0,0,0,0,1
"Turkey",2021-11-01,0,0,0,0,1
"Turkey",2021-12-01,0,0,0,0,1
"Turkey",2022-01-01,0,0,0,0,1
"Turkey",2022-02-01,0,0,0,0,1
"Turkey",2022-04-01,0,0,0,0,1
"Turkey",2022-05-01,0,0,0,0,1
"Turkey",2022-06-01,0,0,0,0,1
"Turkey",2022-07-01,0,0,0,0,1
"Turkey",2022-08-01,0,0,0,0,1
"Turkey",2022-09-01,0,0,0,0,1
"Turkey",2022-10-01,0,0,0,0,1
"Turkey",2022-11-01,0,0,0,0,1
"Turkey",2022-12-01,0,0,0,0,1
"Turkey",2023-01-01,0,0,0,0,1
"Turkey",2023-03-01,0,0,0,0,1
"Turkey",2023-04-01,0,0,0,0,1
"Turkey",2023-05-01,0,0,0,0,1
"Turkey",2023-06-01,0,0,0,0,1
"Turkey",2023-07-01,0,0,0,0,1
"Turkey",2023-08-01,0,0,0,0,1
"Turkey",2023-09-01,0,1,0,1,5
"Turkey",2023-10-01,0,0,0,0,1
"Turkey",2023-11-01,0,0,0,0,1
"Turkey",2023-12-01,0,0,0,0,1
"Turkey",2024-01-01,0,1,0,1,4
"Turkey",2024-02-01,1,0,0,1,1
"Turkey",2024-03-01,0,0,0,0,2
"Turkey",2024-04-01,0,0,1,1,2
"Yemen (North Yemen)",2009-11-01,0,0,0,0,1
"Yemen (North Yemen)",2009-12-01,41,0,0,41,1
"Yemen (North Yemen)",2010-01-01,0,0,0,0,1
"Yemen (North Yemen)",2010-02-01,0,0,0,0,1
"Yemen (North Yemen)",2010-03-01,0,0,0,0,1
"Yemen (North Yemen)",2010-04-01,0,0,0,0,1
"Yemen (North Yemen)",2010-05-01,0,0,0,0,1
"Yemen (North Yemen)",2010-06-01,0,0,0,0,1
"Yemen (North Yemen)",2010-07-01,0,0,0,0,1
"Yemen (North Yemen)",2010-08-01,1,0,0,1,1
"Yemen (North Yemen)",2010-09-01,1,0,0,1,1
"Yemen (North Yemen)",2010-10-01,1,0,0,1,1
"Yemen (North Yemen)",2010-11-01,0,0,0,0,3
"Yemen (North Yemen)",2010-12-01,0,0,0,0,1
"Yemen (North Yemen)",2011-01-01,0,0,0,0,1
"Yemen (North Yemen)",2011-02-01,2,10,0,12,5
"Yemen (North Yemen)",2011-03-01,0,78,0,78,5
"Yemen (North Yemen)",2011-04-01,2,16,0,18,5
"Yemen (North Yemen)",2011-05-01,10,1,0,11,5
"Yemen (North Yemen)",2011-06-01,12,1,0,13,5
"Yemen (North Yemen)",2011-07-01,6,0,0,6,1
"Yemen (North Yemen)",2011-08-01,0,0,0,0,3
"Yemen (North Yemen)",2011-09-01,10,0,0,10,5
"Yemen (North Yemen)",2011-10-01,0,0,0,0,5
"Yemen (North Yemen)",2011-11-01,0,15,0,15,5
"Yemen (North Yemen)",2011-12-01,0,0,0,0,5
"Yemen (North Yemen)",2012-01-01,0,0,0,0,1
"Yemen (North Yemen)",2012-02-01,0,0,0,0,1
"Yemen (North Yemen)",2012-03-01,0,0,0,0,1
"Yemen (North Yemen)",2012-04-01,1,0,0,1,1
"Yemen (North Yemen)",2012-05-01,15,0,3,18,3
"Yemen (North Yemen)",2012-06-01,7,0,0,7,1
"Yemen (North Yemen)",2012-07-01,0,0,0,0,1
"Yemen (North Yemen)",2012-08-01,3,0,0,3,1
"Yemen (North Yemen)",2012-09-01,13,0,0,13,1
"Yemen (North Yemen)",2012-10-01,5,0,0,5,1
"Yemen (North Yemen)",2012-11-01,0,0,0,0,1
"Yemen (North Yemen)",2012-12-01,1,0,0,1,1
"Yemen (North Yemen)",2013-01-01,0,0,0,0,1
"Yemen (North Yemen)",2013-02-01,0,0,0,0,1
"Yemen (North Yemen)",2013-03-01,0,0,0,0,1
"Yemen (North Yemen)",2013-04-01,0,0,0,0,1
"Yemen (North Yemen)",2013-05-01,2,0,0,2,1
"Yemen (North Yemen)",2013-06-01,2,0,0,2,1
"Yemen (North Yemen)",2013-07-01,0,0,0,0,1
"Yemen (North Yemen)",2013-08-01,0,0,0,0,1
"Yemen (North Yemen)",2013-09-01,0,0,0,0,1
"Yemen (North Yemen)",2013-10-01,4,0,0,4,1
"Yemen (North Yemen)",2013-11-01,0,0,0,0,1
"Yemen (North Yemen)",2013-12-01,24,0,0,24,1
"Yemen (North Yemen)",2014-01-01,1,0,0,1,1
"Yemen (North Yemen)",2014-02-01,0,0,0,0,1
"Yemen (North Yemen)",2014-03-01,2,0,0,2,1
"Yemen (North Yemen)",2014-04-01,6,0,0,6,1
"Yemen (North Yemen)",2014-05-01,8,0,0,8,3
"Yemen (North Yemen)",2014-06-01,23,0,0,23,1
"Yemen (North Yemen)",2014-07-01,0,0,0,0,1
"Yemen (North Yemen)",2014-08-01,0,0,0,0,1
"Yemen (North Yemen)",2014-09-01,0,0,0,0,3
"Yemen (North Yemen)",2014-10-01,10,0,7,17,3
"Yemen (North Yemen)",2014-11-01,1,0,0,1,3
"Yemen (North Yemen)",2014-12-01,3,0,16,19,3
"Yemen (North Yemen)",2015-01-01,0,0,1,1,3
"Yemen (North Yemen)",2015-02-01,0,1,0,1,7
"Yemen (North Yemen)",2015-03-01,105,14,0,119,7
"Yemen (North Yemen)",2015-04-01,190,0,0,190,3
"Yemen (North Yemen)",2015-05-01,244,0,0,244,3
"Yemen (North Yemen)",2015-06-01,203,0,0,203,3
"Yemen (North Yemen)",2015-07-01,352,0,0,352,7
"Yemen (North Yemen)",2015-08-01,115,0,0,115,3
"Yemen (North Yemen)",2015-09-01,262,1,0,263,7
"Yemen (North Yemen)",2015-10-01,68,0,0,68,3
"Yemen (North Yemen)",2015-11-01,33,0,0,33,3
"Yemen (North Yemen)",2015-12-01,61,0,0,61,3
"Yemen (North Yemen)",2016-01-01,34,1,1,36,7
"Yemen (North Yemen)",2016-02-01,45,0,5,50,3
"Yemen (North Yemen)",2016-03-01,114,0,0,114,3
"Yemen (North Yemen)",2016-04-01,7,0,0,7,3
"Yemen (North Yemen)",2016-05-01,0,0,2,2,3
"Yemen (North Yemen)",2016-06-01,59,0,9,68,3
"Yemen (North Yemen)",2016-07-01,7,1,4,12,7
"Yemen (North Yemen)",2016-08-01,95,0,2,97,3
"Yemen (North Yemen)",2016-09-01,110,0,0,110,3
"Yemen (North Yemen)",2016-10-01,174,0,0,174,3
"Yemen (North Yemen)",2016-11-01,55,1,0,56,7
"Yemen (North Yemen)",2016-12-01,17,0,0,17,3
"Yemen (North Yemen)",2017-01-01,49,0,20,69,3
"Yemen (North Yemen)",2017-02-01,25,2,0,27,7
"Yemen (North Yemen)",2017-03-01,80,0,7,87,3
"Yemen (North Yemen)",2017-04-01,12,0,3,15,3
"Yemen (North Yemen)",2017-05-01,20,0,0,20,3
"Yemen (North Yemen)",2017-06-01,4,0,0,4,3
"Yemen (North Yemen)",2017-07-01,28,0,0,28,3
"Yemen (North Yemen)",2017-08-01,79,0,0,79,3
"Yemen (North Yemen)",2017-09-01,20,0,0,20,3
"Yemen (North Yemen)",2017-10-01,45,0,0,45,3
"Yemen (North Yemen)",2017-11-01,52,0,0,52,3
"Yemen (North Yemen)",2017-12-01,209,0,11,220,3
"Yemen (North Yemen)",2018-01-01,42,1,0,43,7
"Yemen (North Yemen)",2018-02-01,45,0,3,48,3
"Yemen (North Yemen)",2018-03-01,36,0,2,38,3
"Yemen (North Yemen)",2018-04-01,51,1,0,52,7
"Yemen (North Yemen)",2018-05-01,16,0,0,16,3
"Yemen (North Yemen)",2018-06-01,32,0,0,32,3
"Yemen (North Yemen)",2018-07-01,66,0,0,66,3
"Yemen (North Yemen)",2018-08-01,167,0,0,167,3
"Yemen (North Yemen)",2018-09-01,23,0,0,23,3
"Yemen (North Yemen)",2018-10-01,45,0,0,45,3
"Yemen (North Yemen)",2018-11-01,35,0,0,35,3
"Yemen (North Yemen)",2018-12-01,7,0,0,7,3
"Yemen (North Yemen)",2019-01-01,31,0,2,33,3
"Yemen (North Yemen)",2019-02-01,37,0,0,37,3
"Yemen (North Yemen)",2019-03-01,18,0,0,18,3
"Yemen (North Yemen)",2019-04-01,39,0,2,41,3
"Yemen (North Yemen)",2019-05-01,27,0,6,33,3
"Yemen (North Yemen)",2019-06-01,11,1,0,12,7
"Yemen (North Yemen)",2019-07-01,13,1,0,14,7
"Yemen (North Yemen)",2019-08-01,16,0,12,28,3
"Yemen (North Yemen)",2019-09-01,172,0,0,172,3
"Yemen (North Yemen)",2019-10-01,8,0,0,8,3
"Yemen (North Yemen)",2019-11-01,26,0,0,26,3
"Yemen (North Yemen)",2019-12-01,22,0,0,22,3
"Yemen (North Yemen)",2020-01-01,21,0,2,23,3
"Yemen (North Yemen)",2020-02-01,76,3,1,80,7
"Yemen (North Yemen)",2020-03-01,62,3,0,65,5
"Yemen (North Yemen)",2020-04-01,50,41,0,91,7
"Yemen (North Yemen)",2020-05-01,23,1,4,28,7
"Yemen (North Yemen)",2020-06-01,46,0,0,46,3
"Yemen (North Yemen)",2020-07-01,68,3,0,71,7
"Yemen (North Yemen)",2020-08-01,63,0,2,65,3
"Yemen (North Yemen)",2020-09-01,46,0,1,47,3
"Yemen (North Yemen)",2020-10-01,62,0,0,62,3
"Yemen (North Yemen)",2020-11-01,54,0,0,54,3
"Yemen (North Yemen)",2020-12-01,52,1,0,53,7
"Yemen (North Yemen)",2021-01-01,23,11,0,34,5
"Yemen (North Yemen)",2021-02-01,30,8,0,38,5
"Yemen (North Yemen)",2021-03-01,42,0,5,47,7
"Yemen (North Yemen)",2021-04-01,29,2,0,31,7
"Yemen (North Yemen)",2021-05-01,43,0,0,43,3
"Yemen (North Yemen)",2021-06-01,58,3,1,62,7
"Yemen (North Yemen)",2021-07-01,28,0,2,30,3
"Yemen (North Yemen)",2021-08-01,31,1,0,32,7
"Yemen (North Yemen)",2021-09-01,39,9,0,48,7
"Yemen (North Yemen)",2021-10-01,135,0,0,135,3
"Yemen (North Yemen)",2021-11-01,61,1,1,63,7
"Yemen (North Yemen)",2021-12-01,71,0,0,71,1
"Yemen (North Yemen)",2022-01-01,212,16,0,228,7
"Yemen (North Yemen)",2022-02-01,57,0,1,58,3
"Yemen (North Yemen)",2022-03-01,48,0,0,48,3
"Yemen (North Yemen)",2022-04-01,30,0,0,30,7
"Yemen (North Yemen)",2022-05-01,26,0,0,26,3
"Yemen (North Yemen)",2022-06-01,26,0,3,29,3
"Yemen (North Yemen)",2022-07-01,29,1,0,30,5
"Yemen (North Yemen)",2022-08-01,19,0,10,29,7
"Yemen (North Yemen)",2022-09-01,25,0,0,25,3
"Yemen (North Yemen)",2022-10-01,27,2,0,29,7
"Yemen (North Yemen)",2022-11-01,23,0,1,24,3
"Yemen (North Yemen)",2022-12-01,13,2,0,15,7
"Yemen (North Yemen)",2023-01-01,14,0,0,14,3
"Yemen (North Yemen)",2023-02-01,41,1,1,43,7
"Yemen (North Yemen)",2023-03-01,31,0,3,34,3
"Yemen (North Yemen)",2023-04-01,23,1,2,26,7
"Yemen (North Yemen)",2023-05-01,23,3,3,29,7
"Yemen (North Yemen)",2023-06-01,9,1,1,11,7
"Yemen (North Yemen)",2023-07-01,26,5,1,32,7
"Yemen (North Yemen)",2023-08-01,31,1,0,32,7
"Yemen (North Yemen)",2023-09-01,10,0,8,18,3
"Yemen (North Yemen)",2023-10-01,21,1,3,25,7
"Yemen (North Yemen)",2023-11-01,17,3,0,20,7
"Yemen (North Yemen)",2023-12-01,6,0,0,6,1
"Yemen (North Yemen)",2024-01-01,13,1,3,17,7
"Yemen (North Yemen)",2024-02-01,11,1,8,20,7
"Yemen (North Yemen)",2024-03-01,37,2,3,42,7
"Yemen (North Yemen)",2024-04-01,16,0,4,20,3
